,Player URL,Datetime,R2.0 Defend,R2.0 Attack,R2.0 All,ACS All,ACS Defend,ACS Attack,K All,K Defend,K Attack,D All,D Defend,D Attack,A All,A Defend,A Attack,+/– All,+/– Defend,+/– Attack,KAST All,KAST Defend,KAST Attack,ADR All,ADR Defend,ADR Attack,HS% All,HS% Defend,HS% Attack,FK All,FK Defend,FK Attack,FD All,FD Defend,FD Attack
0,https://vlr.gg/player/44464/nezha,2025-03-11 18:00:00,1.25,1.85,1.54,299,249,354,46,21,25,26,15,11,14,6,8,+3,0,+3,83%,82%,85%,187,166,211,53%,54%,52%,7,4,3,4,4,0
1,https://vlr.gg/player/28596/wanheda,2025-03-11 18:00:00,1.18,1.29,1.24,189,172,209,26,12,14,22,11,11,27,16,11,+8,0,+8,79%,77%,80%,125,122,128,28%,24%,33%,9,1,8,1,1,0
2,https://vlr.gg/player/39565/ellie,2025-03-11 18:00:00,1.30,0.80,1.06,190,225,145,29,18,11,22,11,11,13,10,3,-2,-1,-1,83%,82%,85%,118,145,88,21%,23%,17%,1,0,1,3,1,2
3,https://vlr.gg/player/44462/kyujinn,2025-03-11 18:00:00,1.14,0.94,1.04,202,231,176,33,19,14,26,14,12,7,2,5,+2,+3,-1,74%,73%,75%,141,151,130,39%,44%,33%,3,3,0,1,0,1
4,https://vlr.gg/player/44500/atisca,2025-03-11 18:00:00,0.89,1.06,0.97,210,199,227,33,16,17,28,16,12,8,4,4,+1,+2,-1,71%,77%,65%,136,122,150,21%,29%,15%,7,5,2,6,3,3
5,https://vlr.gg/player/47064/yanbry,2025-03-11 18:00:00,1.36,1.34,1.35,261,273,252,39,19,20,30,15,15,5,1,4,+1,0,+1,67%,60%,73%,169,178,162,53%,44%,64%,3,2,1,2,2,0
6,https://vlr.gg/player/35942/miffy,2025-03-11 18:00:00,0.89,0.71,0.79,181,218,151,26,15,11,35,18,17,10,6,4,0,+2,-2,69%,75%,64%,116,138,96,38%,40%,37%,5,3,2,5,1,4
7,https://vlr.gg/player/44632/andi,2025-03-11 18:00:00,0.74,0.66,0.70,144,127,160,23,9,14,33,15,18,5,5,0,-5,-3,-2,48%,50%,45%,105,86,121,43%,42%,44%,2,0,2,7,3,4
8,https://vlr.gg/player/35923/vale,2025-03-11 18:00:00,0.52,0.84,0.69,146,105,185,21,9,12,34,16,18,8,1,7,0,-2,+2,62%,45%,77%,93,65,119,42%,44%,41%,4,1,3,4,3,1
9,https://vlr.gg/player/45184/rush,2025-03-11 18:00:00,0.41,0.53,0.47,108,80,135,15,5,10,35,17,18,14,10,4,-8,-5,-3,60%,55%,64%,70,45,94,25%,24%,25%,1,0,1,9,5,4
10,https://vlr.gg/player/20140/vora,2025-03-11 16:00:00,1.62,0.83,1.26,223,280,157,53,39,14,37,17,20,12,3,9,+3,+5,-2,81%,89%,72%,158,194,114,40%,43%,34%,6,5,1,3,0,3
11,https://vlr.gg/player/64/gmd,2025-03-11 16:00:00,1.01,1.11,1.05,240,218,258,54,28,26,48,25,23,24,13,11,+2,+2,0,64%,66%,62%,147,133,162,34%,38%,30%,6,3,3,4,1,3
12,https://vlr.gg/player/8376/seven,2025-03-11 16:00:00,1.03,0.93,0.98,188,185,188,41,22,19,41,20,21,20,16,4,0,-1,+1,78%,86%,69%,119,122,117,15%,16%,14%,3,1,2,3,2,1
13,https://vlr.gg/player/3702/sym,2025-03-11 16:00:00,0.90,0.94,0.92,222,251,188,52,31,21,51,29,22,7,4,3,+6,+6,0,66%,60%,72%,144,161,123,40%,39%,42%,18,12,6,12,6,6
14,https://vlr.gg/player/39602/recoil,2025-03-11 16:00:00,0.62,0.87,0.74,169,140,202,39,19,20,50,26,24,8,3,5,-7,-3,-4,66%,57%,76%,115,99,134,44%,53%,38%,1,1,0,8,4,4
15,https://vlr.gg/player/9063/infiltrator,2025-03-11 16:00:00,1.17,1.12,1.14,247,259,239,58,28,30,50,21,29,12,7,5,+3,+3,0,72%,72%,71%,148,148,148,26%,32%,20%,9,5,4,6,2,4
16,https://vlr.gg/player/9837/flare,2025-03-11 16:00:00,1.18,1.08,1.13,193,176,215,46,18,28,42,16,26,15,12,3,0,+1,-1,72%,90%,57%,134,124,143,24%,27%,23%,1,1,0,1,0,1
17,https://vlr.gg/player/9835/ali,2025-03-11 16:00:00,0.89,0.93,0.91,204,212,201,41,21,20,50,23,27,24,9,15,-1,0,-1,72%,79%,66%,130,136,124,27%,25%,28%,7,2,5,8,2,6
18,https://vlr.gg/player/9017/moobs,2025-03-11 16:00:00,1.04,0.75,0.88,189,223,163,45,27,18,50,21,29,9,2,7,-3,+3,-6,56%,62%,51%,121,137,109,34%,37%,31%,12,9,3,15,6,9
19,https://vlr.gg/player/17865/nahsie,2025-03-11 16:00:00,0.90,0.86,0.88,165,148,176,37,16,21,47,19,28,22,12,10,-3,-2,-1,67%,76%,60%,102,88,114,25%,20%,30%,1,0,1,4,2,2
20,https://vlr.gg/player/9540/rxyal,2025-03-11 15:15:00,1.44,1.66,1.54,264,258,274,45,23,22,25,14,11,13,5,8,+5,0,+5,84%,74%,95%,160,157,163,33%,26%,41%,6,1,5,1,1,0
21,https://vlr.gg/player/7267/nex,2025-03-11 15:15:00,0.81,1.10,0.94,264,237,290,38,18,20,35,19,16,6,3,3,0,-3,+3,67%,65%,70%,158,146,172,23%,27%,20%,11,6,5,11,9,2
22,https://vlr.gg/player/8831/noumit,2025-03-11 15:15:00,0.65,1.26,0.93,147,115,181,22,8,14,25,15,10,13,6,7,0,-1,+1,70%,61%,80%,103,87,122,22%,23%,22%,1,0,1,1,1,0
23,https://vlr.gg/player/23352/kixer,2025-03-11 15:15:00,1.04,0.79,0.92,172,177,168,25,14,11,33,17,16,24,14,10,+2,+2,0,79%,83%,75%,106,110,102,18%,15%,24%,4,3,1,2,1,1
24,https://vlr.gg/player/33398/miyamura,2025-03-11 15:15:00,1.12,0.68,0.91,193,212,167,27,15,12,32,16,16,12,8,4,+2,+1,+1,84%,87%,80%,127,143,108,28%,40%,16%,4,1,3,2,0,2
25,https://vlr.gg/player/41076/heizzy,2025-03-11 15:15:00,1.06,1.17,1.12,227,241,217,37,19,18,29,15,14,7,4,3,-1,-2,+1,77%,85%,70%,151,178,128,40%,40%,40%,1,0,1,2,2,0
26,https://vlr.gg/player/27796/yanido,2025-03-11 15:15:00,1.13,1.08,1.10,237,234,240,36,17,19,33,16,17,16,9,7,+4,-1,+5,77%,75%,78%,145,159,134,14%,24%,10%,6,1,5,2,2,0
27,https://vlr.gg/player/51676/prayy,2025-03-11 15:15:00,0.61,1.48,1.08,214,131,292,32,8,24,31,17,14,8,3,5,-6,-2,-4,74%,65%,83%,143,95,185,34%,30%,36%,5,3,2,11,5,6
28,https://vlr.gg/player/37694/ayokz,2025-03-11 15:15:00,0.98,0.70,0.83,163,209,123,22,14,8,32,16,16,24,11,13,-2,-2,0,72%,80%,65%,108,134,86,26%,21%,35%,3,1,2,5,3,2
29,https://vlr.gg/player/27951/rxchyy,2025-03-11 15:15:00,0.75,0.62,0.68,168,162,167,23,12,11,33,15,18,7,2,5,-4,-3,-1,67%,70%,65%,127,116,136,28%,37%,23%,2,0,2,6,3,3
30,https://vlr.gg/player/52962/void,2025-03-11 13:00:00,1.26,1.55,1.39,264,260,266,41,21,20,26,17,9,16,10,6,+3,+1,+2,80%,88%,70%,173,168,181,22%,26%,17%,6,3,3,3,2,1
31,https://vlr.gg/player/23110/hoda,2025-03-11 13:00:00,1.24,1.37,1.30,224,217,224,36,20,16,24,15,9,10,2,8,-2,-3,+1,66%,54%,80%,150,159,139,27%,31%,22%,1,0,1,3,3,0
32,https://vlr.gg/player/52961/selfk,2025-03-11 13:00:00,0.81,1.45,1.10,184,155,225,29,13,16,29,19,10,36,19,17,0,0,0,86%,79%,95%,118,92,149,32%,46%,26%,2,2,0,2,2,0
33,https://vlr.gg/player/52959/gusel,2025-03-11 13:00:00,0.86,1.11,0.97,175,149,203,26,12,14,29,18,11,19,12,7,-1,-3,+2,75%,75%,75%,110,101,120,48%,68%,35%,4,0,4,5,3,2
34,https://vlr.gg/player/52960/ryphian,2025-03-11 13:00:00,0.72,1.15,0.91,203,186,229,32,15,17,33,20,13,9,4,5,0,-1,+1,75%,67%,85%,127,114,144,17%,18%,17%,9,4,5,9,5,4
35,https://vlr.gg/player/16418/smurfette,2025-03-11 13:00:00,1.14,0.98,1.06,229,256,213,36,18,18,33,16,17,8,3,5,+2,+3,-1,68%,70%,67%,145,156,136,36%,33%,41%,8,4,4,6,1,5
36,https://vlr.gg/player/19371/eva,2025-03-11 13:00:00,1.11,0.97,1.03,210,225,197,33,15,18,30,14,16,8,2,6,-2,-3,+1,70%,55%,83%,141,140,142,30%,37%,24%,1,0,1,3,3,0
37,https://vlr.gg/player/24107/sarah,2025-03-11 13:00:00,0.61,1.07,0.86,155,122,181,24,8,16,31,16,15,17,9,8,+5,+1,+4,70%,50%,88%,106,76,130,33%,27%,37%,5,1,4,0,0,0
38,https://vlr.gg/player/17343/ness,2025-03-11 13:00:00,0.38,1.12,0.78,172,114,226,25,7,18,34,18,16,16,2,14,-2,-4,+2,61%,40%,79%,121,74,160,23%,38%,18%,4,1,3,6,5,1
39,https://vlr.gg/player/30186/nami,2025-03-11 13:00:00,0.16,1.13,0.69,168,84,232,23,4,19,37,19,18,16,5,11,-3,-3,0,64%,45%,79%,115,63,158,41%,38%,42%,4,1,3,7,4,3
40,https://vlr.gg/player/26280/lusadris,2025-03-11 12:35:00,1.07,1.14,1.11,252,251,250,76,37,39,63,33,30,15,10,5,0,-1,+1,67%,58%,77%,157,153,161,25%,32%,20%,7,3,4,7,4,3
41,https://vlr.gg/player/1399/sterben,2025-03-11 12:35:00,1.04,1.14,1.09,208,173,251,61,25,36,62,30,32,46,19,27,0,0,0,71%,67%,74%,146,124,167,28%,21%,33%,7,3,4,7,3,4
42,https://vlr.gg/player/39352/rensz,2025-03-11 12:35:00,1.06,1.13,1.09,183,171,198,63,29,34,59,29,30,25,11,14,-8,-3,-5,83%,79%,86%,121,108,135,43%,34%,53%,0,0,0,8,3,5
43,https://vlr.gg/player/10125/qw1,2025-03-11 12:35:00,0.78,1.04,0.91,224,232,212,69,36,33,67,38,29,13,8,5,+1,-5,+6,76%,72%,79%,133,139,128,31%,30%,31%,19,8,11,18,13,5
44,https://vlr.gg/player/7353/glovee,2025-03-11 12:35:00,0.93,0.75,0.84,179,172,182,47,24,23,65,30,35,40,21,19,+3,+2,+1,74%,77%,72%,117,111,123,16%,16%,16%,8,4,4,5,2,3
45,https://vlr.gg/player/41719/mepeezy,2025-03-11 12:35:00,1.20,1.12,1.16,213,224,218,64,34,30,59,29,30,37,14,23,+5,+3,+2,81%,84%,79%,144,147,141,33%,33%,32%,11,5,6,6,2,4
46,https://vlr.gg/player/49346/echo,2025-03-11 12:35:00,1.34,0.96,1.15,223,271,169,68,41,27,61,33,28,43,23,20,+2,+1,+1,80%,84%,77%,137,174,100,36%,35%,38%,6,4,2,4,3,1
47,https://vlr.gg/player/12670/nekky,2025-03-11 12:35:00,1.34,0.97,1.15,224,233,220,70,36,34,61,27,34,30,20,10,0,-3,+3,81%,86%,77%,161,164,158,31%,37%,25%,6,2,4,6,5,1
48,https://vlr.gg/player/39351/wezzy,2025-03-11 12:35:00,0.66,1.21,0.94,241,200,264,70,30,40,69,40,29,12,7,5,0,-5,+5,64%,58%,70%,141,123,159,15%,18%,13%,19,7,12,19,12,7
49,https://vlr.gg/player/40595/var,2025-03-11 12:35:00,0.53,1.00,0.76,151,118,193,44,15,29,66,36,30,30,17,13,-3,+1,-4,65%,63%,67%,106,80,132,21%,18%,23%,3,2,1,6,1,5
50,https://vlr.gg/player/40843/audaz,2025-03-11 10:30:00,1.24,1.76,1.46,268,241,304,42,21,21,28,17,11,11,8,3,+2,+1,+1,90%,92%,89%,192,186,200,49%,48%,51%,3,1,2,1,0,1
51,https://vlr.gg/player/52965/oroni,2025-03-11 10:30:00,1.29,1.28,1.28,230,243,215,34,22,12,27,18,9,15,9,6,+3,+2,+1,81%,92%,67%,165,169,160,27%,27%,26%,3,2,1,0,0,0
52,https://vlr.gg/player/39357/s0pp,2025-03-11 10:30:00,1.14,1.18,1.16,246,225,275,38,21,17,30,16,14,12,2,10,+4,+2,+2,83%,79%,89%,158,137,187,31%,37%,25%,12,6,6,8,4,4
53,https://vlr.gg/player/4962/lurzy0y0,2025-03-11 10:30:00,1.04,1.19,1.11,176,187,163,26,16,10,24,15,9,30,17,13,-1,-1,0,88%,88%,89%,103,109,95,34%,38%,28%,3,1,2,4,2,2
54,https://vlr.gg/player/22716/antsy,2025-03-11 10:30:00,1.28,0.78,1.06,193,237,135,28,19,9,24,13,11,17,10,7,0,0,0,69%,71%,67%,137,159,108,32%,30%,36%,4,4,0,4,4,0
55,https://vlr.gg/player/18539/archfiend,2025-03-11 10:30:00,1.15,0.91,1.02,207,208,207,31,14,17,33,13,20,13,5,8,0,0,0,74%,67%,79%,140,136,144,35%,30%,38%,2,1,1,2,1,1
56,https://vlr.gg/player/12673/bard0lf,2025-03-11 10:30:00,0.99,0.86,0.92,205,219,196,28,13,15,34,14,20,15,6,9,-2,-2,0,69%,72%,67%,138,146,132,43%,48%,40%,2,0,2,4,2,2
57,https://vlr.gg/player/10946/shalz,2025-03-11 10:30:00,0.89,0.91,0.90,184,187,183,28,11,17,33,13,20,9,3,6,-3,-1,-2,71%,67%,75%,130,136,126,28%,16%,35%,1,1,0,4,2,2
58,https://vlr.gg/player/21865/merz,2025-03-11 10:30:00,0.55,0.90,0.75,169,149,185,21,8,13,33,14,19,18,8,10,-2,-2,0,67%,61%,71%,121,100,136,16%,12%,18%,2,1,1,4,3,1
59,https://vlr.gg/player/33522/bex,2025-03-11 10:30:00,0.51,0.75,0.64,171,136,198,25,8,17,35,15,20,1,0,1,-1,+1,-2,57%,44%,67%,107,76,130,37%,32%,41%,10,4,6,11,3,8
60,https://vlr.gg/player/45962/ken,2025-03-11 06:00:00,1.28,1.16,1.22,241,263,220,53,30,23,41,21,20,8,3,5,+4,+2,+2,73%,77%,70%,164,175,153,26%,27%,25%,7,3,4,3,1,2
61,https://vlr.gg/player/6702/bazz,2025-03-11 06:00:00,1.18,1.07,1.13,223,222,220,48,25,23,43,19,24,23,10,13,+3,+3,0,78%,77%,80%,141,141,141,33%,35%,31%,8,5,3,5,2,3
62,https://vlr.gg/player/52723/yutaro,2025-03-11 06:00:00,1.15,0.93,1.04,213,228,205,46,24,22,40,17,23,19,11,8,-4,-3,-1,77%,80%,73%,141,148,134,32%,33%,30%,5,2,3,9,5,4
63,https://vlr.gg/player/10642/jan,2025-03-11 06:00:00,1.28,0.73,1.01,160,208,112,37,24,13,35,16,19,16,8,8,-5,+1,-6,73%,80%,67%,111,146,76,31%,38%,20%,3,3,0,8,2,6
64,https://vlr.gg/player/1009/sakurai,2025-03-11 06:00:00,0.44,0.93,0.68,149,85,213,27,7,20,44,21,23,25,11,14,-2,-3,+1,75%,70%,80%,99,58,141,29%,23%,32%,5,2,3,7,5,2
65,https://vlr.gg/player/10769/nobita,2025-03-11 06:00:00,1.11,0.99,1.05,219,215,222,43,23,20,44,20,24,17,9,8,-2,-1,-1,67%,73%,60%,143,143,143,30%,32%,28%,7,4,3,9,5,4
66,https://vlr.gg/player/10628/misaya,2025-03-11 06:00:00,0.80,1.25,1.03,172,132,216,36,13,23,42,21,21,36,21,15,0,+1,-1,85%,87%,83%,112,80,145,18%,19%,17%,1,1,0,1,0,1
67,https://vlr.gg/player/29840/yuran,2025-03-11 06:00:00,1.41,0.63,1.02,197,267,133,42,29,13,41,18,23,13,6,7,+1,0,+1,72%,80%,63%,139,186,92,27%,29%,23%,5,1,4,4,1,3
68,https://vlr.gg/player/48431/kippei,2025-03-11 06:00:00,1.02,0.85,0.94,158,169,158,33,17,16,40,17,23,26,14,12,+1,0,+1,78%,83%,73%,115,114,115,22%,28%,17%,3,2,1,2,2,0
69,https://vlr.gg/player/40726/gwangboong,2025-03-11 06:00:00,0.99,0.85,0.92,228,258,201,49,27,22,48,25,23,9,8,1,+4,+4,0,73%,87%,60%,144,157,132,26%,33%,20%,16,9,7,12,5,7
70,https://vlr.gg/player/687/zepher,2025-03-11 03:00:00,1.13,1.14,1.13,234,264,201,51,32,19,43,27,16,10,5,5,-2,-5,+3,66%,62%,71%,156,169,138,20%,19%,22%,9,5,4,11,10,1
71,https://vlr.gg/player/6700/anthem,2025-03-11 03:00:00,0.93,1.32,1.09,201,202,234,44,24,20,41,26,15,21,13,8,+6,+3,+3,78%,74%,83%,138,132,146,21%,21%,20%,7,3,4,1,0,1
72,https://vlr.gg/player/993/medusa,2025-03-11 03:00:00,0.77,0.98,0.86,201,174,241,40,21,19,48,27,21,16,7,9,+2,+1,+1,67%,65%,71%,130,109,160,36%,38%,34%,7,4,3,5,3,2
73,https://vlr.gg/player/7745/yoshiii,2025-03-11 03:00:00,0.82,0.83,0.83,169,178,155,34,21,13,43,26,17,16,9,7,+4,+6,-2,71%,76%,63%,100,102,98,31%,32%,29%,6,6,0,2,0,2
74,https://vlr.gg/player/4477/lob,2025-03-11 03:00:00,0.90,0.66,0.79,146,174,129,32,21,11,44,27,17,23,14,9,-8,-3,-5,69%,76%,58%,108,123,85,27%,26%,30%,1,0,1,9,3,6
75,https://vlr.gg/player/29840/yuran,2025-03-11 03:00:00,1.28,1.18,1.22,229,271,200,47,22,25,37,17,20,22,11,11,-1,0,-1,72%,71%,74%,156,186,135,24%,24%,23%,4,2,2,5,2,3
76,https://vlr.gg/player/10628/misaya,2025-03-11 03:00:00,1.16,1.22,1.19,222,219,216,44,18,26,39,16,23,39,12,27,+5,+3,+2,83%,79%,85%,128,128,129,18%,10%,24%,8,4,4,3,1,2
77,https://vlr.gg/player/40726/gwangboong,2025-03-11 03:00:00,0.98,1.26,1.14,292,224,286,52,17,35,41,17,24,10,5,5,-2,+1,-3,74%,79%,71%,162,149,172,20%,22%,19%,10,4,6,12,3,9
78,https://vlr.gg/player/10769/nobita,2025-03-11 03:00:00,0.83,1.00,0.93,179,164,211,40,16,24,42,17,25,15,4,11,-1,-1,0,71%,71%,71%,124,110,134,31%,44%,26%,3,1,2,4,2,2
79,https://vlr.gg/player/48431/kippei,2025-03-11 03:00:00,0.92,0.91,0.91,181,155,194,36,13,23,42,15,27,22,8,14,-3,-3,0,71%,71%,71%,111,100,119,19%,20%,19%,3,1,2,6,4,2
80,https://vlr.gg/player/4828/nismo,2025-03-10 19:35:00,1.21,1.33,1.27,214,166,254,55,22,33,43,18,25,32,19,13,+3,+2,+1,75%,76%,74%,141,114,164,33%,40%,29%,8,3,5,5,1,4
81,https://vlr.gg/player/11118/skuba,2025-03-10 19:35:00,1.21,0.93,1.06,195,195,190,50,25,25,48,20,28,25,12,13,+1,+1,0,73%,76%,69%,129,137,122,37%,50%,28%,6,3,3,5,2,3
82,https://vlr.gg/player/41798/nightz,2025-03-10 19:35:00,1.10,1.02,1.05,226,235,225,58,27,31,53,25,28,21,12,9,+4,+3,+1,74%,74%,74%,152,163,142,40%,37%,42%,9,4,5,5,1,4
83,https://vlr.gg/player/8419/reduxx,2025-03-10 19:35:00,1.07,0.92,0.99,220,260,191,57,30,27,57,29,28,15,10,5,+2,+2,0,73%,76%,69%,145,167,127,24%,31%,17%,14,9,5,12,7,5
84,https://vlr.gg/player/3007/tdawgg,2025-03-10 19:35:00,0.81,0.81,0.81,150,145,156,40,18,22,52,24,28,30,17,13,+1,0,+1,79%,79%,79%,98,90,105,28%,20%,37%,5,2,3,4,2,2
85,https://vlr.gg/player/6437/dark3st,2025-03-10 19:35:00,1.22,0.98,1.11,205,190,220,54,28,26,48,21,27,27,19,8,-4,-3,-1,68%,74%,62%,125,114,138,31%,24%,37%,7,3,4,11,6,5
86,https://vlr.gg/player/29893/timotino,2025-03-10 19:35:00,1.09,1.10,1.09,246,248,245,65,36,29,55,29,26,8,4,4,-1,0,-1,68%,67%,71%,154,148,161,38%,38%,37%,9,7,2,10,7,3
87,https://vlr.gg/player/5093/logan,2025-03-10 19:35:00,0.82,1.03,0.92,186,185,183,42,23,19,51,29,22,27,11,16,+1,-2,+3,73%,72%,74%,129,129,130,29%,26%,33%,5,1,4,4,3,1
88,https://vlr.gg/player/754/nerve,2025-03-10 19:35:00,0.93,0.82,0.88,174,186,168,46,26,20,52,28,24,36,18,18,-4,0,-4,75%,74%,76%,114,122,105,32%,33%,30%,2,2,0,6,2,4
89,https://vlr.gg/player/21878/snarly,2025-03-10 19:35:00,0.69,0.93,0.80,183,166,188,46,24,22,55,31,24,12,5,7,-3,+2,-5,64%,59%,71%,116,109,125,33%,32%,34%,8,5,3,11,3,8
90,https://vlr.gg/player/19715/hinataa,2025-03-10 17:20:00,1.11,0.86,1.00,196,229,153,43,28,15,44,24,20,14,9,5,+4,+2,+2,75%,76%,74%,119,138,94,27%,27%,28%,7,5,2,3,3,0
91,https://vlr.gg/player/25356/reshi,2025-03-10 17:20:00,1.15,0.77,0.99,228,234,215,48,28,20,45,23,22,14,7,7,-1,0,-1,70%,71%,70%,142,149,134,30%,32%,28%,6,3,3,7,3,4
92,https://vlr.gg/player/35906/patitop,2025-03-10 17:20:00,0.92,0.87,0.90,176,187,170,39,22,17,46,26,20,13,8,5,0,+1,-1,64%,62%,67%,117,123,110,48%,43%,55%,5,2,3,5,1,4
93,https://vlr.gg/player/43958/yuna,2025-03-10 17:20:00,0.87,0.80,0.84,218,202,246,46,27,19,52,28,24,7,3,4,-1,-4,+3,66%,68%,63%,157,158,155,32%,42%,21%,11,5,6,12,9,3
94,https://vlr.gg/player/44620/mar,2025-03-10 17:20:00,0.46,0.61,0.53,131,113,155,26,12,14,51,29,22,14,11,3,-5,-3,-2,64%,65%,63%,87,82,94,25%,21%,28%,0,0,0,5,3,2
95,https://vlr.gg/player/35859/hotvru,2025-03-10 17:20:00,1.09,1.46,1.31,222,144,275,17,5,12,10,3,7,8,5,3,-1,0,-1,85%,75%,92%,148,92,186,19%,7%,24%,0,0,0,1,0,1
96,https://vlr.gg/player/40493/setrexz,2025-03-10 17:20:00,0.97,1.36,1.19,258,227,284,58,22,36,45,20,25,12,7,5,+2,-3,+5,75%,74%,76%,166,149,179,30%,40%,24%,16,5,11,14,8,6
97,https://vlr.gg/player/35869/meleliita,2025-03-10 17:20:00,1.27,1.09,1.17,240,241,233,50,23,27,44,19,25,20,10,10,+2,-1,+3,74%,74%,74%,161,175,151,38%,36%,39%,8,3,5,6,4,2
98,https://vlr.gg/player/51239/thommy,2025-03-10 17:20:00,1.27,1.01,1.12,197,246,157,45,25,20,35,16,19,9,1,8,0,+2,-2,79%,81%,76%,125,140,113,29%,32%,25%,3,3,0,3,1,2
99,https://vlr.gg/player/21571/awus,2025-03-10 17:20:00,1.23,0.89,1.04,202,203,211,44,19,25,41,15,26,20,10,10,0,0,0,75%,78%,74%,131,129,132,20%,25%,18%,3,1,2,3,1,2
100,https://vlr.gg/player/21008/mcfly,2025-03-10 17:20:00,1.05,0.68,0.85,155,177,130,24,14,10,27,12,15,5,2,3,0,+1,-1,68%,63%,73%,97,109,87,26%,33%,19%,2,1,1,2,0,2
101,https://vlr.gg/player/29547/ion2x,2025-03-10 16:00:00,1.48,0.91,1.20,198,243,154,51,35,16,38,17,21,34,17,17,-4,-3,-1,84%,86%,81%,140,164,115,26%,27%,25%,0,0,0,4,3,1
102,https://vlr.gg/player/53/inspire,2025-03-10 16:00:00,1.05,1.22,1.13,220,193,244,56,26,30,42,20,22,16,10,6,+4,+1,+3,78%,84%,72%,138,126,151,30%,26%,35%,9,4,5,5,3,2
103,https://vlr.gg/player/36560/canezerra,2025-03-10 16:00:00,0.82,1.09,0.95,224,210,233,55,26,29,56,29,27,13,6,7,+3,0,+3,68%,65%,72%,142,127,159,28%,25%,33%,17,8,9,14,8,6
104,https://vlr.gg/player/21778/p0ppin,2025-03-10 16:00:00,1.22,0.66,0.94,154,185,124,42,24,18,43,17,26,18,16,2,-3,0,-3,74%,84%,64%,100,126,74,19%,22%,16%,2,1,1,5,1,4
105,https://vlr.gg/player/35302/eggsterr,2025-03-10 16:00:00,1.06,0.67,0.86,159,188,136,41,25,16,48,22,26,17,9,8,-2,0,-2,73%,81%,64%,99,107,91,30%,37%,23%,7,4,3,9,4,5
106,https://vlr.gg/player/34400/bao,2025-03-10 16:00:00,1.23,0.98,1.10,196,215,177,48,25,23,45,22,23,17,10,7,-3,-1,-2,73%,72%,73%,132,149,116,25%,25%,25%,4,2,2,7,3,4
107,https://vlr.gg/player/8373/okeanos,2025-03-10 16:00:00,1.12,0.86,0.99,184,214,159,49,31,18,49,22,27,13,3,10,0,-2,+2,68%,69%,68%,119,126,112,26%,29%,23%,8,4,4,8,6,2
108,https://vlr.gg/player/30470/kyu,2025-03-10 16:00:00,1.02,0.80,0.91,173,173,172,45,21,24,53,21,32,18,13,5,+1,-1,+2,68%,67%,70%,110,108,112,21%,21%,21%,5,1,4,4,2,2
109,https://vlr.gg/player/844/bdog,2025-03-10 16:00:00,1.00,0.82,0.90,161,155,169,41,19,22,49,20,29,22,12,10,0,+1,-1,66%,67%,65%,105,99,110,20%,26%,16%,6,3,3,6,2,4
110,https://vlr.gg/player/21659/sato,2025-03-10 16:00:00,0.93,0.62,0.77,166,192,143,44,26,18,55,24,31,12,7,5,+4,+3,+1,68%,69%,68%,108,131,87,26%,26%,25%,14,8,6,10,5,5
111,https://vlr.gg/player/17343/ness,2025-03-10 15:05:00,0.67,1.02,0.90,192,180,200,22,7,15,30,11,19,18,4,14,0,0,0,73%,62%,79%,124,98,138,32%,28%,34%,1,1,0,1,1,0
112,https://vlr.gg/player/19371/eva,2025-03-10 15:05:00,0.71,1.01,0.90,177,129,203,22,6,16,28,10,18,12,4,8,-5,-1,-4,70%,62%,75%,112,73,133,32%,15%,41%,0,0,0,5,1,4
113,https://vlr.gg/player/24107/sarah,2025-03-10 15:05:00,0.71,0.80,0.77,151,128,164,21,6,15,28,10,18,0,0,0,-2,-2,0,57%,54%,58%,101,87,109,40%,70%,31%,1,0,1,3,2,1
114,https://vlr.gg/player/16418/smurfette,2025-03-10 15:05:00,0.28,0.96,0.71,180,89,229,21,3,18,31,11,20,5,2,3,-4,-5,+1,59%,54%,63%,121,69,149,32%,33%,32%,8,1,7,12,6,6
115,https://vlr.gg/player/30186/nami,2025-03-10 15:05:00,0.60,0.40,0.47,121,148,108,16,7,9,31,11,20,5,2,3,0,+1,-1,59%,69%,54%,75,92,66,36%,26%,45%,3,1,2,3,0,3
116,https://vlr.gg/player/27796/yanido,2025-03-10 15:05:00,1.57,1.65,1.60,278,265,309,39,25,14,21,15,6,17,13,4,+3,+1,+2,86%,83%,92%,182,176,192,33%,40%,23%,5,3,2,2,2,0
117,https://vlr.gg/player/41076/heizzy,2025-03-10 15:05:00,1.58,1.51,1.55,270,299,216,36,25,11,19,13,6,13,10,3,+4,+2,+2,84%,83%,85%,177,196,141,32%,30%,39%,6,4,2,2,2,0
118,https://vlr.gg/player/37694/ayokz,2025-03-10 15:05:00,0.80,1.86,1.17,192,139,286,26,12,14,19,15,4,22,12,10,+3,+2,+1,86%,88%,85%,115,82,175,18%,13%,23%,4,2,2,1,0,1
119,https://vlr.gg/player/51676/prayy,2025-03-10 15:05:00,1.21,1.03,1.15,224,270,136,27,21,6,22,16,6,8,6,2,+4,+2,+2,78%,79%,77%,161,193,102,34%,30%,54%,8,5,3,4,3,1
120,https://vlr.gg/player/27951/rxchyy,2025-03-10 15:05:00,0.75,0.93,0.81,149,144,160,20,12,8,21,14,7,9,4,5,-3,-3,0,70%,71%,69%,110,105,120,21%,20%,23%,1,0,1,4,3,1
121,https://vlr.gg/player/20993/luzgardy,2025-03-10 15:00:00,1.20,1.44,1.36,256,261,259,34,12,22,24,12,12,24,7,17,-2,0,-2,92%,93%,92%,158,167,153,24%,35%,19%,3,1,2,5,1,4
122,https://vlr.gg/player/51179/venus,2025-03-10 15:00:00,0.99,1.55,1.34,279,206,319,39,10,29,24,10,14,11,5,6,-2,-2,0,82%,71%,88%,199,141,232,27%,21%,30%,4,1,3,6,3,3
123,https://vlr.gg/player/45742/lupe,2025-03-10 15:00:00,1.09,1.25,1.19,203,222,189,27,11,16,18,9,9,15,7,8,-2,-3,+1,87%,79%,92%,133,141,129,18%,16%,20%,1,0,1,3,3,0
124,https://vlr.gg/player/44515/vazaga,2025-03-10 15:00:00,1.24,1.02,1.10,179,187,179,25,10,15,20,7,13,14,4,10,0,0,0,79%,93%,71%,117,116,117,28%,23%,31%,1,0,1,1,0,1
125,https://vlr.gg/player/35858/flowih,2025-03-10 15:00:00,0.98,0.95,0.96,205,196,198,30,12,18,25,10,15,6,2,4,-4,-1,-3,68%,64%,71%,126,129,125,25%,22%,28%,5,2,3,9,3,6
126,https://vlr.gg/player/40657/ataraxia,2025-03-10 15:00:00,0.84,1.65,1.14,239,184,354,33,15,18,29,19,10,3,2,1,+7,+2,+5,68%,54%,93%,158,123,218,41%,35%,46%,9,4,5,2,2,0
127,https://vlr.gg/player/51173/miku,2025-03-10 15:00:00,1.07,0.89,1.00,234,242,228,31,19,12,33,20,13,5,3,2,+4,+2,+2,61%,58%,64%,157,164,144,38%,38%,36%,8,5,3,4,3,1
128,https://vlr.gg/player/44534/mawyk,2025-03-10 15:00:00,1.00,0.74,0.91,161,176,125,21,15,6,28,18,10,13,8,5,+3,+3,0,61%,58%,64%,97,102,89,30%,24%,47%,3,3,0,0,0,0
129,https://vlr.gg/player/44516/gbc,2025-03-10 15:00:00,0.48,0.81,0.60,123,102,173,16,7,9,33,22,11,7,5,2,-1,-1,0,53%,46%,64%,94,72,132,24%,23%,25%,2,1,1,3,2,1
130,https://vlr.gg/player/21560/valu,2025-03-10 15:00:00,0.40,0.31,0.36,96,97,86,10,7,3,32,21,11,8,3,5,-3,-2,-1,42%,42%,43%,67,71,60,24%,23%,25%,2,1,1,5,3,2
131,https://vlr.gg/player/7267/nex,2025-03-10 13:00:00,1.11,1.57,1.37,295,282,307,47,19,28,29,15,14,4,3,1,+5,+2,+3,79%,78%,79%,175,171,178,23%,34%,15%,8,5,3,3,3,0
132,https://vlr.gg/player/9540/rxyal,2025-03-10 13:00:00,1.45,1.27,1.35,267,249,281,41,18,23,26,10,16,13,5,8,+3,+1,+2,74%,67%,79%,167,156,175,23%,22%,23%,7,2,5,4,1,3
133,https://vlr.gg/player/8831/noumit,2025-03-10 13:00:00,1.52,1.04,1.24,192,265,149,29,17,12,23,12,11,14,5,9,-2,-3,+1,83%,83%,83%,131,179,96,25%,40%,11%,2,0,2,4,3,1
134,https://vlr.gg/player/23352/kixer,2025-03-10 13:00:00,0.61,1.41,1.07,169,105,213,25,6,19,24,13,11,25,12,13,+2,-2,+4,74%,67%,79%,112,74,140,22%,18%,24%,5,0,5,3,2,1
135,https://vlr.gg/player/33398/miyamura,2025-03-10 13:00:00,0.78,1.07,0.95,159,121,174,19,5,14,22,10,12,15,6,9,-4,0,-4,74%,67%,79%,116,98,129,23%,29%,19%,1,1,0,5,1,4
136,https://vlr.gg/player/23110/hoda,2025-03-10 13:00:00,0.87,1.42,1.11,201,159,276,33,14,19,28,17,11,5,2,3,-1,0,-1,64%,67%,61%,138,113,171,23%,19%,27%,2,0,2,3,0,3
137,https://vlr.gg/player/52960/ryphian,2025-03-10 13:00:00,0.81,1.21,0.98,259,235,283,33,17,16,36,22,14,12,7,5,+4,0,+4,67%,58%,78%,160,146,179,31%,28%,38%,16,8,8,12,8,4
138,https://vlr.gg/player/52961/selfk,2025-03-10 13:00:00,0.87,0.91,0.89,154,156,155,23,13,10,30,18,12,23,13,10,-2,-2,0,76%,79%,72%,92,99,83,20%,14%,31%,0,0,0,2,2,0
139,https://vlr.gg/player/52962/void,2025-03-10 13:00:00,0.77,0.71,0.75,161,146,182,21,10,11,32,18,14,15,12,3,-3,-3,0,76%,79%,72%,116,99,138,26%,26%,25%,0,0,0,3,3,0
140,https://vlr.gg/player/52959/gusel,2025-03-10 13:00:00,0.49,0.54,0.51,115,124,97,14,10,4,35,21,14,18,7,11,-2,-1,-1,69%,63%,78%,68,71,65,16%,16%,15%,1,1,0,3,2,1
141,https://vlr.gg/player/3626/lightningfast,2025-03-10 08:30:00,1.95,1.15,1.57,328,431,208,38,27,11,20,11,9,10,5,5,+5,+5,0,91%,100%,80%,198,251,138,34%,36%,29%,6,5,1,1,0,1
142,https://vlr.gg/player/4095/skrossi,2025-03-10 08:30:00,1.46,1.30,1.39,236,234,240,28,16,12,15,6,9,8,2,6,+2,0,+2,78%,76%,80%,162,156,167,36%,30%,41%,3,1,2,1,1,0
143,https://vlr.gg/player/1162/russ,2025-03-10 08:30:00,1.22,1.56,1.38,221,177,273,24,10,14,17,8,9,26,15,11,-1,-1,0,78%,76%,80%,158,142,176,36%,40%,33%,2,0,2,3,1,2
144,https://vlr.gg/player/26829/damaraa,2025-03-10 08:30:00,0.79,1.12,0.95,241,224,255,31,14,17,24,13,11,4,3,1,+3,+1,+2,81%,82%,80%,145,134,157,18%,14%,25%,7,4,3,4,3,1
145,https://vlr.gg/player/9290/madelyn,2025-03-10 08:30:00,0.69,0.98,0.83,157,129,194,17,6,11,18,9,9,12,8,4,+1,-2,+3,78%,71%,87%,94,75,116,10%,10%,10%,3,0,3,2,2,0
146,https://vlr.gg/player/19231/kibojn,2025-03-10 08:30:00,1.19,0.93,1.05,210,264,159,20,12,8,26,12,14,14,6,8,-1,-1,0,69%,73%,65%,132,151,115,27%,30%,24%,0,0,0,1,1,0
147,https://vlr.gg/player/30575/r1sen,2025-03-10 08:30:00,0.75,0.99,0.88,172,135,205,19,8,11,28,13,15,13,4,9,-4,-2,-2,69%,73%,65%,118,93,140,35%,35%,35%,3,0,3,7,2,5
148,https://vlr.gg/player/10760/smokea,2025-03-10 08:30:00,0.81,0.80,0.81,206,215,202,23,12,11,28,13,15,4,0,4,-2,-1,-1,66%,67%,65%,152,160,145,29%,41%,23%,0,0,0,2,1,1
149,https://vlr.gg/player/30877/lilboii,2025-03-10 08:30:00,0.89,0.57,0.72,144,184,110,15,9,6,25,13,12,8,5,3,-1,+2,-3,72%,73%,71%,87,113,65,25%,37%,12%,2,2,0,3,0,3
150,https://vlr.gg/player/46104/envy2k,2025-03-10 08:30:00,0.31,0.75,0.54,172,124,216,17,6,11,31,14,17,7,4,3,-2,-5,+3,75%,73%,76%,113,78,144,18%,7%,26%,6,2,4,8,7,1
151,https://vlr.gg/player/45962/ken,2025-03-10 06:00:00,1.31,0.63,0.96,228,316,144,27,19,8,28,15,13,8,5,3,+1,+2,-1,71%,76%,67%,152,204,103,31%,35%,24%,6,4,2,5,2,3
152,https://vlr.gg/player/10642/jan,2025-03-10 06:00:00,0.72,1.00,0.86,169,129,207,21,7,14,27,13,14,4,2,2,-6,-3,-3,49%,35%,61%,117,92,140,23%,15%,28%,1,0,1,7,3,4
153,https://vlr.gg/player/52723/yutaro,2025-03-10 06:00:00,0.56,0.77,0.67,153,153,155,17,8,9,29,15,14,4,3,1,-2,-1,-1,54%,47%,61%,109,109,110,22%,22%,22%,1,1,0,3,2,1
154,https://vlr.gg/player/6702/bazz,2025-03-10 06:00:00,0.66,0.46,0.56,140,157,127,14,8,6,32,15,17,14,7,7,-1,0,-1,49%,53%,44%,97,102,93,37%,36%,38%,4,2,2,5,2,3
155,https://vlr.gg/player/1009/sakurai,2025-03-10 06:00:00,0.35,0.73,0.48,114,55,170,15,3,12,30,14,16,4,0,4,-3,-1,-2,40%,24%,56%,79,30,125,42%,11%,54%,0,0,0,3,1,2
156,https://vlr.gg/player/34776/absol,2025-03-10 06:00:00,1.69,1.74,1.72,349,353,347,43,22,21,19,11,8,10,7,3,+12,+7,+5,83%,83%,82%,220,240,199,18%,21%,14%,14,8,6,2,1,1
157,https://vlr.gg/player/686/tonbo,2025-03-10 06:00:00,1.62,1.12,1.38,207,225,186,29,16,13,15,6,9,15,9,6,+1,+1,0,77%,89%,65%,125,140,109,23%,21%,27%,3,1,2,2,0,2
158,https://vlr.gg/player/23971/ask,2025-03-10 06:00:00,1.08,1.68,1.37,233,179,289,30,12,18,16,9,7,10,5,5,0,+1,-1,80%,78%,82%,148,109,189,31%,18%,44%,2,2,0,2,1,1
159,https://vlr.gg/player/1395/tennn,2025-03-10 06:00:00,1.04,1.12,1.08,215,187,246,25,12,13,25,12,13,21,10,11,-1,-1,0,74%,72%,76%,147,132,163,25%,38%,18%,3,1,2,4,2,2
160,https://vlr.gg/player/1003/reita,2025-03-10 06:00:00,0.88,0.75,0.82,147,182,110,19,12,7,19,11,8,5,3,2,-1,0,-1,71%,72%,71%,104,128,80,18%,15%,25%,1,1,0,2,1,1
161,https://vlr.gg/player/27775/techno,2025-03-10 05:30:00,0.44,1.53,0.89,193,143,271,23,8,15,32,22,10,19,6,13,+2,0,+2,68%,50%,94%,134,106,173,21%,14%,30%,3,1,2,1,1,0
162,https://vlr.gg/player/3627/hellff,2025-03-10 05:30:00,0.73,1.02,0.85,162,133,217,24,11,13,32,20,12,10,3,7,-2,0,-2,63%,58%,71%,122,96,157,27%,26%,28%,0,0,0,2,0,2
163,https://vlr.gg/player/10749/k1ngkappa,2025-03-10 05:30:00,0.78,0.93,0.84,198,185,217,29,15,14,35,22,13,4,1,3,-2,-2,0,59%,58%,59%,122,114,134,52%,54%,50%,3,1,2,5,3,2
164,https://vlr.gg/player/36687/miz,2025-03-10 05:30:00,0.60,0.77,0.67,214,203,217,29,17,12,37,22,15,6,1,5,-7,-7,0,59%,63%,53%,124,117,134,25%,25%,25%,8,4,4,15,11,4
165,https://vlr.gg/player/43390/d1sease,2025-03-10 05:30:00,0.66,0.60,0.64,122,125,120,17,10,7,31,19,12,15,7,8,-4,-3,-1,51%,42%,65%,74,83,62,28%,35%,18%,0,0,0,4,3,1
166,https://vlr.gg/player/13221/azys,2025-03-10 05:30:00,1.44,2.05,1.80,365,334,378,54,19,35,24,14,10,5,1,4,+7,+1,+6,78%,65%,88%,230,213,242,31%,25%,36%,13,6,7,6,5,1
167,https://vlr.gg/player/3269/antidote,2025-03-10 05:30:00,1.29,1.34,1.32,260,275,262,39,18,21,27,12,15,23,7,16,+4,0,+4,83%,65%,96%,170,160,177,27%,27%,27%,6,1,5,2,1,1
168,https://vlr.gg/player/12947/rawfiul,2025-03-10 05:30:00,0.81,1.29,1.09,200,185,210,29,10,19,23,12,11,8,2,6,+2,+2,0,73%,65%,79%,120,115,124,24%,15%,32%,4,2,2,2,0,2
169,https://vlr.gg/player/3628/deathmaker,2025-03-10 05:30:00,1.07,0.91,0.98,149,155,139,23,11,12,22,10,12,4,1,3,-1,-1,0,78%,65%,88%,104,112,98,30%,31%,29%,2,0,2,3,1,2
170,https://vlr.gg/player/9745/georggyyy,2025-03-10 05:30:00,0.45,1.08,0.81,148,73,204,22,4,18,26,13,13,22,8,14,+1,-1,+2,73%,59%,83%,98,63,122,24%,20%,26%,2,0,2,1,1,0
171,https://vlr.gg/player/10769/nobita,2025-03-10 03:00:00,1.05,1.35,1.18,212,205,222,32,17,15,25,17,8,8,4,4,-2,-1,-1,71%,71%,72%,144,136,154,33%,28%,41%,2,1,1,4,2,2
172,https://vlr.gg/player/40726/gwangboong,2025-03-10 03:00:00,0.75,1.72,1.16,256,201,330,37,17,20,32,21,11,8,2,6,+2,-2,+4,69%,54%,89%,157,133,188,26%,33%,20%,9,5,4,7,7,0
173,https://vlr.gg/player/48431/kippei,2025-03-10 03:00:00,1.23,0.93,1.10,192,230,142,28,19,9,26,17,9,20,14,6,-3,-2,-1,76%,75%,78%,119,144,86,31%,36%,25%,1,1,0,4,3,1
174,https://vlr.gg/player/10628/misaya,2025-03-10 03:00:00,1.06,1.16,1.10,206,193,225,30,17,13,30,17,13,23,10,13,+1,0,+1,79%,79%,78%,130,126,135,21%,25%,16%,4,1,3,3,1,2
175,https://vlr.gg/player/29840/yuran,2025-03-10 03:00:00,1.04,1.05,1.04,180,177,185,28,15,13,27,15,12,9,6,3,0,+1,-1,69%,71%,67%,121,122,119,30%,28%,33%,4,2,2,4,1,3
176,https://vlr.gg/player/2671/popogachi,2025-03-10 03:00:00,0.89,1.08,1.00,231,219,241,33,14,19,33,15,18,17,6,11,+1,0,+1,81%,72%,88%,151,140,159,23%,29%,19%,4,2,2,3,2,1
177,https://vlr.gg/player/47481/frxeez,2025-03-10 03:00:00,0.49,1.26,0.93,210,143,261,30,9,21,32,15,17,8,2,6,-6,-5,-1,71%,56%,83%,132,86,168,24%,35%,20%,7,2,5,13,7,6
178,https://vlr.gg/player/12980/ria,2025-03-10 03:00:00,0.71,0.97,0.86,183,150,208,29,9,20,30,12,18,7,1,6,+1,+1,0,69%,56%,79%,125,103,142,24%,16%,29%,2,1,1,1,0,1
179,https://vlr.gg/player/44613/yamada,2025-03-10 03:00:00,0.82,0.86,0.85,170,179,163,26,12,14,30,14,16,10,3,7,+4,+2,+2,67%,56%,75%,109,116,104,24%,31%,18%,5,2,3,1,0,1
180,https://vlr.gg/player/1971/oitan,2025-03-10 03:00:00,0.80,0.86,0.84,163,166,162,22,9,13,30,14,16,25,9,16,+2,0,+2,67%,61%,71%,101,108,96,21%,18%,25%,4,1,3,2,1,1
181,https://vlr.gg/player/993/medusa,2025-03-10 00:00:00,1.24,1.27,1.25,218,205,206,50,26,24,35,20,15,9,6,3,+1,+2,-1,77%,74%,82%,149,151,147,38%,37%,39%,6,5,1,5,3,2
182,https://vlr.gg/player/687/zepher,2025-03-10 00:00:00,1.08,1.43,1.24,285,256,316,60,30,30,45,25,20,19,8,11,+10,+1,+9,76%,68%,86%,191,175,210,25%,18%,34%,21,8,13,11,7,4
183,https://vlr.gg/player/6700/anthem,2025-03-10 00:00:00,1.31,1.09,1.21,191,208,180,44,26,18,35,18,17,25,12,13,+2,+3,-1,79%,85%,71%,132,132,131,26%,27%,24%,3,3,0,1,0,1
184,https://vlr.gg/player/4477/lob,2025-03-10 00:00:00,1.17,0.96,1.08,164,177,149,37,24,13,36,19,17,39,19,20,+2,+1,+1,79%,82%,75%,103,110,94,35%,37%,32%,4,2,2,2,1,1
185,https://vlr.gg/player/7745/yoshiii,2025-03-10 00:00:00,0.89,0.81,0.85,188,195,161,37,22,15,46,26,20,16,5,11,-1,+1,-2,61%,59%,64%,124,133,113,36%,38%,34%,4,3,1,5,2,3
186,https://vlr.gg/player/17111/allen,2025-03-10 00:00:00,1.28,0.86,1.05,211,234,199,42,21,21,45,18,27,27,14,13,-2,+1,-3,73%,75%,71%,134,142,127,23%,28%,20%,4,3,1,6,2,4
187,https://vlr.gg/player/47482/flora,2025-03-10 00:00:00,0.89,1.01,0.96,213,200,226,46,19,27,46,20,26,8,2,6,-7,-2,-5,66%,64%,68%,143,136,150,33%,32%,33%,3,1,2,10,3,7
188,https://vlr.gg/player/40734/hands,2025-03-10 00:00:00,0.66,1.01,0.86,178,149,219,41,13,28,48,23,25,10,4,6,-3,-1,-2,66%,57%,74%,126,109,139,30%,26%,33%,3,2,1,6,3,3
189,https://vlr.gg/player/5255/neal-x,2025-03-10 00:00:00,0.94,0.76,0.82,177,213,170,39,20,19,46,21,25,13,4,9,-4,-5,+1,65%,68%,62%,131,146,118,21%,23%,18%,8,3,5,12,8,4
190,https://vlr.gg/player/25279/sakura,2025-03-10 00:00:00,0.94,0.65,0.78,143,167,118,29,16,13,43,18,25,19,10,9,+2,+1,+1,66%,71%,62%,84,94,76,32%,33%,31%,6,2,4,4,1,3
191,https://vlr.gg/player/8034/thenightche,2025-03-09 18:00:00,1.25,1.15,1.20,202,198,207,45,24,21,37,21,16,36,19,17,+1,0,+1,79%,82%,76%,122,126,117,31%,33%,29%,4,1,3,3,1,2
192,https://vlr.gg/player/15188/a1mly,2025-03-09 18:00:00,1.09,1.16,1.12,221,213,232,50,26,24,40,23,17,11,7,4,-3,-1,-2,74%,70%,79%,150,140,162,47%,51%,43%,5,3,2,8,4,4
193,https://vlr.gg/player/24424/pa1ze,2025-03-09 18:00:00,1.05,1.10,1.07,267,265,269,56,30,26,47,27,20,11,3,8,0,-1,+1,77%,73%,83%,165,161,170,26%,33%,20%,13,8,5,13,9,4
194,https://vlr.gg/player/1617/alvar,2025-03-09 18:00:00,0.63,1.47,1.02,158,124,198,37,15,22,39,26,13,28,12,16,0,-1,+1,76%,76%,76%,112,90,138,31%,33%,30%,3,1,2,3,2,1
195,https://vlr.gg/player/12331/zmart,2025-03-09 18:00:00,0.77,1.10,0.93,181,153,215,40,15,25,45,25,20,26,13,13,+3,+2,+1,82%,82%,83%,117,108,127,26%,27%,25%,6,3,3,3,1,2
196,https://vlr.gg/player/48951/hassan,2025-03-09 18:00:00,0.60,1.42,1.04,235,165,299,51,16,35,47,25,22,10,5,5,+1,-2,+3,79%,69%,88%,162,109,209,26%,24%,28%,8,2,6,7,4,3
197,https://vlr.gg/player/21305/chwepes,2025-03-09 18:00:00,0.99,1.08,1.04,209,191,226,48,21,27,47,22,25,23,9,14,+3,+2,+1,71%,76%,67%,126,118,134,23%,20%,24%,9,5,4,6,3,3
198,https://vlr.gg/player/10458/phaze,2025-03-09 18:00:00,0.81,0.99,0.91,153,183,130,36,17,19,41,24,17,23,11,12,-4,-1,-3,73%,66%,79%,98,115,84,28%,31%,26%,1,1,0,5,2,3
199,https://vlr.gg/player/30492/electus,2025-03-09 18:00:00,0.79,0.99,0.90,187,186,188,40,19,21,45,25,20,12,3,9,+3,+1,+2,76%,72%,79%,122,120,124,34%,33%,35%,6,4,2,3,3,0
200,https://vlr.gg/player/1267/zodiac,2025-03-09 18:00:00,0.67,0.71,0.69,161,135,184,33,13,20,48,22,26,14,4,10,-4,-2,-2,68%,69%,67%,108,91,123,41%,39%,43%,6,1,5,10,3,7
201,https://vlr.gg/player/16447/d3mur,2025-03-09 15:00:00,1.01,1.01,1.01,213,220,207,38,19,19,38,20,18,15,7,8,0,-3,+3,64%,59%,69%,140,142,138,20%,14%,33%,12,6,6,12,9,3
202,https://vlr.gg/player/30479/terra,2025-03-09 15:00:00,1.01,0.96,0.99,172,173,178,34,17,17,37,17,20,25,10,15,+1,+2,-1,70%,70%,69%,113,108,119,38%,33%,43%,2,2,0,1,0,1
203,https://vlr.gg/player/6069/kheops,2025-03-09 15:00:00,0.60,1.10,0.85,156,113,201,29,12,17,38,20,18,18,7,11,-3,-1,-2,74%,70%,77%,100,70,132,27%,42%,21%,0,0,0,3,1,2
204,https://vlr.gg/player/11013/balli,2025-03-09 15:00:00,0.92,0.76,0.84,154,157,155,29,16,13,36,17,19,10,3,7,-1,-3,+2,66%,63%,69%,106,104,107,25%,23%,27%,5,1,4,6,4,2
205,https://vlr.gg/player/40668/enzo,2025-03-09 15:00:00,0.87,0.82,0.84,208,206,215,38,20,18,40,19,21,8,4,4,-4,-2,-2,66%,67%,65%,137,134,139,31%,31%,30%,4,1,3,8,3,5
206,https://vlr.gg/player/20688/yassien,2025-03-09 15:00:00,1.30,1.50,1.40,257,211,292,50,23,27,29,13,16,11,1,10,+4,+1,+3,81%,77%,85%,160,123,195,26%,29%,24%,7,3,4,3,2,1
207,https://vlr.gg/player/5642/chrollo,2025-03-09 15:00:00,1.25,1.09,1.17,201,240,183,41,24,17,34,18,16,21,10,11,-2,-2,0,77%,77%,78%,135,150,120,23%,26%,19%,4,1,3,6,3,3
208,https://vlr.gg/player/8237/depyro,2025-03-09 15:00:00,0.88,1.29,1.09,199,160,234,33,12,21,35,17,18,31,14,17,+3,-1,+4,79%,77%,81%,127,114,139,16%,18%,15%,5,0,5,2,1,1
209,https://vlr.gg/player/5639/shalaby,2025-03-09 15:00:00,1.21,0.92,1.06,186,198,158,32,18,14,31,14,17,19,12,7,+2,+1,+1,74%,77%,70%,122,134,110,29%,28%,32%,3,2,1,1,1,0
210,https://vlr.gg/player/14366/shniider,2025-03-09 15:00:00,0.89,0.86,0.87,186,221,154,33,19,14,39,22,17,11,8,3,0,+1,-1,74%,81%,67%,121,135,108,19%,27%,12%,11,7,4,11,6,5
211,https://vlr.gg/player/7176/askoo,2025-03-09 14:15:00,1.20,1.55,1.40,262,239,281,37,13,24,27,13,14,18,9,9,+3,+2,+1,83%,76%,88%,170,149,185,30%,28%,31%,5,3,2,2,1,1
212,https://vlr.gg/player/36389/izana,2025-03-09 14:15:00,2.11,0.84,1.37,273,393,195,41,25,16,28,10,18,11,5,6,+4,+2,+2,85%,94%,79%,192,263,141,28%,35%,21%,5,2,3,1,0,1
213,https://vlr.gg/player/40697/hawksinho,2025-03-09 14:15:00,1.11,1.16,1.14,256,236,245,37,14,23,29,12,17,12,5,7,0,0,0,73%,71%,75%,151,153,149,17%,20%,15%,10,4,6,10,4,6
214,https://vlr.gg/player/40587/nyshaa,2025-03-09 14:15:00,0.52,1.49,1.09,192,69,272,29,4,25,23,10,13,14,6,8,0,-1,+1,73%,76%,71%,118,53,163,36%,45%,34%,1,0,1,1,1,0
215,https://vlr.gg/player/90/idex,2025-03-09 14:15:00,0.60,0.81,0.72,150,156,146,20,9,11,29,13,16,16,9,7,-2,0,-2,76%,65%,83%,100,97,102,18%,9%,26%,2,1,1,4,1,3
216,https://vlr.gg/player/9641/pie,2025-03-09 14:15:00,1.16,0.93,1.07,204,236,157,29,21,8,29,17,12,11,4,7,-3,-1,-2,71%,79%,59%,151,169,124,24%,31%,15%,0,0,0,3,1,2
217,https://vlr.gg/player/20659/shak0w,2025-03-09 14:15:00,0.78,1.25,0.98,220,206,261,34,17,17,33,21,12,10,5,5,-3,-2,-1,73%,67%,82%,144,134,158,27%,22%,34%,0,0,0,3,2,1
218,https://vlr.gg/player/20023/cleeann,2025-03-09 14:15:00,0.66,1.01,0.80,201,182,232,28,14,14,34,21,13,6,5,1,+2,0,+2,71%,75%,65%,131,122,144,24%,25%,22%,9,5,4,7,5,2
219,https://vlr.gg/player/46308/binh,2025-03-09 14:15:00,0.97,0.40,0.73,173,210,111,24,19,5,34,19,15,5,0,5,-1,-1,0,56%,54%,59%,104,124,75,37%,36%,39%,5,2,3,6,3,3
220,https://vlr.gg/player/16262/ch,2025-03-09 14:15:00,0.45,0.84,0.59,149,111,215,21,8,13,35,21,14,8,6,2,0,+2,-2,59%,42%,82%,98,71,136,21%,18%,24%,4,4,0,4,2,2
221,https://vlr.gg/player/24344/loita,2025-03-09 13:00:00,1.37,1.27,1.32,275,261,267,72,39,33,53,27,26,35,14,21,+2,+1,+1,78%,78%,78%,173,176,170,36%,39%,33%,9,5,4,7,4,3
222,https://vlr.gg/player/12795/crewen,2025-03-09 13:00:00,1.40,1.04,1.23,229,260,205,63,36,27,49,26,23,23,16,7,+2,+2,0,71%,75%,67%,162,180,143,34%,30%,39%,4,2,2,2,0,2
223,https://vlr.gg/player/31305/lar0k,2025-03-09 13:00:00,1.00,1.41,1.19,201,160,241,56,23,33,44,24,20,29,20,9,-3,-2,-1,78%,78%,78%,129,104,157,34%,38%,32%,5,3,2,8,5,3
224,https://vlr.gg/player/40591/comeback,2025-03-09 13:00:00,0.85,0.88,0.87,200,200,185,54,30,24,55,32,23,13,7,6,+5,0,+5,74%,78%,69%,120,124,116,26%,22%,33%,14,7,7,9,7,2
225,https://vlr.gg/player/5565/ros,2025-03-09 13:00:00,0.86,0.70,0.78,166,164,179,45,23,22,58,28,30,33,19,14,0,+1,-1,74%,75%,72%,107,103,111,28%,23%,33%,9,4,5,9,3,6
226,https://vlr.gg/player/12774/anima,2025-03-09 13:00:00,1.18,1.19,1.19,224,207,238,59,25,34,53,24,29,31,19,12,0,+1,-1,78%,78%,78%,141,128,153,35%,35%,35%,3,1,2,3,0,3
227,https://vlr.gg/player/10161/qutionerx,2025-03-09 13:00:00,1.16,1.04,1.10,222,232,218,59,30,29,58,27,31,16,6,10,+7,+2,+5,71%,72%,70%,145,143,146,31%,32%,31%,15,7,8,8,5,3
228,https://vlr.gg/player/10160/izzy,2025-03-09 13:00:00,0.72,1.17,0.95,190,177,212,53,21,32,57,32,25,12,5,7,-6,-4,-2,64%,61%,68%,131,125,137,29%,28%,31%,7,4,3,13,8,5
229,https://vlr.gg/player/8041/brave,2025-03-09 13:00:00,0.97,0.71,0.83,175,194,169,46,23,23,61,29,32,32,23,9,-1,0,-1,70%,78%,63%,117,122,113,28%,30%,26%,7,3,4,8,3,5
230,https://vlr.gg/player/10163/cyderx,2025-03-09 13:00:00,0.83,0.53,0.67,158,170,152,42,23,19,62,28,34,19,9,10,-6,-3,-3,64%,67%,63%,106,106,105,18%,15%,21%,3,1,2,9,4,5
231,https://vlr.gg/player/28612/tricky,2025-03-09 07:40:00,0.85,1.37,1.14,282,237,309,43,16,27,35,16,19,5,2,3,+1,-2,+3,78%,70%,84%,157,129,180,33%,47%,25%,8,3,5,7,5,2
232,https://vlr.gg/player/2432/moner,2025-03-09 07:40:00,0.97,1.19,1.09,201,212,213,35,17,18,31,15,16,9,3,6,-1,-1,0,71%,80%,64%,146,132,158,24%,26%,23%,3,0,3,4,1,3
233,https://vlr.gg/player/18702/deadly10,2025-03-09 07:40:00,0.75,0.89,0.83,183,186,178,29,14,15,33,16,17,9,1,8,+1,0,+1,56%,55%,56%,126,116,135,37%,34%,38%,2,0,2,1,0,1
234,https://vlr.gg/player/1897/bgg,2025-03-09 07:40:00,0.64,0.92,0.77,155,135,179,24,9,15,32,16,16,11,4,7,-1,-2,+1,60%,60%,60%,120,112,127,28%,23%,31%,7,3,4,8,5,3
235,https://vlr.gg/player/3502/ri0,2025-03-09 07:40:00,0.80,0.65,0.72,126,150,103,17,10,7,33,14,19,21,6,15,-3,-1,-2,69%,75%,64%,79,99,64,28%,30%,26%,1,1,0,4,2,2
236,https://vlr.gg/player/12323/rvk,2025-03-09 07:40:00,0.97,1.51,1.21,247,234,277,41,21,20,32,18,14,5,1,4,+1,0,+1,71%,72%,70%,158,142,179,42%,43%,41%,3,1,2,2,1,1
237,https://vlr.gg/player/26376/deecee,2025-03-09 07:40:00,1.25,1.00,1.14,207,254,141,32,23,9,28,17,11,16,9,7,+4,+3,+1,78%,80%,75%,127,158,89,41%,38%,50%,7,5,2,3,2,1
238,https://vlr.gg/player/27336/venka,2025-03-09 07:40:00,0.74,1.44,1.05,239,154,329,37,14,23,33,17,16,7,3,4,-3,-5,+2,62%,52%,75%,160,118,212,36%,35%,36%,6,2,4,9,7,2
239,https://vlr.gg/player/3639/hoax,2025-03-09 07:40:00,1.25,0.75,1.03,154,180,124,29,19,10,25,12,13,11,7,4,+1,0,+1,78%,80%,75%,94,112,72,16%,16%,16%,1,0,1,0,0,0
240,https://vlr.gg/player/30693/makaveli,2025-03-09 07:40:00,0.57,1.09,0.81,166,128,200,24,10,14,30,18,12,10,6,4,0,-1,+1,67%,64%,70%,112,96,132,28%,20%,36%,7,3,4,7,4,3
241,https://vlr.gg/player/36687/miz,2025-03-09 05:30:00,1.95,1.90,1.91,423,464,402,48,11,37,17,3,14,6,3,3,+6,+2,+4,84%,100%,79%,258,271,254,25%,30%,22%,9,2,7,3,0,3
242,https://vlr.gg/player/3627/hellff,2025-03-09 05:30:00,1.38,1.43,1.42,208,193,209,26,6,20,13,3,10,17,4,13,+2,+3,-1,87%,86%,88%,129,104,136,17%,29%,16%,3,3,0,1,0,1
243,https://vlr.gg/player/27775/techno,2025-03-09 05:30:00,1.88,1.21,1.36,219,375,181,26,10,16,16,4,12,19,5,14,0,0,0,87%,100%,83%,144,200,127,38%,48%,33%,4,1,3,4,1,3
244,https://vlr.gg/player/43390/d1sease,2025-03-09 05:30:00,0.75,1.37,1.23,138,59,162,13,1,12,12,3,9,31,6,25,0,0,0,90%,86%,92%,92,29,110,31%,0%,37%,1,0,1,1,0,1
245,https://vlr.gg/player/10749/k1ngkappa,2025-03-09 05:30:00,0.22,1.37,1.11,218,85,254,22,2,20,18,6,12,16,2,14,+3,0,+3,84%,57%,92%,146,86,164,40%,29%,42%,4,0,4,1,0,1
246,https://vlr.gg/player/19231/kibojn,2025-03-09 05:30:00,0.80,1.34,0.92,187,161,299,19,12,7,25,20,5,5,3,2,-2,0,-2,65%,63%,71%,129,116,174,40%,42%,36%,1,1,0,3,1,2
247,https://vlr.gg/player/30575/r1sen,2025-03-09 05:30:00,0.76,0.54,0.70,142,159,104,14,11,3,27,20,7,11,8,3,0,+1,-1,58%,58%,57%,98,109,58,38%,38%,40%,1,1,0,1,0,1
248,https://vlr.gg/player/10760/smokea,2025-03-09 05:30:00,0.53,0.81,0.59,127,114,173,15,11,4,26,20,6,7,3,4,-6,-4,-2,52%,54%,43%,88,86,96,30%,32%,27%,0,0,0,6,4,2
249,https://vlr.gg/player/46104/envy2k,2025-03-09 05:30:00,0.56,0.52,0.53,164,186,112,16,14,2,27,22,5,6,3,3,-3,-3,0,58%,58%,57%,103,108,83,19%,21%,8%,7,6,1,10,9,1
250,https://vlr.gg/player/30877/lilboii,2025-03-09 05:30:00,0.42,0.64,0.47,123,114,147,12,9,3,30,23,7,10,5,5,0,0,0,58%,58%,57%,78,81,68,26%,30%,17%,1,1,0,1,1,0
251,https://vlr.gg/player/27645/amernone,2025-03-09 05:20:00,1.27,1.34,1.31,290,302,285,84,41,43,59,31,28,17,9,8,+18,+15,+3,78%,78%,79%,180,180,181,24%,25%,22%,27,19,8,9,4,5
252,https://vlr.gg/player/43501/chrollo,2025-03-09 05:20:00,1.10,1.04,1.07,188,187,190,54,27,27,50,24,26,21,12,9,+2,0,+2,74%,78%,71%,131,133,129,19%,25%,15%,6,2,4,4,2,2
253,https://vlr.gg/player/48729/w1sh,2025-03-09 05:20:00,1.11,0.89,1.00,159,177,145,48,26,22,52,24,28,40,25,15,-1,+1,-2,73%,83%,64%,111,120,102,36%,28%,47%,2,1,1,3,0,3
254,https://vlr.gg/player/34082/tupai,2025-03-09 05:20:00,0.92,0.95,0.93,214,183,235,61,25,36,62,27,35,15,6,9,-5,-3,-2,67%,70%,64%,131,120,142,23%,21%,25%,8,2,6,13,5,8
255,https://vlr.gg/player/37028/goldenblue,2025-03-09 05:20:00,0.76,1.07,0.92,171,143,203,48,19,29,58,28,30,29,17,12,0,-3,+3,72%,78%,67%,120,100,139,27%,28%,27%,5,1,4,5,4,1
256,https://vlr.gg/player/23686/kahlheit,2025-03-09 05:20:00,1.35,0.99,1.17,260,310,199,71,46,25,60,32,28,21,5,16,+2,+3,-1,67%,71%,63%,162,181,141,25%,22%,30%,16,10,6,14,7,7
257,https://vlr.gg/player/26826/6ixkey,2025-03-09 05:20:00,1.02,1.00,1.01,195,181,212,55,28,27,56,28,28,23,14,9,-2,-2,0,71%,74%,68%,128,117,138,29%,21%,39%,4,2,2,6,4,2
258,https://vlr.gg/player/34078/mrvl,2025-03-09 05:20:00,0.81,1.10,0.95,178,165,190,52,23,29,59,33,26,37,23,14,-2,-2,0,80%,81%,80%,118,106,130,28%,26%,30%,5,1,4,7,3,4
259,https://vlr.gg/player/48749/randomguy,2025-03-09 05:20:00,0.75,0.96,0.85,184,174,201,53,25,28,58,31,27,10,5,5,-2,+2,-4,68%,69%,68%,118,112,124,17%,13%,22%,7,5,2,9,3,6
260,https://vlr.gg/player/26822/crouzer,2025-03-09 05:20:00,0.73,0.92,0.82,178,172,190,48,23,25,62,34,28,34,20,14,-10,-5,-5,65%,71%,58%,115,111,120,28%,30%,26%,2,1,1,12,6,6
261,https://vlr.gg/player/10581/ryu,2025-03-08 20:20:00,1.03,1.57,1.23,226,189,275,32,16,16,25,17,8,17,11,6,+2,+2,0,82%,75%,93%,150,130,182,36%,37%,34%,4,3,1,2,1,1
262,https://vlr.gg/player/31476/mephisto,2025-03-08 20:20:00,0.78,1.93,1.22,283,207,377,39,17,22,26,19,7,7,6,1,-2,-3,+1,72%,67%,80%,185,154,236,30%,34%,26%,6,5,1,8,8,0
263,https://vlr.gg/player/26757/otaq,2025-03-08 20:20:00,1.54,0.67,1.20,232,282,121,32,25,7,24,15,9,17,10,7,+2,+2,0,82%,83%,80%,135,174,71,19%,20%,16%,4,2,2,2,0,2
264,https://vlr.gg/player/10582/panaek,2025-03-08 20:20:00,0.98,1.42,1.15,204,171,287,29,14,15,23,14,9,8,4,4,+2,-1,+3,82%,83%,80%,149,131,177,30%,37%,24%,4,1,3,2,2,0
265,https://vlr.gg/player/15931/peloncito,2025-03-08 20:20:00,1.27,0.75,1.07,186,239,126,28,22,6,24,15,9,9,6,3,-1,0,-1,74%,79%,67%,117,136,86,37%,32%,60%,3,1,2,4,1,3
266,https://vlr.gg/player/38881/wetysao,2025-03-08 20:20:00,0.98,1.13,1.03,220,250,220,33,15,18,32,15,17,11,1,10,+1,+1,0,72%,67%,75%,146,135,153,32%,33%,32%,6,2,4,5,1,4
267,https://vlr.gg/player/35559/pandejalea,2025-03-08 20:20:00,0.70,1.08,0.93,224,200,234,29,9,20,30,13,17,11,5,6,-4,-4,0,69%,67%,71%,143,135,148,24%,24%,24%,6,2,4,10,6,4
268,https://vlr.gg/player/38912/yuno,2025-03-08 20:20:00,0.37,1.17,0.86,164,93,215,23,4,19,33,14,19,11,4,7,0,+1,-1,74%,67%,79%,116,68,146,36%,50%,33%,3,2,1,3,1,2
269,https://vlr.gg/player/8781/charlslol,2025-03-08 20:20:00,0.89,0.56,0.69,118,143,114,15,7,8,31,12,19,15,6,9,+1,0,+1,62%,60%,63%,84,92,80,19%,16%,22%,1,0,1,0,0,0
270,https://vlr.gg/player/17676/dexuz,2025-03-08 20:20:00,0.79,0.62,0.68,170,159,181,22,7,15,34,12,22,6,3,3,-1,-1,0,49%,47%,50%,118,129,111,16%,15%,17%,2,0,2,3,1,2
271,https://vlr.gg/player/2848/sh0twell,2025-03-08 17:20:00,1.24,0.72,1.00,214,283,143,30,21,9,34,20,14,11,7,4,+1,+3,-2,68%,77%,58%,146,179,107,26%,29%,20%,4,4,0,3,1,2
272,https://vlr.gg/player/7652/tuli,2025-03-08 17:20:00,0.73,1.25,0.97,217,154,304,33,14,19,31,16,15,7,2,5,-3,-5,+2,63%,59%,68%,135,90,187,18%,16%,19%,7,1,6,10,6,4
273,https://vlr.gg/player/2909/alca,2025-03-08 17:20:00,1.11,0.65,0.89,179,216,134,27,18,9,29,16,13,6,5,1,+3,+3,0,66%,77%,53%,119,139,95,25%,20%,38%,4,3,1,1,0,1
274,https://vlr.gg/player/43935/ruso,2025-03-08 17:20:00,0.71,0.90,0.80,163,131,197,24,11,13,32,17,15,5,2,3,+3,0,+3,63%,55%,74%,123,113,135,38%,34%,42%,5,2,3,2,2,0
275,https://vlr.gg/player/8278/knzy,2025-03-08 17:20:00,0.82,0.68,0.76,148,171,114,20,13,7,30,17,13,18,14,4,-3,-1,-2,68%,73%,63%,98,119,74,28%,27%,29%,1,1,0,4,2,2
276,https://vlr.gg/player/2403/mizu,2025-03-08 17:20:00,1.48,1.22,1.34,297,329,259,44,24,20,29,13,16,14,4,10,+1,+1,0,76%,84%,68%,194,208,182,49%,63%,40%,4,2,2,3,1,2
277,https://vlr.gg/player/1291/bnj,2025-03-08 17:20:00,1.20,1.17,1.18,191,197,184,30,13,17,22,10,12,11,5,6,-1,0,-1,68%,68%,68%,131,152,113,24%,32%,18%,0,0,0,1,0,1
278,https://vlr.gg/player/2818/neto,2025-03-08 17:20:00,1.44,0.94,1.17,247,283,224,34,20,14,28,12,16,9,5,4,0,+1,-1,73%,68%,77%,159,173,146,27%,25%,28%,10,5,5,10,4,6
279,https://vlr.gg/player/2586/hanling,2025-03-08 17:20:00,0.76,1.10,0.94,161,119,199,26,8,18,27,11,16,13,4,9,-3,-3,0,71%,68%,73%,99,82,113,24%,19%,29%,3,1,2,6,4,2
280,https://vlr.gg/player/15916/jotinha,2025-03-08 17:20:00,0.73,1.00,0.87,188,111,249,22,5,17,28,11,17,20,10,10,+2,0,+2,73%,74%,73%,124,78,163,25%,22%,27%,3,1,2,1,1,0
281,https://vlr.gg/player/25097/solution,2025-03-08 17:00:00,1.26,1.29,1.27,243,216,274,60,26,34,42,19,23,19,11,8,-1,-1,0,73%,72%,74%,152,135,169,25%,23%,27%,4,0,4,5,1,4
282,https://vlr.gg/player/42199/rei,2025-03-08 17:00:00,0.81,1.59,1.21,265,207,302,56,22,34,50,27,23,8,3,5,+10,+2,+8,68%,63%,74%,168,136,199,43%,46%,41%,22,9,13,12,7,5
283,https://vlr.gg/player/24026/generalsteak,2025-03-08 17:00:00,1.01,0.80,0.90,158,190,131,38,22,16,42,22,20,7,2,5,-1,-1,0,68%,72%,65%,115,132,99,40%,38%,43%,1,1,0,2,2,0
284,https://vlr.gg/player/35567/toro,2025-03-08 17:00:00,0.76,0.98,0.87,161,136,186,36,14,22,42,22,20,17,8,9,-6,-6,0,67%,56%,76%,114,94,133,34%,25%,40%,2,0,2,8,6,2
285,https://vlr.gg/player/2995/maka,2025-03-08 17:00:00,0.94,0.55,0.74,137,167,101,31,18,13,45,22,23,26,15,11,-2,-2,0,70%,72%,68%,81,101,61,16%,15%,18%,4,2,2,6,4,2
286,https://vlr.gg/player/8790/mininiwde,2025-03-08 17:00:00,1.06,1.03,1.05,180,198,162,42,23,19,40,22,18,27,13,14,-2,-1,-1,70%,68%,72%,118,124,111,23%,21%,25%,2,1,1,4,2,2
287,https://vlr.gg/player/41409/vandals,2025-03-08 17:00:00,0.97,1.10,1.03,194,188,199,46,22,24,44,25,19,24,15,9,+1,+1,0,76%,71%,81%,124,114,134,36%,38%,35%,6,5,1,5,4,1
288,https://vlr.gg/player/17694/prask,2025-03-08 17:00:00,0.78,1.17,0.97,194,164,218,45,20,25,47,26,21,10,2,8,+2,-2,+4,70%,59%,81%,126,107,147,32%,36%,29%,7,2,5,5,4,1
289,https://vlr.gg/player/36405/jrmzie,2025-03-08 17:00:00,0.78,1.07,0.92,203,192,227,48,23,25,46,26,20,8,3,5,-3,-5,+2,67%,65%,69%,137,121,153,34%,44%,26%,9,2,7,12,7,5
290,https://vlr.gg/player/8792/xhowi,2025-03-08 17:00:00,1.03,0.75,0.90,177,173,184,40,21,19,44,20,24,14,5,9,+2,-1,+3,70%,65%,75%,119,119,120,23%,27%,20%,9,3,6,7,4,3
291,https://vlr.gg/player/5614/xelouz,2025-03-08 17:00:00,1.30,0.87,1.05,182,207,165,25,12,13,29,9,20,22,13,9,-1,0,-1,63%,82%,50%,118,125,113,22%,22%,22%,1,0,1,2,0,2
292,https://vlr.gg/player/52850/fr1,2025-03-08 17:00:00,1.06,0.83,0.93,233,269,210,32,16,16,35,13,22,7,4,3,+4,0,+4,68%,76%,63%,154,190,128,32%,41%,24%,14,6,8,10,6,4
293,https://vlr.gg/player/19311/kuro,2025-03-08 17:00:00,1.36,0.37,0.77,155,215,110,23,15,8,31,10,21,12,7,5,-1,+2,-3,68%,88%,54%,102,143,72,15%,16%,14%,3,2,1,4,0,4
294,https://vlr.gg/player/42488/koji,2025-03-08 17:00:00,0.76,0.77,0.76,153,176,139,24,11,13,32,11,21,3,1,2,-1,+1,-2,56%,71%,46%,106,111,103,50%,50%,50%,1,1,0,2,0,2
295,https://vlr.gg/player/16885/snipkw,2025-03-08 17:00:00,1.02,0.53,0.73,155,172,143,21,11,10,33,11,22,17,11,6,0,0,0,63%,82%,50%,103,120,90,22%,23%,21%,2,1,1,2,1,1
296,https://vlr.gg/player/1618/spyzera,2025-03-08 17:00:00,1.42,1.33,1.38,261,254,275,39,24,15,26,14,12,14,10,4,+3,+1,+2,85%,96%,71%,167,154,186,49%,46%,54%,5,2,3,2,1,1
297,https://vlr.gg/player/5599/khaalid,2025-03-08 17:00:00,1.14,1.27,1.19,223,170,299,31,13,18,26,11,15,10,8,2,+1,+2,-1,80%,96%,59%,154,118,206,27%,21%,32%,4,3,1,3,1,2
298,https://vlr.gg/player/251/b1sk,2025-03-08 17:00:00,1.37,0.91,1.18,231,270,175,35,25,10,25,13,12,7,5,2,+2,+3,-1,73%,79%,65%,152,167,131,20%,15%,26%,7,5,2,5,2,3
299,https://vlr.gg/player/5600/moh,2025-03-08 17:00:00,1.45,0.66,1.12,208,257,137,28,23,5,24,11,13,20,13,7,-3,-1,-2,78%,96%,53%,139,167,100,30%,31%,26%,2,1,1,5,2,3
300,https://vlr.gg/player/37847/fighter,2025-03-08 17:00:00,1.33,0.60,1.02,174,234,91,27,21,6,24,11,13,10,8,2,-4,-3,-1,76%,88%,59%,134,186,60,27%,25%,36%,2,2,0,6,5,1
301,https://vlr.gg/player/3828/tacolilla,2025-03-08 14:00:00,0.83,1.35,1.11,226,180,254,51,19,32,48,24,24,15,6,9,+7,+1,+6,72%,68%,76%,151,130,169,32%,30%,34%,12,4,8,5,3,2
302,https://vlr.gg/player/1294/nagz,2025-03-08 14:00:00,0.67,1.41,1.08,213,171,246,52,17,35,46,25,21,14,5,9,-5,-5,0,68%,52%,81%,145,117,168,27%,24%,29%,7,3,4,12,8,4
303,https://vlr.gg/player/2468/delz1k,2025-03-08 14:00:00,0.81,1.24,1.04,201,173,235,51,18,33,47,24,23,33,15,18,+4,+3,+1,74%,65%,81%,129,112,144,23%,21%,24%,8,5,3,4,2,2
304,https://vlr.gg/player/29244/mikey-tap,2025-03-08 14:00:00,1.16,0.88,1.01,214,263,174,49,27,22,52,25,27,17,5,12,0,0,0,71%,68%,73%,142,179,112,32%,42%,23%,5,1,4,5,1,4
305,https://vlr.gg/player/2464/suther,2025-03-08 14:00:00,0.96,0.92,0.94,170,186,164,37,21,16,44,21,23,26,5,21,-2,-2,0,68%,71%,65%,129,131,128,18%,22%,15%,4,1,3,6,3,3
306,https://vlr.gg/player/21251/blowz,2025-03-08 14:00:00,1.29,0.99,1.15,226,261,180,54,34,20,43,25,18,19,9,10,-3,-1,-2,78%,68%,90%,147,166,124,37%,44%,28%,2,2,0,5,3,2
307,https://vlr.gg/player/29243/neon,2025-03-08 14:00:00,0.68,1.38,0.99,213,159,287,54,22,32,51,29,22,13,3,10,+4,0,+4,62%,49%,77%,132,95,176,32%,34%,30%,14,6,8,10,6,4
308,https://vlr.gg/player/29241/miradaninja,2025-03-08 14:00:00,1.18,0.75,0.98,214,243,179,50,31,19,49,26,23,19,9,10,+4,+2,+2,76%,81%,71%,136,158,110,21%,26%,15%,7,2,5,3,0,3
309,https://vlr.gg/player/42867/ghoul33,2025-03-08 14:00:00,0.44,1.46,0.91,192,138,264,44,15,29,49,31,18,18,6,12,-7,-6,-1,65%,46%,87%,137,99,183,22%,19%,24%,7,4,3,14,10,4
310,https://vlr.gg/player/29242/erde,2025-03-08 14:00:00,0.68,0.82,0.74,151,130,169,35,16,19,50,27,23,28,18,10,-2,-2,0,69%,62%,77%,103,94,115,28%,23%,34%,2,1,1,4,3,1
311,https://vlr.gg/player/12333/achrf,2025-03-08 14:00:00,1.51,1.61,1.54,275,260,318,35,23,12,18,13,5,18,11,7,+2,+1,+1,89%,83%,100%,194,191,201,21%,18%,31%,3,2,1,1,1,0
312,https://vlr.gg/player/27316/elixllo,2025-03-08 14:00:00,0.88,2.10,1.27,221,162,362,31,14,17,19,15,4,5,3,2,0,0,0,69%,63%,82%,154,123,221,27%,28%,25%,2,1,1,2,1,1
313,https://vlr.gg/player/7286/str1ker,2025-03-08 14:00:00,1.12,1.33,1.18,189,205,157,26,19,7,19,15,4,14,10,4,-1,-1,0,89%,83%,100%,121,135,88,31%,30%,33%,0,0,0,1,1,0
314,https://vlr.gg/player/3807/winteryrook,2025-03-08 14:00:00,1.20,1.12,1.17,228,255,151,28,22,6,21,17,4,16,13,3,+3,+2,+1,89%,83%,100%,129,149,84,34%,44%,14%,6,4,2,3,2,1
315,https://vlr.gg/player/6126/sibeastw0w,2025-03-08 14:00:00,0.91,1.36,1.05,255,236,284,29,18,11,25,19,6,14,9,5,+7,+4,+3,71%,67%,82%,154,153,156,18%,21%,10%,12,8,4,5,4,1
316,https://vlr.gg/player/41090/maher,2025-03-08 14:00:00,0.34,1.38,1.04,223,92,281,28,4,24,31,11,20,9,1,8,-4,-2,-2,66%,55%,71%,144,53,186,32%,22%,34%,2,0,2,6,2,4
317,https://vlr.gg/player/52834/szlw,2025-03-08 14:00:00,0.72,1.00,0.91,210,209,213,25,7,18,28,10,18,3,0,3,+2,+1,+1,69%,45%,79%,141,144,140,41%,39%,43%,6,2,4,4,1,3
318,https://vlr.gg/player/52835/vosx,2025-03-08 14:00:00,0.16,0.92,0.68,151,70,196,18,3,15,30,11,19,7,0,7,-2,-2,0,49%,27%,58%,101,43,127,15%,22%,13%,3,0,3,5,2,3
319,https://vlr.gg/player/52836/fz,2025-03-08 14:00:00,0.17,0.79,0.59,144,59,181,16,2,14,28,10,18,6,1,5,-4,-1,-3,43%,36%,46%,101,43,127,21%,8%,25%,1,1,0,5,2,3
320,https://vlr.gg/player/29857/zife,2025-03-08 14:00:00,0.78,0.49,0.58,125,179,102,15,7,8,32,11,21,11,3,8,-3,-1,-2,63%,64%,63%,80,108,67,41%,40%,41%,0,0,0,3,1,2
321,https://vlr.gg/player/12774/anima,2025-03-08 12:00:00,0.99,1.50,1.27,224,156,280,55,17,38,41,22,19,32,10,22,-8,-2,-6,81%,83%,78%,147,101,185,35%,23%,43%,0,0,0,8,2,6
322,https://vlr.gg/player/8041/brave,2025-03-08 12:00:00,1.36,1.14,1.24,224,262,193,56,26,30,36,20,16,25,17,8,0,-2,+2,76%,70%,81%,148,160,139,36%,36%,37%,7,2,5,7,4,3
323,https://vlr.gg/player/10161/qutionerx,2025-03-08 12:00:00,0.69,1.62,1.20,234,149,308,53,14,39,39,22,17,14,4,10,-2,-9,+7,73%,57%,86%,149,100,188,21%,15%,25%,13,2,11,15,11,4
324,https://vlr.gg/player/10160/izzy,2025-03-08 12:00:00,0.79,1.32,1.08,205,181,226,51,19,32,43,24,19,12,3,9,+4,0,+4,76%,67%,84%,132,112,148,32%,35%,31%,7,2,5,3,2,1
325,https://vlr.gg/player/10163/cyderx,2025-03-08 12:00:00,0.96,0.95,0.95,158,181,137,38,19,19,38,22,16,12,5,7,-1,-1,0,78%,73%,81%,104,120,92,25%,25%,26%,3,2,1,4,3,1
326,https://vlr.gg/player/13258/cyvoph,2025-03-08 12:00:00,0.97,1.04,1.00,180,173,193,44,22,22,49,30,19,33,14,19,+2,+2,0,70%,65%,77%,122,119,126,21%,23%,18%,7,4,3,5,2,3
327,https://vlr.gg/player/3582/keloqz,2025-03-08 12:00:00,0.67,1.34,0.97,196,176,226,47,21,26,50,34,16,10,2,8,+5,-2,+7,67%,51%,87%,130,116,147,20%,29%,11%,12,5,7,7,7,0
328,https://vlr.gg/player/114/enzo,2025-03-08 12:00:00,0.65,0.94,0.78,173,139,222,36,16,20,50,31,19,25,9,16,+3,-3,+6,69%,59%,80%,117,98,140,19%,25%,15%,8,2,6,5,5,0
329,https://vlr.gg/player/1284/mikee,2025-03-08 12:00:00,0.56,1.03,0.77,167,123,223,38,14,24,53,31,22,26,8,18,-1,-3,+2,70%,57%,87%,111,85,144,27%,28%,26%,5,2,3,6,5,1
330,https://vlr.gg/player/113/hyp,2025-03-08 12:00:00,0.55,1.00,0.75,146,120,175,32,14,18,51,32,19,16,6,10,-2,-1,-1,60%,49%,73%,100,81,123,26%,38%,19%,5,2,3,7,3,4
331,https://vlr.gg/player/26829/damaraa,2025-03-08 07:00:00,1.12,2.15,1.68,373,280,448,58,19,39,31,17,14,13,7,6,+5,+1,+4,77%,70%,83%,227,179,266,22%,27%,20%,12,5,7,7,4,3
332,https://vlr.gg/player/9290/madelyn,2025-03-08 07:00:00,0.91,1.41,1.18,202,173,227,33,12,21,27,16,11,11,5,6,0,0,0,80%,75%,83%,126,104,144,23%,18%,25%,0,0,0,0,0,0
333,https://vlr.gg/player/1162/russ,2025-03-08 07:00:00,0.87,1.24,1.08,158,141,173,24,9,15,25,13,12,27,11,16,-3,-3,0,84%,90%,79%,95,85,103,25%,24%,27%,1,0,1,4,3,1
334,https://vlr.gg/player/3626/lightningfast,2025-03-08 07:00:00,1.04,0.95,0.99,170,170,169,26,12,14,29,14,15,23,9,14,+3,0,+3,80%,85%,75%,112,115,110,27%,23%,32%,5,1,4,2,1,1
335,https://vlr.gg/player/4095/skrossi,2025-03-08 07:00:00,0.99,0.88,0.93,202,214,193,30,15,15,32,15,17,13,4,9,+1,-2,+3,75%,70%,79%,140,151,130,18%,20%,17%,7,2,5,6,4,2
336,https://vlr.gg/player/3639/hoax,2025-03-08 07:00:00,1.08,0.98,1.04,203,232,172,30,18,12,33,20,13,21,11,10,+1,0,+1,80%,79%,80%,131,158,99,30%,27%,35%,2,0,2,1,0,1
337,https://vlr.gg/player/30693/makaveli,2025-03-08 07:00:00,0.92,0.83,0.88,194,213,176,30,18,12,35,22,13,12,4,8,+1,-1,+2,73%,67%,80%,141,157,123,26%,37%,14%,4,1,3,3,2,1
338,https://vlr.gg/player/27336/venka,2025-03-08 07:00:00,0.62,1.15,0.86,210,170,256,34,14,20,35,21,14,4,2,2,0,-5,+5,66%,54%,80%,135,107,170,40%,32%,47%,9,3,6,9,8,1
339,https://vlr.gg/player/26376/deecee,2025-03-08 07:00:00,0.46,1.19,0.79,176,132,230,28,12,16,36,21,15,13,3,10,-6,-4,-2,57%,46%,70%,107,79,141,22%,37%,15%,2,2,0,8,6,2
340,https://vlr.gg/player/12323/rvk,2025-03-08 07:00:00,0.45,1.12,0.75,145,105,193,22,7,15,32,20,12,14,9,5,-2,0,-2,66%,50%,85%,98,70,132,32%,19%,45%,2,1,1,4,1,3
341,https://vlr.gg/player/1971/oitan,2025-03-08 05:00:00,1.83,0.87,1.47,285,305,185,39,28,11,21,11,10,11,8,3,+5,+4,+1,78%,83%,71%,168,206,106,40%,47%,25%,5,4,1,0,0,0
342,https://vlr.gg/player/47481/frxeez,2025-03-08 05:00:00,1.16,1.50,1.29,291,249,338,36,18,18,28,17,11,6,5,1,+8,+4,+4,81%,78%,86%,194,185,208,20%,22%,18%,10,6,4,2,2,0
343,https://vlr.gg/player/2671/popogachi,2025-03-08 05:00:00,0.96,1.19,1.04,189,157,274,25,13,12,25,14,11,13,8,5,+1,-1,+2,73%,74%,71%,142,114,188,29%,30%,28%,3,0,3,2,1,1
344,https://vlr.gg/player/12980/ria,2025-03-08 05:00:00,1.23,0.42,0.92,188,234,88,24,20,4,23,13,10,11,7,4,0,+1,-1,70%,78%,57%,119,156,59,23%,21%,30%,4,4,0,4,3,1
345,https://vlr.gg/player/44613/yamada,2025-03-08 05:00:00,1.11,0.42,0.85,157,182,120,21,16,5,24,12,12,11,6,5,+3,+3,0,81%,91%,64%,106,116,90,21%,22%,18%,5,3,2,2,0,2
346,https://vlr.gg/player/47473/yurimu,2025-03-08 05:00:00,2.00,0.71,1.20,208,321,159,29,16,13,27,7,20,19,11,8,-1,-1,0,73%,86%,65%,132,173,107,30%,34%,26%,2,0,2,3,1,2
347,https://vlr.gg/player/50758/lroll,2025-03-08 05:00:00,0.95,0.93,0.93,221,218,256,29,10,19,31,12,19,13,5,8,-3,0,-3,57%,64%,52%,171,143,187,26%,32%,23%,3,2,1,6,2,4
348,https://vlr.gg/player/50759/r14h,2025-03-08 05:00:00,0.88,0.82,0.84,160,143,171,21,8,13,28,10,18,6,3,3,-1,0,-1,65%,64%,65%,109,103,112,28%,33%,25%,1,1,0,2,1,1
349,https://vlr.gg/player/50761/3ip0n,2025-03-08 05:00:00,1.27,0.52,0.80,174,260,140,24,13,11,30,10,20,5,4,1,-7,-4,-3,73%,79%,70%,125,192,84,37%,32%,44%,0,0,0,7,4,3
350,https://vlr.gg/player/50760/kellsea,2025-03-08 05:00:00,0.65,0.61,0.63,151,144,151,18,7,11,31,11,20,6,2,4,-5,-1,-4,57%,57%,57%,99,99,99,26%,33%,22%,4,1,3,9,2,7
351,https://vlr.gg/player/43389/yash,2025-03-08 04:30:00,0.63,1.23,0.98,251,173,306,35,10,25,36,16,20,10,3,7,+1,0,+1,71%,59%,79%,155,98,196,32%,18%,41%,7,3,4,6,3,3
352,https://vlr.gg/player/46058/s1mple,2025-03-08 04:30:00,0.34,1.29,0.90,186,104,242,25,6,19,33,15,18,15,2,13,0,-1,+1,61%,53%,67%,124,52,175,37%,41%,35%,3,0,3,3,1,2
353,https://vlr.gg/player/22054/wave,2025-03-08 04:30:00,0.89,0.82,0.85,174,202,157,24,11,13,32,14,18,8,2,6,+1,+1,0,61%,47%,71%,112,133,97,33%,30%,35%,5,3,2,4,2,2
354,https://vlr.gg/player/27755/icarus,2025-03-08 04:30:00,0.64,0.97,0.83,144,133,153,22,7,15,30,14,16,4,0,4,-4,-2,-2,56%,35%,71%,106,89,117,40%,39%,41%,2,1,1,6,3,3
355,https://vlr.gg/player/4085/near,2025-03-08 04:30:00,0.50,0.75,0.63,141,117,161,19,6,13,34,15,19,11,5,6,-3,-1,-2,63%,53%,71%,106,87,119,35%,44%,32%,1,0,1,4,1,3
356,https://vlr.gg/player/12947/rawfiul,2025-03-08 04:30:00,1.28,1.45,1.35,260,258,256,40,23,17,26,16,10,10,4,6,0,-1,+1,80%,79%,82%,165,160,172,28%,30%,25%,5,3,2,5,4,1
357,https://vlr.gg/player/3628/deathmaker,2025-03-08 04:30:00,1.06,1.67,1.31,246,227,276,36,19,17,22,16,6,14,6,8,+1,+1,0,83%,79%,88%,166,149,189,22%,18%,27%,3,2,1,2,1,1
358,https://vlr.gg/player/13221/azys,2025-03-08 04:30:00,0.89,1.66,1.21,243,203,300,39,20,19,28,19,9,2,0,2,+4,0,+4,76%,67%,88%,153,133,181,25%,32%,19%,9,3,6,5,3,2
359,https://vlr.gg/player/3269/antidote,2025-03-08 04:30:00,0.98,1.44,1.17,187,196,176,26,15,11,20,16,4,24,14,10,+1,+1,0,88%,88%,88%,122,125,116,24%,22%,29%,2,2,0,1,1,0
360,https://vlr.gg/player/9745/georggyyy,2025-03-08 04:30:00,0.80,0.80,0.80,174,179,165,24,14,10,29,18,11,20,11,9,-1,+1,-2,71%,71%,71%,109,108,112,19%,19%,18%,4,3,1,5,2,3
361,https://vlr.gg/player/17111/allen,2025-03-08 02:00:00,1.64,1.08,1.33,237,281,205,38,21,17,26,9,17,17,9,8,+3,+1,+2,77%,79%,75%,156,187,132,29%,24%,36%,6,2,4,3,1,2
362,https://vlr.gg/player/40734/hands,2025-03-08 02:00:00,1.34,1.28,1.31,227,226,225,35,16,19,24,9,15,13,5,8,+3,+1,+2,79%,79%,79%,159,154,163,23%,22%,24%,3,1,2,0,0,0
363,https://vlr.gg/player/47482/flora,2025-03-08 02:00:00,1.21,1.34,1.28,247,213,269,36,14,22,27,11,16,16,10,6,+4,+1,+3,72%,79%,67%,160,142,174,33%,37%,30%,6,2,4,2,1,1
364,https://vlr.gg/player/25279/sakura,2025-03-08 02:00:00,1.03,1.04,1.03,199,236,178,31,16,15,28,14,14,24,9,15,-2,0,-2,72%,68%,75%,131,148,117,36%,37%,34%,3,1,2,5,1,4
365,https://vlr.gg/player/5255/neal-x,2025-03-08 02:00:00,0.93,0.81,0.86,205,223,191,32,15,17,31,13,18,7,3,4,-1,-2,+1,74%,84%,67%,131,137,126,22%,22%,23%,7,4,3,8,6,2
366,https://vlr.gg/player/34736/gwyn,2025-03-08 02:00:00,1.13,0.94,1.04,193,205,182,32,19,13,32,17,15,19,8,11,+2,+1,+1,74%,79%,68%,126,141,107,27%,34%,21%,3,1,2,1,0,1
367,https://vlr.gg/player/52721/reo,2025-03-08 02:00:00,1.08,0.68,0.90,215,224,197,29,18,11,37,18,19,14,7,7,-2,-2,0,70%,71%,68%,136,145,125,25%,28%,22%,2,0,2,4,2,2
368,https://vlr.gg/player/52722/ponta,2025-03-08 02:00:00,0.83,0.97,0.89,221,208,246,33,17,16,36,19,17,7,5,2,-1,-3,+2,70%,67%,74%,141,134,150,33%,41%,24%,9,4,5,10,7,3
369,https://vlr.gg/player/34739/ren,2025-03-08 02:00:00,0.75,0.58,0.67,133,145,121,21,13,8,32,17,15,6,2,4,-3,0,-3,53%,58%,47%,92,100,82,26%,25%,27%,1,1,0,4,1,3
370,https://vlr.gg/player/43031/nao,2025-03-08 02:00:00,0.62,0.56,0.59,140,154,136,21,13,8,35,19,16,10,3,7,-3,-2,-1,60%,50%,74%,96,97,95,24%,27%,21%,3,3,0,6,5,1
371,https://vlr.gg/player/44075/dedmos,2025-03-07 19:05:00,1.11,1.36,1.24,235,178,292,39,15,24,33,15,18,27,15,12,-2,+1,-3,85%,75%,96%,150,118,183,18%,21%,16%,2,2,0,4,1,3
372,https://vlr.gg/player/21428/crunch,2025-03-07 19:05:00,1.06,1.29,1.17,254,221,287,42,19,23,34,18,16,13,7,6,+5,+1,+4,73%,71%,75%,160,142,178,26%,23%,28%,13,5,8,8,4,4
373,https://vlr.gg/player/50835/arbex,2025-03-07 19:05:00,1.16,1.00,1.08,198,234,162,35,20,15,29,16,13,11,4,7,0,+1,-1,79%,79%,79%,133,149,117,38%,44%,32%,2,2,0,2,1,1
374,https://vlr.gg/player/45921/v1bz,2025-03-07 19:05:00,0.84,1.06,0.95,195,189,201,32,15,17,33,18,15,14,8,6,-8,-4,-4,71%,71%,71%,126,128,124,23%,20%,28%,2,1,1,10,5,5
375,https://vlr.gg/player/35619/sxnti,2025-03-07 19:05:00,0.86,0.79,0.82,147,162,133,27,14,13,33,18,15,18,12,6,+1,+1,0,79%,79%,79%,97,107,86,29%,29%,30%,3,2,1,2,1,1
376,https://vlr.gg/player/2753/bandicoot,2025-03-07 19:05:00,0.64,2.14,1.39,265,148,383,46,11,35,30,18,12,11,6,5,+4,+3,+1,81%,75%,88%,174,102,245,35%,22%,41%,5,3,2,1,0,1
377,https://vlr.gg/player/10556/drakk,2025-03-07 19:05:00,1.12,1.13,1.12,236,261,211,40,23,17,35,19,16,8,2,6,+11,+5,+6,73%,71%,75%,164,173,156,34%,32%,37%,12,5,7,1,0,1
378,https://vlr.gg/player/7618/theory,2025-03-07 19:05:00,0.96,0.92,0.94,190,183,197,31,16,15,33,17,16,17,6,11,-4,-3,-1,69%,58%,79%,132,136,129,35%,40%,31%,3,1,2,7,4,3
379,https://vlr.gg/player/35583/edu,2025-03-07 19:05:00,0.64,0.78,0.71,131,118,145,21,9,12,38,19,19,31,14,17,0,-1,+1,71%,75%,67%,84,75,92,35%,24%,50%,1,0,1,1,1,0
380,https://vlr.gg/player/39538/bull3tz,2025-03-07 19:05:00,0.95,0.24,0.59,159,232,86,23,18,5,41,20,21,23,13,10,-7,0,-7,69%,75%,63%,101,141,62,27%,25%,30%,5,5,0,12,5,7
381,https://vlr.gg/player/17669/pompz,2025-03-07 17:00:00,1.35,0.74,0.99,181,269,138,25,14,11,27,11,16,11,5,6,-2,+1,-3,62%,87%,45%,119,175,80,30%,24%,42%,3,1,2,5,0,5
382,https://vlr.gg/player/1328/javiierh,2025-03-07 17:00:00,0.92,1.03,0.98,201,232,191,24,12,12,29,12,17,14,1,13,0,0,0,70%,67%,73%,142,158,131,21%,29%,13%,2,1,1,2,1,1
383,https://vlr.gg/player/24013/navarro,2025-03-07 17:00:00,0.97,0.96,0.96,181,200,167,23,10,13,26,11,15,6,5,1,+1,-1,+2,68%,73%,64%,128,147,114,29%,26%,32%,3,0,3,2,1,1
384,https://vlr.gg/player/49571/paganus,2025-03-07 17:00:00,0.52,0.70,0.63,139,132,143,17,8,9,29,13,16,9,1,8,-1,-2,+1,68%,60%,73%,94,85,99,30%,38%,27%,3,1,2,4,3,1
385,https://vlr.gg/player/46891/sventy,2025-03-07 17:00:00,0.27,0.60,0.44,140,98,168,18,5,13,30,13,17,3,1,2,-11,-5,-6,51%,47%,55%,86,61,102,16%,14%,16%,1,1,0,12,6,6
386,https://vlr.gg/player/10557/darker,2025-03-07 17:00:00,1.33,1.52,1.41,245,209,290,36,18,18,22,12,10,7,5,2,+6,+4,+2,78%,73%,87%,156,131,193,20%,24%,17%,6,4,2,0,0,0
387,https://vlr.gg/player/7616/feniz,2025-03-07 17:00:00,1.43,1.08,1.29,228,233,230,31,19,12,20,9,11,11,6,5,+4,+4,0,84%,82%,87%,147,148,145,35%,36%,32%,5,4,1,1,0,1
388,https://vlr.gg/player/8056/mited,2025-03-07 17:00:00,1.19,1.12,1.16,191,188,190,22,14,8,18,10,8,13,5,8,+3,+3,0,78%,82%,73%,134,124,148,20%,20%,20%,4,4,0,1,1,0
389,https://vlr.gg/player/9354/cebando,2025-03-07 17:00:00,1.16,1.11,1.14,186,184,157,24,15,9,18,10,8,20,10,10,0,-1,+1,78%,77%,80%,107,119,89,37%,38%,36%,3,1,2,3,2,1
390,https://vlr.gg/player/3983/virtyy,2025-03-07 17:00:00,0.83,1.12,0.95,214,207,232,28,15,13,29,17,12,12,7,5,0,-4,+4,76%,73%,80%,132,142,117,24%,22%,28%,7,1,6,7,5,2
391,https://vlr.gg/player/29240/skyppervz,2025-03-07 16:05:00,0.99,1.70,1.35,239,160,309,54,17,37,35,18,17,15,7,8,+7,+2,+5,74%,61%,87%,158,113,202,39%,46%,36%,8,2,6,1,0,1
392,https://vlr.gg/player/29123/kivary,2025-03-07 16:05:00,1.17,1.27,1.22,230,201,251,51,24,27,41,20,21,21,14,7,+5,+3,+2,79%,77%,81%,148,131,164,25%,25%,24%,9,4,5,4,1,3
393,https://vlr.gg/player/8730/1kuzohh,2025-03-07 16:05:00,1.08,0.93,1.00,210,243,177,46,26,20,43,23,20,9,6,3,+13,+9,+4,77%,77%,77%,127,145,108,21%,24%,16%,17,10,7,4,1,3
394,https://vlr.gg/player/41128/mathi,2025-03-07 16:05:00,1.04,0.86,0.95,175,188,169,38,21,17,41,21,20,24,11,13,-2,-2,0,76%,84%,68%,117,114,119,29%,30%,28%,1,0,1,3,2,1
395,https://vlr.gg/player/45955/ego1st,2025-03-07 16:05:00,0.95,0.85,0.90,187,210,166,40,23,17,43,23,20,14,7,7,-3,-3,0,66%,68%,65%,132,144,120,37%,42%,33%,6,4,2,9,7,2
396,https://vlr.gg/player/43926/crazy-ny,2025-03-07 16:05:00,1.11,1.50,1.31,248,206,310,58,24,34,42,21,21,15,6,9,+3,-2,+5,74%,74%,74%,161,131,190,30%,25%,34%,5,0,5,2,2,0
397,https://vlr.gg/player/3677/fross,2025-03-07 16:05:00,1.12,1.02,1.07,213,219,211,47,24,23,48,24,24,22,15,7,+1,+2,-1,71%,74%,68%,138,139,137,23%,22%,24%,4,3,1,3,1,2
398,https://vlr.gg/player/33070/khz,2025-03-07 16:05:00,0.66,1.00,0.83,170,156,188,38,16,22,43,24,19,12,8,4,-7,-4,-3,65%,68%,61%,112,101,123,28%,34%,23%,4,2,2,11,6,5
399,https://vlr.gg/player/11046/deigara,2025-03-07 16:05:00,0.83,0.68,0.76,145,150,137,30,16,14,45,22,23,17,10,7,-5,-2,-3,69%,74%,65%,96,98,95,29%,24%,34%,2,1,1,7,3,4
400,https://vlr.gg/player/35665/miyeon,2025-03-07 16:05:00,0.69,0.46,0.57,146,170,124,30,18,12,51,27,24,12,8,4,-12,-5,-7,61%,68%,55%,96,110,81,15%,15%,16%,6,4,2,18,9,9
401,https://vlr.gg/player/8892/snw,2025-03-07 14:00:00,2.03,2.00,2.01,329,362,324,36,6,30,10,2,8,8,1,7,+8,+1,+7,96%,100%,96%,214,199,217,20%,50%,14%,9,1,8,1,0,1
402,https://vlr.gg/player/12872/david,2025-03-07 14:00:00,1.08,1.68,1.59,273,199,286,29,2,27,13,3,10,16,4,12,+3,0,+3,93%,75%,96%,169,133,175,19%,21%,19%,3,0,3,0,0,0
403,https://vlr.gg/player/13860/rubkkoide,2025-03-07 14:00:00,1.99,1.21,1.32,229,260,225,24,4,20,14,1,13,15,5,10,+2,0,+2,89%,100%,88%,144,136,145,27%,22%,27%,4,0,4,2,0,2
404,https://vlr.gg/player/2931/vaiz,2025-03-07 14:00:00,1.32,1.10,1.13,193,211,190,21,4,17,14,2,12,13,1,12,-1,0,-1,89%,75%,92%,131,115,133,17%,18%,17%,1,0,1,2,0,2
405,https://vlr.gg/player/783/murizzz,2025-03-07 14:00:00,0.84,0.98,0.96,210,210,210,22,4,18,19,3,16,7,0,7,0,+1,-1,89%,75%,92%,146,103,153,23%,60%,20%,3,2,1,3,1,2
406,https://vlr.gg/player/15542/gio,2025-03-07 14:00:00,0.99,0.28,0.89,194,211,93,20,19,1,27,23,4,6,6,0,-2,-1,-1,75%,75%,75%,120,129,70,23%,23%,25%,1,1,0,3,2,1
407,https://vlr.gg/player/33566/ganter,2025-03-07 14:00:00,0.78,0.52,0.73,171,176,142,16,14,2,26,22,4,3,3,0,-2,-3,+1,50%,50%,50%,101,106,76,34%,35%,29%,3,2,1,5,5,0
408,https://vlr.gg/player/36169/mta,2025-03-07 14:00:00,0.66,0.62,0.65,140,127,215,11,9,2,25,21,4,10,9,1,+2,+2,0,61%,58%,75%,91,83,137,28%,25%,43%,3,3,0,1,1,0
409,https://vlr.gg/player/38857/beng,2025-03-07 14:00:00,0.47,0.85,0.52,151,138,233,13,9,4,27,23,4,13,13,0,-2,-2,0,57%,54%,75%,100,90,159,22%,15%,50%,0,0,0,2,2,0
410,https://vlr.gg/player/41135/dantedeu5,2025-03-07 14:00:00,0.38,0.33,0.37,117,112,143,10,8,2,27,23,4,8,7,1,-8,-6,-2,64%,58%,100%,90,92,80,25%,22%,43%,1,1,0,9,7,2
411,https://vlr.gg/player/12795/crewen,2025-03-07 13:10:00,1.66,1.12,1.40,238,266,209,38,22,16,22,10,12,8,4,4,+4,+3,+1,78%,81%,74%,152,167,135,38%,34%,42%,4,3,1,0,0,0
412,https://vlr.gg/player/31305/lar0k,2025-03-07 13:10:00,1.57,1.11,1.36,265,300,230,40,26,14,25,12,13,10,1,9,+4,+2,+2,85%,86%,84%,174,192,154,33%,51%,19%,6,3,3,2,1,1
413,https://vlr.gg/player/40591/comeback,2025-03-07 13:10:00,1.21,1.15,1.18,227,234,221,35,19,16,25,13,12,6,3,3,+1,0,+1,78%,76%,79%,149,141,157,20%,27%,11%,6,3,3,5,3,2
414,https://vlr.gg/player/5565/ros,2025-03-07 13:10:00,0.69,1.19,0.93,181,144,221,25,9,16,28,16,12,14,9,5,-1,-1,0,78%,81%,74%,123,101,148,19%,12%,26%,4,1,3,5,2,3
415,https://vlr.gg/player/24344/loita,2025-03-07 13:10:00,0.61,0.84,0.72,135,100,170,17,6,11,26,14,12,15,10,5,-4,-3,-1,73%,81%,63%,97,75,120,31%,25%,35%,2,1,1,6,4,2
416,https://vlr.gg/player/12774/anima,2025-03-07 13:10:00,1.64,0.88,1.24,226,279,183,32,19,13,28,11,17,17,7,10,-1,0,-1,75%,74%,76%,144,162,127,23%,28%,18%,0,0,0,1,0,1
417,https://vlr.gg/player/8041/brave,2025-03-07 13:10:00,0.78,1.13,0.96,196,140,245,27,10,17,30,14,16,12,5,7,-2,-2,0,70%,58%,81%,131,100,158,29%,24%,31%,2,0,2,4,2,2
418,https://vlr.gg/player/10160/izzy,2025-03-07 13:10:00,0.79,0.85,0.82,180,155,208,27,12,15,31,14,17,7,1,6,+3,+1,+2,60%,63%,57%,121,97,142,24%,22%,24%,7,3,4,4,2,2
419,https://vlr.gg/player/10161/qutionerx,2025-03-07 13:10:00,0.69,0.84,0.77,170,176,162,21,10,11,32,17,15,8,5,3,+2,0,+2,58%,63%,52%,112,108,116,20%,24%,15%,7,4,3,5,4,1
420,https://vlr.gg/player/10163/cyderx,2025-03-07 13:10:00,0.69,0.56,0.62,150,174,128,19,10,9,34,17,17,11,8,3,-6,-2,-4,53%,58%,48%,100,119,82,22%,23%,21%,2,1,1,8,3,5
421,https://vlr.gg/player/13258/cyvoph,2025-03-07 11:00:00,2.24,1.69,2.00,326,366,293,57,35,22,22,11,11,24,14,10,+4,+3,+1,86%,92%,79%,209,229,184,38%,39%,35%,4,3,1,0,0,0
422,https://vlr.gg/player/1284/mikee,2025-03-07 11:00:00,1.35,0.78,1.10,185,211,152,27,18,9,26,13,13,26,16,10,+2,0,+2,86%,96%,74%,122,140,99,28%,31%,24%,5,2,3,3,2,1
423,https://vlr.gg/player/114/enzo,2025-03-07 11:00:00,0.72,1.52,1.07,196,108,301,28,8,20,25,14,11,15,8,7,0,-2,+2,74%,63%,89%,132,80,196,19%,21%,18%,4,1,3,4,3,1
424,https://vlr.gg/player/3582/keloqz,2025-03-07 11:00:00,1.01,1.12,1.05,273,270,255,41,24,17,33,19,14,7,3,4,+7,+3,+4,79%,79%,79%,166,170,160,19%,20%,17%,12,6,6,5,3,2
425,https://vlr.gg/player/113/hyp,2025-03-07 11:00:00,0.69,0.82,0.75,136,152,113,21,12,9,29,18,11,8,3,5,-2,-2,0,77%,75%,79%,83,96,67,14%,19%,7%,2,1,1,4,3,1
426,https://vlr.gg/player/2658/xuss,2025-03-07 11:00:00,1.33,0.97,1.13,253,268,252,39,18,21,35,13,22,8,3,5,+6,+3,+3,60%,68%,54%,161,175,150,41%,48%,32%,12,4,8,6,1,5
427,https://vlr.gg/player/4244/yaboilewis,2025-03-07 11:00:00,0.74,0.90,0.83,189,205,163,26,13,13,34,17,17,8,5,3,-6,-3,-3,63%,74%,54%,123,131,116,45%,52%,39%,1,0,1,7,3,4
428,https://vlr.gg/player/1457/mistic,2025-03-07 11:00:00,0.78,0.74,0.76,148,111,177,23,8,15,33,13,20,14,5,9,-4,-3,-1,67%,68%,67%,109,91,123,40%,28%,48%,0,0,0,4,3,1
429,https://vlr.gg/player/5292/al0rante,2025-03-07 11:00:00,0.97,0.55,0.74,168,212,144,27,15,12,36,16,20,5,3,2,-1,-1,0,58%,68%,50%,114,139,94,46%,47%,46%,3,1,2,4,2,2
430,https://vlr.gg/player/2690/hoody,2025-03-07 11:00:00,0.34,0.86,0.63,140,104,171,20,6,14,36,18,18,13,7,6,-6,-5,-1,63%,58%,67%,95,71,114,19%,22%,18%,0,0,0,6,5,1
431,https://vlr.gg/player/51696/synx,2025-03-07 07:35:00,1.39,0.64,0.91,216,337,163,31,18,13,32,10,22,4,1,3,+1,0,+1,64%,64%,64%,146,221,103,43%,51%,35%,7,2,5,6,2,4
432,https://vlr.gg/player/51695/gambo,2025-03-07 07:35:00,1.21,0.67,0.86,149,165,140,20,9,11,29,7,22,14,5,9,-3,-1,-2,59%,79%,48%,97,104,93,23%,23%,24%,0,0,0,3,1,2
433,https://vlr.gg/player/47825/prime,2025-03-07 07:35:00,0.93,0.70,0.78,147,122,163,17,5,12,30,8,22,10,4,6,+1,+1,0,46%,57%,40%,105,101,107,18%,21%,17%,3,1,2,2,0,2
434,https://vlr.gg/player/47099/roboxfer,2025-03-07 07:35:00,0.95,0.62,0.74,179,173,170,22,9,13,33,9,24,5,1,4,+1,+2,-1,56%,64%,52%,113,116,111,38%,29%,44%,3,2,1,2,0,2
435,https://vlr.gg/player/47824/homeboy,2025-03-07 07:35:00,0.80,0.60,0.66,135,189,124,19,9,10,30,10,20,6,3,3,+1,+2,-1,59%,71%,52%,92,104,86,23%,15%,33%,7,4,3,6,2,4
436,https://vlr.gg/player/2432/moner,2025-03-07 07:35:00,1.90,1.12,1.62,321,341,223,43,32,11,18,9,9,12,8,4,+2,+2,0,82%,88%,71%,199,230,142,26%,28%,21%,5,3,2,3,1,2
437,https://vlr.gg/player/1897/bgg,2025-03-07 07:35:00,1.53,1.02,1.35,251,248,214,35,24,11,19,8,11,7,6,1,+1,+2,-1,82%,88%,71%,147,155,133,28%,26%,33%,3,3,0,2,1,1
438,https://vlr.gg/player/3502/ri0,2025-03-07 07:35:00,1.40,0.67,1.14,188,237,112,26,21,5,20,11,9,13,9,4,-4,0,-4,82%,92%,64%,129,148,95,37%,35%,40%,1,1,0,5,1,4
439,https://vlr.gg/player/18702/deadly10,2025-03-07 07:35:00,0.95,1.07,0.99,177,149,206,23,13,10,25,15,10,19,17,2,+2,+1,+1,77%,84%,64%,119,106,140,26%,20%,36%,3,2,1,1,1,0
440,https://vlr.gg/player/28612/tricky,2025-03-07 07:35:00,0.95,0.68,0.85,179,205,136,27,20,7,27,16,11,7,4,3,-2,-2,0,72%,80%,57%,118,138,81,31%,32%,28%,7,5,2,9,7,2
441,https://vlr.gg/player/34776/absol,2025-03-07 04:40:00,1.17,1.06,1.12,229,260,221,51,29,22,45,25,20,12,9,3,+6,+4,+2,76%,79%,71%,147,152,141,22%,24%,20%,14,9,5,8,5,3
442,https://vlr.gg/player/1003/reita,2025-03-07 04:40:00,0.67,1.31,0.96,176,120,273,38,14,24,40,22,18,13,5,8,-2,-4,+2,66%,56%,79%,119,75,172,22%,14%,28%,4,0,4,6,4,2
443,https://vlr.gg/player/1395/tennn,2025-03-07 04:40:00,0.86,0.82,0.84,206,247,162,43,29,14,50,28,22,14,7,7,+2,+2,0,65%,71%,57%,138,163,108,25%,25%,24%,8,4,4,6,2,4
444,https://vlr.gg/player/23971/ask,2025-03-07 04:40:00,1.02,0.43,0.75,164,209,96,36,26,10,46,24,22,9,5,4,-3,+1,-4,65%,82%,43%,107,144,62,20%,26%,8%,3,3,0,6,2,4
445,https://vlr.gg/player/686/tonbo,2025-03-07 04:40:00,0.81,0.62,0.72,135,158,109,28,17,11,43,24,19,28,17,11,-1,-1,0,71%,79%,61%,88,101,72,25%,24%,26%,3,2,1,4,3,1
446,https://vlr.gg/player/993/medusa,2025-03-07 04:40:00,1.87,1.20,1.50,291,333,242,63,35,28,37,13,24,12,2,10,-1,-2,+1,74%,79%,71%,187,209,169,32%,32%,32%,7,3,4,8,5,3
447,https://vlr.gg/player/7745/yoshiii,2025-03-07 04:40:00,0.98,1.38,1.20,217,162,270,49,17,32,38,15,23,16,7,9,0,0,0,71%,71%,71%,140,109,165,29%,29%,30%,4,0,4,4,0,4
448,https://vlr.gg/player/4477/lob,2025-03-07 04:40:00,0.75,1.34,1.08,193,114,239,41,10,31,38,16,22,41,20,21,-2,-2,0,76%,82%,71%,106,69,138,30%,39%,26%,3,0,3,5,2,3
449,https://vlr.gg/player/6700/anthem,2025-03-07 04:40:00,1.11,0.83,0.96,171,188,155,36,19,17,37,15,22,30,15,15,-2,-1,-1,85%,93%,79%,112,118,107,18%,22%,15%,2,2,0,4,3,1
450,https://vlr.gg/player/687/zepher,2025-03-07 04:40:00,0.85,0.71,0.75,175,223,127,35,20,15,46,22,24,9,4,5,+3,+5,-2,63%,71%,56%,107,141,78,19%,22%,13%,14,9,5,11,4,7
451,https://vlr.gg/player/9290/madelyn,2025-03-07 04:30:00,1.48,1.22,1.35,238,284,203,47,26,21,32,15,17,25,11,14,0,0,0,89%,88%,89%,150,180,122,20%,22%,17%,3,1,2,3,1,2
452,https://vlr.gg/player/3626/lightningfast,2025-03-07 04:30:00,1.15,1.09,1.12,197,206,193,37,19,18,32,17,15,28,14,14,-3,0,-3,81%,85%,78%,131,128,135,33%,34%,32%,3,3,0,6,3,3
453,https://vlr.gg/player/1162/russ,2025-03-07 04:30:00,1.08,1.07,1.07,178,158,198,35,17,18,34,17,17,36,17,19,0,-1,+1,79%,73%,85%,110,106,113,32%,43%,25%,2,0,2,2,1,1
454,https://vlr.gg/player/4095/skrossi,2025-03-07 04:30:00,0.96,1.04,1.00,203,192,223,41,18,23,37,19,18,11,9,2,+4,+1,+3,77%,85%,70%,145,139,150,30%,30%,30%,9,4,5,5,3,2
455,https://vlr.gg/player/26829/damaraa,2025-03-07 04:30:00,0.61,1.13,0.87,221,177,270,38,15,23,48,23,25,17,3,14,+4,-2,+6,60%,54%,67%,141,116,166,23%,22%,23%,12,4,8,8,6,2
456,https://vlr.gg/player/27775/techno,2025-03-07 04:30:00,1.19,1.15,1.17,230,226,232,45,24,21,39,18,21,21,7,14,+1,-3,+4,77%,70%,85%,144,146,142,36%,33%,40%,6,2,4,5,5,0
457,https://vlr.gg/player/3627/hellff,2025-03-07 04:30:00,1.28,1.04,1.16,225,253,200,42,25,17,37,19,18,19,9,10,-1,-2,+1,72%,74%,69%,140,149,131,27%,30%,23%,4,1,3,5,3,2
458,https://vlr.gg/player/10749/k1ngkappa,2025-03-07 04:30:00,0.65,1.42,1.03,228,153,283,43,14,29,41,24,17,6,5,1,+2,+2,0,75%,70%,81%,130,93,169,29%,27%,31%,6,3,3,4,1,3
459,https://vlr.gg/player/36687/miz,2025-03-07 04:30:00,0.77,0.90,0.84,212,202,218,37,17,20,43,22,21,13,10,3,-6,-5,-1,72%,81%,62%,141,142,139,18%,19%,17%,6,2,4,12,7,5
460,https://vlr.gg/player/43390/d1sease,2025-03-07 04:30:00,0.82,0.37,0.60,106,141,71,16,12,4,39,20,19,32,12,20,-1,+1,-2,62%,67%,58%,70,89,50,26%,26%,26%,2,2,0,3,1,2
461,https://vlr.gg/player/45962/ken,2025-03-07 02:00:00,1.41,1.32,1.35,243,231,268,35,12,23,23,9,14,6,3,3,+5,+2,+3,77%,73%,79%,172,162,178,37%,33%,39%,9,4,5,4,2,2
462,https://vlr.gg/player/6702/bazz,2025-03-07 02:00:00,1.03,1.43,1.28,277,218,294,37,12,25,26,12,14,11,3,8,+1,-2,+3,82%,80%,83%,183,158,198,24%,26%,23%,5,0,5,4,2,2
463,https://vlr.gg/player/1009/sakurai,2025-03-07 02:00:00,1.05,1.12,1.09,207,198,197,29,12,17,21,9,12,9,3,6,+1,+1,0,85%,87%,83%,118,119,117,27%,34%,22%,3,1,2,2,0,2
464,https://vlr.gg/player/10642/jan,2025-03-07 02:00:00,1.09,1.03,1.05,196,219,165,25,11,14,23,10,13,22,11,11,0,-1,+1,82%,87%,79%,121,151,102,39%,46%,35%,2,0,2,2,1,1
465,https://vlr.gg/player/52723/yutaro,2025-03-07 02:00:00,0.76,1.22,1.04,171,152,182,25,8,17,20,10,10,7,1,6,+2,+1,+1,79%,60%,92%,112,93,123,22%,24%,22%,5,3,2,3,2,1
466,https://vlr.gg/player/40726/gwangboong,2025-03-07 02:00:00,0.91,1.38,1.09,234,231,304,32,16,16,30,19,11,9,5,4,+2,-1,+3,72%,67%,80%,159,145,181,35%,38%,31%,9,6,3,7,7,0
467,https://vlr.gg/player/10628/misaya,2025-03-07 02:00:00,0.67,1.21,0.87,181,152,233,21,9,12,30,21,9,18,12,6,-3,-2,-1,67%,58%,80%,125,111,147,19%,20%,19%,1,0,1,4,2,2
468,https://vlr.gg/player/29840/yuran,2025-03-07 02:00:00,0.93,0.71,0.84,160,174,134,22,16,6,29,17,12,11,1,10,-3,-3,0,62%,58%,67%,100,115,76,21%,26%,14%,2,0,2,5,3,2
469,https://vlr.gg/player/48431/kippei,2025-03-07 02:00:00,0.63,0.73,0.67,166,165,159,21,13,8,34,21,13,8,5,3,-2,-1,-1,56%,54%,60%,109,113,103,30%,30%,30%,2,2,0,4,3,1
470,https://vlr.gg/player/10769/nobita,2025-03-07 02:00:00,0.74,0.56,0.64,122,109,138,17,9,8,30,18,12,9,6,3,-3,-1,-2,49%,50%,47%,84,71,105,24%,33%,17%,1,0,1,4,1,3
471,https://vlr.gg/player/24013/navarro,2025-03-06 19:40:00,1.33,1.10,1.23,209,220,201,48,28,20,37,17,20,20,8,12,-2,0,-2,80%,79%,81%,141,147,134,20%,22%,18%,1,1,0,3,1,2
472,https://vlr.gg/player/17669/pompz,2025-03-06 19:40:00,1.17,1.29,1.22,243,194,298,52,24,28,39,19,20,25,14,11,+3,0,+3,82%,82%,81%,149,123,183,28%,27%,29%,5,1,4,2,1,1
473,https://vlr.gg/player/1328/javiierh,2025-03-06 19:40:00,1.02,1.31,1.15,196,174,215,39,20,19,37,21,16,39,18,21,+1,0,+1,77%,76%,78%,125,108,146,17%,24%,12%,6,3,3,5,3,2
474,https://vlr.gg/player/49571/paganus,2025-03-06 19:40:00,1.10,0.87,1.00,202,225,171,45,29,16,40,21,19,21,12,9,+2,+1,+1,82%,88%,74%,132,141,122,29%,28%,29%,4,2,2,2,1,1
475,https://vlr.gg/player/46891/sventy,2025-03-06 19:40:00,1.01,0.79,0.92,225,235,203,47,27,20,46,24,22,11,5,6,+7,+3,+4,75%,79%,70%,134,147,118,27%,24%,33%,20,12,8,13,9,4
476,https://vlr.gg/player/21428/crunch,2025-03-06 19:40:00,1.44,1.00,1.19,252,295,219,56,29,27,48,20,28,11,6,5,-5,-2,-3,74%,81%,68%,161,175,150,29%,25%,36%,9,5,4,14,7,7
477,https://vlr.gg/player/45921/v1bz,2025-03-06 19:40:00,1.00,0.98,0.99,198,202,193,47,21,26,46,22,24,21,14,7,+1,0,+1,74%,78%,71%,122,117,125,28%,25%,31%,6,2,4,5,2,3
478,https://vlr.gg/player/44075/dedmos,2025-03-06 19:40:00,1.07,0.76,0.90,190,224,164,38,22,16,45,20,25,31,11,20,+1,-1,+2,82%,81%,82%,132,150,118,25%,41%,16%,4,1,3,3,2,1
479,https://vlr.gg/player/50835/arbex,2025-03-06 19:40:00,0.67,0.95,0.82,160,115,201,31,11,20,43,18,25,26,8,18,-6,-4,-2,69%,59%,76%,113,85,136,28%,31%,27%,1,0,1,7,4,3
480,https://vlr.gg/player/35619/sxnti,2025-03-06 19:40:00,0.69,0.58,0.62,117,140,109,26,13,13,50,23,27,9,5,4,-2,0,-2,52%,59%,47%,80,84,76,31%,33%,29%,5,2,3,7,2,5
481,https://vlr.gg/player/41676/toronto,2025-03-06 17:40:00,1.41,0.80,1.01,204,257,155,24,12,12,28,8,20,15,6,9,+2,-1,+3,70%,85%,63%,141,199,110,39%,50%,31%,3,0,3,1,1,0
482,https://vlr.gg/player/32801/turkish,2025-03-06 17:40:00,1.11,0.94,1.00,228,236,212,29,12,17,30,9,21,5,2,3,-2,-1,-1,70%,85%,63%,139,136,141,45%,50%,43%,2,1,1,4,2,2
483,https://vlr.gg/player/41864/rodd,2025-03-06 17:40:00,0.75,0.95,0.88,205,200,225,27,8,19,32,11,21,10,6,4,-5,-3,-2,62%,77%,54%,132,127,135,26%,27%,25%,5,1,4,10,4,6
484,https://vlr.gg/player/22914/hiiik,2025-03-06 17:40:00,0.58,0.84,0.73,158,149,177,22,7,15,34,12,22,16,4,12,-1,+1,-2,65%,62%,67%,108,85,121,40%,28%,46%,2,2,0,3,1,2
485,https://vlr.gg/player/23855/str0nda,2025-03-06 17:40:00,1.16,0.44,0.68,125,152,130,18,8,10,29,7,22,12,6,6,-3,-1,-2,59%,69%,54%,84,87,83,35%,18%,48%,2,0,2,5,1,4
486,https://vlr.gg/player/37354/basic,2025-03-06 17:40:00,1.62,1.24,1.49,247,287,194,34,25,9,19,11,8,26,17,9,+2,0,+2,84%,83%,85%,160,190,105,33%,48%,9%,2,0,2,0,0,0
487,https://vlr.gg/player/22964/forbanz,2025-03-06 17:40:00,1.64,0.62,1.28,333,384,186,41,35,6,31,18,13,10,2,8,+8,+6,+2,86%,88%,85%,199,230,142,31%,38%,11%,13,10,3,5,4,1
488,https://vlr.gg/player/23832/lucks,2025-03-06 17:40:00,1.33,1.00,1.21,226,240,171,32,22,10,21,12,9,8,6,2,-1,-1,0,81%,88%,69%,148,158,131,50%,49%,52%,1,1,0,2,2,0
489,https://vlr.gg/player/1684/denaro,2025-03-06 17:40:00,0.59,1.89,1.05,173,109,304,26,10,16,23,16,7,11,6,5,0,-1,+1,81%,75%,92%,118,76,195,23%,21%,25%,2,1,1,2,2,0
490,https://vlr.gg/player/27149/brinks,2025-03-06 17:40:00,0.83,0.65,0.77,174,172,154,20,14,6,26,16,10,13,9,4,0,0,0,84%,88%,77%,104,109,94,28%,25%,35%,5,2,3,5,2,3
491,https://vlr.gg/player/31476/mephisto,2025-03-06 17:00:00,1.34,1.42,1.38,286,292,295,52,27,25,34,18,16,4,3,1,+5,+4,+1,67%,65%,70%,188,181,196,25%,27%,22%,13,7,6,8,3,5
492,https://vlr.gg/player/15931/peloncito,2025-03-06 17:00:00,1.28,1.29,1.29,252,245,260,40,21,19,36,19,17,22,9,13,-2,-1,-1,78%,73%,83%,167,153,183,26%,31%,21%,3,2,1,5,3,2
493,https://vlr.gg/player/26757/otaq,2025-03-06 17:00:00,1.10,0.79,0.96,178,224,135,31,21,10,35,18,17,16,9,7,-2,0,-2,76%,73%,78%,113,135,89,12%,10%,18%,5,4,1,7,4,3
494,https://vlr.gg/player/10582/panaek,2025-03-06 17:00:00,0.75,1.14,0.94,162,137,199,29,13,16,34,18,16,9,5,4,-1,-1,0,67%,58%,78%,121,97,149,30%,35%,27%,3,1,2,4,2,2
495,https://vlr.gg/player/10581/ryu,2025-03-06 17:00:00,0.71,0.93,0.82,143,101,181,25,10,15,35,18,17,21,6,15,-1,0,-1,59%,50%,70%,91,74,109,37%,29%,46%,0,0,0,1,0,1
496,https://vlr.gg/player/39538/bull3tz,2025-03-06 17:00:00,1.12,1.28,1.21,255,218,272,44,19,25,32,16,16,17,13,4,0,-1,+1,73%,74%,73%,169,155,182,28%,21%,35%,3,1,2,3,2,1
497,https://vlr.gg/player/2753/bandicoot,2025-03-06 17:00:00,1.25,0.84,1.03,182,207,168,32,18,14,31,14,17,13,6,7,-1,-1,0,67%,70%,65%,140,152,129,32%,36%,29%,2,1,1,3,2,1
498,https://vlr.gg/player/10556/drakk,2025-03-06 17:00:00,0.85,0.84,0.85,212,208,229,37,16,21,39,18,21,7,4,3,+3,+2,+1,69%,78%,62%,129,126,131,25%,27%,23%,12,4,8,9,2,7
499,https://vlr.gg/player/35583/edu,2025-03-06 17:00:00,0.65,0.96,0.81,186,166,196,29,13,16,36,18,18,17,8,9,-3,-1,-2,71%,74%,69%,113,96,127,42%,54%,35%,2,2,0,5,3,2
500,https://vlr.gg/player/7618/theory,2025-03-06 17:00:00,0.81,0.71,0.75,183,200,165,32,17,15,39,19,20,12,6,6,+2,+4,-2,61%,70%,54%,114,122,107,59%,62%,56%,6,5,1,4,1,3
0,https://vlr.gg/player/2909/alca,2025-03-06 16:05:00,0.65,0.96,0.75,146,125,190,17,8,9,30,16,14,12,6,6,+2,0,+2,56%,63%,47%,108,86,135,39%,30%,53%,4,0,4,2,0,2
1,https://vlr.gg/player/43935/ruso,2025-03-06 16:05:00,0.97,0.46,0.74,188,226,137,22,15,7,30,16,14,1,0,1,-1,0,-1,56%,63%,47%,113,140,79,41%,38%,50%,0,0,0,1,0,1
2,https://vlr.gg/player/2848/sh0twell,2025-03-06 16:05:00,0.46,1.06,0.72,151,107,216,17,5,12,28,17,11,14,8,6,-4,-2,-2,56%,47%,67%,99,73,131,22%,14%,30%,2,2,0,6,4,2
3,https://vlr.gg/player/8278/knzy,2025-03-06 16:05:00,0.44,1.00,0.68,153,109,219,17,6,11,30,18,12,16,11,5,-1,-3,+2,65%,58%,73%,99,71,133,19%,11%,24%,3,0,3,4,3,1
4,https://vlr.gg/player/7652/tuli,2025-03-06 16:05:00,0.53,0.42,0.48,147,175,104,15,10,5,31,18,13,3,1,2,0,0,0,47%,53%,40%,93,108,74,31%,31%,29%,6,5,1,6,5,1
5,https://vlr.gg/player/2464/suther,2025-03-06 16:05:00,1.73,1.54,1.62,261,300,252,34,17,17,13,6,7,10,3,7,+2,+1,+1,91%,100%,84%,186,183,188,20%,22%,19%,3,1,2,1,0,1
6,https://vlr.gg/player/3828/tacolilla,2025-03-06 16:05:00,1.24,1.89,1.60,329,284,357,43,16,27,20,11,9,5,2,3,+3,+1,+2,91%,80%,100%,197,170,219,23%,26%,22%,8,4,4,5,3,2
7,https://vlr.gg/player/1294/nagz,2025-03-06 16:05:00,1.09,1.85,1.51,293,217,331,34,11,23,17,9,8,12,3,9,+5,0,+5,82%,73%,89%,170,154,183,20%,32%,14%,7,2,5,2,2,0
8,https://vlr.gg/player/2468/delz1k,2025-03-06 16:05:00,1.38,0.99,1.16,145,180,126,18,11,7,14,6,8,25,10,15,-3,-2,-1,82%,87%,79%,97,123,76,17%,30%,9%,0,0,0,3,2,1
9,https://vlr.gg/player/29244/mikey-tap,2025-03-06 16:05:00,0.54,0.90,0.74,149,133,154,20,9,11,24,12,12,11,3,8,-3,-1,-2,85%,73%,95%,96,81,109,26%,19%,35%,1,0,1,4,1,3
10,https://vlr.gg/player/13093/jzz,2025-03-06 15:00:00,1.32,1.34,1.33,270,260,282,47,24,23,33,17,16,13,3,10,+6,+5,+1,75%,72%,78%,177,168,186,26%,29%,24%,8,5,3,2,0,2
11,https://vlr.gg/player/651/frz,2025-03-06 15:00:00,0.95,1.45,1.19,217,198,242,37,17,20,32,20,12,11,5,6,+3,+1,+2,79%,68%,91%,149,140,158,24%,26%,23%,5,2,3,2,1,1
12,https://vlr.gg/player/8872/mazin,2025-03-06 15:00:00,0.80,1.47,1.12,188,168,201,32,13,19,27,17,10,13,7,6,+2,-1,+3,73%,72%,74%,129,117,141,36%,33%,38%,3,0,3,1,1,0
13,https://vlr.gg/player/1581/guhrvn,2025-03-06 15:00:00,0.94,1.06,1.00,184,196,169,30,16,14,32,19,13,26,12,14,+1,+3,-2,71%,72%,70%,113,116,109,23%,23%,22%,4,4,0,3,1,2
14,https://vlr.gg/player/1575/quick,2025-03-06 15:00:00,0.71,1.20,0.95,202,182,232,32,15,17,34,20,14,15,5,10,-2,-3,+1,65%,52%,78%,133,120,146,26%,30%,22%,9,4,5,11,7,4
15,https://vlr.gg/player/33121/stwz1,2025-03-06 15:00:00,1.08,1.05,1.06,193,211,184,31,17,14,36,17,19,37,12,25,-1,0,-1,83%,78%,88%,132,138,127,33%,50%,21%,2,2,0,3,2,1
16,https://vlr.gg/player/44448/insano,2025-03-06 15:00:00,0.43,1.56,1.02,226,131,307,38,10,28,34,20,14,8,3,5,-3,-2,-1,60%,39%,80%,146,88,198,30%,32%,30%,5,2,3,8,4,4
17,https://vlr.gg/player/28715/hunterx,2025-03-06 15:00:00,0.99,0.95,0.97,189,197,179,31,15,16,32,16,16,11,8,3,-3,-1,-2,65%,70%,60%,130,138,122,24%,26%,22%,3,1,2,6,2,4
18,https://vlr.gg/player/23010/nicksz,2025-03-06 15:00:00,0.91,0.93,0.92,184,191,180,32,16,16,36,19,17,11,4,7,+1,+1,0,67%,57%,76%,117,124,110,28%,43%,19%,5,3,2,4,2,2
19,https://vlr.gg/player/32732/yeah,2025-03-06 15:00:00,0.25,0.97,0.62,165,105,221,26,7,19,40,21,19,5,1,4,-4,-3,-1,56%,39%,72%,111,78,140,25%,19%,28%,4,1,3,8,4,4
20,https://vlr.gg/player/11105/rich,2025-03-06 15:00:00,1.43,1.45,1.44,268,234,313,42,20,22,25,11,14,12,8,4,+3,+1,+2,81%,91%,70%,179,159,202,42%,53%,35%,3,1,2,0,0,0
21,https://vlr.gg/player/1671/kon4n,2025-03-06 15:00:00,1.67,0.91,1.31,193,255,114,30,22,8,19,9,10,10,7,3,+3,+3,0,79%,87%,70%,126,167,78,23%,22%,26%,4,3,1,1,0,1
22,https://vlr.gg/player/3455/zanatsu,2025-03-06 15:00:00,0.94,1.24,1.08,277,274,274,42,22,20,34,19,15,6,5,1,+5,+1,+4,74%,70%,80%,171,173,168,29%,25%,36%,12,6,6,7,5,2
23,https://vlr.gg/player/13823/pxs,2025-03-06 15:00:00,1.08,0.88,0.99,191,201,184,29,17,12,28,14,14,15,8,7,0,0,0,81%,91%,70%,134,133,136,35%,33%,37%,3,2,1,3,2,1
24,https://vlr.gg/player/3157/gaabxx,2025-03-06 15:00:00,0.96,0.93,0.94,140,145,139,23,11,12,22,12,10,12,8,4,-4,-2,-2,79%,87%,70%,90,100,78,14%,17%,11%,3,1,2,7,3,4
25,https://vlr.gg/player/47551/sanoj,2025-03-06 15:00:00,1.13,0.88,0.99,247,285,213,35,19,16,37,16,21,3,0,3,+4,0,+4,70%,60%,78%,152,176,132,31%,28%,35%,7,2,5,3,2,1
26,https://vlr.gg/player/41225/kramarick,2025-03-06 15:00:00,0.90,0.88,0.89,196,191,200,29,14,15,31,14,17,13,5,8,+1,+1,0,65%,55%,74%,123,126,120,35%,47%,27%,4,2,2,3,1,2
27,https://vlr.gg/player/50786/renna,2025-03-06 15:00:00,0.96,0.80,0.87,175,172,181,24,11,13,33,14,19,6,1,5,-2,-2,0,60%,55%,65%,121,110,130,22%,20%,24%,0,0,0,2,2,0
28,https://vlr.gg/player/41466/mixyce,2025-03-06 15:00:00,0.58,0.77,0.69,142,129,152,20,8,12,33,15,18,8,4,4,-2,0,-2,60%,55%,65%,105,92,116,25%,25%,25%,3,2,1,5,2,3
29,https://vlr.gg/player/45864/bruxo,2025-03-06 15:00:00,0.65,0.59,0.62,131,150,118,20,11,9,32,15,17,4,2,2,-8,-3,-5,51%,60%,43%,92,95,88,39%,48%,33%,4,2,2,12,5,7
30,https://vlr.gg/player/12672/bia,2025-03-06 14:00:00,1.42,1.25,1.34,270,285,261,55,29,26,31,15,16,3,2,1,+12,+7,+5,75%,79%,71%,178,180,176,27%,23%,32%,14,7,7,2,0,2
31,https://vlr.gg/player/31114/frandina,2025-03-06 14:00:00,1.13,1.50,1.31,253,216,290,54,23,31,35,19,16,14,8,6,+2,+3,-1,88%,89%,86%,165,146,184,30%,31%,29%,7,4,3,5,1,4
32,https://vlr.gg/player/19775/j4h-x,2025-03-06 14:00:00,1.12,1.30,1.21,227,205,254,47,22,25,33,17,16,30,8,22,-3,-2,-1,77%,68%,86%,144,131,158,36%,34%,38%,4,2,2,7,4,3
33,https://vlr.gg/player/51158/merlo,2025-03-06 14:00:00,1.27,0.90,1.08,208,247,164,43,26,17,33,16,17,13,6,7,-1,+1,-2,79%,82%,75%,132,153,111,30%,27%,34%,5,4,1,6,3,3
34,https://vlr.gg/player/45147/viperz,2025-03-06 14:00:00,0.87,1.14,1.00,178,173,178,35,18,17,35,20,15,26,10,16,-2,-3,+1,73%,75%,71%,119,113,126,33%,45%,23%,2,0,2,4,3,1
35,https://vlr.gg/player/33501/sword,2025-03-06 14:00:00,0.89,1.25,1.07,224,190,268,44,18,26,45,23,22,9,4,5,-4,-2,-2,66%,61%,71%,157,129,186,25%,32%,21%,2,1,1,6,3,3
36,https://vlr.gg/player/30508/rickyvaila,2025-03-06 14:00:00,1.06,0.76,0.91,176,191,155,36,20,16,42,20,22,4,2,2,-1,+1,-2,55%,54%,57%,119,139,98,30%,41%,22%,3,2,1,4,1,3
37,https://vlr.gg/player/6069/kheops,2025-03-06 14:00:00,0.75,0.78,0.76,161,152,175,32,15,17,48,24,24,18,9,9,-2,-2,0,61%,68%,54%,110,115,105,34%,43%,28%,5,1,4,7,3,4
38,https://vlr.gg/player/9559/nk4y,2025-03-06 14:00:00,0.46,0.87,0.64,156,125,194,28,11,17,50,25,25,10,4,6,-1,0,-1,59%,61%,57%,108,87,128,31%,32%,30%,11,7,4,12,7,5
39,https://vlr.gg/player/13234/summonn,2025-03-06 14:00:00,0.81,0.43,0.62,145,186,109,27,16,11,49,24,25,18,11,7,0,+1,-1,71%,75%,68%,94,116,71,26%,30%,19%,3,2,1,3,1,2
40,https://vlr.gg/player/29240/skyppervz,2025-03-06 14:00:00,0.80,1.27,1.03,205,186,229,30,15,15,32,17,15,8,3,5,0,0,0,63%,52%,75%,144,122,168,33%,29%,38%,3,2,1,3,2,1
41,https://vlr.gg/player/45955/ego1st,2025-03-06 14:00:00,1.16,0.70,0.93,183,189,176,26,15,11,31,14,17,8,5,3,-1,+1,-2,54%,57%,50%,119,116,121,34%,38%,31%,4,2,2,5,1,4
42,https://vlr.gg/player/41128/mathi,2025-03-06 14:00:00,1.00,0.70,0.85,161,161,162,23,12,11,33,15,18,14,6,8,+1,+3,-2,73%,67%,80%,102,100,104,28%,38%,19%,5,3,2,4,0,4
43,https://vlr.gg/player/29123/kivary,2025-03-06 14:00:00,0.69,0.91,0.80,163,146,183,23,11,12,33,17,16,15,8,7,-2,-2,0,73%,76%,70%,102,92,113,23%,19%,28%,2,1,1,4,3,1
44,https://vlr.gg/player/8730/1kuzohh,2025-03-06 14:00:00,0.67,0.81,0.74,179,167,190,23,10,13,32,16,16,6,4,2,-5,-5,0,63%,62%,65%,127,126,129,27%,24%,31%,3,1,2,8,6,2
45,https://vlr.gg/player/8892/snw,2025-03-06 14:00:00,1.56,1.67,1.62,361,351,373,54,26,28,28,13,15,6,1,5,+7,+1,+6,71%,65%,76%,227,218,235,21%,30%,16%,13,5,8,6,4,2
46,https://vlr.gg/player/13860/rubkkoide,2025-03-06 14:00:00,1.07,1.05,1.06,218,224,213,32,15,17,26,13,13,12,8,4,+1,+2,-1,76%,75%,76%,159,156,162,42%,63%,30%,3,3,0,2,1,1
47,https://vlr.gg/player/12872/david,2025-03-06 14:00:00,1.35,0.78,1.06,178,255,105,27,18,9,24,12,12,11,9,2,+2,+2,0,73%,90%,57%,123,179,71,32%,33%,30%,4,2,2,2,0,2
48,https://vlr.gg/player/783/murizzz,2025-03-06 14:00:00,0.67,1.28,0.98,150,109,189,24,8,16,24,13,11,12,7,5,-3,-1,-2,76%,75%,76%,109,73,143,43%,50%,39%,1,1,0,4,2,2
49,https://vlr.gg/player/2931/vaiz,2025-03-06 14:00:00,1.01,0.80,0.90,160,180,143,24,15,9,23,11,12,7,2,5,0,0,0,73%,75%,71%,118,133,105,31%,39%,23%,3,1,2,3,1,2
50,https://vlr.gg/player/10160/izzy,2025-03-06 12:45:00,0.99,1.44,1.19,249,232,283,43,22,21,30,19,11,6,5,1,+8,+4,+4,78%,78%,77%,156,144,170,31%,27%,35%,14,8,6,6,4,2
51,https://vlr.gg/player/12774/anima,2025-03-06 12:45:00,1.40,0.84,1.15,200,215,155,32,21,11,26,14,12,26,16,10,+1,+2,-1,80%,81%,77%,119,134,101,28%,27%,30%,2,2,0,1,0,1
52,https://vlr.gg/player/8041/brave,2025-03-06 12:45:00,1.15,1.04,1.10,181,187,181,29,16,13,27,14,13,23,17,6,+3,0,+3,84%,96%,68%,118,115,121,32%,31%,33%,4,1,3,1,1,0
53,https://vlr.gg/player/10163/cyderx,2025-03-06 12:45:00,1.15,0.85,1.01,204,227,166,36,23,13,32,16,16,12,9,3,-2,-2,0,80%,85%,73%,141,157,121,24%,26%,21%,2,0,2,4,2,2
54,https://vlr.gg/player/10161/qutionerx,2025-03-06 12:45:00,0.99,0.94,0.97,187,181,185,32,18,14,30,17,13,7,6,1,-1,-1,0,73%,81%,64%,126,130,121,29%,24%,38%,7,4,3,8,5,3
55,https://vlr.gg/player/2690/hoody,2025-03-06 12:45:00,1.05,1.00,1.02,177,182,179,32,15,17,32,14,18,15,6,9,+3,+1,+2,71%,68%,74%,112,119,106,22%,34%,15%,3,1,2,0,0,0
56,https://vlr.gg/player/4244/yaboilewis,2025-03-06 12:45:00,0.94,0.83,0.88,145,158,149,28,13,15,31,13,18,4,2,2,-3,-2,-1,71%,68%,74%,99,102,96,46%,35%,64%,1,0,1,4,2,2
57,https://vlr.gg/player/5292/al0rante,2025-03-06 12:45:00,0.87,0.88,0.87,212,227,208,35,17,18,42,18,24,12,6,6,-3,-2,-1,61%,64%,59%,137,146,130,48%,54%,43%,5,2,3,8,4,4
58,https://vlr.gg/player/1457/mistic,2025-03-06 12:45:00,0.71,0.88,0.80,146,89,206,23,6,17,30,12,18,21,12,9,-4,-3,-1,78%,68%,85%,106,64,140,37%,21%,47%,3,0,3,7,3,4
59,https://vlr.gg/player/2658/xuss,2025-03-06 12:45:00,0.88,0.59,0.72,156,173,138,27,14,13,37,15,22,7,5,2,-2,0,-2,59%,59%,59%,96,102,91,21%,14%,29%,8,5,3,10,5,5
60,https://vlr.gg/player/40591/comeback,2025-03-06 11:00:00,1.50,2.02,1.77,346,326,369,44,21,23,17,10,7,7,3,4,+3,-2,+5,79%,63%,94%,218,208,229,32%,39%,25%,6,1,5,3,3,0
61,https://vlr.gg/player/24344/loita,2025-03-06 11:00:00,1.15,1.82,1.49,261,193,323,35,12,23,17,9,8,23,10,13,+1,-1,+2,94%,88%,100%,156,120,190,48%,45%,50%,2,0,2,1,1,0
62,https://vlr.gg/player/31305/lar0k,2025-03-06 11:00:00,1.53,1.30,1.40,265,290,238,33,18,15,19,10,9,17,7,10,0,-1,+1,85%,88%,82%,157,174,141,28%,32%,23%,3,1,2,3,2,1
63,https://vlr.gg/player/12795/crewen,2025-03-06 11:00:00,1.58,1.12,1.34,230,267,196,27,16,11,15,7,8,12,6,6,+3,+3,0,94%,88%,100%,156,185,128,26%,30%,21%,5,4,1,2,1,1
64,https://vlr.gg/player/5565/ros,2025-03-06 11:00:00,0.94,0.78,0.86,117,148,90,14,9,5,16,9,7,8,5,3,0,-1,+1,79%,75%,82%,78,90,66,18%,9%,45%,4,1,3,4,2,2
65,https://vlr.gg/player/114/enzo,2025-03-06 11:00:00,0.81,0.86,0.84,202,210,197,20,10,10,29,14,15,6,4,2,0,-1,+1,52%,41%,63%,145,151,138,13%,13%,14%,1,0,1,1,1,0
66,https://vlr.gg/player/13258/cyvoph,2025-03-06 11:00:00,1.07,0.59,0.84,174,197,150,18,11,7,30,15,15,16,11,5,-1,-1,0,64%,71%,56%,109,118,99,32%,33%,30%,2,0,2,3,1,2
67,https://vlr.gg/player/3582/keloqz,2025-03-06 11:00:00,0.59,1.08,0.83,225,179,279,24,10,14,33,17,16,6,3,3,+2,-1,+3,64%,59%,69%,145,104,190,20%,16%,23%,9,4,5,7,5,2
68,https://vlr.gg/player/113/hyp,2025-03-06 11:00:00,0.51,0.44,0.48,102,87,119,11,5,6,29,14,15,8,4,4,-2,-2,0,52%,47%,56%,71,56,87,28%,10%,47%,1,0,1,3,2,1
69,https://vlr.gg/player/1284/mikee,2025-03-06 11:00:00,0.14,0.46,0.27,113,78,150,11,3,8,32,17,15,10,5,5,-6,-4,-2,52%,47%,56%,71,55,88,24%,23%,24%,0,0,0,6,4,2
70,https://vlr.gg/player/42521/jahbu,2025-03-06 11:00:00,1.41,1.14,1.29,230,245,209,84,48,36,56,31,25,11,5,6,+3,0,+3,72%,67%,77%,150,169,127,34%,38%,29%,12,5,7,9,5,4
71,https://vlr.gg/player/33840/lukyyy,2025-03-06 11:00:00,1.24,1.18,1.21,284,307,246,92,56,36,71,43,28,21,8,13,+2,0,+2,75%,73%,77%,185,200,166,20%,24%,14%,17,9,8,15,9,6
72,https://vlr.gg/player/2884/daniel0,2025-03-06 11:00:00,0.77,1.71,1.20,225,155,304,77,27,50,64,40,24,38,21,17,+1,+1,0,75%,67%,84%,143,93,201,26%,24%,28%,12,7,5,11,6,5
73,https://vlr.gg/player/16139/enrik,2025-03-06 11:00:00,0.67,1.18,0.91,161,139,194,54,22,32,63,39,24,48,20,28,-5,-5,0,72%,62%,84%,109,95,127,27%,24%,30%,3,1,2,8,6,2
74,https://vlr.gg/player/42519/lolito,2025-03-06 11:00:00,0.59,1.04,0.80,145,106,189,50,21,29,59,34,25,27,12,15,-2,0,-2,69%,58%,82%,98,72,129,38%,34%,41%,4,2,2,6,2,4
75,https://vlr.gg/player/2996/neiker,2025-03-06 11:00:00,0.84,1.26,1.07,212,184,235,71,27,44,71,36,35,29,8,21,+8,+1,+7,74%,68%,79%,137,123,148,44%,38%,48%,13,3,10,5,2,3
76,https://vlr.gg/player/6364/mishu,2025-03-06 11:00:00,0.60,1.19,0.91,195,154,244,71,24,47,72,37,35,14,4,10,0,-1,+1,65%,59%,69%,132,97,161,38%,59%,30%,8,5,3,8,6,2
77,https://vlr.gg/player/22501/amore,2025-03-06 11:00:00,0.59,1.10,0.87,194,163,224,64,23,41,74,40,34,16,4,12,-2,-2,0,65%,61%,67%,140,117,159,25%,28%,22%,16,7,9,18,9,9
78,https://vlr.gg/player/2893/hastack,2025-03-06 11:00:00,0.92,0.78,0.84,165,181,141,49,26,23,67,34,33,32,14,18,+4,+1,+3,71%,70%,71%,107,126,91,18%,17%,20%,8,4,4,4,3,1
79,https://vlr.gg/player/29958/ximy,2025-03-06 11:00:00,0.78,0.87,0.83,165,166,172,57,25,32,73,37,36,43,19,24,-9,-3,-6,69%,59%,77%,104,105,103,31%,40%,25%,3,1,2,12,4,8
80,https://vlr.gg/player/46058/s1mple,2025-03-06 07:00:00,0.95,1.07,1.01,210,206,217,33,16,17,35,18,17,18,10,8,-1,-2,+1,64%,73%,57%,147,142,152,40%,36%,44%,2,0,2,3,2,1
81,https://vlr.gg/player/43389/yash,2025-03-06 07:00:00,1.17,0.82,0.99,234,305,167,33,21,12,37,19,18,8,4,4,+3,+3,0,64%,64%,65%,167,212,125,27%,33%,18%,8,5,3,5,2,3
82,https://vlr.gg/player/27755/icarus,2025-03-06 07:00:00,1.09,0.81,0.94,187,220,156,28,15,13,33,15,18,12,7,5,+3,+2,+1,64%,73%,57%,124,144,105,28%,31%,24%,5,3,2,2,1,1
83,https://vlr.gg/player/4085/near,2025-03-06 07:00:00,0.86,0.78,0.82,154,159,151,28,15,13,33,16,17,8,4,4,-4,-4,0,56%,64%,48%,119,117,120,32%,27%,38%,1,0,1,5,4,1
84,https://vlr.gg/player/22054/wave,2025-03-06 07:00:00,0.36,0.64,0.50,130,85,173,21,7,14,36,17,19,9,6,3,-6,-5,-1,53%,45%,61%,83,58,108,13%,19%,10%,4,0,4,10,5,5
85,https://vlr.gg/player/30575/r1sen,2025-03-06 07:00:00,1.26,1.62,1.44,254,239,270,43,22,21,26,13,13,20,7,13,-1,-3,+2,73%,70%,77%,160,142,179,39%,51%,29%,5,3,2,6,6,0
86,https://vlr.gg/player/10760/smokea,2025-03-06 07:00:00,1.34,1.10,1.22,226,278,169,33,21,12,26,14,12,14,7,7,-1,0,-1,78%,83%,73%,161,185,135,29%,37%,20%,1,1,0,2,1,1
87,https://vlr.gg/player/19231/kibojn,2025-03-06 07:00:00,1.46,0.91,1.19,231,270,192,41,23,18,28,11,17,10,7,3,-2,-1,-1,80%,83%,77%,140,155,125,26%,28%,24%,3,0,3,5,1,4
88,https://vlr.gg/player/46104/envy2k,2025-03-06 07:00:00,0.88,1.22,1.04,241,203,281,36,16,20,34,18,16,12,3,9,+10,+3,+7,69%,70%,68%,154,116,195,22%,21%,23%,16,7,9,6,4,2
89,https://vlr.gg/player/30877/lilboii,2025-03-06 07:00:00,0.80,1.07,0.93,141,99,185,21,7,14,29,13,16,27,13,14,-1,0,-1,80%,83%,77%,90,61,120,30%,23%,34%,0,0,0,1,0,1
90,https://vlr.gg/player/50826/ramgi,2025-03-06 05:35:00,1.23,1.11,1.16,270,295,251,60,27,33,46,21,25,10,5,5,-1,-3,+2,67%,70%,65%,169,182,159,29%,33%,26%,9,3,6,10,6,4
91,https://vlr.gg/player/4130/rain,2025-03-06 05:35:00,0.76,1.36,1.11,230,167,296,49,15,34,50,23,27,22,4,18,+12,+3,+9,77%,70%,81%,163,107,203,21%,23%,21%,18,6,12,6,3,3
92,https://vlr.gg/player/9192/cloudy,2025-03-06 05:35:00,0.96,0.94,0.95,155,177,148,35,17,18,42,20,22,13,5,8,-1,-1,0,59%,56%,62%,109,117,103,41%,45%,37%,4,1,3,5,2,3
93,https://vlr.gg/player/4475/benecia,2025-03-06 05:35:00,0.70,1.06,0.91,182,157,190,39,15,24,46,21,25,27,10,17,+2,-1,+3,73%,67%,78%,110,95,122,21%,19%,23%,4,1,3,2,2,0
94,https://vlr.gg/player/50827/gnadel,2025-03-06 05:35:00,0.51,0.72,0.63,142,134,143,33,13,20,47,21,26,10,2,8,-2,-3,+1,58%,56%,59%,89,81,94,30%,31%,29%,2,0,2,4,3,1
95,https://vlr.gg/player/43057/dh,2025-03-06 05:35:00,1.21,1.41,1.30,298,293,290,64,36,28,45,27,18,15,7,8,-1,-4,+3,73%,65%,85%,200,193,210,34%,29%,42%,8,4,4,9,8,1
96,https://vlr.gg/player/806/moothie,2025-03-06 05:35:00,0.88,1.38,1.09,232,194,265,49,23,26,44,28,16,20,11,9,-2,-3,+1,73%,65%,85%,146,122,180,43%,36%,51%,2,0,2,4,3,1
97,https://vlr.gg/player/30556/exa,2025-03-06 05:35:00,1.01,0.95,0.98,165,160,186,42,24,18,39,22,17,15,8,7,-1,-2,+1,72%,76%,67%,117,110,127,22%,22%,23%,6,1,5,7,3,4
98,https://vlr.gg/player/4664/gangpin,2025-03-06 05:35:00,0.82,1.18,0.97,154,138,177,35,18,17,41,27,14,17,9,8,0,-1,+1,69%,68%,70%,106,102,112,25%,29%,21%,5,2,3,5,3,2
99,https://vlr.gg/player/29839/tenten,2025-03-06 05:35:00,0.98,0.89,0.94,188,193,186,41,24,17,47,25,22,18,8,10,-6,-5,-1,66%,62%,70%,134,137,130,18%,25%,9%,6,4,2,12,9,3
100,https://vlr.gg/player/27336/venka,2025-03-06 04:30:00,1.13,1.09,1.11,277,291,266,41,21,20,39,19,20,9,2,7,0,0,0,76%,68%,83%,185,186,184,40%,37%,44%,6,5,1,6,5,1
101,https://vlr.gg/player/3639/hoax,2025-03-06 04:30:00,0.93,0.97,0.95,186,178,190,28,13,15,35,17,18,15,8,7,+1,+1,0,67%,73%,61%,133,125,141,34%,33%,35%,4,2,2,3,1,2
102,https://vlr.gg/player/30693/makaveli,2025-03-06 04:30:00,0.87,0.87,0.87,171,187,157,28,14,14,33,17,16,8,5,3,-2,-1,-1,64%,59%,70%,112,117,107,25%,27%,23%,4,2,2,6,3,3
103,https://vlr.gg/player/12323/rvk,2025-03-06 04:30:00,0.87,0.86,0.87,171,168,174,23,12,11,34,16,18,17,6,11,-1,+1,-2,69%,68%,70%,123,117,128,28%,26%,29%,2,2,0,3,1,2
104,https://vlr.gg/player/26376/deecee,2025-03-06 04:30:00,0.44,1.00,0.73,161,97,222,26,9,17,36,18,18,7,1,6,-1,-1,0,53%,45%,61%,96,60,130,31%,35%,29%,5,0,5,6,1,5
105,https://vlr.gg/player/13221/azys,2025-03-06 04:30:00,1.48,1.57,1.52,307,308,307,53,28,25,27,15,12,6,2,4,+7,+5,+2,80%,78%,82%,199,185,215,37%,40%,35%,10,6,4,3,1,2
106,https://vlr.gg/player/9745/georggyyy,2025-03-06 04:30:00,1.22,1.40,1.31,257,230,288,41,19,22,30,16,14,23,16,7,-1,-1,0,64%,70%,59%,161,129,195,26%,24%,28%,7,4,3,8,5,3
107,https://vlr.gg/player/12947/rawfiul,2025-03-06 04:30:00,0.85,1.15,1.00,203,189,215,35,15,20,29,17,12,9,7,2,-4,-3,-1,84%,83%,86%,131,135,127,32%,33%,30%,3,1,2,7,4,3
108,https://vlr.gg/player/3628/deathmaker,2025-03-06 04:30:00,1.12,0.65,0.89,150,196,101,26,18,8,28,14,14,7,4,3,-1,+1,-2,69%,65%,73%,113,148,76,37%,33%,46%,1,1,0,2,0,2
109,https://vlr.gg/player/3269/antidote,2025-03-06 04:30:00,0.89,0.77,0.83,160,153,165,22,10,12,32,15,17,30,22,8,+2,+1,+1,87%,91%,82%,101,92,110,23%,18%,28%,3,1,2,1,0,1
110,https://vlr.gg/player/4657/moves,2025-03-06 03:00:00,1.45,0.86,1.21,240,281,179,32,23,9,30,17,13,22,11,11,-2,-2,0,83%,79%,88%,149,176,108,29%,28%,30%,1,1,0,3,3,0
111,https://vlr.gg/player/25053/wolverine,2025-03-06 03:00:00,1.04,1.33,1.16,232,205,266,33,17,16,30,18,12,9,7,2,+1,+2,-1,65%,63%,69%,156,133,189,41%,32%,55%,2,2,0,1,0,1
112,https://vlr.gg/player/9236/manggong,2025-03-06 03:00:00,0.71,0.84,0.76,170,163,179,24,14,10,32,20,12,13,9,4,-2,0,-2,78%,75%,81%,111,104,121,27%,26%,28%,1,0,1,3,0,3
113,https://vlr.gg/player/9221/kanade,2025-03-06 03:00:00,0.52,1.02,0.72,188,146,254,24,11,13,34,20,14,8,4,4,-5,-5,0,63%,54%,75%,129,96,180,29%,25%,33%,8,5,3,13,10,3
114,https://vlr.gg/player/20879/sungjin,2025-03-06 03:00:00,0.68,0.67,0.68,142,140,146,19,10,9,32,20,12,6,5,1,+2,+1,+1,60%,54%,69%,98,101,94,27%,30%,23%,5,2,3,3,1,2
115,https://vlr.gg/player/34982/athan,2025-03-06 03:00:00,1.75,1.33,1.49,243,263,236,39,18,21,21,7,14,15,4,11,+3,0,+3,85%,81%,88%,165,172,160,32%,30%,33%,3,0,3,0,0,0
116,https://vlr.gg/player/51100/flicker,2025-03-06 03:00:00,1.23,1.17,1.19,214,227,210,30,13,17,25,10,15,12,6,6,0,0,0,73%,69%,75%,141,135,145,22%,22%,22%,3,1,2,3,1,2
117,https://vlr.gg/player/4661/sacrifice,2025-03-06 03:00:00,0.57,1.40,1.07,231,179,260,32,9,23,29,15,14,6,4,2,+3,+1,+2,65%,44%,79%,149,111,175,31%,27%,34%,9,4,5,6,3,3
118,https://vlr.gg/player/51099/zynx,2025-03-06 03:00:00,0.89,1.12,1.03,210,218,204,32,13,19,27,13,14,8,1,7,+3,+1,+2,70%,69%,71%,141,148,137,38%,43%,35%,5,2,3,2,1,1
119,https://vlr.gg/player/51238/yong,2025-03-06 03:00:00,0.72,0.76,0.74,173,171,174,25,10,15,30,12,18,19,4,15,-3,0,-3,73%,69%,75%,98,98,98,36%,32%,39%,3,2,1,6,2,4
120,https://vlr.gg/player/38881/wetysao,2025-03-05 19:00:00,1.47,0.88,1.20,274,339,202,41,27,14,36,19,17,9,5,4,+3,+1,+2,78%,79%,76%,167,206,123,48%,44%,56%,7,4,3,4,3,1
121,https://vlr.gg/player/8781/charlslol,2025-03-05 19:00:00,0.90,0.89,0.89,162,139,185,25,11,14,32,14,18,11,8,3,-1,-1,0,58%,63%,52%,113,103,124,25%,24%,25%,1,1,0,2,2,0
122,https://vlr.gg/player/35559/pandejalea,2025-03-05 19:00:00,0.96,0.71,0.84,197,212,183,33,19,14,34,16,18,4,3,1,-7,-5,-2,62%,67%,57%,137,139,134,35%,31%,42%,5,2,3,12,7,5
123,https://vlr.gg/player/38912/yuno,2025-03-05 19:00:00,0.76,0.82,0.78,176,157,192,25,13,12,37,18,19,14,7,7,-2,-1,-1,67%,71%,62%,119,109,131,32%,28%,37%,5,2,3,7,3,4
124,https://vlr.gg/player/17676/dexuz,2025-03-05 19:00:00,0.79,0.40,0.61,105,113,102,16,10,6,34,15,19,6,4,2,-2,0,-2,51%,67%,33%,78,70,87,20%,12%,25%,0,0,0,2,0,2
125,https://vlr.gg/player/24026/generalsteak,2025-03-05 19:00:00,1.88,0.72,1.26,226,348,125,35,27,8,26,10,16,13,8,5,+1,+1,0,76%,90%,63%,161,227,103,38%,39%,36%,2,2,0,1,1,0
126,https://vlr.gg/player/42199/rei,2025-03-05 19:00:00,0.82,1.44,1.15,263,214,308,41,15,26,31,15,16,4,3,1,+4,+2,+2,73%,62%,83%,168,144,189,29%,27%,30%,11,8,3,7,6,1
127,https://vlr.gg/player/2995/maka,2025-03-05 19:00:00,1.52,0.82,1.15,219,259,185,33,20,13,30,10,20,28,16,12,+2,0,+2,84%,95%,75%,144,167,124,25%,25%,25%,7,1,6,5,1,4
128,https://vlr.gg/player/25097/solution,2025-03-05 19:00:00,1.22,1.03,1.12,184,199,172,32,17,15,25,11,14,12,6,6,0,+1,-1,80%,90%,71%,117,114,119,40%,35%,44%,3,1,2,3,0,3
129,https://vlr.gg/player/35567/toro,2025-03-05 19:00:00,0.89,1.06,0.98,207,197,208,32,13,19,29,14,15,10,7,3,+2,-1,+3,73%,81%,67%,126,130,123,22%,14%,32%,4,0,4,2,1,1
130,https://vlr.gg/player/9094/kess,2025-03-05 19:00:00,1.42,0.87,1.11,180,229,152,39,21,18,37,16,21,16,8,8,-4,0,-4,64%,69%,59%,130,157,107,26%,34%,19%,3,1,2,7,1,6
131,https://vlr.gg/player/862/b0i,2025-03-05 19:00:00,1.04,1.15,1.10,203,214,200,43,20,23,40,18,22,19,6,13,-2,0,-2,76%,81%,72%,126,128,125,27%,31%,24%,1,0,1,3,0,3
132,https://vlr.gg/player/48025/alym,2025-03-05 19:00:00,0.70,1.07,0.91,240,242,247,49,21,28,50,25,25,7,2,5,-4,-3,-1,64%,65%,63%,151,150,151,24%,22%,26%,11,6,5,15,9,6
133,https://vlr.gg/player/10053/fireballops,2025-03-05 19:00:00,1.01,0.72,0.85,199,222,178,37,20,17,49,22,27,17,7,10,-1,0,-1,64%,69%,59%,135,149,124,31%,45%,23%,3,1,2,4,1,3
134,https://vlr.gg/player/62/huynh,2025-03-05 19:00:00,0.20,0.78,0.49,116,81,146,24,8,16,47,23,24,18,4,14,-7,-7,0,60%,50%,69%,72,60,82,23%,32%,21%,2,0,2,9,7,2
135,https://vlr.gg/player/29893/timotino,2025-03-05 19:00:00,1.63,1.02,1.36,292,380,189,61,42,19,42,23,19,10,8,2,+7,+4,+3,76%,81%,69%,183,230,126,31%,31%,30%,14,9,5,7,5,2
136,https://vlr.gg/player/21878/snarly,2025-03-05 19:00:00,0.90,1.53,1.18,224,182,285,46,20,26,37,20,17,17,5,12,+5,+1,+4,71%,59%,85%,141,121,167,23%,19%,26%,8,3,5,3,2,1
137,https://vlr.gg/player/6437/dark3st,2025-03-05 19:00:00,0.81,1.47,1.10,236,155,320,49,18,31,40,22,18,23,10,13,+4,+2,+2,76%,72%,81%,141,99,194,20%,18%,22%,8,4,4,4,2,2
138,https://vlr.gg/player/5093/logan,2025-03-05 19:00:00,1.02,1.09,1.05,168,154,183,35,18,17,35,18,17,24,13,11,+1,0,+1,79%,81%,77%,114,103,129,22%,16%,29%,4,2,2,3,2,1
139,https://vlr.gg/player/754/nerve,2025-03-05 19:00:00,1.12,0.63,0.90,153,173,130,32,21,11,39,19,20,35,21,14,+1,+1,0,79%,78%,81%,95,105,83,25%,25%,25%,4,2,2,3,1,2
140,https://vlr.gg/player/8896/loweed,2025-03-05 17:45:00,1.28,0.66,1.02,225,246,191,29,20,9,33,17,16,12,7,5,+5,+2,+3,76%,79%,71%,137,148,121,23%,17%,34%,12,7,5,7,5,2
141,https://vlr.gg/player/6222/ginilson,2025-03-05 17:45:00,1.17,0.50,0.88,177,225,114,27,21,6,32,17,15,7,2,5,-1,-1,0,63%,67%,59%,115,136,85,27%,28%,25%,3,2,1,4,3,1
142,https://vlr.gg/player/5342/duht,2025-03-05 17:45:00,0.60,1.13,0.82,176,125,248,25,11,14,33,19,14,7,4,3,-2,-1,-1,68%,63%,76%,112,86,149,17%,14%,21%,3,1,2,5,2,3
143,https://vlr.gg/player/1999/rnd,2025-03-05 17:45:00,0.95,0.44,0.74,130,159,91,19,14,5,28,15,13,11,8,3,-1,0,-1,71%,71%,71%,87,105,62,26%,37%,13%,2,2,0,3,2,1
144,https://vlr.gg/player/16620/bruninej,2025-03-05 17:45:00,0.39,1.11,0.69,144,98,211,19,6,13,33,21,12,21,14,7,-2,0,-2,68%,63%,76%,97,65,142,21%,14%,26%,0,0,0,2,0,2
145,https://vlr.gg/player/46568/above,2025-03-05 17:45:00,1.47,1.40,1.43,243,257,239,38,18,20,19,8,11,12,2,10,-3,-2,-1,83%,82%,83%,152,157,149,36%,30%,40%,2,0,2,5,2,3
146,https://vlr.gg/player/25683/desire,2025-03-05 17:45:00,1.58,1.16,1.34,286,324,257,41,19,22,29,11,18,12,6,6,+2,+2,0,80%,100%,67%,190,210,175,43%,38%,49%,4,2,2,2,0,2
147,https://vlr.gg/player/15361/swag,2025-03-05 17:45:00,1.21,1.25,1.23,213,201,223,32,13,19,23,9,14,20,9,11,+1,+1,0,73%,71%,75%,148,148,149,22%,23%,21%,5,2,3,4,1,3
148,https://vlr.gg/player/36106/skz,2025-03-05 17:45:00,0.79,1.17,1.02,167,140,186,25,8,17,24,10,14,22,9,13,0,0,0,78%,76%,79%,108,77,130,32%,24%,36%,2,1,1,2,1,1
149,https://vlr.gg/player/37105/loss,2025-03-05 17:45:00,1.21,0.80,0.97,171,197,153,23,12,11,24,9,15,15,4,11,+1,0,+1,83%,82%,83%,110,140,88,20%,32%,13%,8,4,4,7,4,3
150,https://vlr.gg/player/844/bdog,2025-03-05 17:45:00,1.32,1.07,1.20,219,225,222,51,27,24,42,18,24,34,19,15,-2,-1,-1,80%,79%,81%,145,155,135,25%,25%,24%,5,2,3,7,3,4
151,https://vlr.gg/player/30470/kyu,2025-03-05 17:45:00,1.27,0.98,1.13,215,226,205,51,29,22,45,21,24,15,9,6,-7,-5,-2,74%,74%,75%,143,143,142,28%,22%,36%,1,0,1,8,5,3
152,https://vlr.gg/player/21659/sato,2025-03-05 17:45:00,1.06,0.79,0.93,233,243,218,52,29,23,54,25,29,13,6,7,-3,+1,-4,68%,71%,66%,147,159,134,30%,31%,30%,13,7,6,16,6,10
153,https://vlr.gg/player/8373/okeanos,2025-03-05 17:45:00,1.01,0.84,0.93,180,184,183,43,22,21,46,21,25,18,12,6,+1,0,+1,70%,74%,66%,112,118,107,34%,45%,25%,4,2,2,3,2,1
154,https://vlr.gg/player/34400/bao,2025-03-05 17:45:00,0.98,0.66,0.83,174,194,158,40,24,16,48,22,26,19,12,7,0,+1,-1,73%,82%,63%,118,126,110,28%,26%,31%,4,4,0,4,3,1
155,https://vlr.gg/player/15051/sacred,2025-03-05 17:45:00,1.44,1.00,1.21,238,295,185,57,33,24,46,22,24,23,17,6,+4,+3,+1,74%,88%,62%,157,186,129,28%,29%,28%,7,4,3,3,1,2
156,https://vlr.gg/player/4917/kaoticcc,2025-03-05 17:45:00,1.17,1.12,1.15,246,223,267,56,26,30,50,21,29,16,9,7,+8,+3,+5,76%,78%,74%,153,141,163,20%,18%,22%,15,7,8,7,4,3
157,https://vlr.gg/player/34057/jerrwin,2025-03-05 17:45:00,1.03,0.93,0.98,199,206,196,45,23,22,48,23,25,13,8,5,+1,+2,-1,74%,72%,76%,136,143,130,19%,26%,13%,10,6,4,9,4,5
158,https://vlr.gg/player/29688/mikee,2025-03-05 17:45:00,1.00,0.83,0.91,185,198,173,42,24,18,48,22,26,13,5,8,0,-1,+1,64%,63%,65%,124,128,121,32%,37%,28%,4,1,3,4,2,2
159,https://vlr.gg/player/3874/teague,2025-03-05 17:45:00,0.91,0.51,0.70,119,136,109,29,16,13,45,18,27,24,13,11,-2,0,-2,73%,84%,62%,81,95,68,23%,33%,14%,2,1,1,4,1,3
160,https://vlr.gg/player/9354/cebando,2025-03-05 17:00:00,1.44,1.68,1.57,275,271,280,36,17,19,17,9,8,19,7,12,+5,+2,+3,86%,82%,89%,175,181,169,39%,33%,47%,6,2,4,1,0,1
161,https://vlr.gg/player/10557/darker,2025-03-05 17:00:00,1.22,1.39,1.31,218,202,238,27,11,16,17,8,9,22,10,12,+2,0,+2,89%,88%,89%,135,120,149,29%,27%,30%,2,0,2,0,0,0
162,https://vlr.gg/player/8056/mited,2025-03-05 17:00:00,0.98,1.44,1.22,203,163,242,27,11,16,16,7,9,4,2,2,+4,+1,+3,89%,88%,89%,139,100,175,19%,6%,27%,4,1,3,0,0,0
163,https://vlr.gg/player/7616/feniz,2025-03-05 17:00:00,1.05,1.21,1.13,199,203,196,29,13,16,18,10,8,9,4,5,0,+1,-1,77%,76%,78%,126,130,122,25%,15%,38%,3,3,0,3,2,1
164,https://vlr.gg/player/3983/virtyy,2025-03-05 17:00:00,1.16,1.05,1.10,266,298,231,29,16,13,25,12,13,15,5,10,+10,+5,+5,80%,71%,89%,166,190,143,17%,28%,7%,13,7,6,3,2,1
165,https://vlr.gg/player/8790/mininiwde,2025-03-05 17:00:00,1.16,0.79,0.98,203,262,136,24,17,7,28,16,12,9,3,6,0,-1,+1,66%,67%,65%,131,181,77,27%,29%,24%,2,0,2,2,1,1
166,https://vlr.gg/player/36405/jrmzie,2025-03-05 17:00:00,0.98,0.98,0.98,230,270,186,26,15,11,29,17,12,4,2,2,-6,-4,-2,63%,50%,76%,151,171,130,33%,41%,24%,3,3,0,9,7,2
167,https://vlr.gg/player/17694/prask,2025-03-05 17:00:00,0.46,0.70,0.58,133,127,142,14,6,8,29,16,13,6,4,2,-2,-2,0,69%,67%,71%,100,100,100,24%,21%,27%,0,0,0,2,2,0
168,https://vlr.gg/player/8792/xhowi,2025-03-05 17:00:00,0.50,0.62,0.56,134,100,170,13,4,9,31,15,16,8,3,5,-6,-1,-5,43%,33%,53%,92,77,107,28%,29%,28%,1,0,1,7,1,6
169,https://vlr.gg/player/586/sickly,2025-03-05 17:00:00,0.20,0.67,0.43,119,64,180,16,5,11,33,16,17,5,2,3,-7,-4,-3,54%,44%,65%,78,43,115,38%,40%,37%,1,0,1,8,4,4
170,https://vlr.gg/player/1291/bnj,2025-03-05 16:45:00,1.02,1.03,1.02,190,204,177,24,11,13,28,15,13,16,8,8,-3,-1,-2,74%,68%,80%,126,136,117,23%,22%,25%,0,0,0,3,1,2
171,https://vlr.gg/player/2818/neto,2025-03-05 16:45:00,0.96,0.86,0.91,212,221,203,29,15,14,32,16,16,3,2,1,-8,-4,-4,62%,58%,65%,140,135,144,42%,47%,39%,4,3,1,12,7,5
172,https://vlr.gg/player/2586/hanling,2025-03-05 16:45:00,0.51,1.08,0.80,152,92,209,21,6,15,30,16,14,13,5,8,-2,-1,-1,62%,53%,70%,101,69,131,26%,26%,26%,2,1,1,4,2,2
173,https://vlr.gg/player/2403/mizu,2025-03-05 16:45:00,0.59,0.85,0.72,184,151,218,25,9,16,36,18,18,0,0,0,-1,0,-1,49%,42%,55%,113,101,125,39%,39%,39%,5,2,3,6,2,4
174,https://vlr.gg/player/15916/jotinha,2025-03-05 16:45:00,0.71,0.67,0.69,154,166,143,19,11,8,34,17,17,13,4,9,-3,-1,-2,64%,63%,65%,113,120,106,32%,48%,21%,0,0,0,3,1,2
175,https://vlr.gg/player/29242/erde,2025-03-05 16:45:00,0.86,1.85,1.34,236,116,365,36,7,29,23,12,11,21,13,8,+3,+1,+2,87%,75%,100%,161,79,248,28%,14%,35%,3,1,2,0,0,0
176,https://vlr.gg/player/29241/miradaninja,2025-03-05 16:45:00,1.00,1.60,1.29,228,191,265,33,14,19,21,13,8,12,7,5,+6,+1,+5,74%,70%,79%,146,132,161,21%,30%,16%,9,4,5,3,3,0
177,https://vlr.gg/player/21251/blowz,2025-03-05 16:45:00,1.40,1.14,1.28,212,233,189,28,17,11,19,10,9,18,6,12,+1,0,+1,79%,80%,79%,155,161,148,32%,29%,37%,2,1,1,1,1,0
178,https://vlr.gg/player/29243/neon,2025-03-05 16:45:00,1.54,0.92,1.24,242,306,175,35,23,12,24,13,11,8,4,4,+3,+3,0,82%,80%,84%,165,213,114,33%,44%,18%,7,4,3,4,1,3
179,https://vlr.gg/player/42867/ghoul33,2025-03-05 16:45:00,0.95,0.79,0.87,208,243,175,28,17,11,31,18,13,13,9,4,+4,+5,-1,79%,80%,79%,137,158,115,19%,22%,14%,7,5,2,3,0,3
180,https://vlr.gg/player/9837/flare,2025-03-05 16:00:00,1.56,1.44,1.48,238,213,249,32,9,23,17,3,14,14,7,7,-1,-1,0,89%,91%,88%,169,132,185,26%,21%,28%,2,1,1,3,2,1
181,https://vlr.gg/player/9063/infiltrator,2025-03-05 16:00:00,1.49,1.40,1.43,334,310,327,40,13,27,24,7,17,13,5,8,+5,+3,+2,86%,100%,79%,209,198,214,15%,12%,16%,10,3,7,5,0,5
182,https://vlr.gg/player/9835/ali,2025-03-05 16:00:00,1.58,1.32,1.40,276,270,272,32,10,22,23,7,16,23,9,14,+2,+2,0,83%,91%,79%,173,179,170,23%,18%,25%,4,2,2,2,0,2
183,https://vlr.gg/player/17865/nahsie,2025-03-05 16:00:00,1.42,0.87,1.04,149,172,137,21,9,12,18,4,14,14,5,9,+1,0,+1,77%,82%,75%,98,112,91,36%,24%,46%,1,0,1,0,0,0
184,https://vlr.gg/player/9017/moobs,2025-03-05 16:00:00,0.80,1.13,1.03,184,173,189,24,7,17,19,7,12,8,1,7,+2,+1,+1,71%,55%,79%,126,114,132,41%,53%,35%,5,2,3,3,1,2
185,https://vlr.gg/player/733/stellar,2025-03-05 16:00:00,1.11,0.74,0.99,166,191,140,22,16,6,27,17,10,13,11,2,0,+1,-1,71%,75%,64%,112,124,87,35%,39%,25%,3,3,0,3,2,1
186,https://vlr.gg/player/8742/jakee,2025-03-05 16:00:00,1.06,0.69,0.94,198,233,170,26,20,6,30,20,10,7,3,4,-3,-1,-2,60%,63%,55%,134,141,119,44%,44%,46%,4,3,1,7,4,3
187,https://vlr.gg/player/7716/penny,2025-03-05 16:00:00,0.69,1.00,0.79,184,177,203,20,13,7,31,22,9,15,11,4,-4,-2,-2,71%,67%,82%,126,124,131,17%,15%,20%,2,1,1,6,3,3
188,https://vlr.gg/player/69/thief,2025-03-05 16:00:00,0.77,0.61,0.72,179,180,172,21,15,6,30,21,9,7,5,2,-3,-2,-1,60%,63%,55%,105,105,105,23%,17%,43%,2,2,0,5,4,1
189,https://vlr.gg/player/739/fiziq,2025-03-05 16:00:00,0.43,0.35,0.40,110,119,113,11,8,3,31,21,10,8,5,3,+1,0,+1,57%,58%,55%,87,90,80,13%,17%,5%,2,1,1,1,1,0
190,https://vlr.gg/player/2486/pollo,2025-03-05 15:00:00,1.01,1.44,1.22,245,250,241,38,19,19,30,18,12,10,4,6,0,+1,-1,68%,59%,77%,166,165,167,34%,41%,28%,2,1,1,2,0,2
191,https://vlr.gg/player/41224/tkzin,2025-03-05 15:00:00,0.75,1.65,1.20,262,201,324,40,16,24,32,19,13,15,4,11,+2,-3,+5,68%,59%,77%,169,125,213,28%,28%,29%,11,3,8,9,6,3
192,https://vlr.gg/player/2567/liazzi,2025-03-05 15:00:00,0.97,1.08,1.03,162,184,140,25,14,11,26,16,10,15,9,6,+1,0,+1,75%,77%,73%,116,123,110,24%,27%,21%,3,1,2,2,1,1
193,https://vlr.gg/player/1578/shion,2025-03-05 15:00:00,1.15,0.82,0.99,174,188,161,30,16,14,27,13,14,14,10,4,0,0,0,66%,64%,68%,120,113,126,21%,26%,18%,3,2,1,3,2,1
194,https://vlr.gg/player/25858/sw,2025-03-05 15:00:00,0.94,0.67,0.81,186,223,150,28,17,11,34,18,16,13,7,6,+4,+3,+1,61%,68%,55%,122,134,110,37%,47%,25%,7,5,2,3,2,1
195,https://vlr.gg/player/5722/prince,2025-03-05 15:00:00,0.89,1.53,1.21,202,157,247,32,12,20,27,14,13,15,3,12,+2,+1,+1,80%,77%,82%,128,103,152,33%,42%,28%,3,1,2,1,0,1
196,https://vlr.gg/player/37098/tiezzi,2025-03-05 15:00:00,1.11,1.02,1.07,251,278,224,39,20,19,33,16,17,7,3,4,-7,-4,-3,73%,73%,73%,160,175,144,29%,34%,25%,6,4,2,13,8,5
197,https://vlr.gg/player/2585/tinchoff,2025-03-05 15:00:00,0.86,0.83,0.84,158,136,180,24,12,12,30,14,16,12,4,8,+1,0,+1,64%,68%,59%,104,100,108,45%,59%,35%,4,0,4,3,0,3
198,https://vlr.gg/player/945/drakonz,2025-03-05 15:00:00,0.77,0.86,0.82,180,163,197,27,12,15,35,17,18,12,5,7,0,0,0,75%,77%,73%,123,105,140,23%,26%,21%,2,1,1,2,1,1
199,https://vlr.gg/player/37091/peixeh,2025-03-05 15:00:00,0.45,0.92,0.69,159,118,200,22,8,14,36,18,18,19,5,14,-3,-2,-1,73%,64%,82%,105,79,132,29%,32%,27%,3,2,1,6,4,2
200,https://vlr.gg/player/11046/deigara,2025-03-05 14:20:00,1.24,1.58,1.42,279,226,335,45,16,29,29,12,17,14,7,7,+5,+4,+1,84%,81%,88%,174,139,204,25%,20%,28%,7,5,2,2,1,1
201,https://vlr.gg/player/43926/crazy-ny,2025-03-05 14:20:00,1.19,0.98,1.08,182,209,156,28,16,12,28,13,15,17,3,14,0,0,0,76%,67%,83%,132,156,111,26%,24%,29%,2,0,2,2,0,2
202,https://vlr.gg/player/3677/fross,2025-03-05 14:20:00,0.97,0.82,0.89,204,205,201,33,16,17,31,14,17,12,6,6,-5,0,-5,67%,71%,63%,132,127,136,15%,16%,14%,1,1,0,6,1,5
203,https://vlr.gg/player/35665/miyeon,2025-03-05 14:20:00,0.84,0.87,0.86,199,209,191,31,14,17,33,16,17,7,4,3,+3,+2,+1,73%,76%,71%,122,130,114,23%,23%,23%,10,5,5,7,3,4
204,https://vlr.gg/player/33070/khz,2025-03-05 14:20:00,0.72,0.80,0.76,190,174,197,31,13,18,35,17,18,7,4,3,+2,+1,+1,73%,71%,75%,125,119,130,32%,33%,31%,5,3,2,3,2,1
205,https://vlr.gg/player/41135/dantedeu5,2025-03-05 14:20:00,1.19,1.26,1.22,278,276,284,48,25,23,36,21,15,1,1,0,-1,0,-1,71%,75%,67%,173,168,179,29%,31%,28%,9,6,3,10,6,4
206,https://vlr.gg/player/38857/beng,2025-03-05 14:20:00,1.32,0.98,1.16,198,238,152,32,21,11,32,17,15,12,6,6,+2,+1,+1,69%,67%,71%,128,157,94,26%,27%,24%,3,1,2,1,0,1
207,https://vlr.gg/player/15542/gio,2025-03-05 14:20:00,0.87,1.29,1.06,172,148,196,25,10,15,31,18,13,29,19,10,-1,+1,-2,84%,83%,86%,116,98,136,23%,18%,28%,1,1,0,2,0,2
208,https://vlr.gg/player/33566/ganter,2025-03-05 14:20:00,0.95,0.95,0.95,190,176,202,29,15,14,31,17,14,9,4,5,-3,0,-3,58%,54%,62%,114,112,117,27%,34%,22%,2,2,0,5,2,3
209,https://vlr.gg/player/36169/mta,2025-03-05 14:20:00,0.65,0.55,0.60,157,167,146,22,13,9,38,20,18,20,8,12,-2,0,-2,76%,67%,86%,95,100,89,36%,38%,33%,5,3,2,7,3,4
210,https://vlr.gg/player/1457/mistic,2025-03-05 14:00:00,1.17,0.85,1.00,171,210,154,46,26,20,50,24,26,24,14,10,+5,+2,+3,71%,76%,68%,123,139,109,33%,30%,38%,5,2,3,0,0,0
211,https://vlr.gg/player/2658/xuss,2025-03-05 14:00:00,0.84,1.11,0.98,178,185,177,46,21,25,44,23,21,11,8,3,-4,-6,+2,67%,73%,62%,108,121,97,20%,21%,18%,10,4,6,14,10,4
212,https://vlr.gg/player/4244/yaboilewis,2025-03-05 14:00:00,0.88,0.90,0.89,193,178,194,44,21,23,50,23,27,12,3,9,+1,0,+1,66%,70%,62%,129,119,137,37%,39%,35%,6,2,4,5,2,3
213,https://vlr.gg/player/5292/al0rante,2025-03-05 14:00:00,1.03,0.72,0.86,180,202,164,46,25,21,53,23,30,9,3,6,0,0,0,70%,70%,70%,118,129,108,41%,51%,32%,8,3,5,8,3,5
214,https://vlr.gg/player/2690/hoody,2025-03-05 14:00:00,0.81,0.81,0.81,175,165,183,37,17,20,52,25,27,25,13,12,+6,+1,+5,66%,70%,62%,116,109,123,21%,21%,21%,10,4,6,4,3,1
215,https://vlr.gg/player/1470/simond4rk,2025-03-05 14:00:00,1.38,1.11,1.25,252,275,245,65,36,29,47,22,25,5,3,2,+8,+1,+7,67%,62%,73%,176,190,160,18%,20%,15%,15,5,10,7,4,3
216,https://vlr.gg/player/8226/waddle,2025-03-05 14:00:00,0.98,1.17,1.07,205,168,234,52,24,28,40,20,20,10,4,6,+2,0,+2,77%,81%,73%,125,104,148,36%,40%,34%,5,3,2,3,3,0
217,https://vlr.gg/player/1944/cayden,2025-03-05 14:00:00,1.11,0.99,1.05,173,146,200,44,21,23,38,17,21,24,12,12,-3,0,-3,83%,86%,79%,109,94,126,43%,46%,41%,1,0,1,4,0,4
218,https://vlr.gg/player/2190/baddyg,2025-03-05 14:00:00,1.01,1.00,1.00,206,198,192,48,26,22,46,23,23,24,12,12,-7,-5,-2,69%,68%,70%,123,123,123,26%,26%,27%,4,1,3,11,6,5
219,https://vlr.gg/player/12474/tag,2025-03-05 14:00:00,0.77,0.85,0.81,170,196,149,40,24,16,48,27,21,12,4,8,-8,-7,-1,67%,68%,67%,115,126,104,39%,33%,49%,6,4,2,14,11,3
220,https://vlr.gg/player/4521/unfake,2025-03-05 13:40:00,1.09,0.93,1.02,205,196,194,26,14,12,29,17,12,12,5,7,-1,0,-1,68%,62%,75%,124,135,110,28%,25%,32%,1,1,0,2,1,1
221,https://vlr.gg/player/565/starxo,2025-03-05 13:40:00,0.53,1.34,0.88,192,137,274,24,9,15,31,19,12,7,4,3,-1,-2,+1,68%,62%,75%,129,96,172,21%,23%,19%,2,0,2,3,2,1
222,https://vlr.gg/player/2653/jesse,2025-03-05 13:40:00,0.79,0.77,0.78,150,183,110,20,13,7,29,19,10,10,5,5,-6,-2,-4,62%,62%,63%,92,111,68,53%,65%,33%,1,1,0,7,3,4
223,https://vlr.gg/player/7162/wackie,2025-03-05 13:40:00,0.34,0.81,0.54,109,93,133,15,7,8,30,19,11,3,1,2,-1,-1,0,57%,43%,75%,78,69,91,38%,30%,47%,1,0,1,2,1,1
224,https://vlr.gg/player/440/akumaaaaa,2025-03-05 13:40:00,0.17,0.61,0.34,124,99,167,15,7,8,34,21,13,7,0,7,-4,-6,+2,51%,33%,75%,77,55,104,33%,44%,27%,7,3,4,11,9,2
225,https://vlr.gg/player/8041/brave,2025-03-05 13:40:00,1.51,1.65,1.59,271,267,261,38,17,21,19,10,9,16,3,13,+5,+2,+3,84%,75%,90%,182,185,179,36%,40%,33%,5,2,3,0,0,0
226,https://vlr.gg/player/10160/izzy,2025-03-05 13:40:00,1.46,1.60,1.54,260,237,269,39,16,23,18,8,10,6,1,5,+6,+2,+4,86%,75%,95%,176,163,186,29%,27%,31%,10,4,6,4,2,2
227,https://vlr.gg/player/10163/cyderx,2025-03-05 13:40:00,0.74,1.49,1.17,196,100,266,27,6,21,18,9,9,11,4,7,-2,-2,0,78%,75%,81%,128,68,175,15%,28%,11%,2,0,2,4,2,2
228,https://vlr.gg/player/12774/anima,2025-03-05 13:40:00,0.81,1.30,1.09,179,134,205,21,7,14,21,10,11,24,5,19,0,-1,+1,92%,88%,95%,111,85,131,26%,50%,20%,2,1,1,2,2,0
229,https://vlr.gg/player/10161/qutionerx,2025-03-05 13:40:00,0.83,1.21,1.05,205,217,206,28,12,16,24,13,11,13,3,10,+4,+1,+3,84%,75%,90%,141,145,138,35%,29%,41%,6,2,4,2,1,1
230,https://vlr.gg/player/17343/ness,2025-03-05 13:15:00,1.39,1.23,1.30,217,236,200,34,17,17,24,11,13,29,10,19,-2,-2,0,84%,85%,83%,138,152,126,36%,28%,46%,1,0,1,3,2,1
231,https://vlr.gg/player/19371/eva,2025-03-05 13:15:00,1.18,1.37,1.28,252,248,254,42,19,23,27,13,14,7,2,5,+4,+1,+3,73%,65%,79%,155,159,151,30%,42%,19%,5,2,3,1,1,0
232,https://vlr.gg/player/24107/sarah,2025-03-05 13:15:00,1.17,1.19,1.18,224,241,212,36,18,18,29,14,15,8,3,5,-3,-1,-2,68%,70%,67%,151,155,149,35%,43%,29%,2,1,1,5,2,3
233,https://vlr.gg/player/16418/smurfette,2025-03-05 13:15:00,0.69,1.12,0.93,236,213,257,38,15,23,36,18,18,2,1,1,-5,-6,+1,64%,60%,67%,162,144,177,35%,33%,36%,6,1,5,11,7,4
234,https://vlr.gg/player/30186/nami,2025-03-05 13:15:00,0.76,0.82,0.79,157,153,164,24,11,13,31,13,18,9,2,7,0,-2,+2,73%,70%,75%,106,99,111,35%,32%,38%,5,1,4,5,3,2
235,https://vlr.gg/player/37969/ellie,2025-03-05 13:15:00,1.08,0.93,1.01,240,236,251,37,20,17,36,18,18,9,6,3,+5,+1,+4,68%,67%,70%,155,147,165,38%,38%,37%,13,6,7,8,5,3
236,https://vlr.gg/player/17318/blossi,2025-03-05 13:15:00,0.92,0.89,0.90,200,220,178,31,20,11,35,19,16,16,6,10,0,-1,+1,70%,71%,70%,130,132,126,30%,32%,28%,2,0,2,2,1,1
237,https://vlr.gg/player/41207/jade,2025-03-05 13:15:00,0.89,0.82,0.86,196,191,198,28,16,12,36,19,17,24,12,12,+1,-1,+2,80%,88%,70%,122,131,111,34%,34%,34%,3,0,3,2,1,1
238,https://vlr.gg/player/19373/ginger,2025-03-05 13:15:00,0.51,1.22,0.83,180,129,245,27,9,18,34,19,15,9,8,1,0,-1,+1,64%,54%,75%,127,87,176,22%,17%,25%,4,3,1,4,4,0
239,https://vlr.gg/player/30042/harmonee,2025-03-05 13:15:00,0.70,0.79,0.74,153,160,143,24,13,11,33,19,14,12,7,5,0,-2,+2,68%,67%,70%,97,95,98,31%,31%,31%,3,1,2,3,3,0
240,https://vlr.gg/player/41197/thuy,2025-03-05 13:05:00,0.93,1.08,1.01,194,192,196,27,13,14,29,15,14,16,5,11,0,0,0,74%,63%,85%,117,112,122,32%,37%,29%,4,3,1,4,3,1
241,https://vlr.gg/player/16078/loupiote,2025-03-05 13:05:00,0.90,0.90,0.90,192,177,208,25,10,15,32,15,17,8,6,2,0,-1,+1,67%,63%,70%,125,122,129,37%,29%,46%,5,2,3,5,3,2
242,https://vlr.gg/player/17331/pinkalie,2025-03-05 13:05:00,0.68,0.79,0.74,141,107,173,19,8,11,32,15,17,16,4,12,-1,-1,0,64%,53%,75%,93,60,125,16%,12%,19%,1,0,1,2,1,1
243,https://vlr.gg/player/38142/dream,2025-03-05 13:05:00,0.57,0.78,0.67,145,93,194,19,6,13,29,13,16,3,3,0,-6,-2,-4,51%,47%,55%,95,60,128,21%,24%,20%,1,0,1,7,2,5
244,https://vlr.gg/player/43744/akita,2025-03-05 13:05:00,0.61,0.73,0.67,148,156,140,20,10,10,34,17,17,7,5,2,-2,-3,+1,59%,58%,60%,95,100,91,32%,27%,37%,4,1,3,6,4,2
245,https://vlr.gg/player/20064/vania,2025-03-05 13:05:00,1.31,1.77,1.53,296,267,329,39,18,21,21,12,9,9,4,5,+8,+3,+5,85%,85%,84%,200,173,228,30%,33%,28%,12,5,7,4,2,2
246,https://vlr.gg/player/16321/nelo,2025-03-05 13:05:00,1.31,1.60,1.45,254,232,276,39,19,20,20,12,8,4,0,4,+5,+3,+2,85%,85%,84%,168,146,190,34%,38%,31%,6,3,3,1,0,1
247,https://vlr.gg/player/24149/amy,2025-03-05 13:05:00,1.40,0.94,1.18,224,267,178,34,22,12,23,12,11,7,2,5,0,+1,-1,85%,85%,84%,149,173,124,34%,50%,20%,3,3,0,3,2,1
248,https://vlr.gg/player/17323/mimi,2025-03-05 13:05:00,1.08,1.08,1.08,189,199,178,26,12,14,22,12,10,19,12,7,-3,-2,-1,85%,80%,89%,133,151,114,21%,23%,18%,0,0,0,3,2,1
249,https://vlr.gg/player/17320/petra,2025-03-05 13:05:00,0.71,0.85,0.78,142,157,128,18,10,8,24,15,9,22,17,5,-1,-3,+2,82%,80%,84%,89,96,82,26%,26%,26%,3,0,3,4,3,1
250,https://vlr.gg/player/26632/joliinaa,2025-03-05 11:00:00,1.81,1.19,1.52,301,346,236,42,27,15,20,9,11,8,5,3,+6,+4,+2,77%,86%,67%,192,224,155,40%,43%,36%,10,8,2,4,4,0
251,https://vlr.gg/player/39506/cabbit,2025-03-05 11:00:00,1.81,0.82,1.35,231,308,139,33,24,9,21,9,12,8,6,2,-2,-1,-1,74%,86%,61%,153,203,94,32%,35%,24%,2,1,1,4,2,2
252,https://vlr.gg/player/45174/purity,2025-03-05 11:00:00,1.36,1.22,1.29,204,183,242,28,14,14,19,7,12,18,9,9,0,+1,-1,77%,86%,67%,135,131,140,20%,27%,15%,3,2,1,3,1,2
253,https://vlr.gg/player/20116/jademwah,2025-03-05 11:00:00,1.40,1.17,1.29,196,188,211,28,15,13,21,7,14,23,13,10,-2,-1,-1,90%,90%,89%,121,113,131,23%,24%,23%,2,0,2,4,1,3
254,https://vlr.gg/player/20058/devilasxa,2025-03-05 11:00:00,1.08,1.06,1.07,189,175,203,30,16,14,21,9,12,5,1,4,+1,0,+1,77%,71%,83%,126,126,126,48%,54%,43%,4,1,3,3,1,2
255,https://vlr.gg/player/40175/mayameow,2025-03-05 11:00:00,1.14,0.67,0.89,202,229,181,25,14,11,32,13,19,18,14,4,+6,+3,+3,64%,83%,48%,122,136,109,25%,28%,22%,8,5,3,2,2,0
256,https://vlr.gg/player/24140/superphrog,2025-03-05 11:00:00,1.38,0.40,0.85,168,258,99,27,20,7,31,12,19,3,2,1,-1,-1,0,51%,67%,38%,114,168,67,32%,29%,45%,6,2,4,7,3,4
257,https://vlr.gg/player/30060/alessia,2025-03-05 11:00:00,0.78,0.54,0.65,158,196,124,20,12,8,33,15,18,5,3,2,-1,0,-1,49%,56%,43%,108,126,92,36%,33%,39%,2,1,1,3,1,2
258,https://vlr.gg/player/29960/nidxvilco,2025-03-05 11:00:00,0.66,0.53,0.59,120,108,136,16,5,11,31,12,19,14,11,3,-2,0,-2,59%,67%,52%,76,83,71,26%,19%,35%,1,0,1,3,0,3
259,https://vlr.gg/player/30105/ikyoo,2025-03-05 11:00:00,0.76,0.26,0.49,114,152,80,14,10,4,34,13,21,12,6,6,-5,-2,-3,49%,67%,33%,89,112,69,35%,44%,23%,1,1,0,6,3,3
260,https://vlr.gg/player/17394/ninou,2025-03-05 11:00:00,1.42,1.23,1.32,278,326,252,40,21,19,33,16,17,19,7,12,+5,+1,+4,84%,79%,88%,185,200,172,21%,18%,25%,5,1,4,0,0,0
261,https://vlr.gg/player/24071/liza,2025-03-05 11:00:00,0.69,1.08,0.90,193,172,217,33,12,21,34,18,16,7,4,3,-2,-1,-1,58%,47%,67%,131,114,144,39%,33%,44%,4,2,2,6,3,3
262,https://vlr.gg/player/41196/ja2,2025-03-05 11:00:00,0.80,0.92,0.87,204,192,204,30,13,17,36,18,18,10,4,6,0,-2,+2,65%,68%,63%,118,118,118,25%,25%,24%,9,3,6,9,5,4
263,https://vlr.gg/player/17396/lirilia,2025-03-05 11:00:00,0.61,0.80,0.72,171,165,179,23,9,14,35,17,18,21,7,14,-3,-3,0,70%,63%,75%,106,101,109,18%,12%,24%,1,0,1,4,3,1
264,https://vlr.gg/player/20098/mel,2025-03-05 11:00:00,0.14,1.20,0.71,161,56,240,23,2,21,35,17,18,17,5,12,-1,-2,+1,56%,37%,71%,109,44,160,22%,5%,27%,2,0,2,3,2,1
265,https://vlr.gg/player/47911/berryx,2025-03-05 11:00:00,1.35,2.16,1.70,342,282,428,53,24,29,29,18,11,12,6,6,+6,+3,+3,81%,75%,89%,225,177,285,31%,35%,28%,10,5,5,4,2,2
266,https://vlr.gg/player/17408/lateu,2025-03-05 11:00:00,1.11,1.62,1.34,205,181,235,36,15,21,22,14,8,17,11,6,-1,-2,+1,81%,75%,89%,129,119,142,19%,18%,20%,1,0,1,2,2,0
267,https://vlr.gg/player/29442/wens,2025-03-05 11:00:00,1.18,0.70,0.97,212,246,170,30,20,10,34,19,15,16,6,10,-1,-2,+1,74%,67%,84%,151,169,127,33%,35%,29%,7,4,3,8,6,2
268,https://vlr.gg/player/46311/mimier,2025-03-05 11:00:00,0.57,1.42,0.94,198,152,242,32,14,18,31,21,10,10,4,6,-2,-4,+2,72%,67%,79%,140,114,173,26%,29%,23%,2,0,2,4,4,0
269,https://vlr.gg/player/17326/htm,2025-03-05 11:00:00,0.83,0.70,0.77,149,161,126,22,14,8,33,20,13,24,15,9,-1,-1,0,79%,79%,79%,97,112,78,42%,47%,35%,2,0,2,3,1,2
270,https://vlr.gg/player/7490/anguist,2025-03-05 11:00:00,0.62,1.58,1.04,195,135,287,46,16,30,40,27,13,20,9,11,-5,-6,+1,64%,56%,74%,133,94,182,32%,31%,32%,3,0,3,8,6,2
271,https://vlr.gg/player/4589/burzzy,2025-03-05 11:00:00,0.78,1.26,0.99,192,160,250,43,19,24,47,30,17,23,11,12,+3,-3,+6,75%,68%,85%,127,104,157,44%,43%,45%,8,0,8,5,3,2
272,https://vlr.gg/player/33358/shinnok,2025-03-05 11:00:00,0.84,1.12,0.97,180,180,182,36,20,16,39,25,14,14,6,8,+2,-3,+5,66%,62%,70%,120,118,123,26%,29%,21%,9,2,7,7,5,2
273,https://vlr.gg/player/7104/juseu,2025-03-05 11:00:00,0.62,1.16,0.86,179,175,198,38,20,18,43,31,12,8,5,3,-6,-6,0,69%,68%,70%,123,118,130,24%,20%,32%,3,2,1,9,8,1
274,https://vlr.gg/player/217/seider,2025-03-05 11:00:00,0.49,0.79,0.62,112,107,111,23,12,11,41,27,14,13,5,8,-3,-2,-1,67%,62%,74%,71,71,71,29%,31%,27%,3,3,0,6,5,1
275,https://vlr.gg/player/8805/sacake,2025-03-05 11:00:00,1.12,1.62,1.40,256,216,279,55,20,35,35,20,15,32,9,23,+3,0,+3,75%,63%,85%,155,127,177,31%,32%,30%,6,2,4,3,2,1
276,https://vlr.gg/player/16209/famsii,2025-03-05 11:00:00,1.08,1.35,1.23,235,198,248,50,19,31,39,17,22,18,4,14,+7,-1,+8,77%,63%,88%,149,133,161,35%,38%,32%,10,2,8,3,3,0
277,https://vlr.gg/player/18162/serial,2025-03-05 11:00:00,0.84,1.09,0.98,156,149,167,34,12,22,35,19,16,10,4,6,+1,-2,+3,79%,67%,88%,117,103,128,44%,41%,47%,5,0,5,4,2,2
278,https://vlr.gg/player/1524/h1ber,2025-03-05 11:00:00,0.44,1.31,0.92,148,100,183,32,8,24,35,21,14,22,8,14,-2,-3,+1,77%,59%,91%,102,69,128,27%,36%,23%,3,1,2,5,4,1
279,https://vlr.gg/player/29972/michel,2025-03-05 11:00:00,0.56,1.24,0.92,186,117,238,39,11,28,42,22,20,14,3,11,0,-5,+5,62%,44%,76%,125,87,156,41%,34%,45%,11,3,8,11,8,3
280,https://vlr.gg/player/2894/kiles,2025-03-05 11:00:00,0.82,1.54,1.18,235,169,290,45,15,30,34,20,14,10,3,7,0,-2,+2,72%,62%,81%,167,120,212,27%,27%,27%,4,0,4,4,2,2
281,https://vlr.gg/player/562/zeek,2025-03-05 11:00:00,0.92,1.15,1.04,242,226,268,41,18,23,42,23,19,16,4,12,+3,+1,+2,70%,62%,78%,164,146,181,20%,29%,13%,9,4,5,6,3,3
282,https://vlr.gg/player/1616/starki,2025-03-05 11:00:00,0.78,1.06,0.92,152,146,167,28,13,15,41,23,18,32,12,20,0,-1,+1,75%,77%,74%,101,91,111,23%,19%,27%,3,1,2,3,2,1
283,https://vlr.gg/player/1369/doma,2025-03-05 11:00:00,0.49,1.26,0.88,162,118,205,32,11,21,37,22,15,18,6,12,-2,-4,+2,74%,62%,85%,111,77,143,30%,24%,33%,2,0,2,4,4,0
284,https://vlr.gg/player/2700/jas,2025-03-05 11:00:00,0.33,1.27,0.81,166,112,229,33,9,24,38,24,14,9,4,5,-4,-6,+2,66%,46%,85%,115,76,153,34%,52%,26%,7,2,5,11,8,3
285,https://vlr.gg/player/1835/elllement,2025-03-05 11:00:00,0.86,2.01,1.42,307,216,390,56,20,36,37,24,13,10,2,8,+7,-2,+9,77%,67%,88%,200,149,252,16%,17%,16%,15,4,11,8,6,2
286,https://vlr.gg/player/4329/vince,2025-03-05 11:00:00,0.95,1.52,1.23,223,186,259,43,17,26,34,22,12,27,14,13,-1,-3,+2,75%,63%,88%,139,112,167,18%,13%,21%,4,1,3,5,4,1
287,https://vlr.gg/player/314/ambi,2025-03-05 11:00:00,0.93,1.24,1.08,185,189,196,37,18,19,34,22,12,24,11,13,0,+1,-1,79%,70%,88%,118,122,113,25%,26%,24%,1,1,0,1,0,1
288,https://vlr.gg/player/10885/davih,2025-03-05 11:00:00,0.97,0.82,0.89,149,184,116,26,17,9,32,19,13,13,2,11,-2,-1,-1,72%,63%,81%,107,136,77,23%,33%,11%,1,1,0,3,2,1
289,https://vlr.gg/player/9558/wolfen,2025-03-05 11:00:00,0.34,1.15,0.74,173,117,226,30,8,22,42,26,16,15,9,6,-1,-4,+3,68%,52%,85%,119,89,150,27%,28%,26%,7,2,5,8,6,2
290,https://vlr.gg/player/26829/damaraa,2025-03-05 07:00:00,1.50,2.65,1.76,389,349,490,44,30,14,20,17,3,3,2,1,+2,0,+2,81%,79%,86%,222,200,295,35%,32%,47%,8,6,2,6,6,0
291,https://vlr.gg/player/3626/lightningfast,2025-03-05 07:00:00,1.98,0.59,1.66,315,354,104,32,30,2,13,9,4,15,9,6,-3,-1,-2,87%,92%,71%,194,228,74,56%,62%,14%,0,0,0,3,1,2
292,https://vlr.gg/player/1162/russ,2025-03-05 07:00:00,1.03,1.65,1.17,147,156,133,18,15,3,13,12,1,20,12,8,+1,+1,0,84%,79%,100%,99,100,98,34%,35%,31%,1,1,0,0,0,0
293,https://vlr.gg/player/4095/skrossi,2025-03-05 07:00:00,0.73,2.21,1.06,203,152,422,26,15,11,19,15,4,2,0,2,+2,-1,+3,74%,71%,86%,137,97,274,30%,17%,39%,6,3,3,4,4,0
294,https://vlr.gg/player/9290/madelyn,2025-03-05 07:00:00,1.07,0.50,0.94,160,156,142,16,13,3,15,10,5,17,13,4,-1,-1,0,77%,79%,71%,106,110,92,14%,15%,10%,1,1,0,2,2,0
295,https://vlr.gg/player/47824/homeboy,2025-03-05 07:00:00,0.68,0.96,0.88,217,195,246,24,5,19,28,7,21,6,0,6,+4,0,+4,61%,43%,67%,136,98,147,11%,11%,11%,8,2,6,4,2,2
296,https://vlr.gg/player/47825/prime,2025-03-05 07:00:00,0.73,0.82,0.79,158,129,162,15,2,13,25,6,19,11,2,9,+3,0,+3,61%,43%,67%,108,107,109,25%,11%,34%,4,0,4,1,0,1
297,https://vlr.gg/player/51695/gambo,2025-03-05 07:00:00,1.03,0.51,0.63,144,279,100,14,6,8,26,6,20,8,1,7,-2,0,-2,55%,86%,46%,93,168,71,29%,29%,29%,0,0,0,2,0,2
298,https://vlr.gg/player/51696/synx,2025-03-05 07:00:00,0.41,0.63,0.58,151,134,162,17,4,13,31,7,24,3,0,3,-6,-3,-3,55%,43%,58%,102,70,111,34%,43%,32%,1,0,1,7,3,4
299,https://vlr.gg/player/47099/roboxfer,2025-03-05 07:00:00,0.04,0.60,0.42,99,8,133,10,0,10,26,7,19,8,0,8,0,0,0,55%,14%,67%,67,8,84,48%,0%,53%,2,0,2,2,0,2
300,https://vlr.gg/player/34727/kayle,2025-03-05 05:15:00,1.78,1.13,1.42,266,327,228,43,24,19,24,9,15,12,5,7,+5,+3,+2,82%,88%,77%,168,188,153,24%,22%,26%,5,3,2,0,0,0
301,https://vlr.gg/player/4038/bangnan,2025-03-05 05:15:00,1.58,1.28,1.41,280,322,244,39,20,19,26,12,14,7,4,3,+9,+4,+5,90%,94%,86%,183,215,158,39%,36%,41%,10,5,5,1,1,0
302,https://vlr.gg/player/25089/cabeza,2025-03-05 05:15:00,1.30,0.89,1.07,181,200,163,27,14,13,23,8,15,10,6,4,0,+1,-1,72%,82%,64%,124,130,119,34%,38%,31%,4,1,3,4,0,4
303,https://vlr.gg/player/4127/felix,2025-03-05 05:15:00,1.19,0.89,1.02,178,201,164,25,12,13,23,8,15,22,12,10,+1,+2,-1,69%,82%,59%,109,130,92,16%,13%,20%,5,3,2,4,1,3
304,https://vlr.gg/player/13000/redlight,2025-03-05 05:15:00,0.65,0.85,0.76,162,135,176,19,8,11,28,11,17,17,6,11,0,-3,+3,77%,76%,77%,106,90,119,15%,13%,17%,3,0,3,3,3,0
305,https://vlr.gg/player/42793/kally,2025-03-05 05:15:00,1.27,0.98,1.14,204,245,171,29,18,11,29,15,14,12,8,4,+1,+2,-1,74%,86%,59%,137,152,118,31%,38%,22%,2,2,0,1,0,1
306,https://vlr.gg/player/24979/cloy,2025-03-05 05:15:00,1.27,0.78,1.06,220,225,226,29,18,11,31,14,17,17,8,9,-5,-3,-2,87%,91%,82%,156,161,149,30%,33%,27%,0,0,0,5,3,2
307,https://vlr.gg/player/25048/sid,2025-03-05 05:15:00,0.89,0.71,0.81,178,199,146,23,15,8,31,16,15,7,4,3,-3,-2,-1,64%,68%,59%,121,141,95,32%,28%,37%,3,1,2,6,3,3
308,https://vlr.gg/player/17049/hermes,2025-03-05 05:15:00,0.72,0.62,0.67,191,180,192,24,14,10,33,18,15,2,2,0,-3,-3,0,74%,82%,65%,120,120,120,16%,14%,19%,5,3,2,8,6,2
309,https://vlr.gg/player/27444/banger,2025-03-05 05:15:00,0.83,0.42,0.65,122,122,131,19,11,8,29,12,17,4,2,2,-5,-2,-3,59%,68%,47%,78,73,83,35%,36%,35%,2,1,1,7,3,4
310,https://vlr.gg/player/1897/bgg,2025-03-05 04:30:00,1.42,1.30,1.37,261,256,257,37,21,16,25,12,13,13,7,6,+3,+1,+2,76%,75%,76%,160,162,158,24%,28%,19%,9,4,5,6,3,3
311,https://vlr.gg/player/2432/moner,2025-03-05 04:30:00,1.18,1.61,1.36,258,238,294,37,20,17,26,15,11,15,7,8,-2,-1,-1,88%,83%,94%,177,156,206,28%,19%,43%,2,1,1,4,2,2
312,https://vlr.gg/player/28612/tricky,2025-03-05 04:30:00,0.87,1.53,1.14,224,218,243,34,18,16,27,18,9,11,3,8,+1,+1,0,78%,71%,88%,142,139,148,27%,34%,20%,8,7,1,7,6,1
313,https://vlr.gg/player/18702/deadly10,2025-03-05 04:30:00,1.08,0.82,0.98,151,164,132,25,16,9,23,13,10,9,5,4,-2,0,-2,73%,75%,71%,106,113,97,33%,36%,27%,0,0,0,2,0,2
314,https://vlr.gg/player/3502/ri0,2025-03-05 04:30:00,1.02,0.81,0.93,143,130,151,21,13,8,22,10,12,24,14,10,-3,-1,-2,78%,79%,76%,85,80,91,25%,26%,24%,0,0,0,3,1,2
315,https://vlr.gg/player/27775/techno,2025-03-05 04:30:00,0.87,1.29,1.11,214,194,240,34,13,21,29,13,16,6,2,4,-1,0,-1,76%,76%,75%,142,129,151,33%,28%,36%,4,1,3,5,1,4
316,https://vlr.gg/player/10749/k1ngkappa,2025-03-05 04:30:00,0.85,1.05,0.97,221,212,228,31,13,18,32,14,18,8,3,5,+5,+4,+1,78%,82%,75%,144,141,146,30%,32%,29%,6,4,2,1,0,1
317,https://vlr.gg/player/3627/hellff,2025-03-05 04:30:00,0.91,0.83,0.86,173,165,175,24,10,14,30,11,19,13,7,6,+1,0,+1,63%,65%,63%,110,105,114,41%,41%,41%,5,2,3,4,2,2
318,https://vlr.gg/player/36687/miz,2025-03-05 04:30:00,0.79,0.79,0.79,157,202,135,21,11,10,31,14,17,11,5,6,+2,0,+2,76%,82%,71%,119,138,106,15%,19%,13%,6,3,3,4,3,1
319,https://vlr.gg/player/43390/d1sease,2025-03-05 04:30:00,0.59,0.34,0.44,95,135,66,13,8,5,32,14,18,4,2,2,-4,-1,-3,44%,53%,38%,73,105,49,28%,30%,25%,1,0,1,5,1,4
320,https://vlr.gg/player/37532/zexy,2025-03-05 03:00:00,1.69,1.77,1.73,348,330,366,44,21,23,21,11,10,9,6,3,+5,+3,+2,88%,94%,82%,221,212,230,34%,38%,30%,9,5,4,4,2,2
321,https://vlr.gg/player/34926/oonzmlp,2025-03-05 03:00:00,1.60,1.61,1.60,312,320,304,37,20,17,23,10,13,17,6,11,+2,+2,0,94%,88%,100%,193,194,192,24%,23%,25%,4,2,2,2,0,2
322,https://vlr.gg/player/4426/klaus,2025-03-05 03:00:00,1.25,1.31,1.28,230,211,248,27,13,14,18,8,10,9,4,5,+3,0,+3,88%,88%,88%,169,171,166,25%,21%,29%,4,1,3,1,1,0
323,https://vlr.gg/player/42755/shu,2025-03-05 03:00:00,1.23,0.98,1.10,185,176,193,23,11,12,20,8,12,18,11,7,-4,-2,-2,82%,88%,76%,108,107,109,23%,41%,14%,1,1,0,5,3,2
324,https://vlr.gg/player/2149/c1nder,2025-03-05 03:00:00,1.08,0.51,0.80,137,181,94,17,12,5,20,9,11,5,4,1,+2,+2,0,68%,88%,47%,92,109,75,38%,31%,54%,3,2,1,1,0,1
325,https://vlr.gg/player/42771/nameless,2025-03-05 03:00:00,0.96,0.90,0.93,176,157,195,23,10,13,26,11,15,9,6,3,0,-1,+1,76%,88%,65%,115,97,134,46%,50%,43%,1,0,1,1,1,0
326,https://vlr.gg/player/42710/froz,2025-03-05 03:00:00,0.92,0.66,0.79,215,262,168,23,15,8,32,17,15,16,9,7,0,+2,-2,65%,71%,59%,133,155,112,30%,29%,30%,3,2,1,3,0,3
327,https://vlr.gg/player/4666/acme,2025-03-05 03:00:00,1.03,0.47,0.75,181,229,132,18,13,5,29,13,16,14,6,8,-3,-1,-2,62%,65%,59%,126,152,100,19%,17%,21%,2,2,0,5,3,2
328,https://vlr.gg/player/48925/raxcal,2025-03-05 03:00:00,0.65,0.83,0.74,178,149,208,19,8,11,29,14,15,8,7,1,-1,0,-1,62%,65%,59%,116,94,137,16%,19%,14%,2,2,0,3,2,1
329,https://vlr.gg/player/42769/wezzy,2025-03-05 03:00:00,0.50,0.46,0.48,172,182,164,19,10,9,32,16,16,3,2,1,-4,-3,-1,47%,47%,47%,110,123,97,28%,22%,37%,5,1,4,9,4,5
330,https://vlr.gg/player/45186/sam,2025-03-04 19:20:00,1.53,1.43,1.48,269,283,274,65,27,38,42,18,24,14,4,10,+2,+1,+1,75%,67%,81%,176,181,173,36%,28%,45%,5,2,3,3,1,2
331,https://vlr.gg/player/46200/wire,2025-03-04 19:20:00,0.60,1.21,0.95,220,186,234,44,17,27,51,25,26,17,4,13,+4,-1,+5,68%,59%,75%,145,127,159,33%,40%,29%,9,2,7,5,3,2
332,https://vlr.gg/player/20539/juw,2025-03-04 19:20:00,0.57,1.03,0.83,179,141,204,37,13,24,52,24,28,21,7,14,+2,-2,+4,73%,70%,75%,116,93,134,33%,27%,37%,5,0,5,3,2,1
333,https://vlr.gg/player/35839/vefa,2025-03-04 19:20:00,0.47,1.05,0.80,158,128,186,35,12,23,46,24,22,20,6,14,-5,-4,-1,63%,56%,69%,98,80,112,26%,22%,28%,3,0,3,8,4,4
334,https://vlr.gg/player/25580/jenny,2025-03-04 19:20:00,0.52,0.75,0.62,135,123,153,28,10,18,49,24,25,11,4,7,-8,-3,-5,59%,52%,64%,95,80,106,23%,22%,24%,7,5,2,15,8,7
335,https://vlr.gg/player/24210/tasty,2025-03-04 19:20:00,1.21,1.93,1.52,275,221,337,61,28,33,33,21,12,19,9,10,+5,0,+5,79%,72%,89%,189,154,236,27%,23%,31%,11,3,8,6,3,3
336,https://vlr.gg/player/37923/oasis,2025-03-04 19:20:00,0.84,1.27,1.03,234,225,251,50,27,23,45,28,17,11,4,7,+5,+2,+3,73%,64%,85%,154,140,174,26%,33%,19%,9,6,3,4,4,0
337,https://vlr.gg/player/25741/lied,2025-03-04 19:20:00,0.83,1.28,1.03,217,206,228,50,27,23,45,30,15,13,6,7,-3,-5,+2,73%,67%,81%,143,144,143,32%,30%,35%,9,4,5,12,9,3
338,https://vlr.gg/player/20538/linlin,2025-03-04 19:20:00,0.98,1.04,1.01,201,216,181,46,28,18,45,28,17,26,9,17,0,+1,-1,78%,72%,85%,140,154,122,34%,32%,38%,2,1,1,2,0,2
339,https://vlr.gg/player/20491/ivy,2025-03-04 19:20:00,0.80,0.91,0.84,143,128,171,33,15,18,41,23,18,22,15,7,-2,-2,0,76%,78%,74%,103,91,120,29%,31%,27%,3,2,1,5,4,1
340,https://vlr.gg/player/13831/zeldris,2025-03-04 19:00:00,0.94,1.96,1.43,290,235,355,48,19,29,32,19,13,7,3,4,0,-2,+2,76%,67%,86%,192,149,239,21%,18%,23%,6,2,4,6,4,2
341,https://vlr.gg/player/26848/zeek,2025-03-04 19:00:00,1.41,1.10,1.26,221,246,191,34,20,14,28,14,14,27,15,12,0,0,0,83%,79%,86%,147,160,133,20%,18%,22%,5,4,1,5,4,1
342,https://vlr.gg/player/873/bob,2025-03-04 19:00:00,1.05,1.08,1.07,213,184,244,37,18,19,33,15,18,11,3,8,-1,0,-1,72%,71%,73%,139,125,153,24%,25%,22%,4,1,3,5,1,4
343,https://vlr.gg/player/25902/shondex,2025-03-04 19:00:00,1.06,0.90,0.98,180,188,175,30,16,14,31,15,16,10,5,5,0,+2,-2,78%,75%,82%,127,127,126,38%,38%,37%,3,3,0,3,1,2
344,https://vlr.gg/player/11696/zoestol,2025-03-04 19:00:00,0.87,0.82,0.85,178,200,158,28,16,12,36,20,16,25,15,10,-3,-2,-1,74%,88%,59%,116,136,95,26%,27%,24%,3,1,2,6,3,3
345,https://vlr.gg/player/29893/timotino,2025-03-04 19:00:00,0.91,1.28,1.10,232,224,245,39,17,22,33,17,16,9,5,4,+4,+3,+1,72%,77%,67%,159,138,178,25%,28%,23%,10,6,4,6,3,3
346,https://vlr.gg/player/5093/logan,2025-03-04 19:00:00,1.02,1.09,1.06,213,232,192,33,18,15,34,19,15,8,5,3,+3,+3,0,80%,86%,75%,146,162,131,20%,35%,11%,4,3,1,1,0,1
347,https://vlr.gg/player/6437/dark3st,2025-03-04 19:00:00,1.14,0.84,0.98,225,245,207,36,19,17,38,17,21,30,13,17,0,-3,+3,70%,68%,71%,134,160,110,19%,21%,18%,6,1,5,6,4,2
348,https://vlr.gg/player/754/nerve,2025-03-04 19:00:00,0.70,0.94,0.83,164,136,193,25,10,15,35,17,18,20,10,10,-2,-1,-1,61%,59%,63%,118,104,131,29%,36%,25%,1,0,1,3,1,2
349,https://vlr.gg/player/21878/snarly,2025-03-04 19:00:00,0.71,0.78,0.75,176,175,176,27,13,14,37,18,19,11,5,6,-1,0,-1,67%,68%,67%,120,124,116,27%,21%,33%,4,2,2,5,2,3
350,https://vlr.gg/player/28993/guterwoman,2025-03-04 18:00:00,0.66,1.03,0.85,186,164,206,25,10,15,30,15,15,5,2,3,+4,+2,+2,53%,56%,50%,118,99,136,38%,48%,33%,6,4,2,2,2,0
351,https://vlr.gg/player/35951/morgan,2025-03-04 18:00:00,0.84,0.84,0.84,190,159,219,24,10,14,31,15,16,15,8,7,-3,-2,-1,61%,61%,60%,128,113,142,26%,24%,27%,2,0,2,5,2,3
352,https://vlr.gg/player/39558/liz,2025-03-04 18:00:00,0.55,0.91,0.74,162,124,195,22,9,13,30,14,16,5,1,4,-3,-2,-1,61%,61%,60%,107,85,126,39%,35%,42%,3,0,3,6,2,4
353,https://vlr.gg/player/44501/lauguz,2025-03-04 18:00:00,0.99,0.48,0.72,180,242,127,23,14,9,34,15,19,10,5,5,+1,+1,0,53%,56%,50%,129,167,95,20%,29%,10%,4,3,1,3,2,1
354,https://vlr.gg/player/36081/lulita,2025-03-04 18:00:00,0.40,0.94,0.68,152,107,194,22,6,16,30,16,14,10,7,3,-3,-3,0,66%,67%,65%,111,76,143,24%,11%,33%,2,0,2,5,3,2
355,https://vlr.gg/player/35927/dano,2025-03-04 18:00:00,1.93,1.29,1.63,268,353,169,37,26,11,21,12,9,32,20,12,+1,0,+1,79%,85%,72%,160,201,114,32%,29%,42%,2,0,2,1,0,1
356,https://vlr.gg/player/28187/mili,2025-03-04 18:00:00,1.14,1.36,1.24,257,254,258,35,18,17,24,14,10,7,4,3,0,0,0,71%,75%,67%,168,174,161,31%,30%,33%,7,4,3,7,4,3
357,https://vlr.gg/player/21476/cami,2025-03-04 18:00:00,0.97,1.36,1.16,190,179,202,24,11,13,23,14,9,21,14,7,+1,-1,+2,76%,75%,78%,122,121,124,48%,48%,47%,4,1,3,3,2,1
358,https://vlr.gg/player/29223/tura,2025-03-04 18:00:00,0.86,1.45,1.14,214,187,248,32,14,18,24,15,9,3,2,1,+3,+1,+2,74%,70%,78%,145,117,177,32%,26%,37%,6,4,2,3,3,0
359,https://vlr.gg/player/38728/raven,2025-03-04 18:00:00,0.89,1.14,1.01,198,149,257,27,11,16,24,12,12,6,2,4,-1,0,-1,71%,70%,72%,132,103,166,28%,34%,24%,2,1,1,3,1,2
360,https://vlr.gg/player/7716/penny,2025-03-04 16:00:00,1.08,1.03,1.06,231,226,219,55,32,23,45,24,21,13,8,5,+2,+3,-1,76%,84%,64%,143,140,148,27%,24%,29%,12,10,2,10,7,3
361,https://vlr.gg/player/733/stellar,2025-03-04 16:00:00,1.14,0.81,1.00,202,211,182,46,29,17,47,24,23,33,23,10,0,0,0,73%,76%,68%,125,133,115,17%,17%,18%,4,2,2,4,2,2
362,https://vlr.gg/player/8742/jakee,2025-03-04 16:00:00,0.93,1.06,0.99,223,220,242,53,29,24,50,29,21,27,19,8,+2,0,+2,74%,79%,68%,140,130,153,26%,23%,30%,9,4,5,7,4,3
363,https://vlr.gg/player/739/fiziq,2025-03-04 16:00:00,1.18,0.60,0.93,168,182,120,36,25,11,40,20,20,20,12,8,-2,+2,-4,67%,74%,57%,103,119,82,22%,27%,13%,4,3,1,6,1,5
364,https://vlr.gg/player/69/thief,2025-03-04 16:00:00,1.17,0.51,0.89,178,229,136,42,31,11,50,24,26,21,11,10,0,+3,-3,71%,79%,61%,121,139,97,25%,29%,17%,5,4,1,5,1,4
365,https://vlr.gg/player/15051/sacred,2025-03-04 16:00:00,1.75,1.20,1.43,230,284,210,59,29,30,40,15,25,28,18,10,-2,-1,-1,73%,82%,66%,151,177,132,31%,27%,36%,2,0,2,4,1,3
366,https://vlr.gg/player/4917/kaoticcc,2025-03-04 16:00:00,1.36,1.19,1.26,250,258,242,57,26,31,45,18,27,9,4,5,+5,+6,-1,76%,79%,74%,163,175,154,19%,16%,23%,15,11,4,10,5,5
367,https://vlr.gg/player/29688/mikee,2025-03-04 16:00:00,0.89,0.96,0.93,182,149,204,38,14,24,48,17,31,26,10,16,-4,0,-4,68%,71%,66%,131,114,144,20%,20%,20%,1,1,0,5,1,4
368,https://vlr.gg/player/3874/teague,2025-03-04 16:00:00,1.14,0.77,0.92,180,195,159,39,20,19,47,17,30,19,10,9,-1,+1,-2,71%,86%,61%,117,127,110,20%,15%,24%,3,1,2,4,0,4
369,https://vlr.gg/player/34057/jerrwin,2025-03-04 16:00:00,0.99,0.50,0.71,171,213,141,39,22,17,52,19,33,16,8,8,0,0,0,64%,71%,58%,115,149,91,26%,31%,20%,11,4,7,11,4,7
370,https://vlr.gg/player/565/starxo,2025-03-04 14:25:00,1.23,0.97,1.09,195,232,165,24,12,12,25,12,13,17,8,9,-3,-2,-1,76%,80%,74%,129,152,111,30%,26%,34%,0,0,0,3,2,1
371,https://vlr.gg/player/2653/jesse,2025-03-04 14:25:00,1.02,0.48,0.72,181,246,143,23,13,10,30,14,16,5,5,0,-1,0,-1,65%,80%,53%,125,171,88,32%,37%,26%,2,1,1,3,1,2
372,https://vlr.gg/player/4521/unfake,2025-03-04 14:25:00,0.87,0.55,0.69,172,211,145,20,11,9,27,12,15,12,6,6,-3,0,-3,68%,80%,58%,122,153,98,35%,26%,53%,1,0,1,4,0,4
373,https://vlr.gg/player/440/akumaaaaa,2025-03-04 14:25:00,0.11,1.07,0.64,173,79,247,20,4,16,28,14,14,4,2,2,-1,-3,+2,71%,60%,79%,116,58,161,27%,13%,34%,6,3,3,7,6,1
374,https://vlr.gg/player/7162/wackie,2025-03-04 14:25:00,0.55,0.56,0.56,151,122,169,15,6,9,29,13,16,16,7,9,-4,-2,-2,71%,73%,68%,104,91,115,24%,23%,24%,2,0,2,6,2,4
375,https://vlr.gg/player/9556/demek,2025-03-04 14:25:00,1.86,1.29,1.61,320,362,263,42,27,15,22,12,10,6,4,2,+5,+4,+1,91%,89%,93%,192,217,160,18%,22%,12%,8,5,3,3,1,2
376,https://vlr.gg/player/10448/kozok,2025-03-04 14:25:00,1.11,1.34,1.21,210,187,240,27,13,14,19,10,9,12,7,5,+2,-1,+3,91%,84%,100%,131,116,150,26%,26%,26%,3,0,3,1,1,0
377,https://vlr.gg/player/9557/nefi,2025-03-04 14:25:00,1.00,1.35,1.16,180,149,228,23,10,13,21,12,9,16,10,6,-1,-1,0,82%,84%,80%,124,108,144,29%,31%,27%,2,1,1,3,2,1
378,https://vlr.gg/player/42702/krizz,2025-03-04 14:25:00,0.57,1.66,1.04,197,127,283,25,9,16,19,12,7,5,2,3,+3,+1,+2,74%,63%,87%,124,83,175,38%,41%,36%,4,2,2,1,1,0
379,https://vlr.gg/player/36748/czester,2025-03-04 14:25:00,1.31,0.63,1.01,179,224,132,22,15,7,21,10,11,15,10,5,+3,+2,+1,82%,79%,87%,122,145,92,19%,21%,17%,6,4,2,3,2,1
380,https://vlr.gg/player/16321/nelo,2025-03-04 14:00:00,1.34,1.40,1.37,299,275,324,56,27,29,37,19,18,17,12,5,+6,+8,-2,78%,82%,73%,197,187,208,46%,47%,45%,11,9,2,5,1,4
381,https://vlr.gg/player/20064/vania,2025-03-04 14:00:00,1.48,1.10,1.30,253,293,203,50,31,19,33,17,16,18,8,10,-4,-2,-2,76%,79%,73%,165,194,134,43%,42%,45%,6,3,3,10,5,5
382,https://vlr.gg/player/17320/petra,2025-03-04 14:00:00,1.28,1.01,1.15,240,250,216,47,26,21,35,17,18,25,15,10,+3,0,+3,83%,89%,77%,151,161,140,40%,41%,39%,5,2,3,2,2,0
383,https://vlr.gg/player/17323/mimi,2025-03-04 14:00:00,0.79,1.17,0.97,150,143,165,30,14,16,33,19,14,29,16,13,+4,+2,+2,83%,82%,85%,99,94,105,37%,32%,43%,4,2,2,0,0,0
384,https://vlr.gg/player/24149/amy,2025-03-04 14:00:00,1.09,0.77,0.94,156,183,126,32,20,12,32,17,15,9,6,3,-1,-2,+1,74%,79%,69%,104,127,80,33%,31%,34%,5,1,4,6,3,3
385,https://vlr.gg/player/41207/jade,2025-03-04 14:00:00,1.16,1.49,1.33,258,215,307,49,19,30,42,19,23,16,8,8,-2,-1,-1,72%,69%,75%,173,153,192,37%,27%,45%,1,0,1,3,1,2
386,https://vlr.gg/player/37969/ellie,2025-03-04 14:00:00,0.87,0.73,0.80,189,208,185,36,19,17,45,22,23,9,5,4,-2,0,-2,52%,50%,54%,132,137,127,34%,27%,44%,9,4,5,11,4,7
387,https://vlr.gg/player/17318/blossi,2025-03-04 14:00:00,0.86,0.73,0.79,158,156,162,30,14,16,43,18,25,15,8,7,-2,-2,0,69%,65%,71%,103,102,104,27%,24%,31%,3,1,2,5,3,2
388,https://vlr.gg/player/19373/ginger,2025-03-04 14:00:00,0.97,0.57,0.76,163,189,144,31,18,13,43,19,24,11,4,7,-5,-1,-4,57%,58%,57%,111,123,99,27%,29%,25%,3,2,1,8,3,5
389,https://vlr.gg/player/30042/harmonee,2025-03-04 14:00:00,0.68,0.75,0.70,124,111,146,24,11,13,42,19,23,13,4,9,+3,+2,+1,57%,58%,57%,96,84,108,23%,19%,26%,7,5,2,4,3,1
390,https://vlr.gg/player/1457/mistic,2025-03-04 14:00:00,1.44,1.47,1.46,241,252,245,39,17,22,21,9,12,15,5,10,0,-2,+2,83%,82%,83%,170,186,159,49%,47%,51%,2,0,2,2,2,0
391,https://vlr.gg/player/5292/al0rante,2025-03-04 14:00:00,0.47,1.87,1.29,270,137,343,39,8,31,27,13,14,9,1,8,0,-2,+2,76%,53%,92%,172,100,224,41%,33%,44%,5,0,5,5,2,3
392,https://vlr.gg/player/2690/hoody,2025-03-04 14:00:00,0.97,1.51,1.28,230,151,271,31,9,22,24,11,13,20,7,13,+3,+1,+2,90%,88%,92%,145,90,183,23%,13%,27%,3,1,2,0,0,0
393,https://vlr.gg/player/2658/xuss,2025-03-04 14:00:00,1.40,0.65,0.96,206,313,146,32,19,13,26,11,15,3,3,0,-2,0,-2,66%,82%,54%,145,211,99,26%,24%,29%,8,5,3,10,5,5
394,https://vlr.gg/player/4244/yaboilewis,2025-03-04 14:00:00,1.17,0.61,0.85,175,233,131,26,15,11,29,12,17,7,4,3,0,0,0,78%,88%,71%,113,148,89,38%,34%,44%,3,1,2,3,1,2
395,https://vlr.gg/player/7105/qpert,2025-03-04 14:00:00,0.96,1.16,1.04,194,189,225,30,16,14,30,18,12,13,9,4,+1,+2,-1,76%,71%,82%,137,122,158,34%,32%,38%,2,2,0,1,0,1
396,https://vlr.gg/player/19526/rexxtoned,2025-03-04 14:00:00,0.75,1.22,0.94,165,146,205,27,14,13,29,18,11,5,2,3,+3,+1,+2,59%,50%,71%,108,85,141,38%,46%,33%,5,3,2,2,2,0
397,https://vlr.gg/player/28948/ninja,2025-03-04 14:00:00,0.74,1.06,0.87,192,174,216,28,15,13,34,20,14,10,3,7,0,-2,+2,71%,67%,76%,123,113,138,35%,33%,38%,3,1,2,3,3,0
398,https://vlr.gg/player/50813/gsr,2025-03-04 14:00:00,0.62,0.81,0.70,161,146,174,20,11,9,35,20,15,13,6,7,-2,-4,+2,68%,71%,65%,114,109,121,27%,28%,26%,3,0,3,5,4,1
399,https://vlr.gg/player/40750/donatellooo,2025-03-04 14:00:00,0.63,0.21,0.45,156,178,113,22,15,7,39,23,16,2,1,1,-3,-1,-2,49%,58%,35%,92,111,64,43%,40%,50%,7,4,3,10,5,5
400,https://vlr.gg/player/30105/ikyoo,2025-03-04 11:00:00,1.12,1.02,1.09,239,244,239,44,29,15,46,29,17,18,11,7,+5,+1,+4,70%,72%,67%,156,147,170,29%,31%,27%,8,4,4,3,3,0
401,https://vlr.gg/player/29960/nidxvilco,2025-03-04 11:00:00,0.95,1.05,0.99,166,167,172,34,22,12,38,25,13,21,11,10,+2,0,+2,77%,75%,81%,114,112,116,32%,50%,18%,5,1,4,3,1,2
402,https://vlr.gg/player/30060/alessia,2025-03-04 11:00:00,0.73,0.99,0.82,155,148,182,33,19,14,42,27,15,2,2,0,0,-1,+1,61%,61%,62%,104,92,124,38%,33%,43%,6,3,3,6,4,2
403,https://vlr.gg/player/24140/superphrog,2025-03-04 11:00:00,0.63,1.08,0.80,184,183,220,40,22,18,50,34,16,7,5,2,+2,0,+2,60%,58%,62%,129,113,155,37%,40%,31%,11,8,3,9,8,1
404,https://vlr.gg/player/40175/mayameow,2025-03-04 11:00:00,0.79,0.62,0.73,155,151,146,25,16,9,45,28,17,38,26,12,-4,-2,-2,61%,64%,57%,102,99,109,21%,22%,19%,1,1,0,5,3,2
405,https://vlr.gg/player/31272/els,2025-03-04 11:00:00,1.23,1.56,1.44,242,198,266,56,19,37,27,11,16,7,2,5,-2,-2,0,72%,62%,78%,157,117,180,23%,23%,24%,4,0,4,6,2,4
406,https://vlr.gg/player/24071/liza,2025-03-04 11:00:00,1.48,1.14,1.27,265,302,238,54,22,32,39,14,25,14,5,9,+2,0,+2,79%,81%,78%,166,200,146,33%,30%,36%,5,2,3,3,2,1
407,https://vlr.gg/player/17394/ninou,2025-03-04 11:00:00,1.26,0.97,1.07,183,184,186,38,13,25,35,11,24,21,8,13,-1,0,-1,88%,81%,92%,124,131,120,25%,19%,30%,2,1,1,3,1,2
408,https://vlr.gg/player/20098/mel,2025-03-04 11:00:00,0.85,1.09,1.00,177,159,176,36,13,23,36,14,22,27,4,23,+1,-1,+2,70%,52%,81%,111,115,109,23%,31%,20%,4,1,3,3,2,1
409,https://vlr.gg/player/41196/ja2,2025-03-04 11:00:00,0.52,1.06,0.83,181,142,190,37,11,26,39,18,21,8,2,6,-5,-4,-1,68%,52%,78%,124,83,148,21%,23%,20%,11,3,8,16,7,9
410,https://vlr.gg/player/38142/dream,2025-03-04 11:00:00,1.23,1.23,1.23,227,234,227,59,28,31,47,21,26,12,8,4,0,+3,-3,68%,79%,57%,151,150,151,22%,17%,27%,6,4,2,6,1,5
411,https://vlr.gg/player/43744/akita,2025-03-04 11:00:00,1.13,1.04,1.08,232,269,219,61,33,28,52,28,24,8,3,5,-2,-3,+1,70%,71%,70%,161,174,149,27%,27%,26%,10,4,6,12,7,5
412,https://vlr.gg/player/16078/loupiote,2025-03-04 11:00:00,0.98,1.13,1.06,202,188,223,52,25,27,49,23,26,21,9,12,0,-4,+4,79%,76%,81%,138,120,154,26%,28%,24%,10,3,7,10,7,3
413,https://vlr.gg/player/17331/pinkalie,2025-03-04 11:00:00,0.81,0.77,0.79,167,183,144,40,22,18,52,25,27,29,13,16,-3,0,-3,70%,76%,65%,109,119,99,29%,22%,40%,3,3,0,6,3,3
414,https://vlr.gg/player/41197/thuy,2025-03-04 11:00:00,0.68,0.66,0.67,134,143,124,28,13,15,53,26,27,33,21,12,+2,0,+2,77%,85%,70%,92,106,79,23%,21%,26%,5,1,4,3,1,2
415,https://vlr.gg/player/23049/alkyia,2025-03-04 11:00:00,1.48,1.26,1.37,316,352,263,74,44,30,51,26,25,19,9,10,+7,+5,+2,76%,78%,74%,199,219,177,28%,28%,27%,14,10,4,7,5,2
416,https://vlr.gg/player/38133/anesilia,2025-03-04 11:00:00,1.01,1.24,1.12,199,172,229,46,21,25,41,21,20,23,13,10,+2,+3,-1,75%,78%,71%,134,113,157,22%,23%,21%,12,6,6,10,3,7
417,https://vlr.gg/player/11183/glance,2025-03-04 11:00:00,0.73,1.26,0.99,166,117,220,43,16,27,44,22,22,19,11,8,0,-1,+1,72%,70%,74%,108,73,147,33%,32%,34%,3,2,1,3,3,0
418,https://vlr.gg/player/39057/safiaa,2025-03-04 11:00:00,0.99,0.72,0.86,169,167,167,46,26,20,50,24,26,14,3,11,-2,-3,+1,73%,73%,74%,116,123,108,28%,38%,19%,3,0,3,5,3,2
419,https://vlr.gg/player/22792/jiex,2025-03-04 11:00:00,0.85,0.71,0.77,167,174,166,43,23,20,54,26,28,23,13,10,-4,-5,+1,66%,81%,50%,104,109,98,36%,37%,36%,5,0,5,9,5,4
420,https://vlr.gg/player/33358/shinnok,2025-03-04 11:00:00,0.92,1.23,1.04,197,175,232,40,22,18,43,26,17,19,15,4,0,-1,+1,68%,64%,74%,128,109,158,24%,27%,22%,5,3,2,5,4,1
421,https://vlr.gg/player/7490/anguist,2025-03-04 11:00:00,1.10,0.89,1.01,193,212,188,44,30,14,41,22,19,9,5,4,-1,-2,+1,63%,69%,52%,137,137,138,27%,25%,31%,5,2,3,6,4,2
422,https://vlr.gg/player/4589/burzzy,2025-03-04 11:00:00,0.61,1.02,0.77,167,138,235,36,16,20,49,29,20,18,14,4,-6,-6,0,71%,72%,70%,117,90,159,35%,26%,47%,2,0,2,8,6,2
423,https://vlr.gg/player/7104/juseu,2025-03-04 11:00:00,0.85,0.51,0.71,157,179,129,32,22,10,45,27,18,7,6,1,+1,+3,-2,66%,72%,57%,106,114,94,22%,21%,22%,9,6,3,8,3,5
424,https://vlr.gg/player/217/seider,2025-03-04 11:00:00,0.68,0.53,0.61,119,135,109,22,16,6,48,29,19,28,17,11,-5,-4,-1,61%,64%,57%,81,80,81,28%,24%,36%,3,2,1,8,6,2
425,https://vlr.gg/player/114/enzo,2025-03-04 11:00:00,1.94,1.27,1.53,269,336,229,56,29,27,31,10,21,19,8,11,+8,+5,+3,81%,91%,75%,169,198,151,18%,17%,19%,9,5,4,1,0,1
426,https://vlr.gg/player/13258/cyvoph,2025-03-04 11:00:00,1.84,1.10,1.39,223,301,181,52,28,24,30,10,20,31,17,14,+2,0,+2,83%,91%,78%,140,180,114,32%,32%,31%,6,2,4,4,2,2
427,https://vlr.gg/player/113/hyp,2025-03-04 11:00:00,0.93,1.01,0.98,188,169,206,40,14,26,36,13,23,11,7,4,+1,0,+1,78%,83%,75%,126,110,137,25%,22%,27%,6,1,5,5,1,4
428,https://vlr.gg/player/3582/keloqz,2025-03-04 11:00:00,0.63,1.18,0.96,227,180,244,45,13,32,41,19,22,14,7,7,+3,-2,+5,69%,61%,75%,145,121,160,26%,22%,28%,12,3,9,9,5,4
429,https://vlr.gg/player/1284/mikee,2025-03-04 11:00:00,0.58,1.16,0.93,175,116,201,33,9,24,36,16,20,22,7,15,-3,-2,-1,75%,74%,75%,110,78,130,28%,25%,30%,2,1,1,5,3,2
430,https://vlr.gg/player/1369/doma,2025-03-04 11:00:00,0.70,1.20,1.02,190,150,212,37,10,27,37,15,22,24,8,16,0,+1,-1,70%,70%,69%,122,95,137,23%,11%,29%,1,1,0,1,0,1
431,https://vlr.gg/player/1616/starki,2025-03-04 11:00:00,1.13,0.91,0.99,161,201,150,31,12,19,38,15,23,35,17,18,-3,-1,-2,75%,85%,69%,105,118,98,31%,39%,27%,2,1,1,5,2,3
432,https://vlr.gg/player/2894/kiles,2025-03-04 11:00:00,0.97,0.95,0.96,177,146,190,40,13,27,35,12,23,10,2,8,-1,+1,-2,68%,65%,69%,117,97,128,27%,29%,27%,5,2,3,6,1,5
433,https://vlr.gg/player/2700/jas,2025-03-04 11:00:00,0.82,1.05,0.96,235,212,245,49,16,33,45,17,28,7,2,5,+9,+2,+7,70%,65%,72%,144,132,150,31%,35%,29%,18,5,13,9,3,6
434,https://vlr.gg/player/562/zeek,2025-03-04 11:00:00,0.78,1.04,0.94,195,208,201,38,13,25,40,17,23,22,8,14,-1,-1,0,70%,65%,72%,135,134,135,21%,22%,20%,4,2,2,5,3,2
435,https://vlr.gg/player/31305/lar0k,2025-03-04 11:00:00,1.19,1.48,1.29,198,191,215,40,24,16,35,24,11,33,17,16,+2,+3,-1,80%,72%,95%,131,121,148,32%,33%,31%,5,5,0,3,2,1
436,https://vlr.gg/player/12795/crewen,2025-03-04 11:00:00,1.28,1.28,1.28,226,233,218,46,30,16,36,23,13,16,7,9,+1,0,+1,68%,67%,70%,141,147,130,46%,50%,38%,6,4,2,5,4,1
437,https://vlr.gg/player/24344/loita,2025-03-04 11:00:00,1.07,1.69,1.26,223,207,275,46,25,21,36,25,11,27,17,10,-7,-3,-4,73%,75%,70%,157,143,182,49%,44%,57%,4,2,2,11,5,6
438,https://vlr.gg/player/40591/comeback,2025-03-04 11:00:00,0.88,1.14,0.98,234,225,229,46,29,17,42,29,13,9,4,5,0,-1,+1,70%,67%,75%,143,143,142,24%,24%,23%,7,4,3,7,5,2
439,https://vlr.gg/player/5565/ros,2025-03-04 11:00:00,0.44,0.45,0.44,106,97,117,17,11,6,46,30,16,18,8,10,0,-1,+1,64%,58%,75%,72,67,81,22%,30%,12%,4,2,2,4,3,1
440,https://vlr.gg/player/43389/yash,2025-03-04 08:25:00,0.72,1.68,1.08,199,173,315,27,11,16,30,20,10,11,9,2,-1,-2,+1,71%,71%,71%,161,128,218,26%,24%,29%,6,4,2,7,6,1
441,https://vlr.gg/player/27755/icarus,2025-03-04 08:25:00,1.34,0.54,1.05,196,246,105,26,21,5,29,18,11,9,5,4,+2,+2,0,61%,63%,57%,138,178,69,31%,34%,20%,4,2,2,2,0,2
442,https://vlr.gg/player/43398/river,2025-03-04 08:25:00,0.89,0.78,0.85,131,142,132,18,12,6,27,18,9,20,12,8,-2,-3,+1,68%,67%,71%,98,108,81,32%,30%,38%,1,0,1,3,3,0
443,https://vlr.gg/player/4085/near,2025-03-04 08:25:00,0.77,0.94,0.83,184,181,196,23,14,9,32,21,11,10,5,5,-1,-2,+1,66%,67%,64%,136,135,138,28%,22%,38%,1,0,1,2,2,0
444,https://vlr.gg/player/22054/wave,2025-03-04 08:25:00,0.70,0.87,0.77,170,174,174,25,16,9,32,21,11,13,8,5,-8,-5,-3,66%,67%,64%,112,106,123,39%,33%,50%,2,1,1,10,6,4
445,https://vlr.gg/player/12323/rvk,2025-03-04 08:25:00,1.45,1.44,1.44,260,239,264,36,12,24,20,7,13,14,3,11,+2,+1,+1,74%,79%,71%,166,147,177,35%,33%,35%,3,1,2,1,0,1
446,https://vlr.gg/player/27336/venka,2025-03-04 08:25:00,1.65,1.01,1.24,300,381,254,43,20,23,28,9,19,8,2,6,+1,-1,+2,74%,71%,75%,196,242,170,32%,39%,26%,6,2,4,5,3,2
447,https://vlr.gg/player/26376/deecee,2025-03-04 08:25:00,0.60,1.53,1.19,217,143,247,28,6,22,22,9,13,13,2,11,-2,-3,+1,74%,57%,83%,140,92,168,24%,23%,24%,2,0,2,4,3,1
448,https://vlr.gg/player/3639/hoax,2025-03-04 08:25:00,0.66,1.14,0.97,187,94,229,19,4,15,23,8,15,21,4,17,+3,0,+3,74%,50%,88%,124,62,160,11%,12%,11%,5,1,4,2,1,1
449,https://vlr.gg/player/30693/makaveli,2025-03-04 08:25:00,0.89,0.92,0.91,180,214,164,24,10,14,26,12,14,10,3,7,+6,+3,+3,79%,86%,75%,118,142,105,24%,26%,23%,8,3,5,2,0,2
450,https://vlr.gg/player/10760/smokea,2025-03-04 04:30:00,1.09,1.12,1.11,221,215,232,54,29,25,50,28,22,15,9,6,-3,-1,-2,63%,66%,59%,144,140,150,28%,32%,25%,6,4,2,9,5,4
451,https://vlr.gg/player/19231/kibojn,2025-03-04 04:30:00,1.18,0.97,1.09,199,207,195,51,29,22,48,25,23,19,12,7,+2,+1,+1,74%,74%,75%,131,136,126,33%,36%,31%,7,3,4,5,2,3
452,https://vlr.gg/player/30575/r1sen,2025-03-04 04:30:00,0.94,0.91,0.92,172,191,166,42,25,17,53,29,24,30,17,13,+1,0,+1,69%,66%,72%,112,114,109,24%,21%,29%,4,2,2,3,2,1
453,https://vlr.gg/player/30877/lilboii,2025-03-04 04:30:00,0.73,0.93,0.82,161,151,170,39,20,19,52,29,23,30,16,14,-5,-4,-1,69%,74%,63%,104,99,110,25%,23%,28%,1,0,1,6,4,2
454,https://vlr.gg/player/46104/envy2k,2025-03-04 04:30:00,0.58,0.70,0.63,154,163,158,39,22,17,59,32,27,14,8,6,-6,-4,-2,60%,58%,63%,104,109,98,20%,22%,19%,11,6,5,17,10,7
455,https://vlr.gg/player/9745/georggyyy,2025-03-04 04:30:00,1.20,1.43,1.33,228,187,272,62,25,37,42,17,25,27,9,18,+1,-2,+3,73%,72%,74%,153,123,178,28%,27%,29%,5,0,5,4,2,2
456,https://vlr.gg/player/13221/azys,2025-03-04 04:30:00,1.19,1.21,1.20,274,249,283,65,28,37,51,21,30,16,8,8,+3,+2,+1,79%,84%,74%,170,162,177,26%,26%,26%,16,8,8,13,6,7
457,https://vlr.gg/player/12947/rawfiul,2025-03-04 04:30:00,1.28,1.11,1.19,251,264,229,61,32,29,45,20,25,13,4,9,+8,+3,+5,81%,75%,87%,162,176,150,34%,36%,32%,12,6,6,4,3,1
458,https://vlr.gg/player/3628/deathmaker,2025-03-04 04:30:00,1.02,0.98,1.00,171,188,160,41,21,20,41,19,22,15,7,8,+3,+2,+1,67%,72%,63%,121,134,109,30%,42%,20%,6,3,3,3,1,2
459,https://vlr.gg/player/3269/antidote,2025-03-04 04:30:00,0.62,0.83,0.73,127,127,129,32,13,19,47,23,24,21,11,10,-4,-1,-3,70%,66%,74%,89,87,90,20%,20%,19%,2,1,1,6,2,4
460,https://vlr.gg/player/8422/spaz,2025-03-03 19:00:00,1.76,1.77,1.77,273,285,257,43,25,18,20,12,8,32,8,24,-1,-1,0,91%,83%,100%,172,193,145,19%,24%,14%,0,0,0,1,1,0
461,https://vlr.gg/player/23407/pa1nt,2025-03-03 19:00:00,0.92,1.47,1.16,250,210,302,41,19,22,29,18,11,4,1,3,0,0,0,79%,79%,79%,167,132,212,41%,45%,39%,6,4,2,6,4,2
462,https://vlr.gg/player/4385/monsi,2025-03-03 19:00:00,0.65,1.50,1.03,180,130,244,29,11,18,28,18,10,22,9,13,+1,-1,+2,84%,75%,95%,114,81,155,34%,32%,36%,2,0,2,1,1,0
463,https://vlr.gg/player/2164/paincakes,2025-03-03 19:00:00,0.79,1.21,0.98,190,150,241,29,12,17,28,16,12,10,4,6,+2,0,+2,84%,71%,100%,118,102,139,26%,31%,22%,5,2,3,3,2,1
464,https://vlr.gg/player/864/bcj,2025-03-03 19:00:00,0.50,1.39,0.89,186,162,220,27,13,14,31,20,11,20,4,16,+1,0,+1,74%,67%,84%,122,111,136,18%,20%,16%,10,5,5,9,5,4
465,https://vlr.gg/player/8373/okeanos,2025-03-03 19:00:00,0.76,1.37,1.10,238,203,264,38,14,24,34,18,16,8,2,6,+5,+2,+3,77%,68%,83%,142,120,160,28%,24%,31%,6,3,3,1,1,0
466,https://vlr.gg/player/30470/kyu,2025-03-03 19:00:00,0.98,1.01,1.00,173,204,152,26,13,13,30,16,14,19,6,13,0,+1,-1,67%,47%,83%,119,141,101,16%,21%,12%,5,3,2,5,2,3
467,https://vlr.gg/player/844/bdog,2025-03-03 19:00:00,0.64,0.89,0.78,158,139,176,21,9,12,34,17,17,18,5,13,0,-1,+1,63%,47%,75%,118,108,126,19%,29%,15%,2,0,2,2,1,1
468,https://vlr.gg/player/21659/sato,2025-03-03 19:00:00,0.24,1.20,0.76,199,132,254,29,8,21,35,19,16,5,3,2,-6,-6,0,58%,37%,75%,131,94,161,49%,50%,48%,4,0,4,10,6,4
469,https://vlr.gg/player/34400/bao,2025-03-03 19:00:00,0.40,0.83,0.60,152,133,166,22,8,14,36,19,17,15,5,10,-2,-1,-1,58%,53%,63%,89,80,96,20%,18%,22%,3,1,2,5,2,3
470,https://vlr.gg/player/35660/tok1o,2025-03-03 16:15:00,0.55,1.56,1.10,218,151,268,30,8,22,29,18,11,13,4,9,-3,-4,+1,68%,55%,79%,153,107,191,23%,17%,28%,2,0,2,5,4,1
471,https://vlr.gg/player/35867/saikiwi,2025-03-03 16:15:00,0.99,0.86,0.92,197,224,178,29,15,14,35,18,17,19,7,12,-1,0,-1,70%,55%,83%,133,152,117,41%,45%,37%,4,2,2,5,2,3
472,https://vlr.gg/player/28620/freya,2025-03-03 16:15:00,0.65,0.98,0.83,176,157,191,28,11,17,32,17,15,5,1,4,+1,-3,+4,64%,45%,79%,119,113,124,30%,44%,22%,4,0,4,3,3,0
473,https://vlr.gg/player/35907/naxa,2025-03-03 16:15:00,0.55,1.06,0.83,184,150,215,27,10,17,35,19,16,6,1,5,-5,-2,-3,61%,45%,75%,128,102,150,15%,18%,13%,4,3,1,9,5,4
474,https://vlr.gg/player/3158/theozy,2025-03-03 16:15:00,0.43,0.77,0.62,135,102,165,21,6,15,35,18,17,7,4,3,-3,-1,-2,59%,45%,71%,104,80,125,34%,24%,40%,2,0,2,5,1,4
475,https://vlr.gg/player/22997/waved,2025-03-03 16:15:00,1.20,2.14,1.63,388,330,451,60,27,33,31,21,10,6,3,3,+11,+1,+10,84%,75%,95%,237,215,264,30%,30%,29%,19,9,10,8,8,0
476,https://vlr.gg/player/21108/ponix,2025-03-03 16:15:00,0.86,1.60,1.20,198,126,285,31,10,21,23,14,9,27,15,12,0,0,0,82%,75%,90%,134,90,187,25%,13%,32%,2,1,1,2,1,1
477,https://vlr.gg/player/18982/romily,2025-03-03 16:15:00,1.03,0.95,0.99,141,146,131,26,15,11,23,14,9,4,1,3,+3,0,+3,68%,67%,70%,89,104,72,36%,36%,35%,4,1,3,1,1,0
478,https://vlr.gg/player/42378/nicky,2025-03-03 16:15:00,0.82,1.17,0.98,171,163,181,24,12,12,26,17,9,31,15,16,-2,0,-2,77%,67%,90%,108,108,109,24%,42%,13%,1,1,0,3,1,2
479,https://vlr.gg/player/11236/antg,2025-03-03 16:15:00,0.78,0.81,0.79,166,165,172,25,12,13,32,19,13,15,10,5,-1,0,-1,77%,75%,80%,107,110,103,11%,12%,11%,1,0,1,2,0,2
480,https://vlr.gg/player/48025/alym,2025-03-03 16:00:00,1.51,1.10,1.27,267,305,238,58,28,30,41,16,25,13,7,6,+10,+6,+4,79%,76%,81%,159,186,141,31%,35%,28%,20,9,11,10,3,7
481,https://vlr.gg/player/62/huynh,2025-03-03 16:00:00,1.31,1.12,1.20,213,236,210,48,23,25,38,15,23,27,7,20,+4,+3,+1,77%,76%,78%,142,141,143,32%,29%,33%,8,4,4,4,1,3
482,https://vlr.gg/player/9094/kess,2025-03-03 16:00:00,1.04,1.07,1.06,186,191,178,40,17,23,36,14,22,13,2,11,+3,0,+3,80%,88%,75%,127,126,128,31%,23%,39%,4,0,4,1,0,1
483,https://vlr.gg/player/10053/fireballops,2025-03-03 16:00:00,0.89,1.18,1.06,225,190,235,46,17,29,40,17,23,22,6,16,-3,-2,-1,74%,72%,75%,145,136,151,26%,26%,26%,3,2,1,6,4,2
484,https://vlr.gg/player/862/b0i,2025-03-03 16:00:00,0.84,0.84,0.84,170,159,179,39,15,24,42,16,26,21,10,11,-1,-2,+1,69%,64%,72%,107,105,108,18%,23%,15%,2,0,2,3,2,1
485,https://vlr.gg/player/8758/benjii,2025-03-03 16:00:00,1.19,1.23,1.20,233,217,249,47,27,20,44,25,19,20,7,13,+3,+1,+2,70%,72%,68%,147,149,144,28%,34%,22%,5,1,4,2,0,2
486,https://vlr.gg/player/20959/toozy,2025-03-03 16:00:00,1.05,1.11,1.08,184,172,238,41,20,21,43,23,20,18,15,3,-1,-3,+2,61%,64%,56%,141,131,155,29%,27%,32%,3,0,3,4,3,1
487,https://vlr.gg/player/14048/zerona,2025-03-03 16:00:00,0.96,0.76,0.88,175,188,152,37,26,11,47,28,19,26,16,10,0,0,0,70%,72%,68%,115,118,112,32%,37%,26%,4,4,0,4,4,0
488,https://vlr.gg/player/8397/dip,2025-03-03 16:00:00,0.75,0.95,0.83,171,145,213,34,17,17,47,26,21,19,13,6,-8,-5,-3,69%,67%,72%,124,105,151,23%,18%,29%,2,1,1,10,6,4
489,https://vlr.gg/player/21886/furbsa,2025-03-03 16:00:00,0.95,0.43,0.73,171,221,109,38,29,9,50,29,21,8,4,4,-7,-1,-6,64%,69%,56%,114,139,78,44%,46%,39%,10,8,2,17,9,8
490,https://vlr.gg/player/893/retrq,2025-03-03 16:00:00,1.33,1.27,1.30,256,255,250,49,27,22,37,20,17,14,5,9,+5,+1,+4,73%,74%,72%,152,154,151,26%,26%,26%,5,1,4,0,0,0
491,https://vlr.gg/player/2125/nanners,2025-03-03 16:00:00,0.90,1.63,1.25,258,190,316,44,17,27,38,22,16,23,13,10,+4,+1,+3,75%,78%,72%,167,127,210,27%,28%,27%,8,4,4,4,3,1
492,https://vlr.gg/player/3719/matt,2025-03-03 16:00:00,0.80,1.11,0.95,170,147,191,33,14,19,36,20,16,16,8,8,-4,-3,-1,69%,70%,68%,122,111,134,31%,23%,38%,3,2,1,7,5,2
493,https://vlr.gg/player/24553/boni,2025-03-03 16:00:00,0.78,0.95,0.86,196,191,196,33,17,16,45,24,21,19,8,11,+2,+5,-3,75%,74%,76%,130,118,144,23%,31%,17%,9,6,3,7,1,6
494,https://vlr.gg/player/17770/alvinboy,2025-03-03 16:00:00,1.05,0.59,0.82,164,225,99,28,20,8,39,21,18,31,17,14,-5,-1,-4,79%,81%,76%,99,127,69,24%,23%,26%,2,2,0,7,3,4
495,https://vlr.gg/player/9063/infiltrator,2025-03-03 16:00:00,1.17,1.32,1.25,236,220,257,44,20,24,37,17,20,18,9,9,+5,+1,+4,77%,72%,81%,157,142,171,20%,24%,16%,8,3,5,3,2,1
496,https://vlr.gg/player/17865/nahsie,2025-03-03 16:00:00,1.12,1.20,1.16,188,174,207,36,17,19,31,15,16,30,11,19,+3,+1,+2,83%,76%,89%,127,115,137,28%,27%,28%,4,1,3,1,0,1
497,https://vlr.gg/player/9837/flare,2025-03-03 16:00:00,0.87,1.21,1.05,212,200,240,43,18,25,38,19,19,13,7,6,+1,+1,0,77%,76%,78%,137,126,147,19%,21%,17%,3,2,1,2,1,1
498,https://vlr.gg/player/9835/ali,2025-03-03 16:00:00,0.71,1.08,0.90,225,184,272,38,14,24,44,21,23,31,18,13,-1,-1,0,77%,80%,74%,147,127,165,26%,30%,23%,3,0,3,4,1,3
499,https://vlr.gg/player/9017/moobs,2025-03-03 16:00:00,0.95,0.64,0.79,178,227,130,34,20,14,39,20,19,13,6,7,-10,-1,-9,65%,60%,70%,122,152,94,33%,33%,33%,7,7,0,17,8,9
0,https://vlr.gg/player/893/retrq,2025-03-03 16:00:00,1.33,1.27,1.30,256,255,250,49,27,22,37,20,17,14,5,9,+5,+1,+4,73%,74%,72%,152,154,151,26%,26%,26%,5,1,4,0,0,0
1,https://vlr.gg/player/2125/nanners,2025-03-03 16:00:00,0.90,1.63,1.25,258,190,316,44,17,27,38,22,16,23,13,10,+4,+1,+3,75%,78%,72%,167,127,210,27%,28%,27%,8,4,4,4,3,1
2,https://vlr.gg/player/3719/matt,2025-03-03 16:00:00,0.80,1.11,0.95,170,147,191,33,14,19,36,20,16,16,8,8,-4,-3,-1,69%,70%,68%,122,111,134,31%,23%,38%,3,2,1,7,5,2
3,https://vlr.gg/player/24553/boni,2025-03-03 16:00:00,0.78,0.95,0.86,196,191,196,33,17,16,45,24,21,19,8,11,+2,+5,-3,75%,74%,76%,130,118,144,23%,31%,17%,9,6,3,7,1,6
4,https://vlr.gg/player/17770/alvinboy,2025-03-03 16:00:00,1.05,0.59,0.82,164,225,99,28,20,8,39,21,18,31,17,14,-5,-1,-4,79%,81%,76%,99,127,69,24%,23%,26%,2,2,0,7,3,4
5,https://vlr.gg/player/9063/infiltrator,2025-03-03 16:00:00,1.17,1.32,1.25,236,220,257,44,20,24,37,17,20,18,9,9,+5,+1,+4,77%,72%,81%,157,142,171,20%,24%,16%,8,3,5,3,2,1
6,https://vlr.gg/player/17865/nahsie,2025-03-03 16:00:00,1.12,1.20,1.16,188,174,207,36,17,19,31,15,16,30,11,19,+3,+1,+2,83%,76%,89%,127,115,137,28%,27%,28%,4,1,3,1,0,1
7,https://vlr.gg/player/9837/flare,2025-03-03 16:00:00,0.87,1.21,1.05,212,200,240,43,18,25,38,19,19,13,7,6,+1,+1,0,77%,76%,78%,137,126,147,19%,21%,17%,3,2,1,2,1,1
8,https://vlr.gg/player/9835/ali,2025-03-03 16:00:00,0.71,1.08,0.90,225,184,272,38,14,24,44,21,23,31,18,13,-1,-1,0,77%,80%,74%,147,127,165,26%,30%,23%,3,0,3,4,1,3
9,https://vlr.gg/player/9017/moobs,2025-03-03 16:00:00,0.95,0.64,0.79,178,227,130,34,20,14,39,20,19,13,6,7,-10,-1,-9,65%,60%,70%,122,152,94,33%,33%,33%,7,7,0,17,8,9
10,https://vlr.gg/player/17394/ninou,2025-03-03 14:35:00,0.74,1.38,1.14,226,162,263,29,7,22,29,11,18,17,6,11,+2,+2,0,82%,71%,88%,148,104,174,28%,24%,30%,2,2,0,0,0,0
11,https://vlr.gg/player/20098/mel,2025-03-03 14:35:00,0.74,1.01,0.91,180,168,187,26,8,18,29,12,17,11,5,6,0,-1,+1,61%,50%,67%,125,119,129,36%,45%,32%,5,0,5,5,1,4
12,https://vlr.gg/player/24071/liza,2025-03-03 14:35:00,0.49,0.94,0.78,189,147,213,24,6,18,32,12,20,5,2,3,+2,0,+2,58%,50%,63%,136,126,143,32%,20%,40%,4,1,3,2,1,1
13,https://vlr.gg/player/41196/ja2,2025-03-03 14:35:00,0.74,0.60,0.65,163,230,125,22,11,11,34,14,20,8,2,6,-2,+1,-3,63%,64%,63%,113,137,99,33%,36%,31%,5,4,1,7,3,4
14,https://vlr.gg/player/31272/els,2025-03-03 14:35:00,0.60,0.33,0.43,125,119,129,14,7,7,34,12,22,9,2,7,-4,-2,-2,53%,50%,54%,94,104,89,29%,47%,21%,2,0,2,6,2,4
15,https://vlr.gg/player/41207/jade,2025-03-03 14:35:00,1.28,1.94,1.52,240,214,285,33,19,14,20,14,6,20,12,8,-1,-1,0,82%,75%,93%,164,152,185,26%,21%,34%,2,0,2,3,1,2
16,https://vlr.gg/player/19373/ginger,2025-03-03 14:35:00,1.73,0.58,1.30,235,301,123,34,28,6,22,12,10,5,3,2,+1,0,+1,76%,83%,64%,161,208,79,38%,43%,24%,3,1,2,2,1,1
17,https://vlr.gg/player/30042/harmonee,2025-03-03 14:35:00,1.06,1.63,1.27,195,166,246,27,14,13,18,13,5,18,12,6,0,-2,+2,87%,83%,93%,136,113,174,30%,33%,28%,3,1,2,3,3,0
18,https://vlr.gg/player/37969/ellie,2025-03-03 14:35:00,0.92,1.70,1.21,277,211,391,40,18,22,27,18,9,6,4,2,+2,+4,-2,74%,79%,64%,172,143,221,34%,28%,40%,8,7,1,6,3,3
19,https://vlr.gg/player/17318/blossi,2025-03-03 14:35:00,0.89,0.77,0.85,178,204,135,24,18,6,28,19,9,13,6,7,0,+1,-1,79%,75%,86%,119,135,91,18%,20%,13%,4,4,0,4,3,1
20,https://vlr.gg/player/12474/tag,2025-03-03 14:30:00,1.00,1.36,1.16,229,212,253,35,18,17,31,19,12,9,3,6,+1,0,+1,69%,64%,75%,152,145,161,37%,33%,40%,2,1,1,1,1,0
21,https://vlr.gg/player/2190/baddyg,2025-03-03 14:30:00,1.19,1.10,1.15,219,216,236,35,19,16,32,18,14,21,13,8,0,-2,+2,76%,72%,80%,135,132,140,23%,28%,17%,6,2,4,6,4,2
22,https://vlr.gg/player/1944/cayden,2025-03-03 14:30:00,1.17,0.63,0.93,183,219,129,28,19,9,33,18,15,14,7,7,-2,-1,-1,67%,64%,70%,112,137,80,30%,33%,25%,2,0,2,4,1,3
23,https://vlr.gg/player/1470/simond4rk,2025-03-03 14:30:00,0.63,0.72,0.67,165,184,166,27,15,12,38,22,16,4,2,2,-8,-5,-3,60%,56%,65%,116,113,120,26%,28%,25%,6,5,1,14,10,4
24,https://vlr.gg/player/8226/waddle,2025-03-03 14:30:00,0.53,0.69,0.60,121,103,141,18,8,10,33,19,14,7,1,6,-2,-1,-1,62%,64%,60%,85,72,100,29%,22%,36%,1,0,1,3,1,2
25,https://vlr.gg/player/50813/gsr,2025-03-03 14:30:00,1.40,1.17,1.27,231,237,223,35,16,19,26,11,15,20,12,8,+3,0,+3,84%,85%,84%,151,146,155,36%,31%,40%,5,2,3,2,2,0
26,https://vlr.gg/player/28948/ninja,2025-03-03 14:30:00,1.13,1.31,1.23,223,185,232,39,16,23,26,12,14,9,5,4,+2,0,+2,73%,70%,76%,153,131,171,44%,46%,43%,3,1,2,1,1,0
27,https://vlr.gg/player/7105/qpert,2025-03-03 14:30:00,1.33,1.01,1.15,182,191,177,28,14,14,27,11,16,25,12,13,+1,0,+1,76%,75%,76%,119,121,117,37%,23%,59%,1,0,1,0,0,0
28,https://vlr.gg/player/40750/donatellooo,2025-03-03 14:30:00,1.14,1.02,1.08,261,254,267,42,17,25,33,15,18,5,4,1,+4,+3,+1,67%,70%,64%,161,162,160,27%,27%,27%,14,7,7,10,4,6
29,https://vlr.gg/player/19526/rexxtoned,2025-03-03 14:30:00,0.57,0.90,0.76,143,113,166,23,8,15,31,15,16,10,1,9,+1,-1,+2,67%,50%,80%,89,79,96,42%,39%,43%,5,1,4,4,2,2
30,https://vlr.gg/player/40175/mayameow,2025-03-03 14:15:00,1.14,0.80,1.01,173,195,143,22,15,7,29,17,12,22,15,7,-5,-1,-4,74%,83%,57%,114,122,99,19%,22%,15%,1,1,0,6,2,4
31,https://vlr.gg/player/30060/alessia,2025-03-03 14:15:00,0.79,0.63,0.73,183,189,177,23,15,8,33,20,13,2,1,1,+2,+3,-1,58%,63%,50%,128,126,130,48%,59%,36%,4,4,0,2,1,1
32,https://vlr.gg/player/30105/ikyoo,2025-03-03 14:15:00,0.90,0.37,0.71,148,183,88,20,16,4,32,19,13,5,4,1,-5,-2,-3,61%,67%,50%,99,121,62,26%,23%,36%,0,0,0,5,2,3
33,https://vlr.gg/player/24140/superphrog,2025-03-03 14:15:00,0.67,0.61,0.65,180,185,179,23,15,8,34,20,14,5,4,1,-3,-1,-2,66%,71%,57%,124,126,121,30%,38%,19%,6,6,0,9,7,2
34,https://vlr.gg/player/29960/nidxvilco,2025-03-03 14:15:00,0.67,0.42,0.57,135,149,110,17,14,3,33,20,13,17,10,7,-5,-1,-4,71%,79%,57%,75,78,70,16%,14%,21%,0,0,0,5,1,4
35,https://vlr.gg/player/20064/vania,2025-03-03 14:15:00,1.87,1.45,1.61,308,397,249,43,22,21,21,8,13,17,3,14,+12,+9,+3,87%,86%,88%,188,228,165,32%,31%,33%,14,9,5,2,0,2
36,https://vlr.gg/player/24149/amy,2025-03-03 14:15:00,1.97,1.18,1.47,274,353,226,42,20,22,22,7,15,10,5,5,+3,+3,0,76%,100%,63%,180,234,149,33%,38%,28%,6,3,3,3,0,3
37,https://vlr.gg/player/17323/mimi,2025-03-03 14:15:00,1.52,1.38,1.43,223,198,244,31,11,20,18,5,13,23,8,15,+4,+1,+3,95%,100%,92%,165,140,179,30%,37%,27%,4,1,3,0,0,0
38,https://vlr.gg/player/17320/petra,2025-03-03 14:15:00,1.07,1.01,1.03,174,111,210,23,5,18,21,4,17,16,9,7,-3,+1,-4,82%,86%,79%,116,76,139,25%,8%,35%,2,1,1,5,0,5
39,https://vlr.gg/player/16321/nelo,2025-03-03 14:15:00,1.08,0.88,0.95,172,146,190,22,7,15,23,6,17,19,11,8,0,0,0,89%,100%,83%,127,118,132,26%,19%,30%,1,0,1,1,0,1
40,https://vlr.gg/player/11262/kalita,2025-03-03 14:00:00,0.56,1.58,1.06,209,150,272,24,8,16,27,16,11,5,1,4,+1,0,+1,67%,47%,88%,139,101,178,30%,23%,35%,2,0,2,1,0,1
41,https://vlr.gg/player/35876/tconda,2025-03-03 14:00:00,0.49,0.91,0.69,158,147,172,17,7,10,28,17,11,4,1,3,-2,-3,+1,58%,41%,75%,107,107,108,26%,33%,19%,5,2,3,7,5,2
42,https://vlr.gg/player/20222/crona,2025-03-03 14:00:00,0.35,0.91,0.62,145,104,188,15,5,10,30,17,13,9,2,7,0,-2,+2,58%,59%,56%,90,66,116,25%,25%,26%,2,0,2,2,2,0
43,https://vlr.gg/player/21091/azul,2025-03-03 14:00:00,0.31,0.80,0.55,112,88,140,14,5,9,27,16,11,6,1,5,0,0,0,45%,29%,63%,85,60,111,36%,57%,24%,0,0,0,0,0,0
44,https://vlr.gg/player/29179/vii,2025-03-03 14:00:00,0.36,0.48,0.42,134,113,157,14,7,7,33,17,16,7,1,6,-8,-6,-2,55%,47%,63%,95,80,111,29%,35%,25%,3,1,2,11,7,4
45,https://vlr.gg/player/12055/mmonch,2025-03-03 14:00:00,1.98,1.89,1.93,353,411,301,47,26,21,14,10,4,4,2,2,+4,+3,+1,91%,88%,94%,227,249,206,52%,49%,56%,6,3,3,2,0,2
46,https://vlr.gg/player/11259/conir,2025-03-03 14:00:00,0.86,1.70,1.29,207,128,279,26,8,18,15,9,6,13,4,9,+1,-1,+2,88%,75%,100%,136,97,172,22%,33%,18%,2,0,2,1,1,0
47,https://vlr.gg/player/21558/micaela,2025-03-03 14:00:00,1.00,1.47,1.25,192,167,213,26,10,16,17,10,7,15,7,8,+1,0,+1,88%,88%,88%,139,120,157,40%,32%,48%,2,1,1,1,1,0
48,https://vlr.gg/player/25663/dods,2025-03-03 14:00:00,0.65,1.75,1.21,263,165,353,30,9,21,23,13,10,10,5,5,+1,-3,+4,79%,63%,94%,181,120,238,29%,34%,25%,8,3,5,7,6,1
49,https://vlr.gg/player/11235/biazik,2025-03-03 14:00:00,1.04,0.98,1.01,161,205,123,16,9,7,15,10,5,15,10,5,+2,-1,+3,94%,94%,94%,125,164,88,27%,26%,30%,3,0,3,1,1,0
50,https://vlr.gg/player/36748/czester,2025-03-03 13:25:00,1.04,0.82,0.95,210,214,206,29,18,11,31,19,12,13,7,6,-1,+2,-3,68%,75%,59%,142,146,136,37%,45%,30%,2,2,0,3,0,3
51,https://vlr.gg/player/42702/krizz,2025-03-03 13:25:00,1.03,0.54,0.83,153,179,116,21,15,6,30,16,14,7,4,3,-1,+1,-2,63%,67%,59%,103,120,79,25%,29%,19%,1,1,0,2,0,2
52,https://vlr.gg/player/9556/demek,2025-03-03 13:25:00,0.58,1.04,0.77,172,151,203,25,13,12,30,19,11,7,3,4,-7,-8,+1,61%,63%,59%,113,101,129,26%,26%,26%,5,2,3,12,10,2
53,https://vlr.gg/player/9557/nefi,2025-03-03 13:25:00,0.79,0.66,0.74,141,136,146,19,10,9,32,18,14,12,10,2,+1,+1,0,56%,67%,41%,94,91,98,31%,22%,45%,3,1,2,2,0,2
54,https://vlr.gg/player/10448/kozok,2025-03-03 13:25:00,0.44,0.97,0.66,138,96,199,20,8,12,30,18,12,11,6,5,+1,0,+1,63%,63%,65%,93,63,136,23%,22%,24%,6,4,2,5,4,1
55,https://vlr.gg/player/12774/anima,2025-03-03 13:25:00,1.39,1.53,1.47,235,251,220,34,16,18,20,11,9,23,8,15,+1,+1,0,85%,82%,88%,153,165,145,26%,25%,28%,2,1,1,1,0,1
56,https://vlr.gg/player/10160/izzy,2025-03-03 13:25:00,1.72,1.14,1.38,206,280,155,34,19,15,18,8,10,8,1,7,+3,+3,0,78%,82%,75%,133,181,99,32%,34%,31%,6,4,2,3,1,2
57,https://vlr.gg/player/10161/qutionerx,2025-03-03 13:25:00,0.99,1.37,1.21,268,226,297,36,11,25,29,13,16,15,7,8,+1,+1,0,78%,76%,79%,176,161,187,22%,23%,21%,6,2,4,5,1,4
58,https://vlr.gg/player/8041/brave,2025-03-03 13:25:00,0.99,1.22,1.13,172,130,203,26,9,17,24,9,15,23,8,15,+1,-2,+3,71%,65%,75%,117,87,139,40%,40%,40%,7,2,5,6,4,2
59,https://vlr.gg/player/10163/cyderx,2025-03-03 13:25:00,0.95,0.99,0.97,154,128,174,23,8,15,23,9,14,8,4,4,+1,0,+1,76%,76%,75%,108,97,116,24%,22%,25%,3,1,2,2,1,1
60,https://vlr.gg/player/11183/glance,2025-03-03 11:00:00,1.29,1.04,1.18,223,238,202,59,36,23,45,23,22,15,10,5,+3,+3,0,75%,78%,73%,144,150,136,22%,22%,22%,3,3,0,0,0,0
61,https://vlr.gg/player/39057/safiaa,2025-03-03 11:00:00,1.29,0.89,1.11,231,246,196,56,36,20,49,25,24,22,13,9,-4,-3,-1,73%,80%,64%,154,172,132,27%,23%,33%,4,0,4,8,3,5
62,https://vlr.gg/player/38133/anesilia,2025-03-03 11:00:00,0.98,1.20,1.08,204,183,234,54,26,28,48,26,22,27,14,13,0,-3,+3,81%,80%,82%,138,124,155,27%,26%,29%,8,3,5,8,6,2
63,https://vlr.gg/player/22792/jiex,2025-03-03 11:00:00,1.20,0.89,1.06,203,214,185,52,31,21,46,22,24,23,13,10,-3,-6,+3,71%,73%,70%,125,135,113,33%,33%,32%,4,0,4,7,6,1
64,https://vlr.gg/player/23049/alkyia,2025-03-03 11:00:00,0.83,1.10,0.95,219,200,224,52,27,25,51,31,20,15,11,4,+1,-3,+4,67%,65%,70%,136,130,144,24%,28%,19%,16,8,8,15,11,4
65,https://vlr.gg/player/24101/miyori,2025-03-03 11:00:00,1.26,1.08,1.15,227,254,233,62,30,32,50,21,29,7,2,5,+4,-2,+6,66%,70%,63%,153,163,144,39%,36%,42%,13,3,10,9,5,4
66,https://vlr.gg/player/19362/lyda,2025-03-03 11:00:00,0.90,1.12,1.02,161,164,188,49,20,29,49,23,26,16,7,9,-2,-2,0,68%,70%,68%,126,110,139,35%,37%,34%,5,0,5,7,2,5
67,https://vlr.gg/player/30107/fluxxy,2025-03-03 11:00:00,1.27,0.70,0.96,213,244,173,50,29,21,57,23,34,24,9,15,+1,0,+1,66%,67%,65%,133,154,115,24%,25%,23%,6,3,3,5,3,2
68,https://vlr.gg/player/37990/adora,2025-03-03 11:00:00,0.85,0.71,0.77,186,211,168,48,25,23,61,26,35,8,3,5,0,-3,+3,62%,64%,60%,119,124,115,34%,30%,40%,12,6,6,12,9,3
69,https://vlr.gg/player/9431/cille,2025-03-03 11:00:00,0.49,0.81,0.66,128,84,171,30,8,22,56,24,32,17,10,7,0,-2,+2,60%,61%,60%,90,61,113,18%,15%,19%,2,0,2,2,2,0
70,https://vlr.gg/player/20058/devilasxa,2025-03-03 11:00:00,1.38,1.12,1.24,255,281,226,58,30,28,45,21,24,15,6,9,-3,-2,-1,65%,59%,70%,159,177,145,27%,37%,21%,3,0,3,6,2,4
71,https://vlr.gg/player/26632/joliinaa,2025-03-03 11:00:00,0.86,1.35,1.14,234,202,251,57,23,34,44,22,22,8,3,5,+1,-4,+5,70%,55%,81%,152,136,165,29%,26%,32%,12,4,8,11,8,3
72,https://vlr.gg/player/39506/cabbit,2025-03-03 11:00:00,0.82,1.11,0.98,215,185,240,47,17,30,48,23,25,19,9,10,+3,-1,+4,74%,72%,76%,147,124,165,33%,34%,32%,5,0,5,2,1,1
73,https://vlr.gg/player/45174/purity,2025-03-03 11:00:00,0.75,0.99,0.89,186,164,207,42,15,27,45,22,23,22,10,12,0,-2,+2,74%,69%,78%,125,115,132,28%,24%,32%,7,2,5,7,4,3
74,https://vlr.gg/player/20116/jademwah,2025-03-03 11:00:00,0.61,0.86,0.75,143,145,142,36,14,22,48,24,24,22,10,12,-5,-4,-1,73%,76%,70%,95,93,96,33%,19%,54%,4,2,2,9,6,3
75,https://vlr.gg/player/47911/berryx,2025-03-03 11:00:00,0.98,1.72,1.30,262,204,348,64,27,37,47,29,18,13,11,2,-2,-9,+7,65%,59%,72%,173,133,224,29%,24%,34%,14,5,9,16,14,2
76,https://vlr.gg/player/29442/wens,2025-03-03 11:00:00,0.76,1.42,1.05,197,165,247,49,22,27,45,27,18,10,2,8,0,-2,+2,70%,59%,83%,130,108,158,39%,40%,39%,4,2,2,4,4,0
77,https://vlr.gg/player/46311/mimier,2025-03-03 11:00:00,0.92,1.03,0.97,218,203,224,48,26,22,52,30,22,15,4,11,+6,+3,+3,71%,70%,72%,137,125,153,30%,28%,31%,11,5,6,5,2,3
78,https://vlr.gg/player/17408/lateu,2025-03-03 11:00:00,0.94,0.74,0.85,152,176,122,34,23,11,46,26,20,31,11,20,+1,0,+1,67%,62%,72%,101,120,76,25%,28%,20%,2,1,1,1,1,0
79,https://vlr.gg/player/17326/htm,2025-03-03 11:00:00,0.82,0.81,0.82,170,174,159,35,20,15,50,29,21,26,17,9,-1,-1,0,73%,70%,76%,109,113,105,21%,22%,20%,4,1,3,5,2,3
80,https://vlr.gg/player/114/enzo,2025-03-03 11:00:00,1.24,1.31,1.27,237,214,264,55,27,28,46,21,25,38,21,17,-3,-2,-1,74%,73%,76%,161,149,176,17%,22%,15%,5,1,4,8,3,5
81,https://vlr.gg/player/113/hyp,2025-03-03 11:00:00,1.34,1.04,1.20,210,209,212,60,33,27,48,21,27,25,9,16,-2,-4,+2,76%,73%,79%,140,144,135,36%,42%,30%,4,2,2,6,6,0
82,https://vlr.gg/player/13258/cyvoph,2025-03-03 11:00:00,1.07,1.04,1.06,223,231,210,60,35,25,55,30,25,29,12,17,+1,+1,0,80%,75%,85%,146,151,141,26%,27%,25%,6,3,3,5,2,3
83,https://vlr.gg/player/3582/keloqz,2025-03-03 11:00:00,1.06,0.94,1.00,224,248,170,57,35,22,54,31,23,14,8,6,-2,-2,0,66%,70%,62%,138,157,116,37%,38%,36%,14,8,6,16,10,6
84,https://vlr.gg/player/1284/mikee,2025-03-03 11:00:00,0.86,0.98,0.91,161,155,179,41,20,21,51,27,24,42,19,23,-2,+3,-5,78%,78%,79%,113,106,122,30%,23%,38%,4,4,0,6,1,5
85,https://vlr.gg/player/16209/famsii,2025-03-03 11:00:00,0.96,1.33,1.16,248,206,269,63,26,37,53,25,28,15,7,8,+6,+1,+5,77%,82%,73%,164,139,185,24%,17%,30%,12,4,8,6,3,3
86,https://vlr.gg/player/18162/serial,2025-03-03 11:00:00,1.35,0.87,1.09,214,262,180,60,33,27,54,23,31,8,5,3,0,+2,-2,69%,74%,65%,154,172,139,44%,41%,47%,7,4,3,7,2,5
87,https://vlr.gg/player/8805/sacake,2025-03-03 11:00:00,0.97,0.79,0.87,152,175,137,36,19,17,52,22,30,39,17,22,0,-1,+1,72%,74%,70%,113,129,100,31%,30%,32%,5,4,1,5,5,0
88,https://vlr.gg/player/29972/michel,2025-03-03 11:00:00,0.75,0.93,0.85,168,159,188,48,22,26,55,26,29,15,4,11,0,-2,+2,65%,74%,58%,117,102,130,39%,40%,39%,10,3,7,10,5,5
89,https://vlr.gg/player/1524/h1ber,2025-03-03 11:00:00,1.04,0.63,0.82,183,217,169,47,24,23,60,27,33,20,13,7,+2,+4,-2,64%,71%,58%,135,157,116,23%,21%,26%,7,4,3,5,0,5
90,https://vlr.gg/player/40591/comeback,2025-03-03 11:00:00,1.25,1.69,1.49,305,302,311,52,23,29,27,15,12,7,1,6,+8,+3,+5,84%,76%,92%,193,187,197,30%,39%,23%,11,4,7,3,1,2
91,https://vlr.gg/player/31305/lar0k,2025-03-03 11:00:00,1.29,1.03,1.15,253,286,227,38,20,18,31,14,17,15,6,9,+6,+5,+1,73%,76%,71%,164,178,153,18%,19%,17%,9,5,4,3,0,3
92,https://vlr.gg/player/12795/crewen,2025-03-03 11:00:00,0.97,1.16,1.07,185,203,169,33,17,16,26,14,12,5,1,4,+1,+1,0,71%,71%,71%,121,133,110,33%,41%,27%,5,4,1,4,3,1
93,https://vlr.gg/player/24344/loita,2025-03-03 11:00:00,0.90,1.08,0.99,171,124,209,26,9,17,27,11,16,18,5,13,+2,-1,+3,78%,81%,75%,118,93,140,36%,40%,34%,3,0,3,1,1,0
94,https://vlr.gg/player/5565/ros,2025-03-03 11:00:00,0.54,0.82,0.69,123,115,129,18,7,11,28,15,13,20,10,10,-4,-1,-3,71%,71%,71%,79,71,87,13%,12%,15%,1,1,0,5,2,3
95,https://vlr.gg/player/4329/vince,2025-03-03 11:00:00,1.08,1.17,1.12,194,182,201,29,15,14,30,15,15,22,9,13,+2,0,+2,69%,67%,71%,124,124,125,23%,29%,17%,3,0,3,1,0,1
96,https://vlr.gg/player/9558/wolfen,2025-03-03 11:00:00,0.79,1.38,1.06,232,193,284,37,16,21,34,20,14,8,4,4,-3,-3,0,58%,46%,71%,148,125,173,31%,28%,33%,5,2,3,8,5,3
97,https://vlr.gg/player/10885/davih,2025-03-03 11:00:00,0.92,1.07,0.99,189,175,201,30,15,15,33,17,16,13,5,8,-2,+1,-3,67%,63%,71%,124,108,143,24%,26%,23%,3,3,0,5,2,3
98,https://vlr.gg/player/1835/elllement,2025-03-03 11:00:00,0.53,0.97,0.74,158,143,178,26,11,15,37,21,16,7,6,1,-7,-5,-2,60%,58%,62%,110,106,114,22%,20%,23%,2,1,1,9,6,3
99,https://vlr.gg/player/314/ambi,2025-03-03 11:00:00,1.01,0.27,0.67,121,178,56,17,13,4,33,18,15,13,9,4,-3,+1,-4,69%,79%,57%,81,114,43,16%,19%,9%,3,3,0,6,2,4
100,https://vlr.gg/player/3993/jawgemo,2025-03-02 06:15:00,1.18,1.20,1.19,243,262,228,103,59,44,89,50,39,44,21,23,-8,-9,+1,78%,77%,79%,160,165,154,28%,29%,26%,12,9,3,20,18,2
101,https://vlr.gg/player/15500/trent,2025-03-02 06:15:00,1.11,1.25,1.17,224,193,243,92,42,50,79,43,36,40,22,18,+5,-1,+6,75%,72%,79%,145,129,164,29%,26%,31%,14,6,8,9,7,2
102,https://vlr.gg/player/3885/valyn,2025-03-02 06:15:00,1.02,1.28,1.14,210,205,226,94,49,45,82,48,34,51,27,24,0,-1,+1,77%,77%,77%,138,127,150,25%,26%,24%,10,5,5,10,6,4
103,https://vlr.gg/player/7873/leaf,2025-03-02 06:15:00,0.81,1.06,0.93,190,160,210,79,36,43,86,45,41,31,13,18,-2,-3,+1,75%,71%,81%,119,107,133,21%,28%,14%,13,3,10,15,6,9
104,https://vlr.gg/player/4581/jonahp,2025-03-02 06:15:00,0.92,0.83,0.88,162,166,166,74,40,34,87,46,41,42,17,25,-4,-2,-2,75%,78%,72%,105,110,98,28%,30%,25%,7,1,6,11,3,8
105,https://vlr.gg/player/485/stax,2025-03-02 06:15:00,1.01,0.99,1.00,184,187,190,82,39,43,84,41,43,35,17,18,+3,+1,+2,75%,75%,74%,132,134,131,29%,28%,31%,6,1,5,3,0,3
106,https://vlr.gg/player/13039/meteor,2025-03-02 06:15:00,0.96,1.05,1.00,219,225,227,94,43,51,96,47,49,30,13,17,+5,-2,+7,65%,61%,68%,153,161,147,31%,32%,30%,18,7,11,13,9,4
107,https://vlr.gg/player/4056/sylvan,2025-03-02 06:15:00,0.94,1.04,0.99,191,166,215,82,33,49,84,40,44,65,33,32,+8,+3,+5,77%,70%,83%,111,94,126,24%,24%,23%,12,4,8,4,1,3
108,https://vlr.gg/player/29833/izu,2025-03-02 06:15:00,0.94,0.89,0.91,190,193,182,78,37,41,87,41,46,42,23,19,-1,-3,+2,74%,70%,77%,122,122,121,27%,23%,31%,10,3,7,11,6,5
109,https://vlr.gg/player/804/buzz,2025-03-02 06:15:00,0.75,1.00,0.88,205,189,214,84,36,48,96,47,49,22,9,13,-6,-6,0,69%,58%,78%,128,118,136,19%,20%,18%,19,10,9,25,16,9
110,https://vlr.gg/player/9/tenz,2025-03-02 05:00:00,,,,,,,,,,,,,,,,,,,,,,,,,,,,,,,,,
111,https://vlr.gg/player/29260/kohal,2025-03-02 05:00:00,,,,,,,,,,,,,,,,,,,,,,,,,,,,,,,,,
112,https://vlr.gg/player/9783/doenmo,2025-03-02 05:00:00,,,,,,,,,,,,,,,,,,,,,,,,,,,,,,,,,
113,https://vlr.gg/player/1265/johnqt,2025-03-02 05:00:00,,,,,,,,,,,,,,,,,,,,,,,,,,,,,,,,,
114,,2025-03-02 05:00:00,,,,,,,,,,,,,,,,,,,,,,,,,,,,,,,,,
115,https://vlr.gg/player/4375/superbuss,2025-03-02 05:00:00,,,,,,,,,,,,,,,,,,,,,,,,,,,,,,,,,
116,https://vlr.gg/player/18133/mintauka,2025-03-02 05:00:00,,,,,,,,,,,,,,,,,,,,,,,,,,,,,,,,,
117,https://vlr.gg/player/24679/cgrs,2025-03-02 05:00:00,,,,,,,,,,,,,,,,,,,,,,,,,,,,,,,,,
118,https://vlr.gg/player/25255/primmie,2025-03-02 05:00:00,,,,,,,,,,,,,,,,,,,,,,,,,,,,,,,,,
119,,2025-03-02 05:00:00,,,,,,,,,,,,,,,,,,,,,,,,,,,,,,,,,
120,https://vlr.gg/player/4742/smoggy,2025-03-01 05:00:00,1.02,0.95,0.99,198,189,210,54,30,24,64,36,28,47,28,19,0,+1,-1,73%,71%,74%,129,131,128,35%,36%,33%,9,4,5,9,3,6
121,https://vlr.gg/player/3520/zmjjkk,2025-03-01 05:00:00,0.87,1.17,0.99,225,212,264,69,37,32,71,41,30,11,7,4,-4,-6,+2,68%,61%,77%,154,141,171,24%,26%,22%,15,7,8,19,13,6
122,https://vlr.gg/player/15559/chichoo,2025-03-01 05:00:00,1.10,0.59,0.89,176,198,157,53,34,19,61,31,30,16,10,6,-4,-2,-2,61%,61%,60%,115,126,99,28%,32%,23%,5,4,1,9,6,3
123,https://vlr.gg/player/3017/nobody,2025-03-01 05:00:00,0.86,0.73,0.80,158,166,162,44,26,18,65,37,28,27,18,9,-3,-3,0,65%,71%,57%,116,120,110,25%,27%,22%,4,2,2,7,5,2
124,https://vlr.gg/player/13768/s1mon,2025-03-01 05:00:00,0.94,0.49,0.75,143,171,114,43,32,11,70,39,31,37,21,16,-3,-1,-2,64%,67%,60%,95,104,81,23%,22%,25%,2,2,0,5,3,2
125,https://vlr.gg/player/29833/izu,2025-03-01 05:00:00,1.31,1.35,1.34,221,192,240,71,27,44,46,16,30,12,2,10,+6,+1,+5,83%,80%,86%,149,134,160,30%,32%,28%,10,4,6,4,3,1
126,https://vlr.gg/player/804/buzz,2025-03-01 05:00:00,1.36,1.08,1.20,268,319,235,78,40,38,58,26,32,24,12,12,+1,0,+1,75%,86%,67%,165,193,145,17%,20%,13%,13,5,8,12,5,7
127,https://vlr.gg/player/485/stax,2025-03-01 05:00:00,1.11,1.18,1.15,195,172,210,61,23,38,46,19,27,31,18,13,0,-1,+1,77%,86%,71%,128,115,138,34%,46%,29%,4,1,3,4,2,2
128,https://vlr.gg/player/13039/meteor,2025-03-01 05:00:00,1.11,1.08,1.10,260,248,259,75,30,45,60,24,36,22,7,15,+7,+2,+5,76%,83%,71%,163,159,166,34%,37%,32%,17,7,10,10,5,5
129,https://vlr.gg/player/4056/sylvan,2025-03-01 05:00:00,1.48,0.73,1.04,176,232,139,46,27,19,53,19,34,80,41,39,0,+1,-1,76%,86%,69%,111,146,87,23%,21%,26%,5,2,3,5,1,4
130,https://vlr.gg/player/804/buzz,2025-02-28 07:05:00,1.44,1.04,1.20,270,318,234,57,28,29,42,15,27,14,5,9,+9,+4,+5,70%,79%,65%,168,200,146,13%,18%,10%,15,6,9,6,2,4
131,https://vlr.gg/player/29833/izu,2025-02-28 07:05:00,0.98,1.28,1.16,213,184,217,49,15,34,34,14,20,14,7,7,-4,-1,-3,69%,71%,68%,119,108,126,29%,29%,30%,6,1,5,10,2,8
132,https://vlr.gg/player/13039/meteor,2025-02-28 07:05:00,1.16,1.13,1.14,233,243,229,51,20,31,43,15,28,15,6,9,+6,+5,+1,79%,88%,73%,146,146,146,35%,38%,33%,10,8,2,4,3,1
133,https://vlr.gg/player/4056/sylvan,2025-02-28 07:05:00,1.42,0.86,1.08,176,233,139,38,21,17,34,12,22,37,15,22,+1,+1,0,84%,92%,78%,113,145,91,29%,38%,22%,3,1,2,2,0,2
134,https://vlr.gg/player/485/stax,2025-02-28 07:05:00,1.00,1.09,1.05,158,129,176,35,12,23,30,10,20,17,5,12,-1,-1,0,80%,79%,81%,116,97,128,34%,31%,35%,2,0,2,3,1,2
135,https://vlr.gg/player/2168/trexx,2025-02-28 07:05:00,1.26,0.84,1.09,207,227,182,41,28,13,44,23,21,24,14,10,+2,+2,0,66%,73%,54%,132,143,114,18%,18%,18%,3,2,1,1,0,1
136,https://vlr.gg/player/5022/derke,2025-02-28 07:05:00,0.99,1.05,1.01,215,237,199,46,29,17,47,30,17,9,8,1,-6,-3,-3,64%,62%,67%,143,151,130,24%,24%,23%,8,5,3,14,8,6
137,https://vlr.gg/player/8447/less,2025-02-28 07:05:00,0.86,1.07,0.94,167,172,199,37,20,17,45,28,17,17,14,3,-2,-1,-1,61%,62%,58%,115,113,117,33%,29%,41%,4,4,0,6,5,1
138,https://vlr.gg/player/312/sayf,2025-02-28 07:05:00,1.02,0.28,0.72,170,204,113,33,27,6,48,26,22,14,8,6,+2,+2,0,64%,76%,46%,110,129,80,20%,26%,8%,7,4,3,5,2,3
139,https://vlr.gg/player/11134/kicks,2025-02-28 07:05:00,0.54,0.72,0.61,123,112,160,26,13,13,46,27,19,23,14,9,-7,-3,-4,72%,73%,71%,85,74,102,23%,18%,31%,3,2,1,10,5,5
140,https://vlr.gg/player/4742/smoggy,2025-02-28 05:00:00,1.06,1.00,1.04,203,182,238,29,15,14,32,17,15,13,10,3,+1,-1,+2,68%,67%,71%,147,145,152,37%,38%,36%,4,0,4,3,1,2
141,https://vlr.gg/player/15559/chichoo,2025-02-28 05:00:00,0.79,1.06,0.90,196,165,240,29,15,14,32,19,13,10,4,6,0,-1,+1,66%,67%,65%,140,113,178,33%,29%,38%,2,1,1,2,2,0
142,https://vlr.gg/player/3017/nobody,2025-02-28 05:00:00,0.77,1.05,0.88,168,154,191,23,12,11,29,18,11,8,5,3,+2,+2,0,68%,75%,59%,114,101,133,28%,24%,33%,5,3,2,3,1,2
143,https://vlr.gg/player/3520/zmjjkk,2025-02-28 05:00:00,0.79,0.89,0.83,211,205,220,31,17,14,34,19,15,2,1,1,-8,-7,-1,56%,54%,59%,135,137,133,25%,28%,20%,5,3,2,13,10,3
144,https://vlr.gg/player/13768/s1mon,2025-02-28 05:00:00,0.95,0.34,0.70,122,153,78,16,13,3,31,18,13,15,11,4,-2,-1,-1,66%,75%,53%,81,98,57,35%,41%,26%,1,1,0,3,2,1
145,https://vlr.gg/player/15500/trent,2025-02-28 05:00:00,0.83,1.49,1.22,218,164,257,30,8,22,23,11,12,10,4,6,0,-1,+1,76%,76%,75%,154,118,179,20%,16%,22%,2,0,2,2,1,1
146,https://vlr.gg/player/4581/jonahp,2025-02-28 05:00:00,1.87,0.76,1.22,235,365,147,33,23,10,29,12,17,20,8,12,+5,+2,+3,83%,94%,75%,148,215,100,21%,25%,14%,7,3,4,2,1,1
147,https://vlr.gg/player/3993/jawgemo,2025-02-28 05:00:00,0.87,1.43,1.20,251,199,286,37,12,25,27,12,15,18,4,14,+2,+1,+1,78%,65%,88%,155,134,169,21%,21%,20%,7,5,2,5,4,1
148,https://vlr.gg/player/3885/valyn,2025-02-28 05:00:00,1.00,1.17,1.10,182,173,189,27,11,16,25,11,14,22,8,14,-1,0,-1,80%,82%,79%,124,102,140,33%,30%,35%,3,0,3,4,0,4
149,https://vlr.gg/player/7873/leaf,2025-02-28 05:00:00,1.04,1.09,1.07,196,182,206,30,12,18,24,10,14,8,3,5,+1,-3,+4,71%,59%,79%,144,128,155,29%,35%,26%,5,0,5,4,3,1
150,https://vlr.gg/player/11134/kicks,2025-02-27 08:15:00,1.28,0.88,1.07,214,258,170,38,22,16,36,17,19,18,11,7,-3,0,-3,72%,75%,69%,140,162,118,27%,29%,25%,5,3,2,8,3,5
151,https://vlr.gg/player/8447/less,2025-02-27 08:15:00,0.64,1.25,0.95,199,141,252,34,12,22,37,19,18,17,8,9,-1,-3,+2,70%,71%,69%,122,85,156,24%,19%,28%,4,1,3,5,4,1
152,https://vlr.gg/player/5022/derke,2025-02-27 08:15:00,1.06,0.80,0.92,233,275,200,38,22,16,39,20,19,10,3,7,-2,+2,-4,66%,63%,69%,153,176,131,20%,24%,15%,9,6,3,11,4,7
153,https://vlr.gg/player/2168/trexx,2025-02-27 08:15:00,0.87,0.91,0.89,171,183,167,29,14,15,35,19,16,20,17,3,-1,-1,0,68%,79%,58%,116,120,112,19%,18%,20%,2,1,1,3,2,1
154,https://vlr.gg/player/312/sayf,2025-02-27 08:15:00,0.66,1.02,0.85,195,149,231,34,13,21,38,19,19,11,5,6,-1,0,-1,76%,71%,81%,114,94,132,28%,28%,28%,1,0,1,2,0,2
155,https://vlr.gg/player/7873/leaf,2025-02-27 08:15:00,1.63,1.42,1.53,304,331,274,52,31,21,35,19,16,28,11,17,+5,+5,0,84%,88%,79%,194,208,179,23%,27%,19%,8,5,3,3,0,3
156,https://vlr.gg/player/15500/trent,2025-02-27 08:15:00,1.20,1.47,1.33,237,206,274,43,19,24,34,16,18,17,10,7,+1,+1,0,78%,73%,83%,159,139,181,23%,27%,20%,4,2,2,3,1,2
157,https://vlr.gg/player/4581/jonahp,2025-02-27 08:15:00,1.12,0.97,1.05,186,173,198,35,18,17,34,16,18,25,14,11,+1,0,+1,78%,77%,79%,123,115,133,32%,35%,29%,4,1,3,3,1,2
158,https://vlr.gg/player/3993/jawgemo,2025-02-27 08:15:00,0.64,0.97,0.80,170,177,170,30,14,16,37,22,15,11,7,4,-1,-1,0,66%,62%,71%,115,105,126,20%,18%,23%,9,6,3,10,7,3
159,https://vlr.gg/player/3885/valyn,2025-02-27 08:15:00,0.61,1.02,0.80,135,108,175,24,9,15,33,17,16,21,10,11,+2,+1,+1,70%,58%,83%,88,75,101,18%,18%,19%,4,2,2,2,1,1
160,https://vlr.gg/player/15559/chichoo,2025-02-27 05:00:00,1.60,1.73,1.66,322,294,367,72,38,34,43,22,21,28,17,11,+7,+4,+3,87%,86%,89%,217,192,249,29%,23%,39%,8,4,4,1,0,1
161,https://vlr.gg/player/3017/nobody,2025-02-27 05:00:00,0.92,1.12,1.00,182,178,198,44,25,19,41,24,17,9,7,2,+2,-1,+3,78%,86%,67%,128,120,138,34%,33%,36%,6,1,5,4,2,2
162,https://vlr.gg/player/3520/zmjjkk,2025-02-27 05:00:00,1.03,0.87,0.96,227,254,174,49,31,18,47,27,20,13,12,1,-2,0,-2,73%,81%,63%,133,156,102,21%,23%,19%,15,12,3,17,12,5
163,https://vlr.gg/player/4742/smoggy,2025-02-27 05:00:00,1.01,0.81,0.92,171,178,158,38,24,14,41,22,19,29,21,8,-4,-3,-1,79%,81%,78%,108,108,108,28%,27%,29%,2,0,2,6,3,3
164,https://vlr.gg/player/13768/s1mon,2025-02-27 05:00:00,0.96,0.62,0.81,153,165,150,37,23,14,43,22,21,30,20,10,-4,-2,-2,83%,89%,74%,105,107,102,35%,41%,28%,0,0,0,4,2,2
165,https://vlr.gg/player/804/buzz,2025-02-27 05:00:00,1.15,1.03,1.08,215,232,202,48,23,25,48,20,28,13,6,7,-1,-1,0,65%,70%,61%,145,156,137,23%,25%,23%,7,4,3,8,5,3
166,https://vlr.gg/player/4056/sylvan,2025-02-27 05:00:00,0.98,1.11,1.06,236,204,265,52,20,32,52,20,32,22,11,11,+4,+2,+2,65%,67%,64%,150,127,168,35%,22%,46%,6,2,4,2,0,2
167,https://vlr.gg/player/29833/izu,2025-02-27 05:00:00,1.02,1.07,1.05,190,225,166,43,20,23,41,20,21,12,8,4,+3,0,+3,71%,74%,69%,120,155,95,30%,28%,34%,12,3,9,9,3,6
168,https://vlr.gg/player/485/stax,2025-02-27 05:00:00,1.02,0.68,0.83,152,160,148,33,16,17,47,17,30,31,17,14,-5,-3,-2,60%,67%,56%,107,109,105,27%,37%,20%,1,0,1,6,3,3
169,https://vlr.gg/player/13039/meteor,2025-02-27 05:00:00,0.72,0.76,0.75,181,181,179,39,19,20,52,22,30,14,4,10,0,+1,-1,68%,67%,69%,120,114,125,32%,34%,31%,6,4,2,6,3,3
170,https://vlr.gg/player/651/frz,2025-02-26 18:00:00,1.22,0.74,0.98,196,234,159,28,17,11,28,12,16,4,4,0,-2,-2,0,70%,85%,55%,126,152,99,31%,27%,40%,1,0,1,3,2,1
171,https://vlr.gg/player/1581/guhrvn,2025-02-26 18:00:00,1.12,0.76,0.94,198,195,200,27,14,13,27,11,16,9,6,3,-2,+1,-3,63%,70%,55%,134,132,135,33%,33%,32%,4,2,2,6,1,5
172,https://vlr.gg/player/1575/quick,2025-02-26 18:00:00,1.04,0.78,0.91,198,190,207,28,14,14,28,10,18,2,1,1,-4,-3,-1,63%,60%,65%,125,111,138,37%,32%,41%,4,1,3,8,4,4
173,https://vlr.gg/player/13093/jzz,2025-02-26 18:00:00,0.81,0.43,0.62,155,223,88,22,16,6,33,16,17,4,3,1,0,+2,-2,55%,65%,45%,102,142,61,21%,19%,28%,5,5,0,5,3,2
174,https://vlr.gg/player/8872/mazin,2025-02-26 18:00:00,0.54,0.33,0.44,86,95,77,11,6,5,29,13,16,11,7,4,0,0,0,70%,85%,55%,59,65,52,31%,23%,43%,2,1,1,2,1,1
175,https://vlr.gg/player/1671/kon4n,2025-02-26 18:00:00,1.25,1.45,1.35,245,249,240,34,18,16,22,11,11,13,5,8,+3,0,+3,88%,90%,85%,161,153,169,27%,20%,35%,5,2,3,2,2,0
176,https://vlr.gg/player/3455/zanatsu,2025-02-26 18:00:00,1.59,1.02,1.30,262,327,198,36,23,13,26,12,14,5,4,1,+3,+5,-2,78%,90%,65%,167,205,130,18%,16%,20%,13,9,4,10,4,6
177,https://vlr.gg/player/13823/pxs,2025-02-26 18:00:00,1.41,0.82,1.11,184,220,147,28,18,10,21,8,13,6,1,5,0,+1,-1,78%,75%,80%,121,140,102,38%,45%,28%,2,1,1,2,0,2
178,https://vlr.gg/player/11105/rich,2025-02-26 18:00:00,1.33,0.73,1.03,158,193,123,25,16,9,22,8,14,9,5,4,+4,+1,+3,73%,85%,60%,103,132,74,41%,47%,35%,4,1,3,0,0,0
179,https://vlr.gg/player/3157/gaabxx,2025-02-26 18:00:00,0.74,0.99,0.86,150,93,207,22,8,14,25,10,15,11,4,7,-2,-1,-1,75%,85%,65%,99,60,138,26%,36%,23%,0,0,0,2,1,1
180,https://vlr.gg/player/36433/phc,2025-02-26 15:00:00,1.35,1.63,1.47,249,199,308,38,17,21,22,10,12,17,10,7,+2,0,+2,79%,83%,74%,158,132,191,25%,22%,29%,4,0,4,2,0,2
181,https://vlr.gg/player/6202/guuih,2025-02-26 15:00:00,1.17,1.29,1.22,209,203,220,34,18,16,25,14,11,8,5,3,0,0,0,81%,75%,89%,148,149,146,38%,40%,37%,3,1,2,3,1,2
182,https://vlr.gg/player/3424/siduzord,2025-02-26 15:00:00,1.38,0.86,1.15,216,242,184,33,22,11,25,11,14,13,6,7,0,+1,-1,72%,88%,53%,147,166,123,27%,28%,27%,1,1,0,1,0,1
183,https://vlr.gg/player/15681/palla,2025-02-26 15:00:00,1.11,1.11,1.11,251,264,236,36,21,15,32,18,14,11,5,6,+4,+3,+1,77%,79%,74%,166,171,158,26%,22%,35%,12,9,3,8,6,2
184,https://vlr.gg/player/9266/tisora,2025-02-26 15:00:00,0.65,0.69,0.67,142,159,120,21,13,8,30,18,12,13,7,6,-1,-2,+1,72%,71%,74%,91,99,82,18%,22%,13%,4,2,2,5,4,1
185,https://vlr.gg/player/41466/mixyce,2025-02-26 15:00:00,1.44,0.96,1.17,246,276,223,37,20,17,32,12,20,12,6,6,+1,0,+1,60%,68%,54%,161,180,147,23%,26%,20%,6,2,4,5,2,3
186,https://vlr.gg/player/45864/bruxo,2025-02-26 15:00:00,0.77,1.25,1.04,201,168,226,29,11,18,30,14,16,4,2,2,+6,+3,+3,67%,63%,71%,137,125,146,48%,37%,57%,8,4,4,2,1,1
187,https://vlr.gg/player/50786/renna,2025-02-26 15:00:00,0.87,1.08,0.98,161,146,176,26,10,16,28,13,15,9,5,4,-5,-3,-2,67%,68%,67%,110,108,111,29%,37%,24%,0,0,0,5,3,2
188,https://vlr.gg/player/41225/kramarick,2025-02-26 15:00:00,0.76,0.78,0.77,178,195,164,24,12,12,36,17,19,14,5,9,-1,+1,-2,74%,68%,79%,118,126,111,29%,23%,37%,1,1,0,2,0,2
189,https://vlr.gg/player/47551/sanoj,2025-02-26 15:00:00,0.62,0.25,0.42,129,163,100,18,10,8,36,15,21,4,3,1,-6,-4,-2,44%,53%,38%,87,109,69,31%,45%,20%,4,1,3,10,5,5
190,https://vlr.gg/player/41676/toronto,2025-02-26 15:00:00,0.88,1.02,0.97,219,172,260,26,8,18,27,10,17,4,1,3,0,+2,-2,69%,71%,67%,149,118,169,32%,27%,34%,3,2,1,3,0,3
191,https://vlr.gg/player/22914/hiiik,2025-02-26 15:00:00,1.12,0.84,0.92,213,208,224,25,9,16,28,9,19,14,8,6,-4,-2,-2,60%,57%,62%,142,149,137,38%,36%,39%,2,0,2,6,2,4
192,https://vlr.gg/player/23855/str0nda,2025-02-26 15:00:00,0.92,0.81,0.85,170,199,159,21,11,10,29,11,18,9,0,9,0,+1,-1,69%,79%,62%,119,120,119,32%,28%,34%,2,2,0,2,1,1
193,https://vlr.gg/player/41864/rodd,2025-02-26 15:00:00,0.48,0.54,0.51,147,135,144,16,7,9,31,11,20,5,1,4,-3,-2,-1,60%,64%,57%,104,98,108,21%,23%,20%,1,0,1,4,2,2
194,https://vlr.gg/player/32801/turkish,2025-02-26 15:00:00,0.63,0.37,0.48,118,144,101,12,6,6,28,10,18,3,0,3,-4,+1,-5,60%,57%,62%,86,101,76,40%,48%,32%,4,3,1,8,2,6
195,https://vlr.gg/player/28715/hunterx,2025-02-26 15:00:00,1.50,1.28,1.41,222,237,165,27,19,8,16,10,6,15,9,6,+2,+2,0,83%,90%,71%,142,161,113,28%,29%,28%,2,2,0,0,0,0
196,https://vlr.gg/player/23010/nicksz,2025-02-26 15:00:00,1.46,1.16,1.34,248,261,216,33,21,12,20,10,10,17,12,5,+3,+3,0,80%,90%,64%,155,170,133,26%,26%,26%,6,3,3,3,0,3
197,https://vlr.gg/player/33121/stwz1,2025-02-26 15:00:00,1.33,1.21,1.28,214,210,210,27,17,10,19,10,9,18,12,6,+2,+1,+1,86%,90%,79%,136,132,140,42%,39%,48%,3,2,1,1,1,0
198,https://vlr.gg/player/32732/yeah,2025-02-26 15:00:00,1.13,1.39,1.23,266,276,288,35,20,15,25,16,9,10,4,6,-1,+1,-2,80%,81%,79%,188,181,199,30%,33%,25%,5,3,2,6,2,4
199,https://vlr.gg/player/44448/insano,2025-02-26 15:00:00,0.94,1.04,0.98,178,191,132,21,15,6,20,13,7,8,4,4,+5,+4,+1,69%,76%,57%,115,130,93,32%,32%,32%,7,6,1,2,2,0
200,https://vlr.gg/player/38142/dream,2025-02-26 14:15:00,0.93,1.38,1.18,238,173,293,51,17,34,39,19,20,9,3,6,+4,-1,+5,74%,58%,87%,159,108,201,22%,17%,24%,6,1,5,2,2,0
201,https://vlr.gg/player/41197/thuy,2025-02-26 14:15:00,1.30,0.85,1.06,198,255,152,39,23,16,37,18,19,25,7,18,0,+1,-1,70%,65%,74%,131,162,105,34%,43%,25%,2,1,1,2,0,2
202,https://vlr.gg/player/43744/akita,2025-02-26 14:15:00,0.63,1.22,0.95,235,189,275,47,16,31,48,25,23,9,5,4,+3,-7,+10,65%,50%,77%,156,133,176,37%,38%,37%,16,5,11,13,12,1
203,https://vlr.gg/player/16078/loupiote,2025-02-26 14:15:00,0.66,1.13,0.92,160,120,194,33,10,23,34,19,15,11,5,6,0,-2,+2,70%,69%,71%,109,84,130,34%,29%,37%,4,0,4,4,2,2
204,https://vlr.gg/player/17331/pinkalie,2025-02-26 14:15:00,0.62,0.96,0.81,149,112,181,31,11,20,40,20,20,27,10,17,0,-1,+1,72%,62%,81%,91,72,108,28%,29%,27%,4,1,3,4,2,2
205,https://vlr.gg/player/29960/nidxvilco,2025-02-26 14:15:00,0.88,1.55,1.19,212,181,250,43,18,25,38,25,13,22,10,12,0,-2,+2,77%,71%,85%,140,120,164,31%,26%,37%,3,1,2,3,3,0
206,https://vlr.gg/player/30105/ikyoo,2025-02-26 14:15:00,0.92,1.28,1.09,219,201,242,43,22,21,42,27,15,21,10,11,+4,-1,+5,79%,77%,81%,147,127,171,25%,24%,27%,7,1,6,3,2,1
207,https://vlr.gg/player/24140/superphrog,2025-02-26 14:15:00,1.10,0.97,1.04,229,232,225,47,25,22,43,25,18,7,4,3,-5,-6,+1,70%,61%,81%,144,149,138,26%,29%,21%,9,3,6,14,9,5
208,https://vlr.gg/player/30060/alessia,2025-02-26 14:15:00,0.84,1.03,0.91,188,179,200,39,21,18,38,22,16,6,1,5,-2,-6,+4,67%,61%,73%,116,103,130,29%,32%,27%,5,1,4,7,7,0
209,https://vlr.gg/player/40175/mayameow,2025-02-26 14:15:00,0.68,1.06,0.85,141,118,170,26,11,15,40,25,15,36,19,17,-4,-2,-2,77%,77%,77%,101,86,120,26%,23%,30%,1,1,0,5,3,2
210,https://vlr.gg/player/46311/mimier,2025-02-26 12:50:00,1.65,1.20,1.41,273,286,260,44,23,21,30,12,18,19,9,10,-2,0,-2,80%,86%,75%,176,181,172,34%,33%,35%,4,2,2,6,2,4
211,https://vlr.gg/player/47911/berryx,2025-02-26 12:50:00,1.69,0.93,1.29,248,340,169,42,27,15,29,13,16,13,5,8,+1,+3,-2,78%,81%,75%,167,228,113,23%,25%,15%,9,6,3,8,3,5
212,https://vlr.gg/player/17326/htm,2025-02-26 12:50:00,0.84,1.31,1.09,178,131,219,30,11,19,27,12,15,11,4,7,-1,-1,0,84%,90%,79%,116,80,147,25%,20%,28%,2,0,2,3,1,2
213,https://vlr.gg/player/29442/wens,2025-02-26 12:50:00,1.16,0.91,1.02,201,224,182,33,18,15,30,13,17,12,3,9,-1,0,-1,78%,76%,79%,136,138,134,44%,44%,44%,5,3,2,6,3,3
214,https://vlr.gg/player/17408/lateu,2025-02-26 12:50:00,0.59,1.17,0.90,153,104,196,28,7,21,30,14,16,16,11,5,-2,-1,-1,76%,57%,92%,105,73,133,33%,40%,30%,0,0,0,2,1,1
215,https://vlr.gg/player/41207/jade,2025-02-26 12:50:00,1.36,1.07,1.23,238,261,211,37,22,15,31,16,15,18,8,10,+3,+2,+1,73%,75%,71%,146,159,132,40%,48%,31%,3,2,1,0,0,0
216,https://vlr.gg/player/30042/harmonee,2025-02-26 12:50:00,1.03,0.56,0.81,166,206,121,27,20,7,36,18,18,6,2,4,-2,-2,0,58%,71%,43%,122,134,108,32%,40%,23%,3,2,1,5,4,1
217,https://vlr.gg/player/37969/ellie,2025-02-26 12:50:00,0.85,0.70,0.78,196,225,163,32,19,13,39,21,18,5,4,1,+7,+4,+3,62%,75%,48%,133,152,112,32%,39%,21%,13,8,5,6,4,2
218,https://vlr.gg/player/19373/ginger,2025-02-26 12:50:00,0.59,0.89,0.73,186,157,221,29,14,15,38,20,18,7,4,3,-2,+2,-4,67%,71%,62%,112,95,132,31%,27%,33%,5,3,2,7,1,6
219,https://vlr.gg/player/17318/blossi,2025-02-26 12:50:00,0.59,0.87,0.72,141,105,186,21,7,14,33,16,17,16,5,11,-1,0,-1,62%,67%,57%,90,71,112,18%,19%,18%,1,0,1,2,0,2
220,https://vlr.gg/player/30186/nami,2025-02-26 11:00:00,1.23,1.24,1.23,269,255,276,64,30,34,47,21,26,24,10,14,+4,+1,+3,73%,63%,83%,164,158,170,40%,47%,36%,10,5,5,6,4,2
221,https://vlr.gg/player/24107/sarah,2025-02-26 11:00:00,0.79,1.24,1.02,206,161,251,51,20,31,43,23,20,10,4,6,+4,+2,+2,72%,66%,77%,130,106,152,34%,29%,37%,8,3,5,4,1,3
222,https://vlr.gg/player/16418/smurfette,2025-02-26 11:00:00,1.07,0.98,1.02,225,255,201,56,30,26,46,25,21,3,2,1,-5,-4,-1,66%,69%,63%,148,165,132,31%,27%,38%,12,6,6,17,10,7
223,https://vlr.gg/player/17343/ness,2025-02-26 11:00:00,1.05,0.98,1.01,210,213,202,48,23,25,44,20,24,23,13,10,+3,+1,+2,79%,81%,77%,132,135,129,25%,28%,23%,4,1,3,1,0,1
224,https://vlr.gg/player/19371/eva,2025-02-26 11:00:00,1.00,0.84,0.92,144,173,120,35,20,15,39,20,19,22,9,13,-1,0,-1,82%,84%,80%,107,129,86,28%,33%,22%,2,1,1,3,1,2
225,https://vlr.gg/player/20064/vania,2025-02-26 11:00:00,1.31,1.16,1.24,253,270,248,61,32,29,49,24,25,9,6,3,+1,0,+1,69%,74%,63%,171,180,161,23%,21%,25%,12,7,5,11,7,4
226,https://vlr.gg/player/24149/amy,2025-02-26 11:00:00,1.00,0.88,0.94,198,209,178,43,24,19,51,27,24,20,9,11,-5,-3,-2,70%,71%,69%,126,139,113,34%,30%,41%,6,3,3,11,6,5
227,https://vlr.gg/player/17323/mimi,2025-02-26 11:00:00,0.98,0.78,0.89,157,160,154,38,21,17,49,24,25,23,12,11,+2,+2,0,66%,69%,63%,102,102,102,31%,39%,25%,5,2,3,3,0,3
228,https://vlr.gg/player/16321/nelo,2025-02-26 11:00:00,0.92,0.82,0.87,165,165,165,40,22,18,53,27,26,25,15,10,-2,-3,+1,73%,80%,66%,102,98,107,36%,33%,40%,2,1,1,4,4,0
229,https://vlr.gg/player/17320/petra,2025-02-26 11:00:00,0.40,1.13,0.74,155,92,223,36,11,25,52,29,23,11,6,5,-1,-1,0,64%,63%,66%,105,65,148,25%,33%,22%,6,2,4,7,3,4
230,https://vlr.gg/player/20058/devilasxa,2025-02-26 11:00:00,1.79,1.98,1.82,324,342,219,36,31,5,13,13,0,5,5,0,+5,+5,0,89%,88%,100%,205,213,155,39%,39%,44%,6,6,0,1,1,0
231,https://vlr.gg/player/26632/joliinaa,2025-02-26 11:00:00,1.57,2.14,1.65,306,300,343,32,27,5,14,13,1,6,4,2,+4,+4,0,82%,79%,100%,201,203,192,28%,27%,31%,5,5,0,1,1,0
232,https://vlr.gg/player/45174/purity,2025-02-26 11:00:00,1.27,1.13,1.25,257,253,286,27,23,4,16,13,3,6,4,2,0,-1,+1,79%,79%,75%,153,155,144,33%,27%,78%,4,3,1,4,4,0
233,https://vlr.gg/player/20116/jademwah,2025-02-26 11:00:00,1.16,1.46,1.20,167,170,156,19,16,3,13,12,1,19,16,3,+1,+1,0,86%,83%,100%,113,118,79,11%,11%,11%,1,1,0,0,0,0
234,https://vlr.gg/player/39506/cabbit,2025-02-26 11:00:00,0.96,1.21,0.99,192,183,245,18,15,3,18,15,3,19,15,4,+2,+1,+1,89%,88%,100%,123,123,125,29%,30%,27%,4,2,2,2,1,1
235,https://vlr.gg/player/30107/fluxxy,2025-02-26 11:00:00,0.12,1.10,0.94,247,83,275,22,1,21,26,4,22,10,0,10,-2,0,-2,64%,25%,71%,160,47,179,35%,50%,34%,1,0,1,3,0,3
236,https://vlr.gg/player/37990/adora,2025-02-26 11:00:00,0.66,0.67,0.67,167,167,168,16,2,14,26,4,22,4,2,2,0,0,0,61%,100%,54%,101,98,102,25%,33%,23%,3,1,2,3,1,2
237,https://vlr.gg/player/24101/miyori,2025-02-26 11:00:00,0.40,0.71,0.64,160,108,170,13,1,12,26,4,22,9,0,9,-5,-2,-3,64%,25%,71%,113,97,115,39%,71%,32%,3,0,3,8,2,6
238,https://vlr.gg/player/9431/cille,2025-02-26 11:00:00,0.44,0.54,0.53,119,95,123,11,1,10,26,4,22,7,1,6,+1,0,+1,57%,75%,54%,80,53,84,24%,11%,28%,1,0,1,0,0,0
239,https://vlr.gg/player/19362/lyda,2025-02-26 11:00:00,0.64,0.34,0.39,147,195,140,12,3,9,28,4,24,7,0,7,-6,0,-6,50%,50%,50%,105,121,102,31%,43%,29%,0,0,0,6,0,6
240,https://vlr.gg/player/25053/wolverine,2025-02-26 07:05:00,0.88,0.87,0.87,200,209,199,25,11,14,29,11,18,7,2,5,+4,+1,+3,51%,47%,54%,132,137,129,31%,31%,30%,6,2,4,2,1,1
241,https://vlr.gg/player/20879/sungjin,2025-02-26 07:05:00,1.17,0.62,0.83,182,268,133,23,14,9,30,12,18,7,5,2,+1,+2,-1,72%,87%,63%,129,180,97,15%,17%,13%,3,3,0,2,1,1
242,https://vlr.gg/player/4657/moves,2025-02-26 07:05:00,1.15,0.61,0.82,139,186,129,21,12,9,29,9,20,11,3,8,-2,0,-2,67%,80%,58%,107,125,96,38%,50%,29%,1,1,0,3,1,2
243,https://vlr.gg/player/9236/manggong,2025-02-26 07:05:00,0.89,0.71,0.78,177,214,152,22,10,12,28,10,18,9,4,5,0,0,0,56%,67%,50%,117,138,104,24%,19%,29%,2,0,2,2,0,2
244,https://vlr.gg/player/9221/kanade,2025-02-26 07:05:00,0.43,0.59,0.53,154,118,175,18,5,13,31,11,20,5,3,2,-6,-4,-2,62%,60%,63%,98,83,108,33%,25%,38%,6,1,5,12,5,7
245,https://vlr.gg/player/25017/ash,2025-02-26 07:05:00,1.80,2.31,1.99,320,290,376,47,26,21,15,8,7,6,4,2,+6,+3,+3,87%,83%,93%,218,193,257,30%,33%,27%,6,3,3,0,0,0
246,https://vlr.gg/player/50827/gnadel,2025-02-26 07:05:00,1.29,1.11,1.22,189,180,195,28,17,11,20,9,11,5,2,3,-1,-1,0,64%,67%,60%,131,132,129,33%,27%,45%,3,2,1,4,3,1
247,https://vlr.gg/player/4475/benecia,2025-02-26 07:05:00,0.98,1.11,1.03,164,158,186,23,14,9,22,14,8,15,9,6,+3,+1,+2,79%,75%,87%,110,91,140,20%,27%,14%,5,3,2,2,2,0
248,https://vlr.gg/player/9192/cloudy,2025-02-26 07:05:00,1.14,0.60,0.93,147,138,155,20,13,7,23,10,13,13,10,3,-1,0,-1,72%,79%,60%,95,92,101,38%,39%,36%,1,1,0,2,1,1
249,https://vlr.gg/player/50826/ramgi,2025-02-26 07:05:00,1.22,0.31,0.87,215,277,107,28,23,5,29,16,13,7,3,4,-4,-1,-3,79%,88%,67%,136,175,73,34%,34%,33%,6,4,2,10,5,5
250,https://vlr.gg/player/24979/cloy,2025-02-26 03:00:00,0.93,1.31,1.13,214,188,242,59,25,34,49,27,22,20,9,11,0,-1,+1,76%,74%,78%,139,121,155,35%,35%,35%,5,2,3,5,3,2
251,https://vlr.gg/player/17049/hermes,2025-02-26 03:00:00,1.14,1.10,1.12,225,250,205,57,31,26,48,25,23,12,5,7,0,-5,+5,75%,71%,78%,144,157,131,20%,17%,24%,10,2,8,10,7,3
252,https://vlr.gg/player/42793/kally,2025-02-26 03:00:00,1.14,1.05,1.09,171,174,168,47,24,23,40,21,19,20,9,11,-3,-1,-2,76%,74%,78%,110,109,110,27%,27%,27%,4,1,3,7,2,5
253,https://vlr.gg/player/25048/sid,2025-02-26 03:00:00,0.88,1.18,1.03,200,181,220,51,22,29,51,27,24,24,14,10,-4,-2,-2,71%,63%,78%,134,122,145,27%,27%,27%,3,2,1,7,4,3
254,https://vlr.gg/player/27444/banger,2025-02-26 03:00:00,0.90,0.92,0.91,193,188,204,46,23,23,54,26,28,24,7,17,+1,0,+1,65%,66%,65%,133,125,141,33%,39%,29%,11,6,5,10,6,4
255,https://vlr.gg/player/34926/oonzmlp,2025-02-26 03:00:00,1.26,0.82,1.04,206,243,172,54,31,23,48,23,25,11,9,2,+7,+7,0,67%,70%,63%,133,149,115,36%,34%,40%,12,9,3,5,2,3
256,https://vlr.gg/player/42755/shu,2025-02-26 03:00:00,0.96,1.09,1.02,183,154,217,47,21,26,48,23,25,34,15,19,-2,-2,0,76%,76%,77%,118,96,141,26%,22%,30%,2,2,0,4,4,0
257,https://vlr.gg/player/4426/klaus,2025-02-26 03:00:00,0.71,1.23,0.97,217,168,264,52,22,30,56,31,25,17,5,12,+5,-2,+7,65%,54%,77%,145,120,171,31%,30%,32%,12,2,10,7,4,3
258,https://vlr.gg/player/2149/c1nder,2025-02-26 03:00:00,0.92,0.86,0.89,165,164,160,38,19,19,51,27,24,30,16,14,0,-1,+1,76%,78%,74%,112,112,112,24%,22%,26%,1,0,1,1,1,0
259,https://vlr.gg/player/37532/zexy,2025-02-26 03:00:00,0.70,0.96,0.82,211,190,235,51,23,28,57,31,26,11,8,3,-4,-5,+1,63%,54%,71%,134,130,137,41%,41%,40%,12,4,8,16,9,7
260,https://vlr.gg/player/41224/tkzin,2025-02-25 18:00:00,0.89,1.63,1.38,279,169,334,53,10,43,37,15,22,10,4,6,+8,-2,+10,74%,56%,83%,176,112,208,26%,26%,26%,12,1,11,4,3,1
261,https://vlr.gg/player/2567/liazzi,2025-02-25 18:00:00,0.88,1.33,1.18,196,170,209,37,10,27,30,14,16,9,3,6,+3,+2,+1,80%,61%,89%,127,111,135,23%,19%,24%,5,3,2,2,1,1
262,https://vlr.gg/player/1578/shion,2025-02-25 18:00:00,0.99,1.04,1.02,198,216,187,36,14,22,37,16,21,21,3,18,-1,-1,0,78%,67%,83%,120,131,114,18%,20%,16%,2,0,2,3,1,2
263,https://vlr.gg/player/25858/sw,2025-02-25 18:00:00,0.46,1.14,0.91,200,140,225,37,8,29,41,17,24,24,7,17,-3,-1,-2,69%,50%,78%,124,83,145,26%,14%,30%,7,3,4,10,4,6
264,https://vlr.gg/player/2486/pollo,2025-02-25 18:00:00,0.63,0.77,0.73,139,153,145,29,9,20,38,15,23,11,6,5,-1,-2,+1,74%,67%,78%,96,91,98,33%,24%,39%,4,0,4,5,2,3
265,https://vlr.gg/player/5351/rglmeister,2025-02-25 18:00:00,0.93,1.56,1.14,175,167,230,40,21,19,32,25,7,23,19,4,0,0,0,78%,72%,89%,109,95,137,21%,18%,25%,1,1,0,1,1,0
266,https://vlr.gg/player/1567/bezn1,2025-02-25 18:00:00,1.15,1.01,1.10,201,207,221,39,24,15,34,24,10,16,12,4,+4,+4,0,74%,72%,78%,143,150,129,30%,32%,27%,6,4,2,2,0,2
267,https://vlr.gg/player/1566/prozin,2025-02-25 18:00:00,0.91,1.15,0.99,222,210,217,42,28,14,42,31,11,15,7,8,-4,-4,0,67%,56%,89%,134,136,130,32%,29%,38%,3,1,2,7,5,2
268,https://vlr.gg/player/6238/urango,2025-02-25 18:00:00,0.71,0.93,0.78,139,143,169,25,16,9,41,30,11,26,15,11,-3,-2,-1,72%,64%,89%,99,95,108,38%,40%,35%,3,2,1,6,4,2
269,https://vlr.gg/player/32717/maestr0,2025-02-25 18:00:00,0.54,1.35,0.77,208,152,309,36,16,20,43,31,12,12,8,4,-3,-8,+5,59%,50%,78%,129,105,178,19%,24%,11%,11,5,6,14,13,1
270,https://vlr.gg/player/32675/kring,2025-02-25 15:00:00,1.46,1.24,1.35,257,232,279,55,22,33,33,11,22,16,4,12,0,+1,-1,70%,78%,63%,166,140,191,31%,27%,34%,7,3,4,7,2,5
271,https://vlr.gg/player/14944/ind1n,2025-02-25 15:00:00,0.83,1.40,1.11,224,177,267,44,16,28,41,18,23,12,2,10,+3,+3,0,78%,78%,78%,146,106,186,20%,21%,20%,10,7,3,7,4,3
272,https://vlr.gg/player/1605/champzera,2025-02-25 15:00:00,0.91,1.00,0.95,143,122,166,33,12,21,36,13,23,22,10,12,-2,-1,-1,81%,89%,74%,87,83,92,21%,25%,19%,2,0,2,4,1,3
273,https://vlr.gg/player/1595/myssen,2025-02-25 15:00:00,1.00,0.66,0.83,160,137,183,35,12,23,38,13,25,12,4,8,-1,+1,-2,69%,78%,59%,103,91,115,37%,32%,41%,2,1,1,3,0,3
274,https://vlr.gg/player/44581/gdp,2025-02-25 15:00:00,0.66,0.24,0.45,85,103,67,17,11,6,41,16,25,9,3,6,-2,-1,-1,56%,59%,52%,57,65,48,17%,19%,14%,2,1,1,4,2,2
275,https://vlr.gg/player/15395/gbz,2025-02-25 15:00:00,1.24,1.08,1.16,205,217,193,42,22,20,34,13,21,11,6,5,+1,+1,0,83%,85%,81%,140,151,129,31%,31%,32%,3,2,1,2,1,1
276,https://vlr.gg/player/1650/bladez,2025-02-25 15:00:00,1.04,1.03,1.03,172,186,156,38,19,19,37,20,17,32,20,12,-1,0,-1,81%,78%,85%,116,123,109,41%,35%,50%,1,1,0,2,1,1
277,https://vlr.gg/player/32718/kenkayyy,2025-02-25 15:00:00,1.16,0.83,1.00,182,222,139,35,20,15,37,17,20,23,11,12,-1,+2,-3,76%,74%,78%,111,137,84,45%,57%,31%,4,3,1,5,1,4
278,https://vlr.gg/player/4556/txddy,2025-02-25 15:00:00,0.96,1.03,0.99,175,173,175,34,17,17,33,14,19,12,4,8,+3,0,+3,74%,74%,74%,110,110,110,28%,34%,23%,6,2,4,3,2,1
279,https://vlr.gg/player/32802/luid,2025-02-25 15:00:00,1.06,0.69,0.88,194,258,129,40,25,15,44,24,20,5,4,1,0,+2,-2,74%,78%,70%,131,170,91,17%,22%,9%,11,8,3,11,6,5
280,https://vlr.gg/player/1999/rnd,2025-02-25 15:00:00,0.82,1.48,1.18,271,220,315,38,14,24,33,18,15,8,4,4,+9,+3,+6,80%,80%,79%,179,147,206,17%,18%,16%,14,7,7,5,4,1
281,https://vlr.gg/player/8896/loweed,2025-02-25 15:00:00,1.15,0.80,0.96,151,186,132,24,15,9,27,11,16,15,4,11,-1,-1,0,77%,80%,75%,96,108,85,30%,31%,29%,0,0,0,1,1,0
282,https://vlr.gg/player/16620/bruninej,2025-02-25 15:00:00,1.17,0.66,0.89,167,214,132,26,16,10,27,12,15,12,5,7,-2,0,-2,68%,80%,58%,109,136,87,27%,33%,22%,1,1,0,3,1,2
283,https://vlr.gg/player/5342/duht,2025-02-25 15:00:00,0.52,0.70,0.62,147,131,159,21,8,13,32,15,17,9,4,5,-1,-3,+2,59%,60%,58%,98,91,105,13%,12%,13%,3,0,3,4,3,1
284,https://vlr.gg/player/6222/ginilson,2025-02-25 15:00:00,0.59,0.35,0.46,102,111,93,15,8,7,32,14,18,6,5,1,-9,-3,-6,57%,60%,54%,79,88,71,33%,24%,44%,2,0,2,11,3,8
285,https://vlr.gg/player/37091/peixeh,2025-02-25 15:00:00,1.51,1.12,1.33,228,245,211,35,22,13,26,11,15,25,11,14,+3,+1,+2,82%,88%,75%,139,153,122,40%,38%,41%,6,2,4,3,1,2
286,https://vlr.gg/player/2585/tinchoff,2025-02-25 15:00:00,1.18,1.32,1.24,183,191,175,31,17,14,22,12,10,7,4,3,-1,0,-1,77%,75%,80%,117,119,115,35%,44%,28%,3,3,0,4,3,1
287,https://vlr.gg/player/37098/tiezzi,2025-02-25 15:00:00,1.06,1.14,1.10,223,219,224,34,19,15,28,16,12,4,1,3,+4,+1,+3,70%,63%,80%,141,145,137,33%,41%,23%,10,6,4,6,5,1
288,https://vlr.gg/player/5722/prince,2025-02-25 15:00:00,1.05,1.13,1.08,155,114,206,26,10,16,20,9,11,21,10,11,-2,-1,-1,86%,88%,85%,105,83,131,24%,35%,18%,2,0,2,4,1,3
289,https://vlr.gg/player/945/drakonz,2025-02-25 15:00:00,0.93,0.87,0.90,170,168,173,25,13,12,28,15,13,14,6,8,0,-1,+1,80%,75%,85%,122,125,118,25%,33%,18%,3,1,2,3,2,1
290,https://vlr.gg/player/43744/akita,2025-02-25 14:00:00,0.84,1.71,1.28,285,200,363,74,24,50,54,30,24,15,7,8,0,-2,+2,73%,64%,82%,186,138,231,33%,28%,38%,11,4,7,11,6,5
291,https://vlr.gg/player/17331/pinkalie,2025-02-25 14:00:00,1.08,1.18,1.13,171,175,175,44,21,23,47,24,23,42,18,24,+3,0,+3,81%,78%,84%,112,117,107,24%,19%,31%,6,1,5,3,1,2
292,https://vlr.gg/player/41197/thuy,2025-02-25 14:00:00,1.14,1.08,1.11,202,222,181,52,27,25,51,26,25,29,10,19,-3,0,-3,68%,67%,68%,131,146,117,26%,31%,22%,4,4,0,7,4,3
293,https://vlr.gg/player/16078/loupiote,2025-02-25 14:00:00,0.82,0.97,0.89,175,154,203,47,20,27,56,29,27,19,12,7,-1,-4,+3,73%,72%,74%,127,110,144,28%,33%,24%,7,1,6,8,5,3
294,https://vlr.gg/player/38142/dream,2025-02-25 14:00:00,0.95,0.55,0.74,136,158,122,36,22,14,50,23,27,19,12,7,-3,-4,+1,66%,64%,68%,92,94,91,14%,11%,18%,7,3,4,10,7,3
295,https://vlr.gg/player/41207/jade,2025-02-25 14:00:00,0.94,1.33,1.13,207,191,228,54,25,29,50,29,21,35,17,18,+3,+1,+2,72%,68%,75%,145,123,168,34%,25%,45%,5,1,4,2,0,2
296,https://vlr.gg/player/19373/ginger,2025-02-25 14:00:00,0.93,1.18,1.05,209,184,231,55,25,30,48,26,22,12,3,9,+5,+2,+3,68%,58%,78%,130,118,143,33%,33%,32%,11,5,6,6,3,3
297,https://vlr.gg/player/17318/blossi,2025-02-25 14:00:00,0.99,0.96,0.98,184,190,171,49,26,23,47,26,21,29,15,14,-4,-5,+1,68%,68%,67%,121,128,114,24%,28%,21%,2,0,2,6,5,1
298,https://vlr.gg/player/37969/ellie,2025-02-25 14:00:00,0.81,1.07,0.94,225,216,240,58,27,31,56,32,24,11,5,6,-1,-2,+1,76%,76%,75%,149,134,165,38%,35%,42%,14,8,6,15,10,5
299,https://vlr.gg/player/30042/harmonee,2025-02-25 14:00:00,0.94,0.74,0.84,166,160,174,41,22,19,52,26,26,19,11,8,+1,-2,+3,72%,71%,72%,114,110,119,27%,28%,25%,7,2,5,6,4,2
300,https://vlr.gg/player/24071/liza,2025-02-25 14:00:00,0.98,1.35,1.18,258,222,292,39,14,25,34,17,17,7,3,4,+4,+3,+1,66%,60%,71%,171,141,195,48%,47%,49%,7,5,2,3,2,1
301,https://vlr.gg/player/20098/mel,2025-02-25 14:00:00,1.07,1.13,1.10,215,212,214,32,14,18,34,17,17,17,5,12,+2,+1,+1,75%,70%,79%,143,139,146,33%,48%,24%,4,1,3,2,0,2
302,https://vlr.gg/player/41196/ja2,2025-02-25 14:00:00,0.20,1.34,0.82,160,77,230,22,3,19,32,18,14,11,6,5,+3,-5,+8,73%,60%,83%,105,61,142,21%,26%,19%,11,1,10,8,6,2
303,https://vlr.gg/player/17394/ninou,2025-02-25 14:00:00,0.64,0.86,0.76,110,104,115,17,8,9,29,16,13,14,3,11,-1,0,-1,64%,50%,75%,64,60,67,16%,21%,13%,1,1,0,2,1,1
304,https://vlr.gg/player/31272/els,2025-02-25 14:00:00,0.58,0.78,0.69,155,126,182,21,8,13,36,16,20,8,1,7,-2,-3,+1,55%,45%,63%,113,97,126,24%,23%,24%,2,0,2,4,3,1
305,https://vlr.gg/player/17320/petra,2025-02-25 14:00:00,1.07,1.53,1.28,259,226,294,42,20,22,26,17,9,9,3,6,+3,-1,+4,70%,63%,80%,159,150,169,22%,31%,15%,9,5,4,6,6,0
306,https://vlr.gg/player/24149/amy,2025-02-25 14:00:00,1.12,1.14,1.13,232,228,242,37,20,17,29,16,13,14,4,10,-1,-1,0,73%,67%,80%,148,139,159,33%,45%,24%,3,0,3,4,1,3
307,https://vlr.gg/player/20064/vania,2025-02-25 14:00:00,0.87,1.35,1.09,234,212,257,37,18,19,29,19,10,7,4,3,-1,-3,+2,73%,67%,80%,153,150,157,46%,41%,51%,6,1,5,7,4,3
308,https://vlr.gg/player/16321/nelo,2025-02-25 14:00:00,0.89,1.30,1.08,161,139,194,25,11,14,23,15,8,18,10,8,-2,-1,-1,75%,75%,75%,107,97,119,37%,38%,36%,0,0,0,2,1,1
309,https://vlr.gg/player/17323/mimi,2025-02-25 14:00:00,0.68,1.20,0.91,145,134,156,24,12,12,24,17,7,19,8,11,-5,-4,-1,73%,58%,90%,98,90,107,21%,15%,27%,1,1,0,6,5,1
310,https://vlr.gg/player/26632/joliinaa,2025-02-25 11:00:00,1.20,1.11,1.15,262,262,272,55,26,29,46,21,25,11,8,3,+5,+2,+3,73%,77%,70%,161,157,165,28%,26%,33%,13,6,7,8,4,4
311,https://vlr.gg/player/39506/cabbit,2025-02-25 11:00:00,0.96,1.09,1.03,215,206,235,44,23,21,44,23,21,21,8,13,+2,+1,+1,72%,73%,70%,146,139,154,26%,38%,16%,4,2,2,2,1,1
312,https://vlr.gg/player/45174/purity,2025-02-25 11:00:00,0.71,1.17,0.94,199,169,226,40,16,24,44,23,21,14,7,7,-2,-2,0,73%,77%,70%,130,112,148,28%,20%,35%,7,3,4,9,5,4
313,https://vlr.gg/player/20116/jademwah,2025-02-25 11:00:00,0.87,0.99,0.93,191,183,205,41,19,22,46,23,23,24,12,12,0,-1,+1,83%,87%,80%,118,114,121,31%,26%,36%,5,2,3,5,3,2
314,https://vlr.gg/player/20058/devilasxa,2025-02-25 11:00:00,1.03,0.53,0.78,145,164,122,33,19,14,43,18,25,7,4,3,-1,+2,-3,62%,70%,53%,101,117,85,36%,38%,33%,3,3,0,4,1,3
315,https://vlr.gg/player/39057/safiaa,2025-02-25 11:00:00,1.80,0.99,1.39,272,355,181,61,41,20,40,20,20,13,7,6,0,0,0,77%,87%,67%,182,239,125,27%,31%,22%,5,2,3,5,2,3
316,https://vlr.gg/player/11183/glance,2025-02-25 11:00:00,1.32,1.22,1.27,235,240,230,53,27,26,39,18,21,15,8,7,+2,+3,-1,73%,73%,73%,147,139,155,31%,29%,33%,5,3,2,3,0,3
317,https://vlr.gg/player/23049/alkyia,2025-02-25 11:00:00,0.80,1.13,0.96,197,185,207,45,21,24,43,24,19,5,4,1,+1,-1,+2,65%,60%,70%,120,116,124,20%,21%,19%,10,6,4,9,7,2
318,https://vlr.gg/player/22792/jiex,2025-02-25 11:00:00,0.82,0.95,0.88,173,167,183,37,17,20,42,23,19,22,11,11,-2,-2,0,80%,77%,83%,113,116,110,35%,45%,27%,5,2,3,7,4,3
319,https://vlr.gg/player/38133/anesilia,2025-02-25 11:00:00,0.36,0.84,0.60,140,96,184,27,9,18,49,25,24,24,12,12,-5,-2,-3,67%,60%,73%,102,70,134,27%,30%,25%,3,1,2,8,3,5
320,https://vlr.gg/player/30105/ikyoo,2025-02-25 11:00:00,1.14,0.90,0.99,203,220,193,26,11,15,30,10,20,16,5,11,0,-1,+1,72%,73%,71%,134,147,126,28%,29%,26%,2,1,1,2,2,0
321,https://vlr.gg/player/40175/mayameow,2025-02-25 11:00:00,1.01,0.94,0.97,190,207,184,27,11,16,30,13,17,15,6,9,-1,0,-1,69%,67%,71%,119,136,108,28%,27%,28%,3,1,2,4,1,3
322,https://vlr.gg/player/24140/superphrog,2025-02-25 11:00:00,0.59,0.99,0.84,194,170,207,25,8,17,30,11,19,5,3,2,+2,-3,+5,56%,47%,63%,118,105,125,28%,35%,24%,8,2,6,6,5,1
323,https://vlr.gg/player/29960/nidxvilco,2025-02-25 11:00:00,0.76,0.73,0.74,150,163,144,18,8,10,31,13,18,17,10,7,-2,+1,-3,64%,80%,54%,103,96,107,24%,12%,33%,3,1,2,5,0,5
324,https://vlr.gg/player/30060/alessia,2025-02-25 11:00:00,0.89,0.61,0.72,178,214,151,25,13,12,31,12,19,3,0,3,-2,0,-2,67%,73%,63%,115,128,106,27%,20%,34%,2,1,1,4,1,3
325,https://vlr.gg/player/30107/fluxxy,2025-02-25 11:00:00,1.09,1.75,1.35,224,182,287,32,16,16,23,13,10,17,7,10,+1,0,+1,85%,79%,93%,136,116,169,21%,16%,29%,2,1,1,1,1,0
326,https://vlr.gg/player/37990/adora,2025-02-25 11:00:00,1.37,0.93,1.20,269,284,233,36,25,11,27,16,11,4,2,2,-1,-1,0,72%,71%,73%,193,207,172,32%,41%,20%,6,3,3,7,4,3
327,https://vlr.gg/player/19362/lyda,2025-02-25 11:00:00,1.16,1.24,1.19,226,186,309,32,17,15,26,13,13,12,2,10,+4,+1,+3,72%,63%,87%,163,138,202,29%,36%,24%,7,3,4,3,2,1
328,https://vlr.gg/player/24101/miyori,2025-02-25 11:00:00,1.35,0.82,1.15,192,231,125,28,21,7,20,13,7,7,3,4,-2,-1,-1,72%,75%,67%,131,163,79,39%,39%,41%,4,3,1,6,4,2
329,https://vlr.gg/player/9431/cille,2025-02-25 11:00:00,0.85,0.95,0.89,169,166,177,24,14,10,25,15,10,17,10,7,+1,+1,0,79%,79%,80%,102,103,100,18%,21%,14%,2,2,0,1,1,0
330,https://vlr.gg/player/51099/zynx,2025-02-25 05:45:00,1.14,1.28,1.22,224,224,226,55,25,30,44,22,22,15,8,7,+2,-1,+3,81%,79%,83%,148,158,138,29%,31%,27%,7,3,4,5,4,1
331,https://vlr.gg/player/51238/yong,2025-02-25 05:45:00,1.51,0.73,1.10,202,252,148,51,32,19,48,20,28,29,15,14,-1,+1,-2,75%,82%,69%,124,152,98,36%,42%,27%,3,2,1,4,1,3
332,https://vlr.gg/player/4661/sacrifice,2025-02-25 05:45:00,0.67,1.11,0.88,216,185,251,50,21,29,52,27,25,12,5,7,-1,-4,+3,70%,61%,78%,136,117,154,25%,23%,28%,13,3,10,14,7,7
333,https://vlr.gg/player/51100/flicker,2025-02-25 05:45:00,0.73,0.97,0.85,169,151,200,42,17,25,53,26,27,18,6,12,+2,+2,0,70%,70%,69%,114,92,133,26%,30%,23%,8,5,3,6,3,3
334,https://vlr.gg/player/34982/athan,2025-02-25 05:45:00,0.69,0.74,0.72,145,161,145,36,18,18,53,25,28,22,11,11,-4,0,-4,64%,61%,67%,100,104,97,20%,20%,20%,2,2,0,6,2,4
335,https://vlr.gg/player/29839/tenten,2025-02-25 05:45:00,1.30,1.17,1.24,256,267,253,63,34,29,49,26,23,12,7,5,+5,+3,+2,80%,81%,79%,164,173,154,18%,21%,15%,16,8,8,11,5,6
336,https://vlr.gg/player/806/moothie,2025-02-25 05:45:00,0.79,1.46,1.11,211,146,272,52,19,33,44,23,21,21,13,8,0,0,0,72%,69%,76%,135,84,190,35%,32%,36%,2,2,0,2,2,0
337,https://vlr.gg/player/4664/gangpin,2025-02-25 05:45:00,1.06,0.81,0.94,164,179,150,42,23,19,45,21,24,15,8,7,-2,-1,-1,70%,72%,67%,113,128,98,29%,27%,32%,3,1,2,5,2,3
338,https://vlr.gg/player/30556/exa,2025-02-25 05:45:00,1.12,0.64,0.89,182,227,114,42,29,13,47,24,23,18,6,12,+4,+4,0,74%,81%,67%,112,140,82,27%,31%,21%,7,5,2,3,1,2
339,https://vlr.gg/player/43057/dh,2025-02-25 05:45:00,0.81,0.98,0.89,219,197,247,51,25,26,54,27,27,14,6,8,-5,-6,+1,70%,64%,76%,150,137,164,37%,42%,33%,7,2,5,12,8,4
340,https://vlr.gg/player/42710/froz,2025-02-25 03:00:00,1.06,1.18,1.12,218,208,229,33,17,16,30,16,14,12,7,5,-3,0,-3,74%,79%,68%,136,123,150,38%,38%,38%,4,2,2,7,2,5
341,https://vlr.gg/player/4666/acme,2025-02-25 03:00:00,1.39,0.83,1.12,232,283,178,37,24,13,32,15,17,9,4,5,+3,+2,+1,67%,75%,59%,161,191,128,24%,25%,22%,6,3,3,3,1,2
342,https://vlr.gg/player/42769/wezzy,2025-02-25 03:00:00,1.08,0.68,0.89,206,244,164,32,21,11,35,17,18,9,7,2,-5,-2,-3,63%,75%,50%,142,178,103,25%,37%,13%,7,5,2,12,7,5
343,https://vlr.gg/player/42771/nameless,2025-02-25 03:00:00,0.89,0.81,0.86,172,163,184,30,16,14,34,17,17,23,12,11,-1,0,-1,83%,83%,82%,108,99,118,37%,31%,44%,0,0,0,1,0,1
344,https://vlr.gg/player/48925/raxcal,2025-02-25 03:00:00,0.88,0.63,0.76,130,147,112,22,13,9,28,13,15,16,6,10,0,0,0,65%,75%,55%,76,90,61,28%,39%,15%,3,2,1,3,2,1
345,https://vlr.gg/player/4127/felix,2025-02-25 03:00:00,0.94,1.54,1.25,239,153,318,33,9,24,31,13,18,22,11,11,+1,-2,+3,78%,77%,79%,174,114,230,20%,9%,27%,4,0,4,3,2,1
346,https://vlr.gg/player/4038/bangnan,2025-02-25 03:00:00,1.36,0.93,1.14,268,345,199,45,26,19,38,18,20,2,1,1,+6,+6,0,67%,77%,58%,166,218,119,29%,26%,33%,14,11,3,8,5,3
347,https://vlr.gg/player/25089/cabeza,2025-02-25 03:00:00,1.55,0.55,1.02,187,230,148,31,21,10,30,10,20,9,3,6,-2,+2,-4,70%,82%,58%,126,149,105,26%,32%,20%,4,2,2,6,0,6
348,https://vlr.gg/player/25082/rico,2025-02-25 03:00:00,1.26,0.67,0.95,173,198,150,15,8,7,15,4,11,10,7,3,+1,0,+1,87%,100%,75%,113,124,103,31%,30%,33%,1,0,1,0,0,0
349,https://vlr.gg/player/34727/kayle,2025-02-25 03:00:00,0.92,0.80,0.86,148,156,141,23,12,11,31,13,18,23,11,12,0,+1,-1,83%,77%,88%,97,104,91,22%,24%,21%,1,1,0,1,0,1
350,https://vlr.gg/player/13000/redlight,2025-02-25 03:00:00,0.82,0.66,0.74,119,100,138,12,5,7,15,5,10,4,1,3,0,-1,+1,74%,73%,75%,73,71,75,15%,11%,18%,2,0,2,2,1,1
351,https://vlr.gg/player/3885/valyn,2025-02-24 07:10:00,1.16,1.58,1.38,211,172,250,32,12,20,20,10,10,13,10,3,+2,0,+2,71%,72%,70%,137,111,161,21%,15%,26%,3,1,2,1,1,0
352,https://vlr.gg/player/4581/jonahp,2025-02-24 07:10:00,1.27,1.10,1.18,225,242,209,29,15,14,26,12,14,20,11,9,+3,+2,+1,84%,83%,85%,143,156,131,20%,27%,13%,4,2,2,1,0,1
353,https://vlr.gg/player/15500/trent,2025-02-24 07:10:00,1.17,1.01,1.09,189,205,174,24,13,11,24,11,13,13,5,8,0,+1,-1,79%,83%,75%,112,117,107,26%,24%,29%,3,2,1,3,1,2
354,https://vlr.gg/player/7873/leaf,2025-02-24 07:10:00,0.85,1.18,1.02,196,169,226,29,12,17,25,12,13,6,1,5,-3,-2,-1,68%,67%,70%,122,108,135,20%,17%,23%,3,1,2,6,3,3
355,https://vlr.gg/player/3993/jawgemo,2025-02-24 07:10:00,0.84,1.10,0.98,222,235,210,28,14,14,28,15,13,10,5,5,-6,-3,-3,63%,67%,60%,144,153,136,13%,13%,13%,4,2,2,10,5,5
356,https://vlr.gg/player/457/nats,2025-02-24 07:10:00,0.91,1.44,1.16,254,215,298,37,17,20,29,16,13,5,3,2,+2,0,+2,71%,65%,78%,156,124,192,38%,40%,37%,4,1,3,2,1,1
357,https://vlr.gg/player/14681/kamo,2025-02-24 07:10:00,0.88,0.90,0.89,214,222,212,28,15,13,30,16,14,4,2,2,+1,0,+1,61%,60%,61%,144,137,152,26%,21%,33%,8,6,2,7,6,1
358,https://vlr.gg/player/11494/keiko,2025-02-24 07:10:00,0.97,0.78,0.88,172,198,142,22,14,8,27,14,13,13,6,7,+3,+3,0,76%,70%,83%,111,132,88,23%,32%,13%,5,3,2,2,0,2
359,https://vlr.gg/player/1475/kamyk,2025-02-24 07:10:00,0.80,0.79,0.80,193,205,174,25,13,12,30,16,14,4,3,1,-2,-2,0,79%,85%,72%,130,140,120,33%,36%,29%,1,0,1,3,2,1
360,https://vlr.gg/player/309/patitek,2025-02-24 07:10:00,0.37,0.75,0.55,101,56,154,11,4,7,27,15,12,15,8,7,0,+1,-1,63%,60%,67%,68,48,89,21%,26%,17%,3,1,2,3,0,3
361,https://vlr.gg/player/29833/izu,2025-02-24 05:00:00,1.50,1.23,1.34,240,261,205,36,17,19,21,8,13,5,2,3,+1,+1,0,78%,88%,71%,144,157,134,28%,19%,40%,3,1,2,2,0,2
362,https://vlr.gg/player/13039/meteor,2025-02-24 05:00:00,1.37,1.14,1.24,262,265,276,42,17,25,26,8,18,4,3,1,+4,+6,-2,76%,88%,67%,172,166,177,30%,28%,31%,10,7,3,6,1,5
363,https://vlr.gg/player/4056/sylvan,2025-02-24 05:00:00,1.20,0.99,1.08,178,161,176,25,10,15,21,6,15,36,15,21,+2,0,+2,83%,94%,75%,98,88,105,27%,15%,36%,4,1,3,2,1,1
364,https://vlr.gg/player/804/buzz,2025-02-24 05:00:00,1.24,0.90,1.04,216,252,197,30,16,14,27,10,17,14,4,10,+7,+5,+2,78%,82%,75%,141,150,135,13%,8%,17%,9,5,4,2,0,2
365,https://vlr.gg/player/485/stax,2025-02-24 05:00:00,0.83,1.12,1.00,163,147,166,22,9,13,24,12,12,21,10,11,-1,+1,-2,83%,82%,83%,113,100,122,30%,32%,29%,1,1,0,2,0,2
366,https://vlr.gg/player/1916/free1ng,2025-02-24 05:00:00,1.11,0.84,1.00,230,269,184,33,22,11,31,19,12,6,4,2,-1,+2,-3,71%,79%,59%,143,163,115,23%,21%,26%,6,5,1,7,3,4
367,https://vlr.gg/player/4678/beyn,2025-02-24 05:00:00,1.08,0.83,0.98,174,191,159,25,17,8,27,15,12,17,12,5,-5,-1,-4,71%,71%,71%,111,123,94,26%,26%,25%,1,1,0,6,2,4
368,https://vlr.gg/player/35013/flashback,2025-02-24 05:00:00,1.10,0.60,0.90,173,197,137,25,17,8,30,15,15,8,5,3,0,-1,+1,68%,71%,65%,117,132,96,19%,21%,17%,3,2,1,3,3,0
369,https://vlr.gg/player/4462/mako,2025-02-24 05:00:00,0.83,0.67,0.76,150,147,149,18,10,8,31,16,15,18,10,8,-4,-1,-3,68%,71%,65%,97,101,92,19%,17%,23%,0,0,0,4,1,3
370,https://vlr.gg/player/28400/hyunmin,2025-02-24 05:00:00,0.50,0.70,0.58,135,128,147,18,9,9,36,21,15,14,8,6,-3,+1,-4,68%,67%,71%,91,90,92,25%,22%,28%,4,4,0,7,3,4
371,https://vlr.gg/player/457/nats,2025-02-23 06:55:00,0.93,1.84,1.43,305,176,349,66,20,46,40,20,20,13,6,7,0,-4,+4,75%,66%,83%,174,116,222,26%,42%,22%,6,0,6,6,4,2
372,https://vlr.gg/player/11494/keiko,2025-02-23 06:55:00,1.34,1.14,1.23,212,257,189,54,28,26,40,20,20,27,12,15,+1,+3,-2,80%,83%,77%,143,169,121,36%,44%,28%,7,5,2,6,2,4
373,https://vlr.gg/player/309/patitek,2025-02-23 06:55:00,1.10,0.71,0.88,152,206,133,32,18,14,43,21,22,36,17,19,0,+3,-3,83%,86%,80%,109,133,88,26%,34%,19%,4,3,1,4,0,4
374,https://vlr.gg/player/1475/kamyk,2025-02-23 06:55:00,0.82,0.91,0.87,177,154,184,39,15,24,44,21,23,13,10,3,+2,+1,+1,72%,69%,74%,108,96,118,28%,27%,29%,4,1,3,2,0,2
375,https://vlr.gg/player/14681/kamo,2025-02-23 06:55:00,0.57,1.03,0.82,190,143,226,41,13,28,46,23,23,12,6,6,-3,-6,+3,69%,66%,71%,124,98,145,27%,27%,28%,11,4,7,14,10,4
376,https://vlr.gg/player/36245/n4rrate,2025-02-23 06:55:00,1.01,1.34,1.16,230,223,291,55,25,30,49,28,21,21,9,12,+6,0,+6,78%,71%,86%,165,149,184,28%,23%,35%,9,2,7,3,2,1
377,https://vlr.gg/player/4004/zekken,2025-02-23 06:55:00,0.76,1.32,1.01,210,208,228,49,25,24,44,28,16,8,3,5,-6,-5,-1,69%,63%,76%,143,141,146,32%,33%,30%,11,7,4,17,12,5
378,https://vlr.gg/player/3880/bang,2025-02-23 06:55:00,1.07,0.72,0.91,186,173,166,38,22,16,45,24,21,20,11,9,+1,+2,-1,70%,71%,69%,104,101,108,30%,31%,29%,7,4,3,6,2,4
379,https://vlr.gg/player/1265/johnqt,2025-02-23 06:55:00,0.84,0.85,0.85,160,160,170,37,22,15,45,26,19,18,6,12,0,0,0,72%,77%,66%,105,98,112,21%,25%,17%,1,0,1,1,0,1
380,https://vlr.gg/player/729/zellsis,2025-02-23 06:55:00,0.63,1.08,0.84,175,173,179,34,15,19,52,32,20,29,22,7,-1,0,-1,75%,77%,72%,118,114,122,21%,17%,27%,4,3,1,5,3,2
381,https://vlr.gg/player/29833/izu,2025-02-23 05:00:00,1.67,1.48,1.55,243,191,259,38,12,26,14,4,10,3,1,2,+4,0,+4,86%,85%,88%,158,138,169,43%,28%,52%,5,0,5,1,0,1
382,https://vlr.gg/player/804/buzz,2025-02-23 05:00:00,1.49,1.38,1.42,287,329,263,40,16,24,23,10,13,7,5,2,+1,+2,-1,84%,92%,79%,181,194,175,24%,17%,30%,6,3,3,5,1,4
383,https://vlr.gg/player/13039/meteor,2025-02-23 05:00:00,1.66,1.04,1.26,248,300,230,33,14,19,22,6,16,8,2,6,+4,+3,+1,76%,77%,75%,179,212,162,43%,45%,41%,8,4,4,4,1,3
384,https://vlr.gg/player/485/stax,2025-02-23 05:00:00,1.05,1.16,1.12,192,169,191,25,9,16,19,7,12,8,2,6,0,0,0,78%,77%,79%,127,117,133,28%,22%,32%,2,1,1,2,1,1
385,https://vlr.gg/player/4056/sylvan,2025-02-23 05:00:00,0.60,0.88,0.78,143,138,144,17,6,11,23,10,13,22,7,15,-2,0,-2,81%,77%,83%,94,79,102,29%,38%,26%,1,1,0,3,1,2
386,https://vlr.gg/player/37494/kai,2025-02-23 05:00:00,1.31,0.95,1.18,241,279,184,32,23,9,29,19,10,4,1,3,+1,+2,-1,68%,63%,77%,150,169,113,31%,39%,17%,6,6,0,5,4,1
387,https://vlr.gg/player/3021/biank,2025-02-23 05:00:00,0.75,0.97,0.83,176,140,251,21,10,11,31,19,12,12,9,3,-3,-1,-2,54%,54%,54%,120,99,158,26%,27%,25%,1,0,1,4,1,3
388,https://vlr.gg/player/3045/luok1ng,2025-02-23 05:00:00,0.85,0.32,0.66,142,159,121,18,13,5,32,20,12,12,8,4,0,+2,-2,65%,67%,62%,93,100,80,31%,34%,25%,3,3,0,3,1,2
389,https://vlr.gg/player/4712/heybay,2025-02-23 05:00:00,0.60,0.72,0.64,135,125,157,15,8,7,29,18,11,9,6,3,-1,0,-1,54%,50%,62%,86,82,94,33%,36%,29%,1,1,0,2,1,1
390,https://vlr.gg/player/4770/fengf,2025-02-23 05:00:00,0.53,0.29,0.44,130,132,119,15,10,5,32,20,12,8,5,3,-4,-5,+1,59%,67%,46%,87,86,90,20%,14%,32%,4,1,3,8,6,2
391,https://vlr.gg/player/37990/adora,2025-02-22 14:15:00,0.79,1.78,1.28,292,230,354,48,18,30,34,19,15,8,3,5,+2,-1,+3,75%,67%,83%,179,147,212,36%,26%,44%,12,5,7,10,6,4
392,https://vlr.gg/player/30107/fluxxy,2025-02-22 14:15:00,1.13,1.18,1.16,208,208,208,35,19,16,30,15,15,25,8,17,+3,+3,0,81%,79%,83%,140,137,142,27%,36%,21%,6,4,2,3,1,2
393,https://vlr.gg/player/9431/cille,2025-02-22 14:15:00,0.91,1.01,0.96,159,145,174,29,13,16,32,15,17,15,7,8,0,+1,-1,75%,79%,71%,109,108,109,37%,29%,47%,1,1,0,1,0,1
394,https://vlr.gg/player/24101/miyori,2025-02-22 14:15:00,1.00,0.88,0.94,178,186,170,32,17,15,31,15,16,3,1,2,+2,+2,0,54%,50%,58%,123,131,114,32%,32%,31%,6,3,3,4,1,3
395,https://vlr.gg/player/19362/lyda,2025-02-22 14:15:00,0.91,0.90,0.90,176,175,177,32,16,16,31,15,16,10,5,5,+1,+1,0,75%,71%,79%,121,113,130,30%,31%,30%,3,2,1,2,1,1
396,https://vlr.gg/player/41207/jade,2025-02-22 14:15:00,1.11,1.38,1.24,239,236,242,41,21,20,34,19,15,17,9,8,-1,0,-1,69%,71%,67%,160,158,162,39%,58%,28%,3,2,1,4,2,2
397,https://vlr.gg/player/17318/blossi,2025-02-22 14:15:00,1.17,1.02,1.09,222,232,211,38,19,19,33,16,17,13,9,4,0,+3,-3,73%,75%,71%,145,158,132,39%,34%,46%,6,3,3,6,0,6
398,https://vlr.gg/player/30042/harmonee,2025-02-22 14:15:00,0.87,0.80,0.83,170,169,171,26,13,13,36,17,19,11,6,5,-4,-2,-2,58%,67%,50%,114,126,103,27%,31%,24%,3,2,1,7,4,3
399,https://vlr.gg/player/19373/ginger,2025-02-22 14:15:00,0.61,0.97,0.79,158,140,176,28,13,15,35,19,16,6,2,4,-2,-1,-1,60%,58%,63%,111,102,121,36%,42%,32%,1,0,1,3,1,2
400,https://vlr.gg/player/37969/ellie,2025-02-22 14:15:00,0.46,0.85,0.66,153,163,144,25,13,12,38,22,16,5,2,3,-1,-2,+1,56%,54%,58%,97,93,101,36%,30%,46%,7,4,3,8,6,2
401,https://vlr.gg/player/26632/joliinaa,2025-02-22 13:00:00,1.59,2.20,1.90,370,336,402,44,19,25,17,9,8,6,4,2,+4,-2,+6,94%,87%,100%,238,209,266,37%,27%,50%,7,1,6,3,3,0
402,https://vlr.gg/player/39506/cabbit,2025-02-22 13:00:00,1.35,2.03,1.70,307,267,345,37,16,21,15,9,6,10,4,6,+2,-1,+3,90%,80%,100%,223,191,252,35%,31%,40%,4,1,3,2,2,0
403,https://vlr.gg/player/45174/purity,2025-02-22 13:00:00,1.44,1.31,1.37,231,248,215,28,14,14,15,7,8,12,5,7,+1,+1,0,94%,100%,88%,144,149,139,36%,42%,31%,4,2,2,3,1,2
404,https://vlr.gg/player/20058/devilasxa,2025-02-22 13:00:00,1.36,0.98,1.16,145,200,97,17,11,6,12,7,5,10,7,3,0,0,0,90%,87%,94%,96,126,68,37%,41%,31%,1,1,0,1,1,0
405,https://vlr.gg/player/20116/jademwah,2025-02-22 13:00:00,1.16,1.08,1.12,164,135,190,18,8,10,17,6,11,26,9,17,0,-1,+1,90%,80%,100%,117,116,119,26%,23%,29%,3,1,2,3,2,1
406,https://vlr.gg/player/20098/mel,2025-02-22 13:00:00,0.59,1.08,0.83,185,137,236,22,8,14,28,15,13,7,3,4,+3,+1,+2,58%,56%,60%,98,81,116,15%,18%,13%,4,1,3,1,0,1
407,https://vlr.gg/player/17394/ninou,2025-02-22 13:00:00,0.79,0.62,0.71,149,171,129,17,11,6,28,14,14,9,2,7,0,+1,-1,71%,63%,80%,92,90,95,33%,32%,35%,1,1,0,1,0,1
408,https://vlr.gg/player/24071/liza,2025-02-22 13:00:00,0.46,0.79,0.61,154,116,195,17,7,10,29,15,14,5,2,3,0,-4,+4,61%,63%,60%,100,79,123,32%,44%,26%,4,0,4,4,4,0
409,https://vlr.gg/player/31272/els,2025-02-22 13:00:00,0.74,0.20,0.48,150,220,74,12,10,2,30,16,14,13,7,6,-2,-1,-1,61%,69%,53%,112,159,61,25%,29%,13%,1,0,1,3,1,2
410,https://vlr.gg/player/41196/ja2,2025-02-22 13:00:00,0.03,0.42,0.18,88,63,118,8,2,6,29,16,13,4,3,1,-8,-7,-1,58%,63%,53%,62,48,77,16%,10%,22%,2,1,1,10,8,2
411,https://vlr.gg/player/11183/glance,2025-02-22 11:00:00,1.24,0.86,1.06,183,209,151,44,28,16,40,19,21,18,12,6,0,-1,+1,67%,67%,68%,125,142,106,29%,32%,25%,4,2,2,4,3,1
412,https://vlr.gg/player/39057/safiaa,2025-02-22 11:00:00,1.05,1.07,1.06,202,189,218,48,25,23,44,23,21,17,12,5,-5,-3,-2,72%,75%,68%,140,132,150,27%,26%,28%,4,0,4,9,3,6
413,https://vlr.gg/player/22792/jiex,2025-02-22 11:00:00,0.99,0.94,0.96,208,223,193,48,28,20,51,26,25,21,11,10,+1,-2,+3,67%,72%,61%,139,153,123,32%,33%,32%,7,3,4,6,5,1
414,https://vlr.gg/player/38133/anesilia,2025-02-22 11:00:00,0.90,0.88,0.89,176,173,179,41,23,18,48,24,24,29,16,13,+3,+1,+2,72%,75%,68%,114,106,123,24%,24%,24%,6,3,3,3,2,1
415,https://vlr.gg/player/23049/alkyia,2025-02-22 11:00:00,1.01,0.57,0.80,197,249,139,44,32,12,53,27,26,17,8,9,-2,+1,-3,60%,67%,52%,122,146,94,23%,26%,17%,11,8,3,13,7,6
416,https://vlr.gg/player/16321/nelo,2025-02-22 11:00:00,1.10,1.33,1.23,209,199,219,50,22,28,41,18,23,33,11,22,+1,+1,0,82%,77%,86%,131,128,134,24%,25%,24%,6,4,2,5,3,2
417,https://vlr.gg/player/20064/vania,2025-02-22 11:00:00,1.25,1.15,1.19,238,241,237,57,29,28,47,20,27,13,3,10,+1,0,+1,81%,84%,78%,158,158,157,33%,38%,28%,7,3,4,6,3,3
418,https://vlr.gg/player/24149/amy,2025-02-22 11:00:00,1.59,0.77,1.15,224,296,162,53,33,20,45,17,28,14,6,8,+7,+6,+1,72%,84%,61%,146,180,117,29%,36%,22%,8,6,2,1,0,1
419,https://vlr.gg/player/17323/mimi,2025-02-22 11:00:00,1.04,1.08,1.06,172,133,205,39,15,24,43,14,29,37,15,22,+1,-2,+3,76%,81%,72%,113,88,135,25%,29%,23%,5,0,5,4,2,2
420,https://vlr.gg/player/17320/petra,2025-02-22 11:00:00,0.69,0.72,0.70,162,162,165,37,18,19,49,20,29,13,5,8,-7,-6,-1,64%,65%,64%,105,110,101,18%,26%,10%,9,2,7,16,8,8
421,https://vlr.gg/player/40175/mayameow,2025-02-22 11:00:00,0.92,1.09,1.01,221,240,212,27,11,16,35,16,19,28,16,12,-3,-1,-2,78%,88%,70%,156,162,151,21%,16%,27%,2,1,1,5,2,3
422,https://vlr.gg/player/29960/nidxvilco,2025-02-22 11:00:00,1.25,0.66,0.92,176,240,136,25,16,9,29,11,18,18,9,9,-2,-1,-1,70%,82%,61%,129,161,105,41%,41%,40%,1,0,1,3,1,2
423,https://vlr.gg/player/30105/ikyoo,2025-02-22 11:00:00,0.66,0.90,0.79,193,174,214,26,11,15,35,15,20,11,4,7,+4,+1,+3,68%,71%,65%,122,103,136,30%,30%,30%,6,2,4,2,1,1
424,https://vlr.gg/player/30060/alessia,2025-02-22 11:00:00,0.96,0.58,0.74,168,230,126,25,14,11,33,13,20,4,2,2,-1,0,-1,65%,82%,52%,127,182,86,30%,36%,22%,2,1,1,3,1,2
425,https://vlr.gg/player/24140/superphrog,2025-02-22 11:00:00,0.40,0.88,0.65,187,157,190,24,8,16,35,15,20,4,3,1,-6,-2,-4,50%,47%,52%,109,88,123,17%,21%,15%,5,3,2,11,5,6
426,https://vlr.gg/player/16418/smurfette,2025-02-22 11:00:00,1.62,1.04,1.37,300,338,234,45,30,15,27,15,12,6,4,2,+5,+3,+2,73%,74%,71%,177,207,136,29%,36%,18%,12,8,4,7,5,2
427,https://vlr.gg/player/19371/eva,2025-02-22 11:00:00,1.21,1.51,1.34,212,207,217,36,20,16,22,13,9,7,2,5,+2,+2,0,90%,96%,82%,131,127,135,31%,37%,26%,2,2,0,0,0,0
428,https://vlr.gg/player/17343/ness,2025-02-22 11:00:00,1.20,0.94,1.09,191,205,174,27,17,10,25,12,13,13,7,6,-1,+1,-2,73%,74%,71%,125,134,114,32%,42%,21%,3,3,0,4,2,2
429,https://vlr.gg/player/30186/nami,2025-02-22 11:00:00,1.13,0.94,1.05,204,201,200,26,16,10,26,13,13,24,14,10,+1,0,+1,88%,96%,76%,127,135,115,47%,51%,42%,3,1,2,2,1,1
430,https://vlr.gg/player/24107/sarah,2025-02-22 11:00:00,0.73,1.41,1.02,202,150,286,33,14,19,27,14,13,0,0,0,+1,-1,+2,73%,70%,76%,147,122,182,33%,21%,49%,4,0,4,3,1,2
431,https://vlr.gg/player/15559/chichoo,2025-02-22 08:25:00,1.28,1.31,1.30,235,250,232,63,29,34,42,21,21,18,5,13,0,0,0,71%,65%,76%,157,155,158,21%,28%,17%,6,4,2,6,4,2
432,https://vlr.gg/player/4742/smoggy,2025-02-22 08:25:00,1.00,1.39,1.22,211,159,250,53,17,36,45,22,23,42,17,25,+9,0,+9,78%,71%,83%,141,105,168,25%,20%,27%,9,0,9,0,0,0
433,https://vlr.gg/player/3520/zmjjkk,2025-02-22 08:25:00,0.98,1.19,1.10,259,242,263,63,25,38,54,26,28,22,9,13,+3,0,+3,78%,81%,76%,161,162,161,20%,21%,20%,17,7,10,14,7,7
434,https://vlr.gg/player/3017/nobody,2025-02-22 08:25:00,1.03,1.09,1.07,206,176,197,48,19,29,42,19,23,16,8,8,+2,-2,+4,69%,74%,66%,118,114,120,29%,36%,24%,7,1,6,5,3,2
435,https://vlr.gg/player/13768/s1mon,2025-02-22 08:25:00,0.74,1.12,0.95,175,168,172,43,18,25,47,26,21,33,15,18,0,-1,+1,75%,74%,76%,110,104,114,32%,36%,30%,4,2,2,4,3,1
436,https://vlr.gg/player/15500/trent,2025-02-22 08:25:00,0.90,1.40,1.11,206,179,247,50,23,27,49,31,18,24,10,14,-5,-2,-3,68%,59%,81%,140,119,167,23%,20%,25%,4,2,2,9,4,5
437,https://vlr.gg/player/3885/valyn,2025-02-22 08:25:00,0.99,0.89,0.95,175,195,167,44,28,16,53,32,21,34,12,22,-4,-6,+2,75%,66%,87%,119,126,110,23%,24%,22%,3,0,3,7,6,1
438,https://vlr.gg/player/3993/jawgemo,2025-02-22 08:25:00,0.77,1.07,0.90,198,180,237,53,26,27,55,32,23,12,9,3,-4,-5,+1,65%,59%,74%,130,123,140,24%,24%,23%,8,3,5,12,8,4
439,https://vlr.gg/player/4581/jonahp,2025-02-22 08:25:00,0.72,0.96,0.83,181,139,229,43,18,25,56,32,24,29,18,11,0,-1,+1,74%,66%,84%,114,93,142,23%,23%,23%,8,4,4,8,5,3
440,https://vlr.gg/player/7873/leaf,2025-02-22 08:25:00,0.68,0.85,0.75,160,167,166,40,21,19,57,35,22,14,9,5,-1,-3,+2,65%,68%,61%,116,118,113,25%,28%,21%,6,3,3,7,6,1
441,https://vlr.gg/player/28400/hyunmin,2025-02-22 05:00:00,1.29,0.83,1.07,252,292,201,59,37,22,55,27,28,15,5,10,+2,+4,-2,74%,81%,67%,160,179,139,30%,32%,26%,12,9,3,10,5,5
442,https://vlr.gg/player/1916/free1ng,2025-02-22 05:00:00,1.03,1.06,1.04,207,202,216,49,24,25,47,23,24,20,12,8,-1,+1,-2,75%,81%,70%,142,140,144,29%,25%,33%,6,2,4,7,1,6
443,https://vlr.gg/player/4678/beyn,2025-02-22 05:00:00,0.73,1.33,1.02,176,113,246,43,14,29,46,23,23,28,18,10,+5,-2,+7,77%,78%,76%,113,73,157,29%,20%,34%,7,0,7,2,2,0
444,https://vlr.gg/player/4462/mako,2025-02-22 05:00:00,1.11,0.85,0.98,195,209,186,47,26,21,50,24,26,33,22,11,-3,-4,+1,75%,83%,67%,138,141,134,26%,20%,35%,4,2,2,7,6,1
445,https://vlr.gg/player/35013/flashback,2025-02-22 05:00:00,0.96,0.70,0.84,171,199,142,42,27,15,52,27,25,11,4,7,+2,+1,+1,65%,67%,64%,120,148,90,29%,37%,18%,8,5,3,6,4,2
446,https://vlr.gg/player/5022/derke,2025-02-22 05:00:00,1.09,1.77,1.45,315,281,351,78,35,43,54,28,26,10,1,9,+8,+2,+6,75%,73%,78%,205,174,233,23%,27%,21%,19,10,9,11,8,3
447,https://vlr.gg/player/2168/trexx,2025-02-22 05:00:00,1.25,0.93,1.08,199,231,167,43,25,18,45,20,25,34,16,18,0,-1,+1,74%,82%,67%,135,157,116,20%,26%,15%,4,2,2,4,3,1
448,https://vlr.gg/player/11134/kicks,2025-02-22 05:00:00,1.26,0.77,1.01,185,205,164,46,26,20,45,18,27,22,10,12,-1,-1,0,71%,79%,64%,119,139,100,25%,28%,22%,2,0,2,3,1,2
449,https://vlr.gg/player/8447/less,2025-02-22 05:00:00,1.10,0.85,0.97,193,209,180,50,26,24,49,22,27,20,9,11,-7,-2,-5,68%,76%,61%,130,144,118,26%,30%,23%,2,0,2,9,2,7
450,https://vlr.gg/player/312/sayf,2025-02-22 05:00:00,0.63,0.85,0.74,143,128,158,33,14,19,47,24,23,24,11,13,-5,-3,-2,67%,67%,67%,91,79,103,17%,17%,18%,5,2,3,10,5,5
451,https://vlr.gg/player/41197/thuy,2025-02-21 14:00:00,0.70,1.88,1.40,248,178,292,53,15,38,32,20,12,30,4,26,0,-2,+2,82%,60%,97%,162,116,193,29%,36%,27%,5,3,2,5,5,0
452,https://vlr.gg/player/38142/dream,2025-02-21 14:00:00,1.09,1.25,1.19,234,214,224,47,18,29,37,18,19,27,9,18,+2,+1,+1,82%,64%,94%,142,131,150,20%,18%,22%,7,2,5,5,1,4
453,https://vlr.gg/player/16078/loupiote,2025-02-21 14:00:00,0.61,1.38,1.06,197,116,246,44,10,34,38,19,19,15,7,8,-2,-2,0,72%,64%,78%,127,81,159,31%,29%,31%,3,1,2,5,3,2
454,https://vlr.gg/player/43744/akita,2025-02-21 14:00:00,0.73,1.30,1.06,270,207,310,55,16,39,46,22,24,10,3,7,+1,-5,+6,72%,60%,81%,165,131,189,25%,24%,26%,12,2,10,11,7,4
455,https://vlr.gg/player/17331/pinkalie,2025-02-21 14:00:00,0.78,1.10,0.97,167,182,155,36,16,20,39,21,18,42,10,32,-2,-1,-1,79%,76%,81%,100,120,86,22%,23%,21%,3,0,3,5,1,4
456,https://vlr.gg/player/47911/berryx,2025-02-21 14:00:00,0.71,1.80,1.16,228,178,329,53,23,30,46,32,14,7,3,4,+6,-2,+8,66%,56%,80%,140,109,185,31%,35%,28%,17,7,10,11,9,2
457,https://vlr.gg/player/29442/wens,2025-02-21 14:00:00,0.97,1.31,1.11,216,201,256,46,24,22,48,32,16,21,10,11,+1,-2,+3,66%,58%,76%,152,141,168,43%,39%,47%,7,2,5,6,4,2
458,https://vlr.gg/player/17408/lateu,2025-02-21 14:00:00,0.65,1.47,0.98,171,146,234,37,17,20,43,31,12,29,15,14,0,+1,-1,72%,61%,88%,113,87,149,26%,34%,21%,2,2,0,2,1,1
459,https://vlr.gg/player/46311/mimier,2025-02-21 14:00:00,0.60,0.84,0.70,150,142,184,32,16,16,51,33,18,15,10,5,-2,-1,-1,62%,61%,64%,113,99,132,27%,27%,27%,3,2,1,5,3,2
460,https://vlr.gg/player/17326/htm,2025-02-21 14:00:00,0.45,0.76,0.58,124,114,138,24,12,12,47,32,15,15,11,4,-4,-4,0,61%,53%,72%,86,70,109,23%,16%,31%,2,1,1,6,5,1
461,https://vlr.gg/player/26632/joliinaa,2025-02-21 13:00:00,1.85,0.94,1.31,290,379,231,64,35,29,42,13,29,10,5,5,+7,+8,-1,75%,92%,64%,192,246,155,30%,33%,28%,16,9,7,9,1,8
462,https://vlr.gg/player/20116/jademwah,2025-02-21 13:00:00,1.52,1.09,1.26,205,219,203,47,22,25,34,8,26,36,16,20,0,-1,+1,82%,92%,75%,127,124,128,24%,21%,27%,2,0,2,2,1,1
463,https://vlr.gg/player/45174/purity,2025-02-21 13:00:00,1.44,0.86,1.10,197,251,169,44,23,21,40,13,27,24,14,10,-1,+4,-5,70%,76%,67%,130,162,108,27%,35%,20%,5,5,0,6,1,5
464,https://vlr.gg/player/20058/devilasxa,2025-02-21 13:00:00,0.88,1.07,1.00,179,143,191,41,15,26,38,13,25,10,2,8,+4,+1,+3,69%,76%,64%,109,89,122,31%,36%,28%,6,2,4,2,1,1
465,https://vlr.gg/player/39506/cabbit,2025-02-21 13:00:00,1.19,0.76,0.94,185,190,170,40,19,21,41,11,30,16,7,9,-1,+1,-2,72%,88%,61%,126,126,127,29%,26%,31%,6,3,3,7,2,5
466,https://vlr.gg/player/41207/jade,2025-02-21 13:00:00,1.13,0.87,1.02,197,202,195,40,26,14,46,23,23,28,18,10,0,+1,-1,74%,78%,68%,125,129,118,32%,32%,32%,4,2,2,4,1,3
467,https://vlr.gg/player/37969/ellie,2025-02-21 13:00:00,1.22,0.63,0.98,219,284,132,49,38,11,47,26,21,6,2,4,+1,+4,-3,64%,75%,48%,140,173,92,31%,32%,27%,14,11,3,13,7,6
468,https://vlr.gg/player/19373/ginger,2025-02-21 13:00:00,1.03,0.82,0.94,206,235,172,41,27,14,47,25,22,16,10,6,0,+1,-1,64%,72%,52%,133,150,108,20%,22%,18%,4,4,0,4,3,1
469,https://vlr.gg/player/30042/harmonee,2025-02-21 13:00:00,1.28,0.44,0.94,178,211,135,41,31,10,45,21,24,8,6,2,-1,+2,-3,66%,81%,44%,122,137,100,23%,25%,18%,3,2,1,4,0,4
470,https://vlr.gg/player/17318/blossi,2025-02-21 13:00:00,0.59,0.31,0.48,121,127,115,24,15,9,52,27,25,24,21,3,-9,-4,-5,64%,81%,40%,81,78,84,19%,19%,19%,1,1,0,10,5,5
471,https://vlr.gg/player/30107/fluxxy,2025-02-21 11:00:00,0.98,1.21,1.09,227,203,262,31,14,17,27,16,11,9,6,3,-2,-3,+1,66%,60%,72%,142,124,163,38%,38%,38%,1,0,1,3,3,0
472,https://vlr.gg/player/37990/adora,2025-02-21 11:00:00,0.59,1.19,0.87,216,196,243,29,12,17,31,19,12,3,2,1,-4,-5,+1,63%,55%,72%,146,132,161,36%,41%,32%,5,1,4,9,6,3
473,https://vlr.gg/player/24101/miyori,2025-02-21 11:00:00,0.44,1.00,0.70,183,123,246,23,8,15,33,18,15,4,1,3,-2,-4,+2,58%,35%,83%,115,86,147,22%,31%,19%,6,1,5,8,5,3
474,https://vlr.gg/player/19362/lyda,2025-02-21 11:00:00,0.44,0.66,0.55,137,125,151,17,8,9,32,19,13,4,0,4,0,-1,+1,45%,40%,50%,97,80,117,38%,42%,35%,1,0,1,1,1,0
475,https://vlr.gg/player/9431/cille,2025-02-21 11:00:00,0.34,0.74,0.54,118,90,151,15,5,10,32,18,14,12,5,7,-4,-3,-1,58%,50%,67%,88,68,110,26%,18%,32%,0,0,0,4,3,1
476,https://vlr.gg/player/20064/vania,2025-02-21 11:00:00,1.08,1.84,1.48,300,244,346,43,16,27,20,12,8,8,6,2,+5,-3,+8,76%,72%,80%,166,146,184,25%,26%,24%,10,2,8,5,5,0
477,https://vlr.gg/player/24149/amy,2025-02-21 11:00:00,1.43,1.54,1.48,306,305,306,42,19,23,24,14,10,10,6,4,+2,+1,+1,79%,78%,80%,206,192,218,30%,25%,34%,3,2,1,1,1,0
478,https://vlr.gg/player/17323/mimi,2025-02-21 11:00:00,0.99,1.71,1.37,205,178,226,25,11,14,19,13,6,26,5,21,+6,0,+6,84%,72%,95%,130,117,141,28%,21%,33%,7,1,6,1,1,0
479,https://vlr.gg/player/17320/petra,2025-02-21 11:00:00,0.92,1.40,1.17,217,203,231,30,12,18,24,14,10,12,4,8,+1,0,+1,76%,67%,85%,152,135,168,20%,13%,28%,4,2,2,3,2,1
480,https://vlr.gg/player/16321/nelo,2025-02-21 11:00:00,0.49,0.80,0.66,120,112,131,15,7,8,28,15,13,24,8,16,-2,-2,0,71%,61%,80%,72,68,76,24%,17%,33%,1,0,1,3,2,1
481,https://vlr.gg/player/24071/liza,2025-02-21 11:00:00,1.33,1.27,1.30,257,298,229,58,28,30,42,18,24,11,3,8,+4,0,+4,77%,80%,75%,167,186,154,57%,50%,65%,6,1,5,2,1,1
482,https://vlr.gg/player/31272/els,2025-02-21 11:00:00,1.36,1.13,1.23,254,253,255,55,22,33,43,14,29,19,6,13,-1,0,-1,74%,72%,75%,160,165,157,32%,39%,27%,7,4,3,8,4,4
483,https://vlr.gg/player/17394/ninou,2025-02-21 11:00:00,0.64,1.15,0.94,143,86,182,33,9,24,35,16,19,27,8,19,-2,0,-2,77%,68%,83%,92,48,122,32%,47%,28%,2,1,1,4,1,3
484,https://vlr.gg/player/41196/ja2,2025-02-21 11:00:00,1.05,0.72,0.85,200,257,163,42,24,18,46,19,27,9,3,6,0,+1,-1,64%,72%,58%,129,164,104,27%,34%,19%,11,5,6,11,4,7
485,https://vlr.gg/player/20098/mel,2025-02-21 11:00:00,0.76,0.87,0.83,154,119,179,28,8,20,44,16,28,34,13,21,-2,-2,0,72%,68%,75%,102,80,118,22%,17%,24%,4,1,3,6,3,3
486,https://vlr.gg/player/16418/smurfette,2025-02-21 11:00:00,1.26,1.06,1.18,261,265,258,54,32,22,46,27,19,14,13,1,+1,+2,-1,69%,72%,64%,177,184,167,37%,40%,33%,11,7,4,10,5,5
487,https://vlr.gg/player/17343/ness,2025-02-21 11:00:00,1.05,1.11,1.08,190,181,206,39,21,18,42,25,17,41,24,17,+4,+1,+3,82%,81%,84%,119,116,124,37%,43%,30%,4,1,3,0,0,0
488,https://vlr.gg/player/19371/eva,2025-02-21 11:00:00,1.14,0.88,1.04,190,220,144,44,31,13,39,23,16,12,3,9,+5,+3,+2,70%,72%,68%,115,131,92,26%,26%,28%,6,4,2,1,1,0
489,https://vlr.gg/player/24107/sarah,2025-02-21 11:00:00,0.79,1.14,0.93,194,165,237,42,21,21,41,23,18,8,4,4,-7,-8,+1,69%,67%,72%,133,114,159,37%,33%,41%,4,1,3,11,9,2
490,https://vlr.gg/player/30186/nami,2025-02-21 11:00:00,0.79,0.51,0.68,148,172,117,31,22,9,48,27,21,19,10,9,-2,+2,-4,66%,67%,64%,107,119,91,34%,38%,26%,6,5,1,8,3,5
491,https://vlr.gg/player/15500/trent,2025-02-21 07:25:00,1.29,1.69,1.52,247,211,286,35,12,23,17,8,9,12,5,7,-1,-1,0,76%,75%,76%,177,155,195,31%,26%,36%,4,2,2,5,3,2
492,https://vlr.gg/player/7873/leaf,2025-02-21 07:25:00,1.70,1.25,1.45,249,277,231,37,19,18,17,7,10,4,2,2,+2,0,+2,86%,94%,81%,174,187,163,29%,26%,32%,3,0,3,1,0,1
493,https://vlr.gg/player/3885/valyn,2025-02-21 07:25:00,1.21,1.16,1.18,179,211,155,23,13,10,18,9,9,17,5,12,+3,+2,+1,81%,81%,81%,105,121,92,16%,18%,15%,6,4,2,3,2,1
494,https://vlr.gg/player/4581/jonahp,2025-02-21 07:25:00,1.03,1.13,1.09,177,184,163,21,9,12,22,10,12,28,13,15,-1,0,-1,81%,88%,76%,116,123,111,13%,8%,20%,0,0,0,1,0,1
495,https://vlr.gg/player/3993/jawgemo,2025-02-21 07:25:00,0.71,1.17,0.97,203,171,221,26,9,17,26,13,13,9,6,3,0,-1,+1,70%,63%,76%,135,104,159,21%,19%,23%,7,2,5,7,3,4
496,https://vlr.gg/player/3021/biank,2025-02-21 07:25:00,0.64,1.15,0.86,158,138,192,20,10,10,26,15,11,6,1,5,+2,+1,+1,65%,71%,56%,112,93,136,13%,17%,9%,4,2,2,2,1,1
497,https://vlr.gg/player/3045/luok1ng,2025-02-21 07:25:00,0.69,1.00,0.82,170,144,205,22,10,12,28,17,11,11,7,4,-1,+1,-2,68%,62%,75%,118,94,148,38%,33%,41%,1,1,0,2,0,2
498,https://vlr.gg/player/4712/heybay,2025-02-21 07:25:00,0.95,0.50,0.75,134,161,111,16,11,5,28,14,14,13,5,8,-1,0,-1,65%,67%,63%,93,107,75,21%,23%,17%,4,3,1,5,3,2
499,https://vlr.gg/player/4770/fengf,2025-02-21 07:25:00,0.79,0.52,0.66,173,209,136,20,13,7,31,15,16,4,2,2,-3,-3,0,54%,43%,69%,122,141,97,22%,25%,18%,4,2,2,7,5,2
500,https://vlr.gg/player/37494/kai,2025-02-21 07:25:00,0.31,1.11,0.65,161,106,243,22,9,13,33,19,14,5,0,5,0,-2,+2,57%,48%,69%,108,72,155,30%,47%,22%,4,1,3,4,3,1
0,https://vlr.gg/player/2168/trexx,2025-02-21 05:00:00,1.35,1.30,1.33,256,267,240,40,22,18,26,15,11,20,13,7,0,+1,-1,84%,83%,86%,156,162,150,18%,27%,10%,3,2,1,3,1,2
1,https://vlr.gg/player/8447/less,2025-02-21 05:00:00,1.40,1.21,1.31,246,266,226,42,24,18,28,15,13,15,10,5,-2,-1,-1,73%,71%,76%,153,169,135,36%,40%,31%,4,2,2,6,3,3
2,https://vlr.gg/player/5022/derke,2025-02-21 05:00:00,0.70,1.91,1.26,259,206,320,42,17,25,30,21,9,9,5,4,+1,-4,+5,73%,58%,90%,157,122,198,19%,19%,19%,10,4,6,9,8,1
3,https://vlr.gg/player/11134/kicks,2025-02-21 05:00:00,1.13,1.17,1.14,195,173,219,32,15,17,26,13,13,19,10,9,-3,-1,-2,80%,75%,86%,123,111,136,33%,33%,33%,1,0,1,4,1,3
4,https://vlr.gg/player/312/sayf,2025-02-21 05:00:00,0.70,0.66,0.68,117,127,107,19,11,8,27,15,12,7,1,6,-1,-1,0,71%,67%,76%,85,93,76,26%,30%,22%,2,1,1,3,2,1
5,https://vlr.gg/player/804/buzz,2025-02-21 05:00:00,0.76,1.12,0.95,236,239,233,33,14,19,37,20,17,13,9,4,+5,+2,+3,69%,67%,71%,152,160,145,13%,11%,14%,9,4,5,4,2,2
6,https://vlr.gg/player/13039/meteor,2025-02-21 05:00:00,0.62,1.23,0.94,206,153,254,32,11,21,38,19,19,10,5,5,-1,-2,+1,67%,57%,75%,148,110,181,32%,38%,30%,6,3,3,7,5,2
7,https://vlr.gg/player/29833/izu,2025-02-21 05:00:00,0.93,0.88,0.90,174,166,180,26,13,13,33,15,18,8,4,4,-1,-1,0,67%,71%,63%,115,98,130,29%,28%,30%,2,0,2,3,1,2
8,https://vlr.gg/player/485/stax,2025-02-21 05:00:00,0.98,0.80,0.88,153,156,149,26,12,14,32,15,17,11,5,6,+4,+2,+2,64%,71%,58%,99,101,97,37%,27%,47%,4,2,2,0,0,0
9,https://vlr.gg/player/31207/carpe,2025-02-21 05:00:00,0.49,0.75,0.63,141,121,160,20,8,12,35,17,18,17,10,7,-2,-2,0,67%,67%,67%,92,74,108,27%,30%,25%,4,1,3,6,3,3
10,https://vlr.gg/player/30105/ikyoo,2025-02-20 14:35:00,0.66,1.08,0.90,178,125,215,22,8,14,30,14,16,11,2,9,+1,0,+1,51%,44%,57%,114,77,142,38%,22%,49%,1,0,1,0,0,0
11,https://vlr.gg/player/29960/nidxvilco,2025-02-20 14:35:00,0.53,0.94,0.76,145,93,180,18,4,14,30,14,16,11,3,8,-3,0,-3,54%,50%,57%,99,68,124,27%,29%,26%,0,0,0,3,0,3
12,https://vlr.gg/player/24140/superphrog,2025-02-20 14:35:00,0.35,0.97,0.70,175,122,220,21,6,15,33,16,17,11,4,7,+3,-1,+4,65%,56%,71%,108,70,136,17%,12%,19%,9,4,5,6,5,1
13,https://vlr.gg/player/30060/alessia,2025-02-20 14:35:00,0.61,0.67,0.64,142,151,148,20,8,12,32,15,17,3,1,2,-1,0,-1,51%,44%,57%,95,101,90,48%,56%,42%,4,0,4,5,0,5
14,https://vlr.gg/player/40175/mayameow,2025-02-20 14:35:00,0.69,0.55,0.61,158,194,144,18,10,8,35,16,19,20,7,13,-5,-3,-2,57%,50%,62%,112,130,98,14%,16%,11%,2,2,0,7,5,2
15,https://vlr.gg/player/37969/ellie,2025-02-20 14:35:00,1.38,2.20,1.73,322,293,345,44,22,22,18,14,4,4,3,1,+4,+1,+3,78%,71%,88%,188,166,217,36%,32%,44%,9,5,4,5,4,1
16,https://vlr.gg/player/41207/jade,2025-02-20 14:35:00,1.64,1.28,1.48,259,254,277,37,20,17,20,10,10,20,14,6,-1,-1,0,84%,86%,81%,165,165,165,28%,24%,35%,2,0,2,3,1,2
17,https://vlr.gg/player/19373/ginger,2025-02-20 14:35:00,0.97,1.71,1.29,261,219,307,36,17,19,21,15,6,11,5,6,+1,0,+1,89%,81%,100%,178,147,218,34%,24%,46%,2,1,1,1,1,0
18,https://vlr.gg/player/30042/harmonee,2025-02-20 14:35:00,0.90,1.25,1.05,180,136,241,24,11,13,19,11,8,16,7,9,+1,0,+1,70%,62%,81%,118,86,161,29%,39%,23%,3,1,2,2,1,1
19,https://vlr.gg/player/17318/blossi,2025-02-20 14:35:00,1.14,0.69,0.94,152,204,77,19,15,4,21,13,8,19,9,10,0,+1,-1,84%,76%,94%,99,142,41,21%,23%,13%,5,4,1,5,3,2
20,https://vlr.gg/player/41197/thuy,2025-02-20 14:20:00,1.10,1.42,1.29,237,182,269,33,10,23,28,11,17,13,5,8,+2,0,+2,70%,69%,71%,154,124,174,26%,26%,25%,5,1,4,3,1,2
21,https://vlr.gg/player/43744/akita,2025-02-20 14:20:00,0.89,1.59,1.28,275,228,316,38,12,26,33,15,18,5,2,3,+2,0,+2,60%,44%,71%,182,152,203,36%,32%,38%,9,4,5,7,4,3
22,https://vlr.gg/player/17331/pinkalie,2025-02-20 14:20:00,0.91,0.58,0.71,145,178,117,19,10,9,31,13,18,17,8,9,-2,0,-2,63%,63%,63%,90,122,68,27%,42%,16%,0,0,0,2,0,2
23,https://vlr.gg/player/16078/loupiote,2025-02-20 14:20:00,0.49,0.69,0.61,138,132,146,19,6,13,34,14,20,10,4,6,-1,+1,-2,60%,50%,67%,96,100,94,22%,32%,18%,2,2,0,3,1,2
24,https://vlr.gg/player/38142/dream,2025-02-20 14:20:00,0.60,0.56,0.57,140,136,150,17,7,10,32,12,20,11,2,9,-3,-1,-2,58%,56%,58%,96,89,100,26%,33%,23%,3,1,2,6,2,4
25,https://vlr.gg/player/20058/devilasxa,2025-02-20 14:20:00,1.36,1.61,1.46,262,260,271,39,23,16,22,14,8,10,4,6,0,0,0,85%,79%,94%,168,165,174,34%,33%,36%,2,1,1,2,1,1
26,https://vlr.gg/player/45174/purity,2025-02-20 14:20:00,1.45,0.75,1.17,245,315,125,34,26,8,28,18,10,18,11,7,+1,+2,-1,80%,83%,75%,138,183,71,33%,30%,45%,6,4,2,5,2,3
27,https://vlr.gg/player/26632/joliinaa,2025-02-20 14:20:00,0.93,1.54,1.17,243,212,303,39,20,19,26,17,9,4,2,2,+1,0,+1,68%,63%,75%,156,136,185,31%,27%,35%,7,4,3,6,4,2
28,https://vlr.gg/player/39506/cabbit,2025-02-20 14:20:00,0.67,1.40,0.96,199,155,264,27,12,15,25,17,8,12,7,5,0,0,0,73%,67%,81%,130,106,166,18%,23%,15%,4,2,2,4,2,2
29,https://vlr.gg/player/20116/jademwah,2025-02-20 14:20:00,0.86,0.91,0.88,153,151,147,19,12,7,25,15,10,26,17,9,0,0,0,78%,79%,75%,94,89,102,32%,36%,27%,2,2,0,2,2,0
30,https://vlr.gg/player/24101/miyori,2025-02-20 11:00:00,1.01,1.59,1.30,254,225,278,59,25,34,40,23,17,12,3,9,0,-1,+1,70%,65%,77%,154,136,172,31%,29%,34%,8,4,4,8,5,3
31,https://vlr.gg/player/30107/fluxxy,2025-02-20 11:00:00,1.34,1.12,1.23,239,256,222,54,29,25,38,19,19,24,14,10,-4,-5,+1,79%,71%,87%,143,153,133,33%,29%,40%,6,1,5,10,6,4
32,https://vlr.gg/player/19362/lyda,2025-02-20 11:00:00,0.94,0.94,0.94,182,176,185,40,21,19,40,21,19,23,11,12,+3,+1,+2,82%,74%,90%,121,125,117,27%,28%,25%,3,1,2,0,0,0
33,https://vlr.gg/player/37990/adora,2025-02-20 11:00:00,0.80,1.09,0.94,178,165,191,39,17,22,41,24,17,15,7,8,-3,-3,0,67%,55%,80%,120,114,126,24%,25%,24%,6,3,3,9,6,3
34,https://vlr.gg/player/9431/cille,2025-02-20 11:00:00,0.60,1.13,0.86,162,103,226,34,11,23,43,23,20,25,13,12,+5,+3,+2,72%,61%,83%,105,61,150,28%,31%,26%,8,4,4,3,1,2
35,https://vlr.gg/player/29442/wens,2025-02-20 11:00:00,1.18,0.94,1.06,199,235,175,45,24,21,44,23,21,13,6,7,+1,0,+1,69%,60%,77%,135,159,112,41%,40%,43%,4,2,2,3,2,1
36,https://vlr.gg/player/47911/berryx,2025-02-20 11:00:00,0.70,1.34,1.03,229,192,266,48,19,29,46,27,19,14,4,10,+2,-2,+4,67%,67%,68%,149,129,169,37%,43%,32%,15,5,10,13,7,6
37,https://vlr.gg/player/17326/htm,2025-02-20 11:00:00,0.84,1.08,0.96,163,137,191,38,16,22,42,21,21,11,3,8,0,-1,+1,67%,63%,71%,109,93,123,27%,32%,23%,2,0,2,2,1,1
38,https://vlr.gg/player/46311/mimier,2025-02-20 11:00:00,0.81,0.95,0.88,219,224,211,45,23,22,52,28,24,15,6,9,-4,-3,-1,62%,60%,65%,148,143,154,34%,41%,27%,6,4,2,10,7,3
39,https://vlr.gg/player/17408/lateu,2025-02-20 11:00:00,0.53,1.06,0.80,140,115,170,26,10,16,42,24,18,26,8,18,0,0,0,67%,67%,68%,96,77,114,25%,33%,19%,3,1,2,3,1,2
40,https://vlr.gg/player/38133/anesilia,2025-02-20 11:00:00,1.02,1.45,1.22,201,174,233,50,23,27,42,24,18,33,21,12,+3,0,+3,81%,75%,87%,137,119,159,19%,18%,21%,7,2,5,4,2,2
41,https://vlr.gg/player/22792/jiex,2025-02-20 11:00:00,1.27,0.96,1.13,231,247,217,55,32,23,47,23,24,22,9,13,-3,0,-3,81%,83%,77%,158,173,140,30%,36%,22%,3,3,0,6,3,3
42,https://vlr.gg/player/39057/safiaa,2025-02-20 11:00:00,0.93,1.22,1.06,210,199,217,49,24,25,45,25,20,24,11,13,+4,0,+4,78%,78%,77%,142,139,146,30%,27%,35%,8,3,5,4,3,1
43,https://vlr.gg/player/11183/glance,2025-02-20 11:00:00,0.99,1.08,1.03,195,193,197,46,26,20,44,24,20,23,12,11,-4,-3,-1,78%,83%,71%,126,133,118,27%,32%,21%,0,0,0,4,3,1
44,https://vlr.gg/player/23049/alkyia,2025-02-20 11:00:00,0.76,0.75,0.75,200,222,172,44,27,17,52,30,22,16,8,8,-5,-5,0,70%,67%,74%,122,137,104,18%,19%,16%,13,6,7,18,11,7
45,https://vlr.gg/player/19371/eva,2025-02-20 11:00:00,0.96,1.56,1.28,252,187,311,60,21,39,46,20,26,19,5,14,0,-2,+2,75%,81%,69%,155,116,189,33%,19%,45%,4,1,3,4,3,1
46,https://vlr.gg/player/17343/ness,2025-02-20 11:00:00,0.82,1.09,0.96,173,162,182,38,15,23,47,23,24,33,16,17,+1,0,+1,76%,74%,78%,115,111,119,28%,31%,26%,3,2,1,2,2,0
47,https://vlr.gg/player/16418/smurfette,2025-02-20 11:00:00,1.03,0.85,0.93,235,263,208,52,28,24,57,26,31,10,3,7,+5,+1,+4,70%,71%,69%,141,159,126,26%,20%,35%,18,8,10,13,7,6
48,https://vlr.gg/player/30186/nami,2025-02-20 11:00:00,1.05,0.71,0.86,180,213,154,44,25,19,50,21,29,24,8,16,+1,+2,-1,67%,74%,61%,120,134,108,35%,27%,46%,6,3,3,5,1,4
49,https://vlr.gg/player/24107/sarah,2025-02-20 11:00:00,0.67,0.93,0.80,145,137,153,36,15,21,44,22,22,3,1,2,-2,-4,+2,58%,52%,64%,95,91,98,36%,38%,35%,5,0,5,7,4,3
50,https://vlr.gg/player/35013/flashback,2025-02-20 08:00:00,1.32,1.46,1.38,203,186,262,34,18,16,19,10,9,7,2,5,0,-1,+1,85%,87%,81%,147,130,172,28%,47%,17%,2,0,2,2,1,1
51,https://vlr.gg/player/4678/beyn,2025-02-20 08:00:00,1.34,1.27,1.31,202,205,191,27,17,10,19,11,8,20,10,10,-1,+1,-2,87%,91%,81%,132,128,137,20%,25%,14%,1,1,0,2,0,2
52,https://vlr.gg/player/1916/free1ng,2025-02-20 08:00:00,1.13,1.54,1.30,256,220,282,35,18,17,23,14,9,12,7,5,+4,+2,+2,85%,87%,81%,160,154,169,38%,31%,50%,6,4,2,2,2,0
53,https://vlr.gg/player/4462/mako,2025-02-20 08:00:00,1.07,0.80,0.96,164,187,112,20,14,6,22,13,9,21,13,8,-1,-3,+2,77%,83%,69%,106,131,71,23%,29%,15%,4,2,2,5,5,0
54,https://vlr.gg/player/28400/hyunmin,2025-02-20 08:00:00,1.01,0.80,0.92,208,219,197,31,19,12,30,18,12,4,3,1,+3,+2,+1,69%,74%,63%,133,133,134,48%,55%,40%,9,5,4,6,3,3
55,https://vlr.gg/player/3880/bang,2025-02-20 08:00:00,0.61,1.21,0.97,186,152,230,29,9,20,29,13,16,13,5,8,-1,0,-1,64%,69%,61%,129,91,156,33%,27%,38%,4,2,2,5,2,3
56,https://vlr.gg/player/36245/n4rrate,2025-02-20 08:00:00,1.15,0.65,0.86,161,175,167,20,9,11,28,11,17,19,10,9,+3,+1,+2,72%,81%,65%,122,114,127,25%,16%,33%,4,1,3,1,0,1
57,https://vlr.gg/player/1265/johnqt,2025-02-20 08:00:00,0.90,0.70,0.78,160,164,174,24,10,14,32,12,20,8,5,3,-2,-1,-1,79%,75%,83%,107,103,109,15%,9%,21%,3,0,3,5,1,4
58,https://vlr.gg/player/4004/zekken,2025-02-20 08:00:00,0.86,0.72,0.77,176,190,166,23,10,13,29,12,17,3,2,1,-2,-1,-1,69%,63%,74%,122,140,109,26%,34%,20%,5,3,2,7,4,3
59,https://vlr.gg/player/729/zellsis,2025-02-20 08:00:00,0.71,0.64,0.67,138,157,135,17,9,8,29,13,16,11,2,9,-3,-3,0,62%,50%,70%,95,97,94,14%,29%,8%,1,0,1,4,3,1
60,https://vlr.gg/player/15559/chichoo,2025-02-20 05:00:00,1.44,1.41,1.43,266,253,295,54,27,27,35,17,18,15,6,9,-1,-1,0,74%,72%,75%,172,170,174,35%,34%,36%,3,0,3,4,1,3
61,https://vlr.gg/player/3520/zmjjkk,2025-02-20 05:00:00,0.91,1.30,1.09,265,249,294,48,22,26,43,24,19,11,8,3,+7,+3,+4,72%,66%,79%,167,158,177,26%,23%,30%,14,8,6,7,5,2
62,https://vlr.gg/player/3017/nobody,2025-02-20 05:00:00,0.88,1.02,0.94,195,170,241,36,17,19,39,20,19,11,3,8,-3,-3,0,74%,66%,83%,148,122,179,36%,32%,39%,5,3,2,8,6,2
63,https://vlr.gg/player/13768/s1mon,2025-02-20 05:00:00,1.09,0.62,0.88,161,180,126,30,20,10,34,18,16,18,11,7,0,+1,-1,64%,76%,50%,108,121,92,32%,31%,32%,2,2,0,2,1,1
64,https://vlr.gg/player/4742/smoggy,2025-02-20 05:00:00,0.90,0.82,0.87,166,165,146,29,17,12,37,21,16,21,12,9,+4,+1,+3,70%,66%,75%,97,103,90,33%,39%,26%,6,2,4,2,1,1
65,https://vlr.gg/player/14681/kamo,2025-02-20 05:00:00,1.47,1.11,1.27,253,309,224,48,26,22,39,18,21,7,3,4,+3,+1,+2,66%,67%,66%,170,189,155,27%,25%,29%,9,4,5,6,3,3
66,https://vlr.gg/player/11494/keiko,2025-02-20 05:00:00,0.88,1.24,1.08,206,190,251,41,17,24,40,20,20,12,5,7,-1,-1,0,74%,67%,79%,150,123,173,28%,30%,28%,3,1,2,4,2,2
67,https://vlr.gg/player/457/nats,2025-02-20 05:00:00,1.03,0.94,0.98,190,205,186,38,18,20,38,18,20,11,5,6,-6,-5,-1,68%,67%,69%,131,151,115,18%,17%,19%,4,1,3,10,6,4
68,https://vlr.gg/player/1475/kamyk,2025-02-20 05:00:00,1.19,0.63,0.88,173,217,142,31,19,12,38,17,21,21,10,11,0,+2,-2,74%,79%,69%,122,150,98,33%,41%,25%,4,2,2,4,0,4
69,https://vlr.gg/player/309/patitek,2025-02-20 05:00:00,0.34,0.93,0.67,176,115,206,30,8,22,42,21,21,16,9,7,-3,-3,0,58%,46%,69%,106,76,131,25%,26%,25%,3,1,2,6,4,2
70,https://vlr.gg/player/8373/okeanos,2025-02-19 18:30:00,0.79,1.15,0.97,205,206,225,32,13,19,31,17,14,6,1,5,0,-2,+2,63%,47%,75%,131,118,141,44%,56%,35%,7,4,3,7,6,1
71,https://vlr.gg/player/34400/bao,2025-02-19 18:30:00,0.87,1.03,0.96,184,149,217,27,10,17,30,14,16,15,6,9,+1,0,+1,65%,53%,75%,115,94,131,34%,36%,33%,5,1,4,4,1,3
72,https://vlr.gg/player/844/bdog,2025-02-19 18:30:00,0.75,1.10,0.94,233,218,251,38,15,23,35,18,17,16,6,10,0,-1,+1,77%,74%,79%,147,129,161,26%,28%,24%,6,2,4,6,3,3
73,https://vlr.gg/player/1856/wedid,2025-02-19 18:30:00,0.71,0.95,0.84,193,196,192,27,11,16,35,17,18,11,5,6,+3,0,+3,81%,74%,88%,127,125,128,29%,32%,27%,3,0,3,0,0,0
74,https://vlr.gg/player/30470/kyu,2025-02-19 18:30:00,0.69,0.67,0.68,140,142,127,21,10,11,35,17,18,14,5,9,-1,-2,+1,63%,63%,63%,87,93,82,37%,42%,33%,2,0,2,3,2,1
75,https://vlr.gg/player/4828/nismo,2025-02-19 18:30:00,1.37,1.60,1.47,251,215,294,41,19,22,25,13,12,15,6,9,0,0,0,84%,75%,95%,166,135,206,34%,29%,40%,2,2,0,2,2,0
76,https://vlr.gg/player/8419/reduxx,2025-02-19 18:30:00,1.39,1.37,1.38,327,317,317,47,26,21,33,20,13,8,4,4,+1,-2,+3,79%,71%,89%,192,186,201,28%,29%,27%,8,3,5,7,5,2
77,https://vlr.gg/player/11118/skuba,2025-02-19 18:30:00,1.36,0.95,1.18,205,232,182,35,22,13,27,14,13,13,2,11,0,-1,+1,74%,79%,68%,121,134,104,30%,36%,25%,5,2,3,5,3,2
78,https://vlr.gg/player/41798/nightz,2025-02-19 18:30:00,0.62,1.45,0.98,198,127,286,29,9,20,32,19,13,20,8,12,-1,-2,+1,77%,79%,74%,131,93,178,40%,31%,49%,5,1,4,6,3,3
79,https://vlr.gg/player/3007/tdawgg,2025-02-19 18:30:00,0.21,1.02,0.57,89,66,117,12,5,7,28,20,8,18,8,10,-3,-3,0,65%,54%,79%,56,34,84,16%,11%,19%,0,0,0,3,3,0
80,https://vlr.gg/player/50786/renna,2025-02-19 17:25:00,0.39,1.60,0.87,156,107,239,19,7,12,25,19,6,12,5,7,-2,-2,0,69%,52%,93%,117,79,173,29%,19%,34%,1,0,1,3,2,1
81,https://vlr.gg/player/41225/kramarick,2025-02-19 17:25:00,0.76,0.99,0.85,183,185,195,21,12,9,29,19,10,9,5,4,-1,-2,+1,69%,62%,79%,123,121,125,33%,43%,23%,2,1,1,3,3,0
82,https://vlr.gg/player/45864/bruxo,2025-02-19 17:25:00,0.58,1.12,0.80,168,126,257,21,9,12,29,19,10,9,5,4,0,-2,+2,57%,38%,86%,126,89,180,30%,29%,32%,4,1,3,4,3,1
83,https://vlr.gg/player/41466/mixyce,2025-02-19 17:25:00,0.55,1.02,0.72,179,176,183,20,11,9,29,20,9,11,4,7,0,0,0,57%,52%,64%,110,106,115,24%,27%,21%,2,1,1,2,1,1
84,https://vlr.gg/player/47551/sanoj,2025-02-19 17:25:00,0.25,0.64,0.40,124,119,129,17,9,8,29,19,10,1,0,1,-8,-5,-3,46%,43%,50%,71,75,66,31%,44%,18%,3,2,1,11,7,4
85,https://vlr.gg/player/37354/basic,2025-02-19 17:25:00,1.35,2.12,1.81,265,210,286,33,10,23,13,8,5,26,7,19,+3,+1,+2,91%,93%,90%,169,158,176,31%,25%,35%,3,1,2,0,0,0
86,https://vlr.gg/player/1684/denaro,2025-02-19 17:25:00,1.59,1.49,1.53,259,289,241,30,14,16,18,9,9,21,7,14,+3,+2,+1,89%,79%,95%,182,191,176,20%,28%,16%,5,3,2,2,1,1
87,https://vlr.gg/player/22964/forbanz,2025-02-19 17:25:00,0.84,1.62,1.30,277,228,331,36,10,26,24,12,12,2,2,0,+5,-3,+8,83%,71%,90%,174,152,189,20%,21%,19%,10,2,8,5,5,0
88,https://vlr.gg/player/27149/brinks,2025-02-19 17:25:00,0.71,1.15,0.98,158,152,173,18,5,13,23,11,12,23,12,11,+2,+1,+1,83%,86%,81%,103,94,109,16%,13%,19%,4,1,3,2,0,2
89,https://vlr.gg/player/23832/lucks,2025-02-19 17:25:00,0.57,1.23,0.96,199,110,220,24,6,18,20,10,10,4,0,4,-2,-1,-1,74%,57%,86%,123,80,151,38%,43%,37%,1,0,1,3,1,2
90,https://vlr.gg/player/20140/vora,2025-02-19 16:00:00,1.21,1.20,1.21,235,209,256,36,14,22,24,9,15,8,5,3,-1,-1,0,69%,72%,67%,157,147,165,28%,26%,30%,2,0,2,3,1,2
91,https://vlr.gg/player/39602/recoil,2025-02-19 16:00:00,1.45,0.97,1.18,202,239,174,32,16,16,23,8,15,13,5,8,+4,+3,+1,81%,83%,79%,133,144,124,37%,44%,33%,6,4,2,2,1,1
92,https://vlr.gg/player/64/gmd,2025-02-19 16:00:00,0.86,1.33,1.13,160,106,201,24,7,17,20,9,11,24,12,12,-4,0,-4,81%,78%,83%,104,71,128,31%,16%,38%,0,0,0,4,0,4
93,https://vlr.gg/player/8376/seven,2025-02-19 16:00:00,1.41,0.80,1.06,202,298,131,31,21,10,26,12,14,14,3,11,-1,+2,-3,79%,78%,79%,123,180,81,12%,11%,14%,2,2,0,3,0,3
94,https://vlr.gg/player/3702/sym,2025-02-19 16:00:00,0.84,1.21,1.05,292,236,335,40,13,27,35,16,19,9,6,3,+6,+4,+2,81%,83%,79%,187,163,206,24%,20%,26%,13,7,6,7,3,4
95,https://vlr.gg/player/7716/penny,2025-02-19 16:00:00,1.33,1.25,1.29,247,266,222,38,23,15,30,18,12,9,7,2,+5,+8,-3,74%,83%,61%,156,166,144,26%,27%,24%,13,11,2,8,3,5
96,https://vlr.gg/player/8742/jakee,2025-02-19 16:00:00,0.92,1.43,1.14,190,149,247,31,15,16,30,17,13,8,2,6,-4,-2,-2,74%,67%,83%,127,96,168,33%,35%,31%,1,0,1,5,2,3
97,https://vlr.gg/player/69/thief,2025-02-19 16:00:00,1.15,0.39,0.83,177,222,119,22,16,6,34,18,16,16,12,4,-1,-1,0,69%,71%,67%,122,150,85,22%,21%,25%,1,1,0,2,2,0
98,https://vlr.gg/player/733/stellar,2025-02-19 16:00:00,0.89,0.52,0.72,142,158,122,23,14,9,35,19,16,19,15,4,-1,+1,-2,67%,71%,61%,84,102,60,17%,26%,7%,1,1,0,2,0,2
99,https://vlr.gg/player/739/fiziq,2025-02-19 16:00:00,0.36,0.70,0.50,116,83,161,14,6,8,34,20,14,14,7,7,-3,-2,-1,55%,50%,61%,80,63,101,23%,28%,19%,3,1,2,6,3,3
100,https://vlr.gg/player/24553/boni,2025-02-19 16:00:00,1.01,1.72,1.44,293,197,350,45,12,33,27,11,16,11,4,7,+1,0,+1,85%,94%,79%,178,119,218,31%,42%,28%,4,1,3,3,1,2
101,https://vlr.gg/player/17770/alvinboy,2025-02-19 16:00:00,1.55,1.11,1.29,229,267,203,34,17,17,24,8,16,18,8,10,0,0,0,73%,88%,63%,149,170,135,32%,38%,29%,2,0,2,2,0,2
102,https://vlr.gg/player/893/retrq,2025-02-19 16:00:00,1.38,1.12,1.23,214,276,175,30,15,15,22,10,12,11,5,6,-2,-2,0,83%,81%,83%,145,185,118,23%,24%,23%,2,1,1,4,3,1
103,https://vlr.gg/player/2125/nanners,2025-02-19 16:00:00,1.20,0.83,0.98,183,173,187,25,10,15,25,8,17,13,5,8,-4,-2,-2,68%,63%,71%,113,97,123,31%,33%,30%,4,0,4,8,2,6
104,https://vlr.gg/player/3719/matt,2025-02-19 16:00:00,0.37,0.84,0.64,132,73,175,17,3,14,27,11,16,10,2,8,0,-1,+1,65%,44%,79%,87,49,112,20%,17%,21%,5,3,2,5,4,1
105,https://vlr.gg/player/8286/glyph,2025-02-19 16:00:00,1.17,0.88,1.05,227,235,212,33,21,12,30,17,13,2,2,0,+4,+3,+1,70%,75%,63%,145,148,141,32%,27%,41%,4,3,1,0,0,0
106,https://vlr.gg/player/3227/screwface,2025-02-19 16:00:00,0.89,0.73,0.83,184,207,148,26,17,9,29,19,10,5,4,1,+1,+2,-1,60%,58%,63%,120,143,86,30%,32%,27%,6,5,1,5,3,2
107,https://vlr.gg/player/4931/add3r,2025-02-19 16:00:00,1.17,0.21,0.79,142,190,65,20,17,3,30,16,14,11,6,5,0,0,0,68%,75%,56%,92,116,55,37%,48%,13%,0,0,0,0,0,0
108,https://vlr.gg/player/13084/smiley,2025-02-19 16:00:00,0.60,0.93,0.73,142,128,162,20,11,9,31,20,11,18,11,7,0,0,0,63%,54%,75%,84,70,104,29%,21%,37%,3,2,1,3,2,1
109,https://vlr.gg/player/29076/satellite,2025-02-19 16:00:00,0.48,1.11,0.73,210,166,277,26,11,15,36,22,14,10,8,2,0,-5,+5,68%,67%,69%,133,123,149,17%,17%,18%,9,2,7,9,7,2
110,https://vlr.gg/player/13093/jzz,2025-02-19 15:00:00,1.26,2.23,1.68,306,237,408,43,19,24,20,13,7,10,8,2,+2,-1,+3,84%,81%,88%,200,141,277,32%,29%,34%,6,2,4,4,3,1
111,https://vlr.gg/player/1575/quick,2025-02-19 15:00:00,1.57,1.38,1.49,316,368,223,40,27,13,24,15,9,9,6,3,+4,+3,+1,89%,86%,94%,199,231,158,28%,33%,15%,7,5,2,3,2,1
112,https://vlr.gg/player/651/frz,2025-02-19 15:00:00,1.55,0.92,1.28,233,273,186,31,21,10,18,9,9,13,10,3,-1,-1,0,81%,86%,75%,146,171,113,22%,26%,17%,1,0,1,2,1,1
113,https://vlr.gg/player/8872/mazin,2025-02-19 15:00:00,1.16,1.34,1.24,200,203,191,28,17,11,18,11,7,14,7,7,+3,+2,+1,86%,81%,94%,134,140,127,35%,33%,38%,5,3,2,2,1,1
114,https://vlr.gg/player/1581/guhrvn,2025-02-19 15:00:00,0.51,0.98,0.71,106,87,122,14,6,8,20,13,7,14,6,8,-5,-2,-3,68%,62%,75%,64,55,76,30%,28%,32%,1,1,0,6,3,3
115,https://vlr.gg/player/23855/str0nda,2025-02-19 15:00:00,0.98,0.97,0.97,183,166,206,24,10,14,28,12,16,13,5,8,-2,0,-2,57%,50%,62%,132,125,137,33%,36%,31%,2,1,1,4,1,3
116,https://vlr.gg/player/41676/toronto,2025-02-19 15:00:00,0.78,0.94,0.87,175,165,178,22,9,13,30,13,17,8,2,6,+4,+1,+3,59%,56%,62%,114,109,117,33%,35%,31%,4,1,3,0,0,0
117,https://vlr.gg/player/32801/turkish,2025-02-19 15:00:00,0.46,0.82,0.66,169,128,184,20,7,13,33,14,19,6,3,3,0,-1,+1,57%,56%,57%,106,81,126,36%,29%,41%,4,1,3,4,2,2
118,https://vlr.gg/player/22914/hiiik,2025-02-19 15:00:00,0.49,0.72,0.62,165,154,186,21,8,13,34,14,20,11,7,4,-2,-1,-1,59%,56%,62%,117,92,136,28%,26%,29%,4,2,2,6,3,3
119,https://vlr.gg/player/41864/rodd,2025-02-19 15:00:00,0.40,0.54,0.48,104,103,112,13,5,8,31,13,18,4,1,3,-3,-1,-2,54%,50%,57%,77,69,84,25%,20%,30%,3,2,1,6,3,3
120,https://vlr.gg/player/36433/phc,2025-02-19 15:00:00,1.05,1.17,1.12,200,172,226,41,16,25,40,16,24,24,9,15,+2,+2,0,75%,70%,79%,129,108,147,26%,27%,25%,7,3,4,5,1,4
121,https://vlr.gg/player/15681/palla,2025-02-19 15:00:00,1.05,1.11,1.08,241,250,233,50,23,27,45,20,25,11,1,10,+4,0,+4,70%,63%,76%,145,147,143,27%,32%,24%,17,9,8,13,9,4
122,https://vlr.gg/player/6202/guuih,2025-02-19 15:00:00,0.98,0.84,0.90,164,177,151,38,19,19,43,19,24,7,4,3,-3,-1,-2,70%,74%,67%,109,122,98,36%,39%,33%,1,0,1,4,1,3
123,https://vlr.gg/player/9266/tisora,2025-02-19 15:00:00,0.76,1.00,0.89,196,144,228,38,12,26,44,19,25,21,9,12,-4,-2,-2,77%,81%,73%,121,94,142,18%,18%,18%,2,0,2,6,2,4
124,https://vlr.gg/player/3424/siduzord,2025-02-19 15:00:00,0.37,0.83,0.62,115,76,148,19,3,16,40,20,20,18,9,9,-3,-2,-1,68%,59%,76%,88,67,106,13%,6%,17%,1,0,1,4,2,2
125,https://vlr.gg/player/3455/zanatsu,2025-02-19 15:00:00,1.09,1.29,1.18,238,234,252,52,28,24,41,24,17,13,6,7,+6,+2,+4,65%,61%,70%,161,150,175,29%,31%,28%,15,8,7,9,6,3
126,https://vlr.gg/player/1671/kon4n,2025-02-19 15:00:00,1.03,1.01,1.02,199,206,193,44,26,18,39,23,16,12,6,6,+2,+1,+1,70%,73%,67%,126,125,128,32%,32%,33%,6,3,3,4,2,2
127,https://vlr.gg/player/3157/gaabxx,2025-02-19 15:00:00,0.84,1.20,1.00,179,160,201,39,18,21,34,22,12,17,9,8,-6,-3,-3,77%,76%,78%,115,109,124,28%,34%,24%,2,1,1,8,4,4
128,https://vlr.gg/player/13823/pxs,2025-02-19 15:00:00,0.94,1.05,0.99,184,214,153,38,24,14,38,25,13,17,8,9,+3,+3,0,77%,67%,89%,133,147,117,32%,26%,48%,8,5,3,5,2,3
129,https://vlr.gg/player/11105/rich,2025-02-19 15:00:00,0.88,1.01,0.94,159,143,180,34,17,17,34,19,15,18,12,6,-1,-2,+1,75%,79%,70%,98,84,115,29%,24%,33%,1,0,1,2,2,0
130,https://vlr.gg/player/29243/neon,2025-02-19 14:00:00,1.29,1.16,1.22,217,221,213,66,30,36,46,23,23,13,7,6,+7,+3,+4,77%,78%,76%,140,148,132,27%,34%,21%,15,6,9,8,3,5
131,https://vlr.gg/player/21251/blowz,2025-02-19 14:00:00,1.26,1.16,1.21,205,213,201,65,31,34,52,25,27,37,17,20,+1,+2,-1,73%,71%,76%,141,148,135,36%,41%,31%,4,3,1,3,1,2
132,https://vlr.gg/player/29241/miradaninja,2025-02-19 14:00:00,0.92,1.45,1.20,236,181,280,74,28,46,50,26,24,24,11,13,+1,-2,+3,77%,71%,82%,149,119,176,26%,32%,23%,6,2,4,5,4,1
133,https://vlr.gg/player/42867/ghoul33,2025-02-19 14:00:00,0.83,1.08,0.96,227,195,238,63,27,36,63,31,32,23,9,14,-1,-3,+2,71%,71%,71%,145,131,158,22%,22%,22%,14,6,8,15,9,6
134,https://vlr.gg/player/29242/erde,2025-02-19 14:00:00,1.10,0.81,0.95,168,188,154,51,29,22,54,24,30,38,12,26,-8,-3,-5,74%,71%,78%,123,125,122,28%,24%,32%,4,2,2,12,5,7
135,https://vlr.gg/player/41135/dantedeu5,2025-02-19 14:00:00,1.10,1.03,1.07,228,253,217,66,37,29,63,36,27,17,10,7,+8,+4,+4,67%,62%,73%,148,160,135,21%,25%,17%,17,9,8,9,5,4
136,https://vlr.gg/player/36169/mta,2025-02-19 14:00:00,0.93,0.98,0.95,178,182,189,56,29,27,62,33,29,22,11,11,0,-3,+3,71%,69%,73%,120,111,130,27%,29%,25%,9,4,5,9,7,2
137,https://vlr.gg/player/38857/beng,2025-02-19 14:00:00,0.97,0.81,0.89,172,174,162,48,27,21,62,33,29,19,9,10,+1,+1,0,66%,62%,71%,119,124,114,32%,33%,31%,7,3,4,6,2,4
138,https://vlr.gg/player/15542/gio,2025-02-19 14:00:00,0.71,0.90,0.80,165,138,198,49,22,27,68,36,32,26,13,13,-4,-3,-1,60%,53%,68%,109,90,129,37%,32%,41%,8,3,5,12,6,6
139,https://vlr.gg/player/33566/ganter,2025-02-19 14:00:00,0.65,0.90,0.77,150,142,165,46,21,25,64,36,28,10,6,4,-5,-2,-3,60%,56%,66%,107,96,119,38%,42%,35%,2,2,0,7,4,3
140,https://vlr.gg/player/18162/serial,2025-02-19 12:00:00,1.28,1.19,1.24,210,223,219,75,37,38,55,25,30,17,7,10,+3,0,+3,75%,77%,73%,151,147,154,46%,52%,41%,9,3,6,6,3,3
141,https://vlr.gg/player/16209/famsii,2025-02-19 12:00:00,1.11,1.22,1.17,258,234,268,84,38,46,65,32,33,21,7,14,+2,0,+2,75%,68%,82%,173,165,181,25%,37%,17%,13,5,8,11,5,6
142,https://vlr.gg/player/1524/h1ber,2025-02-19 12:00:00,1.07,1.00,1.03,197,199,199,63,30,33,62,29,33,31,18,13,+3,+1,+2,81%,80%,82%,138,135,141,39%,48%,32%,13,5,8,10,4,6
143,https://vlr.gg/player/29972/michel,2025-02-19 12:00:00,0.74,0.98,0.87,195,193,192,62,26,36,69,35,34,17,10,7,-3,-2,-1,74%,77%,71%,126,129,124,37%,35%,40%,8,5,3,11,7,4
144,https://vlr.gg/player/8805/sacake,2025-02-19 12:00:00,0.79,0.89,0.84,150,160,137,50,25,25,59,31,28,33,12,21,+5,+2,+3,75%,73%,78%,88,95,82,23%,26%,20%,8,4,4,3,2,1
145,https://vlr.gg/player/8226/waddle,2025-02-19 12:00:00,1.36,1.06,1.22,232,247,226,78,43,35,65,34,31,25,14,11,-3,-1,-2,73%,73%,73%,154,167,140,40%,39%,41%,4,2,2,7,3,4
146,https://vlr.gg/player/2190/baddyg,2025-02-19 12:00:00,1.10,1.05,1.08,198,202,202,65,35,30,62,33,29,39,20,19,-1,-2,+1,77%,76%,80%,136,137,135,24%,32%,17%,9,3,6,10,5,5
147,https://vlr.gg/player/12474/tag,2025-02-19 12:00:00,0.98,0.74,0.87,173,184,156,57,32,25,67,35,32,23,10,13,0,+1,-1,72%,67%,77%,111,113,108,29%,30%,29%,7,5,2,7,4,3
148,https://vlr.gg/player/1944/cayden,2025-02-19 12:00:00,0.71,0.90,0.80,146,116,188,49,20,29,66,35,31,37,20,17,-7,-5,-2,73%,67%,80%,106,81,133,34%,33%,35%,4,1,3,11,6,5
149,https://vlr.gg/player/1470/simond4rk,2025-02-19 12:00:00,0.58,0.98,0.77,178,155,205,57,24,33,74,41,33,15,7,8,+1,-2,+3,68%,63%,73%,116,105,128,27%,30%,23%,17,9,8,16,11,5
150,https://vlr.gg/player/754/nerve,2025-02-18 19:25:00,1.41,1.37,1.40,255,269,237,50,31,19,34,20,14,25,15,10,-2,-1,-1,81%,75%,91%,166,170,160,30%,31%,29%,4,3,1,6,4,2
151,https://vlr.gg/player/29893/timotino,2025-02-18 19:25:00,1.07,1.57,1.27,283,257,330,55,30,25,41,26,15,10,5,5,+7,+4,+3,80%,84%,73%,192,171,222,32%,40%,25%,13,9,4,6,5,1
152,https://vlr.gg/player/5093/logan,2025-02-18 19:25:00,1.28,1.11,1.22,235,253,195,47,32,15,37,22,15,17,7,10,0,0,0,74%,75%,73%,134,147,115,16%,17%,15%,3,1,2,3,1,2
153,https://vlr.gg/player/21878/snarly,2025-02-18 19:25:00,0.80,0.83,0.81,141,141,149,26,15,11,33,20,13,13,7,6,+2,+1,+1,72%,69%,77%,98,99,97,31%,38%,23%,6,3,3,4,2,2
154,https://vlr.gg/player/6437/dark3st,2025-02-18 19:25:00,0.58,0.95,0.73,146,128,172,26,13,13,40,26,14,27,15,12,-9,-4,-5,81%,81%,82%,101,89,119,24%,20%,30%,0,0,0,9,4,5
155,https://vlr.gg/player/34057/jerrwin,2025-02-18 19:25:00,0.91,1.17,1.06,228,192,253,44,16,28,42,16,26,7,2,5,-1,-1,0,67%,55%,75%,148,124,164,28%,31%,26%,7,2,5,8,3,5
156,https://vlr.gg/player/15051/sacred,2025-02-18 19:25:00,1.17,0.84,0.97,226,268,198,44,22,22,44,17,27,13,4,9,+4,+3,+1,74%,73%,75%,151,171,137,40%,40%,40%,6,3,3,2,0,2
157,https://vlr.gg/player/4917/kaoticcc,2025-02-18 19:25:00,0.74,1.06,0.93,219,204,224,40,15,25,40,18,22,12,5,7,+2,+2,0,65%,68%,63%,144,133,151,21%,24%,20%,12,7,5,10,5,5
158,https://vlr.gg/player/29688/mikee,2025-02-18 19:25:00,0.90,0.76,0.82,147,166,138,28,12,16,35,15,20,8,3,5,-2,0,-2,72%,68%,75%,103,111,97,21%,22%,20%,0,0,0,2,0,2
159,https://vlr.gg/player/3874/teague,2025-02-18 19:25:00,0.45,0.94,0.72,150,79,208,29,6,23,43,17,26,13,4,9,-1,-2,+1,63%,55%,69%,97,51,129,29%,50%,24%,3,0,3,4,2,2
160,https://vlr.gg/player/13831/zeldris,2025-02-18 18:25:00,1.45,1.52,1.48,297,307,293,67,35,32,42,24,18,15,10,5,+1,-1,+2,69%,67%,72%,201,216,184,28%,29%,27%,13,6,7,12,7,5
161,https://vlr.gg/player/873/bob,2025-02-18 18:25:00,0.88,1.21,1.04,189,161,227,41,18,23,42,24,18,19,10,9,-4,-4,0,74%,67%,83%,135,111,161,26%,33%,20%,1,0,1,5,4,1
162,https://vlr.gg/player/25902/shondex,2025-02-18 18:25:00,0.90,0.99,0.94,187,179,201,42,21,21,48,26,22,14,2,12,+1,0,+1,77%,70%,86%,130,120,143,38%,36%,40%,7,4,3,6,4,2
163,https://vlr.gg/player/11696/zoestol,2025-02-18 18:25:00,0.74,1.01,0.87,167,159,179,37,18,19,47,28,19,28,15,13,-2,-2,0,73%,70%,76%,112,110,115,19%,17%,22%,4,1,3,6,3,3
164,https://vlr.gg/player/26848/zeek,2025-02-18 18:25:00,0.91,0.77,0.84,175,156,199,37,18,19,47,24,23,28,16,12,+4,0,+4,79%,82%,76%,119,105,135,32%,33%,31%,6,2,4,2,2,0
165,https://vlr.gg/player/21886/furbsa,2025-02-18 18:25:00,0.90,1.55,1.25,290,201,353,66,21,45,48,24,24,13,4,9,+1,-2,+3,76%,69%,82%,176,122,224,38%,42%,36%,11,6,5,10,8,2
166,https://vlr.gg/player/8397/dip,2025-02-18 18:25:00,1.14,1.01,1.07,222,248,197,44,24,20,44,22,22,19,12,7,+1,-1,+2,76%,76%,76%,151,167,138,20%,18%,22%,5,1,4,4,2,2
167,https://vlr.gg/player/8758/benjii,2025-02-18 18:25:00,1.11,0.81,0.95,168,201,137,40,23,17,43,21,22,20,5,15,0,-1,+1,73%,72%,73%,113,124,104,36%,36%,37%,5,1,4,5,2,3
168,https://vlr.gg/player/14048/zerona,2025-02-18 18:25:00,0.95,0.92,0.94,192,203,191,43,21,22,46,23,23,22,14,8,-3,-2,-1,79%,83%,76%,125,123,127,34%,35%,33%,6,2,4,9,4,5
169,https://vlr.gg/player/20959/toozy,2025-02-18 18:25:00,0.57,1.10,0.85,157,118,193,33,11,22,43,24,19,30,10,20,+1,-1,+2,79%,76%,82%,102,82,120,27%,21%,32%,4,1,3,3,2,1
170,https://vlr.gg/player/32802/luid,2025-02-18 17:45:00,0.84,2.06,1.50,324,208,424,49,14,35,32,17,15,11,4,7,+7,-1,+8,77%,60%,91%,205,132,269,20%,16%,23%,13,4,9,6,5,1
171,https://vlr.gg/player/4556/txddy,2025-02-18 17:45:00,0.75,1.06,0.91,160,165,156,24,10,14,27,16,11,12,5,7,0,+1,-1,70%,60%,78%,106,108,104,21%,18%,23%,3,1,2,3,0,3
172,https://vlr.gg/player/1650/bladez,2025-02-18 17:45:00,0.54,1.10,0.84,117,93,143,19,6,13,29,16,13,18,5,13,-1,-1,0,72%,55%,87%,85,71,97,44%,50%,42%,2,1,1,3,2,1
173,https://vlr.gg/player/15395/gbz,2025-02-18 17:45:00,0.77,0.87,0.82,162,156,160,23,11,12,30,16,14,15,5,10,-1,+1,-2,58%,45%,70%,101,90,112,27%,23%,30%,4,3,1,5,2,3
174,https://vlr.gg/player/32718/kenkayyy,2025-02-18 17:45:00,0.47,0.69,0.59,118,96,137,18,7,11,32,16,16,9,3,6,0,-2,+2,56%,45%,65%,84,75,92,25%,19%,30%,2,0,2,2,2,0
175,https://vlr.gg/player/25683/desire,2025-02-18 17:45:00,0.90,1.67,1.26,275,213,342,42,17,25,28,17,11,18,8,10,0,-2,+2,70%,65%,75%,179,136,229,28%,23%,32%,4,1,3,4,3,1
176,https://vlr.gg/player/37105/loss,2025-02-18 17:45:00,0.72,1.66,1.16,258,215,302,38,15,23,30,21,9,6,5,1,0,-3,+3,67%,57%,80%,169,145,196,33%,28%,38%,8,4,4,8,7,1
177,https://vlr.gg/player/36106/skz,2025-02-18 17:45:00,0.76,1.59,1.14,181,113,258,28,9,19,24,15,9,16,5,11,+1,0,+1,67%,52%,85%,109,71,153,26%,27%,26%,2,0,2,1,0,1
178,https://vlr.gg/player/15361/swag,2025-02-18 17:45:00,0.78,1.02,0.89,137,149,127,19,11,8,25,17,8,8,4,4,-1,0,-1,60%,57%,65%,98,99,97,36%,36%,36%,2,2,0,3,2,1
179,https://vlr.gg/player/46568/above,2025-02-18 17:45:00,0.99,0.72,0.86,150,190,101,22,16,6,27,15,12,12,4,8,-5,-2,-3,70%,65%,75%,101,126,72,41%,42%,39%,3,1,2,8,3,5
180,https://vlr.gg/player/39538/bull3tz,2025-02-18 17:00:00,0.91,1.04,0.97,177,180,191,54,26,28,60,32,28,22,9,13,+8,+3,+5,71%,68%,73%,121,112,131,31%,32%,30%,14,7,7,6,4,2
181,https://vlr.gg/player/2753/bandicoot,2025-02-18 17:00:00,0.80,1.13,0.97,173,141,217,52,21,31,57,29,28,25,7,18,-2,-3,+1,68%,61%,76%,125,97,153,37%,36%,37%,3,0,3,5,3,2
182,https://vlr.gg/player/35583/edu,2025-02-18 17:00:00,0.95,0.75,0.85,192,212,156,52,30,22,66,35,31,23,7,16,0,-4,+4,67%,63%,71%,116,131,100,35%,28%,47%,6,1,5,6,5,1
183,https://vlr.gg/player/7618/theory,2025-02-18 17:00:00,0.69,0.96,0.82,145,135,166,44,19,25,57,30,27,7,2,5,-3,-4,+1,55%,54%,56%,100,95,106,31%,33%,30%,3,0,3,6,4,2
184,https://vlr.gg/player/10556/drakk,2025-02-18 17:00:00,0.59,1.02,0.80,214,186,243,59,25,34,70,38,32,14,6,8,-11,-11,0,61%,51%,71%,141,125,157,35%,37%,34%,11,3,8,22,14,8
185,https://vlr.gg/player/10557/darker,2025-02-18 17:00:00,1.33,1.29,1.31,237,240,232,69,37,32,50,26,24,39,13,26,+8,+3,+5,80%,78%,83%,158,164,152,32%,31%,33%,9,4,5,1,1,0
186,https://vlr.gg/player/3983/virtyy,2025-02-18 17:00:00,1.04,1.46,1.25,257,249,278,77,34,43,55,31,24,15,10,5,+4,-8,+12,78%,76%,80%,169,165,173,25%,26%,24%,20,6,14,16,14,2
187,https://vlr.gg/player/8056/mited,2025-02-18 17:00:00,1.19,1.12,1.15,209,200,206,54,27,27,46,23,23,29,13,16,-2,-1,-1,77%,76%,78%,153,153,153,22%,20%,25%,2,1,1,4,2,2
188,https://vlr.gg/player/7616/feniz,2025-02-18 17:00:00,0.86,1.16,1.00,190,186,190,57,28,29,54,31,23,15,2,13,+3,-2,+5,73%,66%,80%,128,120,136,36%,36%,36%,8,1,7,5,3,2
189,https://vlr.gg/player/9354/cebando,2025-02-18 17:00:00,0.80,1.05,0.93,168,142,201,53,20,33,56,29,27,44,22,22,-5,-3,-2,77%,73%,80%,108,84,132,36%,29%,41%,6,3,3,11,6,5
190,https://vlr.gg/player/17865/nahsie,2025-02-18 16:00:00,1.61,0.92,1.28,240,300,172,41,27,14,28,12,16,16,8,8,-1,0,-1,77%,88%,65%,152,192,108,32%,38%,24%,1,1,0,2,1,1
191,https://vlr.gg/player/9063/infiltrator,2025-02-18 16:00:00,1.08,1.36,1.21,281,255,321,48,24,24,35,15,20,8,3,5,-1,+2,-3,69%,68%,70%,170,154,187,30%,30%,30%,9,6,3,10,4,6
192,https://vlr.gg/player/9017/moobs,2025-02-18 16:00:00,1.58,0.77,1.19,251,325,176,44,30,14,32,13,19,7,4,3,-5,+2,-7,63%,72%,52%,167,198,132,44%,49%,37%,4,4,0,9,2,7
193,https://vlr.gg/player/9835/ali,2025-02-18 16:00:00,0.96,0.89,0.92,179,166,189,31,15,16,34,14,20,20,13,7,-3,0,-3,73%,88%,57%,121,116,127,21%,21%,21%,3,2,1,6,2,4
194,https://vlr.gg/player/9837/flare,2025-02-18 16:00:00,0.83,0.55,0.70,135,133,135,19,10,9,32,13,19,18,13,5,+2,+1,+1,65%,76%,52%,91,92,90,29%,27%,32%,3,2,1,1,1,0
195,https://vlr.gg/player/46241/demi,2025-02-18 16:00:00,1.30,1.15,1.22,238,247,231,42,22,20,37,16,21,19,12,7,+4,+5,-1,67%,78%,56%,156,166,148,38%,36%,40%,9,6,3,5,1,4
196,https://vlr.gg/player/24232/ghost,2025-02-18 16:00:00,1.40,0.90,1.14,234,263,211,40,23,17,36,15,21,12,8,4,+6,+5,+1,79%,87%,72%,148,168,129,28%,25%,32%,9,5,4,3,0,3
197,https://vlr.gg/player/47392/kaiser,2025-02-18 16:00:00,1.01,0.99,1.00,191,192,192,31,17,14,34,15,19,23,9,14,0,+1,-1,71%,83%,60%,126,114,137,21%,15%,26%,3,2,1,3,1,2
198,https://vlr.gg/player/44085/booey,2025-02-18 16:00:00,1.21,0.45,0.81,179,235,124,27,18,9,37,14,23,18,9,9,+1,+3,-2,75%,83%,68%,124,165,87,20%,16%,26%,5,3,2,4,0,4
199,https://vlr.gg/player/44841/garpa,2025-02-18 16:00:00,0.76,0.33,0.53,136,185,89,21,14,7,39,17,22,20,14,6,-3,-1,-2,54%,65%,44%,87,123,54,26%,31%,19%,2,2,0,5,3,2
200,https://vlr.gg/player/862/b0i,2025-02-18 16:00:00,1.51,1.01,1.25,221,273,181,53,33,20,37,16,21,30,15,15,-2,+1,-3,75%,81%,70%,148,172,125,24%,25%,24%,4,2,2,6,1,5
201,https://vlr.gg/player/48025/alym,2025-02-18 16:00:00,1.09,1.16,1.13,249,234,264,54,26,28,47,21,26,21,11,10,+5,+2,+3,77%,75%,79%,170,146,192,31%,34%,28%,15,9,6,10,7,3
202,https://vlr.gg/player/9094/kess,2025-02-18 16:00:00,1.22,0.97,1.10,225,233,216,52,29,23,46,19,27,21,10,11,+2,+2,0,77%,78%,76%,140,145,135,27%,33%,22%,6,3,3,4,1,3
203,https://vlr.gg/player/62/huynh,2025-02-18 16:00:00,1.26,0.44,0.85,169,198,145,39,23,16,45,16,29,20,15,5,-4,-2,-2,74%,91%,58%,114,135,94,17%,20%,14%,3,1,2,7,3,4
204,https://vlr.gg/player/10053/fireballops,2025-02-18 16:00:00,1.05,0.44,0.74,148,202,102,36,25,11,46,19,27,7,5,2,0,-1,+1,68%,88%,48%,109,141,77,29%,27%,33%,5,2,3,5,3,2
205,https://vlr.gg/player/8422/spaz,2025-02-18 16:00:00,1.44,0.88,1.16,202,233,164,48,28,20,43,18,25,21,14,7,-2,0,-2,72%,88%,56%,137,165,107,23%,24%,23%,2,1,1,4,1,3
206,https://vlr.gg/player/23407/pa1nt,2025-02-18 16:00:00,0.93,1.20,1.06,251,253,279,56,28,28,55,27,28,17,10,7,-1,-3,+2,71%,79%,63%,171,160,182,19%,17%,21%,13,7,6,14,10,4
207,https://vlr.gg/player/2164/paincakes,2025-02-18 16:00:00,1.32,0.76,1.04,196,234,150,44,28,16,46,19,27,19,11,8,-2,+1,-3,71%,85%,56%,131,158,103,33%,39%,26%,3,3,0,5,2,3
208,https://vlr.gg/player/864/bcj,2025-02-18 16:00:00,1.40,0.61,1.01,183,210,161,43,26,17,41,14,27,17,10,7,0,+2,-2,65%,76%,53%,122,134,109,15%,15%,15%,6,3,3,6,1,5
209,https://vlr.gg/player/4385/monsi,2025-02-18 16:00:00,0.89,0.43,0.67,133,153,114,30,20,10,49,20,29,21,11,10,+4,+1,+3,65%,76%,53%,81,87,75,23%,29%,17%,8,3,5,4,2,2
210,https://vlr.gg/player/2567/liazzi,2025-02-18 15:00:00,1.16,1.21,1.19,212,147,257,45,13,32,35,9,26,15,7,8,0,+1,-1,77%,80%,75%,142,102,169,29%,15%,36%,3,2,1,3,1,2
211,https://vlr.gg/player/2486/pollo,2025-02-18 15:00:00,1.41,1.03,1.19,222,257,193,46,23,23,37,12,25,12,3,9,+4,+1,+3,74%,88%,64%,153,183,132,38%,44%,33%,7,2,5,3,1,2
212,https://vlr.gg/player/25858/sw,2025-02-18 15:00:00,1.32,1.01,1.14,218,218,210,48,21,27,40,13,27,15,8,7,+3,+4,-1,77%,84%,72%,139,135,141,32%,37%,29%,9,5,4,6,1,5
213,https://vlr.gg/player/1578/shion,2025-02-18 15:00:00,1.01,0.89,0.94,182,133,213,39,13,26,38,10,28,25,9,16,-1,-1,0,80%,68%,89%,111,76,136,35%,41%,33%,2,1,1,3,2,1
214,https://vlr.gg/player/41224/tkzin,2025-02-18 15:00:00,0.73,0.75,0.72,181,192,181,40,17,23,48,19,29,6,3,3,+1,+4,-3,66%,68%,64%,117,123,113,27%,27%,26%,13,7,6,12,3,9
215,https://vlr.gg/player/5342/duht,2025-02-18 15:00:00,1.50,0.92,1.26,260,318,192,54,40,14,42,26,16,21,16,5,+1,+3,-2,77%,86%,64%,181,210,139,20%,20%,22%,6,5,1,5,2,3
216,https://vlr.gg/player/6222/ginilson,2025-02-18 15:00:00,1.13,0.89,1.03,185,184,180,38,25,13,40,23,17,14,10,4,-2,0,-2,77%,81%,72%,127,130,122,32%,28%,42%,4,2,2,6,2,4
217,https://vlr.gg/player/8896/loweed,2025-02-18 15:00:00,0.99,0.85,0.93,161,201,103,35,26,9,41,26,15,27,19,8,+3,+2,+1,75%,83%,64%,100,114,78,27%,22%,41%,3,2,1,0,0,0
218,https://vlr.gg/player/16620/bruninej,2025-02-18 15:00:00,0.81,0.85,0.82,175,165,178,33,19,14,48,27,21,32,22,10,+1,+2,-1,66%,75%,52%,106,102,112,22%,18%,29%,6,4,2,5,2,3
219,https://vlr.gg/player/1999/rnd,2025-02-18 15:00:00,0.77,0.67,0.73,166,192,140,38,25,13,47,29,18,5,5,0,-10,-5,-5,59%,64%,52%,108,130,75,25%,27%,17%,8,6,2,18,11,7
220,https://vlr.gg/player/32675/kring,2025-02-18 15:00:00,1.28,1.33,1.31,258,248,269,43,21,22,34,15,19,11,3,8,-3,0,-3,85%,82%,88%,174,163,183,34%,47%,26%,0,0,0,3,0,3
221,https://vlr.gg/player/20251/vit9ine,2025-02-18 15:00:00,1.23,1.10,1.16,198,184,200,35,16,19,29,13,16,13,11,2,0,+1,-1,77%,77%,76%,118,108,127,28%,37%,22%,1,1,0,1,0,1
222,https://vlr.gg/player/14944/ind1n,2025-02-18 15:00:00,0.85,0.66,0.75,195,242,159,31,18,13,40,19,21,13,6,7,-6,0,-6,62%,73%,52%,127,153,104,23%,31%,15%,11,7,4,17,7,10
223,https://vlr.gg/player/1605/champzera,2025-02-18 15:00:00,0.75,0.73,0.74,175,181,178,27,14,13,40,18,22,21,9,12,0,0,0,74%,77%,72%,112,121,105,21%,20%,23%,3,1,2,3,1,2
224,https://vlr.gg/player/1595/myssen,2025-02-18 15:00:00,0.70,0.41,0.55,124,167,86,20,13,7,37,17,20,18,12,6,-4,-3,-1,62%,73%,52%,87,113,63,25%,23%,29%,2,1,1,6,4,2
225,https://vlr.gg/player/32717/maestr0,2025-02-18 15:00:00,1.28,1.19,1.24,248,246,236,41,22,19,31,15,16,15,7,8,+2,0,+2,79%,80%,77%,157,160,153,31%,29%,34%,10,4,6,8,4,4
226,https://vlr.gg/player/6238/urango,2025-02-18 15:00:00,0.80,1.54,1.15,233,185,285,39,16,23,35,20,15,19,12,7,+1,+1,0,81%,92%,68%,150,122,183,40%,43%,38%,1,1,0,0,0,0
227,https://vlr.gg/player/5351/rglmeister,2025-02-18 15:00:00,1.29,0.93,1.12,185,180,197,31,16,15,28,11,17,21,14,7,+5,+3,+2,79%,84%,73%,129,126,134,24%,21%,28%,6,3,3,1,0,1
228,https://vlr.gg/player/1567/bezn1,2025-02-18 15:00:00,1.13,0.99,1.06,211,212,212,36,20,16,31,14,17,14,6,8,+1,+2,-1,85%,96%,73%,146,144,148,27%,29%,26%,5,4,1,4,2,2
229,https://vlr.gg/player/1566/prozin,2025-02-18 15:00:00,1.16,0.50,0.85,166,208,127,29,20,9,32,14,18,8,4,4,+4,+5,-1,70%,84%,55%,117,146,84,32%,43%,17%,8,6,2,4,1,3
230,https://vlr.gg/player/6959/flickless,2025-02-18 12:00:00,1.07,1.36,1.21,216,198,231,89,41,48,73,40,33,45,20,25,-2,-2,0,79%,74%,85%,135,119,153,28%,32%,25%,6,3,3,8,5,3
231,https://vlr.gg/player/1839/polvi,2025-02-18 12:00:00,0.86,1.19,1.02,227,232,224,83,41,42,84,50,34,30,17,13,-4,-3,-1,71%,64%,78%,156,154,159,19%,23%,16%,19,11,8,23,14,9
232,https://vlr.gg/player/8834/bucher,2025-02-18 12:00:00,0.90,1.09,0.99,193,196,194,77,39,38,76,43,33,30,11,19,+4,+1,+3,73%,67%,80%,134,136,132,31%,27%,36%,10,5,5,6,4,2
233,https://vlr.gg/player/341/quick,2025-02-18 12:00:00,0.67,1.05,0.85,190,147,236,76,31,45,85,45,40,26,8,18,-4,-4,0,75%,71%,80%,123,94,155,40%,41%,39%,7,1,6,11,5,6
234,https://vlr.gg/player/15473/yuno,2025-02-18 12:00:00,0.83,0.79,0.81,159,150,168,62,31,31,84,42,42,44,16,28,-3,-3,0,71%,69%,72%,100,91,110,23%,20%,25%,9,3,6,12,6,6
235,https://vlr.gg/player/2190/baddyg,2025-02-18 12:00:00,1.06,1.32,1.19,226,206,246,92,37,55,74,39,35,51,27,24,+5,-1,+6,82%,80%,84%,139,130,149,24%,27%,22%,10,3,7,5,4,1
236,https://vlr.gg/player/8226/waddle,2025-02-18 12:00:00,1.23,1.14,1.18,198,213,184,80,42,38,64,35,29,33,20,13,-2,0,-2,78%,78%,78%,137,139,134,30%,31%,29%,5,2,3,7,2,5
237,https://vlr.gg/player/1944/cayden,2025-02-18 12:00:00,1.04,1.24,1.14,204,181,229,84,35,49,77,40,37,53,26,27,+3,0,+3,82%,81%,83%,132,114,149,29%,26%,33%,12,2,10,9,2,7
238,https://vlr.gg/player/12474/tag,2025-02-18 12:00:00,0.72,0.98,0.86,180,154,201,75,31,44,83,42,41,21,6,15,+2,-1,+3,67%,57%,76%,113,95,130,34%,33%,35%,10,3,7,8,4,4
239,https://vlr.gg/player/1470/simond4rk,2025-02-18 12:00:00,0.69,0.83,0.76,195,209,182,71,37,34,90,49,41,32,13,19,+1,0,+1,76%,69%,83%,123,126,120,17%,17%,16%,23,16,7,22,16,6
240,https://vlr.gg/player/114/enzo,2025-02-18 11:00:00,1.49,0.89,1.26,253,291,193,47,35,12,45,27,18,23,11,12,-1,+3,-4,81%,83%,77%,181,204,144,19%,21%,15%,4,4,0,5,1,4
241,https://vlr.gg/player/13258/cyvoph,2025-02-18 11:00:00,0.91,0.65,0.81,167,179,147,33,22,11,48,28,20,22,14,8,-2,-3,+1,69%,72%,64%,108,115,96,33%,33%,31%,4,0,4,6,3,3
242,https://vlr.gg/player/113/hyp,2025-02-18 11:00:00,0.82,0.38,0.65,149,161,131,31,22,9,47,27,20,9,5,4,-2,-2,0,64%,69%,55%,103,111,88,29%,33%,21%,4,3,1,6,5,1
243,https://vlr.gg/player/1284/mikee,2025-02-18 11:00:00,0.60,0.70,0.64,131,133,129,25,15,10,46,29,17,26,19,7,-4,-4,0,60%,64%,55%,91,92,88,28%,25%,35%,4,2,2,8,6,2
244,https://vlr.gg/player/3582/keloqz,2025-02-18 11:00:00,0.57,0.55,0.56,148,150,147,31,20,11,47,29,18,4,3,1,-9,-8,-1,52%,53%,50%,99,99,100,43%,44%,40%,4,2,2,13,10,3
245,https://vlr.gg/player/4521/unfake,2025-02-18 11:00:00,1.24,1.44,1.36,278,245,297,55,19,36,35,14,21,17,5,12,+10,+2,+8,84%,86%,83%,188,167,201,36%,33%,38%,10,2,8,0,0,0
246,https://vlr.gg/player/565/starxo,2025-02-18 11:00:00,1.62,1.10,1.29,213,255,186,47,20,27,31,8,23,21,10,11,+1,+1,0,72%,86%,64%,144,174,125,26%,33%,21%,4,3,1,3,2,1
247,https://vlr.gg/player/7162/wackie,2025-02-18 11:00:00,1.49,0.95,1.15,171,203,151,38,17,21,27,6,21,9,4,5,0,-1,+1,74%,91%,64%,119,141,105,34%,37%,31%,1,0,1,1,1,0
248,https://vlr.gg/player/2653/jesse,2025-02-18 11:00:00,1.24,1.10,1.15,190,164,209,43,15,28,34,10,24,24,11,13,-1,+1,-2,81%,86%,78%,130,99,149,41%,40%,41%,4,1,3,5,0,5
249,https://vlr.gg/player/440/akumaaaaa,2025-02-18 11:00:00,1.08,1.06,1.07,239,264,225,50,22,28,40,15,25,7,1,6,+8,+1,+7,78%,77%,78%,151,157,148,28%,45%,20%,19,7,12,11,6,5
250,https://vlr.gg/player/34982/athan,2025-02-18 05:40:00,1.62,1.46,1.56,283,292,271,40,25,15,25,15,10,25,12,13,+3,+1,+2,85%,88%,82%,184,194,170,35%,43%,26%,4,2,2,1,1,0
251,https://vlr.gg/player/51238/yong,2025-02-18 05:40:00,1.46,1.01,1.28,232,259,195,36,24,12,23,12,11,17,9,8,+2,+2,0,78%,88%,65%,149,175,113,41%,45%,33%,5,4,1,3,2,1
252,https://vlr.gg/player/51100/flicker,2025-02-18 05:40:00,0.89,1.54,1.16,251,199,324,35,17,18,27,16,11,16,4,12,+1,-2,+3,83%,71%,100%,159,127,204,21%,36%,14%,6,2,4,5,4,1
253,https://vlr.gg/player/51099/zynx,2025-02-18 05:40:00,1.12,1.18,1.14,225,240,207,33,20,13,27,17,10,11,6,5,+1,+2,-1,71%,71%,71%,153,150,157,36%,40%,31%,2,2,0,1,0,1
254,https://vlr.gg/player/4661/sacrifice,2025-02-18 05:40:00,0.67,0.97,0.79,172,168,178,26,15,11,29,18,11,3,0,3,-3,-1,-2,56%,50%,65%,127,111,151,45%,39%,50%,5,3,2,8,4,4
255,https://vlr.gg/player/36685/splash,2025-02-18 05:40:00,1.22,1.35,1.30,268,246,285,39,14,25,35,14,21,7,5,2,-1,0,-1,66%,76%,58%,161,149,168,35%,26%,42%,7,3,4,8,3,5
256,https://vlr.gg/player/37057/woody,2025-02-18 05:40:00,1.17,0.92,1.03,221,230,219,32,13,19,34,12,22,7,3,4,+3,+1,+2,66%,59%,71%,148,167,135,43%,58%,32%,4,1,3,1,0,1
257,https://vlr.gg/player/43524/mikezin,2025-02-18 05:40:00,0.72,0.73,0.72,167,189,150,23,11,12,32,14,18,11,5,6,-1,-1,0,61%,71%,54%,108,111,106,27%,26%,29%,1,0,1,2,1,1
258,https://vlr.gg/player/7416/skye,2025-02-18 05:40:00,0.90,0.49,0.66,166,214,133,21,13,8,36,14,22,14,5,9,-2,+1,-3,68%,76%,63%,114,136,99,20%,22%,18%,4,4,0,6,3,3
259,https://vlr.gg/player/7049/natz,2025-02-18 05:40:00,0.18,0.58,0.41,110,51,150,16,3,13,34,15,19,5,5,0,-3,-2,-1,46%,47%,46%,69,30,97,26%,25%,26%,3,0,3,6,2,4
260,https://vlr.gg/player/30575/r1sen,2025-02-18 04:40:00,1.54,1.71,1.60,327,310,362,20,13,7,14,10,4,3,0,3,-1,-1,0,72%,67%,83%,203,184,241,27%,32%,18%,1,1,0,2,2,0
261,https://vlr.gg/player/30877/lilboii,2025-02-18 04:40:00,0.36,1.64,0.79,201,127,350,13,5,8,17,12,5,1,0,1,0,-1,+1,67%,50%,100%,125,74,225,22%,19%,24%,1,0,1,1,1,0
262,https://vlr.gg/player/46104/envy2k,2025-02-18 04:40:00,0.26,1.14,0.55,120,84,193,8,3,5,15,11,4,3,3,0,-2,-2,0,56%,50%,67%,85,58,140,9%,10%,9%,0,0,0,2,2,0
263,https://vlr.gg/player/19231/kibojn,2025-02-18 04:40:00,0.58,0.16,0.44,114,113,117,6,4,2,17,11,6,8,6,2,0,+1,-1,72%,83%,50%,76,84,60,21%,24%,17%,1,1,0,1,0,1
264,https://vlr.gg/player/46051/yuvi,2025-02-18 04:40:00,0.45,0.34,0.41,120,147,68,7,5,2,17,12,5,3,2,1,-1,+1,-2,56%,50%,67%,71,92,28,15%,13%,50%,4,3,1,5,2,3
265,https://vlr.gg/player/37057/woody,2025-02-18 04:40:00,1.77,1.87,1.84,291,289,292,20,7,13,7,3,4,4,1,3,0,0,0,78%,67%,83%,207,217,203,34%,31%,36%,0,0,0,0,0,0
266,https://vlr.gg/player/36685/splash,2025-02-18 04:40:00,1.62,1.73,1.69,387,366,399,25,7,18,12,5,7,3,2,1,+8,+3,+5,94%,100%,92%,234,238,231,32%,35%,31%,8,3,5,0,0,0
267,https://vlr.gg/player/43524/mikezin,2025-02-18 04:40:00,1.20,1.15,1.17,216,264,193,14,5,9,10,5,5,7,4,3,0,0,0,83%,100%,75%,145,157,140,20%,19%,21%,0,0,0,0,0,0
268,https://vlr.gg/player/7416/skye,2025-02-18 04:40:00,0.39,1.11,0.87,182,148,199,12,3,9,12,6,6,4,2,2,-2,0,-2,89%,83%,92%,114,101,120,20%,18%,21%,0,0,0,2,0,2
269,https://vlr.gg/player/7049/natz,2025-02-18 04:40:00,0.28,0.71,0.57,148,108,169,9,2,7,13,5,8,8,4,4,-2,-1,-1,67%,50%,75%,92,73,102,32%,100%,25%,3,1,2,5,2,3
270,https://vlr.gg/player/36685/splash,2025-02-18 04:00:00,1.12,1.70,1.47,362,268,426,26,8,18,17,6,11,1,1,0,+1,-1,+2,85%,63%,100%,223,179,252,45%,83%,35%,7,3,4,6,4,2
271,https://vlr.gg/player/7416/skye,2025-02-18 04:00:00,0.80,0.78,0.79,156,149,162,10,4,6,15,6,9,6,4,2,0,0,0,60%,63%,58%,99,88,106,26%,33%,24%,1,0,1,1,0,1
272,https://vlr.gg/player/37057/woody,2025-02-18 04:00:00,1.04,0.41,0.66,152,210,115,10,6,4,18,6,12,5,0,5,+1,+1,0,60%,63%,58%,104,144,78,50%,55%,45%,1,1,0,0,0,0
273,https://vlr.gg/player/43524/mikezin,2025-02-18 04:00:00,0.26,0.75,0.55,116,68,148,8,2,6,16,6,10,4,0,4,-1,0,-1,55%,38%,67%,79,61,91,31%,29%,32%,0,0,0,1,0,1
274,https://vlr.gg/player/7049/natz,2025-02-18 04:00:00,0.76,0.28,0.47,128,158,108,8,4,4,17,6,11,6,3,3,-1,0,-1,50%,63%,42%,92,113,79,31%,31%,31%,1,0,1,2,0,2
275,https://vlr.gg/player/4661/sacrifice,2025-02-18 04:00:00,1.57,1.41,1.50,295,322,257,23,15,8,12,7,5,2,1,1,0,+1,-1,80%,75%,88%,195,212,170,37%,34%,41%,4,4,0,4,3,1
276,https://vlr.gg/player/34982/athan,2025-02-18 04:00:00,1.10,1.72,1.35,235,204,282,16,8,8,13,8,5,11,8,3,+2,-1,+3,85%,92%,75%,153,139,174,27%,24%,32%,3,0,3,1,1,0
277,https://vlr.gg/player/51100/flicker,2025-02-18 04:00:00,1.47,0.73,1.18,223,267,158,16,12,4,12,6,6,6,2,4,-2,-1,-1,70%,67%,75%,147,167,116,29%,21%,44%,1,0,1,3,1,2
278,https://vlr.gg/player/51099/zynx,2025-02-18 04:00:00,0.84,1.37,1.05,215,223,205,15,8,7,12,9,3,5,3,2,0,+1,-1,70%,75%,63%,138,145,128,33%,23%,60%,2,2,0,2,1,1
279,https://vlr.gg/player/51238/yong,2025-02-18 04:00:00,1.13,0.77,0.99,169,204,117,13,10,3,13,8,5,7,4,3,0,0,0,80%,83%,75%,113,136,77,48%,50%,44%,0,0,0,0,0,0
280,https://vlr.gg/player/29843/yatsuka,2025-02-18 03:00:00,0.76,1.57,1.31,204,132,232,57,12,45,35,15,20,27,11,16,+1,-1,+2,85%,78%,88%,129,82,151,38%,33%,40%,4,1,3,3,2,1
281,https://vlr.gg/player/29841/caedye,2025-02-18 03:00:00,1.37,1.28,1.31,249,256,240,61,21,40,41,16,25,35,12,23,+2,-3,+5,85%,87%,83%,162,155,166,34%,48%,29%,9,1,8,7,4,3
282,https://vlr.gg/player/10584/seoldam,2025-02-18 03:00:00,0.97,1.40,1.26,276,253,273,70,20,50,44,18,26,17,8,9,+14,+1,+13,77%,70%,81%,160,159,160,15%,14%,15%,20,6,14,6,5,1
283,https://vlr.gg/player/4663/joxjo,2025-02-18 03:00:00,1.07,1.32,1.24,233,204,241,57,17,40,40,14,26,33,7,26,+4,+2,+2,79%,70%,83%,155,147,159,24%,27%,23%,8,2,6,4,0,4
284,https://vlr.gg/player/5476/minty,2025-02-18 03:00:00,1.58,1.03,1.21,194,264,160,47,21,26,38,13,25,44,16,28,0,-2,+2,86%,87%,85%,125,173,103,35%,37%,33%,5,0,5,5,2,3
285,https://vlr.gg/player/25915/brian,2025-02-18 03:00:00,0.85,0.98,0.89,198,206,226,51,34,17,61,42,19,28,14,14,-11,-8,-3,69%,67%,74%,134,132,139,27%,29%,23%,5,4,1,16,12,4
286,https://vlr.gg/player/4545/sayaplayer,2025-02-18 03:00:00,0.68,1.05,0.80,182,173,204,42,25,17,59,42,17,10,8,2,-8,-8,0,58%,52%,70%,124,117,139,28%,32%,18%,7,4,3,15,12,3
287,https://vlr.gg/player/31841/take,2025-02-18 03:00:00,0.75,0.77,0.76,133,149,126,35,24,11,57,39,18,16,11,5,-3,-4,+1,63%,56%,78%,98,99,95,27%,25%,30%,5,2,3,8,6,2
288,https://vlr.gg/player/17169/muto,2025-02-18 03:00:00,0.61,1.01,0.74,142,108,242,36,17,19,60,40,20,18,11,7,+7,+2,+5,62%,56%,74%,105,79,158,28%,26%,29%,7,2,5,0,0,0
289,https://vlr.gg/player/1963/hate,2025-02-18 03:00:00,0.69,0.79,0.72,142,147,144,34,22,12,55,38,17,10,5,5,-6,-6,0,55%,54%,57%,104,107,98,36%,36%,35%,1,0,1,7,6,1
290,https://vlr.gg/player/46104/envy2k,2025-02-18 03:00:00,0.32,1.44,1.07,259,147,315,16,3,13,16,6,10,2,0,2,-5,-3,-2,67%,50%,75%,169,73,217,44%,38%,48%,1,0,1,6,3,3
291,https://vlr.gg/player/30575/r1sen,2025-02-18 03:00:00,0.71,1.23,1.06,190,155,208,11,2,9,14,5,9,5,2,3,0,0,0,78%,67%,83%,124,123,124,28%,33%,25%,1,0,1,1,0,1
292,https://vlr.gg/player/30877/lilboii,2025-02-18 03:00:00,0.50,0.88,0.75,158,128,174,10,3,7,15,5,10,4,0,4,0,-3,+3,61%,33%,75%,107,80,121,24%,43%,19%,3,0,3,3,3,0
293,https://vlr.gg/player/46051/yuvi,2025-02-18 03:00:00,0.66,0.48,0.54,154,197,133,8,4,4,17,6,11,4,0,4,-1,0,-1,50%,50%,50%,109,143,92,23%,42%,11%,1,0,1,2,0,2
294,https://vlr.gg/player/19231/kibojn,2025-02-18 03:00:00,0.42,0.07,0.19,54,101,31,3,2,1,15,5,10,3,1,2,0,0,0,39%,50%,33%,40,79,20,27%,27%,25%,0,0,0,0,0,0
295,https://vlr.gg/player/51238/yong,2025-02-18 03:00:00,1.66,1.53,1.62,328,353,279,23,16,7,10,7,3,7,6,1,+3,+2,+1,89%,92%,83%,176,189,149,44%,43%,47%,3,2,1,0,0,0
296,https://vlr.gg/player/34982/athan,2025-02-18 03:00:00,1.81,1.04,1.55,284,338,179,16,14,2,9,6,3,13,5,8,+1,+1,0,89%,92%,83%,178,207,121,23%,29%,13%,1,1,0,0,0,0
297,https://vlr.gg/player/4661/sacrifice,2025-02-18 03:00:00,0.96,2.03,1.32,212,167,303,15,8,7,8,7,1,2,1,1,+5,+2,+3,78%,67%,100%,148,124,197,33%,43%,25%,6,3,3,1,1,0
298,https://vlr.gg/player/51099/zynx,2025-02-18 03:00:00,0.73,1.26,0.90,165,117,261,10,5,5,10,6,4,5,1,4,-2,-4,+2,61%,50%,83%,118,80,193,21%,25%,17%,2,0,2,4,4,0
299,https://vlr.gg/player/51100/flicker,2025-02-18 03:00:00,0.71,1.20,0.87,180,171,198,13,7,6,11,8,3,6,4,2,-1,-1,0,89%,83%,100%,100,108,86,10%,17%,3%,0,0,0,1,1,0
300,https://vlr.gg/player/8419/reduxx,2025-02-17 19:00:00,1.63,1.11,1.40,291,319,252,61,38,23,40,20,20,11,6,5,+5,+2,+3,72%,84%,58%,184,209,153,31%,33%,27%,12,7,5,7,5,2
301,https://vlr.gg/player/3007/tdawgg,2025-02-17 19:00:00,0.92,1.29,1.08,212,177,259,43,19,24,39,23,16,27,20,7,-1,-2,+1,76%,66%,88%,134,106,167,23%,16%,30%,4,1,3,5,3,2
302,https://vlr.gg/player/41798/nightz,2025-02-17 19:00:00,0.84,1.06,0.94,212,205,218,45,24,21,44,26,18,15,8,7,+1,0,+1,78%,75%,81%,140,134,148,41%,45%,37%,3,1,2,2,1,1
303,https://vlr.gg/player/11118/skuba,2025-02-17 19:00:00,1.02,0.75,0.90,183,204,158,37,23,14,40,23,17,17,12,5,-2,-2,0,72%,78%,65%,118,133,98,21%,23%,20%,6,3,3,8,5,3
304,https://vlr.gg/player/4828/nismo,2025-02-17 19:00:00,0.70,1.08,0.87,191,164,221,39,17,22,46,26,20,22,16,6,+1,-2,+3,74%,66%,85%,127,110,148,30%,26%,35%,6,2,4,5,4,1
305,https://vlr.gg/player/4917/kaoticcc,2025-02-17 19:00:00,1.36,1.21,1.27,285,289,283,57,27,30,47,21,26,21,6,15,+5,0,+5,81%,81%,81%,182,176,187,33%,38%,29%,11,4,7,6,4,2
306,https://vlr.gg/player/3874/teague,2025-02-17 19:00:00,1.09,1.22,1.17,221,216,226,45,19,26,41,19,22,23,9,14,0,-1,+1,72%,65%,78%,140,133,145,40%,37%,42%,3,1,2,3,2,1
307,https://vlr.gg/player/34057/jerrwin,2025-02-17 19:00:00,0.75,0.99,0.88,194,182,204,37,16,21,47,22,25,14,3,11,-4,-2,-2,69%,65%,72%,133,119,143,24%,31%,19%,6,4,2,10,6,4
308,https://vlr.gg/player/15051/sacred,2025-02-17 19:00:00,0.58,0.94,0.78,164,130,192,34,12,22,46,22,24,21,12,9,-4,-3,-1,67%,69%,66%,108,91,122,40%,35%,43%,3,0,3,7,3,4
309,https://vlr.gg/player/29688/mikee,2025-02-17 19:00:00,0.74,0.80,0.77,164,160,171,34,15,19,44,20,24,10,2,8,-1,-2,+1,62%,50%,72%,109,108,109,19%,32%,12%,4,0,4,5,2,3
310,https://vlr.gg/player/17397/noia,2025-02-17 18:00:00,0.99,1.50,1.19,237,200,300,34,18,16,28,17,11,7,5,2,0,-1,+1,77%,71%,87%,168,146,204,33%,37%,30%,1,0,1,1,1,0
311,https://vlr.gg/player/3063/mel,2025-02-17 18:00:00,1.50,0.36,1.06,213,280,102,29,24,5,29,17,12,14,9,5,-2,+2,-4,69%,83%,47%,132,173,67,35%,39%,27%,4,4,0,6,2,4
312,https://vlr.gg/player/19292/jowa,2025-02-17 18:00:00,0.73,0.75,0.74,181,185,174,21,14,7,33,20,13,9,4,5,+6,+1,+5,69%,71%,67%,117,116,118,16%,15%,18%,13,7,6,7,6,1
313,https://vlr.gg/player/3079/alexis,2025-02-17 18:00:00,0.67,0.87,0.74,130,118,148,20,10,10,29,17,12,15,10,5,-1,-2,+1,64%,63%,67%,81,79,85,29%,40%,18%,1,0,1,2,2,0
314,https://vlr.gg/player/21486/sarahcat,2025-02-17 18:00:00,0.64,0.56,0.60,146,148,149,16,9,7,34,20,14,16,11,5,+4,+2,+2,67%,71%,60%,106,107,106,19%,22%,15%,4,2,2,0,0,0
315,https://vlr.gg/player/46241/demi,2025-02-17 18:00:00,1.69,1.52,1.58,323,276,351,44,15,29,29,8,21,24,9,15,-4,-4,0,82%,80%,83%,204,181,219,32%,39%,29%,4,0,4,8,4,4
316,https://vlr.gg/player/24232/ghost,2025-02-17 18:00:00,1.53,0.87,1.12,177,277,116,27,16,11,20,8,12,9,6,3,-3,0,-3,79%,87%,75%,117,157,92,27%,27%,28%,1,1,0,4,1,3
317,https://vlr.gg/player/44841/garpa,2025-02-17 18:00:00,1.10,1.08,1.09,190,198,189,27,11,16,24,10,14,19,8,11,+2,+1,+1,79%,87%,75%,118,117,118,31%,27%,33%,2,1,1,0,0,0
318,https://vlr.gg/player/47392/kaiser,2025-02-17 18:00:00,1.15,1.00,1.06,156,166,145,22,10,12,20,7,13,14,4,10,0,0,0,74%,73%,75%,108,108,108,17%,27%,13%,1,0,1,1,0,1
319,https://vlr.gg/player/44085/booey,2025-02-17 18:00:00,0.56,1.30,1.02,239,179,269,33,10,23,27,12,15,8,1,7,-2,-2,0,72%,67%,75%,144,106,167,22%,12%,27%,8,3,5,10,5,5
320,https://vlr.gg/player/41135/dantedeu5,2025-02-17 16:20:00,1.40,1.74,1.56,297,294,301,53,27,26,27,17,10,2,1,1,+8,0,+8,76%,71%,82%,182,200,163,37%,51%,23%,10,2,8,2,2,0
321,https://vlr.gg/player/36169/mta,2025-02-17 16:20:00,0.83,1.33,1.07,192,173,214,31,15,16,28,18,10,15,8,7,+1,+1,0,74%,71%,77%,137,115,161,28%,25%,30%,5,4,1,4,3,1
322,https://vlr.gg/player/33566/ganter,2025-02-17 16:20:00,1.00,1.08,1.04,178,171,186,32,16,16,28,16,12,11,6,5,-1,-4,+3,70%,67%,73%,126,137,113,30%,35%,25%,4,1,3,5,5,0
323,https://vlr.gg/player/15542/gio,2025-02-17 16:20:00,0.91,0.85,0.88,174,202,144,25,15,10,32,18,14,22,10,12,-4,-3,-1,74%,71%,77%,119,136,100,25%,27%,23%,2,0,2,6,3,3
324,https://vlr.gg/player/38857/beng,2025-02-17 16:20:00,0.37,1.05,0.70,158,102,219,25,7,18,35,20,15,24,14,10,0,0,0,72%,67%,77%,104,72,139,33%,32%,33%,4,2,2,4,2,2
325,https://vlr.gg/player/15916/jotinha,2025-02-17 16:20:00,0.86,1.44,1.16,217,174,257,33,12,21,33,16,17,17,3,14,0,0,0,67%,64%,71%,147,108,183,34%,41%,30%,4,1,3,4,1,3
326,https://vlr.gg/player/1291/bnj,2025-02-17 16:20:00,0.77,1.36,1.08,196,158,231,32,11,21,33,17,16,20,8,12,+1,0,+1,76%,64%,88%,124,106,141,26%,26%,25%,3,0,3,2,0,2
327,https://vlr.gg/player/2586/hanling,2025-02-17 16:20:00,0.58,1.38,1.00,179,150,207,26,11,15,30,17,13,25,7,18,-2,-3,+1,76%,64%,88%,121,111,130,25%,22%,27%,1,0,1,3,3,0
328,https://vlr.gg/player/2818/neto,2025-02-17 16:20:00,0.49,1.13,0.82,196,145,244,32,10,22,38,19,19,4,3,1,-4,-7,+3,65%,50%,79%,127,86,164,27%,28%,26%,9,3,6,13,10,3
329,https://vlr.gg/player/2403/mizu,2025-02-17 16:20:00,1.07,0.59,0.82,176,233,125,27,18,9,34,17,17,10,4,6,+1,0,+1,70%,68%,71%,116,148,86,44%,46%,41%,4,2,2,3,2,1
330,https://vlr.gg/player/13831/zeldris,2025-02-17 16:00:00,0.81,1.33,1.15,236,171,265,31,8,23,29,10,19,5,2,3,0,-1,+1,81%,85%,79%,152,121,168,26%,32%,23%,3,0,3,3,1,2
331,https://vlr.gg/player/26848/zeek,2025-02-17 16:00:00,0.90,1.14,1.05,206,182,217,26,9,17,30,11,19,17,1,16,-1,+1,-2,70%,62%,75%,128,117,133,33%,40%,30%,3,2,1,4,1,3
332,https://vlr.gg/player/873/bob,2025-02-17 16:00:00,0.83,0.79,0.80,186,187,196,23,8,15,30,10,20,7,1,6,-1,-2,+1,62%,46%,71%,133,140,129,27%,24%,29%,4,1,3,5,3,2
333,https://vlr.gg/player/25902/shondex,2025-02-17 16:00:00,0.74,0.74,0.74,179,183,186,23,8,15,32,11,21,4,2,2,-5,-2,-3,57%,54%,58%,133,130,135,39%,30%,44%,2,0,2,7,2,5
334,https://vlr.gg/player/11696/zoestol,2025-02-17 16:00:00,0.18,0.67,0.49,126,85,141,14,3,11,31,12,19,14,5,9,-6,-3,-3,62%,38%,75%,81,55,95,15%,16%,15%,0,0,0,6,3,3
335,https://vlr.gg/player/7716/penny,2025-02-17 16:00:00,1.44,1.61,1.50,312,306,300,43,28,15,21,15,6,6,4,2,+10,+6,+4,78%,71%,92%,168,170,164,16%,13%,22%,13,9,4,3,3,0
336,https://vlr.gg/player/733/stellar,2025-02-17 16:00:00,1.16,1.41,1.25,190,194,201,26,16,10,19,14,5,23,14,9,0,-1,+1,78%,67%,100%,119,124,109,25%,23%,29%,3,1,2,3,2,1
337,https://vlr.gg/player/8742/jakee,2025-02-17 16:00:00,1.00,1.66,1.23,232,198,287,31,17,14,24,17,7,20,12,8,+2,0,+2,81%,71%,100%,153,136,183,26%,32%,21%,4,2,2,2,2,0
338,https://vlr.gg/player/69/thief,2025-02-17 16:00:00,0.75,1.42,0.99,219,187,283,29,16,13,27,19,8,7,6,1,0,0,0,70%,67%,77%,138,121,168,23%,25%,20%,1,0,1,1,0,1
339,https://vlr.gg/player/739/fiziq,2025-02-17 16:00:00,1.10,0.53,0.90,187,230,98,23,21,2,26,16,10,16,7,9,+1,+1,0,78%,83%,69%,128,153,80,17%,21%,4%,4,3,1,3,2,1
340,https://vlr.gg/player/844/bdog,2025-02-17 16:00:00,1.38,1.08,1.25,232,257,208,53,32,21,41,22,19,16,9,7,0,-1,+1,71%,71%,71%,148,164,129,21%,20%,22%,7,2,5,7,3,4
341,https://vlr.gg/player/1856/wedid,2025-02-17 16:00:00,0.87,1.43,1.12,204,157,259,44,18,26,42,25,17,17,7,10,+3,+2,+1,76%,74%,79%,133,103,169,29%,24%,32%,8,5,3,5,3,2
342,https://vlr.gg/player/34400/bao,2025-02-17 16:00:00,1.22,1.00,1.12,207,229,182,47,29,18,41,22,19,15,9,6,-1,0,-1,69%,74%,64%,145,168,118,37%,36%,38%,2,2,0,3,2,1
343,https://vlr.gg/player/30470/kyu,2025-02-17 16:00:00,1.17,0.85,1.02,167,182,155,37,22,15,38,18,20,20,14,6,-2,-2,0,73%,74%,71%,110,118,100,31%,32%,29%,3,0,3,5,2,3
344,https://vlr.gg/player/8373/okeanos,2025-02-17 16:00:00,0.78,0.90,0.83,185,194,169,40,22,18,49,29,20,15,12,3,-4,-5,+1,69%,76%,61%,121,131,110,24%,22%,26%,9,5,4,13,10,3
345,https://vlr.gg/player/48025/alym,2025-02-17 16:00:00,1.17,1.06,1.11,241,281,209,52,28,24,44,21,23,8,2,6,+4,+1,+3,66%,68%,65%,156,175,141,36%,33%,39%,10,5,5,6,4,2
346,https://vlr.gg/player/9094/kess,2025-02-17 16:00:00,0.87,0.98,0.93,194,159,223,41,16,25,45,19,26,18,8,10,+6,+3,+3,73%,79%,68%,125,103,142,23%,23%,24%,7,3,4,1,0,1
347,https://vlr.gg/player/62/huynh,2025-02-17 16:00:00,0.82,0.84,0.83,173,182,166,41,19,22,45,21,24,15,6,9,-5,-3,-2,76%,79%,74%,106,113,101,21%,30%,17%,5,2,3,10,5,5
348,https://vlr.gg/player/10053/fireballops,2025-02-17 16:00:00,0.90,0.76,0.82,188,185,183,39,18,21,45,18,27,9,3,6,+1,+1,0,63%,64%,62%,121,125,118,23%,19%,28%,8,3,5,7,2,5
349,https://vlr.gg/player/862/b0i,2025-02-17 16:00:00,0.59,0.91,0.77,154,101,197,34,10,24,42,19,23,12,7,5,-2,-4,+2,68%,61%,74%,97,72,118,23%,28%,20%,3,0,3,5,4,1
350,https://vlr.gg/player/4807/bstrdd,2025-02-17 15:00:00,0.97,1.22,1.08,227,240,227,63,37,26,60,38,22,25,15,10,+5,+2,+3,70%,69%,71%,164,162,166,17%,15%,20%,19,13,6,14,11,3
351,https://vlr.gg/player/15297/joojina,2025-02-17 15:00:00,1.17,0.81,1.02,176,212,143,56,39,17,58,33,25,41,26,15,+3,+2,+1,65%,67%,63%,113,130,90,37%,41%,29%,10,4,6,7,2,5
352,https://vlr.gg/player/12143/bizerra,2025-02-17 15:00:00,0.99,1.02,1.00,194,197,199,62,36,26,61,36,25,16,10,6,-3,0,-3,68%,71%,63%,128,121,137,24%,21%,29%,2,1,1,5,1,4
353,https://vlr.gg/player/14386/isaa,2025-02-17 15:00:00,0.86,0.94,0.89,173,176,187,53,30,23,61,35,26,21,9,12,+1,-1,+2,67%,67%,66%,124,121,128,32%,33%,30%,8,4,4,7,5,2
354,https://vlr.gg/player/11232/daiki,2025-02-17 15:00:00,0.75,0.87,0.80,162,165,161,46,26,20,65,40,25,37,23,14,-4,-4,0,69%,71%,66%,109,109,109,33%,29%,39%,4,2,2,8,6,2
355,https://vlr.gg/player/11239/sayuri,2025-02-17 15:00:00,1.24,1.15,1.19,196,194,187,62,27,35,48,20,28,43,15,28,+2,-1,+3,76%,77%,76%,122,117,126,25%,29%,21%,5,0,5,3,1,2
356,https://vlr.gg/player/31574/srn,2025-02-17 15:00:00,1.08,1.26,1.18,256,228,249,71,28,43,57,25,32,18,8,10,-6,-3,-3,77%,80%,76%,170,175,167,24%,23%,24%,16,7,9,22,10,12
357,https://vlr.gg/player/19791/mel,2025-02-17 15:00:00,1.32,1.08,1.18,233,270,212,67,33,34,58,24,34,33,11,22,+4,0,+4,76%,80%,73%,154,177,138,24%,30%,19%,13,6,7,9,6,3
358,https://vlr.gg/player/21435/jelly,2025-02-17 15:00:00,0.92,1.09,1.01,188,148,220,58,19,39,58,21,37,32,12,20,0,+1,-1,71%,69%,73%,134,100,159,36%,38%,35%,3,2,1,3,1,2
359,https://vlr.gg/player/14685/jubs,2025-02-17 15:00:00,0.77,0.80,0.79,161,121,178,46,15,31,59,22,37,19,9,10,-2,0,-2,73%,74%,71%,101,84,114,30%,22%,33%,4,1,3,6,1,5
360,https://vlr.gg/player/29241/miradaninja,2025-02-17 14:00:00,1.08,1.42,1.23,233,201,264,37,18,19,26,15,11,7,5,2,-1,-1,0,71%,67%,78%,151,130,180,31%,29%,32%,2,1,1,3,2,1
361,https://vlr.gg/player/21251/blowz,2025-02-17 14:00:00,1.04,1.30,1.15,190,162,233,29,13,16,24,13,11,14,9,5,0,0,0,76%,79%,72%,134,124,148,33%,32%,34%,1,0,1,1,0,1
362,https://vlr.gg/player/29242/erde,2025-02-17 14:00:00,1.12,1.05,1.09,193,199,181,30,17,13,25,13,12,13,11,2,-1,-2,+1,76%,79%,72%,136,137,135,24%,27%,21%,2,0,2,3,2,1
363,https://vlr.gg/player/42867/ghoul33,2025-02-17 14:00:00,1.25,0.67,1.00,238,279,181,34,24,10,31,17,14,9,3,6,-1,+3,-4,55%,58%,50%,156,180,123,23%,23%,23%,9,8,1,10,5,5
364,https://vlr.gg/player/29243/neon,2025-02-17 14:00:00,0.69,0.98,0.82,141,114,183,21,10,11,27,14,13,12,3,9,-3,-4,+1,71%,58%,89%,96,85,111,27%,20%,43%,4,1,3,7,5,2
365,https://vlr.gg/player/3828/tacolilla,2025-02-17 14:00:00,0.96,1.29,1.15,248,239,248,36,14,22,33,16,17,5,4,1,+5,0,+5,67%,56%,75%,163,184,147,20%,26%,15%,11,4,7,6,4,2
366,https://vlr.gg/player/29244/mikey-tap,2025-02-17 14:00:00,1.29,0.90,1.07,196,245,160,31,17,14,28,12,16,9,6,3,-1,-2,+1,64%,72%,58%,132,158,112,39%,53%,29%,2,1,1,3,3,0
367,https://vlr.gg/player/2464/suther,2025-02-17 14:00:00,1.01,1.09,1.06,187,206,174,25,12,13,28,13,15,15,6,9,+1,+2,-1,71%,78%,67%,131,135,128,26%,20%,32%,5,2,3,4,0,4
368,https://vlr.gg/player/2468/delz1k,2025-02-17 14:00:00,1.08,0.72,0.87,171,238,132,23,14,9,33,15,18,26,12,14,+4,+3,+1,74%,83%,67%,106,146,75,26%,23%,30%,5,3,2,1,0,1
369,https://vlr.gg/player/1294/nagz,2025-02-17 14:00:00,0.46,0.86,0.67,135,67,180,18,4,14,29,13,16,6,2,4,-3,-1,-2,62%,56%,67%,97,50,132,19%,16%,20%,1,0,1,4,1,3
370,https://vlr.gg/player/24140/superphrog,2025-02-17 13:55:00,0.59,1.43,0.87,221,164,342,28,14,14,29,21,8,3,1,2,-3,-6,+3,53%,42%,75%,130,99,194,32%,29%,36%,9,3,6,12,9,3
371,https://vlr.gg/player/40175/mayameow,2025-02-17 13:55:00,0.62,0.98,0.74,157,142,188,17,9,8,27,20,7,17,13,4,-2,-2,0,75%,67%,92%,108,94,135,24%,18%,33%,1,1,0,3,3,0
372,https://vlr.gg/player/30060/alessia,2025-02-17 13:55:00,0.65,0.90,0.73,150,151,151,18,11,7,29,20,9,11,8,3,-1,-2,+1,64%,63%,67%,102,112,80,31%,28%,39%,2,1,1,3,3,0
373,https://vlr.gg/player/29960/nidxvilco,2025-02-17 13:55:00,0.48,0.99,0.65,137,107,193,17,9,8,28,20,8,13,7,6,0,+1,-1,75%,71%,83%,84,58,136,27%,23%,32%,1,1,0,1,0,1
374,https://vlr.gg/player/30105/ikyoo,2025-02-17 13:55:00,0.59,0.59,0.59,150,155,132,17,11,6,31,22,9,4,3,1,+2,+3,-1,58%,58%,58%,105,112,91,37%,38%,35%,3,3,0,1,0,1
375,https://vlr.gg/player/46311/mimier,2025-02-17 13:55:00,1.20,1.58,1.46,304,208,345,40,10,30,25,8,17,10,4,6,-4,-2,-2,72%,58%,79%,197,139,226,30%,33%,29%,4,1,3,8,3,5
376,https://vlr.gg/player/47911/berryx,2025-02-17 13:55:00,0.41,1.83,1.36,240,140,291,32,5,27,18,11,7,12,3,9,+2,-3,+5,81%,50%,96%,160,109,185,27%,33%,24%,6,0,6,4,3,1
377,https://vlr.gg/player/17326/htm,2025-02-17 13:55:00,1.42,1.11,1.22,184,267,146,26,12,14,18,8,10,8,1,7,0,+1,-1,81%,83%,79%,120,153,104,25%,29%,23%,2,1,1,2,0,2
378,https://vlr.gg/player/29442/wens,2025-02-17 13:55:00,1.13,1.27,1.22,208,176,223,27,8,19,19,8,11,11,5,6,+2,+1,+1,72%,67%,75%,137,102,154,48%,31%,56%,4,2,2,2,1,1
379,https://vlr.gg/player/17408/lateu,2025-02-17 13:55:00,0.83,1.23,1.09,153,140,161,19,6,13,17,8,9,16,4,12,+4,+1,+3,78%,58%,88%,109,95,116,26%,31%,24%,4,1,3,0,0,0
380,https://vlr.gg/player/17331/pinkalie,2025-02-17 12:55:00,0.89,1.16,1.01,171,161,187,28,14,14,31,18,13,19,7,12,-3,-2,-1,79%,78%,80%,115,102,130,27%,28%,27%,0,0,0,3,2,1
381,https://vlr.gg/player/43744/akita,2025-02-17 12:55:00,0.66,1.05,0.84,217,183,259,31,12,19,38,22,16,7,4,3,-2,-2,0,58%,48%,70%,150,125,178,28%,33%,25%,8,6,2,10,8,2
382,https://vlr.gg/player/38142/dream,2025-02-17 12:55:00,0.82,0.84,0.83,198,191,214,31,16,15,36,19,17,10,5,5,+3,+2,+1,70%,70%,70%,124,111,139,29%,28%,31%,5,2,3,2,0,2
383,https://vlr.gg/player/16078/loupiote,2025-02-17 12:55:00,0.38,1.15,0.74,164,100,238,24,6,18,35,21,14,10,7,3,+2,+1,+1,56%,43%,70%,99,66,137,34%,29%,37%,6,2,4,4,1,3
384,https://vlr.gg/player/41197/thuy,2025-02-17 12:55:00,0.71,0.67,0.69,148,154,141,21,11,10,35,20,15,11,4,7,-3,0,-3,56%,48%,65%,101,108,92,22%,27%,18%,1,1,0,4,1,3
385,https://vlr.gg/player/17343/ness,2025-02-17 12:55:00,1.58,1.71,1.65,283,338,246,43,22,21,24,14,10,33,11,22,+2,+1,+1,93%,95%,91%,191,210,175,48%,43%,53%,3,1,2,1,0,1
386,https://vlr.gg/player/19371/eva,2025-02-17 12:55:00,1.18,1.59,1.40,265,213,308,43,17,26,25,14,11,12,5,7,0,+1,-1,88%,80%,96%,162,135,187,23%,28%,21%,2,2,0,2,1,1
387,https://vlr.gg/player/16418/smurfette,2025-02-17 12:55:00,0.72,1.23,0.99,237,172,286,35,12,23,32,17,15,8,3,5,+1,-1,+2,70%,65%,74%,150,114,181,30%,29%,32%,11,3,8,10,4,6
388,https://vlr.gg/player/30186/nami,2025-02-17 12:55:00,0.76,1.20,0.99,187,178,194,28,12,16,27,17,10,16,5,11,+1,+1,0,81%,80%,83%,107,107,107,43%,56%,34%,4,3,1,3,2,1
389,https://vlr.gg/player/24107/sarah,2025-02-17 12:55:00,0.93,1.00,0.97,180,168,193,26,12,14,27,14,13,8,3,5,-1,0,-1,72%,60%,83%,130,124,135,35%,52%,25%,3,2,1,4,2,2
390,https://vlr.gg/player/1524/h1ber,2025-02-17 12:00:00,1.10,1.32,1.21,247,241,259,87,41,46,72,40,32,45,17,28,-1,+1,-2,81%,80%,83%,172,158,186,36%,36%,36%,12,8,4,13,7,6
391,https://vlr.gg/player/18162/serial,2025-02-17 12:00:00,0.99,1.40,1.20,246,205,282,92,35,57,69,37,32,21,13,8,+2,0,+2,76%,67%,85%,166,147,184,46%,37%,55%,8,3,5,6,3,3
392,https://vlr.gg/player/16209/famsii,2025-02-17 12:00:00,0.75,1.42,1.10,210,146,274,78,26,52,69,36,33,26,12,14,-2,-4,+2,76%,65%,87%,142,107,176,31%,36%,29%,6,1,5,8,5,3
393,https://vlr.gg/player/29972/michel,2025-02-17 12:00:00,0.93,1.03,0.98,208,212,203,80,40,40,76,42,34,16,7,9,-1,+2,-3,68%,71%,65%,132,136,129,39%,41%,37%,14,8,6,15,6,9
394,https://vlr.gg/player/8805/sacake,2025-02-17 12:00:00,1.06,0.85,0.95,182,221,137,59,38,21,71,38,33,60,19,41,-1,+2,-3,70%,73%,67%,115,145,86,28%,31%,24%,9,5,4,10,3,7
395,https://vlr.gg/player/5199/guardy,2025-02-17 12:00:00,0.84,1.32,1.08,238,177,303,82,32,50,84,43,41,52,22,30,-3,-3,0,73%,71%,76%,163,125,204,36%,28%,43%,7,3,4,10,6,4
396,https://vlr.gg/player/8502/olizera,2025-02-17 12:00:00,0.87,1.19,1.03,226,200,257,79,36,43,78,43,35,22,5,17,+10,+7,+3,64%,60%,69%,146,129,163,19%,20%,18%,18,11,7,8,4,4
397,https://vlr.gg/player/38424/zachkappa,2025-02-17 12:00:00,0.92,1.09,1.00,193,194,197,75,37,38,76,42,34,19,9,10,-3,-1,-2,72%,73%,71%,128,127,129,26%,24%,29%,13,8,5,16,9,7
398,https://vlr.gg/player/3127/monsteerr,2025-02-17 12:00:00,1.00,0.87,0.94,186,185,189,65,34,31,78,41,37,45,26,19,-1,+1,-2,74%,71%,78%,124,118,129,25%,32%,20%,6,3,3,7,2,5
399,https://vlr.gg/player/22154/pika,2025-02-17 12:00:00,0.63,0.93,0.78,171,165,183,56,25,31,81,47,34,34,21,13,0,0,0,72%,73%,71%,119,119,119,36%,33%,39%,8,3,5,8,3,5
400,https://vlr.gg/player/26632/joliinaa,2025-02-17 11:00:00,1.03,1.17,1.10,254,243,264,52,24,28,47,24,23,9,6,3,+12,+4,+8,78%,86%,71%,157,154,160,20%,28%,13%,16,6,10,4,2,2
401,https://vlr.gg/player/20116/jademwah,2025-02-17 11:00:00,0.93,1.06,1.00,179,170,188,39,17,22,39,20,19,21,13,8,+1,0,+1,63%,68%,58%,117,112,120,34%,36%,32%,3,1,2,2,1,1
402,https://vlr.gg/player/39506/cabbit,2025-02-17 11:00:00,0.94,0.85,0.89,169,225,126,36,23,13,41,22,19,21,5,16,-5,-2,-3,71%,79%,65%,116,148,87,17%,20%,14%,3,3,0,8,5,3
403,https://vlr.gg/player/45174/purity,2025-02-17 11:00:00,0.93,0.82,0.87,194,217,177,36,18,18,44,22,22,22,13,9,+1,0,+1,68%,68%,68%,132,139,125,22%,22%,22%,7,4,3,6,4,2
404,https://vlr.gg/player/20058/devilasxa,2025-02-17 11:00:00,0.82,0.57,0.69,142,145,143,28,15,13,44,19,25,14,3,11,-2,0,-2,64%,68%,61%,98,103,93,31%,46%,20%,4,1,3,6,1,5
405,https://vlr.gg/player/17323/mimi,2025-02-17 11:00:00,1.51,1.30,1.41,261,270,247,55,30,25,35,16,19,30,17,13,+1,+1,0,88%,84%,93%,154,158,149,39%,38%,41%,6,3,3,5,2,3
406,https://vlr.gg/player/20064/vania,2025-02-17 11:00:00,1.25,1.31,1.28,259,251,270,54,27,27,39,20,19,7,3,4,+2,-1,+3,71%,68%,75%,169,165,175,27%,31%,24%,12,6,6,10,7,3
407,https://vlr.gg/player/16321/nelo,2025-02-17 11:00:00,1.02,0.99,1.01,174,163,184,39,18,21,41,19,22,31,15,16,-1,+1,-2,78%,77%,79%,113,112,113,32%,33%,31%,3,2,1,4,1,3
408,https://vlr.gg/player/17320/petra,2025-02-17 11:00:00,1.11,0.87,0.99,160,175,145,36,20,16,36,18,18,16,7,9,-2,0,-2,78%,81%,75%,109,120,97,39%,36%,43%,1,1,0,3,1,2
409,https://vlr.gg/player/24149/amy,2025-02-17 11:00:00,0.57,1.00,0.78,151,101,204,31,13,18,40,21,19,13,4,9,-7,-6,-1,63%,52%,75%,101,72,133,25%,19%,29%,4,1,3,11,7,4
410,https://vlr.gg/player/31272/els,2025-02-17 11:00:00,0.44,1.14,0.88,180,81,241,22,4,18,29,11,18,10,1,9,-5,-4,-1,57%,46%,63%,126,66,159,35%,21%,40%,1,0,1,6,4,2
411,https://vlr.gg/player/17394/ninou,2025-02-17 11:00:00,1.16,0.61,0.80,174,257,138,23,11,12,28,11,17,15,5,10,+2,+1,+1,70%,69%,71%,108,155,82,29%,29%,29%,3,1,2,1,0,1
412,https://vlr.gg/player/20098/mel,2025-02-17 11:00:00,0.35,0.98,0.76,148,94,182,19,4,15,31,12,19,13,5,8,0,0,0,68%,62%,71%,101,55,126,26%,25%,27%,2,0,2,2,0,2
413,https://vlr.gg/player/41196/ja2,2025-02-17 11:00:00,0.33,0.81,0.64,142,143,146,18,6,12,28,13,15,4,1,3,-7,-5,-2,59%,54%,63%,87,87,87,19%,15%,24%,3,1,2,10,6,4
414,https://vlr.gg/player/24071/liza,2025-02-17 11:00:00,0.37,0.50,0.45,113,104,126,13,4,9,30,12,18,10,1,9,-5,-1,-4,49%,46%,50%,86,68,96,30%,20%,36%,2,0,2,7,1,6
415,https://vlr.gg/player/39057/safiaa,2025-02-17 11:00:00,1.10,2.08,1.44,239,194,356,35,18,17,19,14,5,13,5,8,+2,0,+2,76%,67%,92%,162,129,224,33%,34%,31%,4,2,2,2,2,0
416,https://vlr.gg/player/11183/glance,2025-02-17 11:00:00,1.38,1.52,1.43,205,217,207,29,18,11,14,10,4,7,5,2,+5,+3,+2,84%,79%,92%,140,143,136,21%,16%,38%,5,3,2,0,0,0
417,https://vlr.gg/player/23049/alkyia,2025-02-17 11:00:00,1.26,1.33,1.29,261,270,223,34,24,10,21,14,7,10,4,6,+2,+1,+1,76%,71%,85%,155,167,133,19%,17%,22%,9,7,2,7,6,1
418,https://vlr.gg/player/22792/jiex,2025-02-17 11:00:00,1.12,1.27,1.17,200,184,206,25,15,10,20,14,6,24,15,9,+3,0,+3,84%,83%,85%,114,109,122,29%,35%,23%,4,1,3,1,1,0
419,https://vlr.gg/player/38133/anesilia,2025-02-17 11:00:00,0.97,1.36,1.11,183,148,242,23,12,11,21,14,7,22,10,12,+3,+2,+1,73%,63%,92%,126,113,150,19%,16%,23%,4,2,2,1,0,1
420,https://vlr.gg/player/40591/comeback,2025-02-17 10:00:00,1.25,1.24,1.25,268,268,255,98,51,47,64,31,33,14,4,10,+13,+6,+7,72%,75%,70%,161,158,164,20%,23%,17%,23,13,10,10,7,3
421,https://vlr.gg/player/31305/lar0k,2025-02-17 10:00:00,1.11,1.29,1.20,207,172,252,75,33,42,67,29,38,45,19,26,-2,-1,-1,70%,67%,74%,152,127,176,32%,33%,31%,6,2,4,8,3,5
422,https://vlr.gg/player/24344/loita,2025-02-17 10:00:00,0.86,0.93,0.90,185,184,179,64,31,33,74,35,39,34,20,14,-6,-1,-5,72%,76%,68%,117,115,120,37%,33%,41%,6,3,3,12,4,8
423,https://vlr.gg/player/5565/ros,2025-02-17 10:00:00,1.03,0.76,0.89,172,190,164,66,36,30,71,31,40,23,14,9,-7,-2,-5,68%,75%,62%,111,121,103,26%,28%,25%,9,5,4,16,7,9
424,https://vlr.gg/player/12795/crewen,2025-02-17 10:00:00,0.95,0.80,0.88,169,202,140,62,36,26,74,37,37,26,13,13,0,+1,-1,65%,75%,57%,110,123,97,33%,39%,27%,7,4,3,7,3,4
425,https://vlr.gg/player/8041/brave,2025-02-17 10:00:00,1.22,0.84,1.03,202,213,201,74,39,35,77,33,44,55,39,16,+2,+1,+1,68%,77%,59%,137,130,145,38%,37%,40%,9,2,7,7,1,6
426,https://vlr.gg/player/12774/anima,2025-02-17 10:00:00,1.17,0.86,1.02,161,176,143,63,38,25,62,29,33,20,10,10,+1,+2,-1,71%,77%,65%,108,122,94,33%,32%,35%,6,3,3,5,1,4
427,https://vlr.gg/player/10161/qutionerx,2025-02-17 10:00:00,0.97,0.94,0.95,211,215,204,76,39,37,80,40,40,17,10,7,+4,+5,-1,67%,70%,65%,134,145,123,29%,27%,32%,20,12,8,16,7,9
428,https://vlr.gg/player/10163/cyderx,2025-02-17 10:00:00,0.82,1.06,0.94,179,178,181,65,34,31,70,38,32,23,11,12,-7,-3,-4,67%,70%,65%,123,120,125,29%,28%,30%,2,2,0,9,5,4
429,https://vlr.gg/player/10160/izzy,2025-02-17 10:00:00,0.86,0.99,0.92,196,197,207,72,37,35,76,38,38,20,12,8,+2,0,+2,63%,62%,65%,132,128,136,31%,36%,27%,16,10,6,14,10,4
430,https://vlr.gg/player/4545/sayaplayer,2025-02-17 03:00:00,1.23,1.20,1.22,250,263,238,82,44,38,66,37,29,19,9,10,+5,-1,+6,76%,75%,78%,161,166,156,21%,21%,22%,18,9,9,13,10,3
431,https://vlr.gg/player/17169/muto,2025-02-17 03:00:00,1.18,1.02,1.10,215,213,221,74,38,36,64,30,34,16,9,7,+2,+2,0,75%,77%,73%,150,148,152,27%,32%,22%,7,3,4,5,1,4
432,https://vlr.gg/player/25915/brian,2025-02-17 03:00:00,0.89,0.98,0.93,197,182,219,62,28,34,72,35,37,40,25,15,-6,-7,+1,74%,75%,73%,133,124,143,29%,27%,30%,4,1,3,10,8,2
433,https://vlr.gg/player/1963/hate,2025-02-17 03:00:00,0.87,0.98,0.92,179,179,179,61,32,29,65,36,29,22,10,12,-5,-4,-1,66%,63%,69%,121,116,127,35%,41%,30%,5,1,4,10,5,5
434,https://vlr.gg/player/31841/take,2025-02-17 03:00:00,0.84,0.96,0.90,150,135,169,51,23,28,63,33,30,29,17,12,-3,-6,+3,74%,69%,80%,100,92,108,25%,31%,21%,9,2,7,12,8,4
435,https://vlr.gg/player/34785/yowamu,2025-02-17 03:00:00,0.91,1.44,1.18,241,184,287,79,29,50,65,33,32,23,11,12,+7,-1,+8,75%,71%,79%,162,122,200,26%,26%,25%,17,6,11,10,7,3
436,https://vlr.gg/player/1960/eko,2025-02-17 03:00:00,1.10,1.03,1.06,257,285,230,78,42,36,71,37,34,22,7,15,+6,+1,+5,68%,60%,75%,163,173,154,20%,18%,21%,18,8,10,12,7,5
437,https://vlr.gg/player/1952/esperanza,2025-02-17 03:00:00,1.11,0.87,0.99,202,218,192,64,33,31,65,31,34,26,16,10,-1,-7,+6,75%,76%,75%,135,143,127,39%,37%,40%,10,1,9,11,8,3
438,https://vlr.gg/player/6676/thiefy,2025-02-17 03:00:00,0.81,1.13,0.98,185,161,209,57,23,34,65,34,31,45,20,25,+1,0,+1,77%,78%,77%,125,104,144,24%,25%,23%,2,1,1,1,1,0
439,https://vlr.gg/player/7888/blackwiz,2025-02-17 03:00:00,0.95,0.62,0.78,146,172,128,49,29,20,65,30,35,49,21,28,-6,-2,-4,76%,80%,73%,93,103,83,22%,25%,19%,3,2,1,9,4,5
440,https://vlr.gg/player/8056/mited,2025-02-16 19:45:00,1.50,1.35,1.41,227,173,245,33,12,21,18,6,12,10,3,7,0,0,0,78%,69%,83%,137,103,159,19%,17%,21%,3,1,2,3,1,2
441,https://vlr.gg/player/3983/virtyy,2025-02-16 19:45:00,1.09,1.47,1.32,281,260,291,40,15,25,27,13,14,6,3,3,+3,+1,+2,70%,69%,71%,167,156,174,14%,22%,9%,10,4,6,7,3,4
442,https://vlr.gg/player/10557/darker,2025-02-16 19:45:00,1.02,1.35,1.22,218,164,248,33,11,22,21,10,11,16,5,11,+2,-1,+3,80%,56%,96%,142,126,153,31%,42%,26%,3,0,3,1,1,0
443,https://vlr.gg/player/7616/feniz,2025-02-16 19:45:00,0.98,1.17,1.09,220,204,212,29,10,19,23,12,11,14,7,7,0,-1,+1,75%,69%,79%,136,129,141,20%,24%,18%,2,0,2,2,1,1
444,https://vlr.gg/player/9354/cebando,2025-02-16 19:45:00,1.01,0.91,0.95,162,203,154,23,10,13,23,11,12,14,6,8,-3,-1,-2,75%,75%,75%,112,134,97,27%,32%,23%,3,2,1,6,3,3
445,https://vlr.gg/player/31476/mephisto,2025-02-16 19:45:00,1.34,1.47,1.39,293,287,317,40,22,18,31,19,12,12,9,3,+4,+1,+3,68%,67%,69%,196,194,198,22%,28%,14%,13,7,6,9,6,3
446,https://vlr.gg/player/15931/peloncito,2025-02-16 19:45:00,0.73,1.03,0.85,182,165,218,27,14,13,32,21,11,11,7,4,0,0,0,68%,58%,81%,122,105,149,28%,20%,39%,2,1,1,2,1,1
447,https://vlr.gg/player/10581/ryu,2025-02-16 19:45:00,0.44,1.08,0.70,106,56,215,15,4,11,30,18,12,16,10,6,-2,-4,+2,60%,50%,75%,69,32,124,24%,33%,22%,2,0,2,4,4,0
448,https://vlr.gg/player/26757/otaq,2025-02-16 19:45:00,0.75,0.28,0.56,149,190,75,17,13,4,34,22,12,9,7,2,-1,0,-1,58%,63%,50%,102,130,58,24%,20%,35%,1,1,0,2,1,1
449,https://vlr.gg/player/10718/rowancy,2025-02-16 19:45:00,0.36,0.46,0.40,101,97,104,13,7,6,31,20,11,3,0,3,-3,-1,-2,45%,33%,63%,62,64,60,23%,29%,15%,1,1,0,4,2,2
450,https://vlr.gg/player/10556/drakk,2025-02-16 17:00:00,1.66,1.04,1.42,304,366,199,41,31,10,27,17,10,10,4,6,+3,+5,-2,72%,83%,53%,197,240,129,26%,30%,15%,6,5,1,3,0,3
451,https://vlr.gg/player/2753/bandicoot,2025-02-16 17:00:00,1.34,1.51,1.41,206,207,224,32,19,13,18,11,7,9,6,3,+1,0,+1,82%,83%,80%,151,146,160,35%,38%,32%,2,0,2,1,0,1
452,https://vlr.gg/player/39538/bull3tz,2025-02-16 17:00:00,1.31,1.46,1.37,281,262,267,35,21,14,23,15,8,14,10,4,+3,+3,0,74%,79%,67%,171,163,182,29%,36%,20%,7,6,1,4,3,1
453,https://vlr.gg/player/7618/theory,2025-02-16 17:00:00,0.85,0.75,0.81,188,199,153,27,19,8,28,17,11,3,0,3,-1,-2,+1,69%,67%,73%,126,138,107,40%,38%,43%,3,1,2,4,3,1
454,https://vlr.gg/player/35583/edu,2025-02-16 17:00:00,0.53,1.18,0.78,158,131,195,22,12,10,26,18,8,9,4,5,-1,-2,+1,74%,71%,80%,97,83,118,42%,61%,30%,4,2,2,5,4,1
455,https://vlr.gg/player/8790/mininiwde,2025-02-16 17:00:00,0.76,1.53,1.24,244,149,304,33,8,25,28,10,18,13,5,8,+2,0,+2,74%,67%,79%,162,106,197,27%,33%,26%,3,1,2,1,1,0
456,https://vlr.gg/player/17694/prask,2025-02-16 17:00:00,0.56,1.38,1.06,232,103,299,31,6,25,33,12,21,4,2,2,+1,-2,+3,72%,73%,71%,145,69,193,30%,33%,30%,4,1,3,3,3,0
457,https://vlr.gg/player/36405/jrmzie,2025-02-16 17:00:00,1.32,0.65,0.91,203,286,152,28,15,13,30,11,19,6,3,3,-4,-1,-3,72%,87%,63%,135,189,102,39%,44%,34%,3,1,2,7,2,5
458,https://vlr.gg/player/8792/xhowi,2025-02-16 17:00:00,0.66,0.52,0.57,156,168,152,18,7,11,34,11,23,10,2,8,-1,+2,-3,56%,60%,54%,110,115,106,25%,26%,24%,5,3,2,6,1,5
459,https://vlr.gg/player/2497/dobsha,2025-02-16 17:00:00,0.85,0.10,0.37,96,148,65,12,8,4,32,11,21,14,8,6,-3,0,-3,64%,73%,58%,64,101,41,30%,47%,14%,2,1,1,5,1,4
460,https://vlr.gg/player/8329/starbound,2025-02-16 17:00:00,1.19,1.60,1.39,242,229,268,75,37,38,48,30,18,12,6,6,+13,+3,+10,77%,74%,80%,155,140,170,18%,12%,21%,19,7,12,6,4,2
461,https://vlr.gg/player/38583/sleepyaria,2025-02-16 17:00:00,0.84,1.26,1.05,266,227,279,70,30,40,64,36,28,15,7,8,+3,0,+3,67%,62%,73%,150,138,162,13%,12%,15%,13,6,7,10,6,4
462,https://vlr.gg/player/15039/australis,2025-02-16 17:00:00,1.09,0.89,0.99,191,218,169,57,33,24,58,30,28,19,13,6,+3,+4,-1,72%,69%,75%,118,130,105,29%,27%,33%,7,6,1,4,2,2
463,https://vlr.gg/player/24237/powerpixele,2025-02-16 17:00:00,0.67,1.22,0.94,181,156,225,53,19,34,56,33,23,27,17,10,-1,-1,0,68%,64%,73%,136,106,167,19%,14%,23%,7,4,3,8,5,3
464,https://vlr.gg/player/15016/joona,2025-02-16 17:00:00,0.88,0.77,0.83,153,160,164,47,25,22,57,29,28,41,22,19,-4,-2,-2,67%,64%,70%,102,96,108,29%,29%,30%,2,0,2,6,2,4
465,https://vlr.gg/player/11968/l4ce,2025-02-16 17:00:00,1.01,1.29,1.16,217,205,250,65,28,37,56,30,26,29,12,17,+7,+2,+5,76%,68%,83%,155,153,156,35%,30%,39%,9,4,5,2,2,0
466,https://vlr.gg/player/873/bob,2025-02-16 17:00:00,1.01,1.19,1.10,265,254,267,71,34,37,66,34,32,22,8,14,-7,-6,-1,71%,60%,81%,176,160,192,20%,25%,17%,10,5,5,17,11,6
467,https://vlr.gg/player/27884/unstable,2025-02-16 17:00:00,0.72,1.10,0.92,184,161,186,52,23,29,57,32,25,19,4,15,-5,-3,-2,66%,60%,71%,108,106,110,37%,44%,32%,7,3,4,12,6,6
468,https://vlr.gg/player/14868/karra,2025-02-16 17:00:00,0.78,1.01,0.90,169,147,202,49,20,29,59,30,29,34,18,16,-6,-1,-5,73%,70%,76%,112,93,131,30%,25%,34%,5,2,3,11,3,8
469,https://vlr.gg/player/8849/sonder,2025-02-16 17:00:00,0.69,0.92,0.81,175,160,192,46,20,26,64,32,32,41,15,26,-3,-2,-1,68%,63%,74%,117,110,123,22%,26%,20%,3,1,2,6,3,3
470,https://vlr.gg/player/31574/srn,2025-02-16 15:00:00,1.71,1.36,1.56,360,422,266,66,45,21,40,24,16,16,9,7,+6,+4,+2,79%,78%,79%,218,252,174,30%,33%,27%,18,13,5,12,9,3
471,https://vlr.gg/player/11239/sayuri,2025-02-16 15:00:00,1.51,1.14,1.35,196,197,192,41,24,17,27,13,14,43,28,15,+3,0,+3,88%,84%,92%,119,125,112,25%,21%,29%,3,0,3,0,0,0
472,https://vlr.gg/player/19791/mel,2025-02-16 15:00:00,1.31,1.34,1.32,212,207,227,43,24,19,30,16,14,33,19,14,+2,0,+2,89%,94%,83%,148,140,158,30%,34%,25%,3,1,2,1,1,0
473,https://vlr.gg/player/14685/jubs,2025-02-16 15:00:00,1.03,1.23,1.11,188,159,235,41,20,21,32,16,16,8,6,2,+1,0,+1,75%,75%,75%,128,107,157,29%,33%,26%,6,3,3,5,3,2
474,https://vlr.gg/player/21435/jelly,2025-02-16 15:00:00,0.95,1.06,1.00,198,202,196,41,24,17,37,22,15,20,12,8,0,0,0,71%,72%,71%,127,134,117,27%,27%,27%,4,1,3,4,1,3
475,https://vlr.gg/player/14690/lissa,2025-02-16 15:00:00,0.91,1.24,1.10,246,218,267,52,19,33,46,20,26,17,10,7,0,-2,+2,80%,75%,84%,159,141,172,44%,34%,52%,3,0,3,3,2,1
476,https://vlr.gg/player/9821/m4ndzin,2025-02-16 15:00:00,1.15,1.03,1.08,238,258,231,44,20,24,47,19,28,26,15,11,-4,-3,-1,70%,79%,63%,153,170,140,22%,19%,26%,5,1,4,9,4,5
477,https://vlr.gg/player/42397/winter,2025-02-16 15:00:00,0.66,0.54,0.58,139,176,117,26,15,11,48,21,27,12,4,8,-9,-4,-5,57%,46%,66%,98,108,91,20%,23%,17%,4,4,0,13,8,5
478,https://vlr.gg/player/6994/shyz,2025-02-16 15:00:00,0.74,0.38,0.53,100,113,93,18,9,9,43,16,27,13,5,8,0,0,0,57%,67%,50%,67,76,60,15%,16%,14%,5,2,3,5,2,3
479,https://vlr.gg/player/2245/krysme,2025-02-16 15:00:00,0.57,0.47,0.51,135,120,144,26,12,14,48,19,29,7,0,7,+1,+1,0,59%,50%,66%,87,75,96,22%,19%,23%,5,1,4,4,0,4
480,https://vlr.gg/player/43744/akita,2025-02-16 13:15:00,1.41,1.24,1.32,294,306,278,72,35,37,50,22,28,7,3,4,+9,+8,+1,74%,75%,74%,191,200,184,32%,37%,28%,18,10,8,9,2,7
481,https://vlr.gg/player/38142/dream,2025-02-16 13:15:00,1.12,1.26,1.19,237,218,251,60,26,34,46,21,25,17,8,9,+1,0,+1,73%,69%,76%,153,140,164,22%,27%,19%,6,3,3,5,3,2
482,https://vlr.gg/player/17331/pinkalie,2025-02-16 13:15:00,0.86,1.29,1.10,169,129,209,40,13,27,43,18,25,49,21,28,-2,-1,-1,79%,75%,82%,108,83,129,29%,31%,27%,3,1,2,5,2,3
483,https://vlr.gg/player/41197/thuy,2025-02-16 13:15:00,1.10,0.96,1.03,220,213,207,50,23,27,48,21,27,33,17,16,+1,-3,+4,79%,78%,79%,126,132,120,21%,21%,20%,7,1,6,6,4,2
484,https://vlr.gg/player/16078/loupiote,2025-02-16 13:15:00,0.85,0.86,0.86,140,120,152,33,13,20,42,17,25,13,5,8,-1,+2,-3,74%,72%,76%,97,81,111,31%,24%,36%,5,4,1,6,2,4
485,https://vlr.gg/player/24101/miyori,2025-02-16 13:15:00,1.36,0.85,1.13,223,292,166,61,42,19,49,27,22,10,6,4,-1,-1,0,64%,66%,63%,147,173,117,26%,23%,32%,8,4,4,9,5,4
486,https://vlr.gg/player/30107/fluxxy,2025-02-16 13:15:00,0.88,1.01,0.92,192,182,205,44,22,22,51,30,21,34,23,11,+2,+3,-1,76%,76%,75%,129,129,130,29%,23%,38%,4,3,1,2,0,2
487,https://vlr.gg/player/37990/adora,2025-02-16 13:15:00,0.98,0.75,0.88,226,244,215,54,32,22,60,32,28,6,4,2,0,+1,-1,59%,63%,53%,149,164,131,33%,35%,30%,13,8,5,13,7,6
488,https://vlr.gg/player/19362/lyda,2025-02-16 13:15:00,0.64,0.99,0.80,148,137,165,37,18,19,47,29,18,15,8,7,-7,-5,-2,66%,61%,72%,99,91,108,29%,24%,34%,4,2,2,11,7,4
489,https://vlr.gg/player/9431/cille,2025-02-16 13:15:00,0.54,0.89,0.70,132,107,154,33,16,17,48,27,21,10,5,5,-2,0,-2,57%,58%,56%,81,61,105,29%,24%,33%,2,1,1,4,1,3
490,https://vlr.gg/player/36748/czester,2025-02-16 12:00:00,1.11,1.06,1.09,231,226,225,93,47,46,87,43,44,51,27,24,+9,+7,+2,77%,79%,75%,146,145,147,35%,33%,36%,22,12,10,13,5,8
491,https://vlr.gg/player/10448/kozok,2025-02-16 12:00:00,1.03,1.13,1.08,178,181,183,81,39,42,74,38,36,31,16,15,-1,0,-1,76%,75%,76%,128,127,128,22%,20%,24%,8,4,4,9,4,5
492,https://vlr.gg/player/9557/nefi,2025-02-16 12:00:00,1.18,0.93,1.06,216,211,201,86,46,40,84,40,44,70,44,26,-1,-3,+2,77%,85%,68%,130,130,130,34%,37%,31%,7,2,5,8,5,3
493,https://vlr.gg/player/42702/krizz,2025-02-16 12:00:00,0.82,1.01,0.91,182,171,202,78,37,41,87,44,43,22,11,11,-1,-2,+1,66%,66%,66%,124,118,130,25%,28%,23%,5,2,3,6,4,2
494,https://vlr.gg/player/9556/demek,2025-02-16 12:00:00,0.81,0.87,0.84,195,212,183,80,43,37,92,49,43,26,13,13,+6,+3,+3,72%,72%,71%,124,132,115,21%,21%,22%,24,13,11,18,10,8
495,https://vlr.gg/player/50813/gsr,2025-02-16 12:00:00,1.19,1.03,1.11,213,227,203,88,47,41,83,40,43,36,24,12,+3,-2,+5,68%,76%,61%,143,153,134,32%,36%,29%,10,2,8,7,4,3
496,https://vlr.gg/player/16447/d3mur,2025-02-16 12:00:00,1.15,1.03,1.09,237,266,212,102,57,45,90,44,46,27,11,16,-8,-5,-3,71%,73%,69%,155,166,143,28%,27%,29%,18,10,8,26,15,11
497,https://vlr.gg/player/19526/rexxtoned,2025-02-16 12:00:00,0.76,1.21,0.99,180,155,206,82,33,49,80,43,37,15,5,10,-2,-2,0,72%,69%,74%,127,106,148,39%,33%,44%,11,5,6,13,7,6
498,https://vlr.gg/player/7105/qpert,2025-02-16 12:00:00,0.84,1.07,0.96,176,141,215,78,31,47,79,38,41,49,22,27,-4,-2,-2,76%,68%,84%,121,100,141,24%,25%,24%,7,3,4,11,5,6
499,https://vlr.gg/player/28948/ninja,2025-02-16 12:00:00,1.11,0.80,0.96,184,212,169,73,41,32,86,41,45,42,23,19,-1,+4,-5,68%,69%,67%,125,134,117,28%,36%,23%,8,6,2,9,2,7
0,https://vlr.gg/player/33902/sayonara,2025-02-16 11:00:00,1.13,1.26,1.20,232,198,255,68,26,42,55,25,30,28,19,9,-3,0,-3,75%,83%,69%,157,145,167,31%,32%,31%,3,1,2,6,1,5
1,https://vlr.gg/player/2625/sh1n,2025-02-16 11:00:00,0.88,0.92,0.90,171,180,165,50,25,25,59,29,30,31,15,16,0,0,0,69%,70%,69%,114,115,113,27%,22%,33%,6,4,2,6,4,2
2,https://vlr.gg/player/301/takas,2025-02-16 11:00:00,0.77,1.00,0.89,196,192,196,56,26,30,61,32,29,20,11,9,+2,+2,0,68%,70%,67%,122,111,131,18%,18%,18%,17,10,7,15,8,7
3,https://vlr.gg/player/868/logan,2025-02-16 11:00:00,0.99,0.77,0.87,153,152,158,50,25,25,56,24,32,12,2,10,-5,-2,-3,71%,65%,76%,109,110,108,39%,43%,37%,3,2,1,8,4,4
4,https://vlr.gg/player/2841/foxie,2025-02-16 11:00:00,0.84,0.71,0.77,150,147,157,45,23,22,62,27,35,31,9,22,-1,+4,-5,72%,75%,69%,92,93,91,26%,31%,21%,10,5,5,11,1,10
5,https://vlr.gg/player/4521/unfake,2025-02-16 11:00:00,1.03,1.35,1.18,212,180,244,64,29,35,52,28,24,30,18,12,+6,+3,+3,69%,73%,65%,138,123,156,37%,45%,31%,11,6,5,5,3,2
6,https://vlr.gg/player/440/akumaaaaa,2025-02-16 11:00:00,1.39,0.76,1.09,231,280,167,70,47,23,60,31,29,14,5,9,-4,+4,-8,68%,69%,68%,149,182,111,40%,46%,30%,17,14,3,21,10,11
7,https://vlr.gg/player/565/starxo,2025-02-16 11:00:00,1.00,1.09,1.04,202,174,241,59,27,32,55,27,28,32,18,14,+3,+1,+2,79%,80%,78%,130,106,158,20%,23%,17%,8,3,5,5,2,3
8,https://vlr.gg/player/2653/jesse,2025-02-16 11:00:00,0.88,1.18,1.02,156,135,185,48,20,28,49,28,21,44,29,15,0,0,0,76%,78%,75%,106,90,123,33%,35%,31%,5,1,4,5,1,4
9,https://vlr.gg/player/7162/wackie,2025-02-16 11:00:00,1.05,0.92,0.99,163,189,135,49,30,19,53,30,23,26,10,16,+2,+3,-1,86%,87%,85%,114,128,99,28%,28%,29%,5,4,1,3,1,2
10,https://vlr.gg/player/24140/superphrog,2025-02-16 11:00:00,1.13,1.00,1.08,248,278,207,31,19,12,31,19,12,7,2,5,+6,+3,+3,79%,71%,88%,151,174,122,38%,51%,18%,12,8,4,6,5,1
11,https://vlr.gg/player/40175/mayameow,2025-02-16 11:00:00,0.61,1.17,0.86,168,135,219,22,9,13,30,20,10,11,6,5,+1,+1,0,68%,62%,76%,121,90,158,29%,38%,24%,3,2,1,2,1,1
12,https://vlr.gg/player/29960/nidxvilco,2025-02-16 11:00:00,0.40,1.34,0.82,173,105,248,21,6,15,31,21,10,18,9,9,+1,0,+1,76%,67%,88%,113,79,156,22%,20%,24%,2,1,1,1,1,0
13,https://vlr.gg/player/30105/ikyoo,2025-02-16 11:00:00,0.52,0.93,0.70,181,156,214,23,10,13,32,21,11,9,5,4,0,+1,-1,66%,62%,71%,116,94,143,39%,57%,26%,4,2,2,4,1,3
14,https://vlr.gg/player/30060/alessia,2025-02-16 11:00:00,0.75,0.65,0.68,121,122,128,19,11,8,30,17,13,5,1,4,0,0,0,50%,48%,53%,83,83,83,30%,30%,32%,2,0,2,2,0,2
15,https://vlr.gg/player/11183/glance,2025-02-16 11:00:00,1.03,1.68,1.39,254,157,329,38,10,28,20,10,10,12,6,6,-2,-1,-1,79%,76%,81%,151,90,200,23%,23%,23%,2,0,2,4,1,3
16,https://vlr.gg/player/23049/alkyia,2025-02-16 11:00:00,1.65,1.12,1.36,249,306,213,36,19,17,24,12,12,6,1,5,+6,+4,+2,82%,88%,76%,168,196,145,27%,25%,30%,8,4,4,2,0,2
17,https://vlr.gg/player/22792/jiex,2025-02-16 11:00:00,0.99,1.36,1.20,217,174,249,31,11,20,23,13,10,22,10,12,-2,+2,-4,76%,59%,90%,130,94,159,34%,26%,39%,2,2,0,4,0,4
18,https://vlr.gg/player/39057/safiaa,2025-02-16 11:00:00,1.09,1.17,1.14,213,195,219,28,12,16,22,11,11,15,6,9,-5,-4,-1,71%,59%,81%,128,113,140,31%,38%,26%,2,1,1,7,5,2
19,https://vlr.gg/player/38133/anesilia,2025-02-16 11:00:00,0.24,1.29,0.82,178,95,239,21,4,17,27,15,12,15,6,9,-5,-4,-1,71%,59%,81%,109,68,142,17%,10%,19%,1,0,1,6,4,2
20,https://vlr.gg/player/30186/nami,2025-02-16 11:00:00,0.93,1.33,1.13,240,216,264,59,24,35,49,26,23,23,13,10,+1,-2,+3,74%,71%,77%,144,133,154,42%,39%,45%,8,3,5,7,5,2
21,https://vlr.gg/player/17343/ness,2025-02-16 11:00:00,1.32,0.92,1.12,174,215,136,40,26,14,38,18,20,36,15,21,+2,+2,0,84%,85%,83%,121,140,102,38%,42%,33%,5,3,2,3,1,2
22,https://vlr.gg/player/24107/sarah,2025-02-16 11:00:00,1.09,0.99,1.04,187,186,188,49,26,23,42,19,23,15,6,9,+1,+1,0,65%,65%,66%,123,122,124,36%,40%,33%,6,3,3,5,2,3
23,https://vlr.gg/player/16418/smurfette,2025-02-16 11:00:00,0.93,1.07,1.00,222,220,225,53,25,28,50,26,24,10,5,5,-3,-2,-1,68%,71%,66%,154,143,165,30%,36%,25%,13,6,7,16,8,8
24,https://vlr.gg/player/19371/eva,2025-02-16 11:00:00,0.82,1.00,0.92,161,163,159,39,18,21,41,23,18,21,13,8,-2,-1,-1,72%,71%,74%,112,106,117,25%,19%,32%,2,1,1,4,2,2
25,https://vlr.gg/player/47911/berryx,2025-02-16 11:00:00,1.34,1.27,1.30,255,265,246,60,32,28,45,23,22,13,7,6,+6,+2,+4,72%,71%,74%,172,174,170,39%,47%,28%,13,7,6,7,5,2
26,https://vlr.gg/player/29442/wens,2025-02-16 11:00:00,0.85,1.32,1.08,224,172,278,54,21,33,47,25,22,14,10,4,+5,+4,+1,74%,74%,74%,146,115,178,39%,41%,38%,10,5,5,5,1,4
27,https://vlr.gg/player/46311/mimier,2025-02-16 11:00:00,0.92,0.87,0.90,187,209,164,45,26,19,50,26,24,24,13,11,-7,-4,-3,62%,66%,59%,128,145,111,33%,32%,33%,4,3,1,11,7,4
28,https://vlr.gg/player/17408/lateu,2025-02-16 11:00:00,0.84,0.76,0.80,126,126,126,28,14,14,46,22,24,30,10,20,0,-1,+1,74%,71%,76%,81,83,79,25%,26%,23%,3,1,2,3,2,1
29,https://vlr.gg/player/17326/htm,2025-02-16 11:00:00,0.76,0.65,0.71,146,131,162,32,14,18,52,25,27,19,12,7,-3,-2,-1,75%,86%,65%,100,91,109,36%,33%,40%,5,1,4,8,3,5
30,https://vlr.gg/player/10885/davih,2025-02-16 09:00:00,1.27,1.30,1.28,251,242,261,63,30,33,49,25,24,18,9,9,+1,0,+1,84%,82%,86%,162,160,165,23%,25%,21%,6,4,2,5,4,1
31,https://vlr.gg/player/9558/wolfen,2025-02-16 09:00:00,0.66,1.34,1.01,209,174,245,52,20,32,49,28,21,9,4,5,-4,-5,+1,62%,58%,66%,140,114,165,42%,50%,38%,7,3,4,11,8,3
32,https://vlr.gg/player/4329/vince,2025-02-16 09:00:00,1.09,0.70,0.89,206,254,161,51,33,18,54,27,27,20,7,13,-2,0,-2,69%,76%,63%,125,151,101,16%,14%,18%,3,1,2,5,1,4
33,https://vlr.gg/player/1835/elllement,2025-02-16 09:00:00,0.50,1.16,0.84,206,169,241,45,17,28,58,32,26,19,8,11,+1,-4,+5,72%,70%,74%,141,114,166,20%,20%,20%,11,3,8,10,7,3
34,https://vlr.gg/player/314/ambi,2025-02-16 09:00:00,0.68,0.88,0.78,147,142,153,34,16,18,51,27,24,25,11,14,-6,-2,-4,78%,82%,74%,106,107,106,19%,21%,18%,2,0,2,8,2,6
35,https://vlr.gg/player/5292/al0rante,2025-02-16 09:00:00,1.22,1.07,1.15,240,252,229,60,33,27,48,25,23,14,8,6,+4,+1,+3,71%,71%,70%,148,157,139,45%,43%,47%,12,6,6,8,5,3
36,https://vlr.gg/player/2658/xuss,2025-02-16 09:00:00,0.97,1.32,1.14,246,231,263,60,29,31,51,28,23,10,5,5,+7,0,+7,63%,54%,73%,161,146,178,26%,29%,22%,15,6,9,8,6,2
37,https://vlr.gg/player/1457/mistic,2025-02-16 09:00:00,0.91,1.17,1.04,171,133,210,46,18,28,44,22,22,25,9,16,-3,-2,-1,74%,63%,85%,113,95,132,30%,25%,34%,1,0,1,4,2,2
38,https://vlr.gg/player/2690/hoody,2025-02-16 09:00:00,0.83,1.03,0.93,188,176,202,48,22,26,47,25,22,20,8,12,+1,+1,0,71%,60%,82%,122,112,133,22%,18%,27%,4,2,2,3,1,2
39,https://vlr.gg/player/4244/yaboilewis,2025-02-16 09:00:00,0.65,1.11,0.87,203,166,245,47,20,27,55,29,26,20,8,12,+1,-1,+2,78%,77%,79%,128,102,156,45%,48%,43%,7,3,4,6,4,2
40,https://vlr.gg/player/13784/killua,2025-02-16 06:00:00,1.13,1.15,1.14,220,222,219,84,42,42,69,36,33,38,16,22,0,+1,-1,73%,71%,76%,141,138,144,36%,30%,42%,7,5,2,7,4,3
41,https://vlr.gg/player/27244/seph1roth,2025-02-16 06:00:00,0.81,1.31,1.07,206,160,254,74,28,46,74,37,37,51,24,27,+1,0,+1,73%,73%,74%,135,106,163,37%,36%,37%,9,3,6,8,3,5
42,https://vlr.gg/player/8582/laz,2025-02-16 06:00:00,1.00,1.07,1.03,195,201,195,68,33,35,70,34,36,37,11,26,+5,+2,+3,70%,69%,72%,127,126,127,29%,31%,27%,14,6,8,9,4,5
43,https://vlr.gg/player/27254/leviathan,2025-02-16 06:00:00,1.04,1.02,1.03,197,214,176,71,38,33,67,37,30,28,12,16,-7,-4,-3,68%,67%,69%,136,145,128,37%,35%,38%,5,1,4,12,5,7
44,https://vlr.gg/player/23930/potter,2025-02-16 06:00:00,0.65,1.22,0.95,191,163,220,70,27,43,73,41,32,15,9,6,+4,-4,+8,69%,61%,76%,119,104,133,33%,34%,32%,19,8,11,15,12,3
45,https://vlr.gg/player/24628/wayne,2025-02-16 06:00:00,1.03,1.11,1.07,208,218,198,79,43,36,73,40,33,55,25,30,-1,-1,0,80%,78%,82%,134,137,131,26%,28%,25%,8,4,4,9,5,4
46,https://vlr.gg/player/13220/ja,2025-02-16 06:00:00,1.05,1.00,1.03,195,192,186,72,38,34,71,37,34,27,10,17,-4,-1,-3,69%,63%,75%,122,122,123,25%,29%,22%,5,3,2,9,4,5
47,https://vlr.gg/player/1430/crazyguy,2025-02-16 06:00:00,0.88,1.15,1.01,205,193,218,76,36,40,71,39,32,20,8,12,+8,+1,+7,71%,69%,75%,133,126,140,32%,29%,35%,16,5,11,8,4,4
48,https://vlr.gg/player/24653/vera,2025-02-16 06:00:00,0.66,1.23,0.94,218,180,259,74,30,44,80,44,36,29,12,17,-4,-5,+1,60%,50%,71%,140,114,168,20%,23%,17%,17,9,8,21,14,7
49,https://vlr.gg/player/11704/styron,2025-02-16 06:00:00,0.57,0.99,0.77,128,102,165,51,20,31,72,39,33,28,11,17,-2,-2,0,66%,63%,69%,92,65,120,26%,29%,24%,5,2,3,7,4,3
50,https://vlr.gg/player/1960/eko,2025-02-16 04:25:00,1.39,1.57,1.48,303,285,322,47,22,25,28,14,14,10,3,7,+3,+1,+2,77%,64%,91%,182,175,189,22%,18%,27%,6,4,2,3,3,0
51,https://vlr.gg/player/6676/thiefy,2025-02-16 04:25:00,0.85,1.52,1.19,190,177,203,29,13,16,26,17,9,20,6,14,+5,+1,+4,82%,77%,86%,123,119,128,25%,17%,38%,5,1,4,0,0,0
52,https://vlr.gg/player/1952/esperanza,2025-02-16 04:25:00,0.99,1.28,1.14,206,157,255,34,13,21,28,15,13,17,5,12,+2,0,+2,77%,68%,86%,143,119,167,39%,48%,33%,4,1,3,2,1,1
53,https://vlr.gg/player/7888/blackwiz,2025-02-16 04:25:00,0.72,1.04,0.88,152,150,154,22,9,13,28,17,11,18,12,6,0,0,0,80%,77%,82%,114,110,119,33%,22%,45%,2,1,1,2,1,1
54,https://vlr.gg/player/34785/yowamu,2025-02-16 04:25:00,0.86,0.76,0.81,203,196,211,31,15,16,34,16,18,7,2,5,-4,-4,0,70%,59%,82%,143,138,147,30%,36%,26%,8,3,5,12,7,5
55,https://vlr.gg/player/12979/mrtenzouez,2025-02-16 04:25:00,1.12,1.13,1.12,244,256,233,38,19,19,33,19,14,9,4,5,+3,+1,+2,75%,73%,77%,156,177,135,25%,26%,25%,5,2,3,2,1,1
56,https://vlr.gg/player/43064/aace,2025-02-16 04:25:00,1.17,1.01,1.09,192,220,165,31,19,12,28,15,13,6,2,4,+1,+1,0,70%,68%,73%,121,134,108,34%,41%,26%,3,1,2,2,0,2
57,https://vlr.gg/player/1970/neth,2025-02-16 04:25:00,0.66,0.96,0.81,178,148,209,27,11,16,35,19,16,15,6,9,-2,0,-2,68%,68%,68%,120,109,130,36%,46%,31%,2,1,1,4,1,3
58,https://vlr.gg/player/34827/hals,2025-02-16 04:25:00,0.46,1.01,0.73,181,153,211,26,10,16,33,19,14,8,2,6,-3,-3,0,61%,55%,68%,122,106,138,28%,32%,24%,6,3,3,9,6,3
59,https://vlr.gg/player/6673/gon,2025-02-16 04:25:00,0.32,1.02,0.67,145,99,192,22,6,16,34,19,15,12,5,7,-5,-7,+2,61%,59%,64%,91,65,118,34%,23%,44%,3,0,3,8,7,1
60,https://vlr.gg/player/46460/ezeir,2025-02-16 04:00:00,,,,261,,,50,,,25,,,30,,,,,,,,,,,,,,,,,,,,
61,https://vlr.gg/player/36670/obone,2025-02-16 04:00:00,,,,255,,,51,,,31,,,14,,,,,,,,,,,,,,,,,,,,
62,https://vlr.gg/player/41054/guang,2025-02-16 04:00:00,,,,232,,,49,,,29,,,10,,,,,,,,,,,,,,,,,,,,
63,https://vlr.gg/player/39697/cb,2025-02-16 04:00:00,,,,214,,,43,,,34,,,17,,,,,,,,,,,,,,,,,,,,
64,https://vlr.gg/player/4402/o0o0o,2025-02-16 04:00:00,,,,170,,,33,,,38,,,23,,,,,,,,,,,,,,,,,,,,
65,https://vlr.gg/player/14125/spring,2025-02-16 04:00:00,,,,251,,,47,,,43,,,17,,,,,,,,,,,,,,,,,,,,
66,https://vlr.gg/player/7426/juicy,2025-02-16 04:00:00,,,,151,,,26,,,43,,,20,,,,,,,,,,,,,,,,,,,,
67,https://vlr.gg/player/37489/lysoar,2025-02-16 04:00:00,,,,150,,,27,,,48,,,5,,,,,,,,,,,,,,,,,,,,
68,https://vlr.gg/player/7849/siufatbb,2025-02-16 04:00:00,,,,145,,,30,,,45,,,16,,,,,,,,,,,,,,,,,,,,
69,https://vlr.gg/player/11218/yuicaw,2025-02-16 04:00:00,,,,138,,,27,,,47,,,12,,,,,,,,,,,,,,,,,,,,
70,https://vlr.gg/player/5476/minty,2025-02-16 02:00:00,1.44,1.92,1.58,254,215,336,34,21,13,13,10,3,15,11,4,+3,+3,0,91%,88%,100%,155,136,202,28%,30%,25%,3,3,0,0,0,0
71,https://vlr.gg/player/10584/seoldam,2025-02-16 02:00:00,1.32,2.13,1.56,298,273,375,37,23,14,18,15,3,8,7,1,+5,+2,+3,85%,79%,100%,197,185,227,21%,20%,25%,8,5,3,3,3,0
72,https://vlr.gg/player/4663/joxjo,2025-02-16 02:00:00,1.34,1.35,1.34,243,256,201,31,23,8,16,12,4,13,8,5,+3,+2,+1,74%,67%,90%,159,172,128,23%,23%,24%,5,4,1,2,2,0
73,https://vlr.gg/player/29841/caedye,2025-02-16 02:00:00,1.12,0.89,1.05,214,223,198,25,18,7,22,15,7,18,12,6,+4,+1,+3,79%,75%,90%,142,152,118,33%,26%,56%,7,3,4,3,2,1
74,https://vlr.gg/player/29843/yatsuka,2025-02-16 02:00:00,1.04,0.99,1.03,122,141,69,15,13,2,14,11,3,14,8,6,+1,+2,-1,94%,96%,90%,89,98,66,39%,38%,40%,2,2,0,1,0,1
75,https://vlr.gg/player/25915/brian,2025-02-16 02:00:00,0.77,1.11,1.01,223,208,226,24,6,18,31,10,21,10,3,7,+1,0,+1,74%,70%,75%,146,146,145,30%,23%,33%,4,1,3,3,1,2
76,https://vlr.gg/player/1963/hate,2025-02-16 02:00:00,0.50,1.14,0.93,194,49,247,22,2,20,26,8,18,3,0,3,-4,-2,-2,62%,20%,79%,126,31,165,26%,67%,25%,1,0,1,5,2,3
77,https://vlr.gg/player/31841/take,2025-02-16 02:00:00,0.94,0.58,0.69,137,178,118,18,7,11,28,8,20,6,1,5,0,0,0,47%,50%,46%,86,114,75,28%,26%,30%,2,1,1,2,1,1
78,https://vlr.gg/player/4545/sayaplayer,2025-02-16 02:00:00,0.10,0.64,0.47,103,87,115,11,2,9,28,10,18,6,2,4,-11,-4,-7,47%,30%,54%,74,61,80,18%,14%,20%,2,0,2,13,4,9
79,https://vlr.gg/player/17169/muto,2025-02-16 02:00:00,0.41,0.21,0.25,82,90,80,8,3,5,30,8,22,2,1,1,-2,0,-2,53%,70%,46%,57,51,60,14%,15%,14%,0,0,0,2,0,2
80,https://vlr.gg/player/19556/melya,2025-02-15 17:00:00,0.97,1.30,1.14,227,201,252,54,23,31,47,22,25,9,4,5,+3,0,+3,74%,70%,78%,141,129,153,20%,21%,20%,11,5,6,8,5,3
81,https://vlr.gg/player/28870/k0rupt,2025-02-15 17:00:00,1.07,0.93,1.00,207,244,178,46,26,20,53,28,25,34,23,11,-3,+1,-4,70%,79%,61%,126,148,107,25%,27%,23%,4,3,1,7,2,5
82,https://vlr.gg/player/33694/evv,2025-02-15 17:00:00,0.95,0.93,0.94,178,155,197,47,19,28,48,20,28,8,5,3,-3,0,-3,64%,73%,56%,115,103,126,30%,29%,31%,4,3,1,7,3,4
83,https://vlr.gg/player/25246/bunnybee,2025-02-15 17:00:00,1.03,0.61,0.81,198,232,165,47,28,19,57,25,32,12,4,8,-6,-3,-3,62%,70%,56%,127,147,107,34%,40%,27%,7,3,4,13,6,7
84,https://vlr.gg/player/32667/nora,2025-02-15 17:00:00,0.89,0.53,0.70,147,174,127,34,20,14,55,24,31,24,15,9,0,-1,+1,62%,67%,58%,98,112,85,20%,19%,22%,4,1,3,4,2,2
85,https://vlr.gg/player/873/bob,2025-02-15 17:00:00,1.72,1.60,1.66,345,347,355,85,46,39,45,22,23,19,8,11,+11,+8,+3,87%,86%,88%,223,215,232,26%,36%,18%,14,10,4,3,2,1
86,https://vlr.gg/player/14868/karra,2025-02-15 17:00:00,1.17,1.12,1.14,207,200,208,52,27,25,44,20,24,29,18,11,+4,+3,+1,78%,83%,73%,134,128,140,32%,26%,39%,7,4,3,3,1,2
87,https://vlr.gg/player/27884/unstable,2025-02-15 17:00:00,1.15,1.00,1.08,218,230,202,55,30,25,46,22,24,16,10,6,+5,+1,+4,75%,78%,73%,141,149,132,30%,38%,23%,12,4,8,7,3,4
88,https://vlr.gg/player/11968/l4ce,2025-02-15 17:00:00,0.95,0.70,0.83,146,159,135,37,22,15,46,21,25,15,2,13,+1,0,+1,71%,72%,70%,95,100,89,29%,29%,30%,3,1,2,2,1,1
89,https://vlr.gg/player/8849/sonder,2025-02-15 17:00:00,0.57,0.72,0.64,135,139,125,31,16,15,49,27,22,28,21,7,-12,-6,-6,67%,64%,70%,88,96,79,22%,25%,18%,3,2,1,15,8,7
90,https://vlr.gg/player/3753/obnoks,2025-02-15 16:30:00,1.29,0.78,1.06,231,258,198,51,34,17,49,27,22,22,12,10,+1,+1,0,70%,78%,61%,139,154,120,25%,31%,19%,7,3,4,6,2,4
91,https://vlr.gg/player/7660/fizzy,2025-02-15 16:30:00,1.08,0.88,0.99,185,200,166,43,27,16,45,24,21,13,7,6,-1,0,-1,66%,56%,79%,125,127,123,32%,35%,30%,4,3,1,5,3,2
92,https://vlr.gg/player/10338/lime,2025-02-15 16:30:00,0.67,1.34,0.96,193,159,248,46,18,28,50,31,19,20,15,5,-7,-6,-1,66%,61%,71%,129,96,172,35%,28%,40%,4,2,2,11,8,3
93,https://vlr.gg/player/18400/bipo,2025-02-15 16:30:00,0.85,1.07,0.94,211,199,222,45,24,21,49,29,20,13,7,6,+1,-2,+3,64%,58%,71%,132,131,134,29%,36%,23%,9,3,6,8,5,3
94,https://vlr.gg/player/3674/iluri,2025-02-15 16:30:00,0.73,1.02,0.86,153,138,174,34,17,17,42,26,16,18,10,8,-4,-5,+1,73%,69%,79%,97,81,117,29%,28%,30%,3,1,2,7,6,1
95,https://vlr.gg/player/2658/xuss,2025-02-15 16:30:00,0.98,1.50,1.27,234,222,246,60,24,36,39,22,17,4,2,2,+6,+1,+5,77%,79%,75%,150,135,162,27%,28%,25%,13,5,8,7,4,3
96,https://vlr.gg/player/2690/hoody,2025-02-15 16:30:00,1.01,1.23,1.13,225,195,248,51,21,30,44,21,23,31,11,20,-2,-4,+2,81%,86%,78%,138,103,165,23%,24%,23%,4,0,4,6,4,2
97,https://vlr.gg/player/1457/mistic,2025-02-15 16:30:00,0.95,1.06,1.01,181,157,202,41,15,26,42,17,25,28,11,17,+3,0,+3,64%,61%,67%,128,121,133,27%,22%,31%,6,1,5,3,1,2
98,https://vlr.gg/player/4244/yaboilewis,2025-02-15 16:30:00,1.06,0.73,0.88,186,199,176,41,20,21,48,19,29,16,5,11,0,+1,-1,75%,71%,78%,129,132,128,36%,29%,44%,5,3,2,5,2,3
99,https://vlr.gg/player/5292/al0rante,2025-02-15 16:30:00,0.75,0.82,0.79,178,170,180,42,18,24,46,20,26,13,6,7,+3,0,+3,69%,71%,67%,121,120,122,43%,43%,43%,9,4,5,6,4,2
100,https://vlr.gg/player/11183/glance,2025-02-15 14:00:00,1.59,1.54,1.56,277,274,282,44,21,23,24,12,12,11,3,8,+4,+1,+3,81%,76%,86%,178,180,176,28%,25%,33%,5,2,3,1,1,0
101,https://vlr.gg/player/22792/jiex,2025-02-15 14:00:00,1.07,1.49,1.29,237,187,287,37,14,23,28,14,14,15,6,9,+4,+1,+3,84%,81%,86%,143,118,168,35%,31%,39%,6,1,5,2,0,2
102,https://vlr.gg/player/39057/safiaa,2025-02-15 14:00:00,0.99,1.21,1.10,183,213,155,30,16,14,23,15,8,11,5,6,-1,0,-1,72%,67%,77%,127,152,103,30%,27%,38%,2,1,1,3,1,2
103,https://vlr.gg/player/38133/anesilia,2025-02-15 14:00:00,0.89,0.82,0.85,182,178,186,27,14,13,32,15,17,18,8,10,+1,0,+1,70%,71%,68%,119,115,122,24%,22%,27%,2,1,1,1,1,0
104,https://vlr.gg/player/23049/alkyia,2025-02-15 14:00:00,0.41,0.83,0.62,158,151,166,23,10,13,34,20,14,9,3,6,-3,-1,-2,65%,57%,73%,106,96,116,25%,22%,28%,9,6,3,12,7,5
105,https://vlr.gg/player/37969/ellie,2025-02-15 14:00:00,1.02,1.15,1.08,234,227,242,36,18,18,34,18,16,10,3,7,+4,0,+4,70%,68%,71%,144,138,151,20%,16%,24%,8,3,5,4,3,1
106,https://vlr.gg/player/41207/jade,2025-02-15 14:00:00,1.07,0.94,1.01,185,172,198,29,14,15,29,15,14,15,9,6,0,+1,-1,60%,59%,62%,115,110,121,40%,41%,38%,2,1,1,2,0,2
107,https://vlr.gg/player/30042/harmonee,2025-02-15 14:00:00,0.80,0.92,0.86,175,189,162,27,14,13,31,17,14,13,9,4,-4,-3,-1,70%,73%,67%,114,118,109,33%,30%,38%,3,3,0,7,6,1
108,https://vlr.gg/player/19373/ginger,2025-02-15 14:00:00,0.71,1.01,0.86,173,154,194,26,11,15,32,18,14,9,5,4,-4,-1,-3,67%,59%,76%,117,97,137,26%,18%,34%,3,1,2,7,2,5
109,https://vlr.gg/player/17318/blossi,2025-02-15 14:00:00,0.65,0.85,0.75,178,134,222,23,8,15,35,18,17,21,13,8,-1,-1,0,67%,68%,67%,121,87,156,29%,29%,29%,3,1,2,4,2,2
110,https://vlr.gg/player/38142/dream,2025-02-15 13:00:00,1.63,1.63,1.63,266,241,276,36,12,24,18,5,13,18,8,10,-1,-1,0,86%,100%,79%,173,160,180,27%,28%,26%,0,0,0,1,1,0
111,https://vlr.gg/player/17331/pinkalie,2025-02-15 13:00:00,1.52,1.18,1.30,228,244,220,30,12,18,22,6,16,16,4,12,+1,+1,0,81%,92%,75%,147,141,151,26%,21%,29%,2,1,1,1,0,1
112,https://vlr.gg/player/41197/thuy,2025-02-15 13:00:00,1.45,1.13,1.24,209,252,197,29,13,16,22,8,14,18,7,11,+1,0,+1,81%,92%,75%,137,148,131,24%,30%,21%,2,0,2,1,0,1
113,https://vlr.gg/player/43744/akita,2025-02-15 13:00:00,1.49,1.07,1.22,301,363,264,40,17,23,30,10,20,6,3,3,-1,+2,-3,76%,85%,71%,199,249,171,29%,35%,25%,9,5,4,10,3,7
114,https://vlr.gg/player/16078/loupiote,2025-02-15 13:00:00,0.83,0.75,0.78,150,134,153,19,7,12,26,8,18,14,7,7,-5,-3,-2,68%,69%,67%,106,83,118,35%,25%,41%,3,0,3,8,3,5
115,https://vlr.gg/player/24071/liza,2025-02-15 13:00:00,1.20,1.07,1.14,230,265,224,33,23,10,29,18,11,5,4,1,+3,+3,0,62%,63%,62%,168,178,149,46%,53%,32%,6,4,2,3,1,2
116,https://vlr.gg/player/41196/ja2,2025-02-15 13:00:00,0.86,0.96,0.90,211,197,235,27,17,10,30,19,11,4,2,2,-3,-3,0,57%,54%,62%,145,128,176,30%,28%,33%,4,2,2,7,5,2
117,https://vlr.gg/player/17394/ninou,2025-02-15 13:00:00,0.97,0.34,0.74,176,218,124,22,18,4,31,18,13,7,4,3,+4,+4,0,62%,75%,38%,122,134,102,32%,29%,36%,4,4,0,0,0,0
118,https://vlr.gg/player/31272/els,2025-02-15 13:00:00,0.62,0.64,0.63,165,134,215,19,10,9,32,19,13,15,13,2,+1,-1,+2,76%,79%,69%,104,94,123,17%,12%,24%,5,3,2,4,4,0
119,https://vlr.gg/player/20098/mel,2025-02-15 13:00:00,0.72,0.33,0.58,143,161,105,17,13,4,33,19,14,11,6,5,0,+1,-1,73%,83%,54%,92,103,73,22%,20%,29%,2,1,1,2,0,2
120,https://vlr.gg/player/50813/gsr,2025-02-15 12:00:00,1.17,1.33,1.25,230,212,258,97,42,55,75,36,39,33,16,17,-4,-3,-1,67%,65%,69%,160,147,173,30%,29%,32%,6,2,4,10,5,5
121,https://vlr.gg/player/19526/rexxtoned,2025-02-15 12:00:00,1.12,1.23,1.18,229,219,231,95,46,49,74,39,35,27,7,20,-2,-5,+3,73%,70%,76%,150,142,158,42%,47%,37%,12,3,9,14,8,6
122,https://vlr.gg/player/28948/ninja,2025-02-15 12:00:00,0.80,1.18,0.99,211,163,254,86,34,52,84,43,41,44,20,24,-7,-4,-3,70%,60%,80%,132,97,166,26%,28%,25%,9,3,6,16,7,9
123,https://vlr.gg/player/7105/qpert,2025-02-15 12:00:00,0.97,0.67,0.82,141,179,109,59,36,23,80,42,38,37,14,23,+2,+2,0,65%,63%,66%,93,113,74,24%,25%,24%,7,5,2,5,3,2
124,https://vlr.gg/player/16447/d3mur,2025-02-15 12:00:00,0.56,1.05,0.81,181,149,212,73,27,46,88,48,40,23,13,10,-3,+1,-4,63%,54%,71%,117,93,141,20%,16%,22%,17,11,6,20,10,10
125,https://vlr.gg/player/562/zeek,2025-02-15 12:00:00,1.03,1.20,1.11,229,211,237,87,40,47,79,43,36,40,19,21,-1,-2,+1,74%,69%,79%,152,144,161,25%,24%,26%,13,6,7,14,8,6
126,https://vlr.gg/player/1616/starki,2025-02-15 12:00:00,1.05,0.99,1.02,186,184,192,82,43,39,80,40,40,38,18,20,-4,-1,-3,72%,69%,75%,127,112,143,36%,31%,40%,6,2,4,10,3,7
127,https://vlr.gg/player/2894/kiles,2025-02-15 12:00:00,0.91,1.05,0.97,186,199,180,80,41,39,78,46,32,18,10,8,0,+1,-1,74%,69%,79%,124,131,116,38%,38%,38%,9,7,2,9,6,3
128,https://vlr.gg/player/2700/jas,2025-02-15 12:00:00,0.86,1.04,0.94,207,207,211,85,43,42,87,48,39,19,9,10,+18,+8,+10,64%,61%,67%,131,127,135,37%,43%,31%,30,14,16,12,6,6
129,https://vlr.gg/player/1369/doma,2025-02-15 12:00:00,0.66,1.13,0.89,184,145,218,66,25,41,86,48,38,39,19,20,+1,-1,+2,67%,61%,74%,130,100,161,29%,29%,28%,7,3,4,6,4,2
130,https://vlr.gg/player/13258/cyvoph,2025-02-15 11:00:00,1.08,1.44,1.27,266,227,292,67,26,41,57,30,27,40,20,20,0,+1,-1,77%,74%,80%,163,139,185,27%,29%,26%,7,4,3,7,3,4
131,https://vlr.gg/player/113/hyp,2025-02-15 11:00:00,1.26,1.19,1.21,207,229,195,58,29,29,43,21,22,14,4,10,-4,-2,-2,68%,71%,65%,138,148,130,22%,25%,20%,5,2,3,9,4,5
132,https://vlr.gg/player/114/enzo,2025-02-15 11:00:00,0.93,1.31,1.13,219,177,251,59,21,38,49,25,24,27,14,13,-1,0,-1,75%,71%,78%,142,119,162,28%,31%,26%,9,4,5,10,4,6
133,https://vlr.gg/player/3582/keloqz,2025-02-15 11:00:00,0.85,1.16,1.02,227,219,232,60,29,31,56,31,25,14,3,11,+1,0,+1,69%,60%,78%,147,130,163,21%,25%,18%,11,6,5,10,6,4
134,https://vlr.gg/player/1284/mikee,2025-02-15 11:00:00,0.99,0.91,0.95,176,187,156,44,23,21,48,23,25,39,12,27,-5,-2,-3,73%,71%,75%,111,122,101,28%,34%,24%,1,0,1,6,2,4
135,https://vlr.gg/player/24439/yohpa,2025-02-15 11:00:00,1.00,1.16,1.07,220,198,252,61,28,33,56,29,27,28,12,16,+3,+4,-1,81%,68%,97%,152,130,177,37%,34%,40%,5,4,1,2,0,2
136,https://vlr.gg/player/7173/soren,2025-02-15 11:00:00,0.78,1.15,0.95,173,144,214,50,22,28,53,30,23,9,3,6,+2,+1,+1,65%,55%,77%,118,97,142,40%,43%,37%,7,4,3,5,3,2
137,https://vlr.gg/player/11322/sevire,2025-02-15 11:00:00,0.94,0.74,0.84,179,186,166,45,25,20,61,33,28,23,13,10,+1,+1,0,63%,68%,57%,118,126,110,23%,32%,15%,6,3,3,5,2,3
138,https://vlr.gg/player/21216/f4ngeer,2025-02-15 11:00:00,0.68,1.06,0.84,206,199,222,53,25,28,62,36,26,14,6,8,+2,+2,0,60%,53%,69%,134,133,135,24%,30%,17%,20,12,8,18,10,8
139,https://vlr.gg/player/2864/ease,2025-02-15 11:00:00,0.76,0.90,0.83,156,153,177,44,23,21,56,32,24,29,11,18,+1,-2,+3,68%,60%,77%,105,95,116,28%,26%,30%,4,0,4,3,2,1
140,https://vlr.gg/player/17323/mimi,2025-02-15 11:00:00,1.32,1.59,1.44,273,243,310,37,19,18,20,13,7,21,11,10,+1,+1,0,86%,84%,88%,169,159,181,33%,38%,30%,2,2,0,1,1,0
141,https://vlr.gg/player/24149/amy,2025-02-15 11:00:00,1.63,1.03,1.35,248,311,162,31,23,8,18,10,8,5,2,3,+3,+2,+1,80%,84%,75%,160,194,119,46%,62%,30%,6,3,3,3,1,2
142,https://vlr.gg/player/17320/petra,2025-02-15 11:00:00,0.80,1.51,1.12,205,163,254,25,10,15,20,13,7,12,6,6,+1,-1,+2,77%,68%,88%,145,123,172,22%,20%,25%,3,1,2,2,2,0
143,https://vlr.gg/player/20064/vania,2025-02-15 11:00:00,0.49,1.69,1.04,189,148,251,26,10,16,23,15,8,5,2,3,-1,-4,+3,71%,58%,88%,134,95,179,32%,27%,37%,6,1,5,7,5,2
144,https://vlr.gg/player/16321/nelo,2025-02-15 11:00:00,0.97,1.04,1.00,175,170,176,21,11,10,20,12,8,19,8,11,-1,+1,-2,77%,74%,81%,118,112,124,39%,30%,56%,2,2,0,3,1,2
145,https://vlr.gg/player/47911/berryx,2025-02-15 11:00:00,0.94,1.38,1.18,247,184,294,30,10,20,27,12,15,2,1,1,-1,-1,0,66%,56%,74%,153,121,180,44%,40%,47%,4,1,3,5,2,3
146,https://vlr.gg/player/17408/lateu,2025-02-15 11:00:00,0.66,1.22,0.96,193,142,236,24,8,16,28,14,14,8,4,4,+3,+2,+1,69%,56%,79%,130,85,168,38%,30%,42%,4,2,2,1,0,1
147,https://vlr.gg/player/46311/mimier,2025-02-15 11:00:00,0.64,0.78,0.72,158,134,171,17,8,9,28,13,15,10,1,9,-3,-4,+1,57%,44%,68%,103,86,116,20%,14%,25%,1,0,1,4,4,0
148,https://vlr.gg/player/29442/wens,2025-02-15 11:00:00,0.59,0.69,0.64,155,157,153,18,8,10,29,14,15,8,5,3,-1,0,-1,66%,63%,68%,113,112,114,40%,38%,42%,5,2,3,6,2,4
149,https://vlr.gg/player/17326/htm,2025-02-15 11:00:00,0.50,0.67,0.58,108,97,116,12,4,8,28,14,14,11,7,4,-1,-1,0,63%,75%,53%,73,66,78,20%,16%,23%,2,1,1,3,2,1
150,https://vlr.gg/player/30107/fluxxy,2025-02-15 11:00:00,0.95,1.40,1.14,221,183,289,37,16,21,31,18,13,7,3,4,-2,-1,-1,64%,62%,68%,145,128,167,31%,33%,28%,2,1,1,4,2,2
151,https://vlr.gg/player/37990/adora,2025-02-15 11:00:00,0.60,1.32,0.90,192,166,254,27,12,15,35,23,12,13,5,8,-3,-4,+1,64%,50%,84%,145,124,174,23%,28%,19%,7,4,3,10,8,2
152,https://vlr.gg/player/19362/lyda,2025-02-15 11:00:00,0.75,0.73,0.74,162,180,129,26,17,9,37,23,14,9,5,4,0,-1,+1,69%,65%,74%,99,113,80,37%,42%,29%,2,0,2,2,1,1
153,https://vlr.gg/player/24101/miyori,2025-02-15 11:00:00,0.37,1.04,0.62,129,88,210,21,7,14,36,23,13,11,5,6,-4,-3,-1,56%,50%,63%,89,60,128,31%,14%,50%,3,1,2,7,4,3
154,https://vlr.gg/player/9431/cille,2025-02-15 11:00:00,0.64,0.39,0.53,112,145,86,17,12,5,36,21,15,7,4,3,-4,-3,-1,49%,50%,47%,85,98,68,33%,36%,26%,2,1,1,6,4,2
155,https://vlr.gg/player/16418/smurfette,2025-02-15 11:00:00,0.96,1.79,1.44,330,264,344,49,16,33,31,17,14,10,5,5,+8,+1,+7,84%,79%,88%,195,176,209,29%,26%,32%,14,4,10,6,3,3
156,https://vlr.gg/player/19371/eva,2025-02-15 11:00:00,1.02,1.65,1.38,249,191,265,41,14,27,24,14,10,11,4,7,0,0,0,71%,63%,77%,167,143,184,32%,32%,32%,3,1,2,3,1,2
157,https://vlr.gg/player/24107/sarah,2025-02-15 11:00:00,1.26,1.19,1.22,192,196,190,29,13,16,23,10,13,23,13,10,+3,0,+3,73%,68%,77%,133,132,134,36%,44%,33%,5,1,4,2,1,1
158,https://vlr.gg/player/30186/nami,2025-02-15 11:00:00,1.14,1.16,1.15,201,217,204,32,15,17,28,13,15,25,5,20,+4,+2,+2,76%,68%,81%,138,153,126,37%,38%,37%,6,4,2,2,2,0
159,https://vlr.gg/player/17343/ness,2025-02-15 11:00:00,0.94,1.03,0.99,146,130,152,24,9,15,22,10,12,21,10,11,-2,-2,0,80%,74%,85%,95,80,106,31%,22%,38%,1,0,1,3,2,1
160,https://vlr.gg/player/21584/deminatix,2025-02-15 10:00:00,0.74,1.27,1.03,235,166,292,87,29,58,79,36,43,16,8,8,0,-6,+6,65%,57%,72%,144,107,175,31%,22%,39%,24,9,15,24,15,9
161,https://vlr.gg/player/11516/drky,2025-02-15 10:00:00,1.04,1.00,1.02,174,175,173,60,29,31,67,32,35,50,22,28,-1,0,-1,78%,84%,74%,112,116,109,23%,18%,27%,5,3,2,6,3,3
162,https://vlr.gg/player/12226/sturnn,2025-02-15 10:00:00,1.18,0.85,1.00,187,233,148,71,42,29,70,33,37,12,3,9,-5,-2,-3,68%,67%,68%,123,149,100,34%,31%,38%,5,2,3,10,4,6
163,https://vlr.gg/player/10114/baha,2025-02-15 10:00:00,0.90,0.79,0.84,167,184,154,64,32,32,75,34,41,22,9,13,-2,0,-2,69%,71%,67%,110,123,98,30%,34%,28%,8,4,4,10,4,6
164,https://vlr.gg/player/16483/gloomy,2025-02-15 10:00:00,0.71,0.92,0.82,162,139,183,59,25,34,76,35,41,29,13,16,+4,-1,+5,67%,65%,68%,102,86,115,17%,15%,18%,9,2,7,5,3,2
165,https://vlr.gg/player/8041/brave,2025-02-15 10:00:00,1.33,0.98,1.17,232,249,216,86,49,37,67,34,33,31,16,15,+2,+3,-1,68%,70%,65%,152,168,134,35%,34%,36%,13,8,5,11,5,6
166,https://vlr.gg/player/10160/izzy,2025-02-15 10:00:00,0.99,1.24,1.11,209,198,222,80,40,40,65,37,28,22,10,12,+1,0,+1,72%,68%,76%,143,133,155,27%,24%,31%,17,8,9,16,8,8
167,https://vlr.gg/player/10161/qutionerx,2025-02-15 10:00:00,0.94,1.15,1.04,221,217,226,83,47,36,75,42,33,21,7,14,-1,-6,+5,75%,81%,69%,149,132,169,23%,24%,22%,15,7,8,16,13,3
168,https://vlr.gg/player/12774/anima,2025-02-15 10:00:00,0.79,1.05,0.91,153,135,172,58,27,31,67,36,31,39,24,15,+3,-1,+4,74%,77%,69%,100,88,114,28%,27%,28%,6,2,4,3,3,0
169,https://vlr.gg/player/10163/cyderx,2025-02-15 10:00:00,0.93,0.81,0.87,158,161,155,59,33,26,68,36,32,22,12,10,-1,-1,0,69%,72%,65%,109,110,107,25%,27%,23%,4,1,3,5,2,3
170,https://vlr.gg/player/9508/leosen,2025-02-15 09:00:00,1.09,1.29,1.19,237,251,225,63,18,19,57,20,15,18,6,7,+4,+3,+1,72%,68%,75%,162,168,156,32%,33%,31%,7,4,3,3,1,2
171,https://vlr.gg/player/4629/azury,2025-02-15 09:00:00,1.21,1.05,1.12,183,179,182,58,17,17,45,14,15,12,4,6,+7,+3,+4,70%,68%,71%,117,109,125,33%,34%,32%,7,3,4,0,0,0
172,https://vlr.gg/player/45494/proxh,2025-02-15 09:00:00,0.68,1.36,1.03,225,141,301,45,10,23,61,18,18,36,10,15,+1,+1,0,72%,64%,79%,147,97,192,23%,31%,20%,4,3,1,3,2,1
173,https://vlr.gg/player/12528/disisjohn,2025-02-15 09:00:00,0.42,0.97,0.71,209,182,235,51,12,22,61,23,18,12,3,3,+2,-2,+4,67%,64%,71%,139,123,153,19%,20%,18%,7,2,5,5,4,1
174,https://vlr.gg/player/4325/musashi,2025-02-15 09:00:00,0.41,0.90,0.67,148,107,184,42,8,16,56,19,16,22,4,11,-2,-3,+1,59%,41%,75%,98,84,110,20%,23%,19%,4,0,4,6,3,3
175,https://vlr.gg/player/9558/wolfen,2025-02-15 09:00:00,1.25,1.47,1.35,256,248,270,71,20,25,51,18,13,19,6,7,-1,-1,0,80%,71%,91%,191,193,190,41%,43%,39%,4,2,2,5,3,2
176,https://vlr.gg/player/10885/davih,2025-02-15 09:00:00,1.15,1.37,1.25,206,211,203,57,19,16,44,17,10,35,10,11,-4,-4,0,78%,75%,82%,130,138,121,22%,28%,16%,4,1,3,8,5,3
177,https://vlr.gg/player/314/ambi,2025-02-15 09:00:00,0.73,1.30,1.00,199,186,220,55,15,17,51,20,11,22,2,11,+1,-1,+2,78%,71%,86%,131,121,142,24%,32%,20%,3,1,2,2,2,0
178,https://vlr.gg/player/1835/elllement,2025-02-15 09:00:00,0.86,1.07,0.96,227,214,236,52,17,16,58,22,16,21,5,7,-3,-3,0,76%,67%,86%,154,143,166,25%,34%,20%,6,3,3,9,6,3
179,https://vlr.gg/player/4329/vince,2025-02-15 09:00:00,0.57,1.21,0.88,188,142,236,45,11,20,55,20,15,40,4,15,-5,-1,-4,76%,71%,82%,109,92,129,18%,19%,17%,0,0,0,5,1,4
180,https://vlr.gg/player/9263/sayoo,2025-02-15 06:00:00,0.88,1.07,0.98,184,162,211,42,17,25,41,21,20,16,9,7,-1,-2,+1,84%,77%,91%,122,103,139,29%,31%,28%,3,1,2,4,3,1
181,https://vlr.gg/player/2346/cud,2025-02-15 06:00:00,0.80,1.12,0.97,189,157,222,45,17,28,43,23,20,6,3,3,0,-1,+1,65%,63%,67%,125,94,153,35%,34%,35%,8,2,6,8,3,5
182,https://vlr.gg/player/1745/adrnking,2025-02-15 06:00:00,1.13,0.65,0.88,162,200,126,34,21,13,45,22,23,27,14,13,-1,0,-1,76%,77%,76%,102,124,83,48%,65%,34%,1,0,1,2,0,2
183,https://vlr.gg/player/16852/nakya,2025-02-15 06:00:00,0.61,0.92,0.77,186,170,206,40,17,23,54,28,26,7,3,4,0,-4,+4,67%,57%,76%,121,103,137,27%,40%,18%,11,4,7,11,8,3
184,https://vlr.gg/player/23710/gotten,2025-02-15 06:00:00,0.55,0.82,0.69,184,157,198,36,16,20,54,26,28,25,9,16,-1,-3,+2,63%,63%,64%,112,91,132,33%,37%,31%,7,3,4,8,6,2
185,https://vlr.gg/player/1430/crazyguy,2025-02-15 06:00:00,1.26,1.31,1.28,263,244,300,60,29,31,43,21,22,23,12,11,+4,0,+4,78%,79%,77%,176,164,189,25%,29%,22%,11,5,6,7,5,2
186,https://vlr.gg/player/24628/wayne,2025-02-15 06:00:00,1.27,1.10,1.19,199,211,183,48,27,21,37,20,17,19,10,9,-5,-4,-1,73%,70%,77%,124,132,115,31%,31%,32%,1,0,1,6,4,2
187,https://vlr.gg/player/11704/styron,2025-02-15 06:00:00,1.18,1.12,1.15,191,196,185,37,20,17,33,18,15,37,20,17,-2,-1,-1,86%,88%,83%,129,135,123,20%,21%,18%,3,0,3,5,1,4
188,https://vlr.gg/player/24653/vera,2025-02-15 06:00:00,0.97,1.29,1.12,250,246,247,56,27,29,46,28,18,15,7,8,+2,-1,+3,75%,70%,80%,162,165,158,26%,26%,27%,11,7,4,9,8,1
189,https://vlr.gg/player/13220/ja,2025-02-15 06:00:00,0.59,1.23,0.89,159,121,202,36,14,22,38,22,16,14,5,9,+4,-1,+5,79%,73%,87%,110,80,143,26%,27%,26%,7,1,6,3,2,1
190,https://vlr.gg/player/1970/neth,2025-02-15 05:55:00,1.57,1.39,1.51,277,293,218,37,27,10,18,13,5,7,4,3,+1,+1,0,92%,92%,92%,177,191,148,29%,32%,25%,3,2,1,2,1,1
191,https://vlr.gg/player/12979/mrtenzouez,2025-02-15 05:55:00,1.64,1.10,1.46,262,276,206,33,23,10,16,10,6,9,7,2,+2,+3,-1,86%,92%,75%,169,191,125,32%,36%,24%,5,3,2,3,0,3
192,https://vlr.gg/player/43064/aace,2025-02-15 05:55:00,0.97,1.81,1.25,229,180,331,34,18,16,20,14,6,8,5,3,0,0,0,78%,71%,92%,150,120,211,42%,39%,48%,3,3,0,3,3,0
193,https://vlr.gg/player/6673/gon,2025-02-15 05:55:00,1.11,1.09,1.10,187,186,204,26,18,8,18,11,7,16,9,7,+2,0,+2,78%,75%,83%,117,118,114,28%,33%,19%,2,0,2,0,0,0
194,https://vlr.gg/player/34827/hals,2025-02-15 05:55:00,0.71,1.38,0.93,191,168,238,24,14,10,21,16,5,10,4,6,-3,-4,+1,75%,71%,83%,116,111,128,13%,19%,7%,6,4,2,9,8,1
195,https://vlr.gg/player/48431/kippei,2025-02-15 05:55:00,0.95,1.19,1.11,215,198,233,28,10,18,30,11,19,7,0,7,+3,-1,+4,72%,67%,75%,135,111,147,27%,27%,27%,6,1,5,3,2,1
196,https://vlr.gg/player/10628/misaya,2025-02-15 05:55:00,0.34,0.94,0.74,163,98,203,19,2,17,31,11,20,9,6,3,+1,0,+1,61%,58%,63%,113,79,130,14%,9%,16%,2,0,2,1,0,1
197,https://vlr.gg/player/10769/nobita,2025-02-15 05:55:00,0.36,0.74,0.62,134,98,151,17,5,12,29,11,18,4,0,4,-4,-2,-2,58%,58%,58%,84,57,97,33%,36%,32%,1,0,1,5,2,3
198,https://vlr.gg/player/40726/gwangboong,2025-02-15 05:55:00,0.37,0.66,0.55,156,145,164,17,5,12,34,12,22,3,1,2,-1,0,-1,50%,50%,50%,106,93,113,28%,35%,25%,5,2,3,6,2,4
199,https://vlr.gg/player/29840/yuran,2025-02-15 05:55:00,1.03,0.28,0.53,119,190,88,12,7,5,30,9,21,6,2,4,-1,+1,-2,42%,50%,38%,91,132,70,14%,23%,9%,3,2,1,4,1,3
200,https://vlr.gg/player/4774/knight,2025-02-15 04:00:00,,,,247,,,52,,,41,,,18,,,,,,,,,,,,,,,,,,,,
201,https://vlr.gg/player/10698/nephh,2025-02-15 04:00:00,,,,241,,,52,,,37,,,28,,,,,,,,,,,,,,,,,,,,
202,https://vlr.gg/player/4885/whzy,2025-02-15 04:00:00,,,,217,,,48,,,47,,,13,,,,,,,,,,,,,,,,,,,,
203,https://vlr.gg/player/48878/rushia,2025-02-15 04:00:00,,,,205,,,44,,,39,,,28,,,,,,,,,,,,,,,,,,,,
204,https://vlr.gg/player/40845/levius,2025-02-15 04:00:00,,,,164,,,38,,,39,,,15,,,,,,,,,,,,,,,,,,,,
205,https://vlr.gg/player/16924/stew,2025-02-15 04:00:00,,,,213,,,48,,,46,,,8,,,,,,,,,,,,,,,,,,,,
206,https://vlr.gg/player/15302/babyblue,2025-02-15 04:00:00,,,,205,,,45,,,52,,,12,,,,,,,,,,,,,,,,,,,,
207,https://vlr.gg/player/3519/jkuro,2025-02-15 04:00:00,,,,177,,,40,,,47,,,16,,,,,,,,,,,,,,,,,,,,
208,https://vlr.gg/player/41029/z1yan,2025-02-15 04:00:00,,,,170,,,38,,,44,,,11,,,,,,,,,,,,,,,,,,,,
209,https://vlr.gg/player/37674/mrcani,2025-02-15 04:00:00,,,,166,,,32,,,45,,,37,,,,,,,,,,,,,,,,,,,,
210,https://vlr.gg/player/7745/yoshiii,2025-02-15 02:00:00,1.21,1.07,1.15,210,225,202,61,33,28,51,28,23,13,6,7,-7,-6,-1,70%,61%,81%,149,152,145,32%,35%,28%,4,2,2,11,8,3
211,https://vlr.gg/player/993/medusa,2025-02-15 02:00:00,0.85,1.10,0.97,204,173,232,52,25,27,59,32,27,27,7,20,-4,-5,+1,66%,59%,75%,135,130,142,35%,39%,30%,9,3,6,13,8,5
212,https://vlr.gg/player/6700/anthem,2025-02-15 02:00:00,0.87,1.04,0.95,181,186,181,51,27,24,58,33,25,27,13,14,-6,-3,-3,71%,66%,78%,123,131,113,29%,34%,24%,1,0,1,7,3,4
213,https://vlr.gg/player/4477/lob,2025-02-15 02:00:00,0.77,0.87,0.82,145,140,162,38,18,20,54,31,23,30,14,16,-6,-2,-4,70%,66%,75%,95,92,98,22%,29%,17%,1,0,1,7,2,5
214,https://vlr.gg/player/687/zepher,2025-02-15 02:00:00,0.62,1.03,0.81,186,158,236,47,22,25,62,36,26,15,8,7,-4,-5,+1,68%,66%,69%,133,109,161,18%,20%,17%,10,5,5,14,10,4
215,https://vlr.gg/player/1960/eko,2025-02-15 02:00:00,1.22,1.38,1.31,289,303,265,74,36,38,55,30,25,17,8,9,+17,+8,+9,86%,83%,88%,182,181,183,20%,26%,15%,26,15,11,9,7,2
216,https://vlr.gg/player/6676/thiefy,2025-02-15 02:00:00,0.77,1.45,1.13,215,150,278,58,17,41,47,24,23,40,20,20,0,-1,+1,77%,72%,80%,138,101,170,33%,38%,30%,5,0,5,5,1,4
217,https://vlr.gg/player/34785/yowamu,2025-02-15 02:00:00,0.92,1.29,1.12,236,199,252,63,27,36,52,26,26,14,6,8,+6,-3,+9,74%,67%,80%,151,124,174,28%,30%,27%,14,4,10,8,7,1
218,https://vlr.gg/player/1952/esperanza,2025-02-15 02:00:00,1.40,0.88,1.12,189,228,169,57,32,25,47,21,26,19,8,11,+2,+1,+1,74%,78%,71%,135,159,115,30%,29%,31%,3,1,2,1,0,1
219,https://vlr.gg/player/7888/blackwiz,2025-02-15 02:00:00,0.81,0.86,0.84,142,124,148,32,12,20,48,23,25,51,27,24,+2,+1,+1,75%,69%,80%,93,91,95,24%,22%,26%,4,1,3,2,0,2
220,https://vlr.gg/player/873/bob,2025-02-14 20:05:00,1.18,1.84,1.58,322,207,401,42,11,31,20,8,12,11,4,7,+1,-1,+2,74%,67%,78%,216,138,267,31%,38%,30%,4,1,3,3,2,1
221,https://vlr.gg/player/14868/karra,2025-02-14 20:05:00,1.55,1.46,1.50,241,274,216,35,15,20,17,9,8,25,12,13,-3,-2,-1,89%,87%,91%,166,191,151,44%,53%,37%,2,0,2,5,2,3
222,https://vlr.gg/player/27884/unstable,2025-02-14 20:05:00,0.88,1.53,1.28,234,165,271,33,10,23,19,9,10,11,3,8,+6,-1,+7,82%,73%,87%,146,129,157,31%,34%,29%,8,1,7,2,2,0
223,https://vlr.gg/player/8849/sonder,2025-02-14 20:05:00,1.39,1.06,1.19,214,260,177,28,14,14,23,11,12,23,8,15,+5,+4,+1,89%,100%,83%,126,150,110,17%,23%,13%,7,5,2,2,1,1
224,https://vlr.gg/player/11968/l4ce,2025-02-14 20:05:00,1.04,1.17,1.12,172,158,161,20,7,13,16,8,8,18,9,9,+1,+1,0,79%,67%,87%,110,108,111,29%,29%,29%,3,1,2,2,0,2
225,https://vlr.gg/player/28535/misu,2025-02-14 20:05:00,0.81,0.75,0.79,175,159,172,22,13,9,31,20,11,3,3,0,+1,0,+1,50%,43%,60%,102,105,97,27%,29%,24%,3,1,2,2,1,1
226,https://vlr.gg/player/17950/avery,2025-02-14 20:05:00,0.54,1.08,0.74,133,129,192,20,11,9,31,20,11,4,1,3,-5,-4,-1,53%,48%,60%,95,76,124,31%,39%,24%,1,0,1,6,4,2
227,https://vlr.gg/player/30395/edith,2025-02-14 20:05:00,0.64,0.77,0.69,164,168,161,19,11,8,33,20,13,5,3,2,-3,-3,0,55%,48%,67%,112,114,109,26%,26%,26%,3,2,1,6,5,1
228,https://vlr.gg/player/37901/aluvily,2025-02-14 20:05:00,0.29,1.19,0.64,125,61,260,18,4,14,31,20,11,8,4,4,0,-1,+1,47%,35%,67%,86,42,153,38%,27%,44%,4,2,2,4,3,1
229,https://vlr.gg/player/25400/riv,2025-02-14 20:05:00,0.67,0.34,0.52,122,148,102,16,11,5,33,21,12,8,7,1,-3,-1,-2,50%,52%,47%,85,99,64,32%,38%,19%,3,2,1,6,3,3
230,https://vlr.gg/player/28870/k0rupt,2025-02-14 17:00:00,1.21,0.92,1.07,237,251,222,52,30,22,48,22,26,14,5,9,-1,0,-1,74%,76%,72%,145,150,139,23%,28%,19%,6,4,2,7,4,3
231,https://vlr.gg/player/32667/nora,2025-02-14 17:00:00,1.26,0.86,1.07,189,215,158,45,26,19,44,20,24,29,14,15,-2,-1,-1,74%,79%,69%,119,137,100,31%,36%,25%,4,1,3,6,2,4
232,https://vlr.gg/player/25246/bunnybee,2025-02-14 17:00:00,1.10,0.98,1.04,222,235,219,46,25,21,48,24,24,23,14,9,0,-3,+3,69%,70%,69%,152,153,151,23%,29%,19%,9,3,6,9,6,3
233,https://vlr.gg/player/33694/evv,2025-02-14 17:00:00,1.28,0.67,0.98,190,240,144,45,29,16,47,21,26,22,14,8,+2,+3,-1,77%,88%,66%,132,170,94,26%,27%,24%,4,3,1,2,0,2
234,https://vlr.gg/player/19556/melya,2025-02-14 17:00:00,0.52,1.03,0.77,171,155,189,40,18,22,52,29,23,10,6,4,-4,0,-4,65%,64%,66%,125,108,144,23%,23%,23%,7,5,2,11,5,6
235,https://vlr.gg/player/24237/powerpixele,2025-02-14 17:00:00,1.54,1.23,1.38,256,282,237,54,30,24,41,19,22,30,17,13,+6,+2,+4,74%,78%,70%,174,182,165,18%,18%,17%,9,4,5,3,2,1
236,https://vlr.gg/player/15039/australis,2025-02-14 17:00:00,1.31,1.00,1.15,226,256,193,57,34,23,44,20,24,15,9,6,+1,+3,-2,71%,81%,61%,140,148,132,31%,31%,32%,4,4,0,3,1,2
237,https://vlr.gg/player/8329/starbound,2025-02-14 17:00:00,0.86,0.93,0.90,171,128,205,39,15,24,44,17,27,7,4,3,-5,-3,-2,71%,78%,64%,117,92,141,7%,9%,5%,3,0,3,8,3,5
238,https://vlr.gg/player/38583/sleepyaria,2025-02-14 17:00:00,0.89,0.89,0.89,207,207,205,48,22,26,50,25,25,12,7,5,+1,+2,-1,77%,81%,73%,133,141,124,17%,16%,18%,10,7,3,9,5,4
239,https://vlr.gg/player/15016/joona,2025-02-14 17:00:00,0.99,0.71,0.85,185,185,190,41,22,19,49,19,30,27,11,16,+2,0,+2,74%,78%,70%,120,116,124,30%,30%,30%,9,3,6,7,3,4
240,https://vlr.gg/player/7104/juseu,2025-02-14 13:20:00,0.77,1.43,1.10,240,176,291,43,18,25,37,21,16,13,2,11,-2,-3,+1,69%,67%,71%,157,115,197,27%,39%,23%,8,5,3,10,8,2
241,https://vlr.gg/player/33358/shinnok,2025-02-14 13:20:00,1.10,0.89,0.99,187,212,168,37,20,17,40,19,21,13,6,7,+4,+2,+2,76%,81%,71%,128,153,104,32%,29%,36%,6,3,3,2,1,1
242,https://vlr.gg/player/4589/burzzy,2025-02-14 13:20:00,1.23,0.75,0.99,179,220,154,38,23,15,39,18,21,12,8,4,-2,0,-2,75%,74%,75%,116,141,91,36%,35%,38%,2,1,1,4,1,3
243,https://vlr.gg/player/217/seider,2025-02-14 13:20:00,0.73,1.23,0.98,184,144,224,34,11,23,34,19,15,22,15,7,-4,-2,-2,75%,67%,82%,120,94,145,24%,21%,26%,2,0,2,6,2,4
244,https://vlr.gg/player/7490/anguist,2025-02-14 13:20:00,1.16,0.51,0.83,191,241,134,38,25,13,44,20,24,10,5,5,-1,0,-1,56%,63%,50%,116,146,87,37%,40%,32%,7,3,4,8,3,5
245,https://vlr.gg/player/2700/jas,2025-02-14 13:20:00,1.27,1.23,1.25,255,256,258,52,25,27,38,18,20,5,2,3,+4,+3,+1,73%,75%,70%,168,175,161,39%,39%,39%,12,7,5,8,4,4
246,https://vlr.gg/player/1616/starki,2025-02-14 13:20:00,1.13,0.98,1.06,207,241,174,40,23,17,38,21,17,19,12,7,+1,+1,0,75%,71%,78%,133,155,110,40%,37%,47%,4,3,1,3,2,1
247,https://vlr.gg/player/1369/doma,2025-02-14 13:20:00,0.85,1.13,0.99,209,163,254,39,17,22,41,20,21,24,14,10,+4,+1,+3,76%,75%,78%,127,95,160,41%,33%,48%,4,1,3,0,0,0
248,https://vlr.gg/player/562/zeek,2025-02-14 13:20:00,1.05,0.83,0.94,201,209,195,34,19,15,37,17,20,16,7,9,+2,+1,+1,67%,64%,70%,144,141,147,16%,21%,12%,9,4,5,7,3,4
249,https://vlr.gg/player/2894/kiles,2025-02-14 13:20:00,0.72,0.87,0.80,142,129,166,29,13,16,36,17,19,9,2,7,-6,-4,-2,69%,68%,70%,97,84,111,37%,30%,44%,1,0,1,7,4,3
250,https://vlr.gg/player/42702/krizz,2025-02-14 10:00:00,1.27,1.57,1.42,272,251,289,59,28,31,37,21,16,10,5,5,-1,0,-1,82%,81%,83%,179,173,186,35%,38%,33%,1,1,0,2,1,1
251,https://vlr.gg/player/10448/kozok,2025-02-14 10:00:00,1.38,0.95,1.17,192,208,180,41,23,18,37,15,22,18,8,10,+4,+4,0,74%,81%,67%,129,142,116,28%,29%,27%,8,5,3,4,1,3
252,https://vlr.gg/player/36748/czester,2025-02-14 10:00:00,1.29,0.90,1.10,224,274,176,51,31,20,42,20,22,24,13,11,-11,-5,-6,75%,77%,73%,147,172,121,31%,35%,27%,3,1,2,14,6,8
253,https://vlr.gg/player/9557/nefi,2025-02-14 10:00:00,0.82,0.81,0.82,153,118,189,33,14,19,40,19,21,26,16,10,0,-1,+1,77%,81%,73%,100,67,133,30%,27%,32%,4,1,3,4,2,2
254,https://vlr.gg/player/9556/demek,2025-02-14 10:00:00,0.69,0.84,0.76,183,185,183,36,19,17,49,25,24,14,5,9,+3,+1,+2,75%,74%,77%,118,115,121,17%,14%,22%,12,7,5,9,6,3
255,https://vlr.gg/player/50813/gsr,2025-02-14 10:00:00,1.00,1.08,1.04,247,246,244,53,26,27,47,23,24,21,11,10,-1,0,-1,74%,73%,74%,157,160,154,31%,31%,32%,4,2,2,5,2,3
256,https://vlr.gg/player/16447/d3mur,2025-02-14 10:00:00,1.18,0.77,0.97,224,266,190,49,29,20,48,22,26,8,2,6,+3,+2,+1,64%,63%,65%,141,164,119,21%,19%,25%,14,9,5,11,7,4
257,https://vlr.gg/player/28948/ninja,2025-02-14 10:00:00,0.87,1.01,0.94,158,151,166,35,16,19,40,20,20,16,10,6,+3,+1,+2,72%,73%,71%,110,110,110,28%,29%,28%,7,2,5,4,1,3
258,https://vlr.gg/player/7105/qpert,2025-02-14 10:00:00,0.90,0.83,0.87,154,146,161,34,16,18,41,18,23,24,13,11,-1,0,-1,75%,80%,71%,102,97,106,42%,56%,33%,0,0,0,1,0,1
259,https://vlr.gg/player/19526/rexxtoned,2025-02-14 10:00:00,0.84,0.78,0.81,155,159,146,34,18,16,44,22,22,10,5,5,+1,+1,0,66%,70%,61%,104,107,101,46%,53%,40%,8,4,4,7,3,4
260,https://vlr.gg/player/23930/potter,2025-02-14 08:10:00,1.83,1.42,1.70,333,383,232,43,33,10,20,14,6,5,4,1,+8,+5,+3,83%,88%,73%,212,246,140,33%,34%,26%,11,7,4,3,2,1
261,https://vlr.gg/player/13784/killua,2025-02-14 08:10:00,1.16,1.54,1.28,278,262,323,36,22,14,22,16,6,8,6,2,+2,+1,+1,80%,83%,73%,180,175,192,33%,39%,24%,4,3,1,2,2,0
262,https://vlr.gg/player/27244/seph1roth,2025-02-14 08:10:00,1.46,0.83,1.26,209,246,101,27,24,3,18,12,6,22,11,11,0,0,0,86%,92%,73%,132,163,64,34%,35%,33%,1,1,0,1,1,0
263,https://vlr.gg/player/8582/laz,2025-02-14 08:10:00,0.88,1.03,0.93,181,161,203,24,16,8,24,15,9,7,2,5,+4,+1,+3,74%,71%,82%,117,109,133,31%,38%,21%,6,3,3,2,2,0
264,https://vlr.gg/player/27254/leviathan,2025-02-14 08:10:00,0.62,1.30,0.83,159,130,238,20,11,9,23,17,6,8,5,3,-1,-3,+2,89%,88%,91%,114,100,144,36%,48%,25%,2,0,2,3,3,0
265,https://vlr.gg/player/1745/adrnking,2025-02-14 08:10:00,1.31,0.85,0.99,227,338,192,29,13,16,28,9,19,7,1,6,+1,+1,0,63%,73%,58%,140,194,115,38%,26%,53%,2,1,1,1,0,1
266,https://vlr.gg/player/9263/sayoo,2025-02-14 08:10:00,1.47,0.78,0.98,203,287,177,26,11,15,29,7,22,6,0,6,-3,-2,-1,51%,55%,50%,139,183,119,43%,31%,53%,1,0,1,4,2,2
267,https://vlr.gg/player/16852/nakya,2025-02-14 08:10:00,0.49,0.81,0.71,193,135,203,20,5,15,31,9,22,1,0,1,-4,-3,-1,49%,55%,46%,119,85,135,35%,50%,29%,3,0,3,7,3,4
268,https://vlr.gg/player/23710/gotten,2025-02-14 08:10:00,0.42,0.87,0.71,190,78,235,20,3,17,30,8,22,7,2,5,-5,-2,-3,49%,55%,46%,117,48,148,38%,38%,38%,3,0,3,8,2,6
269,https://vlr.gg/player/2346/cud,2025-02-14 08:10:00,0.07,0.41,0.29,98,33,125,12,1,11,32,11,21,3,1,2,-2,-3,+1,46%,27%,54%,63,19,84,54%,25%,59%,2,0,2,4,3,1
270,https://vlr.gg/player/31537/basbabe,2025-02-14 06:00:00,1.33,1.23,1.27,275,286,287,42,16,26,30,11,19,7,3,4,0,+1,-1,62%,69%,58%,187,170,198,36%,34%,37%,8,4,4,8,3,5
271,https://vlr.gg/player/20623/harddora,2025-02-14 06:00:00,0.94,0.82,0.87,175,175,187,27,10,17,31,10,21,7,2,5,0,+1,-1,74%,81%,69%,126,115,133,40%,43%,39%,3,1,2,3,0,3
272,https://vlr.gg/player/41694/endoist,2025-02-14 06:00:00,0.78,0.88,0.84,177,190,220,29,10,19,36,13,23,4,1,3,+4,+1,+3,71%,69%,73%,134,124,141,27%,21%,30%,11,4,7,7,3,4
273,https://vlr.gg/player/17303/fontuz,2025-02-14 06:00:00,0.77,0.80,0.78,152,149,160,23,8,15,30,13,17,13,6,7,-2,-1,-1,76%,75%,77%,99,107,95,25%,36%,20%,0,0,0,2,1,1
274,https://vlr.gg/player/41701/ki1wsy,2025-02-14 06:00:00,0.94,0.55,0.68,117,162,97,17,9,8,29,10,19,17,8,9,0,0,0,60%,63%,58%,76,102,60,33%,43%,25%,0,0,0,0,0,0
275,https://vlr.gg/player/24628/wayne,2025-02-14 06:00:00,1.44,1.14,1.33,242,229,196,36,24,12,22,13,9,18,13,5,+1,+1,0,79%,77%,81%,129,144,104,29%,24%,39%,5,3,2,4,2,2
276,https://vlr.gg/player/24653/vera,2025-02-14 06:00:00,1.17,1.40,1.26,293,255,284,41,24,17,27,17,10,9,8,1,-1,-2,+1,76%,73%,81%,164,159,172,34%,27%,50%,4,2,2,5,4,1
277,https://vlr.gg/player/13220/ja,2025-02-14 06:00:00,1.04,1.58,1.25,246,239,265,36,22,14,31,21,10,19,8,11,+4,+3,+1,83%,81%,88%,170,162,184,30%,30%,30%,5,3,2,1,0,1
278,https://vlr.gg/player/1430/crazyguy,2025-02-14 06:00:00,0.86,0.80,0.84,157,155,188,23,13,10,30,18,12,12,7,5,-2,+1,-3,62%,69%,50%,109,97,128,21%,29%,15%,6,5,1,8,4,4
279,https://vlr.gg/player/11704/styron,2025-02-14 06:00:00,1.02,0.38,0.77,150,179,74,20,16,4,28,16,12,12,8,4,-4,-3,-1,67%,81%,44%,99,125,55,17%,18%,13%,0,0,0,4,3,1
280,https://vlr.gg/player/7426/juicy,2025-02-14 06:00:00,,,,279,,,43,,,23,,,23,,,,,,,,,,,,,,,,,,,,
281,https://vlr.gg/player/11218/yuicaw,2025-02-14 06:00:00,,,,246,,,36,,,27,,,25,,,,,,,,,,,,,,,,,,,,
282,https://vlr.gg/player/14125/spring,2025-02-14 06:00:00,,,,217,,,32,,,32,,,9,,,,,,,,,,,,,,,,,,,,
283,https://vlr.gg/player/37489/lysoar,2025-02-14 06:00:00,,,,162,,,24,,,30,,,6,,,,,,,,,,,,,,,,,,,,
284,https://vlr.gg/player/7849/siufatbb,2025-02-14 06:00:00,,,,134,,,17,,,25,,,12,,,,,,,,,,,,,,,,,,,,
285,https://vlr.gg/player/15302/babyblue,2025-02-14 06:00:00,,,,230,,,35,,,30,,,8,,,,,,,,,,,,,,,,,,,,
286,https://vlr.gg/player/16924/stew,2025-02-14 06:00:00,,,,203,,,33,,,31,,,0,,,,,,,,,,,,,,,,,,,,
287,https://vlr.gg/player/3519/jkuro,2025-02-14 06:00:00,,,,178,,,26,,,31,,,15,,,,,,,,,,,,,,,,,,,,
288,https://vlr.gg/player/41029/z1yan,2025-02-14 06:00:00,,,,163,,,23,,,31,,,11,,,,,,,,,,,,,,,,,,,,
289,https://vlr.gg/player/37674/mrcani,2025-02-14 06:00:00,,,,129,,,20,,,30,,,15,,,,,,,,,,,,,,,,,,,,
290,https://vlr.gg/player/40726/gwangboong,2025-02-14 05:40:00,2.36,1.27,1.59,321,480,255,39,17,22,19,4,15,10,3,7,+2,+2,0,79%,80%,79%,208,271,181,28%,28%,28%,7,4,3,5,2,3
291,https://vlr.gg/player/29840/yuran,2025-02-14 05:40:00,1.81,1.49,1.58,230,204,239,31,8,23,16,3,13,17,8,9,+1,0,+1,76%,90%,71%,147,100,166,20%,18%,20%,2,0,2,1,0,1
292,https://vlr.gg/player/48431/kippei,2025-02-14 05:40:00,1.37,1.30,1.32,214,219,214,28,9,19,18,6,12,15,6,9,+1,0,+1,88%,80%,92%,134,141,131,30%,26%,33%,4,1,3,3,1,2
293,https://vlr.gg/player/10628/misaya,2025-02-14 05:40:00,0.98,1.26,1.17,187,118,215,22,4,18,18,4,14,17,4,13,0,0,0,88%,90%,88%,120,72,140,15%,21%,14%,0,0,0,0,0,0
294,https://vlr.gg/player/10769/nobita,2025-02-14 05:40:00,1.01,1.12,1.09,229,187,238,26,6,20,22,6,16,12,3,9,+4,0,+4,76%,70%,79%,143,134,147,22%,11%,30%,8,1,7,4,1,3
295,https://vlr.gg/player/1003/reita,2025-02-14 05:40:00,0.68,1.06,0.79,191,155,282,21,12,9,30,21,9,13,11,2,-1,-1,0,65%,58%,80%,112,86,174,20%,13%,30%,1,0,1,2,1,1
296,https://vlr.gg/player/1395/tennn,2025-02-14 05:40:00,1.12,0.04,0.79,154,205,45,19,18,1,27,18,9,9,8,1,-4,-3,-1,53%,63%,30%,103,129,40,33%,38%,11%,0,0,0,4,3,1
297,https://vlr.gg/player/23971/ask,2025-02-14 05:40:00,0.73,0.41,0.64,164,185,117,20,16,4,30,21,9,3,2,1,-2,-2,0,59%,58%,60%,108,120,79,35%,37%,29%,1,1,0,3,3,0
298,https://vlr.gg/player/34776/absol,2025-02-14 05:40:00,0.59,0.55,0.58,174,179,173,20,14,6,31,22,9,4,3,1,+1,0,+1,53%,58%,40%,115,114,118,18%,20%,10%,9,6,3,8,6,2
299,https://vlr.gg/player/686/tonbo,2025-02-14 05:40:00,0.57,0.35,0.49,128,129,121,13,10,3,28,20,8,10,7,3,-2,0,-2,56%,50%,70%,93,94,92,33%,42%,21%,2,2,0,4,2,2
300,https://vlr.gg/player/4885/whzy,2025-02-14 04:00:00,,,,308,,,44,,,33,,,2,,,,,,,,,,,,,,,,,,,,
301,https://vlr.gg/player/10698/nephh,2025-02-14 04:00:00,,,,201,,,25,,,29,,,18,,,,,,,,,,,,,,,,,,,,
302,https://vlr.gg/player/48878/rushia,2025-02-14 04:00:00,,,,147,,,19,,,30,,,16,,,,,,,,,,,,,,,,,,,,
303,https://vlr.gg/player/4774/knight,2025-02-14 04:00:00,,,,141,,,13,,,30,,,15,,,,,,,,,,,,,,,,,,,,
304,https://vlr.gg/player/40845/levius,2025-02-14 04:00:00,,,,138,,,15,,,30,,,12,,,,,,,,,,,,,,,,,,,,
305,https://vlr.gg/player/41054/guang,2025-02-14 04:00:00,,,,282,,,42,,,22,,,13,,,,,,,,,,,,,,,,,,,,
306,https://vlr.gg/player/39697/cb,2025-02-14 04:00:00,,,,229,,,29,,,25,,,15,,,,,,,,,,,,,,,,,,,,
307,https://vlr.gg/player/46460/ezeir,2025-02-14 04:00:00,,,,207,,,27,,,22,,,17,,,,,,,,,,,,,,,,,,,,
308,https://vlr.gg/player/36670/obone,2025-02-14 04:00:00,,,,191,,,27,,,24,,,7,,,,,,,,,,,,,,,,,,,,
309,https://vlr.gg/player/4402/o0o0o,2025-02-14 04:00:00,,,,189,,,27,,,24,,,24,,,,,,,,,,,,,,,,,,,,
310,https://vlr.gg/player/45962/ken,2025-02-14 02:00:00,1.49,1.36,1.43,298,294,311,69,36,33,49,22,27,24,13,11,+11,+5,+6,76%,80%,72%,198,193,204,29%,29%,29%,16,7,9,5,2,3
311,https://vlr.gg/player/6702/bazz,2025-02-14 02:00:00,0.92,0.96,0.94,199,192,210,48,25,23,50,24,26,13,4,9,+3,+3,0,69%,66%,72%,125,117,135,30%,33%,29%,10,8,2,7,5,2
312,https://vlr.gg/player/1009/sakurai,2025-02-14 02:00:00,0.95,0.67,0.82,162,173,146,38,22,16,47,22,25,11,7,4,-2,-1,-1,66%,74%,56%,118,125,109,25%,33%,18%,5,3,2,7,4,3
313,https://vlr.gg/player/2400/brofeld,2025-02-14 02:00:00,0.98,0.56,0.78,146,188,108,39,26,13,48,23,25,11,7,4,-4,0,-4,72%,77%,66%,97,116,76,28%,29%,26%,2,2,0,6,2,4
314,https://vlr.gg/player/40736/kapi,2025-02-14 02:00:00,0.89,0.62,0.76,163,190,137,37,21,16,51,27,24,21,17,4,+3,0,+3,76%,89%,63%,113,133,91,29%,28%,30%,6,1,5,3,1,2
315,https://vlr.gg/player/6676/thiefy,2025-02-14 02:00:00,1.33,1.47,1.41,236,216,242,54,24,30,37,17,20,37,21,16,+2,-1,+3,78%,78%,77%,147,144,150,29%,35%,25%,6,2,4,4,3,1
316,https://vlr.gg/player/34785/yowamu,2025-02-14 02:00:00,1.44,0.97,1.20,264,307,239,60,34,26,52,24,28,17,7,10,-1,+1,-2,81%,84%,77%,181,202,162,37%,45%,30%,5,2,3,6,1,5
317,https://vlr.gg/player/1960/eko,2025-02-14 02:00:00,1.02,1.14,1.08,233,215,244,53,23,30,48,21,27,12,8,4,-2,0,-2,70%,72%,69%,152,141,162,25%,29%,22%,10,6,4,12,6,6
318,https://vlr.gg/player/7888/blackwiz,2025-02-14 02:00:00,0.99,0.76,0.87,168,163,175,40,18,22,46,18,28,25,12,13,-6,-2,-4,81%,84%,77%,108,109,106,32%,39%,26%,2,1,1,8,3,5
319,https://vlr.gg/player/1952/esperanza,2025-02-14 02:00:00,1.10,0.49,0.78,150,207,98,38,28,10,48,21,27,15,4,11,-4,-2,-2,69%,75%,63%,96,128,66,27%,31%,22%,5,3,2,9,5,4
320,https://vlr.gg/player/873/bob,2025-02-13 19:50:00,1.79,1.27,1.55,275,328,213,39,25,14,16,9,7,5,3,2,+1,+2,-1,83%,95%,69%,187,225,143,32%,34%,28%,4,3,1,3,1,2
321,https://vlr.gg/player/8849/sonder,2025-02-13 19:50:00,1.36,1.23,1.30,252,243,259,32,17,15,19,9,10,15,9,6,+1,+1,0,89%,95%,81%,153,150,157,25%,22%,28%,4,2,2,3,1,2
322,https://vlr.gg/player/27884/unstable,2025-02-13 19:50:00,1.42,1.14,1.29,254,241,273,33,18,15,20,7,13,10,6,4,+2,-1,+3,80%,79%,81%,164,149,181,47%,60%,37%,8,4,4,6,5,1
323,https://vlr.gg/player/14868/karra,2025-02-13 19:50:00,1.35,1.16,1.26,181,163,208,24,12,12,15,5,10,17,12,5,0,-1,+1,86%,95%,75%,112,91,137,33%,21%,46%,2,0,2,2,1,1
324,https://vlr.gg/player/11968/l4ce,2025-02-13 19:50:00,1.50,0.78,1.17,173,248,74,21,17,4,13,7,6,11,7,4,+3,+2,+1,86%,89%,81%,122,174,62,37%,40%,27%,3,2,1,0,0,0
325,https://vlr.gg/player/28546/venus,2025-02-13 19:50:00,0.64,0.98,0.82,175,145,197,20,7,13,29,13,16,4,0,4,-1,-2,+1,57%,56%,58%,115,102,125,29%,39%,23%,6,4,2,7,6,1
326,https://vlr.gg/player/30790/kestrel,2025-02-13 19:50:00,0.89,0.50,0.68,129,162,105,16,9,7,29,11,18,7,4,3,0,-1,+1,60%,63%,58%,86,97,76,39%,50%,29%,1,0,1,1,1,0
327,https://vlr.gg/player/28530/calsushi,2025-02-13 19:50:00,1.04,0.36,0.67,142,202,97,19,12,7,31,11,20,2,1,1,+1,0,+1,49%,69%,32%,100,139,67,22%,26%,13%,2,1,1,1,1,0
328,https://vlr.gg/player/37920/oranges,2025-02-13 19:50:00,0.63,0.53,0.58,117,105,129,12,5,7,29,12,17,7,5,2,-1,-1,0,51%,56%,47%,77,66,86,25%,42%,19%,2,0,2,3,1,2
329,https://vlr.gg/player/43380/aria,2025-02-13 19:50:00,1.02,0.14,0.55,149,238,81,16,13,3,31,13,18,8,2,6,-6,0,-6,51%,75%,32%,109,171,57,23%,26%,17%,3,1,2,9,1,8
330,https://vlr.gg/player/44448/insano,2025-02-13 18:55:00,0.59,1.79,1.27,268,137,367,44,10,34,27,15,12,9,2,7,-1,-1,0,74%,56%,88%,188,111,245,37%,35%,38%,5,2,3,6,3,3
331,https://vlr.gg/player/23010/nicksz,2025-02-13 18:55:00,0.91,1.47,1.23,200,173,195,31,12,19,23,15,8,10,3,7,0,-2,+2,76%,61%,88%,118,108,126,41%,32%,49%,2,0,2,2,2,0
332,https://vlr.gg/player/28715/hunterx,2025-02-13 18:55:00,0.61,1.50,1.12,191,132,234,28,7,21,25,17,8,14,6,8,+1,+1,0,74%,50%,92%,127,97,150,29%,30%,29%,3,2,1,2,1,1
333,https://vlr.gg/player/32732/yeah,2025-02-13 18:55:00,1.19,0.93,1.04,235,247,230,33,15,18,31,15,16,7,3,4,+1,0,+1,71%,67%,75%,159,180,144,26%,28%,24%,7,2,5,6,2,4
334,https://vlr.gg/player/33121/stwz1,2025-02-13 18:55:00,0.47,1.29,0.94,154,79,205,20,4,16,25,14,11,19,6,13,+5,0,+5,74%,44%,96%,101,63,131,32%,31%,33%,7,2,5,2,2,0
335,https://vlr.gg/player/41225/kramarick,2025-02-13 18:55:00,0.73,1.59,1.10,219,177,288,35,14,21,31,22,9,14,4,10,+1,+1,0,64%,54%,78%,144,113,186,31%,35%,29%,3,2,1,2,1,1
336,https://vlr.gg/player/47551/sanoj,2025-02-13 18:55:00,0.53,1.40,0.90,226,177,295,32,13,19,33,23,10,6,3,3,-2,-4,+2,60%,46%,78%,143,111,185,32%,30%,36%,8,3,5,10,7,3
337,https://vlr.gg/player/45864/bruxo,2025-02-13 18:55:00,0.64,1.22,0.89,160,135,200,23,11,12,30,21,9,7,2,5,-3,-3,0,57%,33%,89%,109,96,126,36%,24%,54%,2,0,2,5,3,2
338,https://vlr.gg/player/41466/mixyce,2025-02-13 18:55:00,0.52,1.17,0.80,175,123,249,25,8,17,31,21,10,13,11,2,-1,-1,0,74%,63%,89%,113,78,161,17%,8%,31%,5,3,2,6,4,2
339,https://vlr.gg/player/50786/renna,2025-02-13 18:55:00,0.52,0.83,0.66,100,95,114,15,8,7,31,21,10,8,2,6,-1,-1,0,62%,46%,83%,77,74,81,22%,22%,22%,0,0,0,1,1,0
340,https://vlr.gg/player/8414/icee,2025-02-13 17:00:00,0.75,1.31,1.05,231,197,260,57,22,35,47,27,20,9,6,3,+3,-1,+4,73%,63%,83%,138,120,156,16%,16%,16%,11,4,7,8,5,3
341,https://vlr.gg/player/17982/lunafox,2025-02-13 17:00:00,0.88,1.15,1.02,209,197,221,47,20,27,50,26,24,20,9,11,+5,+1,+4,72%,63%,80%,139,130,146,28%,30%,26%,9,4,5,4,3,1
342,https://vlr.gg/player/6329/sliicyy,2025-02-13 17:00:00,0.87,1.07,0.97,215,190,234,53,20,33,53,26,27,17,9,8,-2,-4,+2,72%,69%,74%,134,121,147,29%,30%,29%,6,2,4,8,6,2
343,https://vlr.gg/player/6575/aniemal,2025-02-13 17:00:00,1.02,0.74,0.88,184,207,162,43,23,20,48,25,23,12,4,8,-2,-1,-1,57%,53%,60%,124,145,104,25%,28%,22%,5,2,3,7,3,4
344,https://vlr.gg/player/25510/teddyisfluffy,2025-02-13 17:00:00,0.48,0.93,0.71,151,103,193,32,10,22,50,26,24,32,16,16,-3,-3,0,66%,63%,69%,103,62,140,17%,9%,21%,3,0,3,6,3,3
345,https://vlr.gg/player/30395/edith,2025-02-13 17:00:00,0.77,1.75,1.24,258,177,347,63,21,42,48,28,20,11,7,4,-3,-3,0,70%,63%,78%,168,120,220,28%,32%,26%,12,5,7,15,8,7
346,https://vlr.gg/player/28535/misu,2025-02-13 17:00:00,0.88,1.43,1.15,242,213,277,56,24,32,48,30,18,24,11,13,-1,-5,+4,78%,69%,88%,148,133,166,25%,27%,23%,6,1,5,7,6,1
347,https://vlr.gg/player/37901/aluvily,2025-02-13 17:00:00,1.10,1.10,1.10,211,203,225,52,26,26,45,25,20,15,2,13,+3,-1,+4,75%,66%,84%,145,137,153,32%,41%,26%,6,2,4,3,3,0
348,https://vlr.gg/player/17950/avery,2025-02-13 17:00:00,1.00,0.89,0.95,155,184,124,35,23,12,43,26,17,31,11,20,-1,-2,+1,78%,77%,78%,107,129,82,27%,29%,23%,1,0,1,2,2,0
349,https://vlr.gg/player/25400/riv,2025-02-13 17:00:00,0.86,0.90,0.88,178,180,174,40,22,18,48,28,20,18,3,15,+1,+2,-1,81%,74%,88%,121,112,130,36%,37%,36%,8,5,3,7,3,4
350,https://vlr.gg/player/651/frz,2025-02-13 15:00:00,0.99,1.47,1.21,226,206,249,51,23,28,42,26,16,26,11,15,+2,0,+2,82%,73%,94%,155,150,160,31%,39%,25%,5,3,2,3,3,0
351,https://vlr.gg/player/1575/quick,2025-02-13 15:00:00,1.22,1.15,1.19,255,265,239,62,36,26,47,27,20,9,3,6,+5,0,+5,71%,68%,74%,160,163,157,27%,30%,24%,16,8,8,11,8,3
352,https://vlr.gg/player/1581/guhrvn,2025-02-13 15:00:00,0.77,1.33,1.02,161,134,188,35,15,20,38,25,13,29,10,19,+8,+5,+3,76%,68%,87%,106,87,129,25%,25%,25%,11,6,5,3,1,2
353,https://vlr.gg/player/8872/mazin,2025-02-13 15:00:00,0.73,1.25,0.96,180,123,247,44,15,29,47,27,20,29,16,13,+3,0,+3,74%,62%,87%,115,76,161,27%,37%,22%,7,2,5,4,2,2
354,https://vlr.gg/player/13093/jzz,2025-02-13 15:00:00,0.61,1.04,0.81,154,124,183,38,17,21,45,28,17,14,4,10,-2,-2,0,69%,59%,81%,101,79,126,31%,40%,27%,3,1,2,5,3,2
355,https://vlr.gg/player/36433/phc,2025-02-13 15:00:00,1.20,1.19,1.20,196,210,188,47,22,25,37,20,17,31,15,16,+2,+1,+1,81%,81%,81%,123,129,118,33%,31%,35%,7,2,5,5,1,4
356,https://vlr.gg/player/6202/guuih,2025-02-13 15:00:00,0.85,1.20,1.04,203,169,227,50,18,32,44,25,19,4,2,2,-1,0,-1,71%,68%,73%,138,125,148,28%,30%,28%,3,1,2,4,1,3
357,https://vlr.gg/player/3424/siduzord,2025-02-13 15:00:00,0.89,1.10,1.00,185,176,198,45,19,26,44,24,20,17,9,8,+1,-1,+2,71%,71%,70%,126,112,138,26%,18%,33%,3,0,3,2,1,1
358,https://vlr.gg/player/15681/palla,2025-02-13 15:00:00,0.46,1.07,0.79,187,160,212,40,14,26,52,28,24,14,7,7,-10,-7,-3,63%,55%,70%,133,113,150,18%,10%,25%,10,5,5,20,12,8
359,https://vlr.gg/player/9266/tisora,2025-02-13 15:00:00,0.54,0.98,0.78,161,132,197,37,13,24,53,27,26,20,5,15,-8,-6,-2,68%,48%,84%,113,88,134,23%,18%,26%,3,1,2,11,7,4
360,https://vlr.gg/player/11105/rich,2025-02-13 15:00:00,1.03,0.83,0.93,170,177,165,25,14,11,29,15,14,3,2,1,+2,+2,0,59%,67%,50%,115,124,106,43%,53%,32%,4,2,2,2,0,2
361,https://vlr.gg/player/3455/zanatsu,2025-02-13 15:00:00,0.92,0.79,0.86,231,241,225,30,17,13,37,18,19,5,2,3,+2,+4,-2,54%,62%,45%,159,157,161,25%,23%,26%,9,5,4,7,1,6
362,https://vlr.gg/player/3157/gaabxx,2025-02-13 15:00:00,0.95,0.71,0.83,159,180,135,21,12,9,30,15,15,8,3,5,0,-1,+1,68%,67%,70%,115,138,90,24%,27%,20%,3,2,1,3,3,0
363,https://vlr.gg/player/1671/kon4n,2025-02-13 15:00:00,0.62,0.94,0.77,138,123,154,19,8,11,33,16,17,21,11,10,0,0,0,68%,62%,75%,89,82,96,20%,18%,22%,1,1,0,1,1,0
364,https://vlr.gg/player/13823/pxs,2025-02-13 15:00:00,0.78,0.61,0.70,153,165,138,19,11,8,31,16,15,17,7,10,-3,0,-3,66%,67%,65%,104,116,91,27%,30%,23%,4,3,1,7,3,4
365,https://vlr.gg/player/27149/brinks,2025-02-13 15:00:00,1.27,1.49,1.38,245,243,246,31,17,14,21,11,10,27,8,19,+2,+3,-1,88%,85%,90%,166,167,166,26%,40%,18%,5,4,1,3,1,2
366,https://vlr.gg/player/37354/basic,2025-02-13 15:00:00,1.42,1.12,1.26,199,165,231,29,13,16,21,7,14,29,13,16,+1,0,+1,83%,85%,81%,126,115,137,22%,20%,24%,3,1,2,2,1,1
367,https://vlr.gg/player/1684/denaro,2025-02-13 15:00:00,1.16,1.20,1.18,202,191,212,29,14,15,23,10,13,14,6,8,+1,+1,0,85%,85%,86%,133,121,144,17%,13%,22%,2,2,0,1,1,0
368,https://vlr.gg/player/23832/lucks,2025-02-13 15:00:00,0.98,1.22,1.10,212,187,238,35,16,19,21,10,11,4,1,3,-1,0,-1,73%,70%,76%,148,144,153,53%,55%,52%,3,1,2,4,1,3
369,https://vlr.gg/player/22964/forbanz,2025-02-13 15:00:00,1.19,0.93,1.06,234,284,185,36,20,16,28,14,14,5,4,1,-4,0,-4,73%,80%,67%,149,169,129,24%,36%,11%,7,4,3,11,4,7
370,https://vlr.gg/player/37840/msh,2025-02-13 12:20:00,0.87,1.06,0.98,189,137,223,27,9,18,29,12,17,2,0,2,+2,-1,+3,61%,53%,67%,125,85,153,43%,29%,51%,5,0,5,3,1,2
371,https://vlr.gg/player/3839/prti,2025-02-13 12:20:00,0.67,1.04,0.89,171,93,227,23,5,18,30,12,18,12,8,4,-3,-1,-2,56%,59%,54%,119,61,160,33%,46%,29%,1,0,1,4,1,3
372,https://vlr.gg/player/25906/alexiiik,2025-02-13 12:20:00,0.97,0.74,0.84,196,249,161,28,15,13,36,15,21,3,3,0,-6,-4,-2,54%,53%,54%,131,163,108,39%,41%,38%,5,2,3,11,6,5
373,https://vlr.gg/player/4537/tajrex,2025-02-13 12:20:00,0.95,0.77,0.84,181,191,176,23,12,11,30,12,18,9,4,5,-5,-2,-3,56%,59%,54%,130,123,134,30%,37%,26%,1,1,0,6,3,3
374,https://vlr.gg/player/8593/grmekista,2025-02-13 12:20:00,0.58,0.56,0.57,106,101,109,13,6,7,31,13,18,13,7,6,-3,-3,0,54%,59%,50%,75,85,67,23%,25%,22%,1,0,1,4,3,1
375,https://vlr.gg/player/2700/jas,2025-02-13 12:20:00,1.09,1.74,1.36,310,261,376,47,24,23,29,17,12,4,3,1,+4,-1,+5,78%,71%,88%,204,171,251,38%,36%,40%,8,2,6,4,3,1
376,https://vlr.gg/player/562/zeek,2025-02-13 12:20:00,1.36,1.20,1.29,251,270,224,35,22,13,24,14,10,12,8,4,+8,+5,+3,80%,83%,76%,173,180,165,22%,18%,30%,11,7,4,3,2,1
377,https://vlr.gg/player/1369/doma,2025-02-13 12:20:00,1.18,1.09,1.15,166,165,165,25,15,10,20,11,9,19,10,9,-1,-1,0,76%,75%,76%,118,119,117,31%,33%,28%,0,0,0,1,1,0
378,https://vlr.gg/player/1616/starki,2025-02-13 12:20:00,1.12,0.99,1.07,152,155,149,25,15,10,20,12,8,11,7,4,-2,-1,-1,78%,83%,71%,108,113,102,66%,68%,63%,1,1,0,3,2,1
379,https://vlr.gg/player/2894/kiles,2025-02-13 12:20:00,0.94,0.90,0.92,162,179,139,24,16,8,21,13,8,5,3,2,+6,+2,+4,63%,67%,59%,101,107,92,38%,37%,39%,8,4,4,2,2,0
380,https://vlr.gg/player/7106/diseased,2025-02-13 10:00:00,0.89,1.30,1.05,179,181,228,31,18,13,31,20,11,10,3,7,-1,-4,+3,60%,58%,65%,134,117,160,38%,37%,40%,4,0,4,5,4,1
381,https://vlr.gg/player/252/d3ffo,2025-02-13 10:00:00,1.02,1.03,1.02,206,210,168,32,21,11,31,20,11,2,0,2,+5,+5,0,77%,77%,76%,114,122,102,33%,37%,29%,8,7,1,3,2,1
382,https://vlr.gg/player/22617/vitie,2025-02-13 10:00:00,0.72,0.70,0.72,164,165,165,24,15,9,34,20,14,16,9,7,-1,+3,-4,65%,69%,59%,104,104,104,27%,32%,21%,3,3,0,4,0,4
383,https://vlr.gg/player/30901/ianto,2025-02-13 10:00:00,0.59,0.78,0.66,158,148,198,22,12,10,37,22,15,16,11,5,-2,-3,+1,67%,58%,82%,120,99,152,20%,15%,26%,3,1,2,5,4,1
384,https://vlr.gg/player/23098/aphun,2025-02-13 10:00:00,0.46,0.84,0.61,137,109,193,20,8,12,35,21,14,17,11,6,-6,-5,-1,65%,69%,59%,89,68,120,22%,18%,28%,1,0,1,7,5,2
385,https://vlr.gg/player/217/seider,2025-02-13 10:00:00,1.22,1.28,1.25,217,201,219,32,13,19,22,9,13,19,6,13,+1,+2,-1,79%,71%,85%,132,108,149,26%,27%,25%,4,3,1,3,1,2
386,https://vlr.gg/player/33358/shinnok,2025-02-13 10:00:00,0.60,1.63,1.19,229,89,307,35,5,30,27,11,16,8,4,4,+2,-3,+5,72%,59%,81%,141,63,192,28%,50%,24%,5,0,5,3,3,0
387,https://vlr.gg/player/7104/juseu,2025-02-13 10:00:00,1.31,1.10,1.19,226,289,180,35,18,17,24,11,13,5,2,3,+5,+3,+2,70%,65%,73%,158,202,130,40%,31%,53%,9,5,4,4,2,2
388,https://vlr.gg/player/4589/burzzy,2025-02-13 10:00:00,1.16,1.13,1.15,232,229,203,33,14,19,26,11,15,18,9,9,0,-1,+1,74%,82%,69%,130,134,128,42%,44%,40%,4,0,4,4,1,3
389,https://vlr.gg/player/7490/anguist,2025-02-13 10:00:00,1.25,1.02,1.11,226,254,205,33,15,18,30,13,17,12,6,6,-3,0,-3,74%,82%,69%,146,163,136,33%,29%,37%,2,1,1,5,1,4
390,https://vlr.gg/player/1430/crazyguy,2025-02-13 07:50:00,1.70,0.85,1.23,235,281,222,40,22,18,36,13,23,15,9,6,+3,+1,+2,82%,91%,74%,174,183,166,31%,39%,25%,7,3,4,4,2,2
391,https://vlr.gg/player/24653/vera,2025-02-13 07:50:00,1.00,1.18,1.10,233,226,260,41,16,25,35,16,19,12,8,4,+1,-3,+4,84%,91%,78%,161,163,159,20%,26%,13%,9,2,7,8,5,3
392,https://vlr.gg/player/11704/styron,2025-02-13 07:50:00,1.10,0.56,0.80,124,145,104,23,14,9,31,11,20,14,7,7,-2,+1,-3,78%,82%,74%,77,87,68,17%,23%,12%,2,2,0,4,1,3
393,https://vlr.gg/player/13220/ja,2025-02-13 07:50:00,0.85,0.73,0.78,194,191,195,32,15,17,40,17,23,11,6,5,+2,0,+2,69%,73%,67%,135,129,141,28%,37%,23%,5,1,4,3,1,2
394,https://vlr.gg/player/24628/wayne,2025-02-13 07:50:00,1.13,0.39,0.72,148,197,115,29,17,12,35,13,22,11,7,4,-1,+1,-2,67%,73%,63%,89,113,69,34%,36%,31%,3,3,0,4,2,2
395,https://vlr.gg/player/9263/sayoo,2025-02-13 07:50:00,1.43,1.00,1.24,203,213,209,37,21,16,29,13,16,11,7,4,-2,-3,+1,78%,81%,73%,136,138,134,43%,32%,64%,4,1,3,6,4,2
396,https://vlr.gg/player/2346/cud,2025-02-13 07:50:00,1.40,0.72,1.10,206,262,127,36,26,10,31,16,15,9,4,5,-1,0,-1,73%,81%,64%,139,173,99,41%,40%,41%,1,1,0,2,1,1
397,https://vlr.gg/player/23710/gotten,2025-02-13 07:50:00,1.23,0.95,1.10,236,223,218,37,21,16,36,17,19,23,14,9,+4,+1,+3,82%,89%,73%,141,143,138,30%,32%,29%,7,2,5,3,1,2
398,https://vlr.gg/player/16852/nakya,2025-02-13 07:50:00,1.20,0.66,0.96,233,286,182,43,28,15,39,20,19,4,4,0,+1,+1,0,69%,74%,64%,155,182,120,40%,37%,46%,11,8,3,10,7,3
399,https://vlr.gg/player/1745/adrnking,2025-02-13 07:50:00,0.85,0.95,0.90,138,113,183,24,11,13,30,15,15,28,16,12,-5,-2,-3,76%,81%,68%,94,76,116,37%,35%,39%,0,0,0,5,2,3
400,https://vlr.gg/player/42755/shu,2025-02-13 06:55:00,1.57,0.89,1.23,236,254,218,40,23,17,32,12,20,23,12,11,+1,+2,-1,81%,79%,83%,138,136,139,32%,28%,36%,7,3,4,6,1,5
401,https://vlr.gg/player/34926/oonzmlp,2025-02-13 06:55:00,1.25,0.98,1.11,206,255,157,37,23,14,30,15,15,15,5,10,-1,0,-1,77%,79%,75%,134,171,98,38%,40%,35%,3,2,1,4,2,2
402,https://vlr.gg/player/37532/zexy,2025-02-13 06:55:00,0.82,1.38,1.10,233,169,298,39,12,27,36,16,20,18,11,7,+4,+1,+3,75%,71%,79%,161,118,204,23%,21%,24%,10,5,5,6,4,2
403,https://vlr.gg/player/4426/klaus,2025-02-13 06:55:00,1.23,0.86,1.04,226,272,180,38,23,15,35,17,18,9,3,6,0,+2,-2,71%,71%,71%,146,179,113,33%,39%,25%,4,3,1,4,1,3
404,https://vlr.gg/player/2149/c1nder,2025-02-13 06:55:00,0.74,1.16,0.95,141,97,186,24,6,18,26,12,14,12,9,3,-2,-1,-1,71%,75%,67%,101,72,130,21%,14%,25%,1,1,0,3,2,1
405,https://vlr.gg/player/25053/wolverine,2025-02-13 06:55:00,1.45,0.81,1.13,230,300,161,40,26,14,35,17,18,7,4,3,-3,0,-3,67%,71%,63%,150,180,120,35%,33%,37%,3,2,1,6,2,4
406,https://vlr.gg/player/9221/kanade,2025-02-13 06:55:00,1.36,0.83,1.10,239,303,176,40,26,14,36,18,18,7,6,1,+5,+2,+3,65%,67%,63%,139,173,106,27%,27%,26%,12,7,5,7,5,2
407,https://vlr.gg/player/9236/manggong,2025-02-13 06:55:00,0.98,0.95,0.97,213,228,198,33,19,14,36,19,17,32,20,12,-1,+1,-2,73%,83%,63%,128,128,129,26%,24%,30%,3,2,1,4,1,3
408,https://vlr.gg/player/20879/sungjin,2025-02-13 06:55:00,0.58,1.07,0.83,160,124,196,27,10,17,35,19,16,9,5,4,-2,-2,0,77%,79%,75%,110,94,126,17%,16%,19%,3,1,2,5,3,2
409,https://vlr.gg/player/4657/moves,2025-02-13 06:55:00,0.44,0.76,0.60,121,75,168,19,6,13,36,18,18,15,10,5,-1,+1,-2,65%,67%,63%,84,46,121,37%,24%,46%,2,1,1,3,0,3
410,https://vlr.gg/player/41701/ki1wsy,2025-02-13 06:00:00,0.48,1.71,1.00,218,128,379,24,6,18,26,16,10,6,4,2,0,-1,+1,64%,53%,79%,156,92,243,35%,36%,33%,2,0,2,2,1,1
411,https://vlr.gg/player/41694/endoist,2025-02-13 06:00:00,0.68,1.03,0.83,190,164,223,22,11,11,27,17,10,3,1,2,-1,-4,+3,58%,47%,71%,118,99,144,45%,45%,45%,10,4,6,11,8,3
412,https://vlr.gg/player/20623/harddora,2025-02-13 06:00:00,0.66,1.03,0.82,179,186,183,21,12,9,26,18,8,4,1,3,+1,0,+1,70%,63%,79%,122,128,114,29%,29%,29%,2,1,1,1,1,0
413,https://vlr.gg/player/17303/fontuz,2025-02-13 06:00:00,0.84,0.46,0.67,141,196,61,15,12,3,26,17,9,5,4,1,0,0,0,70%,74%,64%,92,125,46,25%,24%,30%,0,0,0,0,0,0
414,https://vlr.gg/player/31537/basbabe,2025-02-13 06:00:00,0.40,0.80,0.57,118,116,121,12,6,6,26,18,8,11,6,5,-3,-2,-1,67%,68%,64%,72,68,78,31%,38%,24%,1,1,0,4,3,1
415,https://vlr.gg/player/13784/killua,2025-02-13 06:00:00,0.99,1.75,1.43,257,150,303,30,8,22,17,8,9,13,5,8,+2,+2,0,73%,64%,79%,152,81,204,53%,40%,58%,4,2,2,2,0,2
416,https://vlr.gg/player/27254/leviathan,2025-02-13 06:00:00,1.56,1.25,1.38,238,236,255,30,13,17,18,7,11,12,3,9,+2,+1,+1,82%,79%,84%,166,171,163,32%,38%,27%,4,1,3,2,0,2
417,https://vlr.gg/player/27244/seph1roth,2025-02-13 06:00:00,0.78,1.42,1.15,195,140,248,25,8,17,18,8,10,10,0,10,0,-4,+4,82%,64%,95%,133,93,162,30%,42%,26%,5,0,5,5,4,1
418,https://vlr.gg/player/23930/potter,2025-02-13 06:00:00,0.71,1.40,1.11,279,224,298,31,10,21,25,13,12,6,2,4,+1,-1,+2,79%,64%,89%,172,142,194,35%,50%,26%,5,2,3,4,3,1
419,https://vlr.gg/player/8582/laz,2025-02-13 06:00:00,0.56,1.18,0.92,134,150,115,15,6,9,16,11,5,12,5,7,-2,-2,0,82%,64%,95%,88,101,79,19%,26%,13%,0,0,0,2,2,0
420,https://vlr.gg/player/13000/redlight,2025-02-13 03:00:00,2.32,1.28,1.90,338,393,256,26,18,8,11,6,5,10,8,2,0,0,0,75%,83%,63%,211,269,125,21%,23%,16%,2,1,1,2,1,1
421,https://vlr.gg/player/4127/felix,2025-02-13 03:00:00,0.86,1.42,1.11,208,175,256,47,22,25,44,26,18,21,11,10,+5,0,+5,76%,67%,87%,143,119,171,22%,17%,28%,8,2,6,3,2,1
422,https://vlr.gg/player/25082/rico,2025-02-13 03:00:00,1.04,1.08,1.06,180,176,181,27,14,13,31,18,13,26,15,11,-2,0,-2,74%,79%,68%,116,113,120,20%,21%,19%,4,2,2,6,2,4
423,https://vlr.gg/player/4038/bangnan,2025-02-13 03:00:00,1.01,1.03,1.02,214,216,213,54,29,25,47,26,21,6,3,3,-6,-5,-1,65%,64%,67%,142,146,136,35%,35%,34%,10,5,5,16,10,6
424,https://vlr.gg/player/34727/kayle,2025-02-13 03:00:00,1.00,0.75,0.89,169,203,128,38,25,13,49,27,22,32,15,17,-1,0,-1,73%,81%,63%,108,134,77,17%,20%,11%,2,2,0,3,2,1
425,https://vlr.gg/player/25089/cabeza,2025-02-13 03:00:00,0.66,1.10,0.86,185,140,240,38,15,23,48,27,21,32,13,19,0,+1,-1,68%,64%,73%,129,98,167,21%,21%,20%,5,4,1,5,3,2
426,https://vlr.gg/player/50826/ramgi,2025-02-13 03:00:00,1.13,1.22,1.18,263,277,255,62,28,34,50,25,25,15,8,7,+4,+3,+1,73%,70%,75%,171,173,170,23%,19%,29%,13,8,5,9,5,4
427,https://vlr.gg/player/50827/gnadel,2025-02-13 03:00:00,1.19,0.89,1.03,200,236,169,48,26,22,44,19,25,9,1,8,-1,-1,0,68%,57%,78%,142,170,119,28%,33%,24%,5,1,4,6,2,4
428,https://vlr.gg/player/4475/benecia,2025-02-13 03:00:00,1.02,1.02,1.02,178,186,173,42,21,21,41,20,21,31,15,16,-1,+1,-2,80%,73%,86%,108,116,101,19%,24%,17%,4,3,1,5,2,3
429,https://vlr.gg/player/25017/ash,2025-02-13 03:00:00,0.76,1.08,0.93,180,145,214,44,15,29,47,20,27,18,11,7,+4,-1,+5,77%,70%,83%,125,100,146,26%,22%,30%,8,2,6,4,3,1
430,https://vlr.gg/player/9192/cloudy,2025-02-13 03:00:00,0.46,0.91,0.70,149,95,194,34,10,24,49,23,26,17,6,11,-2,-2,0,73%,70%,75%,102,68,131,29%,25%,31%,5,1,4,7,3,4
431,https://vlr.gg/player/37901/aluvily,2025-02-12 19:50:00,1.52,1.89,1.69,328,294,366,41,20,21,16,8,8,3,0,3,0,-1,+1,81%,88%,73%,211,199,225,37%,35%,40%,2,0,2,2,1,1
432,https://vlr.gg/player/17950/avery,2025-02-12 19:50:00,1.10,1.89,1.47,220,170,288,28,10,18,14,9,5,17,7,10,+4,+2,+2,91%,88%,93%,143,119,169,24%,22%,26%,5,3,2,1,1,0
433,https://vlr.gg/player/30395/edith,2025-02-12 19:50:00,1.51,1.36,1.44,315,352,267,36,21,15,21,12,9,3,1,2,+7,+4,+3,84%,82%,87%,207,221,190,29%,27%,32%,8,5,3,1,1,0
434,https://vlr.gg/player/28535/misu,2025-02-12 19:50:00,1.19,1.10,1.15,177,169,191,20,11,9,19,10,9,16,7,9,+4,+2,+2,94%,100%,87%,136,135,137,31%,44%,22%,5,2,3,1,0,1
435,https://vlr.gg/player/25400/riv,2025-02-12 19:50:00,1.08,0.70,0.90,161,174,144,18,11,7,16,6,10,5,2,3,+3,0,+3,81%,82%,80%,98,109,87,24%,22%,26%,5,2,3,2,2,0
436,https://vlr.gg/player/15592/angel,2025-02-12 19:50:00,0.72,0.91,0.81,173,154,199,18,7,11,26,13,13,10,6,4,+2,-1,+3,72%,67%,76%,110,85,132,45%,58%,39%,3,0,3,1,1,0
437,https://vlr.gg/player/39715/cia,2025-02-12 19:50:00,0.64,0.88,0.77,168,171,158,16,7,9,26,14,12,7,4,3,-1,0,-1,59%,53%,65%,114,113,115,31%,21%,43%,0,0,0,1,0,1
438,https://vlr.gg/player/43332/aeri,2025-02-12 19:50:00,0.73,0.58,0.65,185,205,177,21,10,11,33,14,19,5,3,2,-1,0,-1,50%,53%,47%,123,129,118,42%,32%,59%,1,1,0,2,1,1
439,https://vlr.gg/player/45801/terror,2025-02-12 19:50:00,0.69,0.53,0.60,165,175,153,16,9,7,30,14,16,11,4,7,-7,-3,-4,63%,60%,65%,116,123,110,50%,53%,47%,3,1,2,10,4,6
440,https://vlr.gg/player/47144/sythrine,2025-02-12 19:50:00,0.36,0.46,0.41,137,159,123,15,8,7,29,15,14,3,2,1,-11,-7,-4,47%,33%,59%,95,113,78,30%,29%,31%,0,0,0,11,7,4
441,https://vlr.gg/player/8329/starbound,2025-02-12 19:00:00,0.98,1.26,1.12,205,185,231,48,21,27,40,22,18,7,3,4,0,-3,+3,68%,58%,77%,136,128,143,14%,24%,6%,9,4,5,9,7,2
442,https://vlr.gg/player/24237/powerpixele,2025-02-12 19:00:00,0.80,1.15,0.97,205,159,245,43,17,26,46,24,22,24,10,14,+8,+1,+7,74%,71%,77%,134,105,162,22%,23%,22%,12,3,9,4,2,2
443,https://vlr.gg/player/15039/australis,2025-02-12 19:00:00,0.86,0.94,0.90,188,186,189,40,19,21,45,24,21,21,9,12,+2,+1,+1,76%,74%,77%,126,124,129,31%,34%,28%,6,3,3,4,2,2
444,https://vlr.gg/player/38583/sleepyaria,2025-02-12 19:00:00,0.89,0.83,0.86,185,199,178,40,21,19,46,26,20,10,5,5,-4,-1,-3,63%,65%,61%,122,134,111,21%,28%,15%,3,3,0,7,4,3
445,https://vlr.gg/player/15016/joona,2025-02-12 19:00:00,0.58,1.04,0.80,171,145,198,35,15,20,47,26,21,22,8,14,-2,-1,-1,53%,45%,61%,111,96,126,24%,17%,31%,3,1,2,5,2,3
446,https://vlr.gg/player/873/bob,2025-02-12 19:00:00,1.78,1.67,1.72,328,330,336,72,35,37,37,20,17,12,7,5,+4,+1,+3,76%,77%,74%,214,206,222,21%,19%,22%,11,4,7,7,3,4
447,https://vlr.gg/player/8849/sonder,2025-02-12 19:00:00,1.16,1.47,1.31,230,230,229,51,24,27,36,22,14,36,14,22,0,0,0,79%,74%,84%,156,153,159,28%,28%,29%,3,2,1,3,2,1
448,https://vlr.gg/player/14868/karra,2025-02-12 19:00:00,0.85,1.00,0.92,171,144,190,35,16,19,42,21,21,27,12,15,+2,+1,+1,71%,68%,74%,102,85,119,39%,45%,35%,6,3,3,4,2,2
449,https://vlr.gg/player/27884/unstable,2025-02-12 19:00:00,0.52,1.26,0.89,190,117,259,41,13,28,45,26,19,13,6,7,-6,-8,+2,65%,58%,71%,123,85,160,24%,21%,26%,7,1,6,13,9,4
450,https://vlr.gg/player/11968/l4ce,2025-02-12 19:00:00,0.64,0.58,0.61,133,148,120,25,14,11,46,24,22,19,7,12,-4,-1,-3,61%,61%,61%,98,105,91,28%,22%,34%,2,2,0,6,3,3
451,https://vlr.gg/player/64/gmd,2025-02-12 18:25:00,1.09,1.00,1.05,203,195,217,30,15,15,30,16,14,13,5,8,-4,0,-4,77%,78%,76%,136,136,136,27%,34%,22%,2,1,1,6,1,5
452,https://vlr.gg/player/39602/recoil,2025-02-12 18:25:00,1.29,0.64,0.98,179,242,109,30,21,9,29,16,13,3,2,1,+1,+1,0,64%,74%,52%,118,167,65,42%,40%,47%,2,1,1,1,0,1
453,https://vlr.gg/player/20140/vora,2025-02-12 18:25:00,0.75,1.08,0.91,168,157,178,23,10,13,31,17,14,13,5,8,0,+2,-2,70%,78%,62%,123,104,143,19%,18%,20%,2,2,0,2,0,2
454,https://vlr.gg/player/8376/seven,2025-02-12 18:25:00,0.46,1.08,0.76,197,113,290,28,8,20,36,19,17,12,6,6,+2,-2,+4,70%,61%,81%,117,71,166,20%,19%,21%,7,2,5,5,4,1
455,https://vlr.gg/player/3702/sym,2025-02-12 18:25:00,0.31,1.15,0.71,202,152,262,29,10,19,41,23,18,4,2,2,-3,-6,+3,57%,48%,67%,131,99,165,19%,21%,17%,7,3,4,10,9,1
456,https://vlr.gg/player/36560/canezerra,2025-02-12 18:25:00,1.19,1.57,1.39,294,258,331,45,18,27,29,16,13,16,8,8,+4,+3,+1,84%,71%,96%,189,156,219,24%,31%,20%,8,4,4,4,1,3
457,https://vlr.gg/player/35302/eggsterr,2025-02-12 18:25:00,0.88,1.31,1.11,200,191,212,32,15,17,28,15,13,13,4,9,+2,-1,+3,75%,62%,87%,127,114,138,27%,22%,32%,7,4,3,5,5,0
458,https://vlr.gg/player/29547/ion2x,2025-02-12 18:25:00,0.88,1.24,1.07,222,214,231,36,16,20,33,17,16,22,9,13,-1,-2,+1,91%,90%,91%,148,141,155,32%,27%,37%,2,0,2,3,2,1
459,https://vlr.gg/player/53/inspire,2025-02-12 18:25:00,1.26,0.83,1.04,186,234,140,32,20,12,25,13,12,6,2,4,+1,+1,0,68%,67%,70%,116,150,84,38%,47%,28%,6,2,4,5,1,4
460,https://vlr.gg/player/21778/p0ppin,2025-02-12 18:25:00,0.56,1.24,0.92,141,98,177,22,7,15,26,15,11,19,7,12,-2,-2,0,77%,71%,83%,86,59,112,21%,12%,27%,1,0,1,3,2,1
461,https://vlr.gg/player/20959/toozy,2025-02-12 18:15:00,1.27,1.52,1.38,224,204,258,48,24,24,31,15,16,30,15,15,-2,-1,-1,86%,84%,88%,150,138,164,21%,24%,18%,1,0,1,3,1,2
462,https://vlr.gg/player/21886/furbsa,2025-02-12 18:15:00,1.35,1.05,1.22,295,309,265,58,36,22,46,24,22,13,8,5,+14,+9,+5,71%,81%,60%,185,200,165,38%,39%,38%,19,10,9,5,1,4
463,https://vlr.gg/player/14048/zerona,2025-02-12 18:15:00,1.41,0.84,1.16,214,258,149,45,30,15,39,19,20,27,19,8,0,+2,-2,86%,90%,80%,143,183,95,32%,33%,29%,4,3,1,4,1,3
464,https://vlr.gg/player/8758/benjii,2025-02-12 18:15:00,1.17,0.73,0.97,162,169,159,33,20,13,36,15,21,19,11,8,0,+2,-2,71%,71%,72%,100,94,107,30%,34%,26%,4,3,1,4,1,3
465,https://vlr.gg/player/8397/dip,2025-02-12 18:15:00,0.61,1.00,0.78,182,148,213,30,13,17,44,23,21,23,12,11,-2,-3,+1,70%,65%,76%,128,106,156,15%,15%,14%,5,4,1,7,7,0
466,https://vlr.gg/player/24553/boni,2025-02-12 18:15:00,1.24,1.14,1.18,283,324,266,55,28,27,45,21,24,16,8,8,+4,+3,+1,77%,88%,68%,191,211,175,24%,19%,30%,9,5,4,5,2,3
467,https://vlr.gg/player/3719/matt,2025-02-12 18:15:00,1.06,0.90,0.97,181,207,164,35,20,15,41,17,24,21,8,13,0,+1,-1,79%,80%,77%,123,132,115,21%,24%,19%,6,3,3,6,2,4
468,https://vlr.gg/player/893/retrq,2025-02-12 18:15:00,1.02,0.89,0.95,180,176,169,34,16,18,36,15,21,17,12,5,-4,-1,-3,71%,88%,58%,108,113,104,24%,32%,18%,1,1,0,5,2,3
469,https://vlr.gg/player/17770/alvinboy,2025-02-12 18:15:00,0.91,0.95,0.93,219,215,227,47,20,27,50,21,29,15,7,8,-5,-1,-4,79%,80%,77%,147,139,154,41%,35%,46%,3,1,2,8,2,6
470,https://vlr.gg/player/2125/nanners,2025-02-12 18:15:00,0.94,0.58,0.74,140,183,117,25,16,9,42,17,25,20,8,12,-5,-3,-2,61%,68%,55%,104,117,93,24%,22%,26%,4,2,2,9,5,4
471,https://vlr.gg/player/945/drakonz,2025-02-12 17:15:00,1.47,1.94,1.74,333,259,386,49,16,33,24,9,15,15,5,10,0,-1,+1,83%,76%,88%,229,209,243,28%,27%,29%,1,0,1,1,1,0
472,https://vlr.gg/player/37091/peixeh,2025-02-12 17:15:00,1.43,1.08,1.22,198,224,178,27,13,14,22,9,13,23,10,13,+5,+1,+4,78%,82%,75%,132,166,107,24%,39%,13%,5,1,4,0,0,0
473,https://vlr.gg/player/37098/tiezzi,2025-02-12 17:15:00,1.35,1.02,1.16,235,237,234,34,15,19,26,10,16,7,3,4,+5,+1,+4,78%,76%,79%,156,146,163,33%,48%,26%,12,4,8,7,3,4
474,https://vlr.gg/player/5722/prince,2025-02-12 17:15:00,0.66,1.30,1.04,209,131,263,32,9,23,25,12,13,18,4,14,-3,-2,-1,78%,65%,88%,124,79,157,24%,14%,29%,2,0,2,5,2,3
475,https://vlr.gg/player/2585/tinchoff,2025-02-12 17:15:00,1.08,0.80,0.92,151,182,131,22,11,11,24,11,13,10,4,6,0,0,0,78%,71%,83%,111,132,96,32%,32%,31%,4,3,1,4,3,1
476,https://vlr.gg/player/4556/txddy,2025-02-12 17:15:00,1.10,0.88,1.00,208,227,183,30,18,12,31,18,13,8,5,3,0,-1,+1,66%,67%,65%,137,157,110,29%,33%,24%,2,0,2,2,1,1
477,https://vlr.gg/player/32718/kenkayyy,2025-02-12 17:15:00,1.07,0.84,0.97,181,194,166,29,18,11,31,19,12,8,4,4,0,-1,+1,73%,71%,76%,125,136,109,36%,32%,45%,2,1,1,2,2,0
478,https://vlr.gg/player/1650/bladez,2025-02-12 17:15:00,0.74,0.98,0.84,176,157,203,23,12,11,33,20,13,18,11,7,+2,0,+2,71%,63%,82%,113,101,130,30%,28%,32%,3,1,2,1,1,0
479,https://vlr.gg/player/32802/luid,2025-02-12 17:15:00,0.74,0.63,0.70,191,201,176,27,17,10,35,21,14,7,4,3,-6,-3,-3,61%,63%,59%,119,127,108,25%,22%,31%,10,6,4,16,9,7
480,https://vlr.gg/player/15395/gbz,2025-02-12 17:15:00,0.17,0.60,0.35,97,64,140,12,5,7,34,22,12,9,7,2,-3,-3,0,51%,50%,53%,70,48,101,24%,14%,33%,0,0,0,3,3,0
481,https://vlr.gg/player/29244/mikey-tap,2025-02-12 17:00:00,1.30,1.28,1.29,219,217,210,41,22,19,31,18,13,17,9,8,+3,+1,+2,85%,75%,96%,147,148,145,35%,32%,37%,4,1,3,1,0,1
482,https://vlr.gg/player/2464/suther,2025-02-12 17:00:00,1.10,1.36,1.23,186,178,203,38,20,18,30,18,12,24,8,16,-2,-3,+1,70%,64%,77%,124,112,136,28%,33%,25%,4,2,2,6,5,1
483,https://vlr.gg/player/2468/delz1k,2025-02-12 17:00:00,0.78,1.72,1.23,251,183,335,47,17,30,37,23,14,22,10,12,-1,-1,0,74%,64%,85%,162,118,208,21%,25%,19%,3,1,2,4,2,2
484,https://vlr.gg/player/1294/nagz,2025-02-12 17:00:00,0.84,1.26,1.04,197,153,248,38,14,24,35,20,15,17,10,7,+1,0,+1,76%,75%,77%,136,110,164,31%,30%,33%,4,1,3,3,1,2
485,https://vlr.gg/player/3828/tacolilla,2025-02-12 17:00:00,0.76,0.69,0.72,145,191,115,26,16,10,40,23,17,15,8,7,-7,-3,-4,69%,64%,73%,104,124,82,23%,22%,25%,9,6,3,16,9,7
486,https://vlr.gg/player/7652/tuli,2025-02-12 17:00:00,0.77,1.39,1.09,227,189,262,45,18,27,37,21,16,3,2,1,+4,0,+4,63%,42%,82%,147,115,176,36%,35%,36%,14,6,8,10,6,4
487,https://vlr.gg/player/2909/alca,2025-02-12 17:00:00,0.96,1.08,1.02,221,192,244,44,18,26,39,18,21,12,6,6,+1,0,+1,70%,65%,75%,142,130,154,42%,39%,46%,5,2,3,4,2,2
488,https://vlr.gg/player/43935/ruso,2025-02-12 17:00:00,0.84,1.03,0.94,207,189,221,37,15,22,38,20,18,16,5,11,+2,-1,+3,70%,69%,71%,142,141,143,25%,24%,27%,7,3,4,5,4,1
489,https://vlr.gg/player/2931/vaiz,2025-02-12 17:00:00,0.76,0.82,0.79,138,153,136,25,13,12,35,20,15,19,7,12,-1,+1,-2,69%,62%,75%,98,100,95,21%,19%,23%,3,2,1,4,1,3
490,https://vlr.gg/player/8278/knzy,2025-02-12 17:00:00,0.44,0.72,0.59,119,94,143,22,7,15,41,22,19,27,13,14,0,0,0,61%,58%,64%,83,72,94,17%,14%,20%,1,0,1,1,0,1
491,https://vlr.gg/player/32667/nora,2025-02-12 17:00:00,1.32,1.97,1.67,289,217,356,46,15,31,25,11,14,15,9,6,+3,+1,+2,86%,85%,88%,197,151,235,33%,26%,36%,4,2,2,1,1,0
492,https://vlr.gg/player/33694/evv,2025-02-12 17:00:00,1.30,1.23,1.26,216,187,241,32,13,19,26,9,17,22,8,14,0,-2,+2,86%,95%,79%,142,132,151,33%,36%,30%,2,0,2,2,2,0
493,https://vlr.gg/player/28870/k0rupt,2025-02-12 17:00:00,1.28,1.07,1.17,235,244,228,38,19,19,32,14,18,25,10,15,-3,-3,0,73%,70%,75%,155,156,153,43%,38%,49%,3,0,3,6,3,3
494,https://vlr.gg/player/19556/melya,2025-02-12 17:00:00,1.44,0.88,1.14,240,293,197,38,21,17,31,12,19,7,3,4,+4,+2,+2,73%,75%,71%,152,186,124,29%,29%,31%,10,5,5,6,3,3
495,https://vlr.gg/player/14403/marceline,2025-02-12 17:00:00,1.91,0.55,1.13,237,346,156,18,12,6,16,5,11,3,2,1,-4,0,-4,67%,78%,58%,154,232,96,31%,29%,33%,2,2,0,6,2,4
496,https://vlr.gg/player/25246/bunnybee,2025-02-12 17:00:00,0.51,0.29,0.40,77,117,40,5,4,1,16,8,8,4,0,4,-2,0,-2,65%,64%,67%,54,81,30,31%,33%,25%,0,0,0,2,0,2
497,https://vlr.gg/player/8414/icee,2025-02-12 17:00:00,1.43,0.68,1.09,247,297,197,39,26,13,34,16,18,4,1,3,+3,+2,+1,73%,79%,65%,164,194,128,30%,25%,37%,9,5,4,6,3,3
498,https://vlr.gg/player/6575/aniemal,2025-02-12 17:00:00,1.13,0.89,1.02,227,260,187,32,20,12,33,18,15,20,10,10,+2,0,+2,80%,83%,75%,155,170,137,21%,21%,21%,4,2,2,2,2,0
499,https://vlr.gg/player/17982/lunafox,2025-02-12 17:00:00,0.93,0.84,0.89,207,215,193,35,20,15,34,19,15,7,3,4,+2,+3,-1,80%,79%,80%,131,149,108,31%,38%,22%,5,3,2,3,0,3
500,https://vlr.gg/player/25514/cyn,2025-02-12 17:00:00,0.54,0.50,0.52,145,142,148,20,12,8,38,19,19,11,6,5,+1,0,+1,64%,79%,45%,100,97,103,28%,34%,21%,2,1,1,1,1,0
501,https://vlr.gg/player/6329/sliicyy,2025-02-12 17:00:00,0.35,0.68,0.44,138,111,170,20,9,11,38,21,17,5,3,2,-6,-5,-1,45%,46%,45%,96,77,119,17%,19%,16%,3,1,2,9,6,3
0,https://vlr.gg/player/42426/kora,2025-02-12 17:00:00,0.91,1.21,1.03,230,234,244,51,28,23,52,34,18,9,6,3,0,-5,+5,71%,68%,77%,151,145,159,45%,48%,40%,10,4,6,10,9,1
1,https://vlr.gg/player/43330/angle,2025-02-12 17:00:00,0.82,1.17,0.96,174,153,199,39,21,18,42,29,13,19,5,14,0,-1,+1,73%,65%,85%,115,100,135,17%,19%,15%,2,0,2,2,1,1
2,https://vlr.gg/player/41357/aus,2025-02-12 17:00:00,0.77,1.09,0.91,180,181,196,41,23,18,47,32,15,20,8,12,-4,-3,-1,70%,65%,77%,114,108,121,32%,44%,21%,4,2,2,8,5,3
3,https://vlr.gg/player/28561/abbie2k,2025-02-12 17:00:00,0.64,1.15,0.85,194,165,239,40,18,22,52,34,18,14,10,4,-9,-10,+1,65%,54%,81%,130,117,148,24%,25%,22%,4,0,4,13,10,3
4,https://vlr.gg/player/45338/cohs,2025-02-12 17:00:00,0.61,0.94,0.75,167,165,176,37,19,18,53,36,17,21,14,7,-6,-4,-2,71%,70%,73%,106,106,105,28%,24%,33%,2,1,1,8,5,3
5,https://vlr.gg/player/28546/venus,2025-02-12 17:00:00,0.96,1.58,1.33,251,194,286,58,19,39,40,21,19,13,3,10,+7,-2,+9,81%,69%,89%,161,142,174,32%,29%,34%,12,3,9,5,5,0
6,https://vlr.gg/player/28530/calsushi,2025-02-12 17:00:00,0.89,1.50,1.25,250,184,297,55,16,39,40,19,21,27,5,22,+2,0,+2,83%,81%,84%,171,124,204,25%,28%,24%,5,1,4,3,1,2
7,https://vlr.gg/player/30790/kestrel,2025-02-12 17:00:00,0.92,1.18,1.07,185,165,189,40,14,26,39,18,21,22,7,15,+5,0,+5,84%,73%,92%,126,116,134,32%,37%,29%,6,1,5,1,1,0
8,https://vlr.gg/player/37920/oranges,2025-02-12 17:00:00,0.95,1.06,1.01,215,215,216,50,21,29,43,19,24,19,1,18,+3,-1,+4,75%,65%,81%,130,135,127,23%,34%,19%,11,3,8,8,4,4
9,https://vlr.gg/player/43380/aria,2025-02-12 17:00:00,0.67,1.19,0.97,214,165,240,43,11,32,46,22,24,41,12,29,+2,-1,+3,83%,73%,89%,137,112,155,16%,21%,13%,7,3,4,5,4,1
10,https://vlr.gg/player/29076/satellite,2025-02-12 16:00:00,0.70,1.14,0.91,209,190,232,31,14,17,33,20,13,5,2,3,-3,-6,+3,55%,41%,70%,121,107,137,20%,18%,22%,9,3,6,12,9,3
11,https://vlr.gg/player/13084/smiley,2025-02-12 16:00:00,0.58,1.16,0.85,167,141,193,27,11,16,32,20,12,7,2,5,0,-2,+2,67%,55%,80%,107,85,131,39%,43%,35%,3,0,3,3,2,1
12,https://vlr.gg/player/8286/glyph,2025-02-12 16:00:00,0.84,0.83,0.84,161,172,147,21,12,9,30,17,13,17,8,9,-2,-2,0,62%,59%,65%,109,118,99,19%,23%,13%,1,0,1,3,2,1
13,https://vlr.gg/player/4931/add3r,2025-02-12 16:00:00,0.81,0.85,0.83,175,157,199,25,13,12,34,18,16,11,3,8,0,-2,+2,57%,59%,55%,122,106,141,36%,37%,35%,5,2,3,5,4,1
14,https://vlr.gg/player/3227/screwface,2025-02-12 16:00:00,0.41,1.09,0.74,139,107,176,20,7,13,31,19,12,11,3,8,-1,0,-1,55%,36%,75%,97,80,116,13%,4%,21%,0,0,0,1,0,1
15,https://vlr.gg/player/6437/dark3st,2025-02-12 16:00:00,1.14,1.37,1.26,240,217,259,33,15,18,25,14,11,19,6,13,+4,0,+4,71%,70%,73%,139,128,149,16%,12%,20%,5,1,4,1,1,0
16,https://vlr.gg/player/754/nerve,2025-02-12 16:00:00,0.98,1.37,1.18,213,176,247,33,13,20,25,13,12,15,7,8,-3,-2,-1,83%,75%,91%,140,114,164,31%,24%,35%,1,1,0,4,3,1
17,https://vlr.gg/player/5093/logan,2025-02-12 16:00:00,1.35,0.97,1.15,190,203,176,27,15,12,23,11,12,10,3,7,+5,+3,+2,79%,75%,82%,127,138,117,27%,44%,16%,5,3,2,0,0,0
18,https://vlr.gg/player/21878/snarly,2025-02-12 16:00:00,0.60,1.59,1.12,203,123,271,34,9,25,22,14,8,3,2,1,-1,-3,+2,71%,55%,86%,138,83,189,53%,53%,53%,4,1,3,5,4,1
19,https://vlr.gg/player/29893/timotino,2025-02-12 16:00:00,0.74,1.08,0.92,221,194,249,33,14,19,29,15,14,4,0,4,+1,-4,+5,67%,50%,82%,132,114,149,23%,36%,16%,9,1,8,8,5,3
20,https://vlr.gg/player/17865/nahsie,2025-02-12 16:00:00,1.13,1.22,1.18,219,227,212,34,16,18,31,14,17,16,7,9,+2,-1,+3,76%,72%,79%,139,157,127,25%,33%,19%,5,1,4,3,2,1
21,https://vlr.gg/player/9063/infiltrator,2025-02-12 16:00:00,1.24,0.76,0.97,229,269,199,31,17,14,33,13,20,7,1,6,+4,+2,+2,74%,83%,67%,145,147,143,20%,34%,11%,9,5,4,5,3,2
22,https://vlr.gg/player/9837/flare,2025-02-12 16:00:00,0.81,1.02,0.93,200,177,221,26,9,17,32,15,17,17,12,5,-4,-3,-1,62%,56%,67%,141,119,158,28%,21%,33%,2,0,2,6,3,3
23,https://vlr.gg/player/9017/moobs,2025-02-12 16:00:00,0.81,0.90,0.86,171,182,161,24,11,13,29,14,15,6,4,2,+2,+2,0,69%,72%,67%,108,108,108,28%,28%,28%,5,2,3,3,0,3
24,https://vlr.gg/player/765/jerk,2025-02-12 16:00:00,0.31,0.93,0.66,137,96,166,17,4,13,32,16,16,9,6,3,0,0,0,57%,56%,58%,99,76,117,17%,10%,21%,2,1,1,2,1,1
25,https://vlr.gg/player/8422/spaz,2025-02-12 16:00:00,1.42,1.69,1.54,277,264,298,42,22,20,24,14,10,25,14,11,0,+3,-3,86%,88%,83%,179,173,188,26%,28%,23%,4,3,1,4,0,4
26,https://vlr.gg/player/2164/paincakes,2025-02-12 16:00:00,1.11,1.59,1.31,248,224,276,39,21,18,26,16,10,7,1,6,+3,+1,+2,74%,71%,78%,165,152,182,26%,32%,21%,5,2,3,2,1,1
27,https://vlr.gg/player/2172/brawk,2025-02-12 16:00:00,1.16,1.17,1.16,196,178,220,31,17,14,23,11,12,11,5,6,0,0,0,81%,83%,78%,130,115,150,10%,18%,4%,1,1,0,1,1,0
28,https://vlr.gg/player/864/bcj,2025-02-12 16:00:00,0.75,0.84,0.79,137,118,165,17,9,8,27,15,12,33,16,17,-1,-1,0,81%,75%,89%,86,73,103,13%,12%,14%,2,0,2,3,1,2
29,https://vlr.gg/player/23407/pa1nt,2025-02-12 16:00:00,0.72,0.67,0.70,173,201,136,26,16,10,32,19,13,5,3,2,-6,-7,+1,67%,63%,72%,109,132,79,23%,24%,20%,7,4,3,13,11,2
30,https://vlr.gg/player/1944/cayden,2025-02-12 15:35:00,1.26,0.39,0.97,186,237,83,23,20,3,28,18,10,12,10,2,+1,+1,0,69%,79%,50%,112,146,43,36%,43%,8%,2,2,0,1,1,0
31,https://vlr.gg/player/2190/baddyg,2025-02-12 15:35:00,0.88,0.59,0.77,178,182,172,22,14,8,32,20,12,16,16,0,-4,-2,-2,64%,79%,33%,107,112,97,16%,14%,21%,2,1,1,6,3,3
32,https://vlr.gg/player/8226/waddle,2025-02-12 15:35:00,0.72,0.65,0.70,172,170,180,21,15,6,32,21,11,7,5,2,-2,-2,0,69%,71%,67%,116,114,121,38%,39%,36%,0,0,0,2,2,0
33,https://vlr.gg/player/12474/tag,2025-02-12 15:35:00,0.68,0.53,0.63,158,165,151,20,13,7,29,19,10,5,5,0,-5,-3,-2,56%,54%,58%,101,104,96,25%,22%,32%,3,2,1,8,5,3
34,https://vlr.gg/player/1470/simond4rk,2025-02-12 15:35:00,0.70,0.35,0.58,168,201,98,19,16,3,33,22,11,11,6,5,-4,-2,-2,69%,79%,50%,98,118,58,11%,12%,7%,4,3,1,8,5,3
35,https://vlr.gg/player/16209/famsii,2025-02-12 15:35:00,2.64,1.31,1.75,289,420,220,39,20,19,17,3,14,8,2,6,+7,+3,+4,86%,100%,79%,195,263,161,28%,41%,20%,9,3,6,2,0,2
36,https://vlr.gg/player/1524/h1ber,2025-02-12 15:35:00,0.97,1.57,1.37,225,128,278,31,6,25,18,5,13,8,2,6,+1,+2,-1,94%,92%,96%,167,98,202,43%,38%,44%,3,2,1,2,0,2
37,https://vlr.gg/player/29972/michel,2025-02-12 15:35:00,1.17,1.43,1.34,299,246,326,40,11,29,28,9,19,9,3,6,+3,0,+3,78%,67%,83%,206,180,219,39%,52%,35%,6,2,4,3,2,1
38,https://vlr.gg/player/8805/sacake,2025-02-12 15:35:00,1.28,0.90,1.03,179,163,185,24,7,17,21,4,17,19,8,11,+2,0,+2,81%,92%,75%,102,98,105,21%,12%,26%,4,0,4,2,0,2
39,https://vlr.gg/player/18162/serial,2025-02-12 15:35:00,1.24,0.75,0.91,156,217,124,20,10,10,21,6,15,11,2,9,+1,+1,0,78%,92%,71%,110,154,88,47%,45%,48%,3,2,1,2,1,1
40,https://vlr.gg/player/25858/sw,2025-02-12 15:00:00,1.84,1.80,1.81,300,310,289,34,20,14,13,7,6,12,3,9,+2,+1,+1,90%,100%,79%,202,194,210,37%,36%,38%,3,2,1,1,1,0
41,https://vlr.gg/player/41224/tkzin,2025-02-12 15:00:00,1.46,1.87,1.65,307,290,320,34,17,17,15,9,6,11,6,5,+10,+4,+6,97%,94%,100%,186,191,180,25%,30%,19%,11,5,6,1,1,0
42,https://vlr.gg/player/2567/liazzi,2025-02-12 15:00:00,1.91,1.04,1.50,212,263,151,25,17,8,9,3,6,13,5,8,-3,0,-3,93%,100%,86%,139,175,97,28%,29%,26%,1,1,0,4,1,3
43,https://vlr.gg/player/1578/shion,2025-02-12 15:00:00,1.04,1.66,1.33,215,202,229,25,12,13,16,11,5,18,12,6,0,-2,+2,93%,88%,100%,147,134,162,24%,24%,23%,2,0,2,2,2,0
44,https://vlr.gg/player/2486/pollo,2025-02-12 15:00:00,1.13,0.91,1.03,169,164,180,18,10,8,16,7,9,8,3,5,+1,+1,0,90%,88%,93%,121,102,143,29%,38%,24%,3,2,1,2,1,1
45,https://vlr.gg/player/1605/champzera,2025-02-12 15:00:00,1.08,0.46,0.75,165,242,106,17,11,6,25,11,14,3,2,1,-3,0,-3,50%,64%,38%,116,166,72,31%,44%,14%,1,0,1,4,0,4
46,https://vlr.gg/player/1595/myssen,2025-02-12 15:00:00,0.70,0.48,0.58,159,162,155,17,8,9,27,11,16,3,2,1,-2,-1,-1,63%,57%,69%,91,90,91,44%,54%,37%,1,0,1,3,1,2
47,https://vlr.gg/player/32675/kring,2025-02-12 15:00:00,0.34,0.76,0.56,147,91,191,14,5,9,28,13,15,6,2,4,-1,-2,+1,50%,29%,69%,95,55,129,33%,31%,34%,2,1,1,3,3,0
48,https://vlr.gg/player/20251/vit9ine,2025-02-12 15:00:00,0.70,0.35,0.51,104,111,102,11,5,6,26,11,15,3,1,2,0,0,0,43%,43%,44%,76,96,59,27%,29%,25%,0,0,0,0,0,0
49,https://vlr.gg/player/14944/ind1n,2025-02-12 15:00:00,0.05,0.28,0.16,103,74,128,10,3,7,30,14,16,3,2,1,-4,-3,-1,50%,50%,50%,70,48,89,15%,6%,21%,6,3,3,10,6,4
50,https://vlr.gg/player/1567/bezn1,2025-02-12 15:00:00,1.03,1.34,1.17,231,207,260,51,25,26,46,27,19,20,9,11,+7,+4,+3,80%,75%,87%,151,127,180,32%,29%,35%,9,5,4,2,1,1
51,https://vlr.gg/player/32717/maestr0,2025-02-12 15:00:00,1.05,1.18,1.11,231,244,217,59,32,27,50,29,21,11,7,4,+1,0,+1,71%,67%,77%,142,149,133,34%,36%,30%,12,7,5,11,7,4
52,https://vlr.gg/player/5351/rglmeister,2025-02-12 15:00:00,0.93,1.25,1.08,177,155,206,43,19,24,39,23,16,18,12,6,+2,+1,+1,76%,72%,80%,119,111,128,27%,24%,32%,6,2,4,4,1,3
53,https://vlr.gg/player/1566/prozin,2025-02-12 15:00:00,0.95,1.05,1.00,195,178,209,46,21,25,42,23,19,18,13,5,+3,+2,+1,76%,75%,77%,128,118,140,32%,26%,39%,6,4,2,3,2,1
54,https://vlr.gg/player/6238/urango,2025-02-12 15:00:00,0.75,1.09,0.91,188,158,225,42,19,23,47,27,20,25,11,14,-3,-1,-2,71%,64%,80%,125,106,148,35%,32%,38%,5,3,2,8,4,4
55,https://vlr.gg/player/25683/desire,2025-02-12 15:00:00,1.27,0.90,1.07,209,251,178,48,27,21,48,23,25,11,5,6,-4,-1,-3,70%,77%,64%,145,158,133,28%,27%,30%,8,4,4,12,5,7
56,https://vlr.gg/player/15361/swag,2025-02-12 15:00:00,0.65,1.33,1.02,198,147,236,47,15,32,46,24,22,18,6,12,+1,-1,+2,68%,57%,78%,128,93,158,28%,24%,30%,3,1,2,2,2,0
57,https://vlr.gg/player/46568/above,2025-02-12 15:00:00,0.78,1.19,1.00,193,181,216,47,19,28,46,25,21,18,8,10,-1,0,-1,76%,73%,78%,133,130,136,39%,34%,43%,4,2,2,5,2,3
58,https://vlr.gg/player/36106/skz,2025-02-12 15:00:00,0.43,1.25,0.88,176,141,199,40,14,26,47,28,19,18,8,10,-3,-2,-1,70%,60%,78%,117,91,138,31%,38%,27%,4,1,3,7,3,4
59,https://vlr.gg/player/37105/loss,2025-02-12 15:00:00,0.81,0.68,0.74,185,193,178,41,20,21,54,25,29,10,5,5,-3,0,-3,58%,53%,61%,123,124,121,28%,32%,25%,9,5,4,12,5,7
60,https://vlr.gg/player/35665/miyeon,2025-02-12 14:00:00,0.83,1.42,1.07,228,187,294,49,23,26,44,28,16,9,5,4,-1,-2,+1,67%,60%,76%,144,121,176,26%,26%,25%,9,5,4,10,7,3
61,https://vlr.gg/player/11046/deigara,2025-02-12 14:00:00,1.06,0.75,0.93,171,201,134,38,26,12,43,27,16,18,14,4,-2,0,-2,67%,69%,64%,111,124,93,30%,33%,24%,1,1,0,3,1,2
62,https://vlr.gg/player/3677/fross,2025-02-12 14:00:00,0.75,0.80,0.77,155,166,140,33,19,14,45,28,17,24,15,9,-3,-2,-1,62%,60%,64%,100,112,83,29%,31%,26%,3,2,1,6,4,2
63,https://vlr.gg/player/39154/kimb0,2025-02-12 14:00:00,0.69,0.87,0.76,158,149,187,34,19,15,46,27,19,8,3,5,-4,-4,0,47%,40%,56%,106,97,118,24%,29%,21%,5,2,3,9,6,3
64,https://vlr.gg/player/46082/jcz,2025-02-12 14:00:00,0.69,0.71,0.70,161,167,161,34,19,15,50,31,19,17,12,5,-6,-5,-1,62%,69%,52%,115,119,110,27%,30%,24%,4,1,3,10,6,4
65,https://vlr.gg/player/2818/neto,2025-02-12 14:00:00,0.99,1.71,1.41,319,250,353,64,20,44,42,21,21,11,6,5,+12,+2,+10,77%,64%,86%,203,166,230,24%,31%,20%,22,8,14,10,6,4
66,https://vlr.gg/player/1291/bnj,2025-02-12 14:00:00,1.28,1.32,1.30,217,195,230,48,18,30,32,13,19,24,10,14,+5,+2,+3,85%,80%,89%,132,116,143,24%,30%,21%,7,2,5,2,0,2
67,https://vlr.gg/player/2403/mizu,2025-02-12 14:00:00,1.33,1.05,1.16,185,227,174,43,22,21,35,15,20,12,6,6,-2,-1,-1,68%,72%,66%,131,140,124,38%,45%,33%,4,2,2,6,3,3
68,https://vlr.gg/player/2586/hanling,2025-02-12 14:00:00,0.85,1.28,1.10,187,128,232,42,12,30,39,16,23,29,11,18,+4,+1,+3,75%,68%,80%,115,77,142,24%,28%,23%,4,1,3,0,0,0
69,https://vlr.gg/player/15916/jotinha,2025-02-12 14:00:00,0.81,0.65,0.71,137,141,119,29,13,16,40,17,23,16,7,9,-3,-1,-2,72%,72%,71%,84,87,82,26%,23%,29%,1,1,0,4,2,2
70,https://vlr.gg/player/24344/loita,2025-02-12 13:30:00,1.59,1.64,1.61,280,294,273,38,22,16,21,12,9,23,8,15,-3,-2,-1,86%,80%,94%,179,187,171,40%,42%,36%,3,1,2,6,3,3
71,https://vlr.gg/player/40591/comeback,2025-02-12 13:30:00,1.54,1.30,1.43,282,327,226,40,25,15,22,14,8,5,2,3,+2,+2,0,78%,85%,71%,178,198,153,30%,29%,32%,7,4,3,5,2,3
72,https://vlr.gg/player/31305/lar0k,2025-02-12 13:30:00,0.88,1.44,1.14,177,123,243,23,7,16,19,10,9,19,10,9,0,0,0,81%,75%,88%,117,83,156,25%,19%,30%,2,1,1,2,1,1
73,https://vlr.gg/player/5565/ros,2025-02-12 13:30:00,0.89,1.35,1.10,211,171,259,30,13,17,22,12,10,14,6,8,-4,-3,-1,84%,80%,88%,126,89,171,15%,13%,17%,2,1,1,6,4,2
74,https://vlr.gg/player/12795/crewen,2025-02-12 13:30:00,0.95,0.91,0.93,188,198,174,23,12,11,23,14,9,9,6,3,-2,-1,-1,68%,65%,71%,126,130,121,29%,28%,30%,1,1,0,3,2,1
75,https://vlr.gg/player/11516/drky,2025-02-12 13:30:00,0.74,1.14,0.96,198,151,233,25,9,16,29,15,14,11,5,6,+3,0,+3,68%,65%,70%,114,83,140,21%,30%,17%,4,0,4,1,0,1
76,https://vlr.gg/player/10114/baha,2025-02-12 13:30:00,0.90,0.83,0.85,223,214,236,29,12,17,33,15,18,9,4,5,0,-1,+1,59%,47%,70%,145,144,146,38%,33%,41%,3,1,2,3,2,1
77,https://vlr.gg/player/16483/gloomy,2025-02-12 13:30:00,0.43,1.02,0.75,159,106,201,19,6,13,29,15,14,10,4,6,-1,-1,0,68%,65%,70%,106,75,133,23%,33%,20%,1,0,1,2,1,1
78,https://vlr.gg/player/12226/sturnn,2025-02-12 13:30:00,0.76,0.60,0.67,113,110,123,15,7,8,29,14,15,6,4,2,0,0,0,62%,59%,65%,88,85,90,37%,39%,36%,1,0,1,1,0,1
79,https://vlr.gg/player/21584/deminatix,2025-02-12 13:30:00,0.66,0.42,0.53,144,194,111,19,11,8,34,16,18,3,1,2,+5,+5,0,51%,59%,45%,92,115,73,29%,31%,27%,13,9,4,8,4,4
80,https://vlr.gg/player/8502/olizera,2025-02-12 13:20:00,1.53,0.81,1.15,218,266,167,34,20,14,29,10,19,15,8,7,+5,+4,+1,79%,82%,76%,145,174,119,29%,34%,23%,8,5,3,3,1,2
81,https://vlr.gg/player/38424/zachkappa,2025-02-12 13:20:00,1.42,0.90,1.14,235,245,214,38,21,17,31,10,21,6,3,3,+5,+6,-1,70%,82%,60%,144,152,137,24%,17%,30%,7,6,1,2,0,2
82,https://vlr.gg/player/5199/guardy,2025-02-12 13:20:00,1.42,0.64,1.01,168,201,147,27,15,12,31,8,23,23,16,7,+1,+2,-1,68%,91%,48%,110,118,102,30%,31%,29%,5,2,3,4,0,4
83,https://vlr.gg/player/22154/pika,2025-02-12 13:20:00,0.90,0.68,0.79,136,131,150,24,12,12,31,10,21,7,2,5,0,+2,-2,72%,82%,64%,100,90,109,38%,47%,33%,6,4,2,6,2,4
84,https://vlr.gg/player/3127/monsteerr,2025-02-12 13:20:00,1.06,0.52,0.77,151,203,113,25,15,10,33,12,21,8,6,2,0,+2,-2,60%,77%,44%,104,136,76,20%,24%,15%,3,2,1,3,0,3
85,https://vlr.gg/player/2534/lowel,2025-02-12 13:20:00,1.54,0.66,1.13,160,223,90,24,20,4,22,9,13,33,18,15,0,+2,-2,83%,92%,73%,101,133,64,23%,33%,11%,3,2,1,3,0,3
86,https://vlr.gg/player/41220/krejz,2025-02-12 13:20:00,1.50,0.67,1.11,214,278,140,38,26,12,30,12,18,8,7,1,+1,+3,-2,68%,88%,45%,147,192,96,35%,31%,48%,4,4,0,3,1,2
87,https://vlr.gg/player/20271/vorwenn,2025-02-12 13:20:00,1.29,0.73,1.03,217,258,176,35,24,11,32,15,17,7,3,4,-6,-1,-5,68%,76%,59%,147,165,127,17%,19%,15%,3,3,0,9,4,5
88,https://vlr.gg/player/292/fit1nho,2025-02-12 13:20:00,1.12,0.63,0.89,201,227,173,33,20,13,34,15,19,15,12,3,-2,0,-2,70%,80%,59%,137,152,120,32%,33%,30%,6,4,2,8,4,4
89,https://vlr.gg/player/7220/saiz,2025-02-12 13:20:00,0.93,0.62,0.78,143,156,136,25,15,10,30,14,16,3,2,1,-4,+1,-5,62%,68%,55%,104,118,88,33%,49%,20%,2,2,0,6,1,5
90,https://vlr.gg/player/1493/starkk,2025-02-12 13:20:00,1.36,1.14,1.25,226,238,214,38,19,19,29,13,16,16,7,9,+1,+2,-1,72%,77%,67%,146,161,132,35%,38%,33%,3,3,0,2,1,1
91,https://vlr.gg/player/5203/bati,2025-02-12 13:20:00,1.11,0.94,1.02,158,173,148,28,15,13,25,11,14,7,3,4,-1,-1,0,76%,77%,75%,104,113,95,19%,18%,21%,3,1,2,4,2,2
92,https://vlr.gg/player/6909/jannyxd,2025-02-12 13:20:00,0.90,0.97,0.94,221,224,221,34,17,17,34,15,19,9,3,6,-4,+1,-5,63%,55%,71%,146,141,150,21%,34%,13%,8,6,2,12,5,7
93,https://vlr.gg/player/15376/grtw,2025-02-12 13:20:00,0.74,1.05,0.90,173,134,211,28,11,17,31,15,16,10,3,7,0,0,0,70%,64%,75%,116,104,127,26%,33%,22%,3,0,3,3,0,3
94,https://vlr.gg/player/13435/fragger,2025-02-12 13:20:00,0.66,0.99,0.83,143,121,168,21,8,13,31,15,16,24,13,11,-2,-2,0,72%,73%,71%,94,89,99,28%,29%,28%,3,1,2,5,3,2
95,https://vlr.gg/player/6925/chadi,2025-02-12 13:20:00,1.78,1.43,1.61,322,379,256,49,32,17,29,16,13,13,2,11,+3,0,+3,80%,79%,82%,210,242,176,27%,37%,15%,10,5,5,7,5,2
96,https://vlr.gg/player/4851/rexs,2025-02-12 13:20:00,0.78,1.22,0.99,181,162,203,28,13,15,30,17,13,16,7,9,+2,+2,0,76%,75%,77%,121,104,140,21%,19%,23%,3,2,1,1,0,1
97,https://vlr.gg/player/2835/kyrrz,2025-02-12 13:20:00,0.68,1.12,0.89,135,108,166,21,8,13,27,14,13,20,9,11,+1,0,+1,70%,67%,73%,91,72,112,24%,22%,25%,7,3,4,6,3,3
98,https://vlr.gg/player/24359/faska,2025-02-12 13:20:00,0.99,0.60,0.80,164,209,118,28,18,10,32,16,16,7,3,4,+2,+4,-2,59%,71%,45%,104,131,75,28%,38%,18%,5,4,1,3,0,3
99,https://vlr.gg/player/19588/neptuno,2025-02-12 13:20:00,0.48,0.82,0.65,128,103,158,23,9,14,31,16,15,7,3,4,-2,0,-2,61%,58%,64%,85,70,101,35%,42%,31%,1,1,0,3,1,2
100,https://vlr.gg/player/6959/flickless,2025-02-12 11:00:00,1.66,1.04,1.27,210,266,178,28,14,14,24,9,15,17,6,11,+2,-1,+3,82%,86%,79%,129,160,111,19%,20%,19%,3,0,3,1,1,0
101,https://vlr.gg/player/8834/bucher,2025-02-12 11:00:00,0.82,1.16,1.03,215,234,205,30,11,19,27,12,15,4,2,2,+2,+1,+1,68%,79%,63%,148,161,141,38%,39%,38%,2,1,1,0,0,0
102,https://vlr.gg/player/15473/yuno,2025-02-12 11:00:00,0.96,1.08,1.03,198,191,202,29,11,18,26,10,16,9,3,6,0,0,0,68%,57%,75%,120,112,125,28%,15%,38%,4,2,2,4,2,2
103,https://vlr.gg/player/1839/polvi,2025-02-12 11:00:00,0.85,0.98,0.93,211,217,208,28,10,18,27,11,16,5,2,3,0,-2,+2,63%,57%,67%,142,160,131,22%,21%,23%,9,2,7,9,4,5
104,https://vlr.gg/player/341/quick,2025-02-12 11:00:00,0.61,1.04,0.88,181,125,214,22,6,16,28,11,17,13,5,8,-2,-2,0,76%,79%,75%,132,91,156,32%,14%,46%,2,0,2,4,2,2
105,https://vlr.gg/player/1615/destrian,2025-02-12 11:00:00,1.15,1.31,1.21,223,194,274,29,16,13,25,15,10,10,7,3,+1,0,+1,71%,67%,79%,154,140,178,31%,30%,31%,2,1,1,1,1,0
106,https://vlr.gg/player/363/7ssk7,2025-02-12 11:00:00,1.48,0.57,1.15,207,256,123,28,23,5,26,14,12,13,8,5,+4,+1,+3,74%,79%,64%,131,164,74,27%,33%,13%,4,1,3,0,0,0
107,https://vlr.gg/player/173/l0udly,2025-02-12 11:00:00,0.94,1.51,1.15,220,195,263,30,16,14,24,16,8,9,5,4,-1,0,-1,68%,58%,86%,158,142,185,29%,26%,33%,4,3,1,5,3,2
108,https://vlr.gg/player/44922/golack,2025-02-12 11:00:00,0.58,1.05,0.76,191,177,216,27,15,12,31,21,10,3,2,1,-2,-2,0,58%,54%,64%,119,108,138,24%,23%,27%,5,3,2,7,5,2
109,https://vlr.gg/player/443/zeddy,2025-02-12 11:00:00,0.47,0.59,0.51,130,104,176,18,9,9,31,19,12,8,5,3,-4,-5,+1,63%,58%,71%,83,69,106,20%,24%,15%,3,1,2,7,6,1
110,https://vlr.gg/player/5854/z3ro,2025-02-12 11:00:00,1.24,1.05,1.15,245,256,233,40,22,18,35,19,16,5,1,4,+2,0,+2,67%,67%,68%,163,167,159,41%,48%,35%,5,1,4,3,1,2
111,https://vlr.gg/player/4277/n-a-i-s,2025-02-12 11:00:00,0.62,1.69,1.13,202,128,289,34,11,23,31,19,12,11,3,8,0,-1,+1,63%,58%,68%,134,83,189,34%,29%,36%,3,1,2,3,2,1
112,https://vlr.gg/player/1472/falltw,2025-02-12 11:00:00,0.90,1.09,0.99,148,156,137,25,13,12,28,18,10,20,9,11,-1,+2,-3,74%,67%,82%,96,102,90,20%,31%,12%,5,4,1,6,2,4
113,https://vlr.gg/player/15384/mot1on,2025-02-12 11:00:00,1.11,0.76,0.94,159,183,134,23,14,9,29,15,14,21,13,8,+2,+2,0,74%,75%,73%,106,121,91,33%,37%,27%,3,2,1,1,0,1
114,https://vlr.gg/player/2617/leare,2025-02-12 11:00:00,0.57,1.11,0.83,208,162,256,34,13,21,38,21,17,6,3,3,-3,-5,+2,65%,58%,73%,126,98,155,23%,21%,25%,7,3,4,10,8,2
115,https://vlr.gg/player/3784/katu,2025-02-12 11:00:00,1.05,1.45,1.26,240,191,283,39,15,24,30,16,14,10,5,5,+4,+1,+3,76%,73%,79%,154,134,172,43%,32%,52%,8,2,6,4,1,3
116,https://vlr.gg/player/402/insider,2025-02-12 11:00:00,0.99,1.02,1.01,179,196,167,29,15,14,26,14,12,6,3,3,0,0,0,67%,59%,75%,118,119,117,40%,48%,33%,4,3,1,4,3,1
117,https://vlr.gg/player/4519/kamisseq,2025-02-12 11:00:00,0.84,1.15,1.00,198,187,203,31,12,19,29,17,12,15,12,3,+1,+2,-1,76%,68%,83%,135,132,138,31%,30%,33%,3,3,0,2,1,1
118,https://vlr.gg/player/1155/buld,2025-02-12 11:00:00,0.88,0.93,0.90,197,161,236,28,11,17,34,17,17,17,6,11,-2,-1,-1,80%,77%,83%,142,122,161,15%,25%,10%,2,1,1,4,2,2
119,https://vlr.gg/player/23347/alannn,2025-02-12 11:00:00,0.61,0.76,0.69,197,194,201,34,16,18,37,19,18,5,2,3,-3,-4,+1,59%,59%,58%,120,112,127,32%,31%,32%,6,1,5,9,5,4
120,https://vlr.gg/player/8041/brave,2025-02-12 09:30:00,1.16,1.41,1.28,247,225,275,59,27,32,43,25,18,22,12,10,-1,0,-1,76%,69%,84%,165,148,184,33%,29%,38%,3,2,1,4,2,2
121,https://vlr.gg/player/12774/anima,2025-02-12 09:30:00,0.99,1.11,1.04,184,222,159,42,24,18,43,27,16,36,15,21,+1,0,+1,78%,74%,81%,126,153,97,31%,32%,29%,4,2,2,3,2,1
122,https://vlr.gg/player/10161/qutionerx,2025-02-12 09:30:00,0.64,1.43,1.01,221,161,284,50,19,31,50,30,20,12,5,7,+8,+2,+6,73%,66%,81%,144,100,192,24%,21%,28%,16,7,9,8,5,3
123,https://vlr.gg/player/10160/izzy,2025-02-12 09:30:00,0.85,1.15,0.99,192,184,188,44,21,23,41,26,15,11,8,3,0,-2,+2,76%,69%,84%,123,125,121,27%,30%,24%,10,4,6,10,6,4
124,https://vlr.gg/player/10163/cyderx,2025-02-12 09:30:00,0.66,0.96,0.80,147,135,155,35,18,17,45,27,18,9,3,6,-7,-3,-4,67%,57%,78%,103,94,112,26%,27%,24%,1,1,0,8,4,4
125,https://vlr.gg/player/31307/yigox,2025-02-12 09:30:00,0.92,1.81,1.39,285,198,359,63,20,43,44,24,20,10,6,4,+9,+3,+6,75%,59%,89%,182,134,226,37%,44%,34%,10,4,6,1,1,0
126,https://vlr.gg/player/18655/best,2025-02-12 09:30:00,1.51,1.23,1.37,302,354,256,69,36,33,48,24,24,8,3,5,+6,+3,+3,67%,69%,66%,190,220,163,38%,41%,35%,19,8,11,13,5,8
127,https://vlr.gg/player/33551/slaughter,2025-02-12 09:30:00,0.85,1.11,0.99,158,124,190,39,15,24,42,21,21,29,10,19,-2,-1,-1,76%,69%,83%,104,91,117,25%,33%,22%,1,0,1,3,1,2
128,https://vlr.gg/player/15735/krostaly,2025-02-12 09:30:00,0.39,0.84,0.63,110,95,127,26,9,17,44,24,20,19,3,16,-6,-1,-5,66%,59%,71%,79,64,93,26%,24%,27%,3,2,1,9,3,6
129,https://vlr.gg/player/40842/ibonata,2025-02-12 09:30:00,0.21,0.79,0.51,118,63,158,25,7,18,53,28,25,25,7,18,-8,-8,0,66%,53%,77%,78,46,106,27%,28%,27%,0,0,0,8,8,0
130,https://vlr.gg/player/9263/sayoo,2025-02-12 08:10:00,0.88,1.26,1.08,192,167,216,49,22,27,44,25,19,17,5,12,+2,0,+2,70%,57%,83%,129,104,154,29%,22%,34%,6,3,3,4,3,1
131,https://vlr.gg/player/16852/nakya,2025-02-12 08:10:00,0.99,1.08,1.04,228,223,236,53,23,30,53,28,25,11,10,1,+7,+2,+5,63%,57%,69%,149,154,145,33%,32%,35%,20,11,9,13,9,4
132,https://vlr.gg/player/1745/adrnking,2025-02-12 08:10:00,0.96,1.01,0.98,175,165,184,46,20,26,48,24,24,16,9,7,+1,0,+1,63%,57%,69%,117,108,126,33%,26%,42%,4,1,3,3,1,2
133,https://vlr.gg/player/2346/cud,2025-02-12 08:10:00,0.71,0.99,0.86,167,167,169,44,21,23,48,27,21,11,2,9,+1,-3,+4,70%,57%,83%,114,115,113,29%,32%,26%,7,1,6,6,4,2
134,https://vlr.gg/player/23710/gotten,2025-02-12 08:10:00,0.67,0.97,0.82,155,122,188,33,12,21,50,26,24,40,21,19,-4,-2,-2,61%,49%,72%,99,76,121,27%,34%,22%,2,0,2,6,2,4
135,https://vlr.gg/player/3401/ptc,2025-02-12 08:10:00,0.87,1.38,1.12,210,183,243,52,24,28,41,25,16,18,6,12,+1,-1,+2,69%,69%,69%,134,114,154,31%,41%,26%,10,3,7,9,4,5
136,https://vlr.gg/player/6913/sultan,2025-02-12 08:10:00,1.24,0.93,1.09,199,214,184,49,27,22,45,23,22,24,17,7,-2,-1,-1,76%,78%,74%,132,139,126,31%,32%,31%,3,1,2,5,2,3
137,https://vlr.gg/player/13744/patmen,2025-02-12 08:10:00,1.12,0.95,1.04,178,199,159,46,26,20,45,24,21,34,19,15,-2,-2,0,72%,69%,74%,117,126,107,39%,40%,37%,3,1,2,5,3,2
138,https://vlr.gg/player/7754/xavi8k,2025-02-12 08:10:00,0.77,1.32,1.04,192,136,250,49,16,33,45,26,19,11,8,3,-1,-1,0,66%,58%,74%,132,105,159,25%,27%,24%,4,1,3,5,2,3
139,https://vlr.gg/player/16842/mojer,2025-02-12 08:10:00,0.79,1.16,0.97,197,185,211,47,20,27,49,29,20,15,10,5,-3,-5,+2,75%,67%,83%,134,130,138,25%,24%,26%,12,7,5,15,12,3
140,https://vlr.gg/player/27254/leviathan,2025-02-12 06:00:00,1.78,1.21,1.42,280,385,221,39,20,19,21,8,13,8,2,6,+11,+6,+5,89%,100%,83%,188,252,151,49%,55%,44%,12,6,6,1,0,1
141,https://vlr.gg/player/27244/seph1roth,2025-02-12 06:00:00,1.75,1.10,1.34,207,265,188,28,14,14,19,5,14,18,6,12,+2,+2,0,92%,93%,92%,138,159,125,35%,45%,28%,4,2,2,2,0,2
142,https://vlr.gg/player/23930/potter,2025-02-12 06:00:00,1.39,1.30,1.33,235,279,215,34,15,19,22,9,13,4,0,4,+6,0,+6,89%,100%,83%,151,161,144,27%,24%,29%,9,2,7,3,2,1
143,https://vlr.gg/player/13784/killua,2025-02-12 06:00:00,0.63,1.46,1.15,218,123,273,29,6,23,24,9,15,16,5,11,0,-1,+1,74%,64%,79%,147,85,183,45%,25%,52%,2,0,2,2,1,1
144,https://vlr.gg/player/8582/laz,2025-02-12 06:00:00,0.56,1.41,1.09,234,101,267,30,5,25,20,8,12,9,5,4,+1,+1,0,82%,86%,79%,132,70,169,37%,16%,46%,2,1,1,1,0,1
145,https://vlr.gg/player/7746/kevzii,2025-02-12 06:00:00,1.14,0.99,1.08,244,277,193,33,23,10,32,21,11,7,5,2,0,+1,-1,66%,75%,50%,162,181,129,32%,31%,35%,4,2,2,4,1,3
146,https://vlr.gg/player/11578/hotsauz,2025-02-12 06:00:00,0.70,0.59,0.66,138,144,175,18,12,6,31,19,12,16,5,11,-4,-2,-2,66%,67%,64%,98,95,101,31%,28%,38%,1,1,0,5,3,2
147,https://vlr.gg/player/16953/zynd,2025-02-12 06:00:00,0.54,0.81,0.64,132,118,167,18,9,9,32,20,12,4,4,0,-3,-4,+1,47%,42%,57%,86,84,88,13%,12%,15%,1,0,1,4,4,0
148,https://vlr.gg/player/9747/emman,2025-02-12 06:00:00,0.49,0.68,0.56,128,113,185,17,8,9,32,20,12,10,8,2,-4,-3,-1,58%,54%,64%,96,81,123,37%,36%,39%,0,0,0,4,3,1
149,https://vlr.gg/player/9737/kakarot,2025-02-12 06:00:00,0.68,0.29,0.54,168,183,136,20,15,5,34,21,13,4,1,3,-9,-4,-5,63%,67%,57%,106,108,103,17%,15%,22%,3,3,0,12,7,5
150,https://vlr.gg/player/4666/acme,2025-02-12 05:40:00,1.41,1.60,1.51,293,297,284,73,35,38,42,22,20,12,5,7,+7,0,+7,84%,75%,92%,195,200,191,32%,30%,34%,10,2,8,3,2,1
151,https://vlr.gg/player/42710/froz,2025-02-12 05:40:00,0.90,1.28,1.10,210,184,231,48,19,29,44,24,20,31,16,15,+1,0,+1,74%,72%,76%,137,112,159,34%,28%,38%,5,1,4,4,1,3
152,https://vlr.gg/player/48925/raxcal,2025-02-12 05:40:00,0.87,1.10,1.00,187,161,201,46,19,27,47,25,22,18,8,10,+1,+3,-2,70%,66%,73%,118,103,131,24%,26%,23%,6,5,1,5,2,3
153,https://vlr.gg/player/42771/nameless,2025-02-12 05:40:00,0.81,1.06,0.94,184,166,204,47,19,28,49,24,25,32,10,22,0,-1,+1,77%,69%,84%,123,105,139,42%,43%,41%,5,2,3,5,3,2
154,https://vlr.gg/player/42769/wezzy,2025-02-12 05:40:00,0.65,0.96,0.82,195,165,228,47,17,30,55,27,28,15,8,7,0,0,0,64%,63%,65%,133,114,150,20%,29%,13%,13,7,6,13,7,6
155,https://vlr.gg/player/4661/sacrifice,2025-02-12 05:40:00,1.04,1.32,1.17,214,202,239,53,26,27,48,28,20,28,12,16,+1,+1,0,75%,70%,81%,149,142,158,34%,31%,37%,3,3,0,2,2,0
156,https://vlr.gg/player/34982/athan,2025-02-12 05:40:00,1.02,1.09,1.05,230,243,212,54,30,24,53,31,22,19,8,11,-1,0,-1,67%,65%,69%,141,152,129,29%,31%,25%,7,3,4,8,3,5
157,https://vlr.gg/player/51100/flicker,2025-02-12 05:40:00,0.42,1.37,0.85,205,161,260,50,19,31,55,35,20,7,4,3,-8,-7,-1,58%,43%,75%,130,105,158,27%,25%,28%,8,3,5,16,10,6
158,https://vlr.gg/player/51099/zynx,2025-02-12 05:40:00,0.63,0.98,0.79,151,124,194,39,17,22,50,28,22,12,3,9,-2,-2,0,65%,54%,78%,104,79,132,27%,26%,27%,6,3,3,8,5,3
159,https://vlr.gg/player/51238/yong,2025-02-12 05:40:00,0.87,0.68,0.78,187,195,176,41,23,18,55,30,25,16,10,6,+1,+1,0,64%,68%,59%,132,135,129,28%,28%,28%,6,3,3,5,2,3
160,https://vlr.gg/player/43064/aace,2025-02-12 04:40:00,0.74,1.29,1.03,228,187,265,57,21,36,51,27,24,10,6,4,0,-1,+1,69%,66%,72%,149,130,166,35%,31%,39%,6,2,4,6,3,3
161,https://vlr.gg/player/34827/hals,2025-02-12 04:40:00,0.81,1.03,0.93,188,151,221,45,17,28,48,23,25,14,7,7,+5,+2,+3,66%,59%,72%,117,91,139,18%,17%,18%,12,6,6,7,4,3
162,https://vlr.gg/player/12979/mrtenzouez,2025-02-12 04:40:00,0.93,0.89,0.91,215,238,200,51,27,24,53,25,28,11,5,6,+5,+1,+4,69%,66%,72%,144,160,129,39%,40%,37%,12,4,8,7,3,4
163,https://vlr.gg/player/6673/gon,2025-02-12 04:40:00,0.81,0.75,0.78,152,199,111,38,24,14,49,26,23,14,3,11,-6,-4,-2,53%,53%,53%,99,126,76,32%,27%,42%,2,1,1,8,5,3
164,https://vlr.gg/player/1970/neth,2025-02-12 04:40:00,0.74,0.78,0.76,164,171,159,32,16,16,52,26,26,33,14,19,+4,+2,+2,66%,63%,69%,113,116,111,23%,23%,22%,6,3,3,2,1,1
165,https://vlr.gg/player/17169/muto,2025-02-12 04:40:00,1.22,1.44,1.32,230,211,244,55,27,28,40,21,19,26,10,16,+1,+1,0,79%,72%,88%,150,138,164,27%,26%,27%,5,4,1,4,3,1
166,https://vlr.gg/player/4545/sayaplayer,2025-02-12 04:40:00,1.18,1.42,1.29,238,239,236,60,32,28,42,24,18,8,3,5,+1,-4,+5,76%,78%,75%,155,156,153,26%,30%,21%,11,3,8,10,7,3
167,https://vlr.gg/player/25915/brian,2025-02-12 04:40:00,1.17,1.15,1.16,239,236,250,55,27,28,47,23,24,25,14,11,-7,-3,-4,72%,72%,72%,171,161,181,36%,36%,36%,6,4,2,13,7,6
168,https://vlr.gg/player/1963/hate,2025-02-12 04:40:00,1.16,1.08,1.12,199,195,205,50,27,23,44,21,23,14,5,9,0,-1,+1,74%,72%,75%,145,142,149,32%,33%,31%,4,1,3,4,2,2
169,https://vlr.gg/player/31841/take,2025-02-12 04:40:00,0.44,0.93,0.67,126,104,153,33,13,20,50,29,21,14,6,8,-3,-1,-2,63%,56%,72%,81,65,99,23%,31%,18%,4,2,2,7,3,4
170,https://vlr.gg/player/43057/dh,2025-02-12 03:00:00,1.53,1.02,1.31,274,327,205,41,27,14,29,17,12,16,12,4,+2,+2,0,76%,79%,72%,178,209,135,26%,21%,37%,5,4,1,3,2,1
171,https://vlr.gg/player/4664/gangpin,2025-02-12 03:00:00,0.98,1.10,1.03,179,144,222,26,12,14,26,15,11,27,16,11,-2,-2,0,76%,75%,78%,128,120,139,19%,21%,17%,2,1,1,4,3,1
172,https://vlr.gg/player/29839/tenten,2025-02-12 03:00:00,0.77,1.33,1.01,202,184,231,34,17,17,28,17,11,7,4,3,-4,-4,0,71%,63%,83%,129,119,141,21%,19%,24%,5,2,3,9,6,3
173,https://vlr.gg/player/806/moothie,2025-02-12 03:00:00,0.95,0.86,0.91,204,205,195,30,18,12,31,17,14,12,6,6,+2,0,+2,79%,83%,72%,132,126,140,41%,45%,35%,4,1,3,2,1,1
174,https://vlr.gg/player/30556/exa,2025-02-12 03:00:00,0.86,0.97,0.91,181,153,223,26,13,13,28,16,12,14,8,6,-1,0,-1,74%,71%,78%,123,109,142,27%,29%,25%,3,2,1,4,2,2
175,https://vlr.gg/player/24979/cloy,2025-02-12 03:00:00,0.91,1.32,1.15,239,172,287,36,10,26,29,13,16,8,8,0,+1,-2,+3,74%,78%,71%,155,127,177,32%,30%,33%,6,1,5,5,3,2
176,https://vlr.gg/player/17049/hermes,2025-02-12 03:00:00,1.07,1.09,1.08,207,249,181,31,15,16,29,13,16,6,2,4,+2,+1,+1,67%,61%,71%,138,158,123,19%,15%,25%,6,2,4,4,1,3
177,https://vlr.gg/player/25048/sid,2025-02-12 03:00:00,0.89,0.95,0.92,181,184,180,25,12,13,32,15,17,12,2,10,+2,+1,+1,83%,83%,83%,127,124,130,32%,29%,33%,4,2,2,2,1,1
178,https://vlr.gg/player/42793/kally,2025-02-12 03:00:00,0.70,0.81,0.76,147,118,169,22,8,14,34,14,20,17,6,11,-1,0,-1,69%,61%,75%,102,85,115,23%,19%,26%,1,1,0,2,1,1
179,https://vlr.gg/player/27444/banger,2025-02-12 03:00:00,0.69,0.72,0.70,153,139,162,23,10,13,33,15,18,9,2,7,-1,-1,0,62%,61%,63%,106,93,116,42%,50%,39%,5,2,3,6,3,3
180,https://vlr.gg/player/4477/lob,2025-02-12 02:00:00,0.65,1.48,0.92,165,133,231,23,11,12,27,20,7,7,5,2,-1,-1,0,67%,58%,83%,110,92,144,33%,32%,35%,0,0,0,1,1,0
181,https://vlr.gg/player/993/medusa,2025-02-12 02:00:00,0.89,0.83,0.87,201,209,179,23,16,7,29,20,9,6,3,3,+4,+3,+1,67%,67%,67%,133,127,146,30%,36%,21%,7,6,1,3,3,0
182,https://vlr.gg/player/7745/yoshiii,2025-02-12 02:00:00,0.58,0.95,0.70,160,140,195,19,11,8,31,22,9,8,5,3,-4,-3,-1,44%,38%,58%,113,99,140,25%,24%,27%,4,2,2,8,5,3
183,https://vlr.gg/player/687/zepher,2025-02-12 02:00:00,0.35,0.76,0.48,153,130,195,18,9,9,34,23,11,2,1,1,-6,-6,0,53%,42%,75%,95,88,110,14%,21%,6%,2,0,2,8,6,2
184,https://vlr.gg/player/6700/anthem,2025-02-12 02:00:00,0.30,0.67,0.42,119,90,182,14,6,8,32,22,10,7,6,1,-3,-1,-2,53%,50%,58%,78,61,113,20%,13%,31%,0,0,0,3,1,2
185,https://vlr.gg/player/10584/seoldam,2025-02-12 02:00:00,0.82,2.05,1.64,287,173,342,37,7,30,17,9,8,10,4,6,+3,+1,+2,92%,83%,96%,179,116,210,20%,22%,19%,6,3,3,3,2,1
186,https://vlr.gg/player/29841/caedye,2025-02-12 02:00:00,1.51,1.60,1.57,355,331,369,46,15,31,25,9,16,9,1,8,+7,+2,+5,86%,83%,88%,216,191,229,35%,56%,29%,11,3,8,4,1,3
187,https://vlr.gg/player/5476/minty,2025-02-12 02:00:00,0.99,1.28,1.18,181,160,192,24,7,17,19,8,11,24,11,13,0,-1,+1,81%,75%,83%,119,91,132,33%,44%,30%,3,0,3,3,1,2
188,https://vlr.gg/player/4663/joxjo,2025-02-12 02:00:00,0.72,1.33,1.13,192,164,203,25,7,18,19,9,10,21,3,18,+2,+1,+1,86%,83%,88%,120,106,127,23%,19%,24%,3,1,2,1,0,1
189,https://vlr.gg/player/29843/yatsuka,2025-02-12 02:00:00,1.16,1.11,1.13,168,238,135,21,10,11,18,9,9,18,4,14,-2,-1,-1,75%,67%,79%,113,147,96,44%,57%,34%,0,0,0,2,1,1
190,https://vlr.gg/player/9185/dodonut,2025-02-11 19:20:00,0.42,1.06,0.88,221,127,258,22,3,19,28,8,20,7,2,5,-1,-1,0,61%,44%,67%,141,94,159,17%,19%,17%,5,1,4,6,2,4
191,https://vlr.gg/player/17397/noia,2025-02-11 19:20:00,0.34,0.95,0.75,139,95,155,17,2,15,27,9,18,2,2,0,-3,-2,-1,48%,33%,54%,106,76,117,27%,8%,33%,2,0,2,5,2,3
192,https://vlr.gg/player/21486/sarahcat,2025-02-11 19:20:00,0.08,0.90,0.67,161,65,199,17,2,15,31,9,22,13,1,12,-4,-2,-2,64%,33%,75%,103,35,129,30%,17%,31%,1,0,1,5,2,3
193,https://vlr.gg/player/3063/mel,2025-02-11 19:20:00,0.43,0.64,0.58,140,111,151,13,3,10,29,8,21,13,2,11,-1,0,-1,48%,33%,54%,94,68,104,18%,18%,18%,3,1,2,4,1,3
194,https://vlr.gg/player/3079/alexis,2025-02-11 19:20:00,0.45,0.57,0.54,115,122,114,14,5,9,29,9,20,17,1,16,0,0,0,67%,44%,75%,75,61,81,29%,43%,25%,1,0,1,1,0,1
195,https://vlr.gg/player/6437/dark3st,2025-02-11 19:20:00,1.56,1.35,1.51,261,281,198,29,23,6,15,12,3,20,15,5,+2,+1,+1,94%,96%,89%,170,190,117,21%,20%,24%,3,1,2,1,0,1
196,https://vlr.gg/player/21878/snarly,2025-02-11 19:20:00,1.27,2.00,1.47,259,242,316,34,23,11,16,14,2,6,5,1,+4,+3,+1,94%,92%,100%,177,163,214,39%,46%,31%,5,4,1,1,1,0
197,https://vlr.gg/player/5093/logan,2025-02-11 19:20:00,1.23,1.70,1.36,214,229,175,29,22,7,14,12,2,7,5,2,0,0,0,82%,75%,100%,132,139,112,19%,17%,27%,1,1,0,1,1,0
198,https://vlr.gg/player/29893/timotino,2025-02-11 19:20:00,1.00,2.18,1.32,330,281,463,37,22,15,23,18,5,10,7,3,+4,+1,+3,85%,79%,100%,215,192,278,26%,35%,16%,11,7,4,7,6,1
199,https://vlr.gg/player/754/nerve,2025-02-11 19:20:00,0.98,1.08,1.01,130,132,126,15,11,4,15,12,3,24,17,7,-1,-1,0,79%,71%,100%,82,78,94,17%,15%,23%,1,1,0,2,2,0
200,https://vlr.gg/player/873/bob,2025-02-11 19:10:00,1.82,1.53,1.66,336,358,322,52,24,28,25,12,13,10,6,4,+8,+6,+2,86%,95%,78%,222,239,209,29%,32%,26%,9,6,3,1,0,1
201,https://vlr.gg/player/27884/unstable,2025-02-11 19:10:00,1.35,1.03,1.18,221,260,180,33,19,14,24,11,13,18,8,10,+1,+2,-1,90%,89%,91%,133,164,108,28%,30%,25%,5,3,2,4,1,3
202,https://vlr.gg/player/8849/sonder,2025-02-11 19:10:00,0.78,1.37,1.10,224,171,269,33,11,22,26,14,12,21,7,14,+1,-1,+2,76%,68%,83%,154,126,178,28%,46%,24%,7,2,5,6,3,3
203,https://vlr.gg/player/11968/l4ce,2025-02-11 19:10:00,0.53,1.38,1.00,206,126,276,30,7,23,31,15,16,22,12,10,+4,0,+4,79%,63%,91%,140,94,178,47%,50%,46%,4,0,4,0,0,0
204,https://vlr.gg/player/14868/karra,2025-02-11 19:10:00,0.82,0.74,0.78,109,149,79,15,10,5,24,13,11,20,9,11,-2,0,-2,71%,63%,78%,82,102,65,25%,30%,21%,2,2,0,4,2,2
205,https://vlr.gg/player/45801/terror,2025-02-11 19:10:00,1.41,1.20,1.31,241,235,252,34,19,15,29,15,14,26,14,12,-3,-2,-1,76%,74%,79%,152,152,153,37%,41%,33%,1,0,1,4,2,2
206,https://vlr.gg/player/43332/aeri,2025-02-11 19:10:00,0.98,1.08,1.03,212,218,200,32,17,15,35,20,15,10,8,2,-1,+1,-2,74%,78%,68%,142,149,133,42%,38%,47%,3,2,1,4,1,3
207,https://vlr.gg/player/39715/cia,2025-02-11 19:10:00,0.70,1.28,0.96,186,147,233,27,10,17,32,18,14,7,5,2,-3,-3,0,62%,65%,58%,129,107,154,28%,29%,27%,1,0,1,4,3,1
208,https://vlr.gg/player/15592/angel,2025-02-11 19:10:00,0.66,0.65,0.66,119,93,154,16,7,9,28,16,12,11,5,6,-4,-1,-3,57%,57%,58%,79,54,109,26%,17%,35%,1,1,0,5,2,3
209,https://vlr.gg/player/47144/sythrine,2025-02-11 19:10:00,0.36,0.61,0.46,155,157,166,21,12,9,40,23,17,10,2,8,-1,0,-1,60%,57%,63%,104,94,116,12%,14%,9%,9,6,3,10,6,4
210,https://vlr.gg/player/21428/crunch,2025-02-11 19:00:00,1.12,1.01,1.05,265,292,256,35,16,19,32,14,18,5,2,3,+2,+3,-1,79%,88%,73%,171,190,156,31%,23%,44%,11,5,6,9,2,7
211,https://vlr.gg/player/50835/arbex,2025-02-11 19:00:00,1.03,0.93,0.97,219,206,215,26,11,15,30,13,17,7,4,3,+1,0,+1,61%,69%,55%,152,152,152,23%,29%,19%,4,2,2,3,2,1
212,https://vlr.gg/player/45921/v1bz,2025-02-11 19:00:00,1.16,0.68,0.88,136,190,107,18,11,7,28,12,16,20,8,12,+2,+2,0,82%,88%,77%,92,130,65,41%,46%,35%,2,2,0,0,0,0
213,https://vlr.gg/player/44075/dedmos,2025-02-11 19:00:00,0.49,1.00,0.78,160,124,188,20,5,15,29,14,15,13,8,5,-2,-1,-1,76%,81%,73%,102,82,116,26%,21%,31%,1,0,1,3,1,2
214,https://vlr.gg/player/35619/sxnti,2025-02-11 19:00:00,0.54,0.80,0.69,169,171,181,25,10,15,30,14,16,3,2,1,-3,-2,-1,71%,69%,73%,115,112,117,33%,31%,34%,1,0,1,4,2,2
215,https://vlr.gg/player/8790/mininiwde,2025-02-11 19:00:00,1.16,2.05,1.53,239,165,345,32,14,18,18,11,7,17,5,12,+4,+2,+2,76%,64%,94%,164,121,224,25%,23%,27%,4,2,2,0,0,0
216,https://vlr.gg/player/17694/prask,2025-02-11 19:00:00,0.98,1.17,1.06,195,174,229,28,12,16,23,14,9,7,6,1,0,-1,+1,76%,68%,88%,145,135,158,29%,31%,27%,2,1,1,2,2,0
217,https://vlr.gg/player/2497/dobsha,2025-02-11 19:00:00,1.05,1.07,1.06,190,195,184,29,17,12,26,15,11,12,4,8,-1,-1,0,84%,82%,88%,132,156,99,30%,33%,24%,1,0,1,2,1,1
218,https://vlr.gg/player/36405/jrmzie,2025-02-11 19:00:00,1.11,0.92,1.03,244,270,200,32,21,11,31,17,14,8,3,5,+2,+4,-2,79%,82%,75%,167,182,146,35%,37%,31%,8,7,1,6,3,3
219,https://vlr.gg/player/8792/xhowi,2025-02-11 19:00:00,1.19,0.77,1.01,205,206,202,28,18,10,26,14,12,10,2,8,-5,-2,-3,68%,64%,75%,144,148,139,40%,44%,36%,4,2,2,9,4,5
220,https://vlr.gg/player/8329/starbound,2025-02-11 19:00:00,0.91,1.68,1.30,238,169,303,39,14,25,26,14,12,6,4,2,+5,-1,+6,69%,64%,74%,150,122,177,7%,6%,8%,8,1,7,3,2,1
221,https://vlr.gg/player/24237/powerpixele,2025-02-11 19:00:00,1.34,1.09,1.21,245,266,222,36,20,16,27,13,14,18,8,10,+3,+2,+1,78%,82%,74%,157,166,148,20%,20%,20%,8,4,4,5,2,3
222,https://vlr.gg/player/15016/joona,2025-02-11 19:00:00,1.53,0.78,1.15,220,301,144,35,23,12,31,14,17,32,16,16,-4,0,-4,80%,82%,78%,139,189,91,36%,42%,29%,2,2,0,6,2,4
223,https://vlr.gg/player/38583/sleepyaria,2025-02-11 19:00:00,0.71,1.38,1.05,225,177,272,35,11,24,32,16,16,10,5,5,+1,0,+1,73%,68%,78%,136,123,148,18%,18%,19%,5,3,2,4,3,1
224,https://vlr.gg/player/15039/australis,2025-02-11 19:00:00,0.78,0.88,0.83,146,145,149,23,12,11,30,15,15,13,4,9,0,+1,-1,71%,68%,74%,104,103,105,21%,33%,13%,2,2,0,2,1,1
225,https://vlr.gg/player/30395/edith,2025-02-11 19:00:00,1.05,1.18,1.11,224,247,200,36,19,17,33,18,15,8,5,3,+3,-1,+4,73%,74%,73%,148,165,131,36%,36%,37%,8,4,4,5,5,0
226,https://vlr.gg/player/37901/aluvily,2025-02-11 19:00:00,1.03,0.95,0.99,192,210,175,31,17,14,32,15,17,5,2,3,+2,+2,0,64%,74%,55%,127,145,108,35%,41%,27%,4,2,2,2,0,2
227,https://vlr.gg/player/17950/avery,2025-02-11 19:00:00,1.07,0.85,0.96,182,205,159,26,16,10,32,16,16,22,7,15,-2,0,-2,73%,83%,64%,119,127,111,28%,38%,20%,1,1,0,3,1,2
228,https://vlr.gg/player/28535/misu,2025-02-11 19:00:00,0.76,0.86,0.81,186,185,183,27,16,11,37,20,17,17,6,11,-1,-1,0,67%,65%,68%,128,124,133,27%,37%,19%,5,3,2,6,4,2
229,https://vlr.gg/player/25400/riv,2025-02-11 19:00:00,0.31,1.23,0.76,169,93,250,26,6,20,34,19,15,20,11,9,-7,-3,-4,71%,70%,73%,104,57,154,26%,17%,30%,2,0,2,9,3,6
230,https://vlr.gg/player/13084/smiley,2025-02-11 18:15:00,1.31,1.35,1.33,214,212,218,34,20,14,23,13,10,19,6,13,+5,+2,+3,81%,79%,83%,130,138,119,29%,38%,20%,5,2,3,0,0,0
231,https://vlr.gg/player/8286/glyph,2025-02-11 18:15:00,1.10,1.23,1.16,220,219,220,31,19,12,25,16,9,19,9,10,+3,0,+3,81%,75%,89%,150,151,148,29%,31%,28%,4,1,3,1,1,0
232,https://vlr.gg/player/4931/add3r,2025-02-11 18:15:00,0.87,1.33,1.06,188,186,191,30,16,14,25,16,9,6,1,5,-1,-1,0,74%,67%,83%,130,133,126,30%,29%,31%,3,2,1,4,3,1
233,https://vlr.gg/player/3227/screwface,2025-02-11 18:15:00,1.41,0.59,1.06,197,250,126,31,23,8,23,13,10,10,6,4,-2,-1,-1,76%,83%,67%,129,155,94,22%,23%,19%,1,0,1,3,1,2
234,https://vlr.gg/player/29076/satellite,2025-02-11 18:15:00,0.60,1.30,0.90,238,207,280,34,15,19,31,19,12,8,4,4,0,-3,+3,62%,50%,78%,147,137,161,21%,20%,21%,10,5,5,10,8,2
235,https://vlr.gg/player/44085/booey,2025-02-11 18:15:00,0.90,1.57,1.28,280,212,332,40,12,28,29,14,15,7,4,3,-2,-3,+1,69%,72%,67%,166,123,197,18%,14%,21%,4,1,3,6,4,2
236,https://vlr.gg/player/47392/kaiser,2025-02-11 18:15:00,0.88,0.87,0.88,165,161,169,25,10,15,31,13,18,8,4,4,0,-1,+1,62%,61%,63%,128,120,133,30%,26%,33%,3,0,3,3,1,2
237,https://vlr.gg/player/44841/garpa,2025-02-11 18:15:00,0.53,0.85,0.71,154,141,165,23,9,14,32,14,18,16,8,8,-3,-4,+1,67%,72%,63%,102,100,104,33%,39%,29%,3,1,2,6,5,1
238,https://vlr.gg/player/46241/demi,2025-02-11 18:15:00,0.84,0.58,0.69,163,195,140,22,12,10,35,14,21,8,3,5,-1,0,-1,60%,67%,54%,103,121,90,25%,21%,29%,5,2,3,6,2,4
239,https://vlr.gg/player/24232/ghost,2025-02-11 18:15:00,0.61,0.51,0.55,118,118,118,17,7,10,34,13,21,6,3,3,+1,-1,+2,55%,56%,54%,75,68,80,35%,33%,36%,4,1,3,3,2,1
240,https://vlr.gg/player/50581/vecious,2025-02-11 17:00:00,1.26,0.93,1.09,240,267,217,27,16,11,28,13,15,6,2,4,-3,-1,-2,66%,71%,61%,158,182,136,29%,32%,25%,4,3,1,7,4,3
241,https://vlr.gg/player/2995/maka,2025-02-11 17:00:00,0.94,0.79,0.86,182,160,202,22,10,12,29,13,16,7,3,4,+1,+1,0,63%,65%,61%,120,107,132,23%,17%,30%,3,1,2,2,0,2
242,https://vlr.gg/player/35567/toro,2025-02-11 17:00:00,1.25,0.37,0.80,177,252,105,22,15,7,32,13,19,7,4,3,+3,+3,0,63%,71%,56%,108,152,66,38%,41%,36%,4,3,1,1,0,1
243,https://vlr.gg/player/1451/sancho,2025-02-11 17:00:00,0.36,0.24,0.30,121,122,123,13,6,7,32,15,17,1,1,0,-3,+2,-5,40%,53%,28%,89,98,82,25%,17%,35%,4,3,1,7,1,6
244,https://vlr.gg/player/24026/generalsteak,2025-02-11 17:00:00,0.21,0.32,0.27,73,55,91,7,2,5,31,14,17,13,8,5,-1,-2,+1,51%,59%,44%,46,41,52,25%,15%,33%,1,0,1,2,2,0
245,https://vlr.gg/player/31476/mephisto,2025-02-11 17:00:00,2.06,1.29,1.69,371,420,312,46,28,18,23,11,12,6,2,4,+7,+6,+1,77%,89%,65%,222,249,194,29%,29%,30%,11,7,4,4,1,3
246,https://vlr.gg/player/15931/peloncito,2025-02-11 17:00:00,1.11,1.64,1.37,237,196,284,31,13,18,19,10,9,14,8,6,-4,-2,-2,86%,94%,76%,162,135,191,40%,65%,29%,1,0,1,5,2,3
247,https://vlr.gg/player/10718/rowancy,2025-02-11 17:00:00,1.34,1.23,1.29,176,173,182,26,13,13,14,6,8,5,3,2,+2,+2,0,83%,89%,76%,119,118,121,44%,38%,50%,2,2,0,0,0,0
248,https://vlr.gg/player/10581/ryu,2025-02-11 17:00:00,1.40,0.91,1.16,210,238,179,26,16,10,19,9,10,21,13,8,-2,0,-2,80%,83%,76%,134,154,112,38%,40%,35%,4,3,1,6,3,3
249,https://vlr.gg/player/26757/otaq,2025-02-11 17:00:00,1.37,0.83,1.11,180,198,161,22,13,9,16,6,10,15,9,6,0,0,0,86%,89%,82%,115,117,114,13%,9%,17%,1,0,1,1,0,1
250,https://vlr.gg/player/28870/k0rupt,2025-02-11 17:00:00,1.76,1.32,1.56,305,329,272,44,29,15,26,11,15,22,12,10,+3,+1,+2,83%,91%,74%,207,228,181,28%,29%,27%,5,3,2,2,2,0
251,https://vlr.gg/player/19556/melya,2025-02-11 17:00:00,1.46,1.20,1.34,279,329,214,42,26,16,27,14,13,10,9,1,+7,+8,-1,81%,83%,79%,190,214,161,40%,43%,35%,11,10,1,4,2,2
252,https://vlr.gg/player/32667/nora,2025-02-11 17:00:00,1.10,1.15,1.13,162,118,219,25,9,16,21,8,13,17,16,1,0,+1,-1,79%,87%,68%,102,75,135,37%,32%,41%,2,1,1,2,0,2
253,https://vlr.gg/player/33694/evv,2025-02-11 17:00:00,1.16,0.95,1.07,206,229,175,30,19,11,26,13,13,5,2,3,+3,+2,+1,74%,83%,63%,132,144,117,46%,49%,42%,6,2,4,3,0,3
254,https://vlr.gg/player/25246/bunnybee,2025-02-11 17:00:00,1.31,0.59,0.98,167,196,140,26,18,8,27,10,17,9,3,6,+1,+1,0,81%,87%,74%,115,138,88,31%,42%,19%,4,2,2,3,1,2
255,https://vlr.gg/player/42426/kora,2025-02-11 17:00:00,0.89,1.30,1.11,222,202,259,38,15,23,33,15,18,2,1,1,-2,+1,-3,64%,74%,57%,148,121,171,38%,39%,38%,7,5,2,9,4,5
256,https://vlr.gg/player/43330/angle,2025-02-11 17:00:00,1.48,0.33,0.85,179,285,104,26,20,6,32,10,22,7,3,4,0,+1,-1,57%,74%,43%,126,182,79,24%,22%,27%,1,1,0,1,0,1
257,https://vlr.gg/player/28561/abbie2k,2025-02-11 17:00:00,0.95,0.58,0.75,182,245,128,26,17,9,35,15,20,7,4,3,-2,0,-2,55%,68%,43%,113,156,77,29%,35%,20%,3,2,1,5,2,3
258,https://vlr.gg/player/41357/aus,2025-02-11 17:00:00,0.57,0.79,0.69,162,131,178,22,9,13,35,14,21,15,7,8,-5,-2,-3,64%,68%,61%,106,82,126,28%,30%,27%,3,1,2,8,3,5
259,https://vlr.gg/player/45338/cohs,2025-02-11 17:00:00,0.80,0.30,0.53,111,146,80,15,10,5,32,12,20,13,6,7,-5,-1,-4,62%,74%,52%,84,113,60,18%,26%,9%,0,0,0,5,1,4
260,https://vlr.gg/player/28546/venus,2025-02-11 17:00:00,1.06,1.20,1.12,242,254,243,35,22,13,33,21,12,2,1,1,+1,0,+1,73%,71%,75%,160,163,154,34%,37%,30%,7,6,1,6,6,0
261,https://vlr.gg/player/43380/aria,2025-02-11 17:00:00,1.45,0.61,1.11,222,276,140,31,22,9,29,17,12,10,7,3,0,+2,-2,58%,54%,63%,140,173,89,29%,36%,16%,5,4,1,5,2,3
262,https://vlr.gg/player/28530/calsushi,2025-02-11 17:00:00,0.87,1.40,1.09,241,193,305,33,16,17,31,20,11,7,6,1,0,0,0,75%,79%,69%,149,124,188,20%,19%,21%,2,1,1,2,1,1
263,https://vlr.gg/player/30790/kestrel,2025-02-11 17:00:00,0.65,0.62,0.64,112,111,116,17,11,6,29,18,11,11,5,6,-2,-2,0,63%,63%,63%,76,79,73,35%,36%,33%,1,0,1,3,2,1
264,https://vlr.gg/player/37920/oranges,2025-02-11 17:00:00,0.54,0.47,0.51,131,135,134,16,9,7,35,22,13,15,10,5,+1,0,+1,68%,71%,63%,89,95,79,16%,12%,23%,5,1,4,4,1,3
265,https://vlr.gg/player/17982/lunafox,2025-02-11 17:00:00,1.32,1.41,1.38,259,235,278,35,13,22,23,10,13,23,7,16,+1,+1,0,73%,56%,83%,181,167,191,26%,24%,27%,3,2,1,2,1,1
266,https://vlr.gg/player/8414/icee,2025-02-11 17:00:00,0.89,1.33,1.15,252,184,289,35,9,26,30,13,17,14,6,8,+2,+1,+1,73%,69%,75%,159,123,183,14%,13%,14%,7,2,5,5,1,4
267,https://vlr.gg/player/25514/cyn,2025-02-11 17:00:00,1.43,0.86,1.09,181,218,158,28,13,15,25,9,16,13,6,7,-1,-1,0,70%,81%,63%,122,143,109,37%,41%,32%,2,0,2,3,1,2
268,https://vlr.gg/player/25510/teddyisfluffy,2025-02-11 17:00:00,1.15,0.92,1.01,209,227,195,32,15,17,27,11,16,13,6,7,-4,-3,-1,80%,69%,88%,141,186,112,24%,33%,18%,3,1,2,7,4,3
269,https://vlr.gg/player/6575/aniemal,2025-02-11 17:00:00,0.95,1.00,0.98,189,146,217,27,9,18,27,9,18,10,2,8,+2,+2,0,78%,75%,79%,128,104,144,16%,19%,15%,5,3,2,3,1,2
270,https://vlr.gg/player/21435/jelly,2025-02-11 17:00:00,1.02,1.26,1.15,206,174,232,32,14,18,30,16,14,10,3,7,-1,-1,0,71%,65%,77%,135,118,150,32%,29%,34%,2,0,2,3,1,2
271,https://vlr.gg/player/14685/jubs,2025-02-11 17:00:00,0.81,1.23,1.03,183,172,196,28,11,17,32,18,14,6,3,3,+3,+2,+1,67%,60%,73%,114,107,121,19%,25%,16%,6,3,3,3,1,2
272,https://vlr.gg/player/19791/mel,2025-02-11 17:00:00,0.39,1.19,0.81,169,92,244,24,6,18,34,18,16,13,5,8,+2,-2,+4,71%,65%,77%,113,65,156,36%,62%,29%,5,1,4,3,3,0
273,https://vlr.gg/player/31574/srn,2025-02-11 17:00:00,0.26,0.99,0.64,178,126,228,25,7,18,36,19,17,6,3,3,-10,-7,-3,62%,55%,68%,125,103,144,20%,25%,17%,3,1,2,13,8,5
274,https://vlr.gg/player/11239/sayuri,2025-02-11 17:00:00,0.77,0.50,0.63,132,148,116,17,10,7,34,16,18,21,9,12,-4,-2,-2,74%,75%,73%,92,97,88,18%,18%,19%,0,0,0,4,2,2
275,https://vlr.gg/player/12143/bizerra,2025-02-11 17:00:00,1.52,1.36,1.44,255,298,213,41,25,16,22,13,9,10,3,7,+3,+1,+2,81%,82%,80%,170,191,146,21%,15%,29%,3,1,2,0,0,0
276,https://vlr.gg/player/15297/joojina,2025-02-11 17:00:00,0.92,1.83,1.36,203,158,252,30,11,19,20,14,6,32,12,20,0,-1,+1,83%,82%,85%,134,101,170,35%,39%,32%,2,1,1,2,2,0
277,https://vlr.gg/player/4807/bstrdd,2025-02-11 17:00:00,0.79,1.37,1.06,261,243,280,35,16,19,28,18,10,15,7,8,+5,+3,+2,79%,68%,90%,166,163,169,11%,11%,10%,11,7,4,6,4,2
278,https://vlr.gg/player/14386/isaa,2025-02-11 17:00:00,0.91,1.20,1.05,205,191,219,32,15,17,25,16,9,7,2,5,0,0,0,74%,68%,80%,131,132,129,32%,40%,25%,5,2,3,5,2,3
279,https://vlr.gg/player/11232/daiki,2025-02-11 17:00:00,0.69,1.12,0.90,185,134,240,28,12,16,31,17,14,13,6,7,+2,-3,+5,74%,73%,75%,109,72,149,27%,42%,21%,5,0,5,3,3,0
280,https://vlr.gg/player/36560/canezerra,2025-02-11 16:00:00,2.21,1.52,1.89,403,450,353,56,35,21,26,12,14,13,6,7,+11,+7,+4,82%,86%,78%,255,293,211,34%,27%,47%,15,9,6,4,2,2
281,https://vlr.gg/player/53/inspire,2025-02-11 16:00:00,1.15,1.13,1.14,203,189,204,28,16,12,22,9,13,10,7,3,+5,0,+5,85%,90%,78%,132,132,131,38%,46%,32%,6,0,6,1,0,1
282,https://vlr.gg/player/21778/p0ppin,2025-02-11 16:00:00,1.27,0.59,0.95,154,208,91,23,17,6,21,10,11,10,8,2,+3,+3,0,79%,90%,67%,92,119,60,33%,33%,35%,4,4,0,1,1,0
283,https://vlr.gg/player/35302/eggsterr,2025-02-11 16:00:00,0.80,0.86,0.83,158,165,152,24,14,10,29,15,14,13,4,9,-1,-1,0,74%,71%,78%,101,113,87,30%,41%,18%,3,2,1,4,3,1
284,https://vlr.gg/player/29547/ion2x,2025-02-11 16:00:00,0.90,0.75,0.83,179,169,198,28,15,13,30,14,16,9,7,2,-1,0,-1,77%,90%,61%,133,133,134,28%,24%,34%,0,0,0,1,0,1
285,https://vlr.gg/player/8419/reduxx,2025-02-11 16:00:00,1.63,1.31,1.46,292,309,286,42,21,21,30,12,18,5,2,3,+1,+2,-1,74%,72%,76%,190,194,187,29%,25%,33%,4,4,0,3,2,1
286,https://vlr.gg/player/11118/skuba,2025-02-11 16:00:00,1.08,0.55,0.80,175,190,160,22,12,10,31,11,20,15,8,7,-5,-4,-1,62%,50%,71%,118,135,103,22%,23%,22%,1,1,0,6,5,1
287,https://vlr.gg/player/3007/tdawgg,2025-02-11 16:00:00,0.88,0.59,0.72,157,183,136,21,11,10,32,13,19,17,10,7,-4,-3,-1,69%,72%,67%,96,108,86,23%,18%,30%,3,0,3,7,3,4
288,https://vlr.gg/player/41798/nightz,2025-02-11 16:00:00,0.51,0.87,0.70,177,120,216,21,7,14,35,14,21,12,6,6,-3,-2,-1,64%,67%,62%,123,85,155,52%,56%,50%,3,0,3,6,2,4
289,https://vlr.gg/player/4828/nismo,2025-02-11 16:00:00,1.13,0.31,0.69,151,233,88,20,15,5,31,13,18,8,6,2,-6,-1,-5,62%,78%,48%,109,153,70,43%,40%,50%,0,0,0,6,1,5
290,https://vlr.gg/player/34057/jerrwin,2025-02-11 16:00:00,1.55,1.35,1.44,332,348,325,76,36,40,45,20,25,11,7,4,+11,0,+11,70%,79%,62%,206,207,206,24%,22%,26%,19,6,13,8,6,2
291,https://vlr.gg/player/15051/sacred,2025-02-11 16:00:00,1.35,1.28,1.31,274,257,267,61,25,36,44,19,25,30,16,14,+5,+2,+3,70%,76%,65%,161,159,162,37%,35%,39%,9,4,5,4,2,2
292,https://vlr.gg/player/29688/mikee,2025-02-11 16:00:00,1.18,0.96,1.05,205,225,185,50,25,25,43,19,24,12,2,10,+2,-3,+5,76%,69%,81%,131,145,120,42%,43%,42%,7,1,6,5,4,1
293,https://vlr.gg/player/4385/monsi,2025-02-11 16:00:00,0.75,1.01,0.89,143,121,162,32,12,20,38,18,20,24,12,12,0,+1,-1,74%,72%,76%,102,88,114,32%,29%,33%,4,2,2,4,1,3
294,https://vlr.gg/player/3874/teague,2025-02-11 16:00:00,0.86,0.84,0.85,136,131,145,30,13,17,41,17,24,36,15,21,+2,-1,+3,71%,72%,70%,90,80,99,21%,20%,21%,4,1,3,2,2,0
295,https://vlr.gg/player/14048/zerona,2025-02-11 16:00:00,1.13,0.96,1.05,208,212,210,49,26,23,49,27,22,18,16,2,-5,-2,-3,62%,57%,69%,127,132,121,37%,34%,41%,1,0,1,6,2,4
296,https://vlr.gg/player/8397/dip,2025-02-11 16:00:00,0.95,1.07,1.00,189,182,207,44,24,20,46,25,21,13,6,7,-2,-5,+3,64%,62%,66%,127,118,139,19%,23%,15%,4,1,3,6,6,0
297,https://vlr.gg/player/8758/benjii,2025-02-11 16:00:00,1.23,0.67,0.98,178,210,142,42,30,12,46,24,22,15,5,10,-3,-2,-1,64%,65%,62%,121,134,105,24%,36%,15%,4,1,3,7,3,4
298,https://vlr.gg/player/20959/toozy,2025-02-11 16:00:00,0.71,0.86,0.77,158,153,162,32,16,16,52,30,22,32,19,13,-5,-3,-2,71%,73%,69%,108,107,111,25%,22%,30%,1,0,1,6,3,3
299,https://vlr.gg/player/21886/furbsa,2025-02-11 16:00:00,0.64,0.82,0.72,189,168,210,44,22,22,56,32,24,8,4,4,-5,-9,+4,62%,51%,76%,117,108,129,33%,34%,32%,13,6,7,18,15,3
300,https://vlr.gg/player/24853/patip,2025-02-11 15:00:00,1.49,1.30,1.38,281,300,251,41,20,21,28,13,15,13,3,10,+6,+2,+4,85%,76%,91%,172,180,166,25%,37%,17%,7,3,4,1,1,0
301,https://vlr.gg/player/27724/natasha,2025-02-11 15:00:00,1.12,0.93,1.01,208,228,211,30,14,16,31,13,18,11,6,5,-4,-2,-2,68%,65%,70%,173,192,159,25%,29%,21%,0,0,0,4,2,2
302,https://vlr.gg/player/29823/mizzy,2025-02-11 15:00:00,0.86,1.06,0.98,189,134,234,29,9,20,30,12,18,13,5,8,+2,0,+2,70%,59%,78%,117,81,144,32%,28%,34%,3,0,3,1,0,1
303,https://vlr.gg/player/24764/akame,2025-02-11 15:00:00,0.37,1.04,0.70,168,99,236,26,5,21,33,15,18,4,3,1,0,-1,+1,60%,59%,61%,99,58,129,25%,11%,32%,9,4,5,9,5,4
304,https://vlr.gg/player/24770/babzzz,2025-02-11 15:00:00,0.41,0.37,0.38,102,118,96,10,5,5,35,16,19,23,9,14,-2,0,-2,68%,59%,74%,66,71,62,11%,15%,9%,2,1,1,4,1,3
305,https://vlr.gg/player/33177/none,2025-02-11 15:00:00,1.19,1.53,1.33,306,274,344,40,21,19,29,17,12,12,8,4,+3,0,+3,73%,65%,82%,199,182,222,22%,25%,19%,7,3,4,4,3,1
306,https://vlr.gg/player/12126/kaah,2025-02-11 15:00:00,0.96,1.43,1.16,226,200,269,34,17,17,29,18,11,24,11,13,-2,0,-2,80%,78%,82%,159,123,206,31%,27%,35%,4,4,0,6,4,2
307,https://vlr.gg/player/35018/allie,2025-02-11 15:00:00,0.88,1.47,1.13,194,171,212,28,13,15,27,18,9,26,16,10,0,+1,-1,90%,91%,88%,121,107,141,36%,39%,33%,2,1,1,2,0,2
308,https://vlr.gg/player/11242/blu,2025-02-11 15:00:00,1.25,0.82,1.07,171,209,103,24,18,6,21,13,8,9,6,3,-1,0,-1,78%,78%,76%,106,139,61,24%,26%,19%,3,2,1,4,2,2
309,https://vlr.gg/player/19255/luiza,2025-02-11 15:00:00,1.05,0.94,1.01,212,230,196,31,19,12,30,17,13,11,4,7,-2,-4,+2,70%,74%,65%,147,155,136,30%,40%,23%,3,0,3,5,4,1
310,https://vlr.gg/player/15735/krostaly,2025-02-11 11:45:00,1.59,1.41,1.51,240,267,212,32,21,11,16,9,7,13,5,8,+2,+3,-1,83%,85%,81%,156,152,161,26%,33%,20%,4,4,0,2,1,1
311,https://vlr.gg/player/18655/best,2025-02-11 11:45:00,1.27,1.79,1.50,315,303,336,41,22,19,22,15,7,12,7,5,+4,+1,+3,86%,80%,94%,203,205,202,41%,51%,29%,7,3,4,3,2,1
312,https://vlr.gg/player/31307/yigox,2025-02-11 11:45:00,1.43,1.41,1.42,293,295,279,37,20,17,21,13,8,16,13,3,+4,+3,+1,86%,90%,81%,170,168,172,37%,43%,31%,6,3,3,2,0,2
313,https://vlr.gg/player/33551/slaughter,2025-02-11 11:45:00,1.01,1.46,1.21,177,155,202,23,11,12,18,10,8,26,9,17,-4,-2,-2,81%,75%,88%,108,108,108,33%,37%,29%,0,0,0,4,2,2
314,https://vlr.gg/player/40842/ibonata,2025-02-11 11:45:00,0.78,0.91,0.84,154,146,158,19,11,8,23,13,10,19,7,12,0,-1,+1,89%,80%,100%,91,81,103,21%,17%,25%,4,2,2,4,3,1
315,https://vlr.gg/player/10146/reazy,2025-02-11 11:45:00,0.72,1.11,0.94,174,115,227,21,7,14,28,12,16,8,3,5,+3,+1,+2,61%,44%,75%,121,72,161,31%,22%,34%,3,1,2,0,0,0
316,https://vlr.gg/player/3862/deepmans,2025-02-11 11:45:00,0.61,0.95,0.80,206,147,248,24,8,16,31,13,18,5,3,2,+3,+1,+2,61%,50%,70%,131,91,164,25%,24%,25%,8,4,4,5,3,2
317,https://vlr.gg/player/568/turko,2025-02-11 11:45:00,0.37,1.06,0.75,191,144,227,24,7,17,31,16,15,8,5,3,-4,-1,-3,67%,69%,65%,121,94,142,36%,33%,37%,0,0,0,4,1,3
318,https://vlr.gg/player/10975/naero,2025-02-11 11:45:00,0.72,0.57,0.64,133,139,127,15,7,8,29,12,17,10,3,7,-3,-2,-1,58%,63%,55%,85,92,81,31%,25%,38%,1,0,1,4,2,2
319,https://vlr.gg/player/569/paura,2025-02-11 11:45:00,0.82,0.19,0.46,118,189,74,15,11,4,33,14,19,4,2,2,-5,-1,-4,47%,44%,50%,78,112,50,15%,16%,14%,3,2,1,8,3,5
320,https://vlr.gg/player/13545/werlass,2025-02-11 09:30:00,1.39,1.50,1.45,272,269,277,42,20,22,32,17,15,8,2,6,-1,-2,+1,76%,76%,75%,182,173,189,32%,38%,28%,1,0,1,2,2,0
321,https://vlr.gg/player/10883/baransel,2025-02-11 09:30:00,0.54,1.14,0.86,183,146,214,29,11,18,35,18,17,9,3,6,-1,-1,0,69%,67%,71%,113,89,133,40%,44%,38%,3,2,1,4,3,1
322,https://vlr.gg/player/19776/jrayn,2025-02-11 09:30:00,0.43,1.15,0.81,144,102,174,23,8,15,29,16,13,17,7,10,+2,0,+2,76%,67%,83%,90,64,112,29%,29%,29%,2,0,2,0,0,0
323,https://vlr.gg/player/3549/touven,2025-02-11 09:30:00,0.75,0.81,0.79,206,194,226,31,12,19,38,18,20,20,9,11,0,+1,-1,69%,67%,71%,127,124,130,31%,29%,33%,11,5,6,11,4,7
324,https://vlr.gg/player/10152/padisah,2025-02-11 09:30:00,0.74,0.44,0.58,136,134,134,20,10,10,36,17,19,7,4,3,-3,-1,-2,60%,76%,46%,96,97,95,21%,19%,23%,4,2,2,7,3,4
325,https://vlr.gg/player/10161/qutionerx,2025-02-11 09:30:00,1.19,1.29,1.24,278,269,287,42,22,20,33,19,14,9,3,6,+2,+1,+1,73%,67%,81%,198,187,210,27%,31%,23%,10,6,4,8,5,3
326,https://vlr.gg/player/12774/anima,2025-02-11 09:30:00,0.88,1.47,1.15,171,140,198,29,12,17,23,14,9,12,7,5,0,-1,+1,71%,63%,81%,108,98,119,32%,31%,32%,3,1,2,3,2,1
327,https://vlr.gg/player/10160/izzy,2025-02-11 09:30:00,1.26,0.82,1.05,201,218,182,34,20,14,26,13,13,6,3,3,0,+1,-1,78%,75%,81%,131,145,115,18%,23%,13%,2,2,0,2,1,1
328,https://vlr.gg/player/8041/brave,2025-02-11 09:30:00,0.73,1.37,1.03,217,195,242,33,15,18,34,22,12,19,11,8,-3,-2,-1,67%,63%,71%,137,120,156,34%,30%,38%,4,1,3,7,3,4
329,https://vlr.gg/player/10163/cyderx,2025-02-11 09:30:00,0.92,1.08,1.00,189,168,212,32,15,17,29,16,13,11,4,7,+4,+1,+3,76%,71%,81%,128,119,139,31%,33%,28%,5,2,3,1,1,0
330,https://vlr.gg/player/2346/cud,2025-02-11 08:10:00,1.46,1.46,1.46,238,237,221,42,15,27,20,8,12,14,3,11,+9,+2,+7,88%,88%,88%,150,152,149,37%,47%,32%,9,2,7,0,0,0
331,https://vlr.gg/player/16852/nakya,2025-02-11 08:10:00,1.47,1.43,1.44,313,335,310,54,19,35,34,12,22,10,5,5,+13,+1,+12,82%,88%,79%,200,201,199,25%,46%,15%,18,5,13,5,4,1
332,https://vlr.gg/player/23710/gotten,2025-02-11 08:10:00,0.99,1.58,1.37,225,148,249,38,8,30,25,11,14,27,11,16,+1,-2,+3,82%,71%,88%,142,85,171,35%,23%,39%,4,0,4,3,2,1
333,https://vlr.gg/player/9263/sayoo,2025-02-11 08:10:00,0.90,1.59,1.35,225,144,259,42,10,32,26,12,14,11,4,7,+6,+2,+4,90%,88%,91%,145,92,172,32%,29%,33%,7,3,4,1,1,0
334,https://vlr.gg/player/1745/adrnking,2025-02-11 08:10:00,0.91,0.89,0.90,154,158,147,29,10,19,27,11,16,19,9,10,+1,0,+1,78%,82%,76%,100,106,96,34%,29%,38%,2,0,2,1,0,1
335,https://vlr.gg/player/37421/riyabtw,2025-02-11 08:10:00,0.75,1.20,0.88,183,171,241,35,20,15,39,28,11,5,2,3,-2,-3,+1,56%,52%,65%,128,117,150,39%,43%,33%,4,2,2,6,5,1
336,https://vlr.gg/player/7851/uta,2025-02-11 08:10:00,0.87,0.41,0.71,149,174,111,26,20,6,41,27,14,11,6,5,-9,-6,-3,54%,55%,53%,108,124,78,30%,37%,19%,2,0,2,11,6,5
337,https://vlr.gg/player/1346/watasink,2025-02-11 08:10:00,0.44,1.13,0.67,139,117,235,26,13,13,41,29,12,10,3,7,-5,-4,-1,58%,48%,76%,105,77,160,24%,19%,29%,2,0,2,7,4,3
338,https://vlr.gg/player/47977/chak,2025-02-11 08:10:00,0.44,1.13,0.67,144,122,206,27,14,13,43,30,13,5,1,4,-7,-8,+1,56%,55%,59%,102,87,131,35%,44%,27%,1,0,1,8,8,0
339,https://vlr.gg/player/24302/chimei,2025-02-11 08:10:00,0.40,0.57,0.46,98,99,126,16,10,6,41,29,12,13,8,5,-7,-6,-1,46%,39%,59%,67,59,83,15%,14%,15%,1,1,0,8,7,1
340,https://vlr.gg/player/22047/rarga,2025-02-11 06:45:00,,,,245,,,39,,,41,,,8,,,,,,,,,,,,,,,,,,,,
341,https://vlr.gg/player/36415/viva,2025-02-11 06:45:00,,,,185,,,34,,,38,,,13,,,,,,,,,,,,,,,,,,,,
342,https://vlr.gg/player/4710/you,2025-02-11 06:45:00,,,,182,,,31,,,36,,,15,,,,,,,,,,,,,,,,,,,,
343,https://vlr.gg/player/12365/coconut,2025-02-11 06:45:00,,,,167,,,26,,,38,,,16,,,,,,,,,,,,,,,,,,,,
344,https://vlr.gg/player/37927/happywei,2025-02-11 06:45:00,,,,145,,,23,,,40,,,12,,,,,,,,,,,,,,,,,,,,
345,https://vlr.gg/player/41029/z1yan,2025-02-11 06:45:00,,,,254,,,42,,,34,,,14,,,,,,,,,,,,,,,,,,,,
346,https://vlr.gg/player/16924/stew,2025-02-11 06:45:00,,,,231,,,42,,,32,,,12,,,,,,,,,,,,,,,,,,,,
347,https://vlr.gg/player/15302/babyblue,2025-02-11 06:45:00,,,,228,,,37,,,30,,,17,,,,,,,,,,,,,,,,,,,,
348,https://vlr.gg/player/3519/jkuro,2025-02-11 06:45:00,,,,218,,,37,,,29,,,18,,,,,,,,,,,,,,,,,,,,
349,https://vlr.gg/player/37674/mrcani,2025-02-11 06:45:00,,,,197,,,35,,,28,,,22,,,,,,,,,,,,,,,,,,,,
350,https://vlr.gg/player/49001/secre,2025-02-11 06:00:00,0.98,1.34,1.18,217,181,250,33,12,21,30,13,17,4,1,3,+1,-1,+2,75%,70%,79%,148,127,165,34%,38%,31%,5,1,4,4,2,2
351,https://vlr.gg/player/44149/pr0digy,2025-02-11 06:00:00,0.69,1.28,1.01,215,162,254,33,11,22,33,15,18,4,0,4,0,-1,+1,57%,50%,63%,138,109,162,33%,41%,29%,7,3,4,7,4,3
352,https://vlr.gg/player/14207/viness,2025-02-11 06:00:00,1.12,0.58,0.82,180,252,120,27,18,9,34,15,19,10,5,5,+4,+2,+2,55%,60%,50%,115,165,74,40%,42%,38%,7,4,3,3,2,1
353,https://vlr.gg/player/44919/aplycs,2025-02-11 06:00:00,0.78,0.60,0.68,144,143,151,23,10,13,35,14,21,13,7,6,-3,-1,-2,70%,70%,71%,94,83,103,36%,22%,48%,1,0,1,4,1,3
354,https://vlr.gg/player/12322/ndg,2025-02-11 06:00:00,0.46,0.85,0.67,124,91,152,18,7,11,32,15,17,14,1,13,0,-1,+1,64%,55%,71%,84,60,103,21%,21%,21%,3,1,2,3,2,1
355,https://vlr.gg/player/31537/basbabe,2025-02-11 06:00:00,1.46,1.58,1.52,266,257,277,42,22,20,22,12,10,24,13,11,+5,+3,+2,86%,88%,85%,156,151,161,29%,28%,30%,7,4,3,2,1,1
356,https://vlr.gg/player/41694/endoist,2025-02-11 06:00:00,1.33,1.34,1.34,306,313,299,46,27,19,32,18,14,8,2,6,0,0,0,68%,71%,65%,195,192,199,33%,37%,29%,9,4,5,9,4,5
357,https://vlr.gg/player/41701/ki1wsy,2025-02-11 06:00:00,0.98,1.41,1.17,205,191,226,35,17,18,25,16,9,13,9,4,+2,0,+2,75%,71%,80%,145,138,153,32%,33%,30%,4,2,2,2,2,0
358,https://vlr.gg/player/17303/fontuz,2025-02-11 06:00:00,0.92,0.94,0.93,153,146,160,21,11,10,25,13,12,20,13,7,-3,-2,-1,68%,75%,60%,109,100,120,21%,19%,25%,1,0,1,4,2,2
359,https://vlr.gg/player/20623/harddora,2025-02-11 06:00:00,0.75,0.53,0.65,134,175,80,20,15,5,30,17,13,8,7,1,-6,-5,-1,66%,67%,65%,93,120,61,28%,31%,20%,0,0,0,6,5,1
360,https://vlr.gg/player/1395/tennn,2025-02-11 06:00:00,1.21,1.22,1.20,236,253,230,59,29,30,48,22,26,30,13,17,+1,0,+1,73%,71%,75%,152,164,142,27%,31%,24%,8,3,5,7,3,4
361,https://vlr.gg/player/1003/reita,2025-02-11 06:00:00,0.84,1.46,1.18,208,158,250,51,16,35,42,22,20,27,15,12,+3,0,+3,78%,74%,81%,141,111,167,27%,23%,30%,9,3,6,6,3,3
362,https://vlr.gg/player/34776/absol,2025-02-11 06:00:00,1.28,1.08,1.17,265,280,251,60,31,29,46,21,25,21,8,13,+1,+4,-3,78%,81%,75%,171,184,159,14%,15%,12%,13,9,4,12,5,7
363,https://vlr.gg/player/686/tonbo,2025-02-11 06:00:00,1.48,0.82,1.12,182,232,134,42,26,16,37,15,22,23,10,13,-1,+2,-3,73%,71%,75%,120,152,92,29%,30%,28%,3,3,0,4,1,3
364,https://vlr.gg/player/23971/ask,2025-02-11 06:00:00,0.71,1.05,0.89,165,142,186,34,13,21,41,22,19,24,14,10,-3,-1,-2,82%,81%,83%,122,108,134,22%,18%,24%,1,0,1,4,1,3
365,https://vlr.gg/player/51094/falk,2025-02-11 06:00:00,0.98,1.02,1.00,197,198,196,48,26,22,49,27,22,20,9,11,+2,+4,-2,73%,69%,77%,128,125,132,38%,44%,32%,4,4,0,2,0,2
366,https://vlr.gg/player/49906/honeybunny,2025-02-11 06:00:00,1.07,0.86,0.97,234,251,218,54,32,22,54,28,26,9,4,5,+7,+5,+2,63%,61%,65%,148,162,131,24%,35%,15%,18,10,8,11,5,6
367,https://vlr.gg/player/43054/lefiedot,2025-02-11 06:00:00,0.61,1.24,0.90,175,117,237,40,14,26,46,26,20,8,6,2,-2,-1,-1,64%,61%,68%,119,81,163,24%,22%,25%,2,1,1,4,2,2
368,https://vlr.gg/player/40738/killaa,2025-02-11 06:00:00,0.85,0.94,0.89,157,141,174,35,17,18,48,24,24,26,9,17,-4,-4,0,67%,64%,71%,107,105,109,28%,27%,29%,2,0,2,6,4,2
369,https://vlr.gg/player/34753/solluzy,2025-02-11 06:00:00,0.86,0.58,0.73,153,184,122,37,23,14,49,26,23,6,4,2,-4,0,-4,61%,64%,58%,101,123,74,20%,24%,11%,7,5,2,11,5,6
370,https://vlr.gg/player/4705/flex1n,2025-02-11 04:00:00,,,,256,,,55,,,44,,,17,,,,,,,,,,,,,,,,,,,,
371,https://vlr.gg/player/11524/nicc,2025-02-11 04:00:00,,,,193,,,41,,,43,,,27,,,,,,,,,,,,,,,,,,,,
372,https://vlr.gg/player/46527/cangshu,2025-02-11 04:00:00,,,,176,,,38,,,49,,,12,,,,,,,,,,,,,,,,,,,,
373,https://vlr.gg/player/51250/ying,2025-02-11 04:00:00,,,,164,,,33,,,49,,,9,,,,,,,,,,,,,,,,,,,,
374,https://vlr.gg/player/31753/spiritz1,2025-02-11 04:00:00,,,,145,,,30,,,47,,,13,,,,,,,,,,,,,,,,,,,,
375,https://vlr.gg/player/14125/spring,2025-02-11 04:00:00,,,,294,,,63,,,43,,,14,,,,,,,,,,,,,,,,,,,,
376,https://vlr.gg/player/7426/juicy,2025-02-11 04:00:00,,,,254,,,53,,,37,,,32,,,,,,,,,,,,,,,,,,,,
377,https://vlr.gg/player/11218/yuicaw,2025-02-11 04:00:00,,,,210,,,45,,,39,,,27,,,,,,,,,,,,,,,,,,,,
378,https://vlr.gg/player/37489/lysoar,2025-02-11 04:00:00,,,,190,,,39,,,38,,,11,,,,,,,,,,,,,,,,,,,,
379,https://vlr.gg/player/7849/siufatbb,2025-02-11 04:00:00,,,,147,,,32,,,41,,,11,,,,,,,,,,,,,,,,,,,,
380,https://vlr.gg/player/10642/jan,2025-02-11 02:00:00,1.31,1.20,1.25,207,191,224,55,25,30,42,17,25,16,8,8,+1,+1,0,77%,76%,78%,146,130,160,32%,36%,29%,5,2,3,4,1,3
381,https://vlr.gg/player/46355/jerry,2025-02-11 02:00:00,1.33,0.93,1.12,212,234,188,54,29,25,49,22,27,18,8,10,-3,0,-3,72%,76%,69%,136,151,121,38%,44%,32%,7,4,3,10,4,6
382,https://vlr.gg/player/25279/sakura,2025-02-11 02:00:00,0.64,1.05,0.85,179,112,242,40,11,29,54,23,31,31,16,15,+3,-1,+4,75%,73%,78%,121,82,157,49%,38%,56%,9,2,7,6,3,3
383,https://vlr.gg/player/17111/allen,2025-02-11 02:00:00,0.72,0.95,0.84,176,161,193,40,18,22,50,25,25,34,15,19,-2,+1,-3,72%,70%,75%,111,100,121,20%,18%,21%,2,2,0,4,1,3
384,https://vlr.gg/player/43072/jinbey,2025-02-11 02:00:00,1.01,0.61,0.80,179,220,139,45,28,17,52,24,28,9,3,6,-6,-2,-4,67%,76%,58%,110,135,87,24%,28%,19%,8,6,2,14,8,6
385,https://vlr.gg/player/10769/nobita,2025-02-11 02:00:00,1.49,0.93,1.22,246,294,198,61,39,22,44,22,22,13,4,9,+6,+6,0,74%,75%,73%,158,188,126,32%,38%,23%,12,8,4,6,2,4
386,https://vlr.gg/player/10628/misaya,2025-02-11 02:00:00,1.02,1.18,1.09,190,169,215,43,20,23,43,22,21,37,19,18,-2,-2,0,74%,72%,76%,129,109,152,21%,29%,16%,3,1,2,5,3,2
387,https://vlr.gg/player/40726/gwangboong,2025-02-11 02:00:00,0.85,1.15,1.00,226,211,245,56,26,30,52,28,24,17,7,10,-1,-2,+1,62%,56%,70%,147,136,159,31%,28%,35%,10,6,4,11,8,3
388,https://vlr.gg/player/48431/kippei,2025-02-11 02:00:00,0.98,0.99,0.99,190,192,184,41,22,19,48,26,22,33,18,15,+2,+2,0,72%,78%,67%,123,129,115,24%,29%,19%,7,2,5,5,0,5
389,https://vlr.gg/player/29840/yuran,2025-02-11 02:00:00,1.05,0.88,0.97,188,229,148,45,29,16,47,25,22,19,7,12,+2,+2,0,74%,72%,76%,128,151,103,25%,27%,22%,6,4,2,4,2,2
390,https://vlr.gg/player/873/bob,2025-02-10 18:35:00,1.45,1.24,1.36,231,257,193,34,22,12,23,15,8,12,7,5,-1,0,-1,83%,83%,81%,158,170,140,18%,20%,14%,1,1,0,2,1,1
391,https://vlr.gg/player/11696/zoestol,2025-02-10 18:35:00,0.96,1.53,1.19,220,198,255,32,17,15,27,18,9,20,11,9,-2,-3,+1,70%,54%,94%,134,123,152,19%,24%,16%,2,1,1,4,4,0
392,https://vlr.gg/player/25902/shondex,2025-02-10 18:35:00,1.06,1.39,1.19,255,219,311,38,19,19,28,17,11,7,4,3,-1,-2,+1,70%,63%,81%,169,155,191,39%,33%,46%,3,1,2,4,3,1
393,https://vlr.gg/player/13831/zeldris,2025-02-10 18:35:00,1.16,0.99,1.09,270,260,285,36,21,15,32,18,14,8,5,3,+3,0,+3,73%,79%,63%,168,166,172,29%,31%,26%,11,5,6,8,5,3
394,https://vlr.gg/player/26848/zeek,2025-02-10 18:35:00,0.54,1.04,0.74,147,111,204,19,8,11,30,19,11,26,16,10,+1,-1,+2,78%,75%,81%,92,69,127,15%,22%,10%,3,1,2,2,2,0
395,https://vlr.gg/player/893/retrq,2025-02-10 18:35:00,1.11,1.15,1.13,215,227,208,31,13,18,30,14,16,11,3,8,-3,-2,-1,78%,69%,83%,154,164,147,29%,23%,34%,1,0,1,4,2,2
396,https://vlr.gg/player/2125/nanners,2025-02-10 18:35:00,0.62,1.18,0.96,210,165,240,29,9,20,31,14,17,13,2,11,-1,-2,+1,68%,50%,79%,124,113,132,25%,24%,26%,6,2,4,7,4,3
397,https://vlr.gg/player/17770/alvinboy,2025-02-10 18:35:00,1.25,0.62,0.88,211,305,149,29,18,11,34,15,19,10,3,7,0,+1,-1,70%,88%,58%,140,182,112,35%,42%,28%,3,1,2,3,0,3
398,https://vlr.gg/player/24553/boni,2025-02-10 18:35:00,0.38,1.27,0.86,211,92,292,29,3,26,33,15,18,8,6,2,+4,-2,+6,68%,63%,71%,129,74,166,13%,12%,14%,8,2,6,4,4,0
399,https://vlr.gg/player/3719/matt,2025-02-10 18:35:00,0.72,0.81,0.77,166,180,157,22,10,12,31,14,17,16,5,11,0,-1,+1,75%,81%,71%,103,121,92,10%,9%,11%,2,0,2,2,1,1
400,https://vlr.gg/player/7716/penny,2025-02-10 18:35:00,1.33,1.01,1.18,261,306,208,41,26,15,29,15,14,10,6,4,+12,+7,+5,87%,88%,86%,165,189,137,19%,23%,13%,17,10,7,5,3,2
401,https://vlr.gg/player/733/stellar,2025-02-10 18:35:00,1.05,1.20,1.12,192,147,239,28,12,16,27,11,16,26,12,14,-1,-1,0,80%,79%,81%,128,102,158,18%,15%,20%,1,0,1,2,1,1
402,https://vlr.gg/player/8742/jakee,2025-02-10 18:35:00,1.09,0.98,1.04,190,197,188,34,18,16,30,14,16,20,13,7,+4,0,+4,78%,79%,76%,111,118,104,22%,33%,15%,7,3,4,3,3,0
403,https://vlr.gg/player/739/fiziq,2025-02-10 18:35:00,0.91,1.06,0.98,169,164,171,27,14,13,26,13,13,11,2,9,0,0,0,69%,63%,76%,102,101,104,16%,18%,14%,2,0,2,2,0,2
404,https://vlr.gg/player/69/thief,2025-02-10 18:35:00,0.85,1.03,0.93,164,160,169,26,13,13,28,15,13,17,8,9,-4,-4,0,76%,71%,81%,109,104,115,22%,23%,21%,1,0,1,5,4,1
405,https://vlr.gg/player/2172/brawk,2025-02-10 18:35:00,1.40,0.85,1.10,206,239,182,34,20,14,31,13,18,8,4,4,-2,-1,-1,71%,71%,71%,146,170,125,18%,15%,20%,2,0,2,4,1,3
406,https://vlr.gg/player/8422/spaz,2025-02-10 18:35:00,1.02,1.06,1.04,187,175,201,27,13,14,30,13,17,21,9,12,-2,-2,0,62%,62%,63%,125,120,130,22%,24%,21%,2,0,2,4,2,2
407,https://vlr.gg/player/864/bcj,2025-02-10 18:35:00,1.01,0.94,0.97,174,184,169,29,14,15,30,14,16,19,9,10,-3,-3,0,78%,76%,79%,108,114,103,16%,12%,23%,2,0,2,5,3,2
408,https://vlr.gg/player/23407/pa1nt,2025-02-10 18:35:00,0.68,1.15,0.93,213,206,222,30,14,16,35,19,16,10,5,5,0,-1,+1,69%,62%,75%,139,131,146,20%,22%,19%,8,4,4,8,5,3
409,https://vlr.gg/player/2164/paincakes,2025-02-10 18:35:00,0.83,0.59,0.70,138,157,115,20,11,9,31,15,16,13,10,3,-4,-2,-2,62%,71%,54%,80,92,69,24%,26%,23%,3,2,1,7,4,3
410,https://vlr.gg/player/27357/lay,2025-02-10 17:00:00,1.11,1.12,1.11,167,170,175,35,18,17,36,19,17,27,10,17,+1,+1,0,74%,63%,85%,115,111,118,33%,39%,26%,3,2,1,2,1,1
411,https://vlr.gg/player/40456/aura,2025-02-10 17:00:00,0.92,1.18,1.04,216,190,249,44,20,24,40,23,17,13,6,7,0,0,0,67%,63%,70%,137,119,156,23%,18%,28%,7,4,3,7,4,3
412,https://vlr.gg/player/41615/luyta,2025-02-10 17:00:00,0.93,0.97,0.95,170,180,176,35,19,16,37,21,16,8,1,7,+5,+4,+1,65%,60%,70%,126,135,115,31%,45%,20%,9,6,3,4,2,2
413,https://vlr.gg/player/36649/gigika,2025-02-10 17:00:00,0.89,0.98,0.93,173,175,191,35,17,18,40,22,18,26,13,13,+1,-1,+2,75%,70%,81%,113,111,116,20%,20%,20%,6,2,4,5,3,2
414,https://vlr.gg/player/40493/setrexz,2025-02-10 17:00:00,0.52,1.39,0.93,185,116,281,39,12,27,41,24,17,6,3,3,+4,-2,+6,72%,57%,89%,133,91,180,33%,28%,38%,9,2,7,5,4,1
415,https://vlr.gg/player/11256/isa1,2025-02-10 17:00:00,0.75,1.39,1.09,250,192,281,48,17,31,43,23,20,9,3,6,0,0,0,68%,52%,83%,152,128,173,22%,28%,18%,10,5,5,10,5,5
416,https://vlr.gg/player/12111/daniops,2025-02-10 17:00:00,0.87,1.16,1.02,193,184,189,38,18,20,33,19,14,11,3,8,-8,-5,-3,70%,59%,80%,126,124,128,28%,24%,32%,1,0,1,9,5,4
417,https://vlr.gg/player/14291/mindle,2025-02-10 17:00:00,0.86,1.10,0.99,191,198,176,37,19,18,37,21,16,12,0,12,-2,-2,0,67%,63%,70%,117,124,112,31%,30%,33%,6,3,3,8,5,3
418,https://vlr.gg/player/11247/misty,2025-02-10 17:00:00,1.02,0.94,0.98,169,180,162,35,17,18,38,20,18,25,17,8,+1,-1,+2,74%,78%,70%,110,113,108,32%,29%,35%,4,1,3,3,2,1
419,https://vlr.gg/player/11244/gabit,2025-02-10 17:00:00,0.90,1.00,0.96,192,170,205,36,14,22,37,19,18,24,17,7,-2,-1,-1,79%,78%,80%,129,113,142,25%,24%,25%,2,0,2,4,1,3
420,https://vlr.gg/player/7652/tuli,2025-02-10 16:05:00,0.95,1.53,1.21,266,238,299,62,29,33,47,29,18,11,6,5,+3,-3,+6,73%,69%,77%,175,157,198,31%,34%,29%,14,5,9,11,8,3
421,https://vlr.gg/player/43935/ruso,2025-02-10 16:05:00,1.02,1.28,1.14,228,218,243,59,31,28,46,28,18,12,6,6,+3,0,+3,79%,81%,77%,144,136,154,27%,27%,28%,8,5,3,5,5,0
422,https://vlr.gg/player/8278/knzy,2025-02-10 16:05:00,1.02,1.11,1.06,188,180,196,45,22,23,40,22,18,26,19,7,-2,-1,-1,77%,75%,80%,127,114,142,19%,21%,17%,2,1,1,4,2,2
423,https://vlr.gg/player/2931/vaiz,2025-02-10 16:05:00,1.04,1.01,1.03,222,230,217,50,29,21,49,28,21,21,11,10,-2,+1,-3,82%,78%,87%,162,163,162,25%,27%,22%,4,3,1,6,2,4
424,https://vlr.gg/player/2909/alca,2025-02-10 16:05:00,0.69,0.77,0.73,156,164,147,37,21,16,46,28,18,17,9,8,-3,-3,0,76%,75%,77%,103,114,90,35%,40%,28%,4,1,3,7,4,3
425,https://vlr.gg/player/8892/snw,2025-02-10 16:05:00,0.98,1.18,1.09,244,236,252,57,25,32,56,27,29,14,4,10,+8,+3,+5,71%,67%,75%,164,162,165,18%,40%,9%,18,8,10,10,5,5
426,https://vlr.gg/player/12872/david,2025-02-10 16:05:00,0.80,1.16,1.00,202,165,238,48,18,30,48,22,26,22,6,16,+4,-1,+5,82%,77%,86%,138,116,156,30%,36%,28%,7,1,6,3,2,1
427,https://vlr.gg/player/783/murizzz,2025-02-10 16:05:00,0.94,1.01,0.98,187,177,195,42,17,25,49,22,27,22,10,12,-4,-3,-1,68%,63%,72%,132,127,136,34%,35%,33%,1,0,1,5,3,2
428,https://vlr.gg/player/13860/rubkkoide,2025-02-10 16:05:00,0.85,0.99,0.93,202,211,195,44,21,23,51,26,25,20,8,12,-6,-4,-2,73%,67%,78%,140,139,141,31%,32%,30%,3,1,2,9,5,4
429,https://vlr.gg/player/46901/maxhinh9,2025-02-10 16:05:00,0.47,0.93,0.72,154,114,190,37,12,25,49,24,25,10,3,7,-1,0,-1,71%,63%,78%,100,75,122,22%,16%,25%,4,2,2,5,2,3
430,https://vlr.gg/player/1856/wedid,2025-02-10 16:00:00,1.18,1.19,1.18,233,204,240,45,21,24,36,15,21,11,4,7,0,0,0,71%,64%,78%,138,126,150,18%,17%,19%,4,3,1,4,3,1
431,https://vlr.gg/player/34400/bao,2025-02-10 16:00:00,1.17,0.80,0.98,170,221,118,31,19,12,32,16,16,12,5,7,-1,+1,-2,65%,64%,67%,118,154,84,28%,29%,26%,5,3,2,6,2,4
432,https://vlr.gg/player/30470/kyu,2025-02-10 16:00:00,0.78,1.10,0.95,161,123,205,31,11,20,34,16,18,18,6,12,-3,-1,-2,85%,76%,93%,104,81,126,27%,16%,34%,1,0,1,4,1,3
433,https://vlr.gg/player/844/bdog,2025-02-10 16:00:00,0.99,0.84,0.91,171,203,164,32,17,15,35,18,17,19,9,10,+1,+2,-1,75%,80%,70%,119,124,114,24%,19%,27%,5,4,1,4,2,2
434,https://vlr.gg/player/8373/okeanos,2025-02-10 16:00:00,0.67,1.01,0.85,212,197,237,39,17,22,39,21,18,8,4,4,-1,-3,+2,79%,76%,81%,144,137,150,21%,29%,15%,9,2,7,10,5,5
435,https://vlr.gg/player/64/gmd,2025-02-10 16:00:00,1.13,1.28,1.20,245,232,254,44,22,22,38,19,19,26,16,10,-1,0,-1,81%,85%,76%,159,135,184,36%,31%,39%,4,2,2,5,2,3
436,https://vlr.gg/player/20140/vora,2025-02-10 16:00:00,1.05,1.13,1.09,215,207,213,39,20,19,32,18,14,11,7,4,+1,0,+1,83%,78%,88%,132,125,138,21%,29%,16%,2,1,1,1,1,0
437,https://vlr.gg/player/3702/sym,2025-02-10 16:00:00,1.16,0.86,1.02,222,256,186,39,24,15,39,20,19,7,4,3,+2,+2,0,62%,63%,60%,149,166,132,28%,40%,13%,13,8,5,11,6,5
438,https://vlr.gg/player/8376/seven,2025-02-10 16:00:00,0.92,1.01,0.96,164,162,170,28,14,14,33,18,15,31,17,14,+1,+1,0,77%,74%,80%,102,100,104,21%,25%,17%,3,1,2,2,0,2
439,https://vlr.gg/player/39602/recoil,2025-02-10 16:00:00,0.64,0.86,0.75,146,127,177,26,10,16,36,18,18,11,7,4,+1,0,+1,73%,70%,76%,101,85,118,17%,25%,13%,6,3,3,5,3,2
440,https://vlr.gg/player/48025/alym,2025-02-10 16:00:00,1.51,1.83,1.67,350,329,359,74,34,40,38,21,17,9,6,3,+7,+5,+2,76%,70%,83%,205,194,217,34%,37%,30%,17,10,7,10,5,5
441,https://vlr.gg/player/10053/fireballops,2025-02-10 16:00:00,0.98,1.23,1.10,227,233,218,48,24,24,40,23,17,11,4,7,0,+2,-2,78%,77%,79%,157,163,151,35%,30%,40%,6,5,1,6,3,3
442,https://vlr.gg/player/862/b0i,2025-02-10 16:00:00,1.06,1.04,1.05,181,170,196,38,19,19,37,18,19,34,18,16,0,0,0,83%,73%,93%,120,107,133,25%,21%,29%,0,0,0,0,0,0
443,https://vlr.gg/player/62/huynh,2025-02-10 16:00:00,1.02,1.08,1.05,206,205,203,45,24,21,42,23,19,14,3,11,0,+2,-2,75%,70%,79%,134,139,129,27%,29%,25%,4,3,1,4,1,3
444,https://vlr.gg/player/9094/kess,2025-02-10 16:00:00,0.71,0.85,0.78,165,142,192,33,15,18,41,20,21,17,7,10,0,-1,+1,73%,63%,83%,116,102,131,31%,30%,33%,6,1,5,6,2,4
445,https://vlr.gg/player/765/jerk,2025-02-10 16:00:00,1.03,1.04,1.04,190,204,176,40,22,18,43,23,20,24,11,13,-1,0,-1,73%,69%,77%,124,138,112,22%,19%,27%,2,1,1,3,1,2
446,https://vlr.gg/player/9837/flare,2025-02-10 16:00:00,0.89,1.01,0.95,198,209,197,42,20,22,46,24,22,23,10,13,+2,+3,-1,71%,69%,73%,138,143,132,31%,27%,34%,5,4,1,3,1,2
447,https://vlr.gg/player/9063/infiltrator,2025-02-10 16:00:00,0.74,0.95,0.85,209,204,231,45,21,24,51,26,25,7,3,4,-6,0,-6,68%,72%,63%,137,129,144,32%,24%,41%,7,5,2,13,5,8
448,https://vlr.gg/player/17865/nahsie,2025-02-10 16:00:00,0.81,0.82,0.81,171,160,177,34,16,18,46,23,23,12,5,7,-4,0,-4,59%,66%,53%,117,110,124,29%,23%,35%,2,1,1,6,1,5
449,https://vlr.gg/player/9017/moobs,2025-02-10 16:00:00,0.50,0.94,0.72,181,135,223,37,14,23,52,26,26,8,2,6,+2,-2,+4,63%,48%,77%,121,92,150,39%,31%,44%,10,4,6,8,6,2
450,https://vlr.gg/player/24359/faska,2025-02-10 15:20:00,0.69,1.33,1.02,223,169,274,35,12,23,38,19,19,13,4,9,+7,+2,+5,66%,57%,75%,146,111,180,31%,48%,25%,11,5,6,4,3,1
451,https://vlr.gg/player/6925/chadi,2025-02-10 15:20:00,0.80,1.12,0.96,205,197,212,31,14,17,35,20,15,10,6,4,-2,-3,+1,74%,78%,71%,136,135,138,26%,33%,20%,7,2,5,9,5,4
452,https://vlr.gg/player/2835/kyrrz,2025-02-10 15:20:00,0.64,1.23,0.94,168,154,180,32,13,19,33,19,14,11,5,6,0,+1,-1,72%,70%,75%,109,94,123,41%,38%,42%,4,3,1,4,2,2
453,https://vlr.gg/player/4851/rexs,2025-02-10 15:20:00,0.84,0.83,0.84,173,181,166,26,12,14,34,18,16,24,12,12,+1,-2,+3,70%,74%,67%,118,127,110,24%,19%,31%,3,0,3,2,2,0
454,https://vlr.gg/player/19588/neptuno,2025-02-10 15:20:00,0.57,0.91,0.74,145,126,164,24,11,13,32,18,14,9,3,6,-1,-1,0,55%,52%,58%,102,88,114,26%,24%,28%,1,0,1,2,1,1
455,https://vlr.gg/player/6959/flickless,2025-02-10 15:20:00,1.14,1.43,1.28,221,207,235,36,16,20,26,15,11,28,14,14,+2,+1,+1,85%,79%,91%,136,139,134,29%,31%,27%,3,2,1,1,1,0
456,https://vlr.gg/player/8834/bucher,2025-02-10 15:20:00,1.20,1.23,1.21,231,234,225,39,20,19,29,17,12,8,2,6,+1,+2,-1,79%,79%,78%,153,152,154,34%,35%,34%,4,2,2,3,0,3
457,https://vlr.gg/player/15473/yuno,2025-02-10 15:20:00,1.21,1.18,1.19,211,226,197,35,19,16,31,17,14,28,14,14,-1,-1,0,77%,79%,74%,139,133,145,27%,38%,18%,1,0,1,2,1,1
458,https://vlr.gg/player/1839/polvi,2025-02-10 15:20:00,0.66,1.49,1.07,245,190,301,38,14,24,34,20,14,12,5,7,0,-5,+5,70%,58%,83%,170,135,205,21%,23%,19%,12,4,8,12,9,3
459,https://vlr.gg/player/341/quick,2025-02-10 15:20:00,0.66,1.18,0.91,156,128,188,24,9,15,28,17,11,19,11,8,-7,-5,-2,66%,58%,74%,104,87,122,23%,19%,27%,1,0,1,8,5,3
460,https://vlr.gg/player/14690/lissa,2025-02-10 15:00:00,0.68,1.41,0.96,174,159,246,24,12,12,27,19,8,5,2,3,-1,-2,+1,51%,48%,57%,133,106,174,38%,37%,39%,4,1,3,5,3,2
461,https://vlr.gg/player/6994/shyz,2025-02-10 15:00:00,0.68,0.90,0.77,163,166,176,19,11,8,30,20,10,10,4,6,-3,-2,-1,54%,52%,57%,119,104,141,36%,36%,36%,3,3,0,6,5,1
462,https://vlr.gg/player/9821/m4ndzin,2025-02-10 15:00:00,0.30,1.35,0.71,123,85,199,16,5,11,29,20,9,15,5,10,-1,0,-1,54%,33%,86%,91,61,137,37%,29%,42%,0,0,0,1,0,1
463,https://vlr.gg/player/2245/krysme,2025-02-10 15:00:00,0.49,0.96,0.68,147,115,194,17,7,10,29,18,11,1,1,0,0,0,0,51%,43%,64%,103,80,138,34%,29%,39%,2,1,1,2,1,1
464,https://vlr.gg/player/42397/winter,2025-02-10 15:00:00,0.30,0.53,0.39,142,140,175,16,8,8,34,21,13,5,3,2,-2,-3,+1,43%,38%,50%,103,100,107,28%,33%,22%,5,2,3,7,5,2
465,https://vlr.gg/player/14386/isaa,2025-02-10 15:00:00,1.19,1.75,1.53,247,227,277,34,11,23,15,9,6,8,1,7,-1,0,-1,89%,86%,90%,158,143,168,27%,37%,22%,1,0,1,2,0,2
466,https://vlr.gg/player/12143/bizerra,2025-02-10 15:00:00,1.48,1.49,1.49,212,250,190,27,12,15,13,7,6,10,2,8,+2,+1,+1,83%,71%,90%,160,183,145,22%,19%,25%,3,1,2,1,0,1
467,https://vlr.gg/player/11232/daiki,2025-02-10 15:00:00,0.59,1.75,1.29,273,115,342,31,5,26,22,11,11,19,7,12,+3,0,+3,77%,71%,81%,167,60,239,28%,60%,25%,5,1,4,2,1,1
468,https://vlr.gg/player/4807/bstrdd,2025-02-10 15:00:00,0.60,1.60,1.20,254,209,269,31,10,21,21,12,9,7,2,5,+2,-1,+3,77%,57%,90%,160,124,184,34%,33%,35%,7,3,4,5,4,1
469,https://vlr.gg/player/15297/joojina,2025-02-10 15:00:00,1.18,0.99,1.07,188,228,169,26,13,13,21,10,11,12,5,7,+1,0,+1,89%,71%,100%,130,172,103,47%,41%,54%,5,2,3,4,2,2
470,https://vlr.gg/player/45955/ego1st,2025-02-10 14:00:00,1.38,0.98,1.18,232,265,206,34,19,15,28,14,14,16,8,8,-1,-1,0,84%,94%,74%,153,171,137,60%,59%,61%,2,0,2,3,1,2
471,https://vlr.gg/player/41128/mathi,2025-02-10 14:00:00,1.62,0.59,1.09,232,320,151,28,19,9,29,14,15,13,11,2,+2,+2,0,73%,94%,53%,152,209,99,21%,18%,30%,5,3,2,3,1,2
472,https://vlr.gg/player/21646/nash,2025-02-10 14:00:00,0.79,1.17,0.98,191,175,208,24,10,14,30,16,14,12,5,7,+2,+1,+1,73%,72%,74%,130,111,148,31%,23%,40%,3,2,1,1,1,0
473,https://vlr.gg/player/29123/kivary,2025-02-10 14:00:00,0.69,1.16,0.93,212,186,232,29,12,17,30,16,14,6,2,4,+2,-2,+4,70%,67%,74%,130,123,138,24%,26%,22%,9,4,5,7,6,1
474,https://vlr.gg/player/43908/levi,2025-02-10 14:00:00,0.18,0.78,0.49,92,48,131,12,3,9,28,15,13,14,6,8,-4,0,-4,70%,61%,79%,59,31,85,24%,50%,18%,0,0,0,4,0,4
475,https://vlr.gg/player/2403/mizu,2025-02-10 14:00:00,1.54,1.00,1.28,251,286,214,35,20,15,25,12,13,12,9,3,0,+1,-1,76%,84%,67%,168,194,140,46%,40%,59%,4,2,2,4,1,3
476,https://vlr.gg/player/1291/bnj,2025-02-10 14:00:00,1.31,1.17,1.24,238,244,231,33,18,15,26,13,13,21,11,10,+2,+1,+1,81%,79%,83%,145,147,144,29%,33%,24%,4,2,2,2,1,1
477,https://vlr.gg/player/2586/hanling,2025-02-10 14:00:00,0.81,1.63,1.21,190,128,255,26,9,17,21,12,9,20,7,13,-1,-1,0,73%,63%,83%,130,79,183,33%,20%,40%,0,0,0,1,1,0
478,https://vlr.gg/player/15916/jotinha,2025-02-10 14:00:00,1.27,0.72,1.00,183,242,119,23,15,8,24,12,12,12,6,6,0,+1,-1,76%,89%,61%,131,171,89,33%,37%,26%,3,1,2,3,0,3
479,https://vlr.gg/player/2818/neto,2025-02-10 14:00:00,0.39,1.24,0.81,223,139,315,27,8,19,31,15,16,13,1,12,-2,-3,+1,59%,47%,72%,145,99,194,20%,27%,17%,7,4,3,9,7,2
480,https://vlr.gg/player/1615/destrian,2025-02-10 13:30:00,1.18,0.66,0.97,178,209,139,24,17,7,35,20,15,26,15,11,-1,-1,0,64%,65%,61%,117,137,89,25%,24%,28%,4,2,2,5,3,2
481,https://vlr.gg/player/363/7ssk7,2025-02-10 13:30:00,0.86,1.06,0.94,165,161,200,26,14,12,32,19,13,19,12,7,-1,-1,0,73%,77%,67%,116,108,126,43%,45%,41%,0,0,0,1,1,0
482,https://vlr.gg/player/44922/golack,2025-02-10 13:30:00,0.91,0.96,0.93,220,204,235,33,18,15,36,22,14,7,5,2,-1,+1,-2,57%,62%,50%,128,127,131,31%,35%,24%,9,6,3,10,5,5
483,https://vlr.gg/player/173/l0udly,2025-02-10 13:30:00,0.75,0.59,0.69,142,165,155,25,16,9,38,21,17,8,3,5,-7,-5,-2,52%,46%,61%,109,111,106,37%,38%,35%,1,0,1,8,5,3
484,https://vlr.gg/player/443/zeddy,2025-02-10 13:30:00,0.28,1.15,0.63,130,109,205,22,8,14,39,25,14,8,3,5,-4,-4,0,57%,38%,83%,100,77,133,17%,11%,23%,1,0,1,5,4,1
485,https://vlr.gg/player/38424/zachkappa,2025-02-10 13:30:00,1.32,1.51,1.43,265,250,265,42,17,25,22,11,11,9,5,4,+9,+3,+6,84%,89%,81%,164,166,162,24%,32%,17%,11,4,7,2,1,1
486,https://vlr.gg/player/22154/pika,2025-02-10 13:30:00,1.45,0.99,1.18,252,289,231,43,20,23,29,10,19,8,4,4,0,-1,+1,80%,78%,81%,160,202,131,38%,49%,30%,4,1,3,4,2,2
487,https://vlr.gg/player/3127/monsteerr,2025-02-10 13:30:00,1.16,1.09,1.12,197,244,172,31,16,15,25,12,13,20,6,14,+1,-1,+2,82%,72%,88%,130,145,121,27%,27%,27%,3,1,2,2,2,0
488,https://vlr.gg/player/8502/olizera,2025-02-10 13:30:00,1.11,1.10,1.10,216,200,224,33,12,21,26,11,15,12,5,7,0,+1,-1,77%,72%,81%,144,153,138,30%,40%,24%,6,2,4,6,1,5
489,https://vlr.gg/player/5199/guardy,2025-02-10 13:30:00,0.60,1.30,1.02,208,130,241,31,8,23,28,13,15,21,9,12,+4,+2,+2,86%,89%,85%,130,72,171,25%,15%,29%,5,3,2,1,1,0
490,https://vlr.gg/player/1155/buld,2025-02-10 13:30:00,1.01,1.78,1.45,268,199,315,40,13,27,23,13,10,10,4,6,0,-3,+3,79%,59%,95%,163,115,200,23%,25%,22%,4,1,3,4,4,0
491,https://vlr.gg/player/4519/kamisseq,2025-02-10 13:30:00,1.27,1.34,1.31,258,259,252,36,15,21,27,13,14,20,9,11,-1,-1,0,79%,82%,77%,170,166,172,31%,31%,31%,2,0,2,3,1,2
492,https://vlr.gg/player/402/insider,2025-02-10 13:30:00,1.40,0.94,1.14,212,243,197,29,15,14,25,11,14,9,2,7,-2,0,-2,67%,65%,68%,148,170,131,32%,37%,28%,3,1,2,5,1,4
493,https://vlr.gg/player/3784/katu,2025-02-10 13:30:00,0.61,0.85,0.74,168,158,171,22,10,12,28,15,13,5,2,3,-3,-3,0,67%,53%,77%,99,83,110,22%,10%,32%,5,1,4,8,4,4
494,https://vlr.gg/player/23347/alannn,2025-02-10 13:30:00,0.22,0.70,0.49,101,71,121,14,4,10,30,15,15,9,4,5,-1,-2,+1,67%,76%,59%,63,42,79,35%,18%,45%,2,1,1,3,3,0
495,https://vlr.gg/player/6909/jannyxd,2025-02-10 13:30:00,1.18,1.20,1.18,285,272,297,39,20,19,32,19,13,4,2,2,+10,+4,+6,74%,68%,82%,176,172,180,17%,17%,16%,13,6,7,3,2,1
496,https://vlr.gg/player/15376/grtw,2025-02-10 13:30:00,1.09,1.07,1.08,170,173,189,25,13,12,23,14,9,8,6,2,-2,-2,0,72%,73%,71%,125,129,119,44%,38%,52%,2,0,2,4,2,2
497,https://vlr.gg/player/1493/starkk,2025-02-10 13:30:00,0.74,0.99,0.85,190,158,238,24,11,13,30,17,13,18,10,8,-1,-3,+2,77%,73%,82%,124,102,152,27%,26%,28%,3,1,2,4,4,0
498,https://vlr.gg/player/13435/fragger,2025-02-10 13:30:00,0.77,0.86,0.81,162,161,158,22,13,9,29,18,11,17,8,9,+1,0,+1,74%,64%,88%,102,95,112,36%,35%,38%,3,2,1,2,2,0
499,https://vlr.gg/player/5203/bati,2025-02-10 13:30:00,0.60,1.03,0.79,151,118,201,23,9,14,27,16,11,5,3,2,-1,-1,0,67%,64%,71%,106,86,131,20%,19%,21%,2,1,1,3,2,1
0,https://vlr.gg/player/21584/deminatix,2025-02-10 12:30:00,1.29,1.51,1.38,277,272,283,35,19,16,19,12,7,6,4,2,+3,+2,+1,83%,90%,75%,174,170,179,20%,25%,15%,8,4,4,5,2,3
1,https://vlr.gg/player/12226/sturnn,2025-02-10 12:30:00,1.26,1.31,1.28,246,242,266,34,18,16,21,11,10,12,5,7,0,0,0,81%,80%,81%,177,170,187,33%,38%,27%,2,1,1,2,1,1
2,https://vlr.gg/player/11516/drky,2025-02-10 12:30:00,1.34,1.02,1.19,201,225,165,26,17,9,18,9,9,11,3,8,+3,+2,+1,83%,90%,75%,131,153,104,29%,31%,25%,3,2,1,0,0,0
3,https://vlr.gg/player/10114/baha,2025-02-10 12:30:00,1.17,1.19,1.18,222,200,253,29,15,14,18,10,8,10,5,5,-2,-4,+2,86%,85%,88%,148,137,162,41%,35%,48%,3,1,2,5,5,0
4,https://vlr.gg/player/16483/gloomy,2025-02-10 12:30:00,0.84,1.01,0.91,182,183,175,23,12,11,23,14,9,5,4,1,0,0,0,72%,75%,69%,128,122,136,17%,15%,20%,4,2,2,4,2,2
5,https://vlr.gg/player/33551/slaughter,2025-02-10 12:30:00,0.74,1.22,1.01,207,107,281,24,6,18,27,12,15,9,4,5,+2,0,+2,64%,56%,70%,136,75,185,37%,43%,35%,3,0,3,1,0,1
6,https://vlr.gg/player/15735/krostaly,2025-02-10 12:30:00,1.06,0.75,0.89,209,257,176,26,15,11,29,13,16,9,2,7,+2,+1,+1,61%,63%,60%,128,139,119,30%,25%,37%,4,2,2,2,1,1
7,https://vlr.gg/player/18655/best,2025-02-10 12:30:00,1.16,0.44,0.76,189,274,128,23,14,9,32,14,18,4,4,0,0,+1,-1,67%,88%,50%,111,165,68,28%,33%,18%,6,4,2,6,3,3
8,https://vlr.gg/player/31307/yigox,2025-02-10 12:30:00,0.57,0.76,0.67,136,120,149,17,7,10,30,13,17,4,1,3,-4,-3,-1,56%,50%,60%,104,79,125,23%,14%,30%,1,0,1,5,3,2
9,https://vlr.gg/player/40842/ibonata,2025-02-10 12:30:00,0.23,0.60,0.44,81,53,105,9,1,8,29,14,15,11,8,3,-4,-3,-1,61%,63%,60%,57,42,70,21%,9%,35%,2,0,2,6,3,3
10,https://vlr.gg/player/2534/lowel,2025-02-10 11:00:00,1.42,1.15,1.31,216,236,192,29,18,11,18,9,9,25,13,12,-1,0,-1,88%,83%,94%,133,143,119,27%,24%,34%,3,2,1,4,2,2
11,https://vlr.gg/player/292/fit1nho,2025-02-10 11:00:00,1.24,1.21,1.23,208,197,220,30,18,12,22,14,8,14,8,6,-1,+1,-2,71%,75%,65%,142,130,158,34%,29%,40%,3,2,1,4,1,3
12,https://vlr.gg/player/7220/saiz,2025-02-10 11:00:00,0.85,1.74,1.22,220,179,278,36,17,19,20,15,5,3,0,3,-1,-2,+1,71%,58%,88%,139,112,177,38%,30%,49%,2,0,2,3,2,1
13,https://vlr.gg/player/41220/krejz,2025-02-10 11:00:00,0.90,1.41,1.11,221,202,247,32,17,15,25,16,9,7,1,6,0,-2,+2,66%,54%,82%,141,128,160,24%,30%,19%,7,4,3,7,6,1
14,https://vlr.gg/player/20271/vorwenn,2025-02-10 11:00:00,0.86,0.99,0.91,185,155,230,26,12,14,26,14,12,8,3,5,+2,+1,+1,73%,71%,76%,118,103,139,25%,23%,29%,5,3,2,3,2,1
15,https://vlr.gg/player/2190/baddyg,2025-02-10 11:00:00,0.99,1.40,1.23,217,170,253,31,10,21,27,12,15,14,4,10,+2,+1,+1,73%,76%,71%,138,116,154,23%,23%,23%,6,2,4,4,1,3
16,https://vlr.gg/player/8226/waddle,2025-02-10 11:00:00,0.82,0.84,0.83,186,206,174,26,12,14,32,15,17,9,5,4,+1,-1,+2,66%,65%,67%,130,127,132,34%,31%,37%,3,0,3,2,1,1
17,https://vlr.gg/player/1470/simond4rk,2025-02-10 11:00:00,0.80,0.81,0.81,163,196,139,22,12,10,29,15,14,3,0,3,+4,+4,0,61%,59%,63%,100,124,83,18%,31%,10%,8,5,3,4,1,3
18,https://vlr.gg/player/12474/tag,2025-02-10 11:00:00,0.33,0.84,0.63,142,81,184,19,5,14,32,14,18,9,1,8,-2,-4,+2,54%,47%,58%,87,46,116,25%,36%,23%,3,0,3,5,4,1
19,https://vlr.gg/player/1944/cayden,2025-02-10 11:00:00,0.41,0.55,0.49,97,82,109,13,4,9,33,15,18,13,6,7,-4,-1,-3,59%,53%,63%,61,50,68,22%,35%,16%,1,1,0,5,2,3
20,https://vlr.gg/player/16209/famsii,2025-02-10 11:00:00,1.42,1.14,1.28,235,270,213,44,25,19,35,17,18,15,10,5,-2,-2,0,78%,86%,70%,159,175,143,33%,34%,31%,4,1,3,6,3,3
21,https://vlr.gg/player/1524/h1ber,2025-02-10 11:00:00,1.35,1.08,1.22,248,279,203,46,29,17,34,17,17,23,17,6,0,0,0,80%,89%,70%,164,183,144,32%,28%,39%,4,3,1,4,3,1
22,https://vlr.gg/player/18162/serial,2025-02-10 11:00:00,1.12,1.12,1.12,178,168,192,37,18,19,31,15,16,11,8,3,-3,0,-3,78%,82%,74%,133,131,135,42%,27%,70%,2,2,0,5,2,3
23,https://vlr.gg/player/8805/sacake,2025-02-10 11:00:00,1.38,0.85,1.12,193,240,150,40,26,14,35,16,19,20,13,7,+1,0,+1,75%,86%,63%,115,140,88,24%,29%,18%,5,1,4,4,1,3
24,https://vlr.gg/player/29972/michel,2025-02-10 11:00:00,0.70,0.74,0.72,175,158,189,32,14,18,41,20,21,10,6,4,+3,+2,+1,71%,82%,59%,115,110,121,27%,29%,25%,12,7,5,9,5,4
25,https://vlr.gg/player/5854/z3ro,2025-02-10 11:00:00,0.97,1.19,1.08,203,177,236,38,17,21,38,17,21,15,6,9,+5,-1,+6,65%,67%,64%,139,123,154,29%,28%,30%,9,2,7,4,3,1
26,https://vlr.gg/player/2617/leare,2025-02-10 11:00:00,1.34,0.63,0.98,234,307,173,49,30,19,44,20,24,4,2,2,-5,+1,-6,64%,74%,54%,142,183,102,29%,27%,31%,5,4,1,10,3,7
27,https://vlr.gg/player/1472/falltw,2025-02-10 11:00:00,1.21,0.65,0.93,191,230,149,34,20,14,40,16,24,22,11,11,-1,0,-1,71%,74%,68%,120,149,92,33%,29%,41%,8,5,3,9,5,4
28,https://vlr.gg/player/4277/n-a-i-s,2025-02-10 11:00:00,0.91,0.72,0.81,169,171,171,30,16,14,38,16,22,10,6,4,+3,+3,0,75%,85%,64%,115,113,116,23%,24%,21%,5,3,2,2,0,2
29,https://vlr.gg/player/15384/mot1on,2025-02-10 11:00:00,0.49,1.05,0.77,127,76,177,25,8,17,39,18,21,21,7,14,-1,-2,+1,73%,78%,68%,80,43,115,45%,40%,47%,1,0,1,2,2,0
30,https://vlr.gg/player/40591/comeback,2025-02-10 09:30:00,1.46,1.59,1.54,315,319,294,45,16,29,24,11,13,7,5,2,+3,+2,+1,87%,87%,88%,196,183,205,21%,23%,19%,6,4,2,3,2,1
31,https://vlr.gg/player/31305/lar0k,2025-02-10 09:30:00,1.58,1.43,1.49,286,276,283,38,15,23,23,8,15,19,7,12,-2,-2,0,79%,73%,83%,179,177,180,24%,23%,25%,3,1,2,5,3,2
32,https://vlr.gg/player/5565/ros,2025-02-10 09:30:00,0.92,1.10,1.03,171,151,177,26,8,18,21,8,13,9,5,4,-2,-1,-1,72%,80%,67%,107,101,111,17%,20%,16%,1,0,1,3,1,2
33,https://vlr.gg/player/12795/crewen,2025-02-10 09:30:00,1.21,0.76,0.94,148,168,138,21,11,10,23,8,15,9,1,8,0,0,0,72%,67%,75%,102,112,96,29%,37%,23%,3,1,2,3,1,2
34,https://vlr.gg/player/24344/loita,2025-02-10 09:30:00,0.94,0.86,0.89,179,144,208,23,7,16,27,9,18,13,8,5,0,0,0,74%,80%,71%,114,83,133,38%,24%,50%,6,1,5,6,1,5
35,https://vlr.gg/player/13545/werlass,2025-02-10 09:30:00,0.87,1.12,0.97,193,171,238,27,14,13,31,19,12,8,6,2,+1,+2,-1,69%,71%,67%,134,114,165,41%,44%,37%,2,2,0,1,0,1
36,https://vlr.gg/player/10883/baransel,2025-02-10 09:30:00,1.09,0.46,0.85,170,192,125,21,16,5,30,18,12,17,10,7,+1,+2,-1,69%,67%,73%,115,133,87,47%,46%,47%,4,3,1,3,1,2
37,https://vlr.gg/player/3549/touven,2025-02-10 09:30:00,0.64,0.99,0.78,189,157,245,24,12,12,33,20,13,4,3,1,0,-3,+3,56%,50%,67%,123,98,164,24%,16%,39%,6,2,4,6,5,1
38,https://vlr.gg/player/19776/jrayn,2025-02-10 09:30:00,0.69,0.88,0.77,162,151,171,21,11,10,28,19,9,14,12,2,0,0,0,69%,63%,80%,98,94,103,40%,56%,27%,1,0,1,1,0,1
39,https://vlr.gg/player/10152/padisah,2025-02-10 09:30:00,0.97,0.12,0.63,184,242,84,25,21,4,34,20,14,4,3,1,-1,-1,0,56%,67%,40%,116,150,61,31%,33%,27%,7,5,2,8,6,2
40,https://vlr.gg/player/9747/emman,2025-02-10 08:15:00,1.35,1.28,1.31,241,248,237,60,30,30,41,19,22,14,8,6,+5,+1,+4,83%,88%,79%,158,146,170,36%,29%,43%,8,3,5,3,2,1
41,https://vlr.gg/player/11578/hotsauz,2025-02-10 08:15:00,1.14,1.30,1.22,206,168,245,50,20,30,41,19,22,31,13,18,+1,-1,+2,76%,72%,79%,135,123,146,35%,30%,39%,4,1,3,3,2,1
42,https://vlr.gg/player/9737/kakarot,2025-02-10 08:15:00,1.11,0.99,1.05,221,238,203,52,26,26,42,21,21,13,7,6,-1,0,-1,76%,66%,85%,142,153,132,17%,17%,17%,9,5,4,10,5,5
43,https://vlr.gg/player/7746/kevzii,2025-02-10 08:15:00,1.12,0.86,0.99,187,187,185,42,22,20,47,20,27,18,9,9,-1,+1,-2,76%,81%,71%,130,133,127,41%,36%,47%,4,3,1,5,2,3
44,https://vlr.gg/player/16953/zynd,2025-02-10 08:15:00,0.92,0.77,0.84,188,209,167,42,22,20,47,24,23,11,7,4,-6,-5,-1,65%,69%,62%,124,141,109,24%,31%,17%,7,2,5,13,7,6
45,https://vlr.gg/player/42901/thyy,2025-02-10 08:15:00,1.34,1.02,1.18,220,236,209,54,29,25,46,23,23,25,16,9,-1,-1,0,71%,71%,72%,147,156,137,43%,49%,37%,0,0,0,1,1,0
46,https://vlr.gg/player/41702/canady,2025-02-10 08:15:00,1.20,1.02,1.11,197,212,184,47,26,21,42,22,20,20,12,8,+4,+5,-1,70%,76%,63%,132,140,123,42%,41%,43%,7,6,1,3,1,2
47,https://vlr.gg/player/46102/snappy,2025-02-10 08:15:00,0.78,0.88,0.83,217,197,239,50,23,27,56,28,28,6,5,1,+4,-3,+7,65%,71%,59%,133,117,149,34%,32%,37%,14,4,10,10,7,3
48,https://vlr.gg/player/23062/surf,2025-02-10 08:15:00,0.66,0.90,0.78,168,151,188,37,18,19,50,27,23,13,7,6,+3,-2,+5,65%,62%,69%,113,100,127,36%,54%,26%,11,5,6,8,7,1
49,https://vlr.gg/player/37547/tbloy,2025-02-10 08:15:00,0.82,0.45,0.64,135,159,109,30,19,11,52,26,26,23,16,7,-8,-1,-7,67%,71%,63%,94,105,83,26%,27%,24%,2,1,1,10,2,8
50,https://vlr.gg/player/6022/yosemite,2025-02-10 06:30:00,,,,297,,,34,,,30,,,13,,,,,,,,,,,,,,,,,,,,
51,https://vlr.gg/player/872/autumn,2025-02-10 06:30:00,,,,153,,,19,,,28,,,7,,,,,,,,,,,,,,,,,,,,
52,https://vlr.gg/player/19530/aaaay,2025-02-10 06:30:00,,,,151,,,22,,,29,,,13,,,,,,,,,,,,,,,,,,,,
53,https://vlr.gg/player/3028/life,2025-02-10 06:30:00,,,,149,,,18,,,29,,,7,,,,,,,,,,,,,,,,,,,,
54,https://vlr.gg/player/7857/berlin,2025-02-10 06:30:00,,,,121,,,16,,,29,,,19,,,,,,,,,,,,,,,,,,,,
55,https://vlr.gg/player/46460/ezeir,2025-02-10 06:30:00,,,,261,,,37,,,19,,,10,,,,,,,,,,,,,,,,,,,,
56,https://vlr.gg/player/4402/o0o0o,2025-02-10 06:30:00,,,,244,,,32,,,21,,,20,,,,,,,,,,,,,,,,,,,,
57,https://vlr.gg/player/39697/cb,2025-02-10 06:30:00,,,,217,,,27,,,23,,,17,,,,,,,,,,,,,,,,,,,,
58,https://vlr.gg/player/41054/guang,2025-02-10 06:30:00,,,,196,,,27,,,24,,,11,,,,,,,,,,,,,,,,,,,,
59,https://vlr.gg/player/36670/obone,2025-02-10 06:30:00,,,,166,,,22,,,22,,,17,,,,,,,,,,,,,,,,,,,,
60,https://vlr.gg/player/24628/wayne,2025-02-10 06:00:00,1.26,1.35,1.31,243,263,220,38,16,22,30,14,16,29,18,11,0,0,0,89%,95%,84%,137,154,123,27%,26%,28%,2,1,1,2,1,1
61,https://vlr.gg/player/13220/ja,2025-02-10 06:00:00,0.81,1.47,1.18,206,158,234,31,11,20,27,14,13,18,6,12,+2,0,+2,80%,75%,84%,154,124,178,24%,32%,20%,3,1,2,1,1,0
62,https://vlr.gg/player/1430/crazyguy,2025-02-10 06:00:00,1.02,1.26,1.16,209,180,237,37,16,21,29,13,16,7,1,6,+1,-2,+3,71%,75%,68%,141,120,157,23%,22%,24%,5,0,5,4,2,2
63,https://vlr.gg/player/11704/styron,2025-02-10 06:00:00,1.31,0.69,0.97,182,227,143,30,17,13,31,12,19,16,8,8,-1,0,-1,80%,85%,76%,124,155,99,24%,29%,19%,2,2,0,3,2,1
64,https://vlr.gg/player/24653/vera,2025-02-10 06:00:00,0.86,0.68,0.76,181,207,149,26,14,12,34,16,18,7,3,4,+1,+4,-3,64%,65%,64%,123,138,110,18%,16%,23%,12,7,5,11,3,8
65,https://vlr.gg/player/13744/patmen,2025-02-10 06:00:00,1.21,1.40,1.29,239,225,266,39,20,19,31,16,15,14,9,5,+2,+3,-1,80%,80%,80%,160,137,188,38%,34%,43%,5,4,1,3,1,2
66,https://vlr.gg/player/7754/xavi8k,2025-02-10 06:00:00,0.97,1.34,1.13,240,193,283,35,16,19,32,18,14,18,10,8,-2,-3,+1,76%,76%,75%,163,134,200,33%,36%,30%,2,1,1,4,4,0
67,https://vlr.gg/player/3401/ptc,2025-02-10 06:00:00,0.76,1.00,0.87,164,150,187,26,12,14,30,17,13,3,2,1,-1,-2,+1,62%,64%,60%,111,107,117,31%,39%,24%,3,1,2,4,3,1
68,https://vlr.gg/player/16842/mojer,2025-02-10 06:00:00,0.94,0.71,0.84,193,232,166,32,20,12,35,19,16,6,3,3,-3,-1,-2,67%,80%,50%,138,164,105,36%,37%,35%,8,4,4,11,5,6
69,https://vlr.gg/player/6913/sultan,2025-02-10 06:00:00,0.79,0.39,0.62,124,160,90,19,14,5,34,18,16,23,11,12,+1,+2,-1,80%,80%,80%,81,98,60,29%,29%,31%,3,2,1,2,0,2
70,https://vlr.gg/player/48878/rushia,2025-02-10 04:00:00,,,,252,,,50,,,40,,,30,,,,,,,,,,,,,,,,,,,,
71,https://vlr.gg/player/40845/levius,2025-02-10 04:00:00,,,,204,,,39,,,41,,,13,,,,,,,,,,,,,,,,,,,,
72,https://vlr.gg/player/4885/whzy,2025-02-10 04:00:00,,,,203,,,44,,,48,,,6,,,,,,,,,,,,,,,,,,,,
73,https://vlr.gg/player/10698/nephh,2025-02-10 04:00:00,,,,200,,,39,,,39,,,20,,,,,,,,,,,,,,,,,,,,
74,https://vlr.gg/player/4774/knight,2025-02-10 04:00:00,,,,189,,,40,,,40,,,18,,,,,,,,,,,,,,,,,,,,
75,https://vlr.gg/player/41739/slowly,2025-02-10 04:00:00,,,,229,,,45,,,45,,,19,,,,,,,,,,,,,,,,,,,,
76,https://vlr.gg/player/3547/ninebody,2025-02-10 04:00:00,,,,224,,,50,,,39,,,7,,,,,,,,,,,,,,,,,,,,
77,https://vlr.gg/player/7135/hfmi0dzjc9z7,2025-02-10 04:00:00,,,,200,,,41,,,43,,,15,,,,,,,,,,,,,,,,,,,,
78,https://vlr.gg/player/47101/5cm,2025-02-10 04:00:00,,,,188,,,36,,,45,,,12,,,,,,,,,,,,,,,,,,,,
79,https://vlr.gg/player/47102/waituu,2025-02-10 04:00:00,,,,165,,,36,,,41,,,21,,,,,,,,,,,,,,,,,,,,
80,https://vlr.gg/player/8790/mininiwde,2025-02-09 20:00:00,1.66,1.29,1.45,238,276,223,42,21,21,23,8,15,19,9,10,+5,+4,+1,83%,89%,79%,153,160,147,27%,27%,28%,6,5,1,1,1,0
81,https://vlr.gg/player/8792/xhowi,2025-02-09 20:00:00,1.20,1.48,1.36,299,272,314,44,18,26,26,12,14,15,7,8,+2,+1,+1,71%,78%,67%,187,170,199,33%,31%,34%,4,1,3,2,0,2
82,https://vlr.gg/player/36405/jrmzie,2025-02-09 20:00:00,0.93,1.15,1.06,211,187,217,32,13,19,28,12,16,5,3,2,+10,+2,+8,74%,78%,71%,142,124,155,38%,33%,41%,13,4,9,3,2,1
83,https://vlr.gg/player/2497/dobsha,2025-02-09 20:00:00,1.54,0.53,0.96,193,297,124,29,19,10,27,10,17,16,9,7,-4,-2,-2,79%,100%,63%,135,207,82,23%,26%,17%,2,0,2,6,2,4
84,https://vlr.gg/player/17694/prask,2025-02-09 20:00:00,0.94,0.82,0.87,185,175,196,27,12,15,32,12,20,13,7,6,0,+1,-1,86%,89%,83%,135,124,143,25%,18%,30%,2,2,0,2,1,1
85,https://vlr.gg/player/1328/javiierh,2025-02-09 20:00:00,0.80,1.36,1.04,227,193,303,35,18,17,33,18,15,11,5,6,-4,-4,0,69%,67%,72%,152,122,192,22%,26%,20%,4,2,2,8,6,2
86,https://vlr.gg/player/17669/pompz,2025-02-09 20:00:00,0.85,0.81,0.83,196,195,181,26,14,12,36,19,17,15,9,6,+2,+1,+1,69%,75%,61%,120,122,118,25%,20%,34%,4,2,2,2,1,1
87,https://vlr.gg/player/49571/paganus,2025-02-09 20:00:00,1.08,0.51,0.83,184,222,137,25,18,7,34,17,17,9,6,3,-7,-2,-5,74%,88%,56%,136,160,104,19%,29%,11%,1,1,0,8,3,5
88,https://vlr.gg/player/24013/navarro,2025-02-09 20:00:00,1.05,0.45,0.80,180,222,120,23,17,6,34,18,16,14,10,4,0,0,0,74%,83%,61%,127,157,87,24%,22%,32%,0,0,0,0,0,0
89,https://vlr.gg/player/46891/sventy,2025-02-09 20:00:00,0.71,0.71,0.71,183,177,208,27,15,12,37,19,18,6,3,3,-4,-2,-2,69%,67%,72%,119,110,131,20%,14%,31%,5,3,2,9,5,4
90,https://vlr.gg/player/17676/dexuz,2025-02-09 17:00:00,1.23,0.75,1.05,216,241,150,42,30,12,42,26,16,21,13,8,0,+2,-2,72%,74%,68%,131,153,97,16%,17%,13%,3,2,1,3,0,3
91,https://vlr.gg/player/38881/wetysao,2025-02-09 17:00:00,0.78,1.44,1.03,228,183,288,44,24,20,45,28,17,11,5,6,+4,-1,+5,75%,71%,82%,145,121,183,34%,34%,33%,11,5,6,7,6,1
92,https://vlr.gg/player/35559/pandejalea,2025-02-09 17:00:00,0.88,1.07,0.95,206,214,205,40,25,15,44,29,15,19,11,8,+2,+3,-1,68%,66%,73%,135,138,131,26%,25%,28%,12,10,2,10,7,3
93,https://vlr.gg/player/38912/yuno,2025-02-09 17:00:00,1.08,0.76,0.94,201,233,161,44,31,13,45,26,19,18,10,8,-6,-4,-2,68%,69%,68%,136,145,121,35%,36%,32%,0,0,0,6,4,2
94,https://vlr.gg/player/8781/charlslol,2025-02-09 17:00:00,0.85,0.86,0.86,152,161,150,32,20,12,43,27,16,26,16,10,-3,-1,-2,82%,86%,77%,101,105,93,28%,30%,26%,1,0,1,4,1,3
95,https://vlr.gg/player/10718/rowancy,2025-02-09 17:00:00,1.42,1.31,1.35,261,267,259,53,22,31,37,14,23,15,2,13,-1,0,-1,74%,73%,74%,189,171,200,27%,28%,26%,5,2,3,6,2,4
96,https://vlr.gg/player/26757/otaq,2025-02-09 17:00:00,1.20,1.17,1.18,229,225,234,42,17,25,40,15,25,27,9,18,+3,+2,+1,84%,82%,86%,150,144,153,19%,20%,18%,7,2,5,4,0,4
97,https://vlr.gg/player/31476/mephisto,2025-02-09 17:00:00,1.06,1.16,1.12,259,254,258,51,20,31,44,17,27,14,2,12,+1,+1,0,79%,82%,77%,164,166,163,20%,30%,15%,11,7,4,10,6,4
98,https://vlr.gg/player/15931/peloncito,2025-02-09 17:00:00,0.99,0.96,0.98,197,169,204,38,13,25,40,14,26,27,12,15,-1,0,-1,68%,73%,66%,128,121,133,29%,30%,29%,3,1,2,4,1,3
99,https://vlr.gg/player/10581/ryu,2025-02-09 17:00:00,0.70,0.80,0.76,164,129,177,34,10,24,41,13,28,16,7,9,+1,-1,+2,75%,64%,83%,101,93,106,32%,32%,32%,4,0,4,3,1,2
100,https://vlr.gg/player/42397/winter,2025-02-09 17:00:00,1.48,1.03,1.28,283,319,237,65,42,23,47,25,22,11,6,5,+10,+6,+4,74%,76%,72%,181,203,153,27%,28%,27%,18,11,7,8,5,3
101,https://vlr.gg/player/9821/m4ndzin,2025-02-09 17:00:00,1.15,1.30,1.22,227,208,238,51,28,23,43,23,20,26,17,9,0,-1,+1,70%,78%,59%,145,143,148,30%,31%,28%,4,2,2,4,3,1
102,https://vlr.gg/player/14690/lissa,2025-02-09 17:00:00,1.17,0.66,0.93,196,243,144,43,30,13,51,27,24,36,19,17,-7,-2,-5,65%,76%,52%,133,161,97,34%,35%,32%,4,2,2,11,4,7
103,https://vlr.gg/player/2245/krysme,2025-02-09 17:00:00,0.85,0.98,0.91,196,212,180,47,29,18,48,28,20,18,6,12,+1,+3,-2,70%,73%,66%,128,140,112,26%,23%,32%,6,5,1,5,2,3
104,https://vlr.gg/player/6994/shyz,2025-02-09 17:00:00,0.71,0.58,0.65,107,110,103,24,15,9,44,23,21,17,7,10,-2,-1,-1,65%,65%,66%,77,78,76,25%,29%,21%,2,1,1,4,2,2
105,https://vlr.gg/player/33177/none,2025-02-09 17:00:00,1.11,1.42,1.28,307,244,344,68,25,43,50,18,32,11,3,8,+1,0,+1,71%,69%,73%,189,155,216,21%,22%,20%,14,6,8,13,6,7
106,https://vlr.gg/player/19255/luiza,2025-02-09 17:00:00,1.33,0.85,1.05,196,260,151,47,28,19,41,16,25,10,3,7,0,+3,-3,62%,69%,57%,131,166,104,32%,41%,24%,7,6,1,7,3,4
107,https://vlr.gg/player/11242/blu,2025-02-09 17:00:00,1.03,0.92,0.97,163,162,164,39,17,22,42,16,26,18,8,10,+1,0,+1,74%,76%,73%,115,124,107,22%,13%,30%,2,0,2,1,0,1
108,https://vlr.gg/player/35018/allie,2025-02-09 17:00:00,0.98,0.94,0.96,165,158,173,41,17,24,48,19,29,26,12,14,+1,+1,0,76%,79%,73%,107,108,106,35%,37%,33%,5,3,2,4,2,2
109,https://vlr.gg/player/12126/kaah,2025-02-09 17:00:00,1.13,0.62,0.85,178,201,161,38,20,18,50,17,33,31,18,13,-5,-1,-4,71%,72%,70%,113,122,107,27%,45%,16%,4,1,3,9,2,7
110,https://vlr.gg/player/31574/srn,2025-02-09 15:00:00,1.96,1.92,1.95,440,446,434,52,37,15,22,15,7,8,7,1,+14,+9,+5,85%,88%,80%,294,297,285,30%,26%,41%,17,12,5,3,3,0
111,https://vlr.gg/player/19791/mel,2025-02-09 15:00:00,1.42,1.01,1.30,192,201,163,27,20,7,14,9,5,8,6,2,-2,0,-2,91%,96%,80%,122,130,103,37%,37%,36%,0,0,0,2,0,2
112,https://vlr.gg/player/21435/jelly,2025-02-09 15:00:00,1.32,1.09,1.26,231,235,166,29,23,6,17,10,7,14,11,3,+4,+3,+1,85%,88%,80%,138,150,110,35%,30%,60%,5,4,1,1,1,0
113,https://vlr.gg/player/14685/jubs,2025-02-09 15:00:00,0.95,1.44,1.09,177,158,230,23,15,8,15,11,4,9,5,4,+2,+1,+1,82%,83%,80%,125,107,167,41%,39%,43%,2,1,1,0,0,0
114,https://vlr.gg/player/11239/sayuri,2025-02-09 15:00:00,1.26,0.65,1.08,158,185,86,16,14,2,14,9,5,18,12,6,0,+1,-1,82%,88%,70%,105,128,51,30%,32%,22%,2,2,0,2,1,1
115,https://vlr.gg/player/27357/lay,2025-02-09 15:00:00,1.30,0.73,0.90,153,254,123,21,10,11,27,7,20,3,1,2,-3,0,-3,56%,60%,54%,112,144,98,53%,53%,52%,0,0,0,3,0,3
116,https://vlr.gg/player/36649/gigika,2025-02-09 15:00:00,0.92,0.68,0.73,169,163,191,21,6,15,32,7,25,4,2,2,0,-1,+1,65%,70%,63%,125,96,136,34%,25%,38%,4,0,4,4,1,3
117,https://vlr.gg/player/40456/aura,2025-02-09 15:00:00,0.61,0.47,0.51,137,152,121,15,6,9,30,7,23,4,0,4,-4,-1,-3,53%,70%,46%,91,89,92,30%,36%,28%,2,1,1,6,2,4
118,https://vlr.gg/player/40493/setrexz,2025-02-09 15:00:00,0.22,0.63,0.49,104,54,125,12,1,11,30,9,21,3,2,1,-9,-3,-6,47%,50%,46%,85,49,101,29%,9%,37%,1,1,0,10,4,6
119,https://vlr.gg/player/41615/luyta,2025-02-09 15:00:00,0.48,0.44,0.45,112,114,117,12,4,8,30,8,22,8,3,5,-2,+1,-3,50%,60%,46%,77,73,79,28%,27%,29%,1,1,0,3,0,3
120,https://vlr.gg/player/8447/less,2025-02-09 12:00:00,1.32,1.01,1.18,214,263,159,82,53,29,65,37,28,32,17,15,-1,-1,0,80%,79%,81%,139,170,103,31%,30%,33%,4,2,2,5,3,2
121,https://vlr.gg/player/312/sayf,2025-02-09 12:00:00,1.06,1.25,1.15,233,226,233,87,45,42,70,40,30,23,15,8,+4,+1,+3,67%,70%,64%,143,140,145,21%,24%,17%,11,6,5,7,5,2
122,https://vlr.gg/player/5022/derke,2025-02-09 12:00:00,0.70,1.40,1.02,235,193,288,81,35,46,77,44,33,17,6,11,+1,-4,+5,70%,64%,77%,152,126,183,31%,32%,31%,23,9,14,22,13,9
123,https://vlr.gg/player/11134/kicks,2025-02-09 12:00:00,0.82,0.98,0.89,166,154,176,59,33,26,68,37,31,41,17,24,+1,0,+1,74%,73%,74%,103,97,111,23%,23%,23%,8,4,4,7,4,3
124,https://vlr.gg/player/2168/trexx,2025-02-09 12:00:00,0.87,0.62,0.76,151,153,151,52,29,23,71,35,36,33,15,18,0,-2,+2,69%,71%,66%,100,104,95,16%,19%,13%,8,4,4,8,6,2
125,https://vlr.gg/player/11494/keiko,2025-02-09 12:00:00,1.11,1.22,1.17,238,250,235,88,40,48,75,36,39,22,10,12,+3,+1,+2,75%,74%,75%,156,162,151,33%,31%,36%,11,4,7,8,3,5
126,https://vlr.gg/player/1475/kamyk,2025-02-09 12:00:00,1.17,1.12,1.14,204,211,200,77,36,41,68,32,36,21,8,13,-1,0,-1,72%,70%,73%,136,146,128,28%,24%,32%,9,5,4,10,5,5
127,https://vlr.gg/player/309/patitek,2025-02-09 12:00:00,0.97,0.89,0.93,162,144,181,61,28,33,69,28,41,23,9,14,+8,+2,+6,68%,72%,64%,109,95,121,24%,29%,22%,12,3,9,4,1,3
128,https://vlr.gg/player/14681/kamo,2025-02-09 12:00:00,0.70,1.02,0.88,197,179,210,70,28,42,76,35,41,14,8,6,-7,-9,+2,70%,64%,75%,128,118,137,29%,28%,30%,10,3,7,17,12,5
129,https://vlr.gg/player/457/nats,2025-02-09 12:00:00,0.75,0.73,0.74,155,164,150,55,26,29,74,35,39,26,13,13,-8,-5,-3,64%,68%,61%,109,121,99,29%,34%,23%,7,3,4,15,8,7
130,https://vlr.gg/player/41029/z1yan,2025-02-09 06:15:00,,,,310,,,42,,,24,,,12,,,,,,,,,,,,,,,,,,,,
131,https://vlr.gg/player/15302/babyblue,2025-02-09 06:15:00,,,,278,,,39,,,28,,,11,,,,,,,,,,,,,,,,,,,,
132,https://vlr.gg/player/16924/stew,2025-02-09 06:15:00,,,,244,,,34,,,25,,,5,,,,,,,,,,,,,,,,,,,,
133,https://vlr.gg/player/3519/jkuro,2025-02-09 06:15:00,,,,182,,,22,,,20,,,27,,,,,,,,,,,,,,,,,,,,
134,https://vlr.gg/player/37674/mrcani,2025-02-09 06:15:00,,,,176,,,23,,,19,,,21,,,,,,,,,,,,,,,,,,,,
135,https://vlr.gg/player/51244/jieni7,2025-02-09 06:15:00,,,,263,,,33,,,30,,,10,,,,,,,,,,,,,,,,,,,,
136,https://vlr.gg/player/48859/century,2025-02-09 06:15:00,,,,215,,,29,,,29,,,11,,,,,,,,,,,,,,,,,,,,
137,https://vlr.gg/player/29401/muggle,2025-02-09 06:15:00,,,,179,,,23,,,32,,,9,,,,,,,,,,,,,,,,,,,,
138,https://vlr.gg/player/14453/sunshine,2025-02-09 06:15:00,,,,173,,,22,,,34,,,6,,,,,,,,,,,,,,,,,,,,
139,https://vlr.gg/player/51243/heav1n,2025-02-09 06:15:00,,,,97,,,9,,,35,,,13,,,,,,,,,,,,,,,,,,,,
140,https://vlr.gg/player/37489/lysoar,2025-02-09 04:00:00,,,,260,,,44,,,27,,,2,,,,,,,,,,,,,,,,,,,,
141,https://vlr.gg/player/7849/siufatbb,2025-02-09 04:00:00,,,,223,,,37,,,28,,,13,,,,,,,,,,,,,,,,,,,,
142,https://vlr.gg/player/7426/juicy,2025-02-09 04:00:00,,,,215,,,32,,,31,,,25,,,,,,,,,,,,,,,,,,,,
143,https://vlr.gg/player/14125/spring,2025-02-09 04:00:00,,,,188,,,27,,,32,,,12,,,,,,,,,,,,,,,,,,,,
144,https://vlr.gg/player/11218/yuicaw,2025-02-09 04:00:00,,,,149,,,23,,,32,,,11,,,,,,,,,,,,,,,,,,,,
145,https://vlr.gg/player/488/rb,2025-02-09 04:00:00,,,,301,,,47,,,31,,,16,,,,,,,,,,,,,,,,,,,,
146,https://vlr.gg/player/4720/haodong,2025-02-09 04:00:00,,,,218,,,34,,,32,,,26,,,,,,,,,,,,,,,,,,,,
147,https://vlr.gg/player/42235/dynamite,2025-02-09 04:00:00,,,,178,,,25,,,36,,,15,,,,,,,,,,,,,,,,,,,,
148,https://vlr.gg/player/5011/abo,2025-02-09 04:00:00,,,,150,,,22,,,35,,,10,,,,,,,,,,,,,,,,,,,,
149,https://vlr.gg/player/30526/b1ack,2025-02-09 04:00:00,,,,132,,,22,,,29,,,27,,,,,,,,,,,,,,,,,,,,
150,https://vlr.gg/player/1916/free1ng,2025-02-09 03:00:00,1.01,1.28,1.15,212,181,225,81,33,48,66,35,31,26,12,14,-2,-3,+1,72%,69%,75%,139,127,150,29%,28%,29%,9,4,5,11,7,4
151,https://vlr.gg/player/4462/mako,2025-02-09 03:00:00,1.01,1.13,1.07,194,168,219,70,26,44,68,34,34,58,37,21,-3,-5,+2,78%,80%,75%,133,115,149,28%,25%,29%,8,1,7,11,6,5
152,https://vlr.gg/player/35013/flashback,2025-02-09 03:00:00,0.97,1.14,1.06,206,186,232,78,33,45,73,36,37,29,13,16,+1,+1,0,78%,76%,79%,138,126,149,26%,31%,23%,9,3,6,8,2,6
153,https://vlr.gg/player/28400/hyunmin,2025-02-09 03:00:00,1.05,1.07,1.06,237,262,230,92,47,45,82,43,39,12,5,7,+8,+5,+3,68%,63%,73%,158,158,158,29%,28%,30%,23,15,8,15,10,5
154,https://vlr.gg/player/4678/beyn,2025-02-09 03:00:00,1.14,0.89,1.01,155,147,148,55,27,28,61,29,32,48,28,20,+3,+3,0,77%,75%,79%,98,98,99,22%,22%,23%,8,3,5,5,0,5
155,https://vlr.gg/player/804/buzz,2025-02-09 03:00:00,1.03,1.52,1.26,272,233,318,101,45,56,78,45,33,20,6,14,+8,+3,+5,79%,73%,84%,187,162,213,20%,20%,20%,25,16,9,17,13,4
156,https://vlr.gg/player/31207/carpe,2025-02-09 03:00:00,1.18,0.93,1.06,176,196,158,65,37,28,71,38,33,71,33,38,-3,+1,-4,81%,82%,80%,109,123,94,29%,33%,24%,4,1,3,7,0,7
157,https://vlr.gg/player/485/stax,2025-02-09 03:00:00,0.75,1.18,0.95,179,141,225,65,25,40,76,42,34,50,27,23,+1,-2,+3,77%,71%,82%,118,94,145,28%,28%,29%,8,1,7,7,3,4
158,https://vlr.gg/player/13039/meteor,2025-02-09 03:00:00,0.80,0.83,0.81,179,187,175,66,35,31,78,44,34,20,8,12,-7,-6,-1,62%,61%,63%,118,121,114,22%,27%,16%,9,7,2,16,13,3
159,https://vlr.gg/player/29833/izu,2025-02-09 03:00:00,0.74,0.69,0.72,131,149,123,53,31,22,73,41,32,20,9,11,-6,-2,-4,67%,64%,71%,96,102,89,28%,24%,33%,4,0,4,10,2,8
160,https://vlr.gg/player/15500/trent,2025-02-08 17:00:00,1.07,1.39,1.22,221,197,254,80,39,41,63,34,29,21,6,15,+8,+4,+4,72%,70%,74%,153,131,178,25%,23%,26%,13,9,4,5,5,0
161,https://vlr.gg/player/3885/valyn,2025-02-08 17:00:00,1.05,1.17,1.10,195,176,215,69,32,37,63,33,30,40,21,19,0,0,0,71%,74%,68%,129,120,139,20%,16%,25%,7,4,3,7,4,3
162,https://vlr.gg/player/7873/leaf,2025-02-08 17:00:00,0.90,1.06,0.97,189,175,208,68,32,36,71,37,34,20,13,7,+3,-2,+5,67%,65%,70%,126,124,129,26%,30%,22%,13,4,9,10,6,4
163,https://vlr.gg/player/4581/jonahp,2025-02-08 17:00:00,0.88,0.90,0.89,157,162,156,58,32,26,68,36,32,41,20,21,-5,-4,-1,74%,76%,72%,93,95,91,21%,20%,22%,3,0,3,8,4,4
164,https://vlr.gg/player/3993/jawgemo,2025-02-08 17:00:00,0.85,0.85,0.85,205,219,182,73,41,32,80,43,37,20,9,11,-7,-2,-5,70%,72%,68%,125,138,110,21%,23%,19%,14,8,6,21,10,11
165,https://vlr.gg/player/1265/johnqt,2025-02-08 17:00:00,0.93,1.33,1.14,199,193,208,69,31,38,64,35,29,27,8,19,+2,+3,-1,71%,64%,78%,143,133,152,32%,37%,28%,8,5,3,6,2,4
166,https://vlr.gg/player/3880/bang,2025-02-08 17:00:00,1.08,0.92,0.99,195,203,193,66,31,35,72,31,41,49,31,18,+3,0,+3,75%,81%,70%,126,127,124,39%,46%,33%,10,2,8,7,2,5
167,https://vlr.gg/player/36245/n4rrate,2025-02-08 17:00:00,1.02,0.94,0.98,197,201,196,71,34,37,71,32,39,29,12,17,+9,+3,+6,73%,77%,70%,127,131,123,27%,23%,30%,16,7,9,7,4,3
168,https://vlr.gg/player/4004/zekken,2025-02-08 17:00:00,0.76,1.12,0.95,197,207,185,74,34,40,70,39,31,13,5,8,-5,-3,-2,66%,57%,74%,130,134,127,28%,29%,27%,12,7,5,17,10,7
169,https://vlr.gg/player/729/zellsis,2025-02-08 17:00:00,0.90,0.89,0.89,183,179,178,63,30,33,73,35,38,35,17,18,-8,-6,-2,67%,70%,65%,119,117,121,22%,28%,18%,5,1,4,13,7,6
170,https://vlr.gg/player/21328/wo0t,2025-02-08 12:00:00,1.17,0.69,0.97,211,239,161,34,26,8,43,25,18,23,9,14,-3,-1,-2,70%,69%,73%,143,154,125,35%,40%,28%,5,4,1,8,5,3
171,https://vlr.gg/player/10971/riens,2025-02-08 12:00:00,1.08,0.44,0.82,173,220,106,34,27,7,47,27,20,15,10,5,-3,-2,-1,57%,66%,45%,111,134,77,43%,61%,21%,1,0,1,4,2,2
172,https://vlr.gg/player/1144/boo,2025-02-08 12:00:00,0.80,0.71,0.76,134,133,139,24,13,11,43,25,18,23,15,8,-3,-2,-1,61%,59%,64%,91,94,85,44%,34%,67%,3,1,2,6,3,3
173,https://vlr.gg/player/18350/miniboo,2025-02-08 12:00:00,0.65,0.91,0.75,187,166,230,32,15,17,47,29,18,10,6,4,-3,-2,-1,56%,50%,64%,131,118,151,28%,31%,25%,6,4,2,9,6,3
174,https://vlr.gg/player/29873/benjyfishy,2025-02-08 12:00:00,0.41,0.70,0.52,119,102,138,22,10,12,46,29,17,9,7,2,-8,-7,-1,61%,59%,64%,80,72,92,37%,31%,44%,2,0,2,10,7,3
175,https://vlr.gg/player/11494/keiko,2025-02-08 12:00:00,1.68,1.26,1.43,246,240,245,51,21,30,29,9,20,21,8,13,+5,+1,+4,89%,82%,94%,155,150,158,52%,56%,50%,7,2,5,2,1,1
176,https://vlr.gg/player/14681/kamo,2025-02-08 12:00:00,1.73,1.08,1.35,272,360,215,52,28,24,34,14,20,14,3,11,+2,+1,+1,78%,77%,78%,186,230,156,26%,28%,25%,11,6,5,9,5,4
177,https://vlr.gg/player/457/nats,2025-02-08 12:00:00,0.92,1.52,1.28,230,138,295,46,11,35,28,10,18,15,4,11,+8,+1,+7,81%,73%,88%,159,94,203,34%,50%,29%,9,2,7,1,1,0
178,https://vlr.gg/player/309/patitek,2025-02-08 12:00:00,1.27,1.28,1.27,182,185,180,37,16,21,21,9,12,19,8,11,+4,+2,+2,78%,82%,75%,122,123,121,27%,26%,29%,6,3,3,2,1,1
179,https://vlr.gg/player/1475/kamyk,2025-02-08 12:00:00,0.98,1.02,1.00,200,182,209,40,15,25,34,13,21,20,6,14,+1,+1,0,83%,82%,84%,128,115,136,22%,28%,19%,4,1,3,3,0,3
180,https://vlr.gg/player/39697/cb,2025-02-08 05:35:00,,,,261,,,60,,,41,,,8,,,,,,,,,,,,,,,,,,,,
181,https://vlr.gg/player/41054/guang,2025-02-08 05:35:00,,,,254,,,54,,,40,,,18,,,,,,,,,,,,,,,,,,,,
182,https://vlr.gg/player/36670/obone,2025-02-08 05:35:00,,,,199,,,45,,,35,,,24,,,,,,,,,,,,,,,,,,,,
183,https://vlr.gg/player/4402/o0o0o,2025-02-08 05:35:00,,,,173,,,37,,,42,,,23,,,,,,,,,,,,,,,,,,,,
184,https://vlr.gg/player/46460/ezeir,2025-02-08 05:35:00,,,,163,,,37,,,34,,,24,,,,,,,,,,,,,,,,,,,,
185,https://vlr.gg/player/51247/pan,2025-02-08 05:35:00,,,,246,,,53,,,48,,,20,,,,,,,,,,,,,,,,,,,,
186,https://vlr.gg/player/51246/viola,2025-02-08 05:35:00,,,,176,,,38,,,50,,,17,,,,,,,,,,,,,,,,,,,,
187,https://vlr.gg/player/51245/aqua,2025-02-08 05:35:00,,,,170,,,38,,,42,,,7,,,,,,,,,,,,,,,,,,,,
188,https://vlr.gg/player/51249/fkey,2025-02-08 05:35:00,,,,166,,,36,,,43,,,18,,,,,,,,,,,,,,,,,,,,
189,https://vlr.gg/player/51248/dondon,2025-02-08 05:35:00,,,,138,,,27,,,50,,,10,,,,,,,,,,,,,,,,,,,,
190,https://vlr.gg/player/41739/slowly,2025-02-08 04:00:00,,,,254,,,31,,,19,,,18,,,,,,,,,,,,,,,,,,,,
191,https://vlr.gg/player/7135/hfmi0dzjc9z7,2025-02-08 04:00:00,,,,249,,,27,,,18,,,16,,,,,,,,,,,,,,,,,,,,
192,https://vlr.gg/player/3547/ninebody,2025-02-08 04:00:00,,,,247,,,27,,,17,,,9,,,,,,,,,,,,,,,,,,,,
193,https://vlr.gg/player/47101/5cm,2025-02-08 04:00:00,,,,232,,,26,,,16,,,9,,,,,,,,,,,,,,,,,,,,
194,https://vlr.gg/player/47102/waituu,2025-02-08 04:00:00,,,,216,,,27,,,12,,,24,,,,,,,,,,,,,,,,,,,,
195,https://vlr.gg/player/25949/bunt,2025-02-08 04:00:00,,,,176,,,15,,,29,,,16,,,,,,,,,,,,,,,,,,,,
196,https://vlr.gg/player/50080/lsn,2025-02-08 04:00:00,,,,175,,,18,,,28,,,4,,,,,,,,,,,,,,,,,,,,
197,https://vlr.gg/player/14431/monk,2025-02-08 04:00:00,,,,154,,,16,,,27,,,8,,,,,,,,,,,,,,,,,,,,
198,https://vlr.gg/player/10821/delb,2025-02-08 04:00:00,,,,149,,,16,,,29,,,1,,,,,,,,,,,,,,,,,,,,
199,https://vlr.gg/player/46748/k1ra,2025-02-08 04:00:00,,,,148,,,17,,,25,,,11,,,,,,,,,,,,,,,,,,,,
200,https://vlr.gg/player/29833/izu,2025-02-08 03:00:00,1.21,0.93,1.09,202,229,185,83,51,32,76,42,34,33,22,11,+1,-1,+2,72%,80%,63%,137,146,126,26%,29%,22%,9,4,5,8,5,3
201,https://vlr.gg/player/31207/carpe,2025-02-08 03:00:00,0.99,1.17,1.07,196,162,231,79,38,41,81,42,39,50,28,22,+8,0,+8,76%,78%,73%,130,113,151,33%,28%,37%,11,1,10,3,1,2
202,https://vlr.gg/player/485/stax,2025-02-08 03:00:00,0.94,1.15,1.04,169,160,197,77,38,39,72,39,33,30,21,9,-1,+2,-3,69%,69%,69%,122,114,132,29%,29%,29%,6,5,1,7,3,4
203,https://vlr.gg/player/13039/meteor,2025-02-08 03:00:00,1.01,0.87,0.95,194,213,159,77,48,29,85,50,35,23,13,10,-3,0,-3,67%,70%,63%,130,146,110,24%,21%,29%,9,7,2,12,7,5
204,https://vlr.gg/player/804/buzz,2025-02-08 03:00:00,0.72,0.68,0.70,184,195,170,67,41,26,97,56,41,25,15,10,-2,-5,+3,64%,67%,61%,118,122,112,12%,12%,12%,24,13,11,26,18,8
205,https://vlr.gg/player/34974/karon,2025-02-08 03:00:00,1.15,1.41,1.30,221,179,252,88,32,56,66,29,37,60,22,38,-1,-4,+3,82%,84%,80%,147,124,164,29%,27%,31%,6,0,6,7,4,3
206,https://vlr.gg/player/2489/munchkin,2025-02-08 03:00:00,0.96,1.23,1.11,215,190,229,83,31,52,75,32,43,49,21,28,+2,-1,+3,81%,78%,83%,138,125,147,24%,23%,25%,11,4,7,9,5,4
207,https://vlr.gg/player/9196/t3xture,2025-02-08 03:00:00,1.00,1.07,1.04,228,228,243,96,42,54,85,39,46,19,9,10,-6,-1,-5,65%,63%,67%,148,144,152,25%,22%,28%,19,11,8,25,12,13
208,https://vlr.gg/player/25081/yoman,2025-02-08 03:00:00,0.96,0.85,0.90,174,185,168,74,37,37,80,36,44,38,14,24,+3,0,+3,77%,78%,75%,109,113,107,27%,26%,28%,11,4,7,8,4,4
209,https://vlr.gg/player/11600/foxy9,2025-02-08 03:00:00,1.10,0.67,0.86,172,209,138,70,40,30,77,31,46,21,7,14,-1,-1,0,69%,73%,66%,112,131,97,28%,29%,26%,9,3,6,10,4,6
210,https://vlr.gg/player/729/zellsis,2025-02-07 17:00:00,1.08,1.35,1.21,252,231,263,85,43,42,69,37,32,43,25,18,+6,0,+6,71%,75%,67%,162,152,174,28%,26%,31%,10,1,9,4,1,3
211,https://vlr.gg/player/36245/n4rrate,2025-02-07 17:00:00,1.12,1.15,1.13,212,210,186,67,35,32,61,32,29,38,25,13,-3,-2,-1,78%,75%,80%,123,131,114,21%,23%,19%,3,2,1,6,4,2
212,https://vlr.gg/player/4004/zekken,2025-02-07 17:00:00,1.07,1.15,1.11,239,237,239,82,45,37,70,38,32,26,13,13,+1,-1,+2,70%,67%,74%,158,152,164,25%,29%,22%,22,13,9,21,14,7
213,https://vlr.gg/player/1265/johnqt,2025-02-07 17:00:00,0.92,1.24,1.07,169,162,184,59,29,30,59,34,25,34,15,19,+1,+1,0,78%,73%,83%,117,112,123,23%,20%,27%,8,5,3,7,4,3
214,https://vlr.gg/player/3880/bang,2025-02-07 17:00:00,1.01,1.11,1.06,191,176,211,61,29,32,65,34,31,54,31,23,+1,+2,-1,80%,79%,80%,126,116,136,37%,35%,39%,9,5,4,8,3,5
215,https://vlr.gg/player/20240/xenom,2025-02-07 17:00:00,1.14,1.09,1.11,205,210,208,72,36,36,63,30,33,35,14,21,+4,+1,+3,76%,76%,75%,138,144,132,31%,35%,27%,8,2,6,4,1,3
216,https://vlr.gg/player/8480/aspas,2025-02-07 17:00:00,0.73,1.14,0.94,202,182,238,74,28,46,69,35,34,9,6,3,+4,+1,+3,69%,65%,73%,139,115,159,31%,32%,30%,19,9,10,15,8,7
217,https://vlr.gg/player/725/nzr,2025-02-07 17:00:00,1.01,0.78,0.89,195,210,172,65,36,29,73,34,39,24,9,15,+2,+2,0,70%,74%,67%,130,145,116,31%,35%,28%,5,3,2,3,1,2
218,https://vlr.gg/player/5395/cortezia,2025-02-07 17:00:00,0.56,0.97,0.78,169,129,221,60,19,41,73,35,38,14,5,9,-4,-2,-2,59%,50%,67%,123,91,152,28%,24%,32%,2,0,2,6,2,4
219,https://vlr.gg/player/5957/artzin,2025-02-07 17:00:00,0.63,0.68,0.65,152,186,147,51,28,23,76,39,37,24,11,13,-12,-8,-4,61%,54%,67%,109,117,101,22%,20%,23%,12,6,6,24,14,10
220,https://vlr.gg/player/8369/yetujey,2025-02-07 14:10:00,1.29,1.10,1.20,286,317,237,59,37,22,46,25,21,9,3,6,+3,-1,+4,69%,75%,62%,175,191,158,28%,33%,23%,10,4,6,7,5,2
221,https://vlr.gg/player/12793/xeus,2025-02-07 14:10:00,0.86,1.05,0.95,218,219,230,47,24,23,49,26,23,7,4,3,-10,-9,-1,59%,53%,66%,143,137,149,37%,38%,37%,5,2,3,15,11,4
222,https://vlr.gg/player/8044/mrfalin,2025-02-07 14:10:00,0.70,1.00,0.85,152,127,185,31,13,18,45,24,21,21,14,7,-2,-3,+1,67%,66%,69%,100,82,121,33%,26%,41%,4,1,3,6,4,2
223,https://vlr.gg/player/6510/atakaptan,2025-02-07 14:10:00,0.95,0.56,0.76,155,168,141,32,18,14,45,22,23,15,8,7,-6,-2,-4,57%,66%,48%,110,125,94,27%,27%,27%,2,1,1,8,3,5
224,https://vlr.gg/player/1139/qraxs,2025-02-07 14:10:00,0.76,0.74,0.75,132,136,134,28,14,14,45,23,22,35,22,13,-2,-1,-1,75%,84%,66%,85,84,87,24%,23%,25%,1,0,1,3,1,2
225,https://vlr.gg/player/11494/keiko,2025-02-07 14:10:00,1.52,1.01,1.25,218,257,188,52,28,24,36,16,20,15,12,3,+3,-2,+5,80%,86%,75%,129,152,108,35%,35%,35%,6,1,5,3,3,0
226,https://vlr.gg/player/1475/kamyk,2025-02-07 14:10:00,1.21,1.25,1.23,247,247,229,47,25,22,36,16,20,25,10,15,+6,+1,+5,82%,76%,88%,153,152,153,19%,21%,18%,9,4,5,3,3,0
227,https://vlr.gg/player/457/nats,2025-02-07 14:10:00,1.16,1.08,1.12,216,219,206,49,23,26,38,18,20,10,7,3,-2,-1,-1,72%,72%,72%,144,153,136,36%,49%,26%,4,2,2,6,3,3
228,https://vlr.gg/player/14681/kamo,2025-02-07 14:10:00,0.85,0.99,0.92,213,186,240,45,20,25,46,21,25,9,3,6,+9,+2,+7,70%,69%,72%,137,120,153,25%,25%,26%,15,7,8,6,5,1
229,https://vlr.gg/player/309/patitek,2025-02-07 14:10:00,0.74,1.03,0.90,172,151,192,37,14,23,41,20,21,19,10,9,+1,+1,0,74%,72%,75%,108,99,116,27%,24%,29%,5,1,4,4,0,4
230,https://vlr.gg/player/2168/trexx,2025-02-07 12:00:00,1.91,1.04,1.57,275,318,167,33,27,6,18,9,9,15,10,5,-1,+1,-2,73%,88%,46%,185,218,125,27%,25%,38%,1,1,0,2,0,2
231,https://vlr.gg/player/312/sayf,2025-02-07 12:00:00,1.22,1.44,1.29,258,240,279,36,24,12,25,15,10,8,6,2,-1,+1,-2,78%,83%,69%,176,160,205,29%,29%,29%,2,2,0,3,1,2
232,https://vlr.gg/player/8447/less,2025-02-07 12:00:00,1.12,1.10,1.11,204,217,150,27,19,8,22,14,8,12,8,4,-1,0,-1,73%,79%,62%,130,141,110,29%,26%,33%,1,1,0,2,1,1
233,https://vlr.gg/player/11134/kicks,2025-02-07 12:00:00,1.06,1.12,1.08,199,178,205,25,16,9,23,13,10,21,12,9,-1,-3,+2,78%,83%,69%,116,105,136,37%,26%,57%,2,0,2,3,3,0
234,https://vlr.gg/player/5022/derke,2025-02-07 12:00:00,0.87,0.71,0.81,203,231,168,26,20,6,29,18,11,6,2,4,0,-1,+1,59%,54%,69%,133,144,112,27%,26%,30%,11,7,4,11,8,3
235,https://vlr.gg/player/10971/riens,2025-02-07 12:00:00,0.99,1.35,1.22,251,203,271,32,11,21,28,9,19,12,2,10,+7,+1,+6,81%,85%,79%,160,146,167,36%,41%,35%,7,1,6,0,0,0
236,https://vlr.gg/player/21328/wo0t,2025-02-07 12:00:00,0.98,1.02,1.00,203,192,216,27,9,18,27,7,20,9,5,4,0,0,0,70%,69%,71%,138,121,147,28%,19%,33%,3,1,2,3,1,2
237,https://vlr.gg/player/18350/miniboo,2025-02-07 12:00:00,1.58,0.58,0.92,178,299,134,25,14,11,31,9,22,11,4,7,+2,+3,-1,65%,85%,54%,121,182,87,40%,35%,48%,7,4,3,5,1,4
238,https://vlr.gg/player/1144/boo,2025-02-07 12:00:00,1.12,0.42,0.64,121,168,101,16,8,8,28,7,21,16,9,7,-5,-3,-2,65%,69%,63%,84,100,76,35%,45%,28%,1,1,0,6,4,2
239,https://vlr.gg/player/29873/benjyfishy,2025-02-07 12:00:00,0.46,0.59,0.54,156,122,165,16,5,11,33,10,23,16,4,12,0,0,0,70%,69%,71%,105,86,116,26%,20%,29%,2,0,2,2,0,2
240,https://vlr.gg/player/25255/primmie,2025-02-07 06:30:00,1.17,0.95,1.04,244,248,240,30,14,16,30,12,18,9,3,6,-2,+1,-3,66%,67%,65%,155,138,167,38%,38%,37%,1,1,0,3,0,3
241,https://vlr.gg/player/5129/ban,2025-02-07 06:30:00,0.76,0.93,0.86,190,171,201,22,8,14,29,12,17,4,1,3,0,0,0,63%,47%,75%,121,103,134,27%,23%,30%,4,3,1,4,3,1
242,https://vlr.gg/player/13788/jitboys,2025-02-07 06:30:00,0.38,0.92,0.66,111,48,152,13,2,11,26,11,15,8,3,5,-1,-1,0,51%,33%,65%,73,24,110,48%,33%,52%,2,1,1,3,2,1
243,https://vlr.gg/player/3977/crws,2025-02-07 06:30:00,0.71,0.36,0.48,121,121,128,13,6,7,30,12,18,10,5,5,-3,0,-3,63%,67%,60%,86,92,82,30%,39%,22%,2,0,2,5,0,5
244,https://vlr.gg/player/3980/governor,2025-02-07 06:30:00,0.46,0.24,0.34,117,132,108,14,7,7,33,13,20,6,4,2,-3,-3,0,51%,60%,45%,80,83,78,13%,21%,5%,4,1,3,7,4,3
245,https://vlr.gg/player/25081/yoman,2025-02-07 06:30:00,1.52,1.61,1.56,215,218,197,27,16,11,13,8,5,16,9,7,+1,0,+1,91%,90%,93%,131,115,151,33%,31%,36%,3,2,1,2,2,0
246,https://vlr.gg/player/34974/karon,2025-02-07 06:30:00,1.53,1.46,1.50,246,246,268,35,18,17,16,9,7,14,12,2,+5,+2,+3,91%,95%,87%,159,161,157,38%,40%,37%,5,2,3,0,0,0
247,https://vlr.gg/player/9196/t3xture,2025-02-07 06:30:00,1.35,1.02,1.21,242,284,199,33,23,10,22,13,9,6,3,3,+2,0,+2,80%,80%,80%,164,188,132,18%,21%,13%,5,2,3,3,2,1
248,https://vlr.gg/player/11600/foxy9,2025-02-07 06:30:00,1.16,1.27,1.21,234,221,246,31,17,14,20,12,8,8,4,4,0,+1,-1,74%,85%,60%,139,126,156,35%,21%,50%,4,3,1,4,2,2
249,https://vlr.gg/player/2489/munchkin,2025-02-07 06:30:00,0.89,1.07,0.97,202,185,200,22,14,8,21,13,8,13,5,8,+1,+3,-2,74%,80%,67%,121,128,112,23%,27%,20%,5,4,1,4,1,3
250,https://vlr.gg/player/29833/izu,2025-02-07 03:00:00,1.33,0.98,1.15,213,248,179,56,33,23,45,21,24,12,4,8,-1,+2,-3,73%,73%,74%,142,154,130,35%,39%,31%,5,3,2,6,1,5
251,https://vlr.gg/player/804/buzz,2025-02-07 03:00:00,1.00,1.31,1.15,272,252,288,67,30,37,59,31,28,17,11,6,+6,+3,+3,71%,70%,71%,171,158,184,23%,27%,20%,18,11,7,12,8,4
252,https://vlr.gg/player/13039/meteor,2025-02-07 03:00:00,1.07,0.96,1.01,216,227,210,58,30,28,55,27,28,15,7,8,-3,-2,-1,73%,78%,68%,153,163,143,35%,37%,33%,7,3,4,10,5,5
253,https://vlr.gg/player/31207/carpe,2025-02-07 03:00:00,0.80,0.99,0.90,163,137,188,43,19,24,54,26,28,38,17,21,-2,-2,0,67%,62%,71%,112,97,127,48%,44%,50%,4,0,4,6,2,4
254,https://vlr.gg/player/485/stax,2025-02-07 03:00:00,0.80,0.88,0.84,154,158,150,40,20,20,52,26,26,28,10,18,-1,-2,+1,72%,76%,68%,98,102,95,23%,27%,19%,3,1,2,4,3,1
255,https://vlr.gg/player/4462/mako,2025-02-07 03:00:00,1.21,1.30,1.25,230,213,244,63,30,33,47,23,24,32,14,18,+1,-1,+2,80%,76%,84%,139,125,154,25%,22%,26%,8,4,4,7,5,2
256,https://vlr.gg/player/28400/hyunmin,2025-02-07 03:00:00,0.96,1.50,1.23,270,212,329,70,28,42,58,29,29,13,6,7,+6,+1,+5,71%,66%,76%,181,144,219,27%,19%,35%,17,9,8,11,8,3
257,https://vlr.gg/player/1916/free1ng,2025-02-07 03:00:00,0.84,1.14,0.99,207,203,222,55,26,29,57,31,26,21,11,10,+4,0,+4,73%,68%,78%,148,144,151,27%,29%,24%,7,3,4,3,3,0
258,https://vlr.gg/player/35013/flashback,2025-02-07 03:00:00,0.88,0.71,0.80,143,175,115,39,25,14,49,26,23,16,7,9,-9,-1,-8,65%,68%,62%,89,109,68,24%,24%,25%,4,2,2,13,3,10
259,https://vlr.gg/player/4678/beyn,2025-02-07 03:00:00,1.09,0.48,0.79,150,176,120,38,25,13,53,23,30,28,14,14,-1,+1,-2,69%,82%,57%,98,116,80,24%,25%,24%,2,1,1,3,0,3
260,https://vlr.gg/player/8480/aspas,2025-02-06 19:20:00,1.74,1.96,1.86,347,342,351,82,37,45,36,19,17,7,2,5,+10,+5,+5,88%,83%,92%,218,224,213,26%,33%,21%,14,6,8,4,1,3
261,https://vlr.gg/player/5395/cortezia,2025-02-06 19:20:00,0.84,1.06,0.96,202,205,195,45,21,24,42,22,20,15,6,9,+2,+2,0,77%,73%,81%,132,134,130,35%,40%,31%,7,4,3,5,2,3
262,https://vlr.gg/player/20240/xenom,2025-02-06 19:20:00,1.00,0.76,0.87,156,175,142,36,18,18,43,20,23,32,15,17,-1,+2,-3,77%,83%,72%,96,110,84,33%,30%,36%,4,2,2,5,0,5
263,https://vlr.gg/player/725/nzr,2025-02-06 19:20:00,0.88,0.84,0.85,141,132,152,32,15,17,42,18,24,27,10,17,-2,-1,-1,70%,67%,72%,95,80,107,23%,38%,17%,0,0,0,2,1,1
264,https://vlr.gg/player/5957/artzin,2025-02-06 19:20:00,0.63,0.83,0.74,187,185,189,43,19,24,52,25,27,18,8,10,-1,0,-1,71%,67%,75%,120,117,122,21%,26%,16%,12,7,5,13,7,6
265,https://vlr.gg/player/24007/shyy,2025-02-06 19:20:00,1.36,1.45,1.40,257,238,274,57,28,29,40,21,19,17,8,9,+2,0,+2,80%,86%,73%,171,167,176,25%,29%,21%,4,1,3,2,1,1
266,https://vlr.gg/player/1311/melser,2025-02-06 19:20:00,0.89,1.08,0.97,185,165,206,42,22,20,47,26,21,32,16,16,-1,+2,-3,76%,81%,70%,109,93,129,32%,29%,35%,5,2,3,6,0,6
267,https://vlr.gg/player/3826/adverso,2025-02-06 19:20:00,0.59,1.21,0.87,182,141,235,41,18,23,50,28,22,20,4,16,-7,-6,-1,68%,67%,70%,122,95,155,19%,19%,19%,3,1,2,10,7,3
268,https://vlr.gg/player/2462/keznit,2025-02-06 19:20:00,0.88,0.71,0.80,182,210,153,41,25,16,51,28,23,7,5,2,+2,+5,-3,68%,69%,67%,118,130,103,15%,15%,15%,12,11,1,10,6,4
269,https://vlr.gg/player/7603/mazino,2025-02-06 19:20:00,0.88,0.59,0.75,146,148,143,34,18,16,50,25,25,33,26,7,-4,-1,-3,68%,72%,63%,92,88,95,25%,20%,31%,5,3,2,9,4,5
270,https://vlr.gg/player/729/zellsis,2025-02-06 17:00:00,1.28,0.72,1.00,209,236,182,29,17,12,32,14,18,10,5,5,0,+1,-1,70%,75%,65%,139,166,111,31%,27%,37%,4,2,2,4,1,3
271,https://vlr.gg/player/3880/bang,2025-02-06 17:00:00,0.84,1.05,0.95,179,142,217,25,10,15,27,13,14,14,10,4,-4,-1,-3,73%,75%,70%,119,87,151,30%,18%,40%,2,1,1,6,2,4
272,https://vlr.gg/player/4004/zekken,2025-02-06 17:00:00,0.80,0.78,0.79,193,206,182,26,14,12,33,16,17,7,4,3,+4,+2,+2,65%,65%,65%,121,131,111,23%,33%,15%,8,4,4,4,2,2
273,https://vlr.gg/player/36245/n4rrate,2025-02-06 17:00:00,1.01,0.55,0.78,186,211,162,25,15,10,33,14,19,14,7,7,-6,-2,-4,68%,75%,60%,127,135,120,31%,37%,25%,2,2,0,8,4,4
274,https://vlr.gg/player/1265/johnqt,2025-02-06 17:00:00,0.70,0.66,0.68,136,151,122,18,11,7,29,14,15,8,4,4,0,0,0,63%,65%,60%,93,101,86,29%,26%,35%,1,1,0,1,1,0
275,https://vlr.gg/player/3993/jawgemo,2025-02-06 17:00:00,1.44,0.96,1.20,255,286,224,36,21,15,29,13,16,16,7,9,+6,+6,0,70%,75%,65%,160,180,139,18%,20%,15%,9,7,2,3,1,2
276,https://vlr.gg/player/4581/jonahp,2025-02-06 17:00:00,1.45,0.90,1.18,183,213,153,26,17,9,20,9,11,20,10,10,+2,0,+2,75%,85%,65%,125,142,109,21%,21%,20%,4,1,3,2,1,1
277,https://vlr.gg/player/15500/trent,2025-02-06 17:00:00,1.47,0.86,1.17,215,257,173,31,21,10,23,10,13,9,2,7,-1,+1,-2,68%,75%,60%,141,161,120,22%,23%,21%,2,2,0,3,1,2
278,https://vlr.gg/player/3885/valyn,2025-02-06 17:00:00,0.97,1.12,1.04,198,155,243,30,12,18,24,8,16,11,3,8,-2,-2,0,65%,75%,55%,121,89,152,22%,21%,22%,2,0,2,4,2,2
279,https://vlr.gg/player/7873/leaf,2025-02-06 17:00:00,0.69,1.38,1.04,212,184,241,30,11,19,28,16,12,8,6,2,+1,+1,0,70%,60%,80%,135,115,156,23%,17%,30%,6,3,3,5,2,3
280,https://vlr.gg/player/25906/alexiiik,2025-02-06 12:05:00,1.12,1.32,1.23,256,267,251,56,25,31,37,19,18,2,1,1,+6,+3,+3,70%,65%,74%,147,153,142,22%,24%,20%,14,7,7,8,4,4
281,https://vlr.gg/player/4537/tajrex,2025-02-06 12:05:00,0.95,0.97,0.96,193,160,220,36,15,21,42,19,23,20,7,13,+6,+3,+3,81%,77%,84%,130,111,146,27%,25%,29%,9,4,5,3,1,2
282,https://vlr.gg/player/37840/msh,2025-02-06 12:05:00,0.79,0.88,0.84,165,128,199,34,12,22,42,18,24,7,2,5,-1,-1,0,67%,58%,74%,118,85,146,43%,38%,45%,3,0,3,4,1,3
283,https://vlr.gg/player/8593/grmekista,2025-02-06 12:05:00,0.67,0.86,0.77,141,109,168,28,10,18,41,19,22,24,11,13,-4,-2,-2,67%,54%,77%,97,71,118,21%,15%,25%,2,1,1,6,3,3
284,https://vlr.gg/player/3839/prti,2025-02-06 12:05:00,0.79,0.71,0.75,138,168,122,25,14,11,41,21,20,16,6,10,-4,-3,-1,74%,65%,81%,104,111,99,20%,25%,16%,2,1,1,6,4,2
285,https://vlr.gg/player/50813/gsr,2025-02-06 12:05:00,1.80,1.38,1.61,271,304,233,56,36,20,28,16,12,20,12,8,-2,-1,-1,81%,81%,81%,187,201,171,31%,29%,34%,2,1,1,4,2,2
286,https://vlr.gg/player/40750/donatellooo,2025-02-06 12:05:00,0.95,1.35,1.14,243,209,282,49,24,25,41,24,17,10,4,6,+5,+1,+4,75%,77%,73%,164,144,188,40%,52%,32%,14,7,7,9,6,3
287,https://vlr.gg/player/19526/rexxtoned,2025-02-06 12:05:00,1.08,0.83,0.97,165,188,133,35,22,13,34,18,16,10,4,6,0,+1,-1,77%,84%,69%,108,121,93,37%,35%,39%,4,3,1,4,2,2
288,https://vlr.gg/player/28948/ninja,2025-02-06 12:05:00,0.87,1.03,0.94,199,188,209,40,19,21,40,24,16,15,9,6,-2,-2,0,67%,58%,77%,130,128,134,19%,17%,22%,5,2,3,7,4,3
289,https://vlr.gg/player/7105/qpert,2025-02-06 12:05:00,0.41,0.95,0.66,116,54,186,23,7,16,37,21,16,22,12,10,-4,-2,-2,77%,74%,81%,69,29,116,22%,18%,23%,2,1,1,6,3,3
290,https://vlr.gg/player/12928/veqaj,2025-02-06 11:00:00,1.32,1.37,1.35,290,282,308,85,38,47,60,26,34,5,1,4,+16,+4,+12,65%,55%,73%,178,176,181,27%,34%,21%,26,10,16,10,6,4
291,https://vlr.gg/player/2252/anq,2025-02-06 11:00:00,1.00,0.89,0.94,168,173,158,49,25,24,56,26,30,20,9,11,-1,-1,0,65%,68%,62%,104,102,106,37%,37%,37%,6,2,4,7,3,4
292,https://vlr.gg/player/45374/juskay,2025-02-06 11:00:00,0.93,0.75,0.83,171,182,168,49,25,24,63,27,36,13,3,10,-6,-6,0,60%,58%,62%,123,118,126,36%,35%,36%,5,1,4,11,7,4
293,https://vlr.gg/player/2621/goaster,2025-02-06 11:00:00,0.75,0.87,0.81,149,121,172,40,15,25,57,24,33,17,6,11,0,+1,-1,71%,74%,69%,107,83,127,27%,18%,35%,3,3,0,3,2,1
294,https://vlr.gg/player/6889/neskaas,2025-02-06 11:00:00,0.62,0.58,0.60,109,118,107,31,14,17,63,30,33,27,13,14,-4,-2,-2,64%,61%,67%,74,82,68,29%,31%,27%,4,1,3,8,3,5
295,https://vlr.gg/player/21216/f4ngeer,2025-02-06 11:00:00,1.33,1.12,1.23,255,259,241,72,42,30,52,27,25,21,10,11,-3,-3,0,71%,71%,71%,165,174,154,38%,37%,38%,17,9,8,20,12,8
296,https://vlr.gg/player/24439/yohpa,2025-02-06 11:00:00,1.22,1.18,1.20,212,218,205,67,38,29,48,26,22,19,13,6,+1,0,+1,73%,73%,74%,135,134,137,38%,41%,33%,3,1,2,2,1,1
297,https://vlr.gg/player/11322/sevire,2025-02-06 11:00:00,1.06,1.24,1.14,214,181,249,62,30,32,50,27,23,29,17,12,-4,-3,-1,69%,62%,76%,139,115,167,29%,30%,28%,7,3,4,11,6,5
298,https://vlr.gg/player/7173/soren,2025-02-06 11:00:00,0.97,0.88,0.93,179,185,176,56,31,25,53,28,25,16,8,8,+3,0,+3,71%,67%,76%,118,121,114,33%,31%,36%,9,4,5,6,4,2
299,https://vlr.gg/player/2864/ease,2025-02-06 11:00:00,0.80,0.81,0.81,148,158,143,42,25,17,51,29,22,33,14,19,-2,-3,+1,70%,69%,71%,104,110,97,30%,36%,23%,3,1,2,5,4,1
300,https://vlr.gg/player/10448/kozok,2025-02-06 10:00:00,1.72,1.30,1.50,229,246,214,28,14,14,14,5,9,17,8,9,+3,0,+3,88%,88%,88%,154,166,142,19%,20%,18%,3,0,3,0,0,0
301,https://vlr.gg/player/42702/krizz,2025-02-06 10:00:00,1.64,1.30,1.47,203,241,171,28,16,12,11,6,5,6,5,1,0,+1,-1,88%,94%,82%,133,153,113,24%,29%,20%,2,1,1,2,0,2
302,https://vlr.gg/player/9556/demek,2025-02-06 10:00:00,1.21,1.43,1.32,268,232,300,31,13,18,18,8,10,11,6,5,+6,0,+6,85%,81%,88%,176,160,190,21%,31%,15%,10,4,6,4,4,0
303,https://vlr.gg/player/36748/czester,2025-02-06 10:00:00,1.17,1.36,1.27,265,270,259,30,15,15,19,11,8,8,4,4,+3,+4,-1,79%,81%,76%,182,182,181,34%,42%,28%,6,5,1,3,1,2
304,https://vlr.gg/player/9557/nefi,2025-02-06 10:00:00,0.96,1.51,1.24,213,163,259,27,10,17,18,9,9,12,6,6,+3,+1,+2,85%,81%,88%,121,87,154,37%,37%,36%,3,1,2,0,0,0
305,https://vlr.gg/player/7106/diseased,2025-02-06 10:00:00,1.02,0.95,0.99,233,233,236,24,13,11,29,14,15,0,0,0,0,0,0,61%,65%,56%,165,165,165,33%,37%,29%,2,1,1,2,1,1
306,https://vlr.gg/player/22617/vitie,2025-02-06 10:00:00,0.78,0.71,0.75,175,197,147,20,12,8,29,16,13,7,1,6,-3,-2,-1,76%,71%,81%,115,130,99,21%,17%,27%,2,1,1,5,3,2
307,https://vlr.gg/player/30901/ianto,2025-02-06 10:00:00,0.50,0.66,0.58,135,124,149,14,6,8,29,15,14,8,5,3,-2,-1,-1,55%,47%,63%,97,101,93,20%,35%,8%,1,0,1,3,1,2
308,https://vlr.gg/player/23098/aphun,2025-02-06 10:00:00,0.48,0.47,0.47,110,109,113,10,5,5,29,15,14,14,8,6,-4,-1,-3,61%,71%,50%,74,70,78,17%,25%,12%,2,1,1,6,2,4
309,https://vlr.gg/player/252/d3ffo,2025-02-06 10:00:00,0.28,0.52,0.40,114,110,118,12,5,7,29,16,13,6,5,1,-6,-5,-1,61%,65%,56%,76,78,74,20%,12%,31%,2,1,1,8,6,2
310,https://vlr.gg/player/44930/nex1sphix,2025-02-06 08:00:00,1.16,1.04,1.09,216,196,232,32,12,20,32,12,20,19,9,10,0,-1,+1,66%,59%,71%,149,116,172,24%,20%,26%,3,0,3,3,1,2
311,https://vlr.gg/player/40912/123,2025-02-06 08:00:00,0.59,1.15,0.92,205,160,239,30,9,21,34,15,19,10,4,6,-6,-3,-3,59%,71%,50%,141,111,162,39%,38%,39%,2,1,1,8,4,4
312,https://vlr.gg/player/40907/mnfear,2025-02-06 08:00:00,0.63,1.02,0.86,159,148,165,24,9,15,30,14,16,10,1,9,-3,-2,-1,66%,53%,75%,104,93,112,31%,33%,29%,2,1,1,5,3,2
313,https://vlr.gg/player/44770/cxix666,2025-02-06 08:00:00,0.95,0.66,0.78,171,203,150,22,11,11,32,14,18,9,5,4,0,-3,+3,68%,59%,75%,117,133,106,20%,17%,22%,4,0,4,4,3,1
314,https://vlr.gg/player/40908/skyisblue,2025-02-06 08:00:00,0.41,0.56,0.49,141,149,137,16,7,9,35,16,19,10,5,5,-4,-2,-2,56%,71%,46%,99,104,96,19%,12%,25%,3,1,2,7,3,4
315,https://vlr.gg/player/36685/splash,2025-02-06 08:00:00,1.43,1.66,1.53,325,319,336,47,27,20,28,18,10,10,5,5,+6,+1,+5,80%,75%,88%,207,203,212,29%,31%,26%,11,5,6,5,4,1
316,https://vlr.gg/player/37057/woody,2025-02-06 08:00:00,1.20,1.55,1.34,234,210,266,32,18,14,23,15,8,30,19,11,+1,0,+1,85%,79%,94%,161,136,195,38%,53%,27%,3,1,2,2,1,1
317,https://vlr.gg/player/26826/6ixkey,2025-02-06 08:00:00,1.13,1.43,1.25,193,188,199,30,16,14,21,14,7,10,6,4,+3,+2,+1,85%,83%,88%,127,119,139,27%,26%,29%,3,2,1,0,0,0
318,https://vlr.gg/player/7783/zhar,2025-02-06 08:00:00,1.03,1.13,1.07,208,179,251,31,15,16,27,15,12,16,9,7,+3,0,+3,80%,88%,71%,120,101,147,21%,18%,24%,6,3,3,3,3,0
319,https://vlr.gg/player/7049/natz,2025-02-06 08:00:00,1.00,0.67,0.86,149,180,108,23,16,7,25,14,11,9,6,3,0,-1,+1,68%,67%,71%,96,116,68,24%,28%,17%,4,2,2,4,3,1
320,https://vlr.gg/player/23930/potter,2025-02-06 06:00:00,1.02,1.37,1.23,283,244,298,37,13,24,27,12,15,9,7,2,+6,+3,+3,69%,75%,65%,156,137,168,18%,24%,13%,11,5,6,5,2,3
321,https://vlr.gg/player/27244/seph1roth,2025-02-06 06:00:00,1.63,0.93,1.22,187,280,140,28,17,11,20,7,13,15,4,11,-3,-1,-2,85%,100%,74%,134,196,90,45%,47%,42%,1,0,1,4,1,3
322,https://vlr.gg/player/13784/killua,2025-02-06 06:00:00,1.64,0.87,1.19,205,251,177,30,16,14,25,7,18,20,5,15,0,-1,+1,82%,88%,78%,141,161,128,44%,37%,54%,3,1,2,3,2,1
323,https://vlr.gg/player/8582/laz,2025-02-06 06:00:00,0.69,1.29,1.04,198,118,236,28,8,20,23,9,14,7,1,6,0,0,0,77%,81%,74%,116,82,139,20%,32%,16%,2,1,1,2,1,1
324,https://vlr.gg/player/27254/leviathan,2025-02-06 06:00:00,1.16,0.87,0.99,210,203,204,26,12,14,25,9,16,8,1,7,0,-1,+1,67%,69%,65%,139,143,135,45%,46%,45%,4,1,3,4,2,2
325,https://vlr.gg/player/5886/flaring,2025-02-06 06:00:00,1.32,0.56,0.99,222,292,112,28,23,5,31,18,13,12,6,6,+1,0,+1,69%,78%,56%,137,179,75,33%,39%,22%,4,2,2,3,2,1
326,https://vlr.gg/player/14209/suka,2025-02-06 06:00:00,1.11,0.74,0.96,214,223,212,27,17,10,32,17,15,19,11,8,+1,+1,0,77%,78%,75%,130,133,125,25%,23%,30%,3,2,1,2,1,1
327,https://vlr.gg/player/45876/fixy,2025-02-06 06:00:00,0.70,1.13,0.88,198,172,241,28,13,15,29,17,12,2,1,1,-1,-1,0,69%,70%,69%,124,110,143,36%,42%,30%,6,3,3,7,4,3
328,https://vlr.gg/player/7513/markl,2025-02-06 06:00:00,0.79,0.78,0.78,165,163,197,24,14,10,30,16,14,5,2,3,0,0,0,67%,65%,69%,124,108,146,18%,21%,17%,2,1,1,2,1,1
329,https://vlr.gg/player/7443/riza,2025-02-06 06:00:00,0.74,0.19,0.50,97,118,62,13,9,4,27,15,12,7,6,1,-4,-3,-1,64%,61%,69%,63,78,41,35%,42%,25%,3,2,1,7,5,2
330,https://vlr.gg/player/25082/rico,2025-02-06 05:55:00,0.90,1.44,1.21,234,156,288,36,11,25,28,12,16,20,6,14,+4,0,+4,74%,67%,79%,136,103,161,23%,33%,20%,5,0,5,1,0,1
331,https://vlr.gg/player/25089/cabeza,2025-02-06 05:55:00,1.68,0.73,1.18,225,319,144,51,34,17,38,16,22,21,9,12,+2,+5,-3,73%,80%,68%,146,204,95,34%,33%,35%,10,8,2,8,3,5
332,https://vlr.gg/player/34727/kayle,2025-02-06 05:55:00,0.95,1.31,1.14,230,172,285,53,19,34,46,20,26,34,14,20,0,-1,+1,75%,73%,76%,160,126,189,20%,21%,20%,6,3,3,6,4,2
333,https://vlr.gg/player/4127/felix,2025-02-06 05:55:00,1.18,1.03,1.10,203,192,208,44,21,23,41,17,24,27,14,13,-2,0,-2,75%,73%,76%,124,122,126,20%,43%,7%,4,2,2,6,2,4
334,https://vlr.gg/player/4038/bangnan,2025-02-06 05:55:00,1.07,1.06,1.07,202,236,178,47,24,23,42,22,20,13,9,4,0,-1,+1,75%,73%,76%,141,165,119,31%,31%,31%,7,3,4,7,4,3
335,https://vlr.gg/player/13000/redlight,2025-02-06 05:55:00,0.79,1.38,1.05,191,151,241,13,7,6,14,7,7,13,3,10,+4,+1,+3,82%,75%,90%,119,97,147,18%,5%,26%,4,1,3,0,0,0
336,https://vlr.gg/player/37532/zexy,2025-02-06 05:55:00,1.21,1.10,1.16,252,270,240,59,34,25,52,27,25,9,4,5,0,+1,-1,70%,68%,73%,162,161,163,27%,29%,25%,9,6,3,9,5,4
337,https://vlr.gg/player/4426/klaus,2025-02-06 05:55:00,0.92,0.86,0.89,166,159,180,37,21,16,45,23,22,13,6,7,-5,-6,+1,63%,65%,60%,124,112,137,43%,49%,39%,4,1,3,9,7,2
338,https://vlr.gg/player/42755/shu,2025-02-06 05:55:00,1.01,0.76,0.89,168,170,163,36,19,17,46,22,24,24,18,6,-1,0,-1,69%,76%,60%,106,111,99,35%,37%,33%,5,2,3,6,2,4
339,https://vlr.gg/player/34926/oonzmlp,2025-02-06 05:55:00,1.01,0.65,0.84,199,231,162,45,28,17,51,26,25,21,12,9,-3,0,-3,64%,65%,63%,129,148,107,44%,45%,43%,6,4,2,9,4,5
340,https://vlr.gg/player/2149/c1nder,2025-02-06 05:55:00,0.57,1.03,0.78,161,143,183,32,13,19,51,30,21,23,15,8,+1,+1,0,59%,62%,57%,114,109,121,23%,22%,23%,4,2,2,3,1,2
341,https://vlr.gg/player/6676/thiefy,2025-02-06 05:00:00,1.61,1.46,1.53,277,247,290,42,17,25,22,8,14,12,4,8,+4,+2,+2,86%,83%,88%,193,170,209,29%,29%,29%,4,2,2,0,0,0
342,https://vlr.gg/player/34785/yowamu,2025-02-06 05:00:00,1.54,1.40,1.46,269,318,241,44,21,23,24,11,13,9,4,5,+7,+2,+5,90%,89%,92%,175,202,155,34%,35%,33%,11,4,7,4,2,2
343,https://vlr.gg/player/1960/eko,2025-02-06 05:00:00,1.08,1.48,1.30,265,240,295,40,14,26,27,12,15,12,6,6,0,-1,+1,79%,78%,79%,160,158,162,20%,18%,22%,5,1,4,5,2,3
344,https://vlr.gg/player/7888/blackwiz,2025-02-06 05:00:00,1.07,0.85,0.94,152,160,142,21,10,11,25,9,16,23,9,14,0,-2,+2,79%,78%,79%,92,95,90,15%,12%,17%,4,1,3,4,3,1
345,https://vlr.gg/player/1952/esperanza,2025-02-06 05:00:00,0.36,1.06,0.76,162,118,186,22,7,15,29,15,14,9,3,6,+3,+1,+2,74%,50%,92%,109,73,136,29%,33%,27%,4,2,2,1,1,0
346,https://vlr.gg/player/49327/lucky,2025-02-06 05:00:00,0.80,1.35,1.03,205,177,261,34,16,18,33,19,14,5,2,3,+3,+3,0,67%,58%,78%,136,116,161,47%,41%,55%,4,3,1,1,0,1
347,https://vlr.gg/player/49326/mimi,2025-02-06 05:00:00,0.71,1.02,0.85,172,168,184,29,15,14,32,19,13,2,2,0,-4,-5,+1,67%,67%,67%,116,105,130,23%,28%,20%,4,1,3,8,6,2
348,https://vlr.gg/player/51142/kuro,2025-02-06 05:00:00,0.98,0.39,0.72,188,237,122,25,19,6,36,20,16,14,7,7,-7,-6,-1,52%,63%,39%,112,142,72,34%,38%,27%,2,0,2,9,6,3
349,https://vlr.gg/player/34775/sota,2025-02-06 05:00:00,0.42,1.05,0.69,137,98,194,19,7,12,35,22,13,19,10,9,-1,0,-1,69%,58%,83%,100,68,143,29%,23%,32%,2,2,0,3,2,1
350,https://vlr.gg/player/34717/taru,2025-02-06 05:00:00,0.79,0.50,0.67,167,189,123,20,15,5,35,20,15,13,5,8,-5,-4,-1,60%,67%,50%,111,130,86,37%,37%,36%,2,0,2,7,4,3
351,https://vlr.gg/player/30556/exa,2025-02-06 03:10:00,1.74,1.19,1.45,246,249,245,41,21,20,26,9,17,15,10,5,+3,+2,+1,78%,91%,67%,151,141,161,32%,27%,36%,6,2,4,3,0,3
352,https://vlr.gg/player/806/moothie,2025-02-06 03:10:00,1.35,1.00,1.17,221,226,216,38,19,19,31,13,18,21,13,8,+2,+1,+1,78%,77%,79%,145,150,141,42%,41%,44%,4,2,2,2,1,1
353,https://vlr.gg/player/43057/dh,2025-02-06 03:10:00,1.36,0.92,1.13,248,303,198,40,23,17,34,15,19,13,6,7,+8,+7,+1,83%,91%,75%,165,195,137,37%,35%,41%,11,8,3,3,1,2
354,https://vlr.gg/player/4664/gangpin,2025-02-06 03:10:00,0.76,1.06,0.92,165,112,213,26,8,18,32,13,19,15,12,3,+1,-1,+2,76%,82%,71%,115,82,146,36%,30%,39%,2,0,2,1,1,0
355,https://vlr.gg/player/29839/tenten,2025-02-06 03:10:00,0.78,0.82,0.80,179,190,169,26,13,13,34,16,18,13,6,7,-2,-1,-1,74%,77%,71%,125,129,122,13%,14%,13%,6,3,3,8,4,4
356,https://vlr.gg/player/25053/wolverine,2025-02-06 03:10:00,1.19,1.16,1.17,248,271,223,40,23,17,34,19,15,8,5,3,-3,-1,-2,72%,75%,68%,159,168,149,42%,40%,44%,6,4,2,9,5,4
357,https://vlr.gg/player/4657/moves,2025-02-06 03:10:00,1.36,0.75,1.07,237,291,179,38,25,13,34,17,17,16,11,5,-3,-1,-2,80%,83%,77%,143,180,103,27%,24%,31%,4,2,2,7,3,4
358,https://vlr.gg/player/20879/sungjin,2025-02-06 03:10:00,1.25,0.66,0.97,157,161,152,28,17,11,32,13,19,13,5,8,-2,0,-2,70%,75%,64%,114,129,97,42%,46%,37%,0,0,0,2,0,2
359,https://vlr.gg/player/9221/kanade,2025-02-06 03:10:00,0.86,0.72,0.79,188,200,176,30,17,13,36,19,17,8,5,3,-4,-1,-3,67%,67%,68%,133,149,115,27%,27%,27%,5,4,1,9,5,4
360,https://vlr.gg/player/9236/manggong,2025-02-06 03:10:00,0.48,0.70,0.58,135,119,153,21,9,12,35,19,16,11,9,2,0,-1,+1,59%,63%,55%,87,78,96,30%,25%,36%,2,0,2,2,1,1
361,https://vlr.gg/player/2671/popogachi,2025-02-06 02:00:00,1.39,0.95,1.14,234,278,199,33,17,16,29,13,16,14,7,7,+7,+3,+4,74%,84%,67%,153,187,127,28%,25%,33%,7,3,4,0,0,0
362,https://vlr.gg/player/47481/frxeez,2025-02-06 02:00:00,0.88,0.84,0.86,209,208,210,32,15,17,35,16,19,6,2,4,+1,0,+1,67%,79%,58%,128,129,127,34%,47%,24%,7,4,3,6,4,2
363,https://vlr.gg/player/1971/oitan,2025-02-06 02:00:00,0.87,0.80,0.83,184,195,176,27,13,14,29,14,15,5,1,4,-2,0,-2,70%,68%,71%,121,130,114,48%,60%,40%,4,2,2,6,2,4
364,https://vlr.gg/player/12980/ria,2025-02-06 02:00:00,0.52,1.01,0.80,157,118,187,23,9,14,29,14,15,15,5,10,+1,0,+1,65%,63%,67%,102,82,119,33%,27%,36%,3,1,2,2,1,1
365,https://vlr.gg/player/44613/yamada,2025-02-06 02:00:00,0.79,0.77,0.78,145,162,131,21,10,11,31,14,17,18,7,11,-2,0,-2,60%,74%,50%,98,102,94,38%,33%,43%,3,1,2,5,1,4
366,https://vlr.gg/player/45962/ken,2025-02-06 02:00:00,0.80,1.68,1.19,252,163,365,36,14,22,30,16,14,9,2,7,+5,+2,+3,65%,58%,74%,164,104,239,38%,41%,37%,8,4,4,3,2,1
367,https://vlr.gg/player/6702/bazz,2025-02-06 02:00:00,1.56,0.62,1.15,232,299,148,34,25,9,29,15,14,14,6,8,-3,0,-3,67%,67%,68%,143,177,101,25%,24%,26%,4,3,1,7,3,4
368,https://vlr.gg/player/2400/brofeld,2025-02-06 02:00:00,1.03,1.23,1.12,148,133,167,26,12,14,19,11,8,8,4,4,+1,+1,0,77%,75%,79%,100,88,116,32%,21%,43%,1,1,0,0,0,0
369,https://vlr.gg/player/40736/kapi,2025-02-06 02:00:00,0.97,1.10,1.03,176,161,194,29,14,15,25,14,11,11,7,4,-3,-2,-1,74%,71%,79%,126,114,142,30%,30%,30%,1,1,0,4,3,1
370,https://vlr.gg/player/1009/sakurai,2025-02-06 02:00:00,0.92,0.58,0.77,188,204,172,28,17,11,33,16,17,11,5,6,-5,-3,-2,63%,71%,53%,124,132,115,35%,49%,21%,5,2,3,10,5,5
371,https://vlr.gg/player/33732/nunmeister,2025-02-05 12:55:00,1.03,1.30,1.16,213,176,252,55,24,31,45,24,21,18,10,8,-3,-3,0,69%,64%,74%,141,114,169,38%,32%,42%,2,1,1,5,4,1
372,https://vlr.gg/player/39682/wanzeru,2025-02-05 12:55:00,1.20,0.98,1.09,260,280,239,61,34,27,56,31,25,11,5,6,+8,+3,+5,63%,64%,62%,168,181,154,20%,23%,16%,15,8,7,7,5,2
373,https://vlr.gg/player/6969/gunners,2025-02-05 12:55:00,0.73,1.00,0.86,166,158,175,36,17,19,54,31,23,28,13,15,+3,+3,0,70%,58%,82%,111,108,113,24%,25%,24%,8,4,4,5,1,4
374,https://vlr.gg/player/2832/patix,2025-02-05 12:55:00,0.70,0.92,0.81,167,145,193,43,18,25,54,29,25,15,8,7,+1,+1,0,73%,67%,79%,114,107,122,43%,43%,43%,8,3,5,7,2,5
375,https://vlr.gg/player/7231/kya,2025-02-05 12:55:00,0.48,0.87,0.67,129,95,165,30,12,18,49,28,21,10,4,6,-1,-4,+3,57%,50%,65%,87,62,114,24%,21%,26%,6,2,4,7,6,1
376,https://vlr.gg/player/33358/shinnok,2025-02-05 12:55:00,1.17,1.47,1.33,228,188,262,56,23,33,40,20,20,24,12,12,0,0,0,79%,74%,83%,152,126,176,25%,28%,22%,5,2,3,5,2,3
377,https://vlr.gg/player/7490/anguist,2025-02-05 12:55:00,0.94,1.21,1.08,202,196,209,51,24,27,45,25,20,19,8,11,-5,-4,-1,67%,62%,72%,132,129,135,20%,23%,19%,3,1,2,8,5,3
378,https://vlr.gg/player/217/seider,2025-02-05 12:55:00,1.11,1.00,1.05,171,198,149,43,25,18,42,23,19,35,13,22,-6,-6,0,70%,62%,78%,112,128,98,30%,37%,24%,3,2,1,9,8,1
379,https://vlr.gg/player/4589/burzzy,2025-02-05 12:55:00,0.92,0.99,0.96,205,200,211,53,24,29,50,26,24,20,7,13,-2,+2,-4,70%,68%,72%,135,130,141,42%,42%,43%,5,4,1,7,2,5
380,https://vlr.gg/player/7104/juseu,2025-02-05 12:55:00,0.69,1.17,0.93,217,166,269,54,19,35,48,26,22,8,4,4,+5,0,+5,77%,74%,81%,139,108,167,27%,35%,23%,15,4,11,10,4,6
381,https://vlr.gg/player/565/starxo,2025-02-05 11:00:00,1.50,1.23,1.36,236,264,215,84,45,39,54,26,28,30,15,15,+6,+3,+3,79%,79%,79%,155,174,138,22%,23%,21%,12,5,7,6,2,4
382,https://vlr.gg/player/2653/jesse,2025-02-05 11:00:00,1.17,1.15,1.16,220,231,204,82,41,41,65,32,33,33,14,19,+4,+1,+3,78%,72%,83%,145,145,146,35%,37%,34%,9,5,4,5,4,1
383,https://vlr.gg/player/4521/unfake,2025-02-05 11:00:00,0.91,1.31,1.12,215,163,250,76,26,50,64,33,31,34,18,16,+3,+1,+2,77%,70%,83%,138,110,162,35%,46%,31%,10,3,7,7,2,5
384,https://vlr.gg/player/7162/wackie,2025-02-05 11:00:00,0.98,0.85,0.91,158,175,144,52,28,24,59,30,29,37,18,19,+4,+3,+1,73%,72%,74%,111,119,104,28%,33%,23%,8,4,4,4,1,3
385,https://vlr.gg/player/440/akumaaaaa,2025-02-05 11:00:00,0.59,1.11,0.87,207,157,244,68,23,45,77,38,39,24,13,11,-3,-7,+4,67%,64%,70%,138,109,164,26%,21%,30%,18,7,11,21,14,7
386,https://vlr.gg/player/5498/kipperman,2025-02-05 11:00:00,0.82,1.17,0.98,227,203,266,81,37,44,79,44,35,17,6,11,+3,-3,+6,67%,57%,79%,150,136,165,32%,36%,29%,20,9,11,17,12,5
387,https://vlr.gg/player/39718/rouss,2025-02-05 11:00:00,0.80,1.11,0.94,179,162,211,70,33,37,73,41,32,22,9,13,-6,-3,-3,67%,68%,66%,122,105,140,32%,30%,34%,5,3,2,11,6,5
388,https://vlr.gg/player/26809/tenshi,2025-02-05 11:00:00,0.82,1.07,0.94,176,170,192,66,31,35,74,42,32,32,17,15,-4,-6,+2,66%,58%,74%,114,106,122,27%,24%,30%,5,2,3,9,8,1
389,https://vlr.gg/player/31058/kpro,2025-02-05 11:00:00,1.01,0.84,0.93,160,179,154,56,34,22,67,36,31,36,14,22,-5,-1,-4,68%,62%,74%,114,131,95,28%,35%,22%,6,3,3,11,4,7
390,https://vlr.gg/player/26837/poegii,2025-02-05 11:00:00,0.85,0.75,0.81,139,142,144,46,25,21,69,36,33,29,12,17,-2,0,-2,63%,62%,64%,98,95,102,21%,23%,19%,7,3,4,9,3,6
391,https://vlr.gg/player/4214/eso177,2025-02-05 10:00:00,1.20,1.16,1.18,222,213,250,46,16,30,40,16,24,23,12,11,+4,0,+4,72%,77%,69%,150,147,152,28%,33%,25%,8,2,6,4,2,2
392,https://vlr.gg/player/31298/luca,2025-02-05 10:00:00,1.10,0.89,0.97,193,190,204,37,15,22,43,17,26,18,7,11,+3,+1,+2,78%,82%,75%,130,130,131,23%,22%,25%,6,2,4,3,1,2
393,https://vlr.gg/player/12372/szoren,2025-02-05 10:00:00,0.86,0.92,0.90,198,238,185,35,16,19,45,20,25,22,9,13,+2,+3,-1,72%,68%,75%,148,162,138,23%,24%,22%,3,3,0,1,0,1
394,https://vlr.gg/player/34002/lukey,2025-02-05 10:00:00,0.71,0.74,0.72,183,186,173,33,16,17,45,20,25,8,2,6,-1,-1,0,61%,59%,63%,117,115,118,27%,29%,25%,9,3,6,10,4,6
395,https://vlr.gg/player/5566/jeyj7y,2025-02-05 10:00:00,0.38,0.66,0.54,123,90,149,24,6,18,44,18,26,10,5,5,-6,-3,-3,57%,59%,56%,89,76,99,24%,29%,22%,2,1,1,8,4,4
396,https://vlr.gg/player/2894/kiles,2025-02-05 10:00:00,1.47,1.28,1.39,272,292,211,53,33,20,32,20,12,10,10,0,+4,+2,+2,80%,84%,73%,167,182,146,32%,31%,33%,8,6,2,4,4,0
397,https://vlr.gg/player/1369/doma,2025-02-05 10:00:00,1.00,1.59,1.24,196,142,301,40,16,24,30,17,13,19,10,9,-1,-1,0,81%,78%,86%,142,99,203,27%,26%,29%,2,0,2,3,1,2
398,https://vlr.gg/player/562/zeek,2025-02-05 10:00:00,1.42,0.93,1.22,269,284,218,47,33,14,39,22,17,28,12,16,-3,-1,-2,81%,88%,73%,170,182,152,27%,28%,25%,5,2,3,8,3,5
399,https://vlr.gg/player/1616/starki,2025-02-05 10:00:00,1.10,1.27,1.17,201,195,223,41,24,17,32,20,12,22,12,10,+1,+1,0,83%,78%,91%,123,120,127,34%,32%,36%,4,2,2,3,1,2
400,https://vlr.gg/player/2700/jas,2025-02-05 10:00:00,0.70,1.03,0.84,192,178,198,36,20,16,42,27,15,10,5,5,-3,-3,0,78%,78%,77%,132,128,136,33%,36%,29%,7,5,2,10,8,2
401,https://vlr.gg/player/37421/riyabtw,2025-02-05 08:55:00,0.87,1.31,1.04,227,200,244,28,15,13,29,19,10,7,5,2,-4,-4,0,57%,52%,64%,140,127,163,38%,43%,32%,4,2,2,8,6,2
402,https://vlr.gg/player/47977/chak,2025-02-05 08:55:00,0.62,0.93,0.74,168,174,172,23,14,9,31,20,11,4,2,2,-2,-2,0,51%,48%,57%,113,109,120,51%,64%,36%,1,1,0,3,3,0
403,https://vlr.gg/player/24302/chimei,2025-02-05 08:55:00,0.72,0.79,0.72,133,150,150,19,12,7,30,19,11,7,4,3,-5,-3,-2,59%,61%,57%,103,99,109,20%,18%,22%,0,0,0,5,3,2
404,https://vlr.gg/player/24304/kiuuuu,2025-02-05 08:55:00,0.67,0.59,0.64,156,174,121,19,13,6,33,21,12,10,7,3,+2,+3,-1,62%,65%,57%,94,106,74,40%,35%,55%,5,3,2,3,0,3
405,https://vlr.gg/player/7851/uta,2025-02-05 08:55:00,0.55,0.59,0.55,127,139,134,16,11,5,30,19,11,7,3,4,-6,-5,-1,54%,52%,57%,88,88,89,46%,57%,31%,1,0,1,7,5,2
406,https://vlr.gg/player/41694/endoist,2025-02-05 08:55:00,0.77,2.01,1.54,319,202,354,42,10,32,20,9,11,9,3,6,+3,+2,+1,76%,71%,78%,200,123,247,25%,25%,24%,7,4,3,4,2,2
407,https://vlr.gg/player/31537/basbabe,2025-02-05 08:55:00,1.65,1.04,1.27,213,353,162,30,17,13,20,8,12,13,5,8,+2,+2,0,86%,93%,83%,152,215,114,39%,54%,25%,3,2,1,1,0,1
408,https://vlr.gg/player/17303/fontuz,2025-02-05 08:55:00,1.23,1.26,1.25,231,163,249,29,9,20,21,7,14,13,6,7,+7,+1,+6,84%,86%,83%,143,95,173,29%,41%,25%,8,2,6,1,1,0
409,https://vlr.gg/player/20623/harddora,2025-02-05 08:55:00,1.04,1.22,1.15,189,156,203,27,9,18,20,7,13,6,4,2,0,0,0,73%,64%,78%,121,86,143,46%,31%,53%,2,0,2,2,0,2
410,https://vlr.gg/player/41701/ki1wsy,2025-02-05 08:55:00,1.10,0.97,1.02,205,204,195,25,10,15,24,9,15,14,6,8,+3,-1,+4,70%,64%,74%,126,129,124,58%,50%,67%,6,1,5,3,2,1
411,https://vlr.gg/player/25017/ash,2025-02-05 06:35:00,0.82,1.08,0.97,213,212,228,32,13,19,33,15,18,11,4,7,-1,-2,+1,67%,61%,71%,144,139,147,26%,27%,25%,4,1,3,5,3,2
412,https://vlr.gg/player/4475/benecia,2025-02-05 06:35:00,0.94,0.91,0.92,166,157,176,24,10,14,28,12,16,15,6,9,-3,-2,-1,69%,61%,75%,110,103,115,21%,14%,26%,2,0,2,5,2,3
413,https://vlr.gg/player/50826/ramgi,2025-02-05 06:35:00,0.71,0.96,0.85,210,203,219,31,12,19,35,16,19,8,3,5,0,0,0,67%,67%,67%,131,125,135,27%,26%,28%,4,2,2,4,2,2
414,https://vlr.gg/player/4130/rain,2025-02-05 06:35:00,0.76,0.87,0.82,197,192,201,27,11,16,34,15,19,5,3,2,+3,-1,+4,60%,56%,63%,131,127,135,35%,41%,30%,8,3,5,5,4,1
415,https://vlr.gg/player/9192/cloudy,2025-02-05 06:35:00,0.50,0.52,0.51,101,92,105,15,6,9,32,14,18,8,5,3,-5,-1,-4,55%,44%,63%,66,55,74,33%,35%,32%,0,0,0,5,1,4
416,https://vlr.gg/player/51099/zynx,2025-02-05 06:35:00,1.60,1.60,1.60,293,303,299,49,28,21,26,16,10,5,3,2,+2,+2,0,71%,67%,78%,189,183,196,33%,28%,44%,4,3,1,2,1,1
417,https://vlr.gg/player/51238/yong,2025-02-05 06:35:00,1.30,0.87,1.12,192,223,136,29,20,9,25,15,10,19,13,6,+4,+3,+1,76%,83%,67%,119,141,89,28%,40%,12%,5,4,1,1,1,0
418,https://vlr.gg/player/34982/athan,2025-02-05 06:35:00,0.93,1.30,1.09,181,176,193,27,15,12,26,17,9,16,11,5,+4,+1,+3,71%,67%,78%,110,106,116,39%,46%,33%,6,3,3,2,2,0
419,https://vlr.gg/player/4661/sacrifice,2025-02-05 06:35:00,0.86,1.40,1.09,240,199,285,34,16,18,28,17,11,10,9,1,0,-5,+5,76%,71%,83%,144,123,173,29%,23%,35%,8,1,7,8,6,2
420,https://vlr.gg/player/51100/flicker,2025-02-05 06:35:00,1.00,0.93,0.97,172,146,212,23,11,12,24,12,12,13,9,4,-4,-1,-3,69%,67%,72%,121,111,135,33%,33%,33%,1,1,0,5,2,3
421,https://vlr.gg/player/23710/gotten,2025-02-05 05:55:00,1.50,1.26,1.39,254,257,240,56,31,25,42,21,21,35,23,12,+8,+5,+3,74%,74%,74%,165,172,157,41%,43%,39%,11,6,5,3,1,2
422,https://vlr.gg/player/9263/sayoo,2025-02-05 05:55:00,1.09,0.95,1.02,182,180,185,43,24,19,39,19,20,10,7,3,+3,0,+3,76%,83%,68%,124,123,125,28%,29%,28%,7,2,5,4,2,2
423,https://vlr.gg/player/1745/adrnking,2025-02-05 05:55:00,0.96,1.06,1.00,163,170,160,41,23,18,41,23,18,26,13,13,-4,-5,+1,71%,69%,74%,108,107,110,34%,45%,25%,1,0,1,5,5,0
424,https://vlr.gg/player/16852/nakya,2025-02-05 05:55:00,0.96,1.00,0.98,236,240,227,52,29,23,46,26,20,11,6,5,-1,-5,+4,70%,66%,74%,148,151,146,26%,26%,27%,14,6,8,15,11,4
425,https://vlr.gg/player/2346/cud,2025-02-05 05:55:00,1.01,0.66,0.85,158,161,152,35,21,14,43,20,23,17,5,12,+2,0,+2,67%,71%,61%,103,109,95,33%,35%,31%,4,1,3,2,1,1
426,https://vlr.gg/player/42901/thyy,2025-02-05 05:55:00,1.65,1.00,1.31,225,280,180,56,34,22,42,17,25,23,10,13,+1,0,+1,70%,68%,71%,151,187,119,38%,37%,39%,4,2,2,3,2,1
427,https://vlr.gg/player/23062/surf,2025-02-05 05:55:00,0.97,0.94,0.94,178,188,177,40,19,21,45,20,25,11,2,9,-3,-3,0,73%,74%,71%,115,119,112,42%,40%,45%,5,1,4,8,4,4
428,https://vlr.gg/player/37547/tbloy,2025-02-05 05:55:00,0.92,0.84,0.88,173,158,193,39,16,23,45,19,26,21,10,11,+3,-2,+5,71%,71%,71%,114,104,124,28%,29%,27%,9,2,7,6,4,2
429,https://vlr.gg/player/41702/canady,2025-02-05 05:55:00,0.75,1.00,0.88,179,143,207,38,15,23,46,20,26,18,4,14,-6,-3,-3,64%,58%,69%,110,88,129,39%,31%,50%,4,2,2,10,5,5
430,https://vlr.gg/player/46102/snappy,2025-02-05 05:55:00,0.76,0.79,0.78,181,181,185,38,18,20,49,23,26,14,5,9,-3,-5,+2,55%,55%,54%,125,125,125,26%,31%,22%,7,2,5,10,7,3
431,https://vlr.gg/player/6676/thiefy,2025-02-05 04:40:00,0.92,1.39,1.20,199,184,212,44,14,30,38,19,19,15,6,9,+1,+2,-1,77%,79%,75%,136,112,151,25%,21%,26%,3,2,1,2,0,2
432,https://vlr.gg/player/1960/eko,2025-02-05 04:40:00,0.84,1.32,1.13,265,156,314,51,13,38,45,17,28,13,5,8,+1,-4,+5,72%,63%,78%,159,100,199,21%,18%,22%,11,1,10,10,5,5
433,https://vlr.gg/player/34785/yowamu,2025-02-05 04:40:00,1.00,1.08,1.05,218,226,210,47,18,29,41,17,24,7,3,4,-7,-4,-3,70%,63%,75%,139,142,138,28%,35%,24%,6,3,3,13,7,6
434,https://vlr.gg/player/1952/esperanza,2025-02-05 04:40:00,0.68,1.23,1.01,180,135,200,35,9,26,36,16,20,16,6,10,+2,+1,+1,73%,71%,75%,122,92,143,29%,33%,28%,5,2,3,3,1,2
435,https://vlr.gg/player/7888/blackwiz,2025-02-05 04:40:00,0.98,0.81,0.87,146,163,138,29,14,15,41,15,26,37,13,24,-3,-3,0,82%,79%,83%,94,89,98,25%,21%,29%,2,0,2,5,3,2
436,https://vlr.gg/player/17169/muto,2025-02-05 04:40:00,0.98,1.40,1.15,234,226,246,48,26,22,40,29,11,13,11,2,+7,+2,+5,65%,58%,75%,150,148,152,34%,31%,40%,11,5,6,4,3,1
437,https://vlr.gg/player/4545/sayaplayer,2025-02-05 04:40:00,0.96,1.07,1.00,208,216,209,47,29,18,42,27,15,7,1,6,+5,+2,+3,70%,64%,79%,133,130,137,27%,27%,26%,11,6,5,6,4,2
438,https://vlr.gg/player/1963/hate,2025-02-05 04:40:00,0.98,0.73,0.88,164,201,119,38,28,10,41,26,15,6,2,4,-1,0,-1,58%,58%,58%,119,142,85,32%,34%,29%,5,3,2,6,3,3
439,https://vlr.gg/player/31841/take,2025-02-05 04:40:00,0.55,1.20,0.81,133,104,181,30,14,16,38,26,12,20,8,12,-2,-2,0,75%,64%,92%,90,69,123,28%,18%,39%,1,0,1,3,2,1
440,https://vlr.gg/player/25915/brian,2025-02-05 04:40:00,0.67,1.03,0.81,191,171,227,38,20,18,45,30,15,15,6,9,-3,-4,+1,72%,67%,79%,132,118,154,35%,36%,35%,5,3,2,8,7,1
441,https://vlr.gg/player/25048/sid,2025-02-05 03:00:00,1.34,1.54,1.45,278,269,282,62,26,36,34,19,15,9,4,5,+2,-1,+3,88%,85%,91%,186,179,191,35%,38%,33%,4,0,4,2,1,1
442,https://vlr.gg/player/17049/hermes,2025-02-05 03:00:00,0.93,1.50,1.25,254,221,258,52,20,32,39,22,17,8,3,5,+8,+2,+6,77%,69%,82%,149,130,162,17%,20%,15%,13,5,8,5,3,2
443,https://vlr.gg/player/27444/banger,2025-02-05 03:00:00,1.07,1.23,1.16,218,197,238,50,19,31,36,17,19,9,3,6,+2,-1,+3,78%,65%,88%,140,128,149,36%,44%,33%,8,3,5,6,4,2
444,https://vlr.gg/player/24979/cloy,2025-02-05 03:00:00,0.96,1.08,1.03,183,152,202,38,14,24,34,16,18,29,12,17,-2,-3,+1,73%,69%,76%,110,90,126,34%,34%,34%,5,2,3,7,5,2
445,https://vlr.gg/player/42793/kally,2025-02-05 03:00:00,0.69,1.11,0.93,148,107,181,31,9,22,37,18,19,18,8,10,-2,-1,-1,82%,77%,85%,112,80,135,33%,41%,29%,4,1,3,6,2,4
446,https://vlr.gg/player/4666/acme,2025-02-05 03:00:00,0.57,1.28,0.88,187,137,259,37,13,24,46,28,18,32,13,19,-1,0,-1,60%,50%,73%,118,91,153,19%,19%,19%,2,1,1,3,1,2
447,https://vlr.gg/player/42710/froz,2025-02-05 03:00:00,0.71,0.99,0.83,166,166,172,36,20,16,44,29,15,7,4,3,-4,-4,0,65%,59%,73%,113,114,111,40%,37%,43%,3,1,2,7,5,2
448,https://vlr.gg/player/42769/wezzy,2025-02-05 03:00:00,0.57,1.12,0.81,163,131,220,35,14,21,47,29,18,10,4,6,+4,-2,+6,65%,59%,73%,109,87,138,16%,21%,11%,13,4,9,9,6,3
449,https://vlr.gg/player/48925/raxcal,2025-02-05 03:00:00,0.52,0.96,0.71,171,169,185,38,20,18,49,32,17,6,3,3,-6,-5,-1,63%,53%,77%,109,100,120,26%,26%,26%,5,4,1,11,9,2
450,https://vlr.gg/player/42771/nameless,2025-02-05 03:00:00,0.71,0.54,0.61,136,137,140,30,17,13,47,27,20,8,3,5,-1,-1,0,65%,62%,69%,96,102,88,29%,36%,23%,3,1,2,4,2,2
451,https://vlr.gg/player/47481/frxeez,2025-02-05 02:00:00,1.59,0.55,0.85,219,348,166,25,13,12,30,8,22,5,2,3,-2,+3,-5,56%,90%,42%,150,240,112,38%,46%,32%,5,4,1,7,1,6
452,https://vlr.gg/player/44613/yamada,2025-02-05 02:00:00,0.90,0.73,0.78,173,168,175,21,6,15,30,7,23,4,3,1,-1,0,-1,53%,60%,50%,104,114,100,21%,22%,20%,3,0,3,4,0,4
453,https://vlr.gg/player/12980/ria,2025-02-05 02:00:00,1.18,0.59,0.77,144,174,132,17,7,10,24,5,19,10,4,6,-3,-1,-2,65%,60%,67%,97,119,87,24%,29%,21%,1,0,1,4,1,3
454,https://vlr.gg/player/1971/oitan,2025-02-05 02:00:00,0.62,0.39,0.46,119,127,116,12,4,8,30,7,23,2,0,2,+1,-1,+2,44%,50%,42%,93,114,84,36%,33%,37%,2,0,2,1,1,0
455,https://vlr.gg/player/2671/popogachi,2025-02-05 02:00:00,0.34,0.48,0.44,112,112,112,11,4,7,28,8,20,7,2,5,-5,-3,-2,59%,70%,54%,77,67,81,26%,45%,19%,1,0,1,6,3,3
456,https://vlr.gg/player/34827/hals,2025-02-05 02:00:00,1.68,1.59,1.66,353,337,391,44,31,13,21,13,8,6,4,2,+6,+2,+4,88%,96%,70%,215,206,236,30%,23%,48%,9,5,4,3,3,0
457,https://vlr.gg/player/43064/aace,2025-02-05 02:00:00,1.78,0.70,1.46,263,317,132,33,28,5,15,8,7,3,3,0,+3,+4,-1,88%,96%,70%,162,197,78,47%,52%,27%,6,5,1,3,1,2
458,https://vlr.gg/player/12979/mrtenzouez,2025-02-05 02:00:00,1.24,1.60,1.34,213,186,279,26,16,10,15,9,6,7,3,4,+3,+2,+1,82%,88%,70%,153,140,183,39%,38%,41%,3,2,1,0,0,0
459,https://vlr.gg/player/6673/gon,2025-02-05 02:00:00,1.37,0.57,1.13,178,209,103,21,18,3,17,10,7,15,14,1,+1,+2,-1,82%,88%,70%,123,140,84,30%,30%,31%,3,3,0,2,1,1
460,https://vlr.gg/player/1970/neth,2025-02-05 02:00:00,1.02,0.79,0.96,140,157,99,18,14,4,18,12,6,18,16,2,-3,-2,-1,74%,88%,40%,104,115,77,44%,41%,57%,1,1,0,4,3,1
461,https://vlr.gg/player/873/bob,2025-02-04 19:10:00,1.06,1.89,1.46,261,181,352,36,13,23,19,10,9,4,2,2,+4,+1,+3,71%,70%,72%,173,114,237,20%,9%,27%,6,2,4,2,1,1
462,https://vlr.gg/player/25902/shondex,2025-02-04 19:10:00,1.55,1.34,1.45,284,300,266,39,22,17,20,10,10,7,3,4,+4,0,+4,87%,85%,89%,191,201,180,44%,54%,34%,7,2,5,3,2,1
463,https://vlr.gg/player/16671/welyy,2025-02-04 19:10:00,1.31,0.98,1.15,198,216,177,26,15,11,21,10,11,12,10,2,0,-2,+2,89%,90%,89%,139,150,128,31%,37%,24%,2,0,2,2,2,0
464,https://vlr.gg/player/26848/zeek,2025-02-04 19:10:00,1.10,1.01,1.06,187,194,182,25,14,11,22,11,11,15,7,8,0,0,0,68%,65%,72%,127,130,124,31%,30%,32%,3,2,1,3,2,1
465,https://vlr.gg/player/11696/zoestol,2025-02-04 19:10:00,0.84,0.79,0.81,170,183,159,21,12,9,27,15,12,18,7,11,+4,+3,+1,74%,75%,72%,110,118,102,34%,33%,34%,7,5,2,3,2,1
466,https://vlr.gg/player/51101/abo2,2025-02-04 19:10:00,1.38,1.26,1.32,285,305,276,39,18,21,30,15,15,10,7,3,-1,+2,-3,76%,78%,75%,183,196,171,25%,33%,19%,3,3,0,4,1,3
467,https://vlr.gg/player/24232/ghost,2025-02-04 19:10:00,1.34,0.75,1.03,179,238,123,23,16,7,26,12,14,12,4,8,+2,0,+2,63%,61%,65%,111,142,83,37%,44%,26%,3,0,3,1,0,1
468,https://vlr.gg/player/44841/garpa,2025-02-04 19:10:00,0.59,0.93,0.77,140,119,154,17,7,10,27,13,14,10,3,7,+1,-1,+2,71%,56%,85%,86,75,95,19%,21%,18%,3,1,2,2,2,0
469,https://vlr.gg/player/44085/booey,2025-02-04 19:10:00,0.12,0.91,0.54,133,71,186,15,3,12,31,16,15,5,3,2,-7,-6,-1,50%,39%,60%,96,62,128,15%,13%,16%,2,0,2,9,6,3
470,https://vlr.gg/player/47392/kaiser,2025-02-04 19:10:00,0.66,0.31,0.47,110,134,95,15,9,6,33,15,18,10,5,5,-7,-5,-2,55%,61%,50%,71,79,64,20%,23%,18%,2,0,2,9,5,4
471,https://vlr.gg/player/2172/brawk,2025-02-04 19:05:00,1.46,1.20,1.35,216,228,218,39,22,17,25,11,14,20,18,2,-2,-1,-1,79%,89%,65%,155,153,159,17%,16%,17%,0,0,0,2,1,1
472,https://vlr.gg/player/864/bcj,2025-02-04 19:05:00,1.87,0.53,1.31,225,275,131,35,28,7,28,11,17,32,20,12,+2,+4,-2,79%,96%,55%,130,159,88,27%,28%,27%,6,5,1,4,1,3
473,https://vlr.gg/player/23407/pa1nt,2025-02-04 19:05:00,0.85,1.66,1.19,280,227,300,47,24,23,33,21,12,6,5,1,-6,-3,-3,73%,82%,60%,160,143,184,25%,22%,28%,7,4,3,13,7,6
474,https://vlr.gg/player/2164/paincakes,2025-02-04 19:05:00,1.40,0.69,1.10,216,269,162,36,28,8,31,15,16,11,5,6,0,0,0,69%,75%,60%,153,176,119,35%,35%,35%,6,4,2,6,4,2
475,https://vlr.gg/player/8422/spaz,2025-02-04 19:05:00,0.89,0.84,0.87,149,169,132,24,16,8,31,17,14,29,18,11,0,-2,+2,73%,82%,60%,101,108,91,17%,25%,8%,2,0,2,2,2,0
476,https://vlr.gg/player/754/nerve,2025-02-04 19:05:00,1.15,0.90,1.01,158,203,160,32,15,17,34,12,22,15,9,6,+1,0,+1,67%,75%,61%,112,127,100,25%,27%,23%,3,1,2,2,1,1
477,https://vlr.gg/player/5093/logan,2025-02-04 19:05:00,0.73,1.14,0.97,211,168,218,29,10,19,36,15,21,11,6,5,-1,-1,0,65%,80%,54%,141,120,156,23%,21%,25%,2,1,1,3,2,1
478,https://vlr.gg/player/29893/timotino,2025-02-04 19:05:00,1.42,0.45,0.85,191,305,128,34,23,11,37,11,26,6,1,5,+3,+2,+1,63%,75%,54%,136,197,93,29%,25%,35%,9,4,5,6,2,4
479,https://vlr.gg/player/6437/dark3st,2025-02-04 19:05:00,1.17,0.58,0.83,169,216,148,28,16,12,37,12,25,23,6,17,+1,+1,0,69%,80%,61%,104,117,94,20%,16%,25%,8,4,4,7,3,4
480,https://vlr.gg/player/21878/snarly,2025-02-04 19:05:00,0.69,0.79,0.75,154,127,174,25,9,16,37,13,24,9,2,7,+2,+2,0,73%,80%,68%,108,87,124,29%,31%,28%,5,2,3,3,0,3
481,https://vlr.gg/player/2468/delz1k,2025-02-04 16:15:00,1.08,1.43,1.25,237,228,247,40,20,20,31,18,13,19,10,9,+2,+1,+1,83%,83%,83%,145,124,166,23%,21%,24%,4,2,2,2,1,1
482,https://vlr.gg/player/2464/suther,2025-02-04 16:15:00,1.21,1.17,1.19,232,244,220,38,20,18,30,15,15,18,7,11,+4,+3,+1,77%,79%,75%,149,158,141,28%,30%,25%,7,4,3,3,1,2
483,https://vlr.gg/player/1294/nagz,2025-02-04 16:15:00,1.01,1.11,1.06,212,157,267,33,13,20,31,12,19,9,2,7,+4,+1,+3,73%,75%,71%,141,108,174,20%,13%,24%,9,3,6,5,2,3
484,https://vlr.gg/player/29244/mikey-tap,2025-02-04 16:15:00,1.16,0.55,0.86,149,191,108,24,15,9,30,14,16,20,13,7,-1,+1,-2,71%,79%,63%,101,120,81,30%,33%,26%,4,3,1,5,2,3
485,https://vlr.gg/player/3828/tacolilla,2025-02-04 16:15:00,0.56,0.82,0.69,123,109,136,17,7,10,31,16,15,10,5,5,-3,-2,-1,73%,75%,71%,82,76,88,9%,11%,7%,3,2,1,6,4,2
486,https://vlr.gg/player/36169/mta,2025-02-04 16:15:00,0.99,1.42,1.20,220,196,244,37,17,20,29,16,13,12,4,8,-3,-2,-1,75%,75%,75%,145,126,164,26%,31%,22%,2,1,1,5,3,2
487,https://vlr.gg/player/38857/beng,2025-02-04 16:15:00,1.35,0.91,1.13,206,189,223,34,16,18,30,12,18,17,9,8,-1,+1,-2,71%,71%,71%,143,129,157,32%,29%,34%,2,1,1,3,0,3
488,https://vlr.gg/player/15542/gio,2025-02-04 16:15:00,1.01,0.93,0.97,177,203,151,30,18,12,28,15,13,19,7,12,-4,-3,-1,75%,75%,75%,118,130,106,43%,41%,44%,2,1,1,6,4,2
489,https://vlr.gg/player/33566/ganter,2025-02-04 16:15:00,0.91,0.79,0.85,158,173,144,27,15,12,30,14,16,9,5,4,+1,+1,0,77%,88%,67%,105,114,97,18%,19%,16%,5,2,3,4,1,3
490,https://vlr.gg/player/41135/dantedeu5,2025-02-04 16:15:00,0.59,0.93,0.76,164,163,165,25,12,13,35,20,15,6,3,3,+1,+1,0,50%,50%,50%,104,100,108,21%,33%,14%,10,6,4,9,5,4
491,https://vlr.gg/player/8419/reduxx,2025-02-04 16:00:00,1.39,1.62,1.49,275,255,307,40,21,19,25,15,10,14,10,4,0,-1,+1,73%,75%,71%,168,163,176,18%,19%,16%,10,5,5,10,6,4
492,https://vlr.gg/player/4828/nismo,2025-02-04 16:00:00,1.45,1.27,1.38,253,274,227,37,24,13,26,15,11,16,8,8,+5,+3,+2,85%,88%,82%,175,189,155,33%,36%,29%,6,3,3,1,0,1
493,https://vlr.gg/player/11118/skuba,2025-02-04 16:00:00,1.50,1.02,1.30,188,193,186,32,20,12,19,10,9,16,13,3,+2,+1,+1,88%,88%,88%,127,134,117,24%,19%,35%,2,1,1,0,0,0
494,https://vlr.gg/player/41798/nightz,2025-02-04 16:00:00,0.98,0.98,0.98,204,215,167,29,19,10,31,19,12,6,4,2,+2,+1,+1,73%,58%,94%,137,152,115,48%,54%,39%,4,3,1,2,2,0
495,https://vlr.gg/player/3007/tdawgg,2025-02-04 16:00:00,0.62,0.93,0.73,145,118,186,17,7,10,30,18,12,25,17,8,-2,-2,0,68%,75%,59%,97,81,118,16%,14%,19%,2,1,1,4,3,1
496,https://vlr.gg/player/8397/dip,2025-02-04 16:00:00,1.35,0.89,1.08,230,278,194,33,18,15,29,11,18,12,3,9,+1,0,+1,85%,76%,92%,143,160,130,24%,22%,25%,3,1,2,2,1,1
497,https://vlr.gg/player/21886/furbsa,2025-02-04 16:00:00,0.47,1.35,0.99,220,145,281,33,9,24,32,15,17,6,3,3,-1,-3,+2,66%,65%,67%,144,98,177,52%,39%,61%,6,1,5,7,4,3
498,https://vlr.gg/player/20959/toozy,2025-02-04 16:00:00,1.07,0.82,0.92,163,159,163,24,10,14,29,10,19,22,11,11,-2,0,-2,71%,82%,63%,97,82,108,32%,27%,35%,0,0,0,2,0,2
499,https://vlr.gg/player/8758/benjii,2025-02-04 16:00:00,0.84,0.70,0.76,182,206,164,25,13,12,31,13,18,10,1,9,-2,+1,-3,68%,65%,71%,118,118,118,35%,39%,33%,5,4,1,7,3,4
500,https://vlr.gg/player/14048/zerona,2025-02-04 16:00:00,0.29,0.56,0.45,128,92,157,16,4,12,34,15,19,13,9,4,-3,-3,0,59%,65%,54%,89,71,102,21%,18%,23%,3,0,3,6,3,3
0,https://vlr.gg/player/3702/sym,2025-02-04 16:00:00,1.29,1.14,1.22,295,341,241,67,40,27,49,28,21,12,5,7,+5,+7,-2,73%,76%,69%,189,218,154,26%,34%,14%,21,15,6,16,8,8
1,https://vlr.gg/player/8376/seven,2025-02-04 16:00:00,1.00,1.19,1.09,215,200,251,47,23,24,45,24,21,23,13,10,+1,-1,+2,76%,76%,76%,141,126,159,20%,22%,19%,4,1,3,3,2,1
2,https://vlr.gg/player/64/gmd,2025-02-04 16:00:00,0.89,1.23,1.05,189,161,211,45,21,24,40,22,18,28,14,14,0,+1,-1,79%,74%,86%,124,103,149,34%,40%,30%,3,1,2,3,0,3
3,https://vlr.gg/player/39602/recoil,2025-02-04 16:00:00,0.98,1.06,1.01,183,156,195,42,21,21,34,18,16,8,4,4,+1,+2,-1,65%,65%,66%,120,110,130,26%,26%,25%,4,3,1,3,1,2
4,https://vlr.gg/player/20140/vora,2025-02-04 16:00:00,0.74,0.96,0.84,147,138,157,31,17,14,41,24,17,22,12,10,-3,+1,-4,75%,79%,69%,100,105,95,28%,25%,31%,2,2,0,5,1,4
5,https://vlr.gg/player/15051/sacred,2025-02-04 16:00:00,0.95,1.20,1.09,204,172,237,45,17,28,45,20,25,23,8,15,+2,+1,+1,79%,76%,82%,132,112,148,25%,28%,23%,7,1,6,5,0,5
6,https://vlr.gg/player/3874/teague,2025-02-04 16:00:00,1.05,1.10,1.08,198,170,224,46,19,27,43,20,23,18,9,9,0,+2,-2,75%,69%,79%,134,113,152,27%,27%,26%,4,3,1,4,1,3
7,https://vlr.gg/player/29688/mikee,2025-02-04 16:00:00,0.80,1.10,0.95,182,182,203,44,19,25,47,25,22,16,4,12,0,+3,-3,60%,52%,68%,125,125,125,33%,33%,33%,5,4,1,5,1,4
8,https://vlr.gg/player/4385/monsi,2025-02-04 16:00:00,0.84,0.94,0.89,167,158,178,38,17,21,46,22,24,23,12,11,-2,0,-2,65%,69%,62%,104,93,114,30%,29%,31%,5,4,1,7,4,3
9,https://vlr.gg/player/34057/jerrwin,2025-02-04 16:00:00,0.86,0.63,0.73,159,202,123,34,19,15,51,25,26,13,8,5,-4,-1,-3,62%,72%,53%,115,144,91,22%,19%,26%,8,5,3,12,6,6
10,https://vlr.gg/player/29243/neon,2025-02-04 14:00:00,1.45,1.49,1.47,278,273,284,40,21,19,21,14,7,9,4,5,+5,0,+5,83%,78%,89%,185,189,179,28%,31%,25%,10,4,6,5,4,1
11,https://vlr.gg/player/29241/miradaninja,2025-02-04 14:00:00,1.44,1.12,1.29,215,243,186,32,19,13,22,15,7,9,6,3,-2,-1,-1,74%,70%,79%,154,181,122,29%,39%,19%,3,2,1,5,3,2
12,https://vlr.gg/player/21251/blowz,2025-02-04 14:00:00,0.67,1.66,1.12,166,116,234,26,10,16,22,18,4,21,9,12,+1,0,+1,79%,65%,95%,107,77,143,36%,30%,42%,2,1,1,1,1,0
13,https://vlr.gg/player/42867/ghoul33,2025-02-04 14:00:00,0.69,1.60,1.10,239,175,313,39,15,24,28,19,9,6,2,4,0,-1,+1,76%,65%,89%,152,110,203,18%,14%,21%,5,2,3,5,3,2
14,https://vlr.gg/player/29242/erde,2025-02-04 14:00:00,0.75,1.49,1.09,183,136,239,25,8,17,21,16,5,14,12,2,+2,-1,+3,81%,74%,89%,119,94,150,25%,19%,33%,4,1,3,2,2,0
15,https://vlr.gg/player/35665/miyeon,2025-02-04 14:00:00,0.82,1.58,1.24,269,198,332,40,12,28,32,17,15,5,1,4,0,-2,+2,69%,42%,91%,183,134,223,23%,20%,24%,8,3,5,8,5,3
16,https://vlr.gg/player/3677/fross,2025-02-04 14:00:00,0.73,1.21,0.99,167,136,207,25,8,17,31,17,14,14,4,10,-1,-2,+1,60%,47%,70%,114,100,125,15%,17%,13%,3,1,2,4,3,1
17,https://vlr.gg/player/39154/kimb0,2025-02-04 14:00:00,0.63,0.84,0.75,155,125,181,21,7,14,33,17,16,6,1,5,-1,-1,0,52%,42%,61%,105,96,113,32%,42%,27%,2,0,2,3,1,2
18,https://vlr.gg/player/46082/jcz,2025-02-04 14:00:00,0.10,0.97,0.56,110,50,159,15,2,13,31,19,12,9,2,7,0,0,0,57%,26%,83%,78,39,110,22%,23%,22%,5,1,4,5,1,4
19,https://vlr.gg/player/11046/deigara,2025-02-04 14:00:00,0.22,0.55,0.40,115,75,142,13,3,10,35,19,16,8,3,5,-4,-4,0,48%,32%,61%,81,61,96,32%,31%,32%,0,0,0,4,4,0
20,https://vlr.gg/player/7746/kevzii,2025-02-04 07:50:00,1.31,0.99,1.16,212,250,159,46,30,16,44,26,18,31,13,18,-1,-1,0,76%,82%,69%,134,166,97,26%,28%,23%,3,1,2,4,2,2
21,https://vlr.gg/player/16953/zynd,2025-02-04 07:50:00,0.80,1.43,1.09,204,163,286,52,21,31,44,27,17,16,5,11,-3,-4,+1,70%,59%,83%,140,107,178,30%,30%,30%,8,4,4,11,8,3
22,https://vlr.gg/player/9747/emman,2025-02-04 07:50:00,0.91,1.18,1.03,230,189,264,46,21,25,49,28,21,19,9,10,+1,-1,+2,76%,68%,86%,153,127,182,36%,35%,36%,7,2,5,6,3,3
23,https://vlr.gg/player/11578/hotsauz,2025-02-04 07:50:00,0.79,1.16,0.96,196,169,229,41,18,23,46,28,18,23,14,9,+2,0,+2,73%,65%,83%,134,115,156,25%,25%,25%,4,2,2,2,2,0
24,https://vlr.gg/player/9737/kakarot,2025-02-04 07:50:00,0.52,1.24,0.84,192,164,244,43,17,26,50,33,17,19,13,6,-2,-6,+4,73%,68%,79%,129,107,154,15%,14%,18%,8,2,6,10,8,2
25,https://vlr.gg/player/49001/secre,2025-02-04 07:50:00,1.00,1.46,1.25,263,223,289,56,23,33,47,25,22,24,9,15,+6,+3,+3,73%,69%,76%,170,145,191,29%,28%,29%,7,3,4,1,0,1
26,https://vlr.gg/player/14207/viness,2025-02-04 07:50:00,0.81,1.34,1.10,246,175,289,55,18,37,48,25,23,8,1,7,+1,-1,+2,68%,55%,79%,163,122,198,26%,27%,26%,6,2,4,5,3,2
27,https://vlr.gg/player/44919/aplycs,2025-02-04 07:50:00,0.82,1.31,1.08,197,178,212,43,17,26,41,24,17,29,12,17,+1,-3,+4,76%,66%,85%,136,109,158,30%,29%,31%,4,0,4,3,3,0
28,https://vlr.gg/player/12322/ndg,2025-02-04 07:50:00,0.75,1.13,0.95,175,137,206,39,14,25,44,21,23,22,5,17,-4,-4,0,71%,48%,91%,120,95,141,23%,25%,22%,4,0,4,8,4,4
29,https://vlr.gg/player/44149/pr0digy,2025-02-04 07:50:00,0.72,0.81,0.77,173,188,167,40,19,21,48,26,22,10,6,4,-1,-4,+3,70%,59%,79%,118,125,111,29%,29%,30%,12,5,7,13,9,4
30,https://vlr.gg/player/13744/patmen,2025-02-04 06:00:00,1.50,1.36,1.46,266,275,242,33,24,9,18,13,5,14,12,2,+3,+1,+2,91%,92%,89%,174,182,154,33%,36%,27%,4,2,2,1,1,0
31,https://vlr.gg/player/6913/sultan,2025-02-04 06:00:00,1.35,1.75,1.46,216,186,287,26,17,9,15,11,4,26,18,8,+2,+1,+1,85%,83%,89%,130,121,154,32%,38%,24%,3,2,1,1,1,0
32,https://vlr.gg/player/7754/xavi8k,2025-02-04 06:00:00,1.37,1.51,1.41,228,216,271,28,20,8,16,11,5,17,12,5,+1,+2,-1,88%,92%,78%,160,150,188,28%,28%,30%,3,2,1,2,0,2
33,https://vlr.gg/player/3401/ptc,2025-02-04 06:00:00,1.43,1.18,1.36,235,264,155,29,22,7,17,13,4,6,5,1,+2,+3,-1,79%,83%,67%,149,167,101,53%,58%,36%,4,4,0,2,1,1
34,https://vlr.gg/player/16842/mojer,2025-02-04 06:00:00,0.91,0.86,0.89,230,237,211,27,20,7,24,18,6,7,7,0,+1,+1,0,79%,79%,78%,147,152,131,31%,36%,20%,7,6,1,6,5,1
35,https://vlr.gg/player/7783/zhar,2025-02-04 06:00:00,0.75,0.84,0.81,176,114,194,20,3,17,28,7,21,10,5,5,-3,0,-3,58%,67%,54%,111,84,121,21%,30%,20%,1,0,1,4,0,4
36,https://vlr.gg/player/37057/woody,2025-02-04 06:00:00,0.85,0.77,0.79,167,202,155,18,7,11,28,8,20,17,3,14,-3,-1,-2,61%,67%,58%,98,110,93,31%,50%,23%,1,1,0,4,2,2
37,https://vlr.gg/player/7049/natz,2025-02-04 06:00:00,0.42,0.89,0.75,191,160,202,21,4,17,28,8,20,3,1,2,-1,-1,0,58%,44%,63%,125,100,134,36%,43%,34%,5,1,4,6,2,4
38,https://vlr.gg/player/26826/6ixkey,2025-02-04 06:00:00,0.77,0.54,0.61,136,158,127,17,6,11,30,8,22,6,1,5,-1,0,-1,58%,56%,58%,86,110,77,43%,42%,44%,1,0,1,2,0,2
39,https://vlr.gg/player/36685/splash,2025-02-04 06:00:00,0.42,0.68,0.61,152,146,155,14,4,10,29,9,20,8,0,8,-1,+1,-2,64%,89%,54%,105,92,110,25%,29%,24%,4,2,2,5,1,4
40,https://vlr.gg/player/29841/caedye,2025-02-04 05:00:00,1.11,1.72,1.37,297,237,351,67,30,37,43,28,15,16,11,5,+10,+3,+7,79%,71%,89%,180,150,220,31%,35%,28%,15,7,8,5,4,1
41,https://vlr.gg/player/10584/seoldam,2025-02-04 05:00:00,1.13,1.29,1.20,260,250,254,55,31,24,46,28,18,19,9,10,0,-5,+5,74%,68%,82%,157,161,151,21%,22%,21%,8,2,6,8,7,1
42,https://vlr.gg/player/4663/joxjo,2025-02-04 05:00:00,1.07,1.20,1.13,207,203,211,46,25,21,41,27,14,28,19,9,0,-3,+3,74%,68%,82%,133,132,134,20%,20%,19%,7,3,4,7,6,1
43,https://vlr.gg/player/5476/minty,2025-02-04 05:00:00,0.82,1.38,1.06,180,170,202,42,21,21,41,29,12,33,16,17,0,0,0,77%,68%,89%,120,105,141,28%,29%,27%,4,2,2,4,2,2
44,https://vlr.gg/player/29843/yatsuka,2025-02-04 05:00:00,0.83,1.05,0.93,172,156,222,41,21,20,43,27,16,25,13,12,-2,-3,+1,73%,63%,86%,126,106,153,33%,29%,37%,3,1,2,5,4,1
45,https://vlr.gg/player/34776/absol,2025-02-04 05:00:00,0.95,1.27,1.13,249,229,267,58,21,37,47,24,23,10,6,4,+5,-1,+6,65%,57%,71%,150,137,160,17%,12%,22%,16,4,12,11,5,6
46,https://vlr.gg/player/1395/tennn,2025-02-04 05:00:00,0.94,0.99,0.95,197,203,206,47,19,28,53,24,29,25,10,15,-3,-4,+1,71%,57%,82%,129,122,134,41%,44%,39%,5,2,3,8,6,2
47,https://vlr.gg/player/23971/ask,2025-02-04 05:00:00,0.69,1.07,0.91,175,137,206,39,13,26,50,24,26,31,11,20,-3,-5,+2,64%,50%,74%,116,90,135,25%,35%,21%,5,0,5,8,5,3
48,https://vlr.gg/player/1003/reita,2025-02-04 05:00:00,0.67,1.05,0.88,178,145,211,42,14,28,51,25,26,16,1,15,-2,-1,-1,56%,39%,68%,119,89,140,21%,23%,20%,0,0,0,2,1,1
49,https://vlr.gg/player/686/tonbo,2025-02-04 05:00:00,0.22,0.76,0.52,113,84,143,27,7,20,51,26,25,9,4,5,-5,-5,0,53%,36%,66%,77,55,94,22%,21%,22%,3,0,3,8,5,3
50,https://vlr.gg/player/25279/sakura,2025-02-04 02:00:00,0.89,1.02,0.96,206,186,227,43,20,23,38,20,18,12,5,7,+2,+3,-1,75%,69%,81%,131,112,151,35%,27%,43%,6,3,3,4,0,4
51,https://vlr.gg/player/46355/jerry,2025-02-04 02:00:00,1.11,0.72,0.92,195,224,165,36,21,15,38,19,19,11,5,6,-1,+1,-2,67%,65%,69%,118,138,99,27%,30%,23%,6,4,2,7,3,4
52,https://vlr.gg/player/17111/allen,2025-02-04 02:00:00,0.88,0.94,0.91,204,208,200,30,15,15,39,21,18,32,16,16,-4,-2,-2,77%,73%,81%,144,145,142,29%,34%,24%,1,0,1,5,2,3
53,https://vlr.gg/player/10642/jan,2025-02-04 02:00:00,0.76,1.03,0.89,170,163,177,30,14,16,38,21,17,12,5,7,+1,0,+1,60%,50%,69%,122,118,127,28%,26%,30%,2,1,1,1,1,0
54,https://vlr.gg/player/43072/jinbey,2025-02-04 02:00:00,0.62,1.03,0.82,187,150,225,37,14,23,40,21,19,7,2,5,-4,-2,-2,63%,54%,73%,116,87,146,21%,27%,15%,8,5,3,12,7,5
55,https://vlr.gg/player/7745/yoshiii,2025-02-04 02:00:00,1.11,1.51,1.31,259,230,289,50,20,30,34,19,15,13,6,7,+5,+4,+1,79%,73%,85%,169,154,185,36%,41%,32%,6,5,1,1,1,0
56,https://vlr.gg/player/993/medusa,2025-02-04 02:00:00,1.30,1.30,1.30,225,221,230,41,21,20,33,18,15,22,7,15,0,+1,-1,69%,73%,65%,156,149,163,29%,32%,27%,4,2,2,4,1,3
57,https://vlr.gg/player/6700/anthem,2025-02-04 02:00:00,0.88,1.33,1.10,200,145,255,31,10,21,34,17,17,33,15,18,+4,+1,+3,85%,77%,92%,125,94,156,25%,20%,28%,5,2,3,1,1,0
58,https://vlr.gg/player/4477/lob,2025-02-04 02:00:00,0.82,1.29,1.05,200,169,231,37,16,21,36,20,16,21,10,11,+7,+2,+5,79%,73%,85%,128,104,151,28%,23%,33%,7,2,5,0,0,0
59,https://vlr.gg/player/687/zepher,2025-02-04 02:00:00,1.28,0.39,0.84,186,257,116,33,23,10,39,19,20,11,6,5,-10,-2,-8,63%,69%,58%,124,168,79,27%,30%,18%,7,5,2,17,7,10
60,https://vlr.gg/player/44075/dedmos,2025-02-03 19:00:00,1.12,1.08,1.10,220,240,204,30,13,17,31,13,18,18,5,13,+2,-1,+3,65%,69%,63%,142,152,136,22%,28%,18%,3,0,3,1,1,0
61,https://vlr.gg/player/45921/v1bz,2025-02-03 19:00:00,0.85,0.95,0.91,170,161,179,22,8,14,31,12,19,21,7,14,+1,+1,0,73%,88%,63%,119,112,123,27%,30%,25%,2,1,1,1,0,1
62,https://vlr.gg/player/21428/crunch,2025-02-03 19:00:00,0.63,0.90,0.79,193,195,195,27,10,17,35,14,21,8,4,4,-6,-6,0,70%,63%,75%,134,135,133,28%,22%,33%,6,0,6,12,6,6
63,https://vlr.gg/player/35619/sxnti,2025-02-03 19:00:00,0.75,0.64,0.68,174,178,168,23,10,13,35,13,22,11,3,8,-4,0,-4,65%,69%,63%,118,117,119,24%,17%,29%,2,2,0,6,2,4
64,https://vlr.gg/player/50835/arbex,2025-02-03 19:00:00,0.32,0.72,0.56,165,121,193,24,7,17,38,16,22,4,2,2,-3,-2,-1,65%,63%,67%,100,75,116,27%,40%,23%,2,1,1,5,3,2
65,https://vlr.gg/player/7616/feniz,2025-02-03 19:00:00,1.40,1.34,1.37,233,257,197,35,22,13,22,15,7,13,10,3,+2,+1,+1,80%,79%,81%,159,172,139,29%,28%,31%,3,2,1,1,1,0
66,https://vlr.gg/player/10557/darker,2025-02-03 19:00:00,1.49,1.11,1.34,251,280,214,40,28,12,26,15,11,21,11,10,+1,0,+1,80%,83%,75%,159,164,150,34%,29%,42%,2,1,1,1,1,0
67,https://vlr.gg/player/3983/virtyy,2025-02-03 19:00:00,1.23,1.24,1.23,284,281,280,41,26,15,29,17,12,7,3,4,+8,+3,+5,83%,83%,81%,187,194,178,27%,34%,19%,14,8,6,6,5,1
68,https://vlr.gg/player/8056/mited,2025-02-03 19:00:00,0.98,1.59,1.22,215,175,278,32,15,17,23,15,8,10,5,5,+1,-1,+2,88%,88%,88%,148,123,184,30%,23%,36%,3,0,3,2,1,1
69,https://vlr.gg/player/9354/cebando,2025-02-03 19:00:00,0.75,0.94,0.83,168,162,180,22,11,11,26,16,10,20,14,6,-2,-1,-1,80%,79%,81%,108,111,105,26%,33%,21%,3,2,1,5,3,2
70,https://vlr.gg/player/765/jerk,2025-02-03 18:10:00,1.10,1.05,1.08,180,221,150,43,24,19,40,23,17,17,7,10,0,+1,-1,74%,73%,75%,121,151,96,26%,21%,31%,7,3,4,7,2,5
71,https://vlr.gg/player/17865/nahsie,2025-02-03 18:10:00,0.89,1.19,1.05,189,173,207,43,17,26,43,22,21,32,14,18,-4,-3,-1,68%,67%,69%,124,107,139,28%,27%,29%,4,1,3,8,4,4
72,https://vlr.gg/player/9017/moobs,2025-02-03 18:10:00,0.91,1.06,0.99,189,168,205,44,18,26,44,20,24,9,3,6,-2,-2,0,59%,50%,67%,127,110,141,30%,33%,28%,6,3,3,8,5,3
73,https://vlr.gg/player/9063/infiltrator,2025-02-03 18:10:00,0.61,1.25,0.96,227,168,275,49,17,32,53,28,25,11,4,7,+1,-6,+7,70%,57%,81%,149,117,176,22%,19%,23%,12,3,9,11,9,2
74,https://vlr.gg/player/9837/flare,2025-02-03 18:10:00,0.96,0.73,0.84,169,156,180,39,17,22,50,20,30,21,6,15,-3,0,-3,73%,80%,67%,118,117,119,22%,20%,24%,0,0,0,3,0,3
75,https://vlr.gg/player/29076/satellite,2025-02-03 18:10:00,0.96,1.32,1.13,274,244,308,64,31,33,52,30,22,9,7,2,+8,-1,+9,74%,67%,83%,161,144,181,17%,11%,25%,17,7,10,9,8,1
76,https://vlr.gg/player/4931/add3r,2025-02-03 18:10:00,0.75,1.40,1.04,210,154,275,50,19,31,44,27,17,18,9,9,+4,+2,+2,74%,64%,87%,138,111,170,35%,37%,34%,7,4,3,3,2,1
77,https://vlr.gg/player/13084/smiley,2025-02-03 18:10:00,1.06,1.01,1.03,190,189,192,43,24,19,41,24,17,33,17,16,0,-1,+1,76%,75%,77%,119,116,122,32%,29%,35%,6,2,4,6,3,3
78,https://vlr.gg/player/3227/screwface,2025-02-03 18:10:00,1.04,0.88,0.97,173,186,163,40,23,17,40,21,19,19,11,8,-4,-3,-1,68%,69%,67%,126,127,126,18%,13%,25%,3,2,1,7,5,2
79,https://vlr.gg/player/8286/glyph,2025-02-03 18:10:00,1.02,0.77,0.91,154,172,132,33,20,13,41,23,18,31,17,14,0,+1,-1,73%,72%,73%,99,109,87,17%,14%,26%,4,2,2,4,1,3
80,https://vlr.gg/player/9094/kess,2025-02-03 18:00:00,1.32,1.39,1.36,275,246,305,66,24,42,46,18,28,26,13,13,+4,+1,+3,84%,90%,79%,185,173,194,23%,27%,20%,9,2,7,5,1,4
81,https://vlr.gg/player/48025/alym,2025-02-03 18:00:00,1.72,0.79,1.20,266,360,173,63,41,22,48,18,30,14,3,11,+3,+4,-1,75%,83%,69%,164,224,118,27%,31%,23%,14,8,6,11,4,7
82,https://vlr.gg/player/10053/fireballops,2025-02-03 18:00:00,1.09,1.16,1.13,222,225,226,51,24,27,47,19,28,21,7,14,+2,0,+2,75%,73%,77%,151,148,154,36%,38%,34%,9,5,4,7,5,2
83,https://vlr.gg/player/862/b0i,2025-02-03 18:00:00,1.01,0.90,0.95,170,177,162,42,19,23,44,17,27,23,12,11,+1,+2,-1,77%,83%,72%,107,107,106,26%,21%,31%,4,3,1,3,1,2
84,https://vlr.gg/player/62/huynh,2025-02-03 18:00:00,0.99,0.78,0.87,149,129,162,37,14,23,42,13,29,23,11,12,-3,+1,-4,74%,87%,64%,104,94,112,20%,21%,19%,2,1,1,5,0,5
85,https://vlr.gg/player/3063/mel,2025-02-03 18:00:00,1.05,1.15,1.10,202,187,242,47,24,23,48,26,22,27,17,10,-1,0,-1,67%,67%,67%,135,120,154,27%,23%,32%,5,4,1,6,4,2
86,https://vlr.gg/player/9185/dodonut,2025-02-03 18:00:00,0.89,0.88,0.89,211,219,201,50,30,20,54,30,24,6,5,1,+2,+3,-1,71%,77%,63%,139,141,137,33%,29%,40%,15,9,6,13,6,7
87,https://vlr.gg/player/3079/alexis,2025-02-03 18:00:00,1.03,0.64,0.86,147,167,154,37,23,14,49,24,25,25,19,6,-3,-3,0,68%,77%,57%,112,122,100,32%,30%,35%,0,0,0,3,3,0
88,https://vlr.gg/player/21486/sarahcat,2025-02-03 18:00:00,1.05,0.53,0.82,191,227,138,48,33,15,56,30,26,5,3,2,-4,+1,-5,65%,74%,53%,129,151,100,36%,35%,37%,3,3,0,7,2,5
89,https://vlr.gg/player/17397/noia,2025-02-03 18:00:00,1.02,0.54,0.81,177,215,138,44,31,13,52,27,25,9,4,5,-1,0,-1,54%,59%,47%,119,139,93,31%,29%,35%,8,4,4,9,4,5
90,https://vlr.gg/player/10556/drakk,2025-02-03 17:00:00,1.83,1.82,1.82,375,446,359,57,24,33,22,10,12,8,6,2,+11,+3,+8,87%,80%,92%,245,270,229,36%,41%,32%,11,3,8,0,0,0
91,https://vlr.gg/player/35583/edu,2025-02-03 17:00:00,1.54,1.18,1.32,244,268,196,33,17,16,21,8,13,21,5,16,+6,+2,+4,90%,80%,96%,130,156,113,27%,14%,40%,7,2,5,1,0,1
92,https://vlr.gg/player/2753/bandicoot,2025-02-03 17:00:00,0.91,1.31,1.15,185,146,213,24,7,17,20,9,11,18,7,11,+3,+2,+1,85%,87%,83%,131,105,146,34%,32%,36%,5,3,2,2,1,1
93,https://vlr.gg/player/39538/bull3tz,2025-02-03 17:00:00,0.96,0.91,0.93,215,226,212,30,12,18,33,13,20,16,5,11,+2,+1,+1,79%,87%,75%,139,145,135,38%,33%,42%,6,3,3,4,2,2
94,https://vlr.gg/player/7618/theory,2025-02-03 17:00:00,0.48,1.15,0.89,155,122,165,21,7,14,22,11,11,11,2,9,+1,-1,+2,77%,80%,75%,100,77,114,41%,33%,45%,2,0,2,1,1,0
95,https://vlr.gg/player/35567/toro,2025-02-03 17:00:00,1.25,0.81,1.08,269,264,255,34,21,13,34,19,15,9,7,2,-5,-2,-3,67%,58%,80%,159,167,145,31%,41%,20%,2,1,1,7,3,4
96,https://vlr.gg/player/24026/generalsteak,2025-02-03 17:00:00,0.96,1.25,1.07,177,158,215,26,13,13,27,16,11,9,5,4,-2,-2,0,62%,58%,67%,126,118,139,47%,43%,55%,0,0,0,2,2,0
97,https://vlr.gg/player/1451/sancho,2025-02-03 17:00:00,0.89,0.43,0.71,158,204,112,22,17,5,34,20,14,11,7,4,-3,-1,-2,49%,46%,53%,108,129,74,29%,24%,45%,2,1,1,5,2,3
98,https://vlr.gg/player/2995/maka,2025-02-03 17:00:00,0.33,1.30,0.70,151,97,257,21,7,14,33,21,12,1,1,0,-4,-4,0,49%,33%,73%,97,57,162,26%,25%,27%,1,0,1,5,4,1
99,https://vlr.gg/player/50581/vecious,2025-02-03 17:00:00,0.32,0.36,0.32,121,120,144,15,9,6,37,22,15,6,2,4,-9,-7,-2,44%,46%,40%,86,85,88,21%,21%,21%,3,2,1,12,9,3
100,https://vlr.gg/player/36560/canezerra,2025-02-03 16:00:00,1.73,1.83,1.78,371,382,361,52,24,28,24,11,13,8,4,4,+9,+6,+3,82%,83%,80%,250,254,248,43%,42%,43%,11,6,5,2,0,2
101,https://vlr.gg/player/29547/ion2x,2025-02-03 16:00:00,1.25,1.60,1.43,266,195,327,38,14,24,20,9,11,13,6,7,-2,-1,-1,79%,78%,80%,181,150,210,40%,59%,34%,2,0,2,4,1,3
102,https://vlr.gg/player/53/inspire,2025-02-03 16:00:00,1.08,1.14,1.11,191,246,151,26,16,10,18,10,8,8,3,5,0,0,0,76%,72%,80%,120,144,99,30%,40%,21%,1,1,0,1,1,0
103,https://vlr.gg/player/35302/eggsterr,2025-02-03 16:00:00,1.10,0.99,1.04,189,209,174,26,14,12,23,11,12,12,3,9,-4,-3,-1,74%,67%,80%,119,130,110,34%,50%,22%,2,1,1,6,4,2
104,https://vlr.gg/player/21778/p0ppin,2025-02-03 16:00:00,0.84,1.02,0.93,152,113,181,16,5,11,19,9,10,16,8,8,-3,-2,-1,76%,72%,80%,100,86,113,22%,24%,21%,3,1,2,6,3,3
105,https://vlr.gg/player/17770/alvinboy,2025-02-03 16:00:00,1.30,0.77,1.05,250,318,167,34,22,12,30,16,14,5,4,1,0,+2,-2,66%,75%,56%,156,202,105,37%,31%,50%,5,3,2,5,1,4
106,https://vlr.gg/player/893/retrq,2025-02-03 16:00:00,0.62,1.08,0.83,164,115,220,23,9,14,30,16,14,13,4,9,+2,-1,+3,66%,50%,83%,88,63,116,23%,25%,21%,3,0,3,1,1,0
107,https://vlr.gg/player/24553/boni,2025-02-03 16:00:00,0.63,0.88,0.74,186,190,191,25,13,12,33,18,15,4,2,2,+1,+2,-1,47%,50%,44%,118,119,115,32%,31%,33%,7,6,1,6,4,2
108,https://vlr.gg/player/3719/matt,2025-02-03 16:00:00,0.50,0.80,0.64,144,120,173,16,7,9,33,18,15,14,8,6,+2,-1,+3,63%,55%,72%,104,89,121,22%,17%,27%,3,0,3,1,1,0
109,https://vlr.gg/player/2125/nanners,2025-02-03 16:00:00,0.33,0.48,0.40,85,74,99,6,3,3,32,17,15,13,4,9,-5,-2,-3,50%,40%,61%,66,58,75,10%,15%,6%,1,1,0,6,3,3
110,https://vlr.gg/player/30470/kyu,2025-02-03 16:00:00,0.86,1.74,1.38,235,144,285,36,9,27,23,11,12,14,6,8,-2,0,-2,76%,65%,83%,158,91,206,31%,29%,32%,1,1,0,3,1,2
111,https://vlr.gg/player/8373/okeanos,2025-02-03 16:00:00,1.85,0.79,1.23,276,404,190,40,25,15,31,12,19,10,3,7,+1,+2,-1,68%,71%,67%,182,248,135,24%,32%,14%,7,4,3,6,2,4
112,https://vlr.gg/player/1856/wedid,2025-02-03 16:00:00,0.92,1.24,1.11,216,202,216,31,12,19,28,13,15,15,6,9,+2,0,+2,78%,71%,83%,131,127,134,28%,28%,28%,4,2,2,2,2,0
113,https://vlr.gg/player/844/bdog,2025-02-03 16:00:00,0.74,1.14,0.97,178,131,207,24,7,17,25,10,15,11,3,8,+5,-1,+6,68%,59%,75%,114,95,128,30%,25%,33%,9,1,8,4,2,2
114,https://vlr.gg/player/34400/bao,2025-02-03 16:00:00,0.68,1.17,0.97,178,111,229,26,6,20,26,11,15,10,4,6,-1,0,-1,68%,59%,75%,131,82,165,41%,47%,40%,2,1,1,3,1,2
115,https://vlr.gg/player/7716/penny,2025-02-03 16:00:00,1.23,1.23,1.23,270,274,271,39,24,15,32,19,13,7,1,6,+3,-1,+4,66%,58%,76%,163,160,167,19%,18%,21%,10,3,7,7,4,3
116,https://vlr.gg/player/69/thief,2025-02-03 16:00:00,0.79,1.39,1.04,229,191,277,33,14,19,30,20,10,10,9,1,-2,-1,-1,76%,75%,76%,131,120,146,24%,36%,18%,1,1,0,3,2,1
117,https://vlr.gg/player/733/stellar,2025-02-03 16:00:00,0.92,0.85,0.87,160,191,124,23,16,7,29,18,11,12,5,7,+1,+1,0,73%,79%,65%,117,132,95,18%,16%,20%,1,1,0,0,0,0
118,https://vlr.gg/player/8742/jakee,2025-02-03 16:00:00,0.62,0.98,0.77,170,174,174,25,14,11,32,21,11,7,6,1,-2,+2,-4,61%,63%,59%,118,116,121,26%,26%,26%,5,5,0,7,3,4
119,https://vlr.gg/player/739/fiziq,2025-02-03 16:00:00,0.38,0.34,0.35,91,101,86,13,8,5,34,20,14,8,5,3,-5,-5,0,61%,63%,59%,61,62,59,21%,19%,25%,1,0,1,6,5,1
120,https://vlr.gg/player/15473/yuno,2025-02-03 15:30:00,0.78,1.71,1.26,224,144,295,37,10,27,26,18,8,21,10,11,+3,0,+3,72%,50%,92%,147,87,202,26%,28%,26%,3,0,3,0,0,0
121,https://vlr.gg/player/6959/flickless,2025-02-03 15:30:00,0.90,1.52,1.22,183,177,186,31,12,19,24,17,7,24,12,12,0,0,0,80%,68%,92%,126,118,132,30%,22%,41%,1,1,0,1,1,0
122,https://vlr.gg/player/8834/bucher,2025-02-03 15:30:00,0.81,1.34,1.08,189,165,216,34,12,22,27,18,9,4,1,3,+2,0,+2,78%,64%,92%,129,112,145,39%,32%,45%,4,1,3,2,1,1
123,https://vlr.gg/player/1839/polvi,2025-02-03 15:30:00,0.65,1.35,1.01,249,200,292,39,15,24,33,19,14,4,1,3,+1,-6,+7,67%,45%,88%,161,120,199,16%,9%,22%,15,4,11,14,10,4
124,https://vlr.gg/player/341/quick,2025-02-03 15:30:00,0.42,1.27,0.86,138,100,170,21,8,13,29,19,10,22,5,17,0,-2,+2,67%,45%,88%,95,73,116,25%,33%,20%,3,1,2,3,3,0
125,https://vlr.gg/player/402/insider,2025-02-03 15:30:00,0.86,1.33,1.08,202,170,239,32,14,18,30,19,11,6,2,4,-1,-3,+2,67%,67%,68%,138,111,168,32%,29%,33%,2,0,2,3,3,0
126,https://vlr.gg/player/1155/buld,2025-02-03 15:30:00,0.26,1.79,0.99,193,70,330,33,5,28,32,21,11,10,2,8,-2,-4,+2,52%,29%,77%,123,47,206,25%,17%,28%,4,1,3,6,5,1
127,https://vlr.gg/player/23347/alannn,2025-02-03 15:30:00,0.69,1.27,0.97,162,149,177,26,10,16,32,21,11,17,8,9,-2,-2,0,63%,54%,73%,109,103,115,36%,34%,38%,0,0,0,2,2,0
128,https://vlr.gg/player/3784/katu,2025-02-03 15:30:00,0.41,1.28,0.83,181,127,236,28,9,19,33,22,11,5,2,3,+1,-5,+6,65%,50%,82%,121,91,153,25%,28%,20%,12,2,10,11,7,4
129,https://vlr.gg/player/4519/kamisseq,2025-02-03 15:30:00,0.57,0.81,0.68,130,122,142,20,10,10,35,22,13,18,8,10,-2,0,-2,65%,54%,77%,85,74,97,34%,42%,28%,2,2,0,4,2,2
130,https://vlr.gg/player/3127/monsteerr,2025-02-03 13:35:00,1.34,1.31,1.33,239,240,236,45,23,22,31,13,18,19,6,13,-2,-4,+2,82%,88%,76%,152,159,145,24%,29%,19%,3,0,3,5,4,1
131,https://vlr.gg/player/8502/olizera,2025-02-03 13:35:00,1.42,0.97,1.20,247,286,209,44,26,18,33,15,18,11,6,5,-2,+2,-4,76%,84%,68%,155,182,128,26%,30%,20%,6,5,1,8,3,5
132,https://vlr.gg/player/5199/guardy,2025-02-03 13:35:00,1.35,0.78,1.07,221,251,194,37,23,14,36,15,21,20,11,9,+2,+1,+1,80%,84%,76%,158,175,141,33%,36%,29%,3,2,1,1,1,0
133,https://vlr.gg/player/22154/pika,2025-02-03 13:35:00,0.99,0.90,0.95,177,159,197,33,15,18,35,14,21,15,7,8,0,+1,-1,76%,80%,72%,120,118,121,36%,37%,35%,4,2,2,4,1,3
134,https://vlr.gg/player/38424/zachkappa,2025-02-03 13:35:00,0.95,0.78,0.87,174,170,180,32,17,15,37,16,21,12,7,5,-2,-1,-1,62%,68%,56%,117,109,124,20%,14%,28%,7,3,4,9,4,5
135,https://vlr.gg/player/6925/chadi,2025-02-03 13:35:00,1.79,0.98,1.38,287,341,230,48,31,17,34,14,20,9,4,5,+2,0,+2,76%,88%,64%,186,228,143,24%,25%,22%,10,5,5,8,5,3
136,https://vlr.gg/player/4851/rexs,2025-02-03 13:35:00,1.23,1.01,1.12,250,236,265,39,19,20,40,17,23,25,17,8,+1,+1,0,76%,84%,68%,172,166,178,33%,38%,29%,7,4,3,6,3,3
137,https://vlr.gg/player/24359/faska,2025-02-03 13:35:00,1.20,0.58,0.89,201,273,130,37,26,11,39,18,21,5,0,5,+5,+4,+1,66%,72%,60%,127,163,91,32%,31%,34%,6,4,2,1,0,1
138,https://vlr.gg/player/2835/kyrrz,2025-02-03 13:35:00,0.71,0.86,0.78,139,153,128,26,14,12,38,19,19,17,8,9,-2,-1,-1,68%,68%,68%,99,113,85,41%,50%,32%,2,1,1,4,2,2
139,https://vlr.gg/player/19588/neptuno,2025-02-03 13:35:00,0.46,0.56,0.51,125,107,143,22,9,13,40,19,21,12,7,5,-2,-1,-1,62%,64%,60%,84,80,89,23%,13%,36%,2,0,2,4,1,3
140,https://vlr.gg/player/292/fit1nho,2025-02-03 13:35:00,0.97,1.78,1.39,273,198,342,33,11,22,23,14,9,11,6,5,+2,-2,+4,77%,65%,89%,174,132,213,46%,31%,59%,4,0,4,2,2,0
141,https://vlr.gg/player/41220/krejz,2025-02-03 13:35:00,1.18,1.46,1.32,284,265,301,35,15,20,24,13,11,3,1,2,+5,0,+5,69%,71%,67%,175,160,189,33%,41%,26%,12,5,7,7,5,2
142,https://vlr.gg/player/20271/vorwenn,2025-02-03 13:35:00,0.86,1.28,1.08,213,179,247,26,10,16,25,13,12,20,6,14,0,0,0,80%,71%,89%,138,124,151,30%,38%,25%,1,1,0,1,1,0
143,https://vlr.gg/player/2534/lowel,2025-02-03 13:35:00,0.88,0.80,0.82,148,130,164,17,6,11,24,12,12,16,13,3,-1,0,-1,66%,65%,67%,99,78,119,20%,18%,21%,0,0,0,1,0,1
144,https://vlr.gg/player/7220/saiz,2025-02-03 13:35:00,0.68,0.86,0.78,124,130,118,16,8,8,21,12,9,8,3,5,-1,-1,0,74%,59%,89%,83,74,90,29%,29%,29%,3,1,2,4,2,2
145,https://vlr.gg/player/18162/serial,2025-02-03 13:35:00,1.49,1.19,1.34,233,277,186,29,18,11,22,14,8,7,2,5,+1,+1,0,74%,72%,76%,175,203,145,42%,36%,52%,1,1,0,0,0,0
146,https://vlr.gg/player/8805/sacake,2025-02-03 13:35:00,1.08,1.13,1.10,209,216,204,27,14,13,25,15,10,12,5,7,-1,-2,+1,66%,56%,76%,130,138,121,22%,19%,26%,3,1,2,4,3,1
147,https://vlr.gg/player/16209/famsii,2025-02-03 13:35:00,0.56,1.14,0.84,167,123,216,20,7,13,26,16,10,6,5,1,+5,0,+5,63%,67%,59%,112,84,142,18%,14%,21%,6,0,6,1,0,1
148,https://vlr.gg/player/1524/h1ber,2025-02-03 13:35:00,0.36,1.14,0.72,148,94,210,18,6,12,26,16,10,19,8,11,-4,-3,-1,63%,44%,82%,88,55,124,18%,11%,21%,1,0,1,5,3,2
149,https://vlr.gg/player/29972/michel,2025-02-03 13:35:00,0.46,0.98,0.70,174,137,220,23,8,15,28,16,12,5,3,2,-6,-4,-2,60%,44%,76%,117,83,152,39%,29%,47%,4,3,1,10,7,3
150,https://vlr.gg/player/5203/bati,2025-02-03 11:00:00,1.59,0.89,1.26,207,249,161,36,23,13,29,11,18,17,13,4,+4,+4,0,80%,100%,57%,139,163,111,16%,15%,16%,5,4,1,1,0,1
151,https://vlr.gg/player/6909/jannyxd,2025-02-03 11:00:00,1.52,0.89,1.23,277,329,223,49,32,17,35,15,20,10,7,3,+3,+3,0,67%,85%,48%,174,218,123,19%,22%,11%,12,6,6,9,3,6
152,https://vlr.gg/player/1493/starkk,2025-02-03 11:00:00,1.64,0.68,1.19,243,306,147,40,30,10,33,14,19,14,7,7,+5,+6,-1,82%,88%,74%,151,198,99,27%,23%,40%,8,6,2,3,0,3
153,https://vlr.gg/player/15376/grtw,2025-02-03 11:00:00,0.94,0.87,0.91,158,126,197,27,12,15,31,12,19,14,8,6,0,+2,-2,73%,81%,65%,106,87,128,25%,24%,26%,3,3,0,3,1,2
154,https://vlr.gg/player/13435/fragger,2025-02-03 11:00:00,0.95,0.48,0.73,158,187,133,28,18,10,37,16,21,21,13,8,-1,+1,-2,71%,73%,70%,105,122,86,28%,25%,32%,2,2,0,3,1,2
155,https://vlr.gg/player/1472/falltw,2025-02-03 11:00:00,1.40,0.90,1.13,233,282,199,41,24,17,36,14,22,14,8,6,0,0,0,76%,87%,65%,158,189,131,24%,26%,22%,3,1,2,3,1,2
156,https://vlr.gg/player/16447/d3mur,2025-02-03 11:00:00,1.22,0.76,0.98,231,278,201,40,23,17,38,15,23,8,3,5,-1,+4,-5,71%,83%,62%,157,176,140,31%,40%,23%,6,6,0,7,2,5
157,https://vlr.gg/player/5854/z3ro,2025-02-03 11:00:00,0.91,0.90,0.91,180,154,203,35,15,20,37,14,23,12,8,4,-1,-1,0,61%,65%,58%,109,99,117,33%,34%,33%,7,4,3,8,5,3
158,https://vlr.gg/player/7868/lele,2025-02-03 11:00:00,1.73,0.18,0.90,176,289,76,29,24,5,35,10,25,21,13,8,-6,+2,-8,63%,91%,38%,113,179,55,17%,14%,26%,3,3,0,9,1,8
159,https://vlr.gg/player/4277/n-a-i-s,2025-02-03 11:00:00,0.81,0.46,0.63,118,114,113,20,11,9,34,12,22,12,7,5,-3,0,-3,63%,78%,50%,68,64,70,15%,7%,25%,0,0,0,3,0,3
160,https://vlr.gg/player/1470/simond4rk,2025-02-03 11:00:00,1.42,1.36,1.39,276,296,251,52,27,25,34,18,16,4,4,0,-3,-4,+1,69%,65%,73%,182,210,154,27%,32%,19%,9,5,4,12,9,3
161,https://vlr.gg/player/2190/baddyg,2025-02-03 11:00:00,1.38,0.78,1.08,210,263,158,40,26,14,33,16,17,15,8,7,0,+2,-2,75%,85%,65%,142,168,116,23%,24%,22%,5,3,2,5,1,4
162,https://vlr.gg/player/12474/tag,2025-02-03 11:00:00,0.90,1.06,0.98,202,169,232,37,16,21,36,17,19,8,5,3,-4,-2,-2,63%,69%,58%,134,124,144,40%,42%,38%,3,1,2,7,3,4
163,https://vlr.gg/player/1944/cayden,2025-02-03 11:00:00,0.79,0.89,0.84,152,148,160,28,13,15,35,19,16,22,15,7,-1,-1,0,75%,77%,73%,98,101,96,36%,33%,38%,2,0,2,3,1,2
164,https://vlr.gg/player/8226/waddle,2025-02-03 11:00:00,0.91,0.72,0.82,138,151,125,25,14,11,32,15,17,12,7,5,-2,-3,+1,69%,69%,69%,94,104,84,31%,36%,26%,2,0,2,4,3,1
165,https://vlr.gg/player/363/7ssk7,2025-02-03 11:00:00,1.21,1.26,1.23,275,266,269,50,25,25,38,18,20,6,2,4,+8,+4,+4,73%,73%,73%,174,172,177,30%,27%,34%,13,7,6,5,3,2
166,https://vlr.gg/player/173/l0udly,2025-02-03 11:00:00,1.16,1.00,1.08,194,207,181,34,19,15,33,17,16,17,4,13,+3,+3,0,67%,65%,69%,133,139,128,33%,40%,26%,6,4,2,3,1,2
167,https://vlr.gg/player/8808/pyrolll,2025-02-03 11:00:00,1.12,0.81,0.96,173,206,145,33,19,14,36,16,20,11,2,9,-4,-2,-2,62%,62%,62%,120,136,104,28%,22%,38%,3,1,2,7,3,4
168,https://vlr.gg/player/443/zeddy,2025-02-03 11:00:00,0.63,1.03,0.83,182,132,225,32,12,20,39,19,20,9,3,6,+4,-1,+5,71%,69%,73%,113,82,144,27%,40%,21%,8,2,6,4,3,1
169,https://vlr.gg/player/2996/neiker,2025-02-03 11:00:00,0.62,0.67,0.65,105,87,124,20,9,11,36,16,20,14,3,11,-1,-2,+1,56%,54%,58%,75,69,81,35%,33%,37%,1,0,1,2,2,0
170,https://vlr.gg/player/24653/vera,2025-02-03 08:00:00,1.24,1.30,1.27,314,333,277,44,27,17,32,18,14,9,5,4,+4,+1,+3,81%,79%,83%,206,222,184,22%,29%,10%,10,6,4,6,5,1
171,https://vlr.gg/player/1430/crazyguy,2025-02-03 08:00:00,0.88,1.46,1.13,207,160,266,34,16,18,25,16,9,8,5,3,0,0,0,79%,75%,83%,131,109,161,20%,22%,18%,4,2,2,4,2,2
172,https://vlr.gg/player/13220/ja,2025-02-03 08:00:00,1.17,0.90,1.05,158,206,101,27,19,8,23,14,9,3,1,2,+2,0,+2,67%,67%,67%,114,152,62,35%,40%,29%,5,3,2,3,3,0
173,https://vlr.gg/player/24628/wayne,2025-02-03 08:00:00,0.91,1.21,1.04,215,163,278,31,14,17,31,17,14,19,10,9,-2,-1,-1,79%,79%,78%,137,105,179,29%,39%,22%,1,0,1,3,1,2
174,https://vlr.gg/player/11704/styron,2025-02-03 08:00:00,0.78,1.19,0.95,168,160,173,23,12,11,26,16,10,22,13,9,-2,-2,0,81%,79%,83%,115,112,119,14%,9%,22%,2,0,2,4,2,2
175,https://vlr.gg/player/14209/suka,2025-02-03 08:00:00,0.89,1.21,1.07,205,196,216,32,13,19,30,14,16,10,2,8,+1,0,+1,76%,78%,75%,136,130,140,28%,22%,32%,2,0,2,1,0,1
176,https://vlr.gg/player/45876/fixy,2025-02-03 08:00:00,0.72,1.31,1.06,242,204,270,34,11,23,34,15,19,7,4,3,0,-2,+2,67%,72%,63%,145,121,163,13%,8%,18%,14,6,8,14,8,6
177,https://vlr.gg/player/5886/flaring,2025-02-03 08:00:00,0.73,0.95,0.86,161,140,174,20,9,11,30,13,17,20,6,14,-1,-1,0,76%,89%,67%,105,85,121,19%,15%,22%,1,0,1,2,1,1
178,https://vlr.gg/player/7513/markl,2025-02-03 08:00:00,0.81,0.69,0.74,170,167,173,26,12,14,34,15,19,9,5,4,0,0,0,67%,72%,63%,106,99,111,9%,12%,8%,1,1,0,1,1,0
179,https://vlr.gg/player/7443/riza,2025-02-03 08:00:00,0.68,0.80,0.74,134,128,143,23,9,14,31,14,17,7,4,3,-2,-1,-1,64%,61%,67%,90,88,93,44%,53%,38%,2,0,2,4,1,3
180,https://vlr.gg/player/13784/killua,2025-02-03 06:00:00,1.57,1.33,1.43,233,262,220,33,13,20,19,7,12,22,9,13,-1,0,-1,90%,87%,92%,155,179,141,34%,29%,39%,0,0,0,1,0,1
181,https://vlr.gg/player/23930/potter,2025-02-03 06:00:00,1.09,1.56,1.38,268,242,280,38,13,25,25,12,13,8,3,5,+1,-1,+2,82%,73%,88%,155,140,165,38%,41%,37%,7,2,5,6,3,3
182,https://vlr.gg/player/27254/leviathan,2025-02-03 06:00:00,1.10,1.27,1.21,202,211,200,30,11,19,23,11,12,13,6,7,-3,+1,-4,74%,73%,75%,144,149,141,27%,26%,29%,1,1,0,4,0,4
183,https://vlr.gg/player/27244/seph1roth,2025-02-03 06:00:00,1.22,1.15,1.17,217,205,216,31,12,19,23,9,14,15,5,10,-1,0,-1,82%,87%,79%,129,116,136,35%,26%,42%,1,1,0,2,1,1
184,https://vlr.gg/player/8582/laz,2025-02-03 06:00:00,1.06,1.12,1.10,240,243,231,31,13,18,26,11,15,12,4,8,+3,-1,+4,72%,67%,75%,154,152,155,22%,23%,21%,10,3,7,7,4,3
185,https://vlr.gg/player/40912/123,2025-02-03 06:00:00,1.13,0.50,0.89,212,255,148,27,19,8,33,20,13,5,4,1,+2,+3,-1,62%,67%,53%,152,182,104,36%,40%,29%,5,4,1,3,1,2
186,https://vlr.gg/player/44770/cxix666,2025-02-03 06:00:00,0.82,0.96,0.87,152,139,189,24,13,11,29,18,11,4,2,2,+3,+1,+2,49%,38%,67%,95,84,111,26%,11%,50%,6,3,3,3,2,1
187,https://vlr.gg/player/40907/mnfear,2025-02-03 06:00:00,0.64,1.06,0.80,193,152,259,23,11,12,34,21,13,10,5,5,+3,0,+3,59%,54%,67%,137,114,175,28%,26%,30%,3,0,3,0,0,0
188,https://vlr.gg/player/44930/nex1sphix,2025-02-03 06:00:00,0.41,1.26,0.73,188,119,284,26,10,16,32,21,11,10,5,5,-2,-2,0,49%,46%,53%,128,86,195,42%,28%,58%,1,0,1,3,2,1
189,https://vlr.gg/player/40908/skyisblue,2025-02-03 06:00:00,0.59,0.23,0.45,130,166,76,16,13,3,35,21,14,15,7,8,-5,-2,-3,59%,58%,60%,90,113,53,24%,21%,40%,5,5,0,10,7,3
190,https://vlr.gg/player/683/pancada,2025-02-02 20:30:00,1.34,0.99,1.19,219,231,192,32,19,13,32,20,12,11,8,3,+3,+4,-1,74%,79%,67%,159,163,154,38%,35%,42%,4,4,0,1,0,1
191,https://vlr.gg/player/2408/tuyz,2025-02-02 20:30:00,0.87,1.32,1.06,195,167,229,28,13,15,29,19,10,13,7,6,+3,-2,+5,71%,58%,89%,124,114,138,35%,35%,35%,6,1,5,3,3,0
192,https://vlr.gg/player/8873/dgzin,2025-02-02 20:30:00,0.53,1.44,0.92,219,166,302,36,15,21,33,22,11,1,1,0,+1,-3,+4,57%,46%,72%,150,108,205,30%,35%,27%,8,1,7,7,4,3
193,https://vlr.gg/player/1586/v1nny,2025-02-02 20:30:00,0.53,0.95,0.71,134,117,164,18,8,10,29,20,9,18,10,8,-2,-3,+1,67%,50%,89%,94,83,110,28%,36%,24%,1,0,1,3,3,0
194,https://vlr.gg/player/6193/cauanzin,2025-02-02 20:30:00,0.28,0.94,0.56,161,127,205,21,9,12,36,23,13,8,2,6,-3,-2,-1,60%,42%,83%,107,82,140,32%,26%,37%,3,3,0,6,5,1
195,https://vlr.gg/player/1311/melser,2025-02-02 20:30:00,1.08,1.72,1.45,283,213,320,45,15,30,25,14,11,14,6,8,+4,+1,+3,86%,78%,92%,168,125,200,28%,33%,26%,5,1,4,1,0,1
196,https://vlr.gg/player/24007/shyy,2025-02-02 20:30:00,1.48,1.03,1.22,196,232,177,29,14,15,25,11,14,11,6,5,0,-1,+1,79%,83%,75%,140,159,125,27%,33%,21%,2,0,2,2,1,1
197,https://vlr.gg/player/7603/mazino,2025-02-02 20:30:00,0.77,1.25,1.04,199,157,237,32,10,22,28,15,13,17,9,8,-2,-2,0,81%,78%,83%,133,97,159,31%,26%,34%,3,2,1,5,4,1
198,https://vlr.gg/player/3826/adverso,2025-02-02 20:30:00,0.47,1.39,1.00,202,124,250,26,5,21,28,16,12,18,8,10,-1,-2,+1,74%,67%,79%,129,89,159,12%,3%,17%,4,0,4,5,2,3
199,https://vlr.gg/player/2462/keznit,2025-02-02 20:30:00,0.77,1.11,0.96,188,191,184,27,11,16,29,15,14,8,3,5,-3,-4,+1,71%,50%,88%,130,134,127,18%,22%,15%,6,2,4,9,6,3
200,https://vlr.gg/player/1818/tex,2025-02-02 17:00:00,1.13,1.14,1.14,184,178,188,48,23,25,39,18,21,8,4,4,-1,+2,-3,74%,76%,71%,123,109,137,36%,39%,34%,4,3,1,5,1,4
201,https://vlr.gg/player/26171/demon1,2025-02-02 17:00:00,1.42,0.78,1.09,250,321,181,61,40,21,50,23,27,18,6,12,-7,-3,-4,75%,79%,71%,165,206,127,26%,39%,13%,6,4,2,13,7,6
202,https://vlr.gg/player/5004/natank,2025-02-02 17:00:00,1.12,0.80,0.95,197,221,178,45,25,20,46,21,25,25,11,14,-2,+4,-6,79%,85%,74%,139,143,135,24%,25%,23%,7,6,1,9,2,7
203,https://vlr.gg/player/8549/kingg,2025-02-02 17:00:00,0.89,0.96,0.92,186,159,208,44,19,25,48,21,27,23,11,12,-1,+2,-3,81%,79%,83%,129,108,150,30%,29%,30%,5,3,2,6,1,5
204,https://vlr.gg/player/619/c0m,2025-02-02 17:00:00,0.76,0.87,0.82,170,145,194,39,17,22,47,21,26,21,10,11,-2,-2,0,76%,79%,74%,111,97,125,17%,16%,18%,5,2,3,7,4,3
205,https://vlr.gg/player/8480/aspas,2025-02-02 17:00:00,1.08,1.21,1.14,222,208,233,51,24,27,45,22,23,9,8,1,+10,+6,+4,75%,83%,67%,143,139,148,18%,24%,11%,15,9,6,5,3,2
206,https://vlr.gg/player/5957/artzin,2025-02-02 17:00:00,1.34,0.81,1.08,230,275,202,51,32,19,53,25,28,23,12,11,+1,+5,-4,72%,77%,67%,162,176,147,12%,12%,13%,12,8,4,11,3,8
207,https://vlr.gg/player/5395/cortezia,2025-02-02 17:00:00,1.29,0.71,1.01,225,271,179,53,35,18,49,22,27,17,7,10,+6,+5,+1,69%,77%,61%,144,171,116,32%,35%,27%,9,6,3,3,1,2
208,https://vlr.gg/player/20240/xenom,2025-02-02 17:00:00,1.15,0.81,0.99,164,174,162,44,25,19,42,19,23,19,13,6,-5,0,-5,74%,83%,64%,106,112,99,35%,27%,47%,3,2,1,8,2,6
209,https://vlr.gg/player/725/nzr,2025-02-02 17:00:00,0.60,1.06,0.82,138,107,174,31,10,21,48,25,23,24,16,8,+1,0,+1,66%,63%,70%,101,80,123,26%,21%,30%,1,0,1,0,0,0
210,https://vlr.gg/player/19588/neptuno,2025-02-02 15:00:00,0.59,1.42,1.06,225,131,293,31,8,23,32,18,14,12,2,10,-1,-3,+2,71%,50%,88%,153,91,200,31%,21%,37%,4,0,4,5,3,2
211,https://vlr.gg/player/6925/chadi,2025-02-02 15:00:00,0.47,1.46,1.03,227,140,292,35,8,27,30,16,14,4,1,3,-3,-8,+5,64%,39%,83%,145,109,173,27%,32%,25%,7,0,7,10,8,2
212,https://vlr.gg/player/2835/kyrrz,2025-02-02 15:00:00,0.47,1.17,0.87,147,105,182,22,6,16,33,18,15,22,5,17,-2,0,-2,76%,61%,88%,89,70,104,22%,23%,21%,1,1,0,3,1,2
213,https://vlr.gg/player/24359/faska,2025-02-02 15:00:00,0.26,1.21,0.80,145,75,200,23,4,19,30,17,13,7,1,6,+1,-1,+2,55%,44%,63%,94,58,122,29%,27%,30%,3,1,2,2,2,0
214,https://vlr.gg/player/4851/rexs,2025-02-02 15:00:00,0.45,0.62,0.55,121,119,121,15,7,8,32,17,15,14,4,10,-3,0,-3,57%,39%,71%,76,67,84,20%,13%,26%,2,1,1,5,1,4
215,https://vlr.gg/player/1470/simond4rk,2025-02-02 15:00:00,1.25,1.52,1.36,299,322,262,41,25,16,29,21,8,16,6,10,0,-3,+3,76%,63%,94%,196,208,180,18%,23%,11%,7,3,4,7,6,1
216,https://vlr.gg/player/2190/baddyg,2025-02-02 15:00:00,0.61,1.91,1.17,219,117,357,31,8,23,26,18,8,22,8,14,+4,-1,+5,71%,50%,100%,138,82,212,30%,30%,29%,7,1,6,3,2,1
217,https://vlr.gg/player/1944/cayden,2025-02-02 15:00:00,0.85,1.53,1.14,163,138,196,26,12,14,20,16,4,17,6,11,-2,-2,0,74%,63%,89%,108,91,131,28%,25%,31%,1,1,0,3,3,0
218,https://vlr.gg/player/12474/tag,2025-02-02 15:00:00,0.87,1.42,1.11,210,176,253,32,16,16,25,18,7,11,5,6,+6,+3,+3,79%,71%,89%,123,97,157,14%,22%,9%,9,5,4,3,2,1
219,https://vlr.gg/player/8226/waddle,2025-02-02 15:00:00,0.59,1.42,0.95,161,116,223,27,10,17,26,20,6,6,4,2,0,-1,+1,69%,46%,100%,102,80,131,34%,20%,50%,1,0,1,1,1,0
220,https://vlr.gg/player/10883/baransel,2025-02-02 13:35:00,1.18,1.43,1.30,276,280,273,23,12,11,18,10,8,6,2,4,-2,-3,+1,71%,67%,75%,174,161,187,38%,26%,50%,1,0,1,3,3,0
221,https://vlr.gg/player/10152/padisah,2025-02-02 13:35:00,1.31,1.15,1.23,270,274,267,24,12,12,18,10,8,1,1,0,-2,-1,-1,63%,58%,67%,159,161,157,30%,35%,24%,5,3,2,7,4,3
222,https://vlr.gg/player/19776/jrayn,2025-02-02 13:35:00,1.10,0.87,0.98,153,173,133,11,6,5,15,8,7,11,4,7,+1,0,+1,83%,83%,83%,103,128,77,38%,45%,29%,1,0,1,0,0,0
223,https://vlr.gg/player/13545/werlass,2025-02-02 13:35:00,0.84,0.90,0.87,208,238,179,19,10,9,16,10,6,1,1,0,-1,-1,0,83%,83%,83%,128,151,104,43%,48%,38%,0,0,0,1,1,0
224,https://vlr.gg/player/3549/touven,2025-02-02 13:35:00,0.38,0.56,0.47,90,45,136,7,2,5,18,9,9,7,4,3,-4,-1,-3,63%,67%,58%,68,38,99,44%,40%,46%,1,0,1,5,1,4
225,https://vlr.gg/player/10161/qutionerx,2025-02-02 13:35:00,1.58,0.95,1.26,255,334,177,22,14,8,15,8,7,4,2,2,+5,+3,+2,75%,75%,75%,153,201,105,42%,41%,45%,7,4,3,2,1,1
226,https://vlr.gg/player/10160/izzy,2025-02-02 13:35:00,1.15,1.25,1.20,260,252,270,22,10,12,20,9,11,6,3,3,+1,0,+1,71%,67%,75%,173,167,180,29%,30%,28%,3,1,2,2,1,1
227,https://vlr.gg/player/8041/brave,2025-02-02 13:35:00,0.57,1.26,0.92,231,166,297,18,6,12,18,10,8,10,4,6,0,-1,+1,71%,58%,83%,149,113,185,43%,60%,34%,2,1,1,2,2,0
228,https://vlr.gg/player/12774/anima,2025-02-02 13:35:00,0.99,0.74,0.87,131,128,135,11,6,5,15,7,8,11,4,7,+1,+1,0,71%,67%,75%,94,95,94,29%,22%,38%,1,1,0,0,0,0
229,https://vlr.gg/player/10163/cyderx,2025-02-02 13:35:00,0.41,0.94,0.67,140,63,217,12,2,10,16,8,8,3,2,1,+1,-1,+2,63%,50%,75%,96,54,138,55%,33%,64%,3,0,3,2,1,1
230,https://vlr.gg/player/29972/michel,2025-02-02 13:00:00,1.58,1.62,1.60,335,347,308,54,26,28,31,15,16,16,5,11,+7,+4,+3,76%,76%,76%,203,212,195,47%,49%,45%,11,6,5,4,2,2
231,https://vlr.gg/player/18162/serial,2025-02-02 13:00:00,1.25,1.49,1.38,241,227,271,44,18,26,25,13,12,11,4,7,+1,0,+1,85%,81%,88%,167,143,187,48%,43%,52%,3,1,2,2,1,1
232,https://vlr.gg/player/1524/h1ber,2025-02-02 13:00:00,0.78,1.37,1.10,206,137,260,34,10,24,29,14,15,8,3,5,+2,-2,+4,65%,52%,76%,125,95,151,28%,21%,32%,7,1,6,5,3,2
233,https://vlr.gg/player/8805/sacake,2025-02-02 13:00:00,0.61,0.94,0.79,155,152,154,21,9,12,32,17,15,23,6,17,-1,-2,+1,67%,52%,80%,115,122,110,20%,24%,17%,1,0,1,2,2,0
234,https://vlr.gg/player/16209/famsii,2025-02-02 13:00:00,0.41,0.65,0.54,129,127,130,17,8,9,37,19,18,24,8,16,-1,-1,0,70%,57%,80%,82,85,80,20%,25%,15%,5,2,3,6,3,3
235,https://vlr.gg/player/13435/fragger,2025-02-02 13:00:00,1.01,1.41,1.19,212,194,232,35,19,16,32,19,13,26,11,15,0,-2,+2,83%,80%,86%,140,116,168,32%,29%,33%,4,2,2,4,4,0
236,https://vlr.gg/player/5203/bati,2025-02-02 13:00:00,0.96,1.29,1.11,213,174,261,34,14,20,32,18,14,14,9,5,0,-2,+2,72%,68%,76%,144,119,174,17%,16%,18%,3,1,2,3,3,0
237,https://vlr.gg/player/6909/jannyxd,2025-02-02 13:00:00,1.00,1.17,1.07,225,224,243,36,18,18,37,21,16,7,5,2,-2,-1,-1,67%,68%,67%,157,154,160,22%,24%,21%,7,3,4,9,4,5
238,https://vlr.gg/player/1493/starkk,2025-02-02 13:00:00,0.69,0.88,0.78,133,145,125,24,14,10,33,21,12,13,7,6,-1,-1,0,74%,64%,86%,89,91,87,28%,31%,24%,2,1,1,3,2,1
239,https://vlr.gg/player/15376/grtw,2025-02-02 13:00:00,0.59,0.74,0.66,167,145,197,25,11,14,36,20,16,13,8,5,-5,-3,-2,63%,60%,67%,112,90,138,24%,25%,23%,3,1,2,8,4,4
240,https://vlr.gg/player/3784/katu,2025-02-02 13:00:00,1.35,1.34,1.35,290,329,244,47,25,22,31,16,15,8,6,2,+1,+2,-1,66%,73%,60%,172,191,155,44%,38%,51%,9,5,4,8,3,5
241,https://vlr.gg/player/4519/kamisseq,2025-02-02 13:00:00,1.01,1.38,1.21,218,188,244,38,14,24,29,15,14,15,8,7,-2,-1,-1,66%,64%,68%,152,144,159,41%,33%,49%,1,0,1,3,1,2
242,https://vlr.gg/player/402/insider,2025-02-02 13:00:00,1.18,0.77,0.96,135,191,89,22,15,7,22,11,11,6,3,3,+1,+2,-1,79%,86%,72%,89,124,59,37%,52%,21%,4,3,1,3,1,2
243,https://vlr.gg/player/23347/alannn,2025-02-02 13:00:00,0.62,1.21,0.94,194,131,251,33,11,22,33,16,17,17,6,11,+1,-1,+2,68%,64%,72%,129,94,159,48%,65%,43%,3,1,2,2,2,0
244,https://vlr.gg/player/1155/buld,2025-02-02 13:00:00,1.08,0.67,0.86,185,203,168,32,17,15,36,14,22,11,5,6,0,-2,+2,79%,91%,68%,115,117,114,26%,27%,26%,7,2,5,7,4,3
245,https://vlr.gg/player/38424/zachkappa,2025-02-02 13:00:00,1.27,1.82,1.52,305,284,331,54,27,27,31,18,13,4,2,2,+3,-2,+5,74%,72%,77%,193,171,218,27%,34%,23%,9,3,6,6,5,1
246,https://vlr.gg/player/3127/monsteerr,2025-02-02 13:00:00,1.04,1.03,1.04,197,182,226,31,14,17,33,15,18,19,11,8,-1,0,-1,70%,72%,68%,138,131,146,19%,20%,18%,2,0,2,3,0,3
247,https://vlr.gg/player/22154/pika,2025-02-02 13:00:00,0.84,0.77,0.81,133,133,127,20,11,9,30,16,14,14,9,5,+2,+1,+1,70%,76%,64%,86,89,83,31%,31%,30%,3,2,1,1,1,0
248,https://vlr.gg/player/5199/guardy,2025-02-02 13:00:00,0.67,0.77,0.72,169,170,165,24,13,11,39,21,18,22,9,13,-3,-1,-2,70%,68%,73%,104,100,108,28%,29%,27%,3,2,1,6,3,3
249,https://vlr.gg/player/8502/olizera,2025-02-02 13:00:00,0.80,0.39,0.61,158,175,140,22,14,8,39,20,19,14,10,4,-2,+1,-3,55%,56%,55%,113,117,108,22%,23%,20%,6,5,1,8,4,4
250,https://vlr.gg/player/40591/comeback,2025-02-02 12:45:00,2.06,2.22,2.20,470,357,489,24,3,21,7,1,6,2,0,2,+7,+1,+6,100%,100%,100%,278,238,284,33%,17%,36%,8,1,7,1,0,1
251,https://vlr.gg/player/5565/ros,2025-02-02 12:45:00,3.08,1.52,1.74,356,418,347,18,4,14,8,0,8,6,0,6,+3,0,+3,100%,100%,100%,225,243,222,21%,33%,20%,3,0,3,0,0,0
252,https://vlr.gg/player/31305/lar0k,2025-02-02 12:45:00,1.20,1.29,1.27,142,176,137,7,1,6,4,1,3,15,1,14,+1,0,+1,100%,100%,100%,93,121,88,22%,50%,19%,1,0,1,0,0,0
253,https://vlr.gg/player/12795/crewen,2025-02-02 12:45:00,1.71,1.00,1.10,178,294,159,10,2,8,6,1,5,5,2,3,-1,-1,0,79%,50%,83%,110,187,97,41%,38%,42%,0,0,0,1,1,0
254,https://vlr.gg/player/24344/loita,2025-02-02 12:45:00,0.02,1.00,0.83,140,13,162,6,0,6,9,2,7,13,1,12,0,0,0,93%,50%,100%,81,,95,24%,,24%,0,0,0,0,0,0
255,https://vlr.gg/player/10125/qw1,2025-02-02 12:45:00,0.76,2.40,0.99,255,195,621,11,7,4,12,10,2,1,1,0,-4,-5,+1,57%,50%,100%,154,122,347,34%,29%,50%,1,0,1,5,5,0
256,https://vlr.gg/player/3604/mojj,2025-02-02 12:45:00,1.16,0.01,0.96,169,190,44,7,7,0,12,10,2,2,2,0,-1,0,-1,57%,58%,50%,119,131,44,41%,38%,100%,0,0,0,1,0,1
257,https://vlr.gg/player/7353/glovee,2025-02-02 12:45:00,0.97,0.14,0.85,246,267,120,12,11,1,14,12,2,1,1,0,0,0,0,57%,58%,50%,148,157,98,31%,31%,33%,1,1,0,1,1,0
258,https://vlr.gg/player/6559/destruct1vee,2025-02-02 12:45:00,0.23,0.01,0.16,57,63,28,2,2,0,13,11,2,3,3,0,-4,-4,0,36%,42%,,50,54,28,27%,30%,0%,0,0,0,4,4,0
259,https://vlr.gg/player/1399/sterben,2025-02-02 12:45:00,0.12,0.02,0.07,43,47,23,2,2,0,14,12,2,1,1,0,-1,-1,0,50%,58%,,37,40,23,29%,40%,0%,0,0,0,1,1,0
260,https://vlr.gg/player/7490/anguist,2025-02-02 12:30:00,1.33,0.77,1.09,231,278,176,55,38,17,52,29,23,17,9,8,-6,-3,-3,73%,79%,64%,155,173,129,32%,31%,32%,3,3,0,9,6,3
261,https://vlr.gg/player/4589/burzzy,2025-02-02 12:30:00,0.88,1.19,1.02,234,211,254,52,27,25,55,32,23,24,15,9,-2,0,-2,70%,71%,68%,145,137,155,38%,39%,37%,5,3,2,7,3,4
262,https://vlr.gg/player/33358/shinnok,2025-02-02 12:30:00,0.95,0.87,0.91,171,164,179,40,22,18,49,26,23,18,11,7,-4,-2,-2,65%,71%,57%,115,115,115,33%,25%,47%,4,3,1,8,5,3
263,https://vlr.gg/player/217/seider,2025-02-02 12:30:00,0.72,0.73,0.72,116,119,116,26,16,10,48,27,21,25,14,11,-2,+2,-4,64%,58%,71%,84,84,83,28%,32%,24%,4,3,1,6,1,5
264,https://vlr.gg/player/7104/juseu,2025-02-02 12:30:00,0.77,0.45,0.64,174,192,152,40,26,14,55,29,26,9,5,4,0,+1,-1,65%,66%,64%,111,126,91,26%,31%,19%,10,6,4,10,5,5
265,https://vlr.gg/player/50813/gsr,2025-02-02 12:30:00,1.32,1.41,1.37,281,272,267,64,27,37,41,18,23,27,14,13,+1,0,+1,79%,93%,68%,173,177,170,36%,32%,38%,7,4,3,6,4,2
266,https://vlr.gg/player/28948/ninja,2025-02-02 12:30:00,1.57,1.18,1.34,261,287,230,66,33,33,41,16,25,19,10,9,+4,+3,+1,80%,89%,74%,157,179,141,28%,35%,23%,6,3,3,2,0,2
267,https://vlr.gg/player/19526/rexxtoned,2025-02-02 12:30:00,1.14,0.97,1.05,206,205,210,51,22,29,43,16,27,10,4,6,+3,+3,0,77%,82%,74%,140,138,141,45%,43%,47%,7,4,3,4,1,3
268,https://vlr.gg/player/7105/qpert,2025-02-02 12:30:00,1.08,0.92,0.99,155,150,173,36,14,22,39,13,26,32,15,17,+1,+1,0,76%,79%,74%,112,110,113,28%,27%,28%,6,2,4,5,1,4
269,https://vlr.gg/player/40750/donatellooo,2025-02-02 12:30:00,0.84,0.85,0.85,195,200,191,42,20,22,49,21,28,10,3,7,+5,+5,0,71%,82%,63%,125,121,127,26%,24%,29%,14,7,7,9,2,7
270,https://vlr.gg/player/4894/jn3v1ce,2025-02-02 11:45:00,1.40,1.29,1.33,211,164,242,13,4,9,11,3,8,15,9,6,+3,+2,+1,75%,88%,67%,133,103,153,42%,33%,48%,3,2,1,0,0,0
271,https://vlr.gg/player/40841/kabzi,2025-02-02 11:45:00,1.35,1.26,1.29,169,142,187,13,4,9,9,2,7,3,1,2,+1,+1,0,80%,88%,75%,121,95,139,31%,20%,38%,1,1,0,0,0,0
272,https://vlr.gg/player/50776/influx,2025-02-02 11:45:00,1.70,0.93,1.24,294,397,225,21,12,9,13,4,9,3,0,3,0,+1,-1,70%,75%,67%,188,243,151,28%,34%,21%,3,2,1,3,1,2
273,https://vlr.gg/player/13571/musz3kk,2025-02-02 11:45:00,1.45,0.57,0.93,242,366,160,17,11,6,16,6,10,0,0,0,-2,+1,-3,50%,88%,25%,155,212,116,18%,14%,23%,3,1,2,5,0,5
274,https://vlr.gg/player/5500/docent,2025-02-02 11:45:00,0.78,0.51,0.61,129,95,152,10,4,6,15,4,11,5,1,4,0,-1,+1,70%,88%,58%,78,57,92,25%,20%,29%,1,0,1,1,1,0
275,https://vlr.gg/player/10146/reazy,2025-02-02 11:45:00,1.45,0.61,1.12,234,299,137,18,14,4,15,8,7,0,0,0,0,+1,-1,75%,75%,75%,146,181,94,43%,52%,25%,1,1,0,1,0,1
276,https://vlr.gg/player/569/paura,2025-02-02 11:45:00,1.22,0.79,1.05,228,256,186,14,10,4,15,8,7,6,3,3,+1,+1,0,55%,67%,38%,147,166,118,46%,44%,50%,4,2,2,3,1,2
277,https://vlr.gg/player/3862/deepmans,2025-02-02 11:45:00,0.88,0.91,0.89,201,201,201,14,8,6,15,8,7,3,3,0,-1,0,-1,60%,75%,38%,135,132,138,29%,19%,46%,3,3,0,4,3,1
278,https://vlr.gg/player/568/turko,2025-02-02 11:45:00,1.15,0.34,0.83,162,198,109,11,9,2,15,8,7,4,2,2,-1,+1,-2,55%,67%,38%,113,140,73,37%,38%,33%,1,1,0,2,0,2
279,https://vlr.gg/player/50775/lava,2025-02-02 11:45:00,0.72,0.38,0.59,91,90,94,7,4,3,14,7,7,6,5,1,-1,-1,0,70%,83%,50%,59,62,56,28%,27%,29%,0,0,0,1,1,0
280,https://vlr.gg/player/253/sp1ke,2025-02-02 11:00:00,1.18,1.33,1.27,265,255,274,88,36,52,69,29,40,23,11,12,+11,-1,+12,74%,73%,74%,175,175,175,19%,19%,18%,24,5,19,13,6,7
281,https://vlr.gg/player/854/matelian,2025-02-02 11:00:00,1.01,1.13,1.08,167,150,185,59,21,38,60,25,35,39,18,21,+1,+1,0,75%,76%,74%,108,97,116,26%,30%,24%,5,2,3,4,1,3
282,https://vlr.gg/player/15969/yuta,2025-02-02 11:00:00,1.04,0.86,0.93,197,211,197,72,32,40,75,29,46,13,4,9,-4,-5,+1,62%,61%,62%,136,147,129,42%,40%,44%,11,5,6,15,10,5
283,https://vlr.gg/player/11013/balli,2025-02-02 11:00:00,1.04,0.78,0.88,179,214,153,62,29,33,71,33,38,35,20,15,0,+3,-3,78%,78%,78%,114,133,101,40%,39%,41%,7,4,3,7,1,6
284,https://vlr.gg/player/126/nowaxxzang,2025-02-02 11:00:00,0.50,0.84,0.70,147,103,179,53,16,37,76,32,44,15,7,8,-7,-5,-2,58%,59%,57%,100,72,119,29%,29%,29%,3,1,2,10,6,4
285,https://vlr.gg/player/7173/soren,2025-02-02 11:00:00,1.00,1.23,1.09,225,218,258,85,47,38,75,43,32,22,13,9,+2,-1,+3,73%,74%,71%,158,142,180,42%,44%,39%,8,4,4,6,5,1
286,https://vlr.gg/player/24439/yohpa,2025-02-02 11:00:00,1.14,1.01,1.08,206,206,200,70,39,31,57,35,22,33,25,8,+5,+3,+2,77%,79%,73%,137,141,131,39%,34%,47%,6,3,3,1,0,1
287,https://vlr.gg/player/21216/f4ngeer,2025-02-02 11:00:00,1.17,0.89,1.06,201,232,157,72,49,23,65,39,26,12,7,5,+2,-1,+3,66%,69%,61%,134,157,102,31%,40%,13%,18,11,7,16,12,4
288,https://vlr.gg/player/11322/sevire,2025-02-02 11:00:00,1.01,1.10,1.03,234,216,243,78,44,34,70,40,30,24,10,14,+1,-2,+3,69%,62%,78%,147,142,154,41%,45%,38%,13,6,7,12,8,4
289,https://vlr.gg/player/2864/ease,2025-02-02 11:00:00,0.63,0.93,0.74,134,124,147,45,23,22,67,43,24,40,27,13,-11,-7,-4,69%,66%,73%,87,85,89,26%,25%,28%,4,1,3,15,8,7
290,https://vlr.gg/player/7868/lele,2025-02-02 11:00:00,1.12,0.85,0.98,187,199,169,27,17,10,27,16,11,9,8,1,-3,-1,-2,61%,67%,50%,121,126,112,38%,44%,27%,2,1,1,5,2,3
291,https://vlr.gg/player/4277/n-a-i-s,2025-02-02 11:00:00,0.72,1.33,0.95,172,136,266,23,11,12,29,18,11,7,3,4,+1,-3,+4,61%,54%,71%,115,94,152,32%,21%,48%,5,1,4,4,4,0
292,https://vlr.gg/player/5854/z3ro,2025-02-02 11:00:00,0.84,0.95,0.88,157,148,188,20,11,9,30,19,11,10,6,4,+3,+3,0,66%,63%,71%,123,124,123,32%,31%,35%,4,3,1,1,0,1
293,https://vlr.gg/player/1472/falltw,2025-02-02 11:00:00,0.99,0.43,0.76,167,200,99,23,18,5,32,21,11,12,8,4,-1,0,-1,63%,67%,57%,105,132,59,29%,30%,23%,1,1,0,2,1,1
294,https://vlr.gg/player/16447/d3mur,2025-02-02 11:00:00,0.51,0.53,0.52,151,154,159,18,12,6,33,22,11,7,3,4,-2,-3,+1,63%,58%,71%,106,106,106,25%,22%,30%,6,4,2,8,7,1
295,https://vlr.gg/player/6959/flickless,2025-02-02 11:00:00,1.94,1.23,1.49,290,355,245,38,18,20,22,7,15,21,7,14,+2,+3,-1,84%,79%,88%,185,222,164,26%,28%,25%,3,3,0,1,0,1
296,https://vlr.gg/player/8834/bucher,2025-02-02 11:00:00,1.44,1.36,1.39,238,213,250,36,13,23,18,6,12,6,0,6,-1,0,-1,89%,79%,96%,159,151,163,42%,55%,37%,1,0,1,2,0,2
297,https://vlr.gg/player/15473/yuno,2025-02-02 11:00:00,0.72,1.24,1.05,184,127,215,26,6,20,22,9,13,17,8,9,-1,-3,+2,79%,64%,88%,117,87,134,31%,29%,31%,4,0,4,5,3,2
298,https://vlr.gg/player/341/quick,2025-02-02 11:00:00,1.21,0.84,0.98,195,221,186,25,11,14,25,9,16,16,7,9,+1,0,+1,79%,86%,75%,132,140,127,26%,26%,26%,3,0,3,2,0,2
299,https://vlr.gg/player/1839/polvi,2025-02-02 11:00:00,0.68,1.16,0.98,210,172,225,26,7,19,24,11,13,6,4,2,+1,-2,+3,68%,57%,75%,146,134,153,22%,22%,22%,9,3,6,8,5,3
300,https://vlr.gg/player/443/zeddy,2025-02-02 11:00:00,1.08,0.87,0.95,181,205,165,23,11,12,26,9,17,12,5,7,-5,-1,-4,68%,71%,67%,115,124,110,23%,24%,22%,1,1,0,6,2,4
301,https://vlr.gg/player/363/7ssk7,2025-02-02 11:00:00,1.05,0.65,0.80,183,217,168,24,12,12,32,11,21,6,3,3,-3,0,-3,68%,86%,58%,122,137,114,24%,24%,24%,7,4,3,10,4,6
302,https://vlr.gg/player/2996/neiker,2025-02-02 11:00:00,0.89,0.65,0.74,131,169,108,18,9,9,30,12,18,16,8,8,-2,0,-2,61%,79%,50%,84,109,69,32%,38%,28%,0,0,0,2,0,2
303,https://vlr.gg/player/8808/pyrolll,2025-02-02 11:00:00,0.86,0.53,0.65,161,191,141,20,9,11,31,11,20,13,7,6,-3,0,-3,63%,79%,54%,107,126,95,33%,32%,34%,2,1,1,5,1,4
304,https://vlr.gg/player/173/l0udly,2025-02-02 11:00:00,0.57,0.58,0.58,158,168,155,19,8,11,31,12,19,3,1,2,-3,-1,-2,55%,71%,46%,104,120,94,22%,32%,16%,1,0,1,4,1,3
305,https://vlr.gg/player/292/fit1nho,2025-02-02 11:00:00,1.62,2.03,1.77,315,252,425,46,24,22,18,9,9,9,7,2,+7,+4,+3,82%,83%,79%,210,160,297,46%,39%,54%,8,5,3,1,1,0
306,https://vlr.gg/player/2534/lowel,2025-02-02 11:00:00,1.31,1.31,1.31,206,166,282,27,13,14,19,8,11,20,13,7,-1,0,-1,82%,83%,79%,137,117,172,27%,22%,34%,2,1,1,3,1,2
307,https://vlr.gg/player/41220/krejz,2025-02-02 11:00:00,1.31,0.82,1.13,244,275,192,36,26,10,26,15,11,1,0,1,+6,+5,+1,76%,79%,71%,158,178,123,30%,32%,26%,9,7,2,3,2,1
308,https://vlr.gg/player/20271/vorwenn,2025-02-02 11:00:00,1.22,0.96,1.12,171,174,161,23,16,7,17,8,9,10,1,9,+4,+3,+1,76%,83%,64%,107,105,110,32%,38%,23%,5,3,2,1,0,1
309,https://vlr.gg/player/7220/saiz,2025-02-02 11:00:00,1.01,0.47,0.79,143,194,56,18,16,2,24,15,9,7,6,1,0,+2,-2,74%,79%,64%,100,133,44,31%,33%,23%,3,3,0,3,1,2
310,https://vlr.gg/player/33994/creamydreamy,2025-02-02 11:00:00,1.05,1.20,1.12,261,249,279,108,58,50,94,54,40,32,18,14,+12,+10,+2,73%,77%,67%,168,163,175,33%,34%,31%,23,12,11,11,2,9
311,https://vlr.gg/player/5477/leon,2025-02-02 11:00:00,1.00,1.17,1.08,192,195,198,80,43,37,76,43,33,38,20,18,0,+2,-2,70%,69%,71%,130,130,129,29%,32%,25%,8,7,1,8,5,3
312,https://vlr.gg/player/12519/ticey,2025-02-02 11:00:00,1.00,0.99,1.00,212,208,230,90,50,40,89,48,41,21,12,9,-9,-6,-3,65%,66%,63%,144,139,149,16%,21%,10%,12,6,6,21,12,9
313,https://vlr.gg/player/2540/happen,2025-02-02 11:00:00,1.03,0.74,0.90,177,203,158,74,46,28,87,46,41,33,19,14,-2,-2,0,62%,65%,60%,128,143,108,24%,22%,29%,7,3,4,9,5,4
314,https://vlr.gg/player/13238/shiio,2025-02-02 11:00:00,0.87,0.84,0.86,152,156,158,64,35,29,81,44,37,48,33,15,-1,0,-1,66%,74%,56%,98,95,102,25%,22%,28%,8,6,2,9,6,3
315,https://vlr.gg/player/7987/kovaq,2025-02-02 11:00:00,1.27,1.28,1.28,258,263,252,112,52,60,78,34,44,12,2,10,-5,0,-5,65%,65%,65%,164,163,164,37%,36%,38%,11,6,5,16,6,10
316,https://vlr.gg/player/12593/felix,2025-02-02 11:00:00,1.19,0.83,0.99,183,223,164,73,41,32,80,36,44,43,17,26,+7,+6,+1,70%,71%,69%,131,145,121,28%,30%,26%,10,7,3,3,1,2
317,https://vlr.gg/player/122/luckerrr,2025-02-02 11:00:00,0.62,1.22,0.95,222,145,266,87,26,61,87,38,49,16,7,9,+4,0,+4,63%,58%,68%,130,98,156,24%,22%,25%,22,9,13,18,9,9
318,https://vlr.gg/player/7968/stavinci,2025-02-02 11:00:00,0.90,0.96,0.93,173,188,164,79,38,41,80,38,42,36,13,23,-6,-3,-3,68%,73%,65%,122,133,112,30%,31%,29%,3,1,2,9,4,5
319,https://vlr.gg/player/20302/jini,2025-02-02 11:00:00,0.85,0.83,0.84,194,182,189,76,35,41,92,39,53,31,12,19,0,0,0,70%,65%,74%,122,116,127,20%,18%,21%,13,5,8,13,5,8
320,https://vlr.gg/player/10114/baha,2025-02-02 10:40:00,2.16,1.18,1.65,346,437,263,30,17,13,15,6,9,5,3,2,-1,0,-1,78%,91%,67%,219,265,177,43%,48%,36%,2,0,2,3,0,3
321,https://vlr.gg/player/11516/drky,2025-02-02 10:40:00,1.53,1.21,1.36,234,276,197,17,11,6,13,6,7,10,4,6,+1,+1,0,74%,91%,58%,159,168,151,12%,19%,7%,1,1,0,0,0,0
322,https://vlr.gg/player/21584/deminatix,2025-02-02 10:40:00,0.89,0.86,0.87,197,188,207,16,7,9,17,8,9,4,4,0,+2,0,+2,65%,73%,58%,128,116,139,30%,28%,33%,7,4,3,5,4,1
323,https://vlr.gg/player/16483/gloomy,2025-02-02 10:40:00,0.60,0.97,0.79,153,111,192,11,5,6,15,7,8,12,2,10,-2,-2,0,83%,73%,92%,101,80,121,21%,31%,16%,1,0,1,3,2,1
324,https://vlr.gg/player/12226/sturnn,2025-02-02 10:40:00,0.90,0.55,0.72,109,124,96,10,7,3,14,5,9,5,0,5,-1,0,-1,65%,82%,50%,70,85,57,42%,50%,33%,0,0,0,1,0,1
325,https://vlr.gg/player/40843/audaz,2025-02-02 10:40:00,1.53,1.51,1.52,303,233,381,25,11,14,16,6,10,6,5,1,+3,-1,+4,74%,67%,82%,192,135,255,38%,32%,42%,4,0,4,1,1,0
326,https://vlr.gg/player/16552/pckwn,2025-02-02 10:40:00,0.96,1.00,0.98,198,205,191,14,7,7,16,8,8,7,6,1,0,0,0,70%,75%,64%,125,118,133,16%,13%,22%,2,1,1,2,1,1
327,https://vlr.gg/player/4962/lurzy0y0,2025-02-02 10:40:00,1.28,0.25,0.79,151,212,85,10,8,2,16,6,10,10,6,4,+2,+2,0,65%,75%,55%,106,139,71,29%,30%,25%,2,2,0,0,0,0
328,https://vlr.gg/player/31855/celasun,2025-02-02 10:40:00,1.09,0.36,0.74,150,183,116,12,8,4,17,7,10,4,0,4,+1,+1,0,61%,75%,45%,99,114,83,27%,27%,27%,2,1,1,1,0,1
329,https://vlr.gg/player/39357/s0pp,2025-02-02 10:40:00,0.57,0.37,0.47,140,175,103,13,8,5,19,10,9,1,1,0,-5,-2,-3,43%,50%,36%,81,94,67,7%,4%,14%,2,2,0,7,4,3
330,https://vlr.gg/player/2894/kiles,2025-02-02 10:00:00,1.14,0.95,1.05,207,237,176,35,21,14,29,16,13,5,3,2,-1,-1,0,78%,79%,76%,136,150,120,43%,44%,43%,2,2,0,3,3,0
331,https://vlr.gg/player/2700/jas,2025-02-02 10:00:00,0.60,1.51,1.02,234,172,310,39,14,25,34,20,14,3,3,0,+5,-3,+8,56%,46%,67%,142,123,163,33%,38%,29%,13,4,9,8,7,1
332,https://vlr.gg/player/1369/doma,2025-02-02 10:00:00,1.02,0.84,0.94,154,172,128,25,15,10,28,15,13,5,1,4,+2,+2,0,62%,71%,52%,111,127,92,20%,24%,16%,2,2,0,0,0,0
333,https://vlr.gg/player/1616/starki,2025-02-02 10:00:00,0.99,0.73,0.87,166,175,157,26,15,11,30,16,14,11,7,4,-3,0,-3,73%,71%,76%,115,123,106,41%,42%,39%,2,1,1,5,1,4
334,https://vlr.gg/player/562/zeek,2025-02-02 10:00:00,0.78,0.91,0.84,173,172,176,24,14,10,30,16,14,16,5,11,0,0,0,67%,63%,71%,112,117,106,25%,28%,22%,5,2,3,5,2,3
335,https://vlr.gg/player/25906/alexiiik,2025-02-02 10:00:00,0.80,1.58,1.21,247,189,295,42,15,27,32,17,15,5,2,3,+6,0,+6,67%,52%,79%,148,108,184,25%,26%,24%,13,6,7,7,6,1
336,https://vlr.gg/player/4537/tajrex,2025-02-02 10:00:00,1.29,1.11,1.20,235,226,235,38,18,20,30,12,18,16,9,7,-3,-3,0,58%,52%,63%,146,145,147,32%,27%,37%,4,1,3,7,4,3
337,https://vlr.gg/player/8593/grmekista,2025-02-02 10:00:00,0.97,1.22,1.11,177,159,195,27,11,16,26,13,13,19,11,8,-1,-1,0,71%,62%,79%,124,100,145,27%,42%,22%,1,0,1,2,1,1
338,https://vlr.gg/player/3839/prti,2025-02-02 10:00:00,0.93,0.70,0.81,152,169,140,23,12,11,32,14,18,8,3,5,-2,0,-2,64%,71%,58%,105,116,96,27%,32%,23%,1,0,1,3,0,3
339,https://vlr.gg/player/37840/msh,2025-02-02 10:00:00,0.84,0.61,0.71,125,148,104,21,12,9,29,14,15,7,3,4,-3,-1,-2,64%,62%,67%,93,111,78,28%,35%,21%,2,1,1,5,2,3
340,https://vlr.gg/player/569/paura,2025-02-02 09:30:00,0.87,1.42,1.17,274,220,321,21,8,13,17,8,9,2,0,2,-1,0,-1,68%,70%,67%,176,127,218,55%,89%,45%,2,1,1,3,1,2
341,https://vlr.gg/player/568/turko,2025-02-02 09:30:00,1.59,0.52,1.01,229,326,148,16,10,6,16,6,10,5,2,3,+1,0,+1,68%,80%,58%,148,219,88,28%,41%,11%,1,0,1,0,0,0
342,https://vlr.gg/player/10146/reazy,2025-02-02 09:30:00,0.89,0.87,0.88,185,149,216,12,5,7,16,6,10,7,1,6,+1,0,+1,77%,60%,92%,127,98,151,31%,27%,33%,1,0,1,0,0,0
343,https://vlr.gg/player/50775/lava,2025-02-02 09:30:00,1.07,0.50,0.76,177,230,133,15,9,6,17,7,10,1,0,1,+1,0,+1,68%,70%,67%,115,151,85,20%,26%,9%,3,1,2,2,1,1
344,https://vlr.gg/player/3862/deepmans,2025-02-02 09:30:00,0.07,1.21,0.69,185,97,260,15,3,12,18,9,9,0,0,0,-4,-6,+2,59%,40%,75%,111,64,151,24%,33%,21%,3,0,3,7,6,1
345,https://vlr.gg/player/33551/slaughter,2025-02-02 09:30:00,1.17,1.85,1.48,265,181,368,21,8,13,13,7,6,9,5,4,+2,0,+2,91%,92%,90%,163,120,213,32%,26%,37%,2,0,2,0,0,0
346,https://vlr.gg/player/31307/yigox,2025-02-02 09:30:00,1.81,0.58,1.25,215,288,129,16,12,4,13,6,7,11,7,4,+2,+1,+1,86%,92%,80%,149,205,82,36%,38%,31%,2,1,1,0,0,0
347,https://vlr.gg/player/18655/best,2025-02-02 09:30:00,0.66,1.58,1.08,254,207,311,21,10,11,19,12,7,0,0,0,+1,-2,+3,68%,58%,80%,159,118,207,32%,29%,35%,7,3,4,6,5,1
348,https://vlr.gg/player/15735/krostaly,2025-02-02 09:30:00,1.24,0.83,1.05,233,259,203,18,11,7,17,9,8,7,5,2,-1,-2,+1,77%,92%,60%,153,172,129,25%,27%,24%,1,0,1,2,2,0
349,https://vlr.gg/player/40842/ibonata,2025-02-02 09:30:00,0.76,0.27,0.54,115,175,45,8,7,1,17,10,7,11,8,3,-2,-1,-1,64%,67%,60%,73,110,29,24%,29%,13%,0,0,0,2,1,1
350,https://vlr.gg/player/2489/munchkin,2025-02-02 06:00:00,1.55,1.16,1.36,235,264,207,31,17,14,18,9,9,15,9,6,+4,+2,+2,76%,84%,68%,149,164,134,33%,33%,34%,7,3,4,3,1,2
351,https://vlr.gg/player/11600/foxy9,2025-02-02 06:00:00,1.13,1.23,1.18,199,186,213,28,12,16,20,9,11,7,3,4,-3,0,-3,71%,68%,74%,143,120,166,41%,34%,46%,1,1,0,4,1,3
352,https://vlr.gg/player/25081/yoman,2025-02-02 06:00:00,1.32,1.03,1.17,182,231,132,26,16,10,17,9,8,9,3,6,+1,0,+1,79%,89%,68%,112,145,78,41%,41%,41%,1,0,1,0,0,0
353,https://vlr.gg/player/34974/karon,2025-02-02 06:00:00,1.17,1.12,1.15,198,198,198,30,16,14,23,11,12,14,4,10,-4,-4,0,74%,74%,74%,143,152,134,47%,47%,47%,0,0,0,4,4,0
354,https://vlr.gg/player/9196/t3xture,2025-02-02 06:00:00,0.87,1.13,1.00,219,188,250,30,13,17,24,11,13,5,1,4,+2,-1,+3,68%,58%,79%,136,114,159,28%,19%,35%,10,4,6,8,5,3
355,https://vlr.gg/player/13002/akame,2025-02-02 06:00:00,0.89,1.15,1.02,212,178,246,27,12,15,29,14,15,8,2,6,+4,+2,+2,68%,68%,68%,144,108,180,22%,11%,30%,5,2,3,1,0,1
356,https://vlr.gg/player/6672/meiy,2025-02-02 06:00:00,1.19,0.53,0.86,183,250,117,22,15,7,29,14,15,4,2,2,-1,0,-1,58%,63%,53%,121,165,78,21%,22%,18%,6,4,2,7,4,3
357,https://vlr.gg/player/10627/art,2025-02-02 06:00:00,0.67,0.94,0.81,173,125,222,19,7,12,30,14,16,14,5,9,+1,-4,+5,66%,68%,63%,112,83,142,14%,13%,14%,6,1,5,5,5,0
358,https://vlr.gg/player/4052/jinboong,2025-02-02 06:00:00,0.80,0.61,0.70,123,124,122,16,8,8,28,13,15,13,7,6,-2,0,-2,61%,68%,53%,76,83,70,38%,37%,40%,2,1,1,4,1,3
359,https://vlr.gg/player/48577/gyen,2025-02-02 06:00:00,0.64,0.70,0.67,129,158,100,18,11,7,29,16,13,8,3,5,-2,-1,-1,61%,58%,63%,76,87,65,24%,25%,22%,0,0,0,2,1,1
360,https://vlr.gg/player/25255/primmie,2025-02-02 03:00:00,1.31,1.59,1.46,267,233,284,64,28,36,37,17,20,17,9,8,-3,-2,-1,81%,77%,85%,177,162,191,41%,36%,45%,2,1,1,5,3,2
361,https://vlr.gg/player/13788/jitboys,2025-02-02 03:00:00,1.48,1.26,1.36,225,235,213,53,27,26,34,17,17,21,13,8,+5,+3,+2,76%,77%,76%,146,164,129,29%,35%,25%,7,4,3,2,1,1
362,https://vlr.gg/player/3977/crws,2025-02-02 03:00:00,1.00,0.91,0.95,183,197,182,41,20,21,42,19,23,25,16,9,0,+1,-1,79%,87%,73%,113,117,109,25%,22%,28%,6,3,3,6,2,4
363,https://vlr.gg/player/3980/governor,2025-02-02 03:00:00,0.91,0.69,0.79,184,183,174,36,17,19,47,21,26,13,6,7,-3,+2,-5,71%,80%,64%,118,123,113,14%,16%,12%,10,6,4,13,4,9
364,https://vlr.gg/player/5129/ban,2025-02-02 03:00:00,0.81,0.61,0.71,153,168,146,33,18,15,45,21,24,16,8,8,-4,-2,-2,68%,60%,76%,100,111,91,28%,25%,31%,4,2,2,8,4,4
365,https://vlr.gg/player/31829/ivy,2025-02-02 03:00:00,1.04,1.01,1.03,176,172,185,42,21,21,40,20,20,22,10,12,+2,+2,0,76%,85%,67%,111,114,109,37%,43%,31%,3,2,1,1,0,1
366,https://vlr.gg/player/4122/persia,2025-02-02 03:00:00,0.89,1.11,0.99,189,160,222,41,18,23,43,22,21,24,15,9,-1,+2,-3,76%,79%,73%,121,100,143,27%,36%,22%,5,3,2,6,1,5
367,https://vlr.gg/player/31828/francis,2025-02-02 03:00:00,0.95,0.91,0.93,198,199,201,41,22,19,47,24,23,17,11,6,-3,-1,-2,67%,70%,63%,136,135,138,24%,23%,25%,4,2,2,7,3,4
368,https://vlr.gg/player/31827/dambi,2025-02-02 03:00:00,1.03,0.75,0.89,217,233,198,43,26,17,51,26,25,21,9,12,+2,0,+2,68%,70%,67%,142,141,142,25%,25%,24%,11,6,5,9,6,3
369,https://vlr.gg/player/33576/margaret,2025-02-02 03:00:00,0.92,0.85,0.89,170,194,152,37,22,15,46,25,21,18,9,9,+5,+4,+1,73%,76%,70%,120,130,110,25%,25%,25%,11,7,4,6,3,3
370,https://vlr.gg/player/5132/mada,2025-02-01 19:30:00,1.17,1.44,1.29,283,276,301,64,34,30,44,27,17,12,9,3,-2,-6,+4,73%,64%,86%,177,171,186,28%,23%,36%,10,5,5,12,11,1
371,https://vlr.gg/player/11225/ethan,2025-02-01 19:30:00,1.34,1.08,1.23,234,264,207,51,32,19,46,27,19,34,18,16,+1,0,+1,73%,72%,75%,153,175,126,26%,27%,26%,5,2,3,4,2,2
372,https://vlr.gg/player/4164/s0m,2025-02-01 19:30:00,0.70,1.17,0.91,193,142,253,42,18,24,47,29,18,25,17,8,-2,-1,-1,78%,69%,89%,128,88,178,27%,40%,21%,3,3,0,5,4,1
373,https://vlr.gg/player/21668/verno,2025-02-01 19:30:00,0.71,0.78,0.74,135,132,140,29,15,14,46,29,17,16,12,4,-5,-2,-3,69%,72%,64%,94,96,91,27%,26%,29%,2,0,2,7,2,5
374,https://vlr.gg/player/817/finesse,2025-02-01 19:30:00,0.40,0.56,0.47,110,94,128,20,9,11,51,29,22,16,9,7,-6,-5,-1,55%,53%,57%,75,71,80,17%,15%,19%,5,1,4,11,6,5
375,https://vlr.gg/player/1311/melser,2025-02-01 19:30:00,1.16,1.20,1.18,188,196,185,48,20,28,34,17,17,21,8,13,+3,0,+3,80%,75%,83%,122,138,110,33%,42%,26%,6,2,4,3,2,1
376,https://vlr.gg/player/3826/adverso,2025-02-01 19:30:00,0.90,1.23,1.09,208,161,240,48,16,32,40,18,22,20,6,14,+4,+2,+2,73%,68%,78%,135,110,154,16%,24%,13%,7,3,4,3,1,2
377,https://vlr.gg/player/24007/shyy,2025-02-01 19:30:00,1.17,1.00,1.07,205,236,177,48,25,23,42,21,21,11,3,8,+4,-2,+6,72%,68%,75%,129,149,114,29%,31%,26%,7,0,7,3,2,1
378,https://vlr.gg/player/2462/keznit,2025-02-01 19:30:00,0.72,1.23,1.01,207,161,240,45,16,29,43,21,22,12,2,10,+2,-1,+3,73%,75%,72%,138,100,168,28%,40%,22%,11,4,7,9,5,4
379,https://vlr.gg/player/7603/mazino,2025-02-01 19:30:00,0.82,1.03,0.94,195,166,224,45,16,29,47,21,26,28,16,12,+1,+1,0,72%,71%,72%,126,97,148,28%,17%,34%,8,5,3,7,4,3
380,https://vlr.gg/player/826/supamen,2025-02-01 17:00:00,1.13,1.15,1.14,227,241,235,34,21,13,31,21,10,5,4,1,-1,-2,+1,62%,54%,73%,156,162,146,38%,40%,36%,3,1,2,4,3,1
381,https://vlr.gg/player/881/yay,2025-02-01 17:00:00,0.40,1.16,0.69,171,115,254,22,8,14,33,21,12,4,3,1,-3,-7,+4,49%,38%,67%,110,78,163,37%,36%,38%,4,0,4,7,7,0
382,https://vlr.gg/player/1533/derrek,2025-02-01 17:00:00,0.60,0.76,0.66,159,158,178,22,13,9,33,21,12,10,5,5,+1,0,+1,64%,63%,67%,107,90,134,40%,36%,45%,1,0,1,0,0,0
383,https://vlr.gg/player/8402/icy,2025-02-01 17:00:00,0.80,0.41,0.65,181,222,101,23,18,5,34,23,11,4,4,0,-3,-3,0,56%,58%,53%,112,142,63,20%,22%,14%,6,3,3,9,6,3
384,https://vlr.gg/player/4927/nature,2025-02-01 17:00:00,0.55,0.78,0.64,134,139,131,15,10,5,31,21,10,14,6,8,-5,-4,-1,62%,54%,73%,90,91,89,24%,19%,33%,0,0,0,5,4,1
385,https://vlr.gg/player/8480/aspas,2025-02-01 17:00:00,1.65,1.19,1.36,257,281,256,38,16,22,22,6,16,7,4,3,+7,+1,+6,90%,93%,88%,160,168,155,14%,18%,10%,10,3,7,3,2,1
386,https://vlr.gg/player/20240/xenom,2025-02-01 17:00:00,1.29,1.30,1.30,204,218,204,27,10,17,23,9,14,26,9,17,0,-1,+1,90%,80%,96%,131,138,127,26%,20%,32%,2,1,1,2,2,0
387,https://vlr.gg/player/5395/cortezia,2025-02-01 17:00:00,0.88,1.33,1.16,247,184,278,35,11,24,25,10,15,7,1,6,+3,-2,+5,79%,60%,92%,160,118,186,42%,50%,40%,6,0,6,3,2,1
388,https://vlr.gg/player/725/nzr,2025-02-01 17:00:00,0.95,1.27,1.15,196,157,203,26,8,18,21,9,12,15,6,9,+2,-1,+3,79%,73%,83%,139,112,155,24%,21%,26%,3,0,3,1,1,0
389,https://vlr.gg/player/5957/artzin,2025-02-01 17:00:00,0.89,1.28,1.13,254,198,272,36,10,26,27,13,14,11,5,6,-1,-2,+1,85%,87%,83%,146,128,157,15%,19%,13%,4,1,3,5,3,2
390,https://vlr.gg/player/2658/xuss,2025-02-01 14:00:00,1.07,1.54,1.35,278,200,311,41,13,28,22,10,12,2,2,0,+10,+1,+9,83%,75%,88%,162,109,197,24%,20%,26%,15,4,11,5,3,2
391,https://vlr.gg/player/4244/yaboilewis,2025-02-01 14:00:00,1.37,1.00,1.15,193,181,193,27,10,17,18,6,12,11,7,4,+1,-1,+2,80%,81%,79%,135,115,148,33%,31%,34%,2,0,2,1,1,0
392,https://vlr.gg/player/1457/mistic,2025-02-01 14:00:00,1.28,1.05,1.14,222,216,219,33,12,21,21,8,13,17,9,8,+1,0,+1,93%,94%,92%,157,158,157,25%,28%,23%,1,0,1,0,0,0
393,https://vlr.gg/player/2690/hoody,2025-02-01 14:00:00,1.47,0.91,1.14,178,213,156,26,13,13,21,6,15,15,2,13,+3,+2,+1,80%,75%,83%,114,133,101,20%,26%,15%,5,2,3,2,0,2
394,https://vlr.gg/player/5292/al0rante,2025-02-01 14:00:00,1.14,1.12,1.13,246,268,230,37,17,20,25,11,14,8,3,5,+3,+2,+1,80%,75%,83%,172,179,168,43%,50%,38%,6,4,2,3,2,1
395,https://vlr.gg/player/39062/terrox,2025-02-01 14:00:00,1.16,0.69,0.97,176,196,151,25,17,8,31,18,13,4,3,1,-2,-4,+2,58%,63%,50%,124,137,105,21%,21%,22%,3,1,2,5,5,0
396,https://vlr.gg/player/27954/movi,2025-02-01 14:00:00,0.87,1.11,0.97,183,160,232,24,12,12,31,17,14,9,6,3,+1,-1,+2,60%,54%,69%,132,117,155,25%,26%,24%,2,0,2,1,1,0
397,https://vlr.gg/player/15382/kongi,2025-02-01 14:00:00,0.92,0.59,0.79,142,167,106,19,14,5,34,22,12,15,9,6,-1,+1,-2,58%,63%,50%,89,100,73,28%,27%,31%,2,2,0,3,1,2
398,https://vlr.gg/player/12514/spocki,2025-02-01 14:00:00,0.79,0.45,0.64,126,138,117,17,11,6,33,20,13,14,12,2,-5,-4,-1,53%,58%,44%,84,85,81,40%,42%,35%,2,1,1,7,5,2
399,https://vlr.gg/player/27813/zery,2025-02-01 14:00:00,0.49,0.77,0.61,159,152,199,22,12,10,35,22,13,7,5,2,-11,-6,-5,58%,58%,56%,117,105,135,28%,24%,33%,2,1,1,13,7,6
400,https://vlr.gg/player/40935/umu7,2025-02-01 13:45:00,1.42,0.90,1.16,234,277,193,21,13,8,19,9,10,5,0,5,-3,-1,-2,83%,75%,92%,146,177,115,39%,60%,23%,0,0,0,3,1,2
401,https://vlr.gg/player/3557/skylen,2025-02-01 13:45:00,0.71,1.37,1.04,198,142,255,16,5,11,17,9,8,6,2,4,+2,+1,+1,58%,42%,75%,133,101,166,41%,42%,41%,2,1,1,0,0,0
402,https://vlr.gg/player/22676/ventt,2025-02-01 13:45:00,1.00,0.87,0.93,174,204,146,15,9,6,18,10,8,12,5,7,-4,-1,-3,71%,67%,75%,118,130,106,19%,40%,6%,1,1,0,5,2,3
403,https://vlr.gg/player/10137/ip0tt,2025-02-01 13:45:00,0.64,0.67,0.65,160,167,154,13,6,7,21,10,11,3,2,1,+2,+2,0,58%,58%,58%,101,97,105,22%,21%,24%,6,4,2,4,2,2
404,https://vlr.gg/player/5510/oxmann,2025-02-01 13:45:00,0.36,0.84,0.60,130,108,153,11,5,6,19,11,8,3,0,3,+1,-1,+2,63%,42%,83%,100,88,112,37%,42%,33%,2,0,2,1,1,0
405,https://vlr.gg/player/10160/izzy,2025-02-01 13:45:00,1.44,1.49,1.47,323,358,290,26,15,11,17,9,8,8,2,6,+7,+3,+4,79%,75%,83%,226,230,222,22%,31%,9%,9,5,4,2,2,0
406,https://vlr.gg/player/12774/anima,2025-02-01 13:45:00,1.47,1.19,1.33,271,279,264,21,11,10,15,6,9,7,3,4,0,0,0,75%,83%,67%,178,184,173,21%,43%,10%,2,1,1,2,1,1
407,https://vlr.gg/player/10161/qutionerx,2025-02-01 13:45:00,0.83,1.55,1.19,236,158,315,20,6,14,15,8,7,12,6,6,-2,0,-2,88%,83%,92%,172,119,225,35%,32%,36%,0,0,0,2,0,2
408,https://vlr.gg/player/10163/cyderx,2025-02-01 13:45:00,1.06,0.96,1.01,181,176,187,16,8,8,15,7,8,7,1,6,-2,0,-2,83%,83%,83%,117,118,117,41%,46%,36%,1,0,1,3,0,3
409,https://vlr.gg/player/8041/brave,2025-02-01 13:45:00,0.58,1.00,0.79,134,114,156,11,5,6,14,8,6,10,2,8,-1,-1,0,75%,67%,83%,86,75,96,40%,27%,53%,1,1,0,2,2,0
410,https://vlr.gg/player/22617/vitie,2025-02-01 13:45:00,1.39,1.21,1.29,226,249,193,36,19,17,26,12,14,16,7,9,+3,+1,+2,82%,85%,80%,142,174,117,33%,34%,31%,6,2,4,3,1,2
411,https://vlr.gg/player/7106/diseased,2025-02-01 13:45:00,1.62,1.03,1.29,209,232,190,34,18,16,22,7,15,11,3,8,+3,+1,+2,71%,75%,68%,130,148,116,22%,23%,21%,5,2,3,2,1,1
412,https://vlr.gg/player/252/d3ffo,2025-02-01 13:45:00,1.39,1.16,1.26,241,263,214,39,20,19,27,12,15,7,2,5,-2,0,-2,78%,75%,80%,147,166,132,28%,36%,21%,3,2,1,5,2,3
413,https://vlr.gg/player/30901/ianto,2025-02-01 13:45:00,1.23,1.26,1.24,244,224,248,37,16,21,28,13,15,14,5,9,+1,+3,-2,82%,85%,80%,166,152,177,24%,25%,23%,6,5,1,5,2,3
414,https://vlr.gg/player/23098/aphun,2025-02-01 13:45:00,0.81,0.88,0.85,157,140,190,24,8,16,31,13,18,10,7,3,-4,-1,-3,73%,90%,60%,117,98,132,26%,32%,23%,3,1,2,7,2,5
415,https://vlr.gg/player/12372/szoren,2025-02-01 13:45:00,1.37,0.41,0.95,194,246,134,31,22,9,33,15,18,13,7,6,-2,0,-2,60%,68%,50%,127,160,85,28%,35%,15%,2,1,1,4,1,3
416,https://vlr.gg/player/5566/jeyj7y,2025-02-01 13:45:00,0.99,0.67,0.85,166,165,184,27,15,12,34,17,17,9,6,3,-3,-1,-2,56%,60%,50%,126,126,126,22%,22%,23%,1,0,1,4,1,3
417,https://vlr.gg/player/31298/luca,2025-02-01 13:45:00,0.97,0.61,0.81,141,156,120,22,14,8,30,15,15,14,10,4,+1,0,+1,62%,60%,65%,85,85,86,25%,32%,19%,1,0,1,0,0,0
418,https://vlr.gg/player/4214/eso177,2025-02-01 13:45:00,0.49,1.09,0.76,161,130,220,25,9,16,34,20,14,7,6,1,+2,+3,-1,62%,60%,65%,114,85,151,27%,19%,33%,8,5,3,6,2,4
419,https://vlr.gg/player/34002/lukey,2025-02-01 13:45:00,0.60,0.66,0.63,204,202,195,29,17,12,39,22,17,7,3,4,+1,+1,0,62%,56%,70%,128,123,134,22%,25%,20%,10,8,2,9,7,2
420,https://vlr.gg/player/19776/jrayn,2025-02-01 12:45:00,1.40,2.54,1.63,217,191,323,13,9,4,5,5,0,10,10,0,+1,+1,0,93%,92%,100%,133,120,186,28%,25%,38%,1,1,0,0,0,0
421,https://vlr.gg/player/10152/padisah,2025-02-01 12:45:00,1.11,2.63,1.41,265,229,411,15,10,5,9,9,0,5,3,2,-3,-3,0,93%,92%,100%,181,155,281,23%,27%,15%,0,0,0,3,3,0
422,https://vlr.gg/player/10883/baransel,2025-02-01 12:45:00,1.57,0.28,1.32,311,379,42,16,16,0,12,10,2,10,8,2,0,0,0,87%,92%,67%,212,255,42,26%,28%,0%,1,1,0,1,1,0
423,https://vlr.gg/player/3549/touven,2025-02-01 12:45:00,1.18,1.51,1.25,174,169,193,10,8,2,7,6,1,13,9,4,-3,-2,-1,87%,92%,67%,114,115,111,26%,28%,22%,0,0,0,3,2,1
424,https://vlr.gg/player/13545/werlass,2025-02-01 12:45:00,1.00,2.09,1.22,277,257,361,14,10,4,10,9,1,8,5,3,+2,0,+2,73%,67%,100%,168,161,197,21%,29%,0%,4,2,2,2,2,0
425,https://vlr.gg/player/31855/celasun,2025-02-01 12:45:00,0.14,1.18,0.97,241,88,279,12,1,11,15,3,12,5,0,5,0,0,0,67%,33%,75%,142,57,164,26%,33%,25%,0,0,0,0,0,0
426,https://vlr.gg/player/16552/pckwn,2025-02-01 12:45:00,0.67,0.86,0.82,198,142,213,9,2,7,14,3,11,11,0,11,+2,0,+2,87%,67%,92%,126,100,132,25%,100%,19%,2,0,2,0,0,0
427,https://vlr.gg/player/40843/audaz,2025-02-01 12:45:00,0.59,0.72,0.69,175,145,183,9,1,8,13,3,10,2,0,2,+2,+1,+1,67%,33%,75%,118,98,123,36%,20%,41%,3,1,2,1,0,1
428,https://vlr.gg/player/4962/lurzy0y0,2025-02-01 12:45:00,0.02,0.75,0.59,142,49,166,7,0,7,13,3,10,1,0,1,-2,0,-2,33%,,42%,99,49,111,45%,40%,47%,0,0,0,2,0,2
429,https://vlr.gg/player/39357/s0pp,2025-02-01 12:45:00,0.02,0.71,0.54,145,47,171,6,0,6,13,3,10,2,1,1,+1,-2,+3,60%,33%,67%,102,47,116,24%,0%,29%,4,0,4,3,2,1
430,https://vlr.gg/player/12774/anima,2025-02-01 11:30:00,0.95,1.29,1.12,175,159,193,16,7,9,14,8,6,6,1,5,-1,-1,0,75%,58%,92%,131,99,163,20%,21%,20%,0,0,0,1,1,0
431,https://vlr.gg/player/10160/izzy,2025-02-01 11:30:00,0.55,1.45,1.00,240,182,299,20,7,13,19,12,7,0,0,0,+3,-1,+4,63%,50%,75%,140,118,163,28%,32%,24%,6,1,5,3,2,1
432,https://vlr.gg/player/10161/qutionerx,2025-02-01 11:30:00,0.45,1.48,0.96,187,97,279,17,4,13,17,10,7,12,4,8,0,-2,+2,71%,58%,83%,115,61,169,32%,31%,32%,3,1,2,3,3,0
433,https://vlr.gg/player/10163/cyderx,2025-02-01 11:30:00,0.34,1.36,0.85,164,92,236,14,4,10,17,11,6,7,2,5,0,0,0,63%,50%,75%,124,64,185,35%,36%,35%,2,1,1,2,1,1
434,https://vlr.gg/player/8041/brave,2025-02-01 11:30:00,0.52,0.65,0.59,115,134,97,9,5,4,17,11,6,6,2,4,-4,-2,-2,54%,50%,58%,85,92,78,25%,29%,20%,0,0,0,4,2,2
435,https://vlr.gg/player/10114/baha,2025-02-01 11:30:00,1.30,1.99,1.65,317,248,388,28,10,18,14,9,5,10,6,4,-1,-1,0,83%,67%,100%,199,156,243,39%,35%,42%,3,2,1,4,3,1
436,https://vlr.gg/player/12226/sturnn,2025-02-01 11:30:00,0.91,1.45,1.18,239,195,284,20,8,12,16,9,7,4,1,3,+2,0,+2,79%,75%,83%,147,121,173,19%,22%,17%,3,1,2,1,1,0
437,https://vlr.gg/player/21584/deminatix,2025-02-01 11:30:00,0.43,1.64,1.04,205,161,251,17,6,11,15,11,4,7,3,4,+1,0,+1,75%,67%,83%,123,93,154,22%,23%,22%,3,1,2,2,1,1
438,https://vlr.gg/player/11516/drky,2025-02-01 11:30:00,0.93,0.76,0.85,118,157,79,8,5,3,14,9,5,5,1,4,-1,-1,0,83%,67%,100%,86,113,60,24%,22%,30%,0,0,0,1,1,0
439,https://vlr.gg/player/16483/gloomy,2025-02-01 11:30:00,0.36,1.06,0.71,141,81,201,11,3,8,17,11,6,10,5,5,+1,-2,+3,63%,50%,75%,81,49,114,14%,22%,11%,4,0,4,3,2,1
440,https://vlr.gg/player/14612/lux9,2025-02-01 11:00:00,1.01,1.07,1.04,258,234,281,53,21,32,51,22,29,10,5,5,+5,-2,+7,67%,62%,71%,164,152,174,21%,30%,15%,17,6,11,12,8,4
441,https://vlr.gg/player/3563/babax,2025-02-01 11:00:00,1.04,1.01,1.02,201,231,180,44,24,20,43,21,22,16,5,11,+4,+1,+3,65%,55%,74%,133,152,118,28%,31%,25%,7,2,5,3,1,2
442,https://vlr.gg/player/2620/ooriime,2025-02-01 11:00:00,1.02,0.85,0.93,181,216,151,38,22,16,43,20,23,21,7,14,0,+2,-2,63%,62%,65%,122,149,98,33%,33%,34%,4,3,1,4,1,3
443,https://vlr.gg/player/2098/thebigfiz,2025-02-01 11:00:00,1.05,0.77,0.89,160,198,134,36,21,15,44,21,23,10,5,5,+2,0,+2,63%,62%,65%,117,132,105,21%,19%,24%,5,2,3,3,2,1
444,https://vlr.gg/player/16345/yayax,2025-02-01 11:00:00,0.13,0.73,0.46,112,65,155,25,6,19,51,25,26,9,6,3,-6,-2,-4,49%,45%,53%,80,45,109,38%,24%,48%,1,1,0,7,3,4
445,https://vlr.gg/player/26809/tenshi,2025-02-01 11:00:00,1.36,1.12,1.24,257,250,265,57,31,26,40,18,22,24,12,12,0,+1,-1,81%,79%,83%,161,157,166,36%,47%,29%,7,3,4,7,2,5
446,https://vlr.gg/player/39718/rouss,2025-02-01 11:00:00,1.16,1.13,1.14,218,219,217,49,27,22,41,22,19,13,7,6,+2,+2,0,70%,65%,76%,142,136,148,33%,28%,39%,9,6,3,7,4,3
447,https://vlr.gg/player/31058/kpro,2025-02-01 11:00:00,0.93,1.31,1.10,186,161,214,43,19,24,38,21,17,17,13,4,-5,-5,0,75%,68%,83%,120,110,132,36%,30%,43%,2,0,2,7,5,2
448,https://vlr.gg/player/5498/kipperman,2025-02-01 11:00:00,0.87,1.19,1.02,224,208,247,49,25,24,43,25,18,8,5,3,-3,-3,0,65%,68%,62%,154,137,173,27%,29%,26%,8,4,4,11,7,4
449,https://vlr.gg/player/26837/poegii,2025-02-01 11:00:00,1.13,0.86,1.01,159,173,145,34,21,13,34,16,18,17,9,8,+1,-1,+2,71%,74%,69%,118,119,117,30%,31%,28%,3,1,2,2,2,0
450,https://vlr.gg/player/10885/davih,2025-02-01 11:00:00,1.46,1.30,1.39,255,256,253,51,29,22,32,17,15,20,11,9,+4,+4,0,87%,87%,88%,160,167,152,31%,32%,30%,6,4,2,2,0,2
451,https://vlr.gg/player/4329/vince,2025-02-01 11:00:00,1.17,1.19,1.18,227,214,242,46,27,19,31,18,13,19,11,8,+1,-1,+2,75%,77%,71%,130,122,141,18%,23%,13%,4,0,4,3,1,2
452,https://vlr.gg/player/1835/elllement,2025-02-01 11:00:00,1.38,0.86,1.15,214,252,161,44,29,15,35,19,16,11,7,4,+2,+3,-1,73%,74%,71%,138,163,106,17%,23%,7%,8,6,2,6,3,3
453,https://vlr.gg/player/314/ambi,2025-02-01 11:00:00,0.91,1.15,1.01,190,152,241,36,17,19,38,20,18,24,12,12,-2,-1,-1,82%,81%,83%,124,95,162,22%,20%,23%,1,1,0,3,2,1
454,https://vlr.gg/player/9558/wolfen,2025-02-01 11:00:00,0.82,0.76,0.79,192,198,180,36,21,15,42,24,18,19,11,8,-8,-4,-4,67%,68%,67%,130,129,130,30%,26%,34%,7,5,2,15,9,6
455,https://vlr.gg/player/35513/samed,2025-02-01 11:00:00,1.13,1.05,1.08,245,256,241,47,21,26,45,20,25,12,6,6,+4,+1,+3,69%,71%,68%,165,167,164,23%,21%,26%,9,3,6,5,2,3
456,https://vlr.gg/player/45490/ico,2025-02-01 11:00:00,1.03,0.95,0.98,188,182,193,39,17,22,43,18,25,15,7,8,+1,0,+1,65%,63%,68%,126,121,130,43%,38%,48%,7,2,5,6,2,4
457,https://vlr.gg/player/4969/shazeon,2025-02-01 11:00:00,0.83,0.86,0.85,188,189,196,36,16,20,43,18,25,9,4,5,+2,+1,+1,62%,67%,58%,131,137,127,32%,39%,29%,6,3,3,4,2,2
458,https://vlr.gg/player/22180/spmak,2025-02-01 11:00:00,1.13,0.60,0.83,154,181,138,26,14,12,39,14,25,23,14,9,-3,+1,-4,62%,67%,58%,103,111,97,16%,28%,7%,4,3,1,7,2,5
459,https://vlr.gg/player/7865/xanarchy,2025-02-01 11:00:00,0.62,0.79,0.72,151,130,171,30,12,18,43,20,23,10,2,8,-1,+1,-2,65%,63%,68%,98,77,115,24%,24%,24%,3,3,0,4,2,2
460,https://vlr.gg/player/31305/lar0k,2025-02-01 10:30:00,0.96,2.11,1.62,271,171,346,20,5,15,11,7,4,19,9,10,-1,0,-1,90%,89%,92%,173,123,211,44%,18%,63%,0,0,0,1,0,1
461,https://vlr.gg/player/12795/crewen,2025-02-01 10:30:00,1.58,1.53,1.55,270,298,250,21,10,11,11,6,5,6,1,5,+1,0,+1,76%,78%,75%,183,216,159,33%,42%,26%,2,1,1,1,1,0
462,https://vlr.gg/player/40591/comeback,2025-02-01 10:30:00,1.49,0.65,1.01,219,364,112,17,12,5,15,8,7,2,1,1,0,+2,-2,67%,67%,67%,126,198,71,36%,43%,14%,3,3,0,3,1,2
463,https://vlr.gg/player/24344/loita,2025-02-01 10:30:00,0.74,0.89,0.83,149,115,176,11,3,8,14,6,8,7,3,4,-1,0,-1,76%,67%,83%,103,74,125,24%,18%,26%,1,0,1,2,0,2
464,https://vlr.gg/player/5565/ros,2025-02-01 10:30:00,0.20,1.05,0.68,154,56,229,10,1,9,15,7,8,3,3,0,-6,-3,-3,62%,56%,67%,97,35,144,27%,20%,29%,1,0,1,7,3,4
465,https://vlr.gg/player/18655/best,2025-02-01 10:30:00,1.69,1.21,1.48,361,411,295,27,17,10,16,9,7,2,0,2,+6,+3,+3,71%,75%,67%,203,219,182,33%,44%,22%,9,5,4,3,2,1
466,https://vlr.gg/player/15735/krostaly,2025-02-01 10:30:00,0.62,1.20,0.87,186,145,241,13,5,8,17,10,7,14,7,7,+2,+2,0,71%,67%,78%,111,87,143,24%,27%,23%,3,2,1,1,0,1
467,https://vlr.gg/player/40842/ibonata,2025-02-01 10:30:00,0.38,1.37,0.80,136,52,249,9,1,8,14,9,5,6,4,2,-1,0,-1,67%,50%,89%,92,39,162,10%,17%,8%,1,1,0,2,1,1
468,https://vlr.gg/player/33551/slaughter,2025-02-01 10:30:00,0.53,0.82,0.65,112,97,132,8,4,4,15,9,6,7,3,4,0,0,0,71%,58%,89%,79,80,78,35%,50%,23%,0,0,0,0,0,0
469,https://vlr.gg/player/31307/yigox,2025-02-01 10:30:00,0.56,0.70,0.62,128,121,139,9,5,4,17,11,6,4,1,3,0,+1,-1,62%,58%,67%,90,86,96,22%,16%,31%,1,1,0,1,0,1
470,https://vlr.gg/player/33732/nunmeister,2025-02-01 10:00:00,0.99,1.36,1.16,209,184,239,44,20,24,36,19,17,26,11,15,+1,+1,0,72%,69%,75%,139,119,161,27%,20%,35%,6,3,3,5,2,3
471,https://vlr.gg/player/6969/gunners,2025-02-01 10:00:00,1.21,0.73,0.99,178,223,128,39,27,12,39,21,18,15,7,8,+2,+2,0,70%,75%,64%,118,148,83,30%,33%,24%,3,2,1,1,0,1
472,https://vlr.gg/player/39682/wanzeru,2025-02-01 10:00:00,1.01,0.86,0.94,205,213,202,41,23,18,48,25,23,12,7,5,+3,+4,-1,70%,69%,71%,135,137,134,20%,16%,25%,10,9,1,7,5,2
473,https://vlr.gg/player/7231/kya,2025-02-01 10:00:00,0.72,1.00,0.85,173,128,229,38,15,23,45,22,23,3,1,2,0,-3,+3,57%,59%,54%,119,91,151,38%,31%,44%,5,1,4,5,4,1
474,https://vlr.gg/player/2832/patix,2025-02-01 10:00:00,0.42,0.57,0.49,111,90,137,23,10,13,51,27,24,16,9,7,-2,-2,0,65%,66%,64%,71,60,84,29%,30%,28%,8,2,6,10,4,6
475,https://vlr.gg/player/42702/krizz,2025-02-01 10:00:00,1.71,1.53,1.61,293,315,270,64,33,31,30,14,16,7,3,4,0,+2,-2,75%,79%,72%,200,212,189,25%,23%,26%,3,2,1,3,0,3
476,https://vlr.gg/player/9557/nefi,2025-02-01 10:00:00,1.39,0.94,1.16,155,186,126,21,14,7,16,7,9,22,6,16,-2,0,-2,87%,89%,85%,92,114,71,29%,33%,23%,1,1,0,3,1,2
477,https://vlr.gg/player/36748/czester,2025-02-01 10:00:00,0.62,1.50,1.09,214,144,273,45,14,31,38,20,18,25,13,12,0,-3,+3,78%,68%,88%,145,106,180,36%,26%,44%,9,3,6,9,6,3
478,https://vlr.gg/player/10448/kozok,2025-02-01 10:00:00,1.07,0.86,0.96,159,192,129,33,19,14,34,18,16,16,10,6,-2,-1,-1,67%,71%,63%,108,137,83,19%,17%,20%,4,2,2,6,3,3
479,https://vlr.gg/player/3780/vilczek,2025-02-01 10:00:00,0.93,0.72,0.81,171,157,181,13,5,8,18,7,11,8,5,3,0,-1,+1,76%,78%,75%,106,98,113,21%,11%,29%,3,0,3,3,1,2
480,https://vlr.gg/player/9556/demek,2025-02-01 10:00:00,0.80,0.79,0.79,204,219,192,43,20,23,49,24,25,11,5,6,0,+1,-1,78%,75%,81%,122,137,109,17%,25%,12%,8,5,3,8,4,4
481,https://vlr.gg/player/50776/influx,2025-02-01 09:30:00,1.24,0.84,1.08,258,258,259,16,9,7,15,8,7,2,2,0,0,0,0,70%,83%,50%,164,175,146,24%,26%,20%,3,1,2,3,1,2
482,https://vlr.gg/player/4894/jn3v1ce,2025-02-01 09:30:00,0.94,1.11,1.01,170,126,238,12,5,7,13,6,7,5,4,1,-1,0,-1,70%,75%,63%,107,78,149,39%,50%,33%,1,1,0,2,1,1
483,https://vlr.gg/player/40841/kabzi,2025-02-01 09:30:00,0.81,0.89,0.84,191,177,213,12,7,5,16,8,8,6,1,5,-1,0,-1,60%,58%,63%,119,121,117,30%,35%,25%,1,1,0,2,1,1
484,https://vlr.gg/player/5500/docent,2025-02-01 09:30:00,0.98,0.24,0.68,133,205,26,9,9,0,15,8,7,7,2,5,-1,0,-1,60%,67%,50%,78,123,10,19%,21%,0%,1,1,0,2,1,1
485,https://vlr.gg/player/13571/musz3kk,2025-02-01 09:30:00,0.60,0.35,0.50,128,156,87,8,6,2,16,9,7,3,2,1,-1,0,-1,50%,50%,50%,86,101,64,16%,19%,10%,2,2,0,3,2,1
486,https://vlr.gg/player/10125/qw1,2025-02-01 09:30:00,1.30,1.66,1.52,311,303,317,23,9,14,11,5,6,3,3,0,+6,+3,+3,80%,88%,75%,202,198,204,20%,17%,23%,7,4,3,1,1,0
487,https://vlr.gg/player/3604/mojj,2025-02-01 09:30:00,1.96,0.85,1.30,242,348,173,17,11,6,12,4,8,5,1,4,-2,+1,-3,75%,88%,67%,151,210,112,52%,56%,47%,1,1,0,3,0,3
488,https://vlr.gg/player/1399/sterben,2025-02-01 09:30:00,1.67,1.03,1.29,185,278,124,14,9,5,9,3,6,12,4,8,0,-1,+1,75%,63%,83%,120,189,74,46%,69%,23%,1,0,1,1,1,0
489,https://vlr.gg/player/6559/destruct1vee,2025-02-01 09:30:00,0.63,1.07,0.89,167,102,211,12,3,9,13,5,8,8,4,4,-3,0,-3,80%,88%,75%,129,103,145,36%,50%,30%,0,0,0,3,0,3
490,https://vlr.gg/player/7353/glovee,2025-02-01 09:30:00,0.95,0.76,0.83,138,154,128,9,4,5,12,4,8,7,4,3,+3,+1,+2,70%,88%,58%,81,78,83,28%,33%,25%,3,1,2,0,0,0
491,https://vlr.gg/player/6672/meiy,2025-02-01 07:10:00,1.36,1.72,1.50,327,296,346,42,24,18,26,17,9,10,8,2,+4,+2,+2,84%,87%,79%,212,209,218,33%,30%,41%,7,5,2,3,3,0
492,https://vlr.gg/player/48577/gyen,2025-02-01 07:10:00,1.19,1.92,1.46,233,222,295,36,19,17,21,15,6,15,9,6,+7,+2,+5,84%,78%,93%,148,144,153,25%,35%,16%,8,3,5,1,1,0
493,https://vlr.gg/player/4052/jinboong,2025-02-01 07:10:00,1.17,1.13,1.15,183,179,182,26,17,9,21,13,8,9,5,4,-6,-2,-4,81%,83%,79%,122,126,115,27%,27%,26%,1,1,0,7,3,4
494,https://vlr.gg/player/10627/art,2025-02-01 07:10:00,1.14,0.91,1.05,205,227,157,25,18,7,24,14,10,14,7,7,0,0,0,70%,70%,71%,139,152,119,23%,24%,21%,1,1,0,1,1,0
495,https://vlr.gg/player/13002/akame,2025-02-01 07:10:00,1.27,0.67,1.04,203,212,148,24,18,6,24,12,12,21,8,13,+2,+3,-1,84%,87%,79%,114,126,95,22%,27%,14%,5,4,1,3,1,2
496,https://vlr.gg/player/9801/f0rsaken,2025-02-01 07:10:00,1.02,1.13,1.07,226,210,259,30,10,20,29,10,19,9,5,4,-2,-1,-1,73%,86%,65%,166,138,183,29%,35%,27%,2,1,1,4,2,2
497,https://vlr.gg/player/17086/something,2025-02-01 07:10:00,0.75,0.93,0.86,192,194,188,25,9,16,30,13,17,5,2,3,0,+1,-1,70%,71%,70%,118,112,122,23%,28%,19%,7,4,3,7,3,4
498,https://vlr.gg/player/7378/jinggg,2025-02-01 07:10:00,0.54,0.92,0.78,200,147,219,24,8,16,30,12,18,7,0,7,-1,-2,+1,62%,71%,57%,131,97,151,38%,40%,37%,4,0,4,5,2,3
499,https://vlr.gg/player/9800/mindfreak,2025-02-01 07:10:00,1.12,0.37,0.66,161,281,114,24,15,9,32,11,21,11,6,5,-1,+1,-2,62%,71%,57%,102,170,62,27%,29%,25%,2,1,1,3,0,3
500,https://vlr.gg/player/9803/d4v41,2025-02-01 07:10:00,0.51,0.58,0.55,128,84,150,13,3,10,32,11,21,20,11,9,-3,-1,-2,65%,64%,65%,89,69,101,29%,15%,39%,0,0,0,3,1,2
0,https://vlr.gg/player/31829/ivy,2025-02-01 03:00:00,1.06,1.23,1.15,193,177,219,66,29,37,56,27,29,35,14,21,-2,-1,-1,75%,72%,78%,126,119,133,29%,31%,28%,6,2,4,8,3,5
1,https://vlr.gg/player/31828/francis,2025-02-01 03:00:00,0.94,1.13,1.04,237,211,232,64,30,34,63,32,31,31,14,17,+4,+1,+3,73%,74%,72%,156,151,160,19%,17%,20%,6,2,4,2,1,1
2,https://vlr.gg/player/4122/persia,2025-02-01 03:00:00,1.02,1.01,1.01,174,195,181,57,30,27,56,27,29,36,21,15,+2,+1,+1,76%,81%,72%,124,128,119,29%,31%,28%,6,2,4,4,1,3
3,https://vlr.gg/player/33576/margaret,2025-02-01 03:00:00,1.17,0.86,1.01,186,194,189,56,29,27,60,25,35,25,10,15,+8,0,+8,69%,65%,72%,130,136,125,31%,36%,27%,13,4,9,5,4,1
4,https://vlr.gg/player/31827/dambi,2025-02-01 03:00:00,0.73,1.10,0.92,224,207,227,66,31,35,72,39,33,26,14,12,+7,-2,+9,72%,70%,74%,135,122,147,25%,24%,25%,23,11,12,16,13,3
5,https://vlr.gg/player/24895/jemkin,2025-02-01 03:00:00,0.88,1.51,1.18,243,203,306,76,29,47,61,33,28,30,18,12,-7,-10,+3,75%,74%,77%,164,137,193,24%,21%,28%,14,7,7,21,17,4
6,https://vlr.gg/player/25025/estrella,2025-02-01 03:00:00,1.08,1.16,1.12,184,181,198,58,28,30,59,29,30,42,17,25,+2,0,+2,81%,78%,84%,131,123,140,31%,33%,30%,5,2,3,3,2,1
7,https://vlr.gg/player/4871/xffero,2025-02-01 03:00:00,1.31,0.79,1.06,214,244,179,67,43,24,60,28,32,26,9,17,-4,-2,-2,73%,72%,74%,141,157,123,22%,25%,20%,5,1,4,9,3,6
8,https://vlr.gg/player/4866/kushy,2025-02-01 03:00:00,0.79,1.00,0.89,181,171,176,53,25,28,65,35,30,31,17,14,-4,-2,-2,71%,70%,72%,118,119,116,27%,25%,29%,4,1,3,8,3,5
9,https://vlr.gg/player/8497/monyet,2025-02-01 03:00:00,0.86,0.86,0.86,172,191,161,53,32,21,64,35,29,23,9,14,-6,-6,0,72%,65%,79%,119,123,114,26%,24%,31%,7,2,5,13,8,5
10,https://vlr.gg/player/7873/leaf,2025-01-31 21:00:00,1.65,1.35,1.53,298,314,279,44,29,15,24,13,11,9,3,6,+6,+4,+2,80%,83%,75%,196,204,185,26%,22%,33%,8,5,3,2,1,1
11,https://vlr.gg/player/15500/trent,2025-01-31 21:00:00,1.20,2.01,1.53,237,206,280,37,19,18,21,13,8,12,6,6,0,-2,+2,90%,88%,94%,166,152,188,32%,33%,31%,3,0,3,3,2,1
12,https://vlr.gg/player/4581/jonahp,2025-01-31 21:00:00,0.98,1.06,1.01,206,191,229,30,16,14,30,17,13,25,15,10,0,+1,-1,83%,83%,81%,135,127,148,24%,27%,22%,2,2,0,2,1,1
13,https://vlr.gg/player/3993/jawgemo,2025-01-31 21:00:00,0.86,0.91,0.88,217,250,176,29,20,9,34,21,13,13,6,7,+4,+4,0,73%,71%,75%,137,155,111,9%,10%,6%,9,7,2,5,3,2
14,https://vlr.gg/player/3885/valyn,2025-01-31 21:00:00,0.79,0.76,0.78,153,154,148,21,13,8,29,17,12,17,11,6,0,+1,-1,70%,75%,63%,112,118,103,21%,22%,19%,3,2,1,3,1,2
15,https://vlr.gg/player/8549/kingg,2025-01-31 21:00:00,1.05,1.03,1.04,227,249,208,31,15,16,33,13,20,19,7,12,+1,+1,0,78%,88%,71%,146,159,137,27%,26%,28%,4,2,2,3,1,2
16,https://vlr.gg/player/1818/tex,2025-01-31 21:00:00,1.06,0.99,1.02,215,234,201,32,13,19,31,12,19,2,0,2,-6,0,-6,63%,63%,63%,143,161,131,42%,50%,38%,1,1,0,7,1,6
17,https://vlr.gg/player/5004/natank,2025-01-31 21:00:00,0.56,1.29,0.99,227,164,274,32,9,23,31,13,18,9,2,7,0,-4,+4,68%,50%,79%,144,103,171,26%,21%,27%,8,2,6,8,6,2
18,https://vlr.gg/player/619/c0m,2025-01-31 21:00:00,0.80,0.70,0.74,154,202,135,23,12,11,32,12,20,8,2,6,0,+1,-1,63%,69%,58%,107,118,100,23%,26%,20%,1,1,0,1,0,1
19,https://vlr.gg/player/26171/demon1,2025-01-31 21:00:00,0.59,0.74,0.67,155,163,162,20,8,12,35,14,21,21,8,13,-5,0,-5,65%,63%,67%,115,111,118,31%,30%,31%,1,1,0,6,1,5
20,https://vlr.gg/player/8873/dgzin,2025-01-31 17:00:00,1.13,1.39,1.27,253,262,243,61,30,31,44,25,19,10,4,6,+9,+3,+6,74%,59%,89%,161,168,154,28%,32%,23%,14,8,6,5,5,0
21,https://vlr.gg/player/683/pancada,2025-01-31 17:00:00,1.00,1.15,1.08,204,156,251,53,20,33,46,22,24,28,18,10,+3,+1,+2,70%,71%,69%,132,107,156,37%,31%,40%,7,2,5,4,1,3
22,https://vlr.gg/player/6193/cauanzin,2025-01-31 17:00:00,0.58,1.29,0.93,215,168,262,49,18,31,53,30,23,22,9,13,+3,-3,+6,66%,53%,78%,138,113,162,23%,16%,29%,13,4,9,10,7,3
23,https://vlr.gg/player/2408/tuyz,2025-01-31 17:00:00,0.85,0.79,0.82,133,147,122,35,20,15,42,22,20,7,3,4,-1,0,-1,73%,71%,75%,85,87,82,34%,33%,35%,4,2,2,5,2,3
24,https://vlr.gg/player/1586/v1nny,2025-01-31 17:00:00,0.77,0.60,0.68,126,158,99,31,18,13,50,27,23,19,13,6,-4,+1,-5,67%,65%,69%,91,104,78,41%,40%,43%,2,2,0,6,1,5
25,https://vlr.gg/player/4004/zekken,2025-01-31 17:00:00,1.12,1.30,1.21,253,250,258,61,30,31,47,25,22,21,9,12,+3,0,+3,81%,78%,85%,161,164,157,24%,22%,26%,15,8,7,12,8,4
26,https://vlr.gg/player/1265/johnqt,2025-01-31 17:00:00,0.94,1.15,1.04,183,178,187,45,23,22,43,25,18,16,7,9,0,0,0,73%,75%,71%,127,119,135,26%,23%,29%,4,2,2,4,2,2
27,https://vlr.gg/player/729/zellsis,2025-01-31 17:00:00,1.21,0.83,1.02,191,202,178,45,25,20,46,22,24,21,11,10,-6,-1,-5,70%,67%,74%,118,122,113,17%,22%,13%,5,3,2,11,4,7
28,https://vlr.gg/player/3880/bang,2025-01-31 17:00:00,0.59,1.44,1.00,186,105,271,48,13,35,46,24,22,17,9,8,-2,-6,+4,74%,64%,85%,117,66,172,30%,26%,32%,5,0,5,7,6,1
29,https://vlr.gg/player/36245/n4rrate,2025-01-31 17:00:00,0.84,0.95,0.89,150,151,152,36,18,18,47,27,20,29,17,12,-5,-1,-4,71%,72%,71%,102,103,100,14%,13%,15%,1,1,0,6,2,4
30,https://vlr.gg/player/5568/sociablee,2025-01-31 14:15:00,1.06,1.27,1.16,240,225,258,59,28,31,50,25,25,14,6,8,0,0,0,74%,77%,71%,152,143,161,24%,25%,23%,13,8,5,13,8,5
31,https://vlr.gg/player/172/vakk,2025-01-31 14:15:00,1.34,0.85,1.10,203,241,162,52,33,19,45,22,23,23,10,13,-3,0,-3,72%,86%,59%,122,143,100,33%,32%,33%,1,1,0,4,1,3
32,https://vlr.gg/player/5554/profek,2025-01-31 14:15:00,1.13,0.72,0.93,185,225,144,49,31,18,48,24,24,14,8,6,-5,-2,-3,67%,69%,65%,123,150,96,29%,33%,24%,0,0,0,5,2,3
33,https://vlr.gg/player/20144/lewn,2025-01-31 14:15:00,0.82,0.91,0.86,196,207,186,49,27,22,53,28,25,17,7,10,-10,-5,-5,65%,63%,68%,125,130,121,30%,50%,11%,8,3,5,18,8,10
34,https://vlr.gg/player/9780/jamppi,2025-01-31 14:15:00,0.48,1.13,0.80,176,110,243,38,10,28,54,26,28,23,11,12,-3,-2,-1,65%,66%,65%,116,82,150,30%,21%,35%,2,1,1,5,3,2
35,https://vlr.gg/player/11494/keiko,2025-01-31 14:15:00,0.98,1.32,1.15,223,194,252,56,24,32,46,23,23,15,11,4,+7,+3,+4,68%,65%,71%,145,120,170,32%,27%,37%,9,4,5,2,1,1
36,https://vlr.gg/player/1475/kamyk,2025-01-31 14:15:00,1.00,1.19,1.10,208,201,214,49,23,26,47,24,23,25,13,12,0,-1,+1,70%,74%,66%,137,130,144,25%,25%,25%,3,1,2,3,2,1
37,https://vlr.gg/player/14681/kamo,2025-01-31 14:15:00,0.92,1.12,1.02,225,203,249,54,23,31,52,24,28,8,5,3,+6,+1,+5,68%,71%,66%,152,156,149,30%,29%,31%,12,4,8,6,3,3
38,https://vlr.gg/player/457/nats,2025-01-31 14:15:00,1.13,0.72,0.92,214,248,185,51,30,21,55,25,30,19,6,13,+8,+7,+1,67%,68%,66%,139,156,122,31%,33%,29%,14,9,5,6,2,4
39,https://vlr.gg/player/309/patitek,2025-01-31 14:15:00,1.02,0.65,0.83,158,191,127,40,25,15,47,22,25,17,10,7,0,+2,-2,72%,76%,69%,101,120,82,26%,29%,23%,7,5,2,7,3,4
40,https://vlr.gg/player/8369/yetujey,2025-01-31 12:00:00,1.15,1.48,1.30,218,199,245,34,19,15,24,15,9,12,3,9,+7,+3,+4,81%,74%,89%,138,121,159,28%,35%,22%,8,3,5,1,0,1
41,https://vlr.gg/player/12793/xeus,2025-01-31 12:00:00,0.77,1.93,1.29,248,190,330,40,15,25,29,19,10,7,4,3,-5,-5,0,74%,61%,89%,166,123,218,44%,42%,46%,6,3,3,11,8,3
42,https://vlr.gg/player/8044/mrfalin,2025-01-31 12:00:00,1.20,0.91,1.07,171,187,152,23,15,8,22,11,11,20,9,11,0,0,0,69%,70%,68%,116,122,109,19%,24%,14%,1,0,1,1,0,1
43,https://vlr.gg/player/6510/atakaptan,2025-01-31 12:00:00,1.03,1.05,1.04,201,205,187,29,15,14,32,18,14,19,11,8,+1,-1,+2,69%,65%,74%,119,126,110,28%,29%,26%,6,3,3,5,4,1
44,https://vlr.gg/player/1139/qraxs,2025-01-31 12:00:00,0.99,0.97,0.98,195,216,157,27,16,11,28,18,10,17,10,7,+1,0,+1,69%,74%,63%,125,136,112,24%,22%,28%,2,1,1,1,1,0
45,https://vlr.gg/player/9810/alfajer,2025-01-31 12:00:00,0.53,1.28,0.94,223,163,273,34,10,24,33,17,16,1,1,0,+3,-1,+4,67%,53%,78%,138,106,165,38%,29%,43%,7,2,5,4,3,1
46,https://vlr.gg/player/9554/kaajak,2025-01-31 12:00:00,0.70,1.09,0.91,194,183,204,28,12,16,29,16,13,12,4,8,-6,-5,-1,62%,47%,74%,124,115,132,47%,56%,41%,4,0,4,10,5,5
47,https://vlr.gg/player/4/crashies,2025-01-31 12:00:00,0.66,1.13,0.91,198,128,247,28,8,20,30,14,16,15,4,11,0,-1,+1,71%,58%,83%,133,97,163,35%,35%,36%,2,1,1,2,2,0
48,https://vlr.gg/player/458/chronicle,2025-01-31 12:00:00,1.02,0.67,0.83,168,221,123,24,15,9,30,14,16,16,7,9,-1,-1,0,67%,68%,65%,105,131,84,32%,32%,32%,1,1,0,2,2,0
49,https://vlr.gg/player/438/boaster,2025-01-31 12:00:00,0.69,0.69,0.69,135,117,153,19,7,12,32,13,19,15,5,10,0,+1,-1,64%,58%,70%,97,83,108,31%,33%,29%,5,2,3,5,1,4
50,https://vlr.gg/player/25081/yoman,2025-01-31 05:45:00,1.21,0.79,0.99,167,200,142,30,17,13,33,15,18,10,7,3,-2,-1,-1,64%,71%,58%,112,131,94,31%,43%,21%,2,0,2,4,1,3
51,https://vlr.gg/player/34974/karon,2025-01-31 05:45:00,1.12,0.72,0.92,165,208,120,27,16,11,34,15,19,26,13,13,-2,+1,-3,70%,83%,58%,102,124,81,34%,39%,29%,1,1,0,3,0,3
52,https://vlr.gg/player/11600/foxy9,2025-01-31 05:45:00,0.91,0.90,0.91,185,196,188,33,17,16,38,18,20,6,3,3,+3,+3,0,60%,63%,58%,126,124,128,43%,36%,50%,6,3,3,3,0,3
53,https://vlr.gg/player/2489/munchkin,2025-01-31 05:45:00,0.74,0.82,0.78,170,136,202,26,12,14,38,17,21,22,7,15,-4,-2,-2,74%,71%,77%,115,87,141,18%,19%,18%,2,0,2,6,2,4
54,https://vlr.gg/player/9196/t3xture,2025-01-31 05:45:00,0.38,1.12,0.76,205,160,238,36,13,23,42,22,20,3,2,1,-5,-5,0,54%,54%,54%,121,104,137,24%,30%,20%,9,6,3,14,11,3
55,https://vlr.gg/player/1916/free1ng,2025-01-31 05:45:00,1.31,1.50,1.40,250,233,270,47,23,24,28,14,14,10,6,4,+5,+3,+2,84%,81%,88%,153,136,172,32%,26%,38%,8,6,2,3,3,0
56,https://vlr.gg/player/4678/beyn,2025-01-31 05:45:00,1.20,1.22,1.21,217,200,223,40,20,20,30,15,15,20,14,6,+1,+2,-1,80%,85%,75%,147,139,155,43%,42%,43%,4,3,1,3,1,2
57,https://vlr.gg/player/4462/mako,2025-01-31 05:45:00,1.23,1.03,1.14,184,216,155,31,19,12,30,15,15,27,13,14,-2,0,-2,76%,73%,79%,128,139,117,28%,25%,31%,1,0,1,3,0,3
58,https://vlr.gg/player/35013/flashback,2025-01-31 05:45:00,0.89,1.15,1.01,192,145,255,32,12,20,31,15,16,14,7,7,+3,-3,+6,76%,77%,75%,128,108,150,28%,27%,29%,9,1,8,6,4,2
59,https://vlr.gg/player/28400/hyunmin,2025-01-31 05:45:00,1.16,0.75,0.97,206,264,144,35,24,11,33,18,15,12,5,7,+3,+4,-1,78%,77%,79%,145,180,107,35%,42%,26%,8,6,2,5,2,3
60,https://vlr.gg/player/804/buzz,2025-01-31 03:00:00,1.05,1.68,1.35,251,222,287,52,22,30,39,22,17,17,10,7,+8,+5,+3,75%,67%,85%,175,153,199,22%,22%,21%,13,7,6,5,2,3
61,https://vlr.gg/player/29833/izu,2025-01-31 03:00:00,1.02,1.23,1.12,179,181,181,41,21,20,32,19,13,12,5,7,-2,-2,0,82%,83%,81%,127,118,137,32%,34%,30%,3,2,1,5,4,1
62,https://vlr.gg/player/13039/meteor,2025-01-31 03:00:00,0.72,1.19,0.94,229,210,250,45,21,24,46,26,20,13,4,9,+1,-4,+5,61%,47%,78%,158,141,177,33%,40%,28%,8,2,6,7,6,1
63,https://vlr.gg/player/485/stax,2025-01-31 03:00:00,0.89,0.94,0.91,139,163,120,28,16,12,36,20,16,26,11,15,0,+1,-1,72%,63%,81%,100,109,90,30%,28%,32%,2,2,0,2,1,1
64,https://vlr.gg/player/4056/sylvan,2025-01-31 03:00:00,0.65,1.04,0.84,174,121,232,30,11,19,40,22,18,27,14,13,-4,-2,-2,74%,73%,74%,122,87,160,26%,31%,22%,4,1,3,8,3,5
65,https://vlr.gg/player/5129/ban,2025-01-31 03:00:00,0.85,1.44,1.16,219,171,257,45,17,28,34,20,14,13,7,6,+3,+2,+1,70%,67%,73%,138,106,166,35%,35%,35%,8,5,3,5,3,2
66,https://vlr.gg/player/25255/primmie,2025-01-31 03:00:00,0.83,1.34,1.10,207,164,248,45,18,27,39,20,19,2,1,1,0,0,0,68%,67%,70%,135,114,154,30%,25%,35%,4,1,3,4,1,3
67,https://vlr.gg/player/13788/jitboys,2025-01-31 03:00:00,0.91,1.11,1.02,184,178,190,38,16,22,41,21,20,23,15,8,0,-1,+1,84%,85%,83%,127,127,126,32%,29%,34%,3,0,3,3,1,2
68,https://vlr.gg/player/3980/governor,2025-01-31 03:00:00,0.85,0.88,0.86,196,224,168,38,21,17,40,22,18,5,1,4,-2,-2,0,61%,63%,60%,124,133,116,24%,27%,19%,10,5,5,12,7,5
69,https://vlr.gg/player/3977/crws,2025-01-31 03:00:00,0.54,0.78,0.66,137,127,143,27,12,15,42,22,20,15,5,10,-4,-4,0,63%,63%,63%,82,79,85,17%,11%,23%,2,0,2,6,4,2
70,https://vlr.gg/player/12872/david,2025-01-30 17:30:00,1.41,1.07,1.23,263,298,229,41,23,18,35,16,19,22,9,13,+1,+2,-1,80%,86%,75%,159,179,141,22%,21%,22%,3,2,1,2,0,2
71,https://vlr.gg/player/783/murizzz,2025-01-30 17:30:00,1.22,0.96,1.08,201,228,181,32,19,13,32,14,18,17,7,10,-1,-1,0,72%,77%,67%,135,142,129,32%,38%,27%,4,0,4,5,1,4
72,https://vlr.gg/player/13860/rubkkoide,2025-01-30 17:30:00,0.76,1.06,0.92,186,166,207,29,11,18,35,17,18,24,12,12,-1,-1,0,74%,73%,75%,132,123,140,47%,38%,55%,1,1,0,2,2,0
73,https://vlr.gg/player/8892/snw,2025-01-30 17:30:00,0.69,1.00,0.85,201,188,210,33,14,19,36,18,18,8,6,2,-7,-3,-4,67%,77%,58%,132,118,146,33%,28%,38%,8,6,2,15,9,6
74,https://vlr.gg/player/46901/maxhinh9,2025-01-30 17:30:00,0.73,0.52,0.62,143,150,137,24,13,11,36,16,20,7,4,3,-2,-1,-1,61%,59%,63%,93,90,95,19%,17%,21%,2,0,2,4,1,3
75,https://vlr.gg/player/38857/beng,2025-01-30 17:30:00,1.54,1.33,1.44,277,283,270,48,27,21,28,12,16,23,9,14,+3,+1,+2,85%,92%,77%,170,181,158,33%,32%,35%,3,1,2,0,0,0
76,https://vlr.gg/player/41135/dantedeu5,2025-01-30 17:30:00,1.38,1.27,1.32,298,329,267,46,26,20,33,18,15,12,7,5,+5,+4,+1,70%,71%,68%,186,194,178,27%,21%,40%,14,9,5,9,5,4
77,https://vlr.gg/player/36169/mta,2025-01-30 17:30:00,0.85,1.10,0.97,204,178,232,34,16,18,33,16,17,19,8,11,-3,-1,-2,87%,83%,91%,138,117,161,33%,28%,37%,1,0,1,4,1,3
78,https://vlr.gg/player/33566/ganter,2025-01-30 17:30:00,0.70,0.93,0.81,160,126,200,27,11,16,32,16,16,6,2,4,0,-1,+1,61%,54%,68%,106,86,129,26%,28%,25%,4,1,3,4,2,2
79,https://vlr.gg/player/15542/gio,2025-01-30 17:30:00,0.86,0.46,0.67,137,171,101,19,13,6,33,17,16,23,13,10,+5,+3,+2,67%,75%,59%,89,111,66,20%,21%,18%,6,4,2,1,1,0
80,https://vlr.gg/player/1885/purp0,2025-01-30 14:15:00,1.32,1.05,1.16,278,335,241,38,19,19,32,14,18,5,0,5,+4,+2,+2,80%,88%,75%,179,223,151,36%,57%,23%,10,5,5,6,3,3
81,https://vlr.gg/player/19691/tomaszy,2025-01-30 14:15:00,0.95,0.82,0.87,156,182,142,23,10,13,30,12,18,17,7,10,0,0,0,73%,75%,71%,99,114,90,38%,41%,36%,3,1,2,3,1,2
82,https://vlr.gg/player/4181/cloud,2025-01-30 14:15:00,0.74,0.88,0.83,172,160,182,25,10,15,33,13,20,12,5,7,+1,0,+1,70%,63%,75%,125,113,133,32%,26%,36%,3,0,3,2,0,2
83,https://vlr.gg/player/34684/westside,2025-01-30 14:15:00,0.42,1.00,0.77,180,120,217,25,7,18,32,13,19,6,1,5,-1,-1,0,63%,63%,63%,123,84,150,42%,39%,44%,2,1,1,3,2,1
84,https://vlr.gg/player/21610/runner,2025-01-30 14:15:00,0.59,0.76,0.69,177,157,188,21,7,14,34,14,20,17,8,9,-4,-3,-1,83%,69%,92%,126,120,129,20%,24%,18%,2,0,2,6,3,3
85,https://vlr.gg/player/14681/kamo,2025-01-30 14:15:00,1.09,1.63,1.30,258,237,295,39,21,18,27,17,10,7,4,3,+4,+3,+1,70%,71%,69%,165,141,200,27%,30%,24%,9,7,2,5,4,1
86,https://vlr.gg/player/11494/keiko,2025-01-30 14:15:00,0.80,1.88,1.23,244,170,346,36,15,21,28,18,10,14,11,3,-1,-3,+2,80%,79%,81%,172,119,251,32%,32%,32%,4,1,3,5,4,1
87,https://vlr.gg/player/457/nats,2025-01-30 14:15:00,1.27,1.12,1.21,234,264,189,33,23,10,27,17,10,16,8,8,-3,-1,-2,80%,79%,81%,155,172,128,24%,25%,22%,2,1,1,5,2,3
88,https://vlr.gg/player/309/patitek,2025-01-30 14:15:00,1.18,1.07,1.14,190,180,206,26,15,11,23,12,11,20,11,9,-2,-2,0,85%,79%,94%,132,127,140,24%,27%,20%,1,0,1,3,2,1
89,https://vlr.gg/player/1475/kamyk,2025-01-30 14:15:00,1.34,0.57,1.03,181,228,113,27,21,6,27,15,12,12,7,5,+2,+1,+1,78%,79%,75%,129,163,77,33%,33%,33%,4,2,2,2,1,1
90,https://vlr.gg/player/2931/vaiz,2025-01-30 14:00:00,1.18,1.49,1.34,243,213,273,63,24,39,42,19,23,21,10,11,+2,0,+2,81%,79%,84%,154,139,167,28%,29%,28%,6,3,3,4,3,1
91,https://vlr.gg/player/2909/alca,2025-01-30 14:00:00,1.09,1.06,1.07,216,206,216,54,26,28,44,20,24,20,9,11,-1,0,-1,67%,64%,70%,147,138,156,44%,54%,38%,3,2,1,4,2,2
92,https://vlr.gg/player/7652/tuli,2025-01-30 14:00:00,0.97,0.85,0.91,234,257,215,56,29,27,59,27,32,9,6,3,+6,+3,+3,73%,73%,73%,151,165,139,29%,32%,27%,20,10,10,14,7,7
93,https://vlr.gg/player/1309/tio,2025-01-30 14:00:00,0.78,0.75,0.77,133,142,128,30,16,14,45,21,24,36,14,22,-1,+1,-2,81%,82%,81%,88,88,87,18%,19%,16%,4,2,2,5,1,4
94,https://vlr.gg/player/8278/knzy,2025-01-30 14:00:00,0.95,0.60,0.76,146,174,125,37,23,14,49,23,26,20,6,14,-2,+1,-3,74%,79%,70%,98,111,86,17%,20%,15%,4,2,2,6,1,5
95,https://vlr.gg/player/1294/nagz,2025-01-30 14:00:00,1.34,1.09,1.22,219,235,198,55,30,25,43,21,22,17,11,6,-4,-1,-3,73%,76%,70%,157,177,135,25%,25%,26%,6,4,2,10,5,5
96,https://vlr.gg/player/2468/delz1k,2025-01-30 14:00:00,1.10,0.94,1.02,207,231,178,51,30,21,52,28,24,20,12,8,0,-1,+1,76%,73%,79%,130,143,115,25%,27%,23%,5,2,3,5,3,2
97,https://vlr.gg/player/29244/mikey-tap,2025-01-30 14:00:00,0.95,1.03,0.99,196,163,235,53,23,30,47,23,24,19,13,6,-1,-2,+1,73%,70%,76%,130,112,150,35%,32%,38%,7,2,5,8,4,4
98,https://vlr.gg/player/2464/suther,2025-01-30 14:00:00,1.00,0.83,0.92,189,183,195,41,22,19,50,24,26,27,11,16,+2,+2,0,70%,70%,70%,126,121,131,22%,25%,20%,7,5,2,5,3,2
99,https://vlr.gg/player/3828/tacolilla,2025-01-30 14:00:00,0.90,0.82,0.86,165,185,145,39,24,15,48,26,22,14,4,10,-1,+3,-4,69%,68%,70%,117,124,111,18%,16%,20%,8,6,2,9,3,6
100,https://vlr.gg/player/25906/alexiiik,2025-01-30 13:10:00,1.57,0.95,1.25,292,352,237,68,42,26,50,22,28,8,2,6,-2,-1,-1,67%,69%,65%,176,206,148,28%,33%,21%,12,8,4,14,9,5
101,https://vlr.gg/player/8593/grmekista,2025-01-30 13:10:00,1.23,1.07,1.15,192,218,170,43,23,20,38,18,20,23,11,12,-2,-3,+1,73%,78%,68%,128,147,109,30%,26%,36%,5,2,3,7,5,2
102,https://vlr.gg/player/4537/tajrex,2025-01-30 13:10:00,0.87,1.08,0.98,205,193,216,48,21,27,48,25,23,17,14,3,-3,+1,-4,71%,81%,62%,141,132,149,27%,28%,26%,6,2,4,9,1,8
103,https://vlr.gg/player/3839/prti,2025-01-30 13:10:00,0.78,0.99,0.89,162,123,198,36,14,22,43,19,24,11,6,5,0,-1,+1,59%,63%,56%,114,91,136,25%,29%,24%,3,0,3,3,1,2
104,https://vlr.gg/player/37840/msh,2025-01-30 13:10:00,0.69,0.86,0.78,157,159,157,37,18,19,47,23,24,7,3,4,-1,0,-1,62%,59%,65%,113,120,108,36%,34%,39%,3,2,1,4,2,2
105,https://vlr.gg/player/4525/stix,2025-01-30 13:10:00,1.11,1.55,1.33,242,213,271,58,27,31,44,23,21,15,7,8,+5,+1,+4,71%,68%,75%,160,146,176,36%,37%,35%,7,3,4,2,2,0
106,https://vlr.gg/player/2525/szimpli,2025-01-30 13:10:00,1.21,0.93,1.07,232,277,190,57,36,21,47,25,22,6,1,5,+3,+3,0,70%,76%,63%,162,185,138,40%,46%,33%,13,7,6,10,4,6
107,https://vlr.gg/player/10378/almo,2025-01-30 13:10:00,1.12,0.90,1.01,195,194,190,46,24,22,43,19,24,9,3,6,+4,+2,+2,71%,74%,69%,134,143,123,33%,33%,33%,9,5,4,5,3,2
108,https://vlr.gg/player/164/bzt,2025-01-30 13:10:00,0.91,0.58,0.75,143,157,131,32,19,13,46,20,26,26,13,13,+3,+2,+1,68%,71%,66%,98,105,90,19%,17%,23%,3,2,1,0,0,0
109,https://vlr.gg/player/2701/maniek,2025-01-30 13:10:00,0.46,0.82,0.63,160,130,191,33,13,20,53,27,26,14,8,6,-7,-4,-3,62%,59%,66%,108,91,127,21%,23%,20%,5,2,3,12,6,6
110,https://vlr.gg/player/23169/minny,2025-01-30 12:00:00,1.15,1.01,1.06,195,197,194,24,10,14,24,8,16,5,0,5,+5,+3,+2,59%,62%,58%,127,120,131,33%,29%,35%,6,4,2,1,1,0
111,https://vlr.gg/player/20871/k4davra,2025-01-30 12:00:00,1.13,1.02,1.05,210,251,188,29,12,17,24,10,14,5,0,5,-1,0,-1,59%,54%,63%,134,170,115,42%,38%,45%,1,0,1,2,0,2
112,https://vlr.gg/player/5893/robbiebk,2025-01-30 12:00:00,0.75,0.91,0.85,156,95,189,17,4,13,29,9,20,10,4,6,0,0,0,65%,62%,67%,113,68,137,26%,29%,25%,4,0,4,4,0,4
113,https://vlr.gg/player/11/zyppan,2025-01-30 12:00:00,0.61,0.65,0.63,110,107,112,10,3,7,28,9,19,19,8,11,+2,0,+2,62%,54%,67%,80,85,77,30%,19%,41%,3,1,2,1,1,0
114,https://vlr.gg/player/7866/click,2025-01-30 12:00:00,0.42,0.63,0.52,121,76,147,17,3,14,28,10,18,1,1,0,-7,-4,-3,49%,54%,46%,73,50,86,38%,36%,38%,4,1,3,11,5,6
115,https://vlr.gg/player/9554/kaajak,2025-01-30 12:00:00,1.48,1.56,1.51,337,328,360,44,28,16,23,15,8,7,3,4,+1,0,+1,68%,71%,62%,221,219,224,36%,33%,42%,8,4,4,7,4,3
116,https://vlr.gg/player/438/boaster,2025-01-30 12:00:00,1.19,1.44,1.28,166,144,210,23,13,10,14,9,5,18,14,4,0,0,0,84%,83%,85%,106,86,143,29%,21%,39%,1,1,0,1,1,0
117,https://vlr.gg/player/9810/alfajer,2025-01-30 12:00:00,1.14,1.13,1.13,251,267,222,34,23,11,25,17,8,3,2,1,+4,+2,+2,68%,67%,69%,165,182,135,30%,28%,39%,8,5,3,4,3,1
118,https://vlr.gg/player/458/chronicle,2025-01-30 12:00:00,0.92,1.05,0.96,138,152,112,20,14,6,18,13,5,10,3,7,-3,-2,-1,68%,71%,62%,83,94,62,20%,21%,18%,1,1,0,4,3,1
119,https://vlr.gg/player/4/crashies,2025-01-30 12:00:00,0.88,0.69,0.81,97,112,72,12,9,3,17,11,6,5,4,1,-1,0,-1,70%,71%,69%,76,86,58,24%,33%,7%,1,1,0,2,1,1
120,https://vlr.gg/player/50814/fractioned,2025-01-30 11:00:00,1.12,1.66,1.40,295,262,327,52,21,31,35,18,17,7,1,6,+5,0,+5,70%,57%,83%,192,160,224,29%,33%,25%,13,6,7,8,6,2
121,https://vlr.gg/player/42550/merix,2025-01-30 11:00:00,1.07,1.41,1.25,274,238,308,44,19,25,37,19,18,25,9,16,+2,+1,+1,79%,74%,83%,179,159,198,35%,42%,30%,2,1,1,0,0,0
122,https://vlr.gg/player/45834/aidan,2025-01-30 11:00:00,0.61,1.11,0.86,188,160,215,33,13,20,36,19,17,5,1,4,-5,-4,-1,68%,57%,79%,128,98,157,28%,31%,26%,4,2,2,9,6,3
123,https://vlr.gg/player/20443/br-di,2025-01-30 11:00:00,0.61,0.67,0.64,125,118,131,20,9,11,34,18,16,10,4,6,-4,0,-4,47%,39%,54%,99,101,97,27%,37%,22%,1,0,1,5,0,5
124,https://vlr.gg/player/31300/drog,2025-01-30 11:00:00,0.47,0.75,0.62,126,96,157,18,6,12,35,18,17,14,6,8,+1,0,+1,70%,61%,79%,91,68,112,24%,21%,26%,3,1,2,2,1,1
125,https://vlr.gg/player/50813/gsr,2025-01-30 11:00:00,0.88,1.59,1.23,278,233,325,48,19,29,35,21,14,11,9,2,0,-1,+1,74%,79%,70%,177,153,201,32%,31%,33%,2,1,1,2,2,0
126,https://vlr.gg/player/19526/rexxtoned,2025-01-30 11:00:00,0.85,1.24,1.04,184,183,185,31,16,15,31,20,11,11,5,6,-1,+1,-2,77%,67%,87%,122,120,123,39%,36%,42%,2,2,0,3,1,2
127,https://vlr.gg/player/7105/qpert,2025-01-30 11:00:00,1.09,0.92,1.01,165,191,139,27,16,11,31,18,13,19,8,11,+3,+1,+2,72%,71%,74%,110,133,86,32%,36%,26%,6,3,3,3,2,1
128,https://vlr.gg/player/40750/donatellooo,2025-01-30 11:00:00,0.76,1.23,0.99,225,183,268,38,16,22,36,21,15,6,3,3,+2,0,+2,70%,63%,78%,142,108,178,31%,38%,28%,12,5,7,10,5,5
129,https://vlr.gg/player/28948/ninja,2025-01-30 11:00:00,1.00,0.97,0.99,194,207,181,32,17,15,34,19,15,16,11,5,-3,-3,0,77%,75%,78%,138,135,141,32%,33%,31%,2,0,2,5,3,2
130,https://vlr.gg/player/18384/bully,2025-01-30 11:00:00,0.91,1.68,1.30,260,188,333,46,18,28,31,19,12,5,1,4,+3,0,+3,71%,58%,83%,175,119,230,37%,38%,36%,4,1,3,1,1,0
131,https://vlr.gg/player/3934/eleo,2025-01-30 11:00:00,1.16,1.25,1.20,212,217,208,35,15,20,29,17,12,14,11,3,+6,+2,+4,83%,71%,96%,145,156,133,32%,41%,24%,6,2,4,0,0,0
132,https://vlr.gg/player/27789/deyten,2025-01-30 11:00:00,0.67,1.27,0.97,180,162,199,32,13,19,33,21,12,17,6,11,+2,+1,+1,81%,75%,88%,121,109,132,33%,31%,36%,4,2,2,2,1,1
133,https://vlr.gg/player/33974/appa,2025-01-30 11:00:00,0.53,1.23,0.88,177,150,205,28,11,17,34,21,13,17,8,9,-8,-11,+3,71%,54%,88%,123,103,144,25%,20%,29%,6,1,5,14,12,2
134,https://vlr.gg/player/47270/darkwinjett,2025-01-30 11:00:00,0.82,0.74,0.78,162,157,167,27,13,14,38,20,18,26,12,14,-1,-2,+1,77%,79%,75%,103,104,102,21%,20%,23%,5,1,4,6,3,3
135,https://vlr.gg/player/31298/luca,2025-01-30 11:00:00,1.32,1.26,1.29,226,270,182,38,21,17,28,17,11,8,4,4,-1,-2,+1,81%,79%,83%,151,176,127,31%,31%,33%,2,1,1,3,3,0
136,https://vlr.gg/player/4214/eso177,2025-01-30 11:00:00,1.01,1.20,1.11,207,176,238,36,15,21,32,18,14,14,7,7,+3,-1,+4,77%,71%,83%,142,124,159,28%,38%,22%,6,1,5,3,2,1
137,https://vlr.gg/player/12372/szoren,2025-01-30 11:00:00,0.50,1.40,0.95,186,123,249,33,9,24,35,22,13,14,7,7,+4,+1,+3,65%,58%,71%,123,91,156,29%,26%,31%,7,3,4,3,2,1
138,https://vlr.gg/player/5566/jeyj7y,2025-01-30 11:00:00,0.55,1.26,0.90,208,151,266,33,13,20,35,20,15,14,4,10,-2,-2,0,75%,63%,88%,139,90,187,42%,43%,41%,2,0,2,4,2,2
139,https://vlr.gg/player/34002/lukey,2025-01-30 11:00:00,0.39,0.88,0.63,140,100,180,25,9,16,38,21,17,4,3,1,-6,-8,+2,60%,54%,67%,84,64,105,22%,20%,23%,6,1,5,12,9,3
140,https://vlr.gg/player/25915/brian,2025-01-30 07:55:00,1.19,1.53,1.36,267,256,278,67,32,35,45,24,21,22,10,12,+3,-2,+5,78%,76%,79%,160,155,166,34%,32%,36%,13,6,7,10,8,2
141,https://vlr.gg/player/17169/muto,2025-01-30 07:55:00,1.58,1.09,1.34,237,265,208,60,33,27,40,18,22,16,8,8,-1,-3,+2,85%,79%,91%,165,185,146,27%,29%,24%,3,1,2,4,4,0
142,https://vlr.gg/player/1963/hate,2025-01-30 07:55:00,1.04,1.04,1.04,177,166,189,42,20,22,41,20,21,18,3,15,0,-1,+1,84%,79%,88%,122,104,140,30%,33%,28%,5,0,5,5,1,4
143,https://vlr.gg/player/4545/sayaplayer,2025-01-30 07:55:00,0.47,1.24,0.85,171,125,219,41,14,27,47,28,19,16,7,9,-3,-4,+1,69%,56%,82%,120,96,144,27%,25%,29%,8,3,5,11,7,4
144,https://vlr.gg/player/31841/take,2025-01-30 07:55:00,0.59,1.07,0.83,174,122,228,38,12,26,52,27,25,39,17,22,-1,0,-1,76%,74%,79%,121,94,147,27%,18%,34%,4,2,2,5,2,3
145,https://vlr.gg/player/51094/falk,2025-01-30 07:55:00,1.02,1.26,1.14,205,184,226,50,23,27,46,25,21,31,13,18,+1,-1,+2,74%,68%,79%,137,124,149,38%,40%,36%,4,1,3,3,2,1
146,https://vlr.gg/player/34753/solluzy,2025-01-30 07:55:00,0.75,1.07,0.91,194,183,204,45,22,23,50,29,21,17,6,11,+1,-2,+3,75%,71%,79%,136,128,145,16%,18%,14%,5,1,4,4,3,1
147,https://vlr.gg/player/40738/killaa,2025-01-30 07:55:00,0.88,0.89,0.89,185,205,167,44,24,20,53,29,24,36,15,21,-1,-1,0,71%,65%,76%,110,123,96,24%,23%,25%,3,1,2,4,2,2
148,https://vlr.gg/player/49906/honeybunny,2025-01-30 07:55:00,0.67,1.09,0.88,238,210,266,55,24,31,58,30,28,11,3,8,+1,-4,+5,69%,53%,85%,146,133,159,31%,34%,28%,18,7,11,17,11,6
149,https://vlr.gg/player/43054/lefiedot,2025-01-30 07:55:00,0.73,0.93,0.83,134,149,123,31,15,16,42,24,18,17,7,10,0,0,0,69%,71%,68%,93,102,85,20%,12%,34%,5,3,2,5,3,2
150,https://vlr.gg/player/17303/fontuz,2025-01-30 07:00:00,1.09,1.41,1.24,204,161,257,50,21,29,42,22,20,21,11,10,+4,+1,+3,79%,72%,88%,137,107,170,28%,26%,29%,6,1,5,2,0,2
151,https://vlr.gg/player/41701/ki1wsy,2025-01-30 07:00:00,1.10,1.01,1.06,209,210,193,46,25,21,51,27,24,24,10,14,-1,-1,0,69%,64%,75%,137,139,134,24%,29%,20%,5,3,2,6,4,2
152,https://vlr.gg/player/20623/harddora,2025-01-30 07:00:00,0.89,1.10,0.99,183,173,194,43,20,23,47,26,21,18,7,11,+3,+2,+1,69%,64%,75%,112,108,117,30%,47%,19%,6,3,3,3,1,2
153,https://vlr.gg/player/41694/endoist,2025-01-30 07:00:00,0.80,1.08,0.93,211,190,248,49,23,26,50,26,24,17,6,11,-11,-14,+3,66%,61%,72%,141,124,160,18%,19%,17%,8,1,7,19,15,4
154,https://vlr.gg/player/31537/basbabe,2025-01-30 07:00:00,0.60,1.15,0.86,184,155,213,42,19,23,52,30,22,27,6,21,-1,-2,+1,69%,56%,84%,119,99,140,40%,44%,37%,6,3,3,7,5,2
155,https://vlr.gg/player/42901/thyy,2025-01-30 07:00:00,1.55,1.37,1.46,241,262,235,60,29,31,37,19,18,35,19,16,+1,-1,+2,84%,88%,81%,158,166,151,35%,27%,46%,3,0,3,2,1,1
156,https://vlr.gg/player/41702/canady,2025-01-30 07:00:00,0.95,1.09,1.02,208,199,231,53,23,30,49,25,24,25,13,12,+7,+2,+5,76%,81%,72%,137,133,141,28%,32%,24%,9,2,7,2,0,2
157,https://vlr.gg/player/23062/surf,2025-01-30 07:00:00,0.75,1.23,1.00,208,168,241,50,19,31,46,24,22,12,6,6,+5,+1,+4,71%,59%,81%,129,105,150,36%,32%,40%,9,4,5,4,3,1
158,https://vlr.gg/player/46102/snappy,2025-01-30 07:00:00,0.56,1.00,0.79,209,188,220,46,20,26,52,29,23,16,6,10,-4,-5,+1,68%,63%,72%,121,107,134,20%,16%,24%,12,6,6,16,11,5
159,https://vlr.gg/player/37547/tbloy,2025-01-30 07:00:00,0.74,0.68,0.71,138,181,109,33,20,13,46,25,21,18,10,8,-3,-5,+2,74%,72%,75%,99,127,75,22%,20%,26%,4,0,4,7,5,2
160,https://vlr.gg/player/10769/nobita,2025-01-30 04:20:00,0.97,1.31,1.15,229,196,264,53,20,33,46,20,26,14,9,5,-5,-2,-3,67%,65%,69%,150,128,170,41%,43%,39%,7,3,4,12,5,7
161,https://vlr.gg/player/48431/kippei,2025-01-30 04:20:00,1.17,1.02,1.09,197,190,201,46,22,24,45,18,27,15,8,7,+4,+3,+1,73%,68%,77%,120,117,123,33%,33%,32%,6,3,3,2,0,2
162,https://vlr.gg/player/40726/gwangboong,2025-01-30 04:20:00,1.22,0.93,1.07,220,242,205,53,27,26,47,21,26,9,4,5,+1,0,+1,77%,84%,71%,139,155,124,32%,36%,28%,7,2,5,6,2,4
163,https://vlr.gg/player/29840/yuran,2025-01-30 04:20:00,0.81,0.78,0.79,153,167,141,33,18,15,49,21,28,20,9,11,-2,+1,-3,64%,65%,63%,101,99,104,24%,25%,22%,6,6,0,8,5,3
164,https://vlr.gg/player/10628/misaya,2025-01-30 04:20:00,0.89,0.53,0.70,141,138,147,32,15,17,51,20,31,26,13,13,-2,-1,-1,61%,68%,54%,91,85,96,16%,17%,16%,4,1,3,6,2,4
165,https://vlr.gg/player/6673/gon,2025-01-30 04:20:00,1.15,1.06,1.11,191,183,203,49,23,26,40,20,20,26,21,5,-4,-3,-1,79%,83%,74%,131,126,137,41%,40%,42%,3,0,3,7,3,4
166,https://vlr.gg/player/34827/hals,2025-01-30 04:20:00,0.99,1.19,1.09,216,213,212,51,26,25,46,25,21,16,8,8,+4,0,+4,68%,69%,68%,132,136,127,24%,29%,16%,13,7,6,9,7,2
167,https://vlr.gg/player/12979/mrtenzouez,2025-01-30 04:20:00,1.17,0.99,1.08,187,195,175,47,26,21,42,22,20,17,11,6,+3,+4,-1,71%,80%,61%,121,115,128,45%,53%,36%,6,4,2,3,0,3
168,https://vlr.gg/player/43064/aace,2025-01-30 04:20:00,1.11,0.80,0.97,203,213,198,53,26,27,44,22,22,15,9,6,+2,+3,-1,64%,60%,68%,131,143,119,32%,31%,33%,9,7,2,7,4,3
169,https://vlr.gg/player/1970/neth,2025-01-30 04:20:00,0.94,0.56,0.76,134,163,103,37,22,15,45,23,22,25,13,12,-1,+1,-2,68%,66%,71%,91,106,75,31%,27%,39%,3,2,1,4,1,3
170,https://vlr.gg/player/49571/paganus,2025-01-29 19:20:00,0.84,1.08,0.99,209,179,232,28,8,20,30,12,18,12,5,7,0,0,0,68%,71%,67%,136,125,143,42%,38%,45%,2,0,2,2,0,2
171,https://vlr.gg/player/24013/navarro,2025-01-29 19:20:00,0.77,0.73,0.75,185,187,172,23,10,13,30,11,19,11,2,9,+2,+1,+1,79%,79%,79%,120,126,117,39%,47%,34%,4,2,2,2,1,1
172,https://vlr.gg/player/17669/pompz,2025-01-29 19:20:00,0.55,0.87,0.72,165,130,203,23,6,17,32,12,20,9,3,6,-1,0,-1,63%,50%,71%,104,66,126,27%,18%,31%,6,2,4,7,2,5
173,https://vlr.gg/player/46891/sventy,2025-01-29 19:20:00,0.64,0.75,0.71,160,153,169,22,7,15,34,12,22,5,3,2,+2,+2,0,63%,79%,54%,105,101,108,25%,26%,24%,6,4,2,4,2,2
174,https://vlr.gg/player/1328/javiierh,2025-01-29 19:20:00,0.57,0.73,0.67,176,169,185,23,7,16,33,13,20,3,1,2,-1,-1,0,66%,57%,71%,122,123,121,15%,17%,14%,2,0,2,3,1,2
175,https://vlr.gg/player/10557/darker,2025-01-29 19:20:00,1.70,1.79,1.73,347,341,326,48,30,18,25,17,8,11,8,3,+5,+2,+3,89%,88%,93%,222,232,205,37%,34%,45%,6,3,3,1,1,0
176,https://vlr.gg/player/9354/cebando,2025-01-29 19:20:00,1.08,1.62,1.28,185,150,257,25,14,11,19,14,5,23,9,14,0,0,0,79%,71%,93%,119,95,161,43%,54%,36%,2,1,1,2,1,1
177,https://vlr.gg/player/7616/feniz,2025-01-29 19:20:00,0.86,1.72,1.18,194,171,248,31,15,16,22,16,6,7,4,3,-1,-1,0,84%,79%,93%,128,110,159,27%,30%,24%,1,1,0,2,2,0
178,https://vlr.gg/player/3983/virtyy,2025-01-29 19:20:00,1.09,0.91,1.02,260,291,199,33,24,9,30,20,10,8,4,4,-4,-1,-3,74%,79%,64%,160,176,132,18%,24%,6%,8,6,2,12,7,5
179,https://vlr.gg/player/8056/mited,2025-01-29 19:20:00,0.94,0.81,0.89,154,158,129,22,16,6,23,14,9,9,3,6,-2,0,-2,71%,67%,79%,109,114,101,25%,31%,15%,1,1,0,3,1,2
180,https://vlr.gg/player/45921/v1bz,2025-01-29 17:00:00,1.29,1.31,1.30,241,244,241,39,19,20,30,13,17,26,9,17,+2,0,+2,83%,86%,79%,148,135,160,30%,27%,32%,3,1,2,1,1,0
181,https://vlr.gg/player/44075/dedmos,2025-01-29 17:00:00,1.30,1.20,1.24,201,238,168,36,19,17,29,16,13,22,11,11,+1,+1,0,78%,77%,79%,135,163,110,32%,33%,29%,4,3,1,3,2,1
182,https://vlr.gg/player/35619/sxnti,2025-01-29 17:00:00,0.94,0.93,0.94,197,196,200,32,17,15,35,16,19,10,3,7,0,0,0,83%,82%,83%,130,120,139,35%,33%,36%,3,1,2,3,1,2
183,https://vlr.gg/player/50835/arbex,2025-01-29 17:00:00,0.84,0.93,0.89,176,148,207,30,12,18,34,16,18,13,9,4,-4,+1,-5,65%,64%,67%,121,94,147,50%,43%,54%,4,2,2,8,1,7
184,https://vlr.gg/player/21428/crunch,2025-01-29 17:00:00,0.95,0.80,0.87,216,212,220,33,15,18,37,16,21,13,7,6,-1,-4,+3,67%,68%,67%,139,140,138,36%,34%,39%,8,3,5,9,7,2
185,https://vlr.gg/player/8790/mininiwde,2025-01-29 17:00:00,0.86,1.56,1.19,247,209,285,40,18,22,33,19,14,19,9,10,+2,-1,+3,83%,75%,91%,158,132,187,31%,33%,29%,3,0,3,1,1,0
186,https://vlr.gg/player/36405/jrmzie,2025-01-29 17:00:00,1.29,0.67,0.99,200,253,144,33,22,11,31,16,15,6,3,3,+1,+4,-3,74%,83%,64%,134,156,110,25%,41%,15%,6,6,0,5,2,3
187,https://vlr.gg/player/17694/prask,2025-01-29 17:00:00,1.11,0.78,0.95,189,189,191,31,18,13,33,15,18,14,5,9,-2,-1,-1,74%,79%,68%,125,122,130,36%,48%,27%,3,2,1,5,3,2
188,https://vlr.gg/player/8792/xhowi,2025-01-29 17:00:00,0.66,1.18,0.91,192,140,245,30,11,19,35,18,17,20,12,8,+1,-2,+3,78%,75%,82%,125,85,169,41%,50%,36%,5,1,4,4,3,1
189,https://vlr.gg/player/2497/dobsha,2025-01-29 17:00:00,0.93,0.65,0.80,196,251,134,31,19,12,38,20,18,6,4,2,0,0,0,70%,71%,68%,135,176,90,19%,20%,18%,7,3,4,7,3,4
190,https://vlr.gg/player/12793/xeus,2025-01-29 14:25:00,0.81,1.15,0.97,257,237,285,34,16,18,34,18,16,5,2,3,-1,0,-1,59%,55%,65%,151,155,146,32%,30%,34%,6,4,2,7,4,3
191,https://vlr.gg/player/8044/mrfalin,2025-01-29 14:25:00,0.77,0.77,0.77,154,177,122,19,12,7,28,16,12,9,1,8,-5,-2,-3,59%,50%,71%,104,106,101,17%,18%,15%,1,1,0,6,3,3
192,https://vlr.gg/player/8369/yetujey,2025-01-29 14:25:00,0.65,0.90,0.76,178,180,185,22,12,10,31,19,12,6,3,3,+1,+2,-1,76%,75%,76%,121,112,132,23%,23%,24%,4,3,1,3,1,2
193,https://vlr.gg/player/1139/qraxs,2025-01-29 14:25:00,0.44,0.93,0.66,151,112,198,18,6,12,29,16,13,7,4,3,-4,-3,-1,65%,65%,65%,107,91,126,21%,15%,27%,1,0,1,5,3,2
194,https://vlr.gg/player/6510/atakaptan,2025-01-29 14:25:00,0.65,0.68,0.66,123,116,135,16,8,8,31,17,14,15,6,9,-4,-1,-3,68%,60%,76%,78,70,87,32%,27%,36%,0,0,0,4,1,3
195,https://vlr.gg/player/5022/derke,2025-01-29 14:25:00,1.45,1.62,1.54,349,366,324,44,20,24,25,13,12,7,4,3,+8,+4,+4,76%,71%,80%,225,243,209,24%,17%,34%,14,7,7,6,3,3
196,https://vlr.gg/player/11134/kicks,2025-01-29 14:25:00,0.98,1.86,1.46,264,195,323,36,12,24,23,13,10,22,9,13,+4,+1,+3,89%,88%,90%,166,132,194,28%,29%,27%,4,1,3,0,0,0
197,https://vlr.gg/player/312/sayf,2025-01-29 14:25:00,1.13,1.26,1.20,199,208,196,29,13,16,19,10,9,11,4,7,+2,+3,-1,78%,71%,85%,139,131,146,34%,38%,31%,3,3,0,1,0,1
198,https://vlr.gg/player/8447/less,2025-01-29 14:25:00,1.19,1.11,1.14,204,202,205,27,14,13,20,9,11,9,2,7,-2,+1,-3,70%,65%,75%,137,124,148,27%,24%,29%,1,1,0,3,0,3
199,https://vlr.gg/player/2168/trexx,2025-01-29 14:25:00,0.92,0.94,0.93,149,146,149,17,8,9,22,10,12,17,8,9,+1,0,+1,73%,76%,70%,99,90,106,14%,8%,18%,3,1,2,2,1,1
200,https://vlr.gg/player/34002/lukey,2025-01-29 14:10:00,1.77,1.41,1.58,334,349,323,43,21,22,22,8,14,6,1,5,+8,+3,+5,83%,75%,89%,207,200,213,25%,25%,25%,12,5,7,4,2,2
201,https://vlr.gg/player/31298/luca,2025-01-29 14:10:00,1.19,1.38,1.29,208,148,254,28,9,19,16,5,11,8,2,6,0,-1,+1,80%,81%,79%,145,108,176,24%,25%,23%,3,1,2,3,2,1
202,https://vlr.gg/player/12372/szoren,2025-01-29 14:10:00,1.45,1.04,1.23,235,237,224,31,15,16,21,7,14,12,7,5,+3,+1,+2,89%,88%,89%,148,139,156,32%,34%,30%,3,1,2,0,0,0
203,https://vlr.gg/player/4214/eso177,2025-01-29 14:10:00,1.03,1.22,1.13,195,152,229,23,7,16,17,6,11,21,8,13,+1,-2,+3,83%,88%,79%,130,108,148,17%,13%,20%,3,0,3,2,2,0
204,https://vlr.gg/player/5566/jeyj7y,2025-01-29 14:10:00,1.30,0.72,0.99,146,176,116,18,10,8,17,5,12,11,7,4,-1,-1,0,83%,88%,79%,96,113,82,22%,30%,15%,2,1,1,3,2,1
205,https://vlr.gg/player/6038/b3astm0d3,2025-01-29 14:10:00,1.23,0.57,0.93,191,249,124,22,16,6,27,16,11,9,6,3,-1,-1,0,69%,63%,75%,141,178,97,35%,30%,58%,3,2,1,4,3,1
206,https://vlr.gg/player/30585/pashalime,2025-01-29 14:10:00,1.01,0.80,0.91,186,208,164,23,14,9,29,16,13,2,1,1,+2,-1,+3,69%,74%,63%,123,143,99,33%,35%,29%,6,1,5,4,2,2
207,https://vlr.gg/player/2107/russ,2025-01-29 14:10:00,1.12,0.56,0.86,216,263,153,26,19,7,31,16,15,6,4,2,-1,+1,-2,63%,74%,50%,143,167,114,26%,34%,16%,2,1,1,3,0,3
208,https://vlr.gg/player/10429/luvjix,2025-01-29 14:10:00,0.45,0.64,0.54,124,117,136,13,6,7,27,16,11,8,6,2,-8,-9,+1,63%,63%,63%,82,81,82,29%,18%,47%,1,0,1,9,9,0
209,https://vlr.gg/player/8034/thenightche,2025-01-29 14:10:00,0.55,0.24,0.38,85,114,47,9,7,2,29,17,12,12,9,3,-3,-1,-2,60%,74%,44%,57,73,38,22%,24%,18%,0,0,0,3,1,2
210,https://vlr.gg/player/2701/maniek,2025-01-29 13:05:00,1.24,1.30,1.26,274,289,241,55,37,18,42,29,13,15,10,5,-1,-2,+1,75%,81%,63%,173,179,161,26%,26%,27%,10,8,2,11,10,1
211,https://vlr.gg/player/164/bzt,2025-01-29 13:05:00,1.23,0.85,1.10,189,200,170,39,27,12,35,22,13,11,10,1,-2,0,-2,71%,81%,53%,133,143,116,35%,36%,31%,1,1,0,3,1,2
212,https://vlr.gg/player/4525/stix,2025-01-29 13:05:00,1.23,0.76,1.07,174,199,127,35,27,8,32,20,12,21,16,5,0,+1,-1,75%,78%,68%,127,149,84,32%,30%,42%,3,2,1,3,1,2
213,https://vlr.gg/player/2525/szimpli,2025-01-29 13:05:00,0.64,1.37,0.89,193,156,273,38,20,18,42,28,14,11,6,5,-3,-7,+4,69%,64%,79%,128,103,177,32%,31%,33%,8,2,6,11,9,2
214,https://vlr.gg/player/10378/almo,2025-01-29 13:05:00,0.74,1.00,0.83,175,174,173,34,22,12,40,28,12,13,9,4,+1,0,+1,56%,58%,53%,120,122,118,32%,29%,36%,3,1,2,2,1,1
215,https://vlr.gg/player/6101/999kvmil,2025-01-29 13:05:00,1.52,1.30,1.38,242,252,239,50,17,33,34,9,25,20,10,10,+4,0,+4,76%,84%,72%,151,143,156,27%,23%,29%,6,1,5,2,1,1
216,https://vlr.gg/player/8440/puggy,2025-01-29 13:05:00,0.68,1.39,1.14,223,163,258,41,10,31,38,15,23,19,6,13,+2,-1,+3,69%,58%,75%,155,117,175,26%,18%,30%,5,1,4,3,2,1
217,https://vlr.gg/player/15491/maximn,2025-01-29 13:05:00,0.96,0.78,0.84,166,185,157,33,13,20,42,13,29,14,4,10,-2,-1,-1,71%,63%,75%,118,122,115,24%,31%,20%,3,1,2,5,2,3
218,https://vlr.gg/player/13024/vuubit,2025-01-29 13:05:00,0.91,0.73,0.79,195,196,191,37,14,23,43,14,29,15,5,10,+3,+1,+2,67%,79%,61%,125,130,122,39%,58%,31%,11,3,8,8,2,6
219,https://vlr.gg/player/12471/kalkkuna,2025-01-29 13:05:00,0.48,0.82,0.70,161,146,171,30,10,20,44,17,27,13,2,11,-2,-2,0,65%,63%,67%,104,91,112,29%,21%,33%,5,2,3,7,4,3
220,https://vlr.gg/player/27784/c4pee,2025-01-29 13:05:00,0.79,1.42,1.13,244,182,291,34,13,21,34,16,18,8,1,7,+4,-1,+5,63%,47%,77%,159,120,192,36%,44%,33%,8,3,5,4,4,0
221,https://vlr.gg/player/20591/eagle,2025-01-29 13:05:00,0.83,0.83,0.83,182,182,184,25,10,15,33,15,18,10,6,4,+4,+2,+2,61%,58%,64%,114,112,115,20%,22%,19%,4,2,2,0,0,0
222,https://vlr.gg/player/2691/nausea,2025-01-29 13:05:00,0.79,0.62,0.69,144,141,148,21,9,12,33,15,18,16,6,10,-1,-1,0,63%,68%,59%,82,80,85,24%,29%,20%,2,0,2,3,1,2
223,https://vlr.gg/player/9505/paulus,2025-01-29 13:05:00,0.77,0.58,0.67,169,201,149,23,13,10,36,17,19,7,4,3,-4,-2,-2,66%,74%,59%,111,117,105,14%,17%,13%,3,2,1,7,4,3
224,https://vlr.gg/player/1365/nixoon,2025-01-29 13:05:00,0.85,0.40,0.61,125,155,108,17,10,7,34,14,20,13,4,9,-8,-3,-5,54%,53%,55%,82,99,68,16%,21%,12%,1,0,1,9,3,6
225,https://vlr.gg/player/50813/gsr,2025-01-29 13:05:00,1.68,2.05,1.85,368,372,364,55,29,26,23,13,10,20,12,8,+6,+5,+1,90%,95%,84%,234,228,241,38%,35%,41%,7,6,1,1,1,0
226,https://vlr.gg/player/28948/ninja,2025-01-29 13:05:00,1.49,1.17,1.34,220,254,193,34,22,12,21,10,11,15,6,9,+2,+2,0,85%,86%,84%,168,186,146,27%,27%,26%,3,2,1,1,0,1
227,https://vlr.gg/player/40750/donatellooo,2025-01-29 13:05:00,0.91,1.07,0.99,231,201,269,35,16,19,31,17,14,5,4,1,-1,-3,+2,68%,68%,68%,154,139,172,42%,37%,49%,9,2,7,10,5,5
228,https://vlr.gg/player/19526/rexxtoned,2025-01-29 13:05:00,1.07,0.81,0.95,143,149,133,22,14,8,22,12,10,9,3,6,-1,-1,0,78%,95%,58%,99,94,106,46%,52%,41%,2,1,1,3,2,1
229,https://vlr.gg/player/7105/qpert,2025-01-29 13:05:00,0.89,0.96,0.93,169,162,168,24,12,12,24,13,11,18,7,11,-1,-3,+2,85%,86%,84%,113,114,111,24%,19%,33%,2,0,2,3,3,0
230,https://vlr.gg/player/9780/jamppi,2025-01-29 12:00:00,1.32,1.17,1.24,265,303,236,37,19,18,35,16,19,18,10,8,+3,+1,+2,86%,90%,83%,187,209,168,25%,20%,33%,5,1,4,2,0,2
231,https://vlr.gg/player/5554/profek,2025-01-29 12:00:00,1.05,0.86,0.95,164,142,179,24,9,15,32,11,21,24,13,11,-2,-1,-1,66%,70%,63%,110,97,120,32%,43%,27%,2,0,2,4,1,3
232,https://vlr.gg/player/5568/sociablee,2025-01-29 12:00:00,0.90,0.81,0.85,181,166,189,28,14,14,34,13,21,11,3,8,-7,-5,-2,66%,65%,67%,118,103,130,21%,17%,24%,2,1,1,9,6,3
233,https://vlr.gg/player/172/vakk,2025-01-29 12:00:00,0.76,0.72,0.74,140,163,125,23,12,11,33,15,18,7,5,2,+1,+1,0,66%,70%,63%,87,96,80,43%,58%,32%,2,1,1,1,0,1
234,https://vlr.gg/player/20144/lewn,2025-01-29 12:00:00,0.73,0.71,0.72,167,171,166,27,12,15,35,14,21,6,3,3,-9,-6,-3,57%,60%,54%,111,109,112,26%,24%,28%,4,2,2,13,8,5
235,https://vlr.gg/player/21328/wo0t,2025-01-29 12:00:00,1.19,1.29,1.24,232,231,239,36,20,16,25,14,11,24,13,11,+4,+3,+1,84%,79%,90%,153,145,162,42%,48%,37%,6,3,3,2,0,2
236,https://vlr.gg/player/1144/boo,2025-01-29 12:00:00,1.57,0.84,1.24,213,278,135,33,24,9,26,13,13,30,22,8,+1,0,+1,82%,92%,70%,144,195,83,33%,37%,23%,2,1,1,1,1,0
237,https://vlr.gg/player/29873/benjyfishy,2025-01-29 12:00:00,1.37,0.94,1.18,215,242,187,34,22,12,27,13,14,10,4,6,+1,0,+1,77%,83%,70%,149,163,132,41%,47%,35%,3,1,2,2,1,1
238,https://vlr.gg/player/10971/riens,2025-01-29 12:00:00,1.19,1.02,1.12,218,224,202,35,20,15,29,15,14,11,7,4,+6,+3,+3,86%,88%,85%,143,157,127,47%,47%,46%,9,6,3,3,3,0
239,https://vlr.gg/player/18350/miniboo,2025-01-29 12:00:00,0.67,1.25,0.93,194,160,232,31,14,17,32,18,14,7,3,4,+2,-2,+4,68%,67%,70%,132,117,150,26%,34%,19%,9,3,6,7,5,2
240,https://vlr.gg/player/42702/krizz,2025-01-29 11:00:00,1.77,1.56,1.68,267,290,234,34,22,12,11,5,6,8,1,7,+5,+5,0,88%,89%,87%,171,180,158,34%,45%,24%,5,5,0,0,0,0
241,https://vlr.gg/player/10448/kozok,2025-01-29 11:00:00,1.60,1.17,1.41,216,216,238,28,16,12,17,6,11,21,14,7,+4,+3,+1,82%,95%,67%,143,132,157,24%,26%,22%,5,3,2,1,0,1
242,https://vlr.gg/player/36748/czester,2025-01-29 11:00:00,1.26,1.42,1.33,207,202,223,27,14,13,17,9,8,7,5,2,+2,+1,+1,82%,95%,67%,137,137,137,43%,46%,39%,3,1,2,1,0,1
243,https://vlr.gg/player/9556/demek,2025-01-29 11:00:00,1.47,0.58,1.08,274,314,201,33,24,9,24,10,14,8,4,4,+2,+1,+1,85%,95%,73%,172,212,122,18%,22%,11%,8,5,3,6,4,2
244,https://vlr.gg/player/9557/nefi,2025-01-29 11:00:00,1.08,1.08,1.08,179,152,201,23,10,13,18,8,10,14,10,4,-3,-1,-2,85%,95%,73%,96,85,110,20%,13%,28%,1,0,1,4,1,3
245,https://vlr.gg/player/42550/merix,2025-01-29 11:00:00,1.34,0.77,1.02,192,225,178,23,13,10,26,9,17,9,4,5,+1,+1,0,71%,80%,63%,131,142,122,48%,46%,50%,3,1,2,2,0,2
246,https://vlr.gg/player/45834/aidan,2025-01-29 11:00:00,1.01,0.46,0.70,176,263,128,23,14,9,29,12,17,2,1,1,-1,+1,-2,56%,67%,47%,121,167,85,22%,25%,19%,2,1,1,3,0,3
247,https://vlr.gg/player/31300/drog,2025-01-29 11:00:00,0.93,0.41,0.64,141,203,97,15,10,5,29,11,18,8,4,4,-3,-2,-1,50%,67%,37%,105,148,71,26%,25%,29%,0,0,0,3,2,1
248,https://vlr.gg/player/20443/br-di,2025-01-29 11:00:00,0.48,0.71,0.59,120,113,131,13,5,8,30,13,17,16,8,8,-3,-2,-1,50%,53%,47%,83,77,88,24%,37%,17%,2,1,1,5,3,2
249,https://vlr.gg/player/50814/fractioned,2025-01-29 11:00:00,0.42,0.39,0.40,126,154,98,13,7,6,31,14,17,2,1,1,-4,+1,-5,38%,53%,26%,85,110,66,26%,24%,28%,5,4,1,9,3,6
250,https://vlr.gg/player/1369/doma,2025-01-29 11:00:00,1.21,1.18,1.19,240,200,254,57,23,34,45,19,26,21,13,8,+4,0,+4,77%,74%,79%,145,126,160,38%,38%,39%,6,2,4,2,2,0
251,https://vlr.gg/player/2700/jas,2025-01-29 11:00:00,1.04,1.10,1.08,239,245,240,59,27,32,49,25,24,10,4,6,-8,-4,-4,68%,61%,74%,154,158,152,27%,34%,21%,10,4,6,18,8,10
252,https://vlr.gg/player/2894/kiles,2025-01-29 11:00:00,0.90,1.14,1.03,178,171,181,47,19,28,42,22,20,13,6,7,-2,-2,0,70%,52%,84%,115,113,117,21%,18%,24%,2,1,1,4,3,1
253,https://vlr.gg/player/1616/starki,2025-01-29 11:00:00,1.18,0.83,0.99,172,214,143,41,23,18,43,20,23,42,23,19,0,+2,-2,77%,77%,76%,112,126,100,24%,21%,26%,6,3,3,6,1,5
254,https://vlr.gg/player/562/zeek,2025-01-29 11:00:00,0.80,0.97,0.89,192,177,206,47,18,29,51,25,26,25,15,10,-7,-3,-4,67%,71%,63%,121,112,129,36%,26%,44%,4,2,2,11,5,6
255,https://vlr.gg/player/8593/grmekista,2025-01-29 11:00:00,1.29,1.02,1.17,199,203,203,48,27,21,42,21,21,28,14,14,+3,+2,+1,78%,76%,81%,133,133,134,30%,35%,25%,7,4,3,4,2,2
256,https://vlr.gg/player/4537/tajrex,2025-01-29 11:00:00,1.00,1.00,1.00,193,184,216,46,24,22,53,29,24,29,16,13,+5,+1,+4,70%,71%,68%,133,123,144,27%,27%,26%,8,3,5,3,2,1
257,https://vlr.gg/player/25906/alexiiik,2025-01-29 11:00:00,0.99,0.91,0.95,222,254,203,55,34,21,55,34,21,4,3,1,+6,+4,+2,64%,55%,74%,141,154,126,21%,21%,20%,19,13,6,13,9,4
258,https://vlr.gg/player/3839/prti,2025-01-29 11:00:00,0.89,0.83,0.87,193,182,205,45,23,22,55,29,26,13,7,6,+1,+2,-1,64%,66%,61%,141,143,138,25%,22%,30%,5,2,3,4,0,4
259,https://vlr.gg/player/37840/msh,2025-01-29 11:00:00,0.52,1.15,0.80,147,82,204,36,11,25,46,28,18,5,3,2,-2,-3,+1,62%,58%,68%,95,66,131,39%,35%,42%,2,0,2,4,3,1
260,https://vlr.gg/player/33974/appa,2025-01-29 11:00:00,0.91,1.26,1.10,257,239,272,38,16,22,35,16,19,6,3,3,+8,+3,+5,72%,79%,67%,153,137,166,18%,11%,26%,11,4,7,3,1,2
261,https://vlr.gg/player/18384/bully,2025-01-29 11:00:00,1.53,0.67,1.05,221,284,172,35,20,15,28,11,17,4,3,1,+5,+4,+1,70%,74%,67%,142,191,104,29%,22%,39%,8,5,3,3,1,2
262,https://vlr.gg/player/27789/deyten,2025-01-29 11:00:00,0.80,0.98,0.90,158,118,188,25,8,17,30,11,19,16,7,9,-3,-1,-2,74%,74%,75%,102,80,120,28%,26%,29%,2,2,0,5,3,2
263,https://vlr.gg/player/47270/darkwinjett,2025-01-29 11:00:00,0.90,0.87,0.88,180,158,197,27,12,15,32,11,21,17,5,12,-3,-2,-1,63%,58%,67%,130,113,143,25%,20%,28%,2,0,2,5,2,3
264,https://vlr.gg/player/3934/eleo,2025-01-29 11:00:00,0.94,0.64,0.77,151,164,141,22,11,11,33,12,21,15,6,9,-4,-1,-3,63%,79%,50%,111,124,100,26%,26%,25%,0,0,0,4,1,3
265,https://vlr.gg/player/39682/wanzeru,2025-01-29 11:00:00,1.65,1.39,1.53,329,356,295,50,31,19,28,15,13,8,4,4,-1,0,-1,74%,75%,74%,207,228,180,27%,25%,31%,9,7,2,10,7,3
266,https://vlr.gg/player/33732/nunmeister,2025-01-29 11:00:00,1.03,1.32,1.16,219,220,218,34,20,14,28,16,12,9,5,4,+1,0,+1,70%,71%,68%,148,148,148,39%,49%,28%,3,1,2,2,1,1
267,https://vlr.gg/player/7231/kya,2025-01-29 11:00:00,0.95,0.94,0.95,187,207,163,31,18,13,30,18,12,5,4,1,-6,-2,-4,77%,88%,63%,130,144,114,27%,23%,33%,3,2,1,9,4,5
268,https://vlr.gg/player/6969/gunners,2025-01-29 11:00:00,1.08,0.63,0.88,171,215,114,24,18,6,30,16,14,21,13,8,+3,+2,+1,70%,75%,63%,110,136,78,24%,25%,23%,4,2,2,1,0,1
269,https://vlr.gg/player/2832/patix,2025-01-29 11:00:00,0.80,0.60,0.71,145,126,168,19,10,9,31,15,16,19,14,5,0,0,0,70%,83%,53%,98,86,112,37%,28%,45%,1,0,1,1,0,1
270,https://vlr.gg/player/16953/zynd,2025-01-29 08:00:00,1.83,0.97,1.34,286,411,203,44,28,16,32,12,20,8,3,5,+5,+3,+2,76%,83%,71%,197,266,144,30%,34%,23%,6,3,3,1,0,1
271,https://vlr.gg/player/7746/kevzii,2025-01-29 08:00:00,1.04,1.22,1.15,225,165,289,34,10,24,29,9,20,10,8,2,-1,+1,-2,76%,83%,71%,157,115,189,23%,16%,27%,2,1,1,3,0,3
272,https://vlr.gg/player/9737/kakarot,2025-01-29 08:00:00,0.82,0.83,0.82,186,163,198,25,9,16,32,12,20,7,5,2,+2,+3,-1,69%,83%,58%,116,104,125,17%,12%,21%,7,4,3,5,1,4
273,https://vlr.gg/player/9747/emman,2025-01-29 08:00:00,0.70,0.64,0.67,157,156,154,23,11,12,33,12,21,10,4,6,-7,-4,-3,71%,83%,63%,101,101,102,30%,25%,33%,4,2,2,11,6,5
274,https://vlr.gg/player/11578/hotsauz,2025-01-29 08:00:00,1.04,0.29,0.60,129,194,91,19,13,6,33,11,22,14,7,7,-1,+1,-2,64%,89%,46%,90,121,67,23%,24%,22%,1,1,0,2,0,2
275,https://vlr.gg/player/23710/gotten,2025-01-29 08:00:00,1.06,1.54,1.27,224,199,266,37,19,18,28,15,13,10,6,4,-1,+1,-2,74%,79%,67%,140,118,169,39%,41%,37%,4,3,1,5,2,3
276,https://vlr.gg/player/2346/cud,2025-01-29 08:00:00,1.36,0.93,1.18,250,280,206,39,26,13,29,16,13,5,3,2,0,0,0,74%,75%,72%,153,177,120,40%,39%,43%,5,3,2,5,3,2
277,https://vlr.gg/player/1745/adrnking,2025-01-29 08:00:00,1.37,0.71,1.09,172,204,123,27,18,9,26,12,14,19,15,4,+1,+1,0,69%,79%,56%,113,142,75,33%,31%,39%,2,1,1,1,0,1
278,https://vlr.gg/player/16852/nakya,2025-01-29 08:00:00,1.15,0.75,0.98,262,292,192,34,23,11,34,18,16,13,8,5,+3,+4,-1,67%,75%,56%,171,201,131,26%,22%,33%,9,7,2,6,3,3
279,https://vlr.gg/player/9263/sayoo,2025-01-29 08:00:00,1.15,0.48,0.86,153,199,102,22,17,5,28,13,15,13,8,5,-1,0,-1,74%,75%,72%,107,132,74,21%,26%,13%,2,1,1,3,1,2
280,https://vlr.gg/player/37057/woody,2025-01-29 06:00:00,1.34,1.12,1.23,234,241,227,42,22,20,35,16,19,14,10,4,+8,+4,+4,80%,80%,79%,170,188,151,35%,33%,37%,8,4,4,0,0,0
281,https://vlr.gg/player/36685/splash,2025-01-29 06:00:00,1.29,1.11,1.20,242,250,238,44,24,20,35,18,17,11,6,5,+7,+2,+5,82%,88%,75%,159,160,158,27%,22%,33%,9,3,6,2,1,1
282,https://vlr.gg/player/7049/natz,2025-01-29 06:00:00,1.21,1.18,1.19,231,229,235,39,21,18,32,16,16,20,13,7,+4,+2,+2,71%,68%,75%,159,151,167,31%,30%,33%,7,4,3,3,2,1
283,https://vlr.gg/player/7783/zhar,2025-01-29 06:00:00,0.97,1.09,1.03,142,123,163,22,9,13,27,13,14,35,20,15,-1,-2,+1,82%,92%,71%,98,78,119,15%,7%,20%,1,0,1,2,2,0
284,https://vlr.gg/player/26826/6ixkey,2025-01-29 06:00:00,1.08,0.71,0.90,216,258,173,37,22,15,39,21,18,11,6,5,+3,+5,-2,69%,72%,67%,135,163,105,16%,15%,18%,10,7,3,7,2,5
285,https://vlr.gg/player/45876/fixy,2025-01-29 06:00:00,0.97,1.20,1.09,261,219,302,46,19,27,40,18,22,7,5,2,-7,-6,-1,69%,75%,64%,166,144,186,22%,17%,26%,3,0,3,10,6,4
286,https://vlr.gg/player/5886/flaring,2025-01-29 06:00:00,0.91,1.12,1.02,201,159,237,34,14,20,36,17,19,17,8,9,-2,0,-2,73%,71%,76%,124,98,149,31%,18%,44%,2,2,0,4,2,2
287,https://vlr.gg/player/14209/suka,2025-01-29 06:00:00,1.29,0.65,0.96,184,244,129,29,19,10,34,15,19,32,16,16,-2,+1,-3,73%,79%,68%,123,156,92,21%,23%,19%,1,1,0,3,0,3
288,https://vlr.gg/player/7443/riza,2025-01-29 06:00:00,1.12,0.78,0.95,195,226,162,33,19,14,37,18,19,15,8,7,-5,-3,-2,69%,75%,64%,122,135,111,23%,19%,29%,5,3,2,10,6,4
289,https://vlr.gg/player/7513/markl,2025-01-29 06:00:00,0.60,0.75,0.68,162,161,161,26,13,13,37,18,19,8,3,5,-5,-2,-3,61%,58%,64%,113,108,118,17%,16%,17%,3,1,2,8,3,5
290,https://vlr.gg/player/23971/ask,2025-01-29 06:00:00,1.43,1.05,1.28,231,256,184,32,23,9,23,13,10,18,13,5,0,-1,+1,85%,88%,81%,163,179,139,21%,18%,27%,1,0,1,1,1,0
291,https://vlr.gg/player/686/tonbo,2025-01-29 06:00:00,1.31,1.14,1.24,228,254,189,31,21,10,24,15,9,14,11,3,-2,-2,0,88%,92%,81%,160,173,141,28%,30%,23%,3,0,3,5,2,3
292,https://vlr.gg/player/34776/absol,2025-01-29 06:00:00,0.87,1.66,1.18,250,213,318,36,17,19,28,17,11,7,4,3,+3,-3,+6,80%,75%,88%,155,134,185,18%,22%,14%,7,1,6,4,4,0
293,https://vlr.gg/player/1395/tennn,2025-01-29 06:00:00,0.89,0.86,0.88,211,226,186,32,21,11,29,18,11,12,10,2,+1,0,+1,75%,75%,75%,139,156,115,35%,35%,36%,5,4,1,4,4,0
294,https://vlr.gg/player/1003/reita,2025-01-29 06:00:00,0.81,0.82,0.82,200,201,199,30,18,12,31,19,12,12,4,8,-2,-2,0,75%,75%,75%,125,123,129,27%,22%,34%,4,3,1,6,5,1
295,https://vlr.gg/player/49327/lucky,2025-01-29 06:00:00,1.15,1.12,1.13,232,254,214,32,14,18,30,12,18,8,2,6,+1,-2,+3,75%,69%,79%,141,163,127,40%,40%,40%,6,1,5,5,3,2
296,https://vlr.gg/player/34775/sota,2025-01-29 06:00:00,1.28,0.96,1.09,209,220,202,30,14,16,30,10,20,22,4,18,+1,0,+1,83%,81%,83%,128,150,114,41%,60%,30%,4,1,3,3,1,2
297,https://vlr.gg/player/49326/mimi,2025-01-29 06:00:00,0.56,1.32,1.01,231,142,288,30,7,23,35,13,22,8,2,6,0,-4,+4,70%,50%,83%,154,96,192,20%,26%,18%,7,1,6,7,5,2
298,https://vlr.gg/player/51142/kuro,2025-01-29 06:00:00,0.84,0.82,0.83,175,183,169,21,9,12,32,12,20,9,2,7,+2,+1,+1,80%,81%,79%,123,124,123,35%,27%,41%,3,1,2,1,0,1
299,https://vlr.gg/player/34717/taru,2025-01-29 06:00:00,0.32,0.75,0.58,134,102,158,17,4,13,34,14,20,17,7,10,-4,-3,-1,65%,50%,75%,82,70,91,20%,11%,28%,0,0,0,4,3,1
300,https://vlr.gg/player/4477/lob,2025-01-29 02:00:00,1.22,1.43,1.31,225,203,249,46,24,22,37,23,14,39,21,18,+3,0,+3,89%,83%,96%,143,137,152,24%,29%,19%,7,2,5,4,2,2
301,https://vlr.gg/player/7745/yoshiii,2025-01-29 02:00:00,1.02,1.62,1.27,238,213,277,54,26,28,38,26,12,19,11,8,+5,+3,+2,76%,69%,85%,163,141,194,35%,28%,42%,6,4,2,1,1,0
302,https://vlr.gg/player/687/zepher,2025-01-29 02:00:00,1.09,1.31,1.18,271,254,272,56,32,24,42,27,15,13,6,7,+9,+5,+4,71%,67%,77%,175,175,174,21%,20%,22%,16,10,6,7,5,2
303,https://vlr.gg/player/6700/anthem,2025-01-29 02:00:00,0.98,1.21,1.08,190,167,215,40,21,19,39,23,16,30,19,11,+1,-1,+2,71%,67%,77%,123,112,139,29%,28%,31%,4,1,3,3,2,1
304,https://vlr.gg/player/993/medusa,2025-01-29 02:00:00,0.88,0.86,0.87,152,172,131,33,21,12,38,24,14,14,3,11,-2,-1,-1,73%,69%,77%,108,121,91,31%,32%,28%,6,4,2,8,5,3
305,https://vlr.gg/player/45962/ken,2025-01-29 02:00:00,0.99,1.08,1.04,239,262,231,51,23,28,47,22,25,13,5,8,-3,-3,0,65%,54%,72%,156,154,158,18%,15%,21%,12,4,8,15,7,8
306,https://vlr.gg/player/1009/sakurai,2025-01-29 02:00:00,0.71,1.19,0.99,196,131,232,42,12,30,43,19,24,17,8,9,+1,-2,+3,66%,69%,64%,128,86,159,28%,30%,27%,5,1,4,4,3,1
307,https://vlr.gg/player/6702/bazz,2025-01-29 02:00:00,0.61,0.97,0.82,182,145,202,37,12,25,47,21,26,16,10,6,-7,-3,-4,63%,62%,64%,118,94,136,27%,32%,25%,3,2,1,10,5,5
308,https://vlr.gg/player/2400/brofeld,2025-01-29 02:00:00,0.76,0.70,0.73,149,148,150,35,16,19,47,21,26,13,4,9,-5,0,-5,65%,65%,64%,100,107,95,36%,33%,39%,2,1,1,7,1,6
309,https://vlr.gg/player/40736/kapi,2025-01-29 02:00:00,0.42,0.90,0.69,124,94,159,29,8,21,46,22,24,10,3,7,-2,-2,0,58%,42%,69%,83,67,95,23%,18%,27%,1,0,1,3,2,1
310,https://vlr.gg/player/69/thief,2025-01-28 18:40:00,1.45,0.87,1.22,231,275,178,50,36,14,40,25,15,13,8,5,+4,+3,+1,69%,67%,74%,154,177,117,32%,35%,28%,6,4,2,2,1,1
311,https://vlr.gg/player/8742/jakee,2025-01-28 18:40:00,0.89,1.46,1.11,219,176,297,47,22,25,41,26,15,20,12,8,-1,-1,0,66%,64%,70%,140,110,186,31%,27%,36%,6,4,2,7,5,2
312,https://vlr.gg/player/7716/penny,2025-01-28 18:40:00,0.64,1.50,0.98,204,163,273,41,18,23,43,30,13,21,13,8,+1,-1,+2,73%,69%,78%,131,106,170,21%,18%,28%,12,5,7,11,6,5
313,https://vlr.gg/player/739/fiziq,2025-01-28 18:40:00,0.78,0.98,0.86,167,159,172,35,20,15,42,26,16,12,5,7,-2,-1,-1,66%,64%,70%,109,108,110,27%,32%,22%,3,3,0,5,4,1
314,https://vlr.gg/player/733/stellar,2025-01-28 18:40:00,0.86,0.79,0.84,164,157,169,31,19,12,43,27,16,27,13,14,-3,-2,-1,68%,61%,78%,117,114,120,22%,21%,26%,2,1,1,5,3,2
315,https://vlr.gg/player/9094/kess,2025-01-28 18:40:00,1.35,1.19,1.25,238,235,248,54,21,33,40,16,24,15,7,8,+3,+4,-1,73%,74%,72%,147,129,157,30%,42%,26%,5,4,1,2,0,2
316,https://vlr.gg/player/48025/alym,2025-01-28 18:40:00,0.75,1.37,1.13,242,200,262,51,16,35,42,19,23,11,4,7,+8,-3,+11,75%,65%,81%,152,121,172,32%,38%,29%,13,2,11,5,5,0
317,https://vlr.gg/player/862/b0i,2025-01-28 18:40:00,0.76,1.18,1.01,195,186,191,37,13,24,40,20,20,25,6,19,-2,0,-2,73%,61%,81%,123,121,124,22%,20%,23%,5,2,3,7,2,5
318,https://vlr.gg/player/10053/fireballops,2025-01-28 18:40:00,0.51,1.13,0.89,178,107,236,36,9,27,44,19,25,15,3,12,0,0,0,71%,70%,72%,132,83,164,36%,36%,36%,4,2,2,4,2,2
319,https://vlr.gg/player/62/huynh,2025-01-28 18:40:00,1.12,0.64,0.83,147,198,120,31,16,15,38,15,23,22,11,11,-8,-2,-6,69%,78%,64%,102,140,78,19%,17%,22%,3,1,2,11,3,8
320,https://vlr.gg/player/20959/toozy,2025-01-28 18:00:00,1.23,1.23,1.23,195,212,190,40,23,17,33,17,16,48,25,23,-2,-1,-1,85%,83%,86%,131,126,136,35%,34%,35%,1,1,0,3,2,1
321,https://vlr.gg/player/21886/furbsa,2025-01-28 18:00:00,1.05,1.36,1.20,228,206,254,48,21,27,33,18,15,9,5,4,0,0,0,75%,73%,76%,150,151,150,33%,38%,29%,10,5,5,10,5,5
322,https://vlr.gg/player/8758/benjii,2025-01-28 18:00:00,1.33,0.93,1.14,226,248,193,50,30,20,40,19,21,12,4,8,+4,+6,-2,76%,73%,79%,152,174,130,37%,35%,38%,9,7,2,5,1,4
323,https://vlr.gg/player/14048/zerona,2025-01-28 18:00:00,1.02,0.95,0.99,211,239,181,44,23,21,43,24,19,18,13,5,+7,+5,+2,75%,80%,69%,144,165,123,26%,27%,25%,10,6,4,3,1,2
324,https://vlr.gg/player/8397/dip,2025-01-28 18:00:00,0.96,0.98,0.97,202,187,208,39,19,20,43,19,24,16,10,6,-2,-2,0,76%,83%,69%,135,137,134,19%,26%,13%,3,0,3,5,2,3
325,https://vlr.gg/player/754/nerve,2025-01-28 18:00:00,0.77,1.23,1.00,205,162,238,42,17,25,44,21,23,22,9,13,-4,-2,-2,75%,72%,77%,135,106,162,27%,32%,24%,2,1,1,6,3,3
326,https://vlr.gg/player/29893/timotino,2025-01-28 18:00:00,1.20,0.67,0.93,215,288,160,43,28,15,46,21,25,14,6,8,-3,+2,-5,66%,72%,60%,144,183,107,29%,26%,38%,11,8,3,14,6,8
327,https://vlr.gg/player/6437/dark3st,2025-01-28 18:00:00,0.98,0.88,0.93,181,191,177,36,19,17,46,22,24,26,14,12,0,+2,-2,71%,76%,67%,124,119,129,31%,35%,28%,4,2,2,4,0,4
328,https://vlr.gg/player/5093/logan,2025-01-28 18:00:00,0.80,0.95,0.88,193,169,218,39,17,22,46,21,25,15,6,9,+2,0,+2,64%,66%,63%,133,115,151,23%,25%,21%,5,2,3,3,2,1
329,https://vlr.gg/player/21878/snarly,2025-01-28 18:00:00,0.71,0.91,0.81,145,149,146,32,14,18,40,20,20,11,7,4,-2,-1,-1,63%,59%,67%,95,98,92,37%,38%,37%,4,2,2,6,3,3
330,https://vlr.gg/player/1856/wedid,2025-01-28 16:00:00,1.53,1.85,1.79,298,345,292,35,8,27,15,5,10,14,0,14,+5,+2,+3,90%,83%,92%,190,200,188,24%,28%,23%,7,2,5,2,0,2
331,https://vlr.gg/player/8373/okeanos,2025-01-28 16:00:00,0.74,1.72,1.52,323,169,363,32,3,29,17,5,12,12,3,9,+2,0,+2,80%,50%,88%,223,126,247,25%,36%,23%,7,2,5,5,2,3
332,https://vlr.gg/player/34400/bao,2025-01-28 16:00:00,1.57,1.32,1.37,249,280,239,29,7,22,17,4,13,11,3,8,+4,0,+4,90%,83%,92%,167,185,163,36%,37%,36%,4,0,4,0,0,0
333,https://vlr.gg/player/844/bdog,2025-01-28 16:00:00,1.22,1.37,1.34,167,148,167,20,4,16,12,3,9,24,4,20,-1,0,-1,87%,67%,92%,99,83,103,22%,25%,21%,0,0,0,1,0,1
334,https://vlr.gg/player/30470/kyu,2025-01-28 16:00:00,1.00,1.37,1.30,190,73,219,21,1,20,13,2,11,15,4,11,+2,0,+2,93%,83%,96%,123,58,139,24%,38%,22%,3,0,3,1,0,1
335,https://vlr.gg/player/24232/ghost,2025-01-28 16:00:00,0.97,0.26,0.83,197,229,68,22,20,2,26,22,4,4,4,0,0,+1,-1,63%,67%,50%,122,138,58,46%,47%,40%,3,3,0,3,2,1
336,https://vlr.gg/player/44085/booey,2025-01-28 16:00:00,0.57,0.80,0.62,161,154,187,15,12,3,27,22,5,7,3,4,+1,+1,0,47%,46%,50%,102,99,114,32%,33%,29%,4,3,1,3,2,1
337,https://vlr.gg/player/44841/garpa,2025-01-28 16:00:00,0.43,1.38,0.62,153,104,350,15,7,8,28,23,5,6,4,2,0,0,0,63%,54%,100%,98,73,196,32%,23%,56%,0,0,0,0,0,0
338,https://vlr.gg/player/47392/kaiser,2025-01-28 16:00:00,0.44,0.92,0.53,144,146,115,13,10,3,27,23,4,9,7,2,-6,-5,-1,47%,42%,67%,98,103,79,25%,26%,18%,0,0,0,6,5,1
339,https://vlr.gg/player/51101/abo2,2025-01-28 16:00:00,0.24,0.66,0.32,108,98,159,9,6,3,29,24,5,7,6,1,-7,-7,0,53%,50%,67%,74,70,88,22%,20%,29%,2,1,1,9,8,1
340,https://vlr.gg/player/29076/satellite,2025-01-28 16:00:00,1.05,1.21,1.13,260,278,243,44,24,20,34,18,16,8,5,3,+4,+4,0,68%,74%,63%,154,151,156,15%,12%,21%,10,6,4,6,2,4
341,https://vlr.gg/player/8286/glyph,2025-01-28 16:00:00,1.51,0.56,1.02,216,300,136,36,25,11,33,14,19,17,8,9,+2,0,+2,77%,87%,67%,127,179,77,18%,20%,15%,4,1,3,2,1,1
342,https://vlr.gg/player/13084/smiley,2025-01-28 16:00:00,1.10,0.62,0.85,133,142,124,22,12,10,27,10,17,21,13,8,-3,-2,-1,89%,91%,88%,85,89,81,27%,39%,19%,3,1,2,6,3,3
343,https://vlr.gg/player/3227/screwface,2025-01-28 16:00:00,1.12,0.48,0.79,154,179,132,23,15,8,30,10,20,13,8,5,-2,-2,0,66%,83%,50%,107,110,104,14%,10%,18%,2,1,1,4,3,1
344,https://vlr.gg/player/16757/cohburg,2025-01-28 16:00:00,0.70,0.67,0.68,169,160,179,26,12,14,37,17,20,12,7,5,-4,-1,-3,62%,70%,54%,112,108,115,21%,21%,20%,3,2,1,7,3,4
345,https://vlr.gg/player/4828/nismo,2025-01-28 16:00:00,1.47,1.06,1.27,217,242,187,34,20,14,27,12,15,16,9,7,+2,+3,-1,85%,96%,74%,144,153,135,35%,35%,36%,4,3,1,2,0,2
346,https://vlr.gg/player/8419/reduxx,2025-01-28 16:00:00,1.09,1.19,1.14,231,219,244,39,18,21,31,14,17,6,5,1,+1,-1,+2,79%,79%,78%,144,141,148,24%,28%,20%,10,6,4,9,7,2
347,https://vlr.gg/player/41798/nightz,2025-01-28 16:00:00,1.32,0.68,1.00,191,200,182,34,20,14,33,12,21,4,0,4,+4,+2,+2,72%,88%,57%,137,147,125,45%,57%,34%,6,2,4,2,0,2
348,https://vlr.gg/player/11118/skuba,2025-01-28 16:00:00,1.31,0.57,0.95,171,225,117,30,21,9,28,11,17,15,6,9,-4,-1,-3,72%,83%,61%,113,148,76,24%,23%,28%,2,2,0,6,3,3
349,https://vlr.gg/player/3007/tdawgg,2025-01-28 16:00:00,1.00,0.80,0.90,157,149,166,24,13,11,32,14,18,19,9,10,0,-1,+1,70%,79%,61%,112,109,114,30%,42%,22%,3,0,3,3,1,2
350,https://vlr.gg/player/35665/miyeon,2025-01-28 16:00:00,1.47,1.20,1.34,281,321,250,61,35,26,41,22,19,8,4,4,+4,0,+4,71%,77%,66%,190,211,168,28%,28%,28%,14,7,7,10,7,3
351,https://vlr.gg/player/11046/deigara,2025-01-28 16:00:00,1.10,1.05,1.08,184,163,198,38,17,21,36,17,19,21,14,7,0,-1,+1,75%,80%,69%,120,113,128,31%,28%,34%,4,1,3,4,2,2
352,https://vlr.gg/player/3677/fross,2025-01-28 16:00:00,1.04,1.07,1.05,186,205,180,39,22,17,39,19,20,25,8,17,-3,-1,-2,73%,70%,76%,122,125,120,18%,20%,16%,3,1,2,6,2,4
353,https://vlr.gg/player/39154/kimb0,2025-01-28 16:00:00,0.66,1.08,0.86,179,153,207,38,18,20,46,24,22,13,4,9,-5,-5,0,64%,63%,66%,124,108,141,30%,27%,32%,2,0,2,7,5,2
354,https://vlr.gg/player/46082/jcz,2025-01-28 16:00:00,0.67,0.74,0.71,147,123,171,32,14,18,43,21,22,18,9,9,-1,-3,+2,64%,67%,62%,95,87,103,29%,26%,31%,4,1,3,5,4,1
355,https://vlr.gg/player/2818/neto,2025-01-28 16:00:00,1.16,1.08,1.12,263,256,263,52,26,26,45,21,24,7,3,4,+3,-2,+5,63%,55%,70%,167,167,166,37%,35%,39%,16,5,11,13,7,6
356,https://vlr.gg/player/15916/jotinha,2025-01-28 16:00:00,1.06,1.14,1.10,210,212,206,44,22,22,39,19,20,17,10,7,-1,-1,0,75%,76%,73%,134,140,128,29%,30%,28%,4,1,3,5,2,3
357,https://vlr.gg/player/1291/bnj,2025-01-28 16:00:00,1.17,0.73,0.95,202,221,181,41,23,18,45,21,24,24,17,7,+6,+2,+4,73%,76%,70%,124,131,118,26%,31%,22%,8,4,4,2,2,0
358,https://vlr.gg/player/2586/hanling,2025-01-28 16:00:00,0.75,1.04,0.90,155,135,175,31,13,18,38,20,18,19,13,6,-1,-1,0,64%,62%,67%,108,96,119,26%,31%,23%,0,0,0,1,1,0
359,https://vlr.gg/player/2403/mizu,2025-01-28 16:00:00,0.81,0.95,0.88,169,167,174,36,17,19,41,21,20,13,9,4,-2,-3,+1,75%,72%,77%,121,125,118,40%,37%,43%,4,2,2,6,5,1
360,https://vlr.gg/player/41128/mathi,2025-01-28 14:00:00,1.31,0.83,0.98,217,301,182,23,10,13,28,8,20,9,3,6,+1,+2,-1,69%,82%,63%,159,218,132,37%,38%,36%,3,2,1,2,0,2
361,https://vlr.gg/player/21646/nash,2025-01-28 14:00:00,0.63,1.05,0.92,171,87,208,22,4,18,27,6,21,4,0,4,-4,-2,-2,54%,55%,54%,111,53,138,44%,18%,51%,2,0,2,6,2,4
362,https://vlr.gg/player/29123/kivary,2025-01-28 14:00:00,0.88,0.89,0.89,187,167,198,22,8,14,27,7,20,7,0,7,-4,0,-4,63%,64%,63%,131,117,138,32%,42%,30%,5,2,3,9,2,7
363,https://vlr.gg/player/45955/ego1st,2025-01-28 14:00:00,1.13,0.30,0.56,146,207,124,17,9,8,31,7,24,7,2,5,0,+1,-1,51%,64%,46%,104,153,81,36%,40%,32%,2,1,1,2,0,2
364,https://vlr.gg/player/43908/levi,2025-01-28 14:00:00,0.59,0.35,0.42,108,127,107,14,5,9,30,8,22,3,1,2,-2,-2,0,54%,64%,50%,70,71,69,35%,33%,36%,1,0,1,3,2,1
365,https://vlr.gg/player/29241/miradaninja,2025-01-28 14:00:00,1.59,1.73,1.63,319,300,357,40,26,14,18,11,7,10,6,4,+5,+2,+3,83%,88%,73%,216,217,213,31%,31%,31%,6,2,4,1,0,1
366,https://vlr.gg/player/29243/neon,2025-01-28 14:00:00,1.66,1.45,1.59,295,298,254,37,27,10,15,9,6,6,2,4,+2,+3,-1,77%,79%,73%,177,184,160,37%,44%,23%,4,3,1,2,0,2
367,https://vlr.gg/player/21251/blowz,2025-01-28 14:00:00,1.30,0.46,1.04,168,216,60,20,19,1,19,11,8,13,8,5,+2,+3,-1,86%,88%,82%,114,146,44,28%,31%,13%,3,3,0,1,0,1
368,https://vlr.gg/player/42867/ghoul33,2025-01-28 14:00:00,0.97,0.79,0.92,183,226,125,25,20,5,23,16,7,8,6,2,+2,+1,+1,74%,79%,64%,117,127,93,31%,29%,38%,8,7,1,6,6,0
369,https://vlr.gg/player/29242/erde,2025-01-28 14:00:00,0.89,0.95,0.91,166,170,155,21,15,6,23,15,8,11,7,4,-2,-1,-1,69%,67%,73%,112,108,120,29%,28%,30%,1,1,0,3,2,1
370,https://vlr.gg/player/36748/czester,2025-01-28 14:00:00,0.95,1.26,1.11,237,189,258,42,17,25,39,19,20,16,9,7,+4,+1,+3,72%,73%,71%,144,125,161,44%,33%,59%,6,2,4,2,1,1
371,https://vlr.gg/player/42702/krizz,2025-01-28 14:00:00,0.94,1.04,0.99,186,187,199,35,16,19,34,16,18,8,4,4,+1,0,+1,74%,73%,75%,129,128,130,18%,18%,17%,3,1,2,2,1,1
372,https://vlr.gg/player/10448/kozok,2025-01-28 14:00:00,0.91,0.88,0.89,142,143,153,26,13,13,33,15,18,12,6,6,-4,-3,-1,69%,81%,57%,101,104,99,18%,15%,22%,3,1,2,7,4,3
373,https://vlr.gg/player/9557/nefi,2025-01-28 14:00:00,0.89,0.71,0.79,159,167,165,32,16,16,39,18,21,17,12,5,-3,-1,-2,69%,77%,61%,108,106,111,35%,35%,34%,5,2,3,8,3,5
374,https://vlr.gg/player/9556/demek,2025-01-28 14:00:00,0.74,0.67,0.70,173,207,158,32,18,14,43,22,21,4,3,1,0,-1,+1,63%,73%,54%,112,125,99,20%,16%,25%,9,5,4,9,6,3
375,https://vlr.gg/player/4589/burzzy,2025-01-28 14:00:00,1.57,0.87,1.23,230,286,183,46,30,16,36,16,20,20,7,13,+1,+2,-1,78%,82%,73%,159,190,127,35%,39%,29%,5,3,2,4,1,3
376,https://vlr.gg/player/7490/anguist,2025-01-28 14:00:00,0.80,1.48,1.13,188,149,232,36,15,21,30,17,13,13,5,8,+2,-1,+3,78%,71%,85%,135,111,161,37%,38%,35%,5,1,4,3,2,1
377,https://vlr.gg/player/217/seider,2025-01-28 14:00:00,1.03,1.07,1.05,176,165,176,31,16,15,30,15,15,20,10,10,0,-2,+2,76%,79%,73%,115,117,112,32%,41%,25%,6,2,4,6,4,2
378,https://vlr.gg/player/7104/juseu,2025-01-28 14:00:00,0.86,1.21,1.03,208,215,183,41,22,19,35,21,14,8,3,5,-2,-4,+2,70%,68%,73%,120,125,114,27%,26%,30%,6,3,3,8,7,1
379,https://vlr.gg/player/33358/shinnok,2025-01-28 14:00:00,0.95,1.10,1.02,195,169,232,34,15,19,36,18,18,19,7,12,+1,+3,-2,78%,71%,85%,135,117,155,23%,33%,18%,6,4,2,5,1,4
380,https://vlr.gg/player/3934/eleo,2025-01-28 14:00:00,1.08,1.24,1.16,208,229,198,36,19,17,33,20,13,14,5,9,+1,+1,0,76%,72%,79%,154,164,144,29%,33%,24%,3,1,2,2,0,2
381,https://vlr.gg/player/27789/deyten,2025-01-28 14:00:00,0.78,1.28,1.03,223,192,249,39,16,23,35,21,14,23,15,8,-5,-3,-2,82%,84%,79%,133,118,149,27%,20%,33%,5,2,3,10,5,5
382,https://vlr.gg/player/47270/darkwinjett,2025-01-28 14:00:00,0.91,1.10,1.00,208,196,224,36,17,19,37,20,17,28,12,16,+1,0,+1,80%,84%,75%,135,124,147,15%,16%,14%,2,1,1,1,1,0
383,https://vlr.gg/player/18384/bully,2025-01-28 14:00:00,0.65,1.10,0.87,192,135,247,31,10,21,36,19,17,7,5,2,+8,+3,+5,61%,40%,83%,121,91,152,27%,28%,26%,10,4,6,2,1,1
384,https://vlr.gg/player/33974/appa,2025-01-28 14:00:00,0.82,0.89,0.86,181,201,163,30,17,13,37,21,16,9,4,5,0,-2,+2,65%,60%,71%,116,128,103,25%,30%,21%,7,4,3,7,6,1
385,https://vlr.gg/player/30901/ianto,2025-01-28 14:00:00,1.32,1.58,1.45,261,235,294,48,22,26,32,16,16,18,6,12,-1,-3,+2,86%,83%,88%,177,145,208,25%,34%,21%,4,1,3,5,4,1
386,https://vlr.gg/player/252/d3ffo,2025-01-28 14:00:00,1.01,1.20,1.11,252,244,259,43,21,22,37,20,17,12,5,7,-1,-1,0,69%,67%,72%,162,158,166,22%,24%,20%,9,3,6,10,4,6
387,https://vlr.gg/player/7106/diseased,2025-01-28 14:00:00,0.78,1.28,1.03,176,167,186,29,13,16,30,18,12,10,4,6,0,+1,-1,69%,63%,76%,118,113,123,20%,22%,19%,3,2,1,3,1,2
388,https://vlr.gg/player/22617/vitie,2025-01-28 14:00:00,0.80,0.99,0.89,197,172,216,33,14,19,38,20,18,23,14,9,0,-1,+1,73%,75%,72%,119,112,127,31%,29%,33%,4,2,2,4,3,1
389,https://vlr.gg/player/23098/aphun,2025-01-28 14:00:00,0.53,1.04,0.79,153,110,191,25,7,18,35,19,16,19,10,9,-3,-2,-1,73%,75%,72%,111,70,151,22%,10%,30%,2,1,1,5,3,2
390,https://vlr.gg/player/42458/bravo,2025-01-28 11:00:00,1.38,0.97,1.19,230,271,187,31,20,11,27,13,14,11,4,7,-1,+1,-2,78%,90%,63%,145,165,123,28%,30%,25%,1,1,0,2,0,2
391,https://vlr.gg/player/4339/rare,2025-01-28 11:00:00,1.14,1.03,1.09,232,246,212,32,18,14,29,16,13,5,0,5,-1,-3,+2,55%,57%,53%,149,158,140,21%,25%,17%,5,2,3,6,5,1
392,https://vlr.gg/player/7185/nero,2025-01-28 11:00:00,1.01,0.44,0.74,173,194,147,19,13,6,29,14,15,13,5,8,+1,-1,+2,68%,71%,63%,119,124,113,22%,30%,15%,2,0,2,1,1,0
393,https://vlr.gg/player/42638/amcar,2025-01-28 11:00:00,0.48,0.92,0.69,139,102,183,20,7,13,32,17,15,6,2,4,-2,-1,-1,55%,52%,58%,101,71,135,41%,32%,47%,1,1,0,3,2,1
394,https://vlr.gg/player/22291/razziss,2025-01-28 11:00:00,0.15,0.35,0.24,99,96,106,12,6,6,36,19,17,4,1,3,-7,-5,-2,45%,33%,58%,72,72,72,15%,6%,29%,6,2,4,13,7,6
395,https://vlr.gg/player/31298/luca,2025-01-28 11:00:00,1.43,1.31,1.36,224,234,212,36,18,18,20,9,11,9,3,6,+2,-1,+3,88%,84%,90%,143,155,133,25%,26%,24%,4,0,4,2,1,1
396,https://vlr.gg/player/5566/jeyj7y,2025-01-28 11:00:00,0.96,1.47,1.22,225,188,255,32,12,20,22,11,11,12,7,5,0,-2,+2,78%,79%,76%,146,130,161,24%,23%,25%,4,2,2,4,4,0
397,https://vlr.gg/player/4214/eso177,2025-01-28 11:00:00,1.49,0.97,1.22,185,221,147,28,17,11,19,8,11,10,5,5,0,+1,-1,80%,84%,76%,120,154,90,27%,24%,32%,3,2,1,3,1,2
398,https://vlr.gg/player/34002/lukey,2025-01-28 11:00:00,0.99,1.20,1.10,248,203,289,32,12,20,29,13,16,13,7,6,+6,+2,+4,80%,84%,76%,167,134,196,19%,15%,23%,11,5,6,5,3,2
399,https://vlr.gg/player/12372/szoren,2025-01-28 11:00:00,1.38,0.73,1.04,175,210,150,25,15,10,24,9,15,16,6,10,+2,+1,+1,78%,89%,67%,118,144,95,35%,33%,37%,3,1,2,1,0,1
400,https://vlr.gg/player/42661/barck,2025-01-28 11:00:00,1.03,1.14,1.09,221,212,231,35,17,18,33,17,16,7,4,3,+1,-1,+2,61%,59%,64%,149,141,158,26%,31%,23%,2,0,2,1,1,0
401,https://vlr.gg/player/42650/mally,2025-01-28 11:00:00,1.12,0.95,1.03,208,218,198,28,15,13,34,16,18,27,18,9,-6,-3,-3,75%,77%,73%,135,132,138,30%,28%,32%,1,1,0,7,4,3
402,https://vlr.gg/player/42651/avey,2025-01-28 11:00:00,1.12,0.73,0.93,195,240,151,31,20,11,33,17,16,13,7,6,-5,-1,-4,70%,73%,68%,122,153,91,19%,23%,13%,1,0,1,6,1,5
403,https://vlr.gg/player/16012/akira,2025-01-28 11:00:00,0.71,0.93,0.82,136,136,137,20,9,11,31,16,15,13,5,8,-6,-3,-3,61%,64%,59%,100,101,99,25%,22%,28%,1,0,1,7,3,4
404,https://vlr.gg/player/23421/laser,2025-01-28 11:00:00,0.44,0.73,0.59,160,150,170,25,12,13,38,20,18,4,1,3,-6,-6,0,55%,55%,55%,102,103,101,33%,37%,29%,6,3,3,12,9,3
405,https://vlr.gg/player/20591/eagle,2025-01-28 11:00:00,1.40,1.23,1.32,222,227,218,35,18,17,23,10,13,14,7,7,+1,0,+1,73%,73%,73%,157,159,156,22%,30%,17%,2,0,2,1,0,1
406,https://vlr.gg/player/27784/c4pee,2025-01-28 11:00:00,1.14,1.34,1.24,219,195,243,37,15,22,26,12,14,13,6,7,+5,+2,+3,80%,68%,91%,144,136,152,28%,27%,29%,6,2,4,1,0,1
407,https://vlr.gg/player/1365/nixoon,2025-01-28 11:00:00,1.32,1.08,1.20,238,259,217,38,20,18,30,15,15,19,14,5,+6,+3,+3,82%,82%,82%,141,138,144,28%,35%,22%,10,5,5,4,2,2
408,https://vlr.gg/player/9505/paulus,2025-01-28 11:00:00,0.65,1.27,0.96,196,180,212,31,15,16,29,16,13,7,2,5,+8,+3,+5,75%,68%,82%,122,107,138,17%,17%,17%,12,7,5,4,4,0
409,https://vlr.gg/player/2691/nausea,2025-01-28 11:00:00,1.07,0.77,0.92,187,184,190,28,15,13,31,13,18,27,13,14,+2,0,+2,75%,73%,77%,119,123,116,23%,25%,22%,3,1,2,1,1,0
410,https://vlr.gg/player/7754/xavi8k,2025-01-28 09:10:00,1.97,1.56,1.85,365,378,264,40,32,8,17,13,4,18,10,8,+1,0,+1,88%,83%,100%,231,252,181,28%,32%,16%,2,1,1,1,1,0
411,https://vlr.gg/player/13744/patmen,2025-01-28 09:10:00,1.34,2.41,1.65,286,250,392,37,22,15,17,15,2,19,11,8,+5,+3,+2,79%,75%,90%,179,143,263,40%,36%,47%,6,4,2,1,1,0
412,https://vlr.gg/player/16842/mojer,2025-01-28 09:10:00,1.09,1.40,1.18,238,263,162,31,23,8,21,18,3,0,0,0,+2,+1,+1,79%,75%,90%,149,162,119,31%,31%,30%,10,8,2,8,7,1
413,https://vlr.gg/player/3401/ptc,2025-01-28 09:10:00,0.88,1.65,1.11,205,146,339,26,13,13,19,14,5,5,3,2,+1,-1,+2,71%,63%,90%,135,103,214,30%,35%,26%,2,0,2,1,1,0
414,https://vlr.gg/player/6913/sultan,2025-01-28 09:10:00,0.67,1.17,0.82,115,112,135,14,8,6,18,15,3,18,16,2,-1,-1,0,82%,75%,100%,79,70,100,26%,25%,27%,1,0,1,2,1,1
415,https://vlr.gg/player/44770/cxix666,2025-01-28 09:10:00,0.47,1.45,1.16,226,163,261,27,5,22,26,10,16,4,0,4,-2,-2,0,59%,30%,71%,147,102,166,41%,60%,37%,4,1,3,6,3,3
416,https://vlr.gg/player/40907/mnfear,2025-01-28 09:10:00,0.25,0.95,0.74,162,83,198,21,3,18,30,10,20,8,1,7,-2,0,-2,62%,40%,71%,112,42,142,40%,22%,45%,0,0,0,2,0,2
417,https://vlr.gg/player/40910/consz,2025-01-28 09:10:00,0.47,0.75,0.66,169,133,185,20,4,16,32,10,22,6,1,5,-1,-1,0,62%,50%,67%,107,95,112,26%,29%,25%,4,0,4,5,1,4
418,https://vlr.gg/player/44930/nex1sphix,2025-01-28 09:10:00,0.41,0.55,0.51,129,118,140,13,3,10,31,10,21,15,3,12,+1,-1,+2,74%,80%,71%,94,85,98,23%,14%,27%,3,0,3,2,1,1
419,https://vlr.gg/player/40908/skyisblue,2025-01-28 09:10:00,0.19,0.49,0.40,98,65,113,11,2,9,29,10,19,9,2,7,-4,-2,-2,59%,50%,63%,74,41,88,27%,13%,31%,2,1,1,6,3,3
420,https://vlr.gg/player/46102/snappy,2025-01-28 06:00:00,1.31,1.25,1.27,284,313,284,69,35,34,51,22,29,16,5,11,+12,+5,+7,77%,81%,73%,182,188,177,28%,27%,28%,20,10,10,8,5,3
421,https://vlr.gg/player/37547/tbloy,2025-01-28 06:00:00,1.60,0.90,1.22,221,267,192,57,33,24,43,16,27,22,14,8,-1,+2,-3,75%,88%,65%,151,184,123,37%,39%,33%,3,2,1,4,0,4
422,https://vlr.gg/player/41702/canady,2025-01-28 06:00:00,1.10,0.99,1.04,212,215,209,50,24,26,48,20,28,24,13,11,0,-3,+3,80%,84%,76%,137,141,134,37%,31%,42%,4,0,4,4,3,1
423,https://vlr.gg/player/23062/surf,2025-01-28 06:00:00,1.07,0.77,0.90,163,176,156,42,21,21,46,18,28,23,13,10,0,+2,-2,77%,78%,76%,106,110,102,44%,43%,44%,8,5,3,8,3,5
424,https://vlr.gg/player/42901/thyy,2025-01-28 06:00:00,0.77,0.84,0.81,157,157,150,34,18,16,45,21,24,30,17,13,+2,-2,+4,64%,69%,59%,95,97,93,33%,38%,30%,6,1,5,4,3,1
425,https://vlr.gg/player/49001/secre,2025-01-28 06:00:00,1.10,1.11,1.11,249,206,260,58,29,29,51,24,27,25,16,9,-3,0,-3,77%,81%,72%,140,128,154,25%,24%,27%,3,2,1,6,2,4
426,https://vlr.gg/player/44149/pr0digy,2025-01-28 06:00:00,1.02,1.10,1.05,264,250,228,56,32,24,53,28,25,10,3,7,-3,-6,+3,65%,68%,63%,152,158,146,32%,32%,31%,11,4,7,14,10,4
427,https://vlr.gg/player/44919/aplycs,2025-01-28 06:00:00,1.06,0.74,0.91,174,180,146,37,24,13,48,22,26,30,13,17,-3,-3,0,67%,68%,66%,113,122,103,21%,24%,18%,2,1,1,5,4,1
428,https://vlr.gg/player/14207/viness,2025-01-28 06:00:00,1.12,0.60,0.87,154,203,127,38,26,12,46,22,24,13,7,6,-4,0,-4,59%,68%,50%,117,142,88,32%,35%,28%,7,5,2,11,5,6
429,https://vlr.gg/player/12322/ndg,2025-01-28 06:00:00,0.90,0.72,0.82,152,178,163,43,24,19,54,26,28,8,5,3,0,0,0,65%,73%,56%,121,129,112,34%,33%,35%,5,2,3,5,2,3
430,https://vlr.gg/player/53/inspire,2025-01-27 19:25:00,0.92,1.50,1.28,232,160,269,47,13,34,29,12,17,9,1,8,-2,-3,+1,81%,80%,82%,154,109,181,30%,41%,27%,4,1,3,6,4,2
431,https://vlr.gg/player/36560/canezerra,2025-01-27 19:25:00,0.98,1.34,1.21,300,275,306,55,19,36,42,18,24,17,5,12,+6,+1,+5,74%,70%,76%,188,187,189,32%,31%,32%,11,3,8,5,2,3
432,https://vlr.gg/player/29547/ion2x,2025-01-27 19:25:00,1.76,0.85,1.18,189,274,133,39,23,16,29,10,19,20,5,15,+1,-1,+2,74%,85%,68%,119,182,82,42%,53%,33%,3,0,3,2,1,1
433,https://vlr.gg/player/35302/eggsterr,2025-01-27 19:25:00,1.10,1.07,1.08,230,264,213,43,18,25,37,16,21,19,7,12,+1,-2,+3,85%,70%,94%,154,169,145,20%,20%,20%,8,2,6,7,4,3
434,https://vlr.gg/player/21778/p0ppin,2025-01-27 19:25:00,0.89,1.02,0.97,167,161,177,34,12,22,32,14,18,15,7,8,-2,-3,+1,76%,80%,74%,109,100,115,13%,16%,12%,3,0,3,5,3,2
435,https://vlr.gg/player/25902/shondex,2025-01-27 19:25:00,1.14,1.14,1.14,239,222,279,47,27,20,42,24,18,8,5,3,+3,-1,+4,72%,62%,90%,159,147,179,35%,37%,33%,6,2,4,3,3,0
436,https://vlr.gg/player/873/bob,2025-01-27 19:25:00,0.99,0.99,0.99,207,205,239,40,24,16,44,27,17,6,3,3,+3,0,+3,67%,62%,75%,152,141,171,25%,23%,27%,7,3,4,4,3,1
437,https://vlr.gg/player/26848/zeek,2025-01-27 19:25:00,0.65,1.06,0.80,171,134,236,29,14,15,43,28,15,24,14,10,-2,-4,+2,67%,62%,75%,113,89,154,27%,33%,22%,3,1,2,5,5,0
438,https://vlr.gg/player/16671/welyy,2025-01-27 19:25:00,0.83,0.76,0.80,154,155,173,31,18,13,43,26,17,15,10,5,-6,-4,-2,59%,62%,55%,105,100,113,35%,34%,37%,4,2,2,10,6,4
439,https://vlr.gg/player/11696/zoestol,2025-01-27 19:25:00,0.69,0.35,0.57,126,155,86,22,16,6,46,28,18,20,9,11,-2,-3,+1,67%,62%,75%,79,98,46,13%,15%,7%,5,3,2,7,6,1
440,https://vlr.gg/player/31476/mephisto,2025-01-27 19:00:00,1.32,1.25,1.28,287,306,266,44,24,20,29,13,16,9,4,5,+5,+3,+2,79%,81%,77%,183,200,167,30%,29%,32%,12,7,5,7,4,3
441,https://vlr.gg/player/26757/otaq,2025-01-27 19:00:00,1.60,0.72,1.15,237,308,171,34,23,11,30,12,18,11,5,6,+1,+1,0,74%,76%,73%,152,196,109,18%,21%,15%,2,1,1,1,0,1
442,https://vlr.gg/player/10718/rowancy,2025-01-27 19:00:00,1.06,0.79,0.92,200,217,185,32,17,15,31,14,17,3,3,0,+1,0,+1,65%,71%,59%,135,153,118,30%,27%,33%,6,3,3,5,3,2
443,https://vlr.gg/player/10581/ryu,2025-01-27 19:00:00,0.96,0.68,0.82,155,167,144,23,12,11,34,14,20,18,11,7,-1,0,-1,77%,90%,64%,105,105,105,32%,34%,29%,1,0,1,2,0,2
444,https://vlr.gg/player/15931/peloncito,2025-01-27 19:00:00,0.59,0.64,0.62,119,110,130,15,6,9,34,15,19,21,11,10,-5,-3,-2,63%,67%,59%,90,86,93,20%,18%,23%,1,0,1,6,3,3
445,https://vlr.gg/player/24026/generalsteak,2025-01-27 19:00:00,2.21,0.73,1.49,236,328,140,39,29,10,24,7,17,23,12,11,0,0,0,81%,95%,67%,153,220,84,33%,33%,33%,0,0,0,0,0,0
446,https://vlr.gg/player/35567/toro,2025-01-27 19:00:00,1.06,1.09,1.07,233,255,208,35,19,16,33,16,17,17,10,7,+1,+1,0,74%,86%,62%,149,166,131,40%,41%,39%,3,2,1,2,1,1
447,https://vlr.gg/player/50581/vecious,2025-01-27 19:00:00,0.66,1.13,0.89,223,190,259,34,15,19,32,17,15,4,2,2,-2,-2,0,58%,64%,52%,135,109,163,18%,22%,16%,10,5,5,12,7,5
448,https://vlr.gg/player/1451/sancho,2025-01-27 19:00:00,0.95,0.78,0.87,163,194,131,26,17,9,29,15,14,6,3,3,+3,+1,+2,67%,73%,62%,111,147,74,28%,43%,14%,5,3,2,2,2,0
449,https://vlr.gg/player/2995/maka,2025-01-27 19:00:00,0.95,0.79,0.87,168,129,212,24,10,14,30,11,19,15,8,7,-3,0,-3,79%,86%,71%,113,86,141,21%,19%,23%,3,1,2,6,1,5
450,https://vlr.gg/player/34057/jerrwin,2025-01-27 18:00:00,0.95,1.83,1.43,300,206,356,49,15,34,31,16,15,9,6,3,+5,-3,+8,78%,71%,84%,184,136,224,27%,36%,22%,11,2,9,6,5,1
451,https://vlr.gg/player/15051/sacred,2025-01-27 18:00:00,1.52,1.03,1.26,237,285,194,39,23,16,30,13,17,27,10,17,-3,-1,-2,78%,76%,80%,139,165,118,30%,28%,33%,1,0,1,4,1,3
452,https://vlr.gg/player/4385/monsi,2025-01-27 18:00:00,1.03,1.27,1.16,195,196,208,35,14,21,26,13,13,11,4,7,-3,0,-3,74%,71%,76%,137,128,145,37%,38%,36%,3,3,0,6,3,3
453,https://vlr.gg/player/29688/mikee,2025-01-27 18:00:00,1.37,0.89,1.11,243,304,186,33,20,13,31,16,15,15,7,8,+2,+2,0,76%,81%,72%,166,196,140,33%,41%,25%,6,3,3,4,1,3
454,https://vlr.gg/player/3874/teague,2025-01-27 18:00:00,0.58,1.11,0.87,125,73,173,22,5,17,28,14,14,14,7,7,-1,-1,0,76%,67%,84%,82,55,104,14%,10%,16%,2,1,1,3,2,1
455,https://vlr.gg/player/9185/dodonut,2025-01-27 18:00:00,1.06,1.52,1.27,272,231,319,43,18,25,35,20,15,5,4,1,+2,-2,+4,67%,60%,76%,188,166,214,27%,22%,33%,13,5,8,11,7,4
456,https://vlr.gg/player/17397/noia,2025-01-27 18:00:00,0.99,0.74,0.88,209,233,192,35,22,13,37,20,17,6,2,4,0,0,0,65%,52%,81%,142,160,120,27%,40%,18%,5,2,3,5,2,3
457,https://vlr.gg/player/3079/alexis,2025-01-27 18:00:00,1.08,0.59,0.86,156,196,111,24,16,8,35,19,16,28,16,12,+1,+2,-1,70%,68%,71%,101,121,78,38%,45%,27%,3,3,0,2,1,1
458,https://vlr.gg/player/21486/sarahcat,2025-01-27 18:00:00,0.40,1.17,0.75,171,110,246,27,9,18,35,21,14,8,4,4,0,-1,+1,70%,64%,76%,117,73,170,23%,19%,24%,2,1,1,2,2,0
459,https://vlr.gg/player/3063/mel,2025-01-27 18:00:00,0.44,0.70,0.56,114,108,118,17,9,8,36,21,15,15,6,9,-3,-2,-1,65%,60%,71%,76,69,84,23%,27%,20%,0,0,0,3,2,1
460,https://vlr.gg/player/2172/brawk,2025-01-27 16:00:00,1.42,0.99,1.23,234,278,179,55,37,18,41,22,19,27,13,14,-4,-1,-3,84%,89%,79%,152,160,142,22%,21%,23%,2,2,0,6,3,3
461,https://vlr.gg/player/8422/spaz,2025-01-27 16:00:00,1.30,1.03,1.18,220,219,219,48,29,19,40,18,22,20,9,11,+3,0,+3,77%,77%,76%,145,135,156,24%,22%,26%,8,3,5,5,3,2
462,https://vlr.gg/player/23407/pa1nt,2025-01-27 16:00:00,1.21,0.86,1.05,243,271,214,54,34,20,47,24,23,16,8,8,+5,+4,+1,70%,71%,69%,162,168,156,22%,24%,18%,15,10,5,10,6,4
463,https://vlr.gg/player/2164/paincakes,2025-01-27 16:00:00,0.80,1.33,1.04,205,143,267,45,17,28,41,23,18,22,13,9,+4,+1,+3,73%,77%,69%,125,99,157,25%,25%,26%,5,2,3,1,1,0
464,https://vlr.gg/player/864/bcj,2025-01-27 16:00:00,0.97,0.90,0.94,199,207,181,40,22,18,47,26,21,41,29,12,-2,-3,+1,70%,74%,66%,118,125,108,12%,11%,13%,5,1,4,7,4,3
465,https://vlr.gg/player/2125/nanners,2025-01-27 16:00:00,1.01,0.99,1.00,202,192,212,45,20,25,47,20,27,17,4,13,+2,-1,+3,72%,72%,71%,122,115,129,23%,23%,24%,9,2,7,7,3,4
466,https://vlr.gg/player/17770/alvinboy,2025-01-27 16:00:00,1.05,0.93,0.98,205,219,201,45,21,24,50,21,29,14,7,7,+3,+1,+2,72%,69%,74%,135,148,123,31%,37%,27%,6,2,4,3,1,2
467,https://vlr.gg/player/893/retrq,2025-01-27 16:00:00,1.07,0.91,0.98,164,188,162,40,19,21,46,20,26,21,13,8,-1,-3,+2,70%,76%,66%,106,112,101,23%,33%,16%,4,1,3,5,4,1
468,https://vlr.gg/player/24553/boni,2025-01-27 16:00:00,1.23,0.76,0.97,222,277,198,53,30,23,54,23,31,14,5,9,-1,+1,-2,61%,69%,54%,158,181,140,15%,20%,11%,10,7,3,11,6,5
469,https://vlr.gg/player/3719/matt,2025-01-27 16:00:00,0.77,0.85,0.81,146,122,175,33,13,20,45,19,26,22,9,13,-9,-3,-6,67%,66%,69%,113,92,129,17%,17%,18%,0,0,0,9,3,6
470,https://vlr.gg/player/64/gmd,2025-01-27 16:00:00,1.48,0.72,1.29,219,258,102,27,23,4,17,12,5,12,10,2,+3,+3,0,75%,88%,38%,126,145,71,26%,25%,27%,3,3,0,0,0,0
471,https://vlr.gg/player/20140/vora,2025-01-27 16:00:00,1.24,1.43,1.29,201,201,236,23,15,8,15,11,4,17,15,2,+1,+1,0,91%,92%,88%,144,147,133,17%,23%,4%,2,1,1,1,0,1
472,https://vlr.gg/player/3702/sym,2025-01-27 16:00:00,1.26,1.36,1.29,357,353,290,37,29,8,25,19,6,6,4,2,+4,+2,+2,69%,63%,88%,216,224,190,30%,30%,29%,12,10,2,8,8,0
473,https://vlr.gg/player/39602/recoil,2025-01-27 16:00:00,1.01,1.85,1.22,226,165,434,27,15,12,18,13,5,9,6,3,+1,-2,+3,84%,79%,100%,156,123,254,23%,20%,25%,3,0,3,2,2,0
474,https://vlr.gg/player/8376/seven,2025-01-27 16:00:00,1.15,1.28,1.19,210,214,204,24,18,6,18,14,4,21,14,7,-1,0,-1,81%,88%,63%,129,129,131,18%,15%,26%,0,0,0,1,0,1
475,https://vlr.gg/player/765/jerk,2025-01-27 16:00:00,0.83,0.84,0.83,196,191,197,19,6,13,26,8,18,9,2,7,-1,0,-1,66%,75%,63%,134,118,140,28%,36%,26%,2,0,2,3,0,3
476,https://vlr.gg/player/9063/infiltrator,2025-01-27 16:00:00,1.13,0.68,0.79,181,235,173,20,6,14,28,7,21,6,2,4,-1,0,-1,69%,100%,58%,123,155,113,25%,23%,26%,5,2,3,6,2,4
477,https://vlr.gg/player/17865/nahsie,2025-01-27 16:00:00,0.58,0.84,0.77,149,169,152,17,4,13,28,8,20,19,8,11,-1,-1,0,63%,88%,54%,94,91,95,24%,21%,24%,2,0,2,3,1,2
478,https://vlr.gg/player/9017/moobs,2025-01-27 16:00:00,0.56,0.80,0.73,182,141,189,20,4,16,28,7,21,3,0,3,-4,-2,-2,56%,38%,63%,107,77,117,38%,22%,43%,2,0,2,6,2,4
479,https://vlr.gg/player/9837/flare,2025-01-27 16:00:00,0.44,0.71,0.64,154,151,161,17,4,13,28,8,20,10,3,7,-1,-1,0,59%,63%,58%,101,76,109,23%,20%,24%,1,0,1,2,1,1
480,https://vlr.gg/player/5199/guardy,2025-01-27 15:15:00,1.36,1.51,1.43,274,243,312,45,23,22,26,14,12,21,12,9,+1,0,+1,86%,88%,85%,162,142,187,31%,24%,38%,5,2,3,4,2,2
481,https://vlr.gg/player/8502/olizera,2025-01-27 15:15:00,1.21,1.01,1.12,247,294,191,37,24,13,26,15,11,5,4,1,+4,+1,+3,84%,83%,85%,159,189,124,31%,31%,32%,5,2,3,1,1,0
482,https://vlr.gg/player/22154/pika,2025-01-27 15:15:00,1.50,0.62,1.10,188,249,115,29,22,7,24,13,11,13,8,5,+1,+1,0,82%,88%,75%,129,161,90,26%,24%,30%,2,2,0,1,1,0
483,https://vlr.gg/player/3127/monsteerr,2025-01-27 15:15:00,0.95,1.15,1.04,214,188,246,33,16,17,29,15,14,23,10,13,0,+2,-2,80%,88%,70%,135,124,148,29%,30%,28%,5,3,2,5,1,4
484,https://vlr.gg/player/38424/zachkappa,2025-01-27 15:15:00,0.99,1.04,1.01,201,195,210,32,17,15,26,14,12,9,7,2,+2,0,+2,75%,79%,70%,132,133,131,32%,34%,30%,9,5,4,7,5,2
485,https://vlr.gg/player/7868/lele,2025-01-27 15:15:00,1.08,1.05,1.06,185,183,188,28,13,15,31,14,17,16,7,9,-5,-2,-3,77%,80%,75%,128,124,132,22%,28%,18%,0,0,0,5,2,3
486,https://vlr.gg/player/16447/d3mur,2025-01-27 15:15:00,1.13,0.83,0.97,244,262,229,36,18,18,39,17,22,8,5,3,-1,-1,0,61%,60%,63%,148,160,139,38%,39%,37%,8,3,5,9,4,5
487,https://vlr.gg/player/5854/z3ro,2025-01-27 15:15:00,0.65,1.20,0.95,199,130,257,29,9,20,35,16,19,12,5,7,+2,-1,+3,52%,50%,54%,131,85,168,25%,19%,28%,7,3,4,5,4,1
488,https://vlr.gg/player/4277/n-a-i-s,2025-01-27 15:15:00,0.99,0.77,0.87,176,179,173,26,13,13,34,13,21,12,5,7,-1,0,-1,64%,60%,67%,122,124,119,20%,30%,15%,2,1,1,3,1,2
489,https://vlr.gg/player/1472/falltw,2025-01-27 15:15:00,0.73,0.23,0.46,89,115,69,12,7,5,37,14,23,15,8,7,-3,0,-3,45%,45%,46%,62,81,47,30%,30%,29%,1,1,0,4,1,3
490,https://vlr.gg/player/28948/ninja,2025-01-27 13:35:00,1.40,1.18,1.27,237,271,212,17,8,9,13,6,7,5,2,3,0,0,0,81%,89%,75%,148,179,125,32%,39%,23%,2,1,1,2,1,1
491,https://vlr.gg/player/19526/rexxtoned,2025-01-27 13:35:00,0.66,1.71,1.26,278,142,381,22,5,17,14,7,7,3,0,3,+4,0,+4,76%,78%,75%,178,94,241,39%,50%,36%,5,1,4,1,1,0
492,https://vlr.gg/player/50813/gsr,2025-01-27 13:35:00,1.25,0.74,0.96,190,263,136,14,9,5,15,7,8,9,5,4,-1,0,-1,76%,78%,75%,123,155,99,22%,24%,20%,0,0,0,1,0,1
493,https://vlr.gg/player/7105/qpert,2025-01-27 13:35:00,0.41,1.11,0.81,144,67,204,10,1,9,14,6,8,10,5,5,+1,0,+1,71%,78%,67%,102,52,140,20%,18%,21%,1,0,1,0,0,0
494,https://vlr.gg/player/40750/donatellooo,2025-01-27 13:35:00,0.41,0.98,0.74,191,142,228,14,4,10,15,8,7,4,3,1,-5,-1,-4,76%,78%,75%,137,115,153,32%,15%,50%,2,2,0,7,3,4
495,https://vlr.gg/player/8593/grmekista,2025-01-27 13:35:00,0.98,3.23,1.95,327,162,548,25,7,18,12,9,3,11,4,7,+4,+2,+2,90%,83%,100%,202,98,341,41%,24%,52%,4,2,2,0,0,0
496,https://vlr.gg/player/37840/msh,2025-01-27 13:35:00,0.61,1.37,0.94,186,192,178,14,8,6,15,11,4,1,0,1,0,0,0,67%,50%,89%,130,124,139,36%,35%,37%,1,1,0,1,1,0
497,https://vlr.gg/player/3839/prti,2025-01-27 13:35:00,0.66,0.69,0.67,114,123,104,10,6,4,14,9,5,1,0,1,-2,-2,0,57%,42%,78%,91,99,80,29%,24%,43%,1,0,1,3,2,1
498,https://vlr.gg/player/25906/alexiiik,2025-01-27 13:35:00,0.82,0.35,0.62,194,236,141,13,9,4,20,12,8,2,1,1,+2,+3,-1,57%,67%,44%,119,144,85,24%,32%,12%,4,3,1,2,0,2
499,https://vlr.gg/player/4537/tajrex,2025-01-27 13:35:00,0.74,0.40,0.59,138,176,90,9,7,2,16,9,7,8,5,3,-3,-3,0,67%,75%,56%,82,101,57,21%,27%,9%,1,0,1,4,3,1
0,https://vlr.gg/player/2701/maniek,2025-01-27 13:35:00,0.57,0.74,0.70,209,213,208,10,2,8,13,3,10,1,1,0,-2,-1,-1,53%,67%,50%,118,114,119,41%,33%,44%,1,0,1,3,1,2
1,https://vlr.gg/player/164/bzt,2025-01-27 13:35:00,0.35,0.67,0.60,140,133,142,8,2,6,13,3,10,1,0,1,-1,0,-1,47%,67%,42%,87,73,90,33%,33%,33%,0,0,0,1,0,1
2,https://vlr.gg/player/2525/szimpli,2025-01-27 13:35:00,0.02,0.75,0.57,195,83,224,9,1,8,15,3,12,3,0,3,-4,-1,-3,53%,33%,58%,127,35,150,30%,100%,26%,2,0,2,6,1,5
3,https://vlr.gg/player/10378/almo,2025-01-27 13:35:00,0.93,0.43,0.53,159,222,143,6,2,4,15,3,12,4,2,2,-1,0,-1,47%,100%,33%,128,203,110,23%,18%,25%,0,0,0,1,0,1
4,https://vlr.gg/player/4525/stix,2025-01-27 13:35:00,0.05,0.50,0.41,100,96,101,5,1,4,14,3,11,3,0,3,-1,-1,0,47%,33%,50%,65,55,67,21%,0%,25%,0,0,0,1,1,0
5,https://vlr.gg/player/42550/merix,2025-01-27 13:35:00,1.45,2.57,1.67,265,236,380,16,11,5,7,6,1,8,7,1,+3,+1,+2,93%,92%,100%,157,155,167,28%,25%,38%,4,2,2,1,1,0
6,https://vlr.gg/player/31300/drog,2025-01-27 13:35:00,1.54,0.93,1.42,211,233,127,11,9,2,7,5,2,4,4,0,+3,+2,+1,93%,92%,100%,134,154,57,38%,38%,40%,3,2,1,0,0,0
7,https://vlr.gg/player/50814/fractioned,2025-01-27 13:35:00,1.50,0.90,1.38,363,384,284,19,16,3,11,8,3,4,2,2,+4,+4,0,87%,83%,100%,204,219,145,12%,17%,5%,4,4,0,0,0,0
8,https://vlr.gg/player/20443/br-di,2025-01-27 13:35:00,1.27,1.45,1.31,186,198,143,11,9,2,5,4,1,9,9,0,0,0,0,100%,100%,100%,121,119,128,31%,24%,75%,0,0,0,0,0,0
9,https://vlr.gg/player/45834/aidan,2025-01-27 13:35:00,1.12,1.93,1.28,215,199,281,13,10,3,8,7,1,4,2,2,-1,-1,0,87%,83%,100%,151,143,183,21%,25%,9%,1,1,0,2,2,0
10,https://vlr.gg/player/2107/russ,2025-01-27 13:35:00,1.06,1.10,1.08,224,183,255,16,6,10,14,4,10,4,1,3,+3,0,+3,71%,78%,67%,154,134,169,46%,45%,47%,3,0,3,0,0,0
11,https://vlr.gg/player/6038/b3astm0d3,2025-01-27 13:35:00,1.61,0.45,0.94,170,283,85,14,10,4,14,4,10,3,1,2,+4,+4,0,52%,78%,33%,107,182,51,28%,27%,30%,4,4,0,0,0,0
12,https://vlr.gg/player/11527/noman,2025-01-27 13:35:00,0.83,0.88,0.86,216,216,217,16,7,9,18,7,11,2,1,1,+5,+3,+2,67%,78%,58%,145,154,138,47%,33%,64%,8,4,4,3,1,2
13,https://vlr.gg/player/8034/thenightche,2025-01-27 13:35:00,0.63,0.74,0.69,119,74,154,10,2,8,13,4,9,0,0,0,0,0,0,71%,89%,58%,68,45,85,21%,8%,29%,1,0,1,1,0,1
14,https://vlr.gg/player/10429/luvjix,2025-01-27 13:35:00,0.94,0.33,0.59,116,169,76,7,5,2,15,5,10,5,2,3,+1,0,+1,57%,89%,33%,86,116,63,26%,33%,15%,1,0,1,0,0,0
15,https://vlr.gg/player/562/zeek,2025-01-27 13:35:00,1.62,1.32,1.49,281,286,277,20,12,8,12,6,6,8,6,2,+1,+1,0,71%,83%,56%,175,164,189,27%,26%,29%,1,1,0,0,0,0
16,https://vlr.gg/player/2894/kiles,2025-01-27 13:35:00,1.19,0.79,1.02,227,257,188,16,11,5,14,8,6,3,0,3,-3,-4,+1,71%,67%,78%,158,167,146,36%,55%,21%,1,0,1,4,4,0
17,https://vlr.gg/player/2700/jas,2025-01-27 13:35:00,1.35,0.46,0.97,215,305,96,14,12,2,15,8,7,5,3,2,-4,0,-4,76%,92%,56%,141,195,69,17%,19%,13%,2,2,0,6,2,4
18,https://vlr.gg/player/1616/starki,2025-01-27 13:35:00,0.85,0.99,0.91,132,116,156,13,7,6,11,6,5,3,3,0,-4,-3,-1,71%,83%,56%,83,68,103,22%,25%,20%,0,0,0,4,3,1
19,https://vlr.gg/player/1369/doma,2025-01-27 13:35:00,1.12,0.61,0.90,138,158,113,11,8,3,11,5,6,3,2,1,-3,0,-3,81%,92%,67%,96,105,84,38%,43%,30%,0,0,0,3,0,3
20,https://vlr.gg/player/7231/kya,2025-01-27 13:35:00,1.18,1.81,1.48,246,208,289,22,9,13,10,7,3,5,1,4,+1,-1,+2,74%,50%,100%,143,131,157,25%,32%,20%,3,1,2,2,2,0
21,https://vlr.gg/player/39682/wanzeru,2025-01-27 13:35:00,1.33,1.47,1.40,257,209,309,23,9,14,14,7,7,4,1,3,-1,0,-1,74%,58%,91%,169,153,187,20%,26%,16%,3,2,1,4,2,2
22,https://vlr.gg/player/2832/patix,2025-01-27 13:35:00,0.84,1.03,0.93,170,142,202,14,6,8,15,8,7,8,4,4,-3,0,-3,70%,75%,64%,106,86,128,55%,58%,53%,1,0,1,4,0,4
23,https://vlr.gg/player/33732/nunmeister,2025-01-27 13:35:00,0.62,1.07,0.83,171,156,189,14,7,7,14,9,5,5,2,3,-2,-2,0,78%,75%,82%,117,100,136,50%,50%,50%,0,0,0,2,2,0
24,https://vlr.gg/player/6969/gunners,2025-01-27 13:35:00,0.23,1.42,0.80,146,80,219,10,3,7,14,10,4,13,3,10,-2,-3,+1,78%,58%,100%,105,56,159,24%,27%,23%,1,0,1,3,3,0
25,https://vlr.gg/player/12471/kalkkuna,2025-01-27 13:35:00,1.04,1.38,1.22,235,206,263,20,8,12,16,9,7,3,0,3,+3,+2,+1,74%,73%,75%,157,138,174,38%,48%,31%,4,3,1,1,1,0
26,https://vlr.gg/player/15491/maximn,2025-01-27 13:35:00,0.84,1.10,0.97,203,197,210,17,7,10,17,10,7,6,2,4,0,-1,+1,48%,45%,50%,122,120,124,17%,13%,21%,3,1,2,3,2,1
27,https://vlr.gg/player/6101/999kvmil,2025-01-27 13:35:00,1.06,0.81,0.93,163,224,108,12,9,3,17,10,7,8,2,6,+4,+2,+2,65%,55%,75%,109,144,77,18%,28%,5%,4,2,2,0,0,0
28,https://vlr.gg/player/8440/puggy,2025-01-27 13:35:00,0.28,1.22,0.77,125,71,176,8,1,7,16,10,6,8,5,3,-1,-1,0,65%,55%,75%,88,57,116,20%,44%,13%,0,0,0,1,1,0
29,https://vlr.gg/player/13024/vuubit,2025-01-27 13:35:00,0.05,1.09,0.59,129,31,220,10,1,9,17,10,7,6,2,4,+1,-1,+2,61%,45%,75%,76,18,129,42%,20%,50%,4,0,4,3,1,2
30,https://vlr.gg/player/10152/padisah,2025-01-27 13:30:00,1.59,0.94,1.27,287,366,210,24,16,8,17,8,9,7,3,4,0,+1,-1,79%,83%,75%,170,202,137,25%,23%,29%,2,1,1,2,0,2
31,https://vlr.gg/player/19776/jrayn,2025-01-27 13:30:00,0.87,1.55,1.21,192,147,237,15,5,10,14,8,6,13,8,5,0,0,0,92%,100%,83%,138,113,164,40%,35%,43%,0,0,0,0,0,0
32,https://vlr.gg/player/10883/baransel,2025-01-27 13:30:00,1.18,1.05,1.12,227,219,236,20,11,9,15,7,8,9,1,8,0,+1,-1,79%,67%,92%,150,140,160,32%,28%,35%,2,2,0,2,1,1
33,https://vlr.gg/player/13545/werlass,2025-01-27 13:30:00,0.89,0.83,0.86,168,201,137,15,9,6,16,8,8,5,1,4,+1,0,+1,71%,92%,50%,112,136,89,26%,35%,17%,3,1,2,2,1,1
34,https://vlr.gg/player/3549/touven,2025-01-27 13:30:00,0.82,0.86,0.84,184,183,186,15,8,7,17,8,9,6,2,4,-1,0,-1,58%,58%,58%,108,112,104,40%,38%,42%,5,3,2,6,3,3
35,https://vlr.gg/player/10137/ip0tt,2025-01-27 13:30:00,0.99,1.38,1.18,243,200,287,20,8,12,17,8,9,9,1,8,0,-1,+1,83%,75%,92%,155,136,174,37%,35%,39%,2,1,1,2,2,0
36,https://vlr.gg/player/5510/oxmann,2025-01-27 13:30:00,0.66,1.48,1.07,207,142,274,19,6,13,16,8,8,3,2,1,+1,-1,+2,71%,67%,75%,130,100,161,41%,19%,57%,3,1,2,2,2,0
37,https://vlr.gg/player/22676/ventt,2025-01-27 13:30:00,1.17,0.49,0.83,138,184,92,12,9,3,17,7,10,8,5,3,0,+1,-1,71%,83%,58%,84,94,75,24%,31%,18%,1,1,0,1,0,1
38,https://vlr.gg/player/3557/skylen,2025-01-27 13:30:00,0.92,0.63,0.78,153,176,131,13,8,5,18,8,10,7,1,6,-2,0,-2,75%,83%,67%,109,123,94,41%,35%,50%,1,0,1,3,0,3
39,https://vlr.gg/player/40935/umu7,2025-01-27 13:30:00,1.01,0.55,0.78,204,223,187,15,9,6,21,9,12,6,3,3,+1,+3,-2,54%,67%,42%,139,133,145,14%,17%,11%,5,4,1,4,1,3
40,https://vlr.gg/player/292/fit1nho,2025-01-27 13:15:00,1.26,1.21,1.23,232,232,236,29,13,16,28,14,14,19,9,10,-1,0,-1,77%,74%,80%,147,153,143,36%,30%,44%,1,0,1,2,0,2
41,https://vlr.gg/player/7220/saiz,2025-01-27 13:15:00,0.63,1.24,0.94,212,165,254,29,11,18,31,16,15,3,0,3,-2,0,-2,72%,63%,80%,125,94,154,36%,45%,32%,2,2,0,4,2,2
42,https://vlr.gg/player/41220/krejz,2025-01-27 13:15:00,0.61,1.05,0.84,200,168,229,27,10,17,32,17,15,6,3,3,-6,-5,-1,64%,58%,70%,125,101,148,34%,36%,32%,7,2,5,13,7,6
43,https://vlr.gg/player/20271/vorwenn,2025-01-27 13:15:00,0.35,1.05,0.71,160,119,199,20,6,14,32,19,13,11,4,7,-3,-2,-1,72%,74%,70%,111,87,134,32%,29%,34%,2,1,1,5,3,2
44,https://vlr.gg/player/2534/lowel,2025-01-27 13:15:00,0.65,0.60,0.63,126,136,118,17,9,8,30,17,13,7,3,4,+1,+2,-1,59%,53%,65%,76,78,74,23%,24%,22%,2,2,0,1,0,1
45,https://vlr.gg/player/4851/rexs,2025-01-27 13:15:00,1.26,1.42,1.34,269,201,343,37,15,22,26,12,14,14,5,9,+1,+2,-1,79%,75%,84%,189,148,231,35%,44%,29%,6,3,3,5,1,4
46,https://vlr.gg/player/6925/chadi,2025-01-27 13:15:00,1.08,1.51,1.29,251,272,230,37,19,18,21,15,6,5,3,2,+5,+3,+2,87%,80%,95%,153,172,134,23%,44%,7%,8,5,3,3,2,1
47,https://vlr.gg/player/19588/neptuno,2025-01-27 13:15:00,1.10,1.04,1.07,204,226,181,30,17,13,24,15,9,9,3,6,0,-1,+1,72%,65%,79%,127,137,116,25%,27%,23%,3,0,3,3,1,2
48,https://vlr.gg/player/24359/faska,2025-01-27 13:15:00,0.76,1.17,0.96,220,199,243,31,14,17,29,17,12,9,5,4,+4,+1,+3,74%,65%,84%,147,132,162,29%,28%,29%,6,3,3,2,2,0
49,https://vlr.gg/player/2835/kyrrz,2025-01-27 13:15:00,0.48,1.33,0.89,126,85,168,18,5,13,22,14,8,22,10,12,+1,+1,0,77%,65%,89%,82,53,112,25%,42%,19%,2,2,0,1,1,0
50,https://vlr.gg/player/2190/baddyg,2025-01-27 13:15:00,0.83,1.45,1.24,202,133,239,27,6,21,21,9,12,11,5,6,-4,-1,-3,76%,54%,88%,122,74,149,28%,20%,31%,0,0,0,4,1,3
51,https://vlr.gg/player/1944/cayden,2025-01-27 13:15:00,0.87,1.24,1.11,171,101,207,22,5,17,22,8,14,23,6,17,-1,+1,-2,78%,69%,83%,111,62,138,37%,50%,34%,3,2,1,4,1,3
52,https://vlr.gg/player/8226/waddle,2025-01-27 13:15:00,0.84,1.24,1.09,199,137,234,27,6,21,24,9,15,10,2,8,+1,0,+1,78%,77%,79%,135,95,157,28%,11%,36%,2,0,2,1,0,1
53,https://vlr.gg/player/12474/tag,2025-01-27 13:15:00,0.76,1.03,0.94,206,204,205,28,10,18,26,11,15,8,2,6,+1,-1,+2,76%,62%,83%,128,124,130,26%,29%,25%,7,2,5,6,3,3
54,https://vlr.gg/player/1470/simond4rk,2025-01-27 13:15:00,0.92,0.72,0.79,198,291,147,23,12,11,29,12,17,3,0,3,0,0,0,70%,69%,71%,134,184,107,16%,12%,21%,5,2,3,5,2,3
55,https://vlr.gg/player/402/insider,2025-01-27 13:15:00,1.00,1.44,1.15,223,197,273,28,16,12,24,16,8,12,4,8,+4,+3,+1,65%,67%,62%,141,129,162,24%,33%,16%,6,4,2,2,1,1
56,https://vlr.gg/player/1155/buld,2025-01-27 13:15:00,1.06,0.95,1.02,217,222,207,27,17,10,23,16,7,11,8,3,0,+1,-1,76%,75%,77%,140,141,138,24%,29%,19%,3,3,0,3,2,1
57,https://vlr.gg/player/4519/kamisseq,2025-01-27 13:15:00,0.98,0.98,0.98,149,161,131,22,15,7,23,17,6,8,6,2,-1,0,-1,70%,63%,85%,108,118,89,51%,45%,67%,3,2,1,4,2,2
58,https://vlr.gg/player/3784/katu,2025-01-27 13:15:00,0.65,1.51,0.95,206,146,319,27,13,14,29,20,9,12,6,6,+3,0,+3,76%,71%,85%,123,93,178,23%,24%,22%,6,3,3,3,3,0
59,https://vlr.gg/player/23347/alannn,2025-01-27 13:15:00,0.73,0.72,0.73,145,162,114,18,12,6,28,19,9,9,5,4,-3,-2,-1,51%,46%,62%,102,116,76,29%,39%,10%,2,1,1,5,3,2
60,https://vlr.gg/player/3862/deepmans,2025-01-27 12:30:00,1.20,0.60,1.00,196,217,155,12,9,3,12,8,4,1,1,0,+1,+2,-1,67%,67%,67%,122,130,105,25%,22%,33%,3,3,0,2,1,1
61,https://vlr.gg/player/10146/reazy,2025-01-27 12:30:00,1.06,0.46,0.86,163,180,129,11,8,3,13,8,5,5,5,0,-2,-2,0,56%,58%,50%,117,138,74,52%,47%,67%,1,0,1,3,2,1
62,https://vlr.gg/player/569/paura,2025-01-27 12:30:00,1.12,0.01,0.67,149,211,26,10,10,0,15,9,6,1,1,0,-4,-1,-3,39%,58%,,97,133,26,32%,32%,33%,1,1,0,5,2,3
63,https://vlr.gg/player/50775/lava,2025-01-27 12:30:00,0.73,0.39,0.62,178,186,165,11,8,3,15,10,5,1,1,0,0,0,0,56%,58%,50%,116,116,116,33%,27%,43%,1,1,0,1,1,0
64,https://vlr.gg/player/568/turko,2025-01-27 12:30:00,0.57,0.44,0.53,89,100,68,5,4,1,13,8,5,3,2,1,-1,-1,0,61%,67%,50%,61,69,44,40%,36%,50%,0,0,0,1,1,0
65,https://vlr.gg/player/40591/comeback,2025-01-27 12:30:00,1.77,1.42,1.54,321,366,299,20,7,13,10,3,7,5,2,3,+4,+2,+2,83%,100%,75%,209,277,175,20%,25%,15%,6,2,4,2,0,2
66,https://vlr.gg/player/5565/ros,2025-01-27 12:30:00,1.09,1.55,1.39,253,198,282,16,5,11,10,3,7,6,2,4,+1,0,+1,78%,83%,75%,163,115,187,22%,31%,20%,1,0,1,0,0,0
67,https://vlr.gg/player/24344/loita,2025-01-27 12:30:00,2.68,0.65,1.33,210,399,116,15,9,6,8,0,8,4,1,3,+1,+2,-1,78%,100%,67%,129,231,79,60%,75%,46%,2,2,0,1,0,1
68,https://vlr.gg/player/12795/crewen,2025-01-27 12:30:00,1.19,0.67,0.85,157,164,154,10,4,6,11,2,9,5,1,4,-1,0,-1,72%,83%,67%,107,116,103,57%,44%,64%,1,1,0,2,1,1
69,https://vlr.gg/player/31305/lar0k,2025-01-27 12:30:00,0.61,0.91,0.81,129,8,191,7,0,7,10,2,8,7,1,6,+1,0,+1,89%,100%,83%,76,4,112,21%,0%,22%,2,0,2,1,0,1
70,https://vlr.gg/player/7185/nero,2025-01-27 12:00:00,1.47,0.72,1.13,192,213,169,14,9,5,13,5,8,9,6,3,+1,+1,0,77%,92%,60%,148,163,130,45%,50%,38%,2,1,1,1,0,1
71,https://vlr.gg/player/42458/bravo,2025-01-27 12:00:00,1.80,0.27,1.11,214,326,81,18,16,2,15,6,9,7,5,2,0,+1,-1,77%,92%,60%,144,220,53,25%,34%,6%,1,1,0,1,0,1
72,https://vlr.gg/player/42638/amcar,2025-01-27 12:00:00,1.10,0.85,0.98,160,167,153,13,8,5,13,6,7,2,1,1,-1,-1,0,73%,75%,70%,120,121,119,26%,30%,23%,1,1,0,2,2,0
73,https://vlr.gg/player/22291/razziss,2025-01-27 12:00:00,0.98,0.88,0.93,218,232,201,16,9,7,19,10,9,4,4,0,-1,-1,0,68%,83%,50%,165,191,133,20%,20%,18%,6,3,3,7,4,3
74,https://vlr.gg/player/4339/rare,2025-01-27 12:00:00,1.05,0.70,0.89,156,165,147,12,7,5,15,7,8,8,6,2,-1,0,-1,73%,83%,60%,108,115,100,15%,15%,14%,0,0,0,1,0,1
75,https://vlr.gg/player/42550/merix,2025-01-27 12:00:00,1.61,0.88,1.21,221,244,202,19,11,8,13,3,10,3,1,2,+1,+1,0,77%,90%,67%,128,112,142,15%,3%,30%,1,1,0,0,0,0
76,https://vlr.gg/player/50814/fractioned,2025-01-27 12:00:00,1.51,0.82,1.13,241,298,195,18,10,8,15,5,10,6,4,2,0,+1,-1,73%,90%,58%,144,179,115,16%,22%,12%,5,2,3,5,1,4
77,https://vlr.gg/player/45834/aidan,2025-01-27 12:00:00,0.98,1.09,1.04,229,196,258,17,6,11,16,6,10,10,6,4,+1,-1,+2,77%,80%,75%,145,135,154,24%,35%,18%,3,1,2,2,2,0
78,https://vlr.gg/player/31300/drog,2025-01-27 12:00:00,1.22,0.54,0.85,144,221,81,13,9,4,15,6,9,5,2,3,+1,+1,0,64%,80%,50%,108,152,71,32%,26%,44%,2,2,0,1,1,0
79,https://vlr.gg/player/20443/br-di,2025-01-27 12:00:00,0.99,0.62,0.79,115,121,110,8,5,3,14,4,10,11,4,7,-1,0,-1,73%,90%,58%,77,82,72,25%,25%,25%,1,0,1,2,0,2
80,https://vlr.gg/player/11527/noman,2025-01-27 12:00:00,1.02,2.24,1.54,302,228,402,22,9,13,13,8,5,4,1,3,+5,0,+5,71%,58%,89%,199,135,284,32%,42%,22%,8,3,5,3,3,0
81,https://vlr.gg/player/6038/b3astm0d3,2025-01-27 12:00:00,1.48,1.37,1.43,232,247,212,18,11,7,10,7,3,8,5,3,+1,+1,0,86%,83%,89%,138,145,130,25%,35%,15%,1,1,0,0,0,0
82,https://vlr.gg/player/2107/russ,2025-01-27 12:00:00,0.63,1.94,1.19,235,140,362,19,6,13,15,11,4,6,3,3,0,0,0,76%,75%,78%,176,115,258,30%,33%,29%,0,0,0,0,0,0
83,https://vlr.gg/player/8034/thenightche,2025-01-27 12:00:00,0.85,0.93,0.88,143,169,110,11,8,3,12,8,4,4,1,3,-2,-3,+1,67%,58%,78%,97,118,70,24%,32%,15%,2,0,2,4,3,1
84,https://vlr.gg/player/10429/luvjix,2025-01-27 12:00:00,0.50,0.87,0.65,124,125,124,9,5,4,13,9,4,6,2,4,-1,-2,+1,71%,67%,78%,72,72,71,19%,29%,12%,1,0,1,2,2,0
85,https://vlr.gg/player/27784/c4pee,2025-01-27 12:00:00,0.62,1.33,1.03,173,151,191,13,4,9,14,8,6,6,1,5,-2,-3,+1,57%,56%,58%,116,104,125,19%,27%,14%,2,0,2,4,3,1
86,https://vlr.gg/player/9505/paulus,2025-01-27 12:00:00,0.73,1.12,0.95,258,220,288,18,6,12,19,9,10,3,2,1,+3,0,+3,71%,56%,83%,154,138,165,29%,24%,33%,5,1,4,2,1,1
87,https://vlr.gg/player/1365/nixoon,2025-01-27 12:00:00,0.25,1.26,0.83,180,74,260,13,2,11,17,8,9,7,2,5,0,-2,+2,67%,44%,83%,119,56,166,31%,20%,34%,2,0,2,2,2,0
88,https://vlr.gg/player/20591/eagle,2025-01-27 12:00:00,0.21,1.05,0.69,120,69,159,9,2,7,15,8,7,2,1,1,-2,-1,-1,57%,33%,75%,88,48,119,42%,40%,42%,0,0,0,2,1,1
89,https://vlr.gg/player/2691/nausea,2025-01-27 12:00:00,0.78,0.54,0.64,129,167,101,10,6,4,14,7,7,2,0,2,-2,-1,-1,67%,56%,75%,80,88,74,31%,63%,17%,0,0,0,2,1,1
90,https://vlr.gg/player/4214/eso177,2025-01-27 12:00:00,1.44,1.58,1.48,301,287,338,18,12,6,14,10,4,6,3,3,-2,0,-2,88%,92%,80%,204,206,198,30%,29%,33%,0,0,0,2,0,2
91,https://vlr.gg/player/31298/luca,2025-01-27 12:00:00,0.81,1.23,0.94,210,195,249,13,8,5,14,10,4,5,4,1,+1,+1,0,71%,67%,80%,133,115,176,22%,23%,21%,2,2,0,1,1,0
92,https://vlr.gg/player/12372/szoren,2025-01-27 12:00:00,0.93,0.26,0.73,147,178,73,8,7,1,14,10,4,5,3,2,0,+1,-1,65%,75%,40%,106,126,57,23%,26%,13%,1,1,0,1,0,1
93,https://vlr.gg/player/5566/jeyj7y,2025-01-27 12:00:00,0.40,0.71,0.49,155,129,220,9,4,5,16,11,5,3,3,0,0,-1,+1,59%,50%,80%,105,94,130,19%,18%,20%,1,0,1,1,1,0
94,https://vlr.gg/player/34002/lukey,2025-01-27 12:00:00,0.40,0.17,0.33,116,121,107,6,5,1,16,11,5,4,1,3,-2,-3,+1,47%,50%,40%,97,99,91,19%,24%,10%,3,2,1,5,5,0
95,https://vlr.gg/player/50813/gsr,2025-01-27 12:00:00,1.74,1.46,1.54,268,328,243,17,6,11,10,3,7,4,0,4,+1,0,+1,71%,60%,75%,177,223,158,27%,50%,19%,2,0,2,1,0,1
96,https://vlr.gg/player/28948/ninja,2025-01-27 12:00:00,1.21,1.51,1.42,252,202,273,17,4,13,9,3,6,8,2,6,0,0,0,94%,100%,92%,151,143,154,11%,38%,5%,2,1,1,2,1,1
97,https://vlr.gg/player/19526/rexxtoned,2025-01-27 12:00:00,0.51,1.37,1.12,223,118,268,13,2,11,11,4,7,5,0,5,+3,0,+3,88%,80%,92%,163,94,192,20%,25%,19%,3,0,3,0,0,0
98,https://vlr.gg/player/40750/donatellooo,2025-01-27 12:00:00,1.51,0.90,1.08,273,361,237,18,7,11,15,5,10,3,1,2,0,+1,-1,71%,60%,75%,190,242,168,45%,64%,38%,3,2,1,3,1,2
99,https://vlr.gg/player/7105/qpert,2025-01-27 12:00:00,1.13,1.03,1.06,146,170,137,9,3,6,9,3,6,8,2,6,-1,0,-1,88%,100%,83%,98,91,101,30%,33%,29%,0,0,0,1,0,1
100,https://vlr.gg/player/42650/mally,2025-01-27 12:00:00,0.02,0.86,0.78,187,55,198,6,0,6,13,1,12,2,0,2,+1,0,+1,62%,,67%,141,55,149,26%,0%,26%,1,0,1,0,0,0
101,https://vlr.gg/player/23421/laser,2025-01-27 12:00:00,0.72,0.48,0.50,132,170,129,6,1,5,13,1,12,0,0,0,0,0,0,38%,100%,33%,85,105,84,33%,100%,29%,2,0,2,2,0,2
102,https://vlr.gg/player/42651/avey,2025-01-27 12:00:00,1.16,0.39,0.45,119,280,106,4,1,3,12,1,11,5,1,4,-3,0,-3,46%,100%,42%,86,165,79,23%,33%,21%,0,0,0,3,0,3
103,https://vlr.gg/player/16012/akira,2025-01-27 12:00:00,0.01,0.33,0.28,104,,113,5,0,5,13,1,12,0,0,0,-1,0,-1,38%,,42%,77,,83,45%,,45%,0,0,0,1,0,1
104,https://vlr.gg/player/39060/kodeth,2025-01-27 12:00:00,0.01,0.21,0.18,94,55,98,3,0,3,13,1,12,3,1,2,-4,-1,-3,46%,100%,42%,59,30,61,20%,0%,21%,0,0,0,4,1,3
105,https://vlr.gg/player/2832/patix,2025-01-27 12:00:00,1.95,1.38,1.90,315,337,50,15,15,0,3,3,0,3,1,2,0,0,0,85%,83%,100%,211,228,,52%,52%,,1,1,0,1,1,0
106,https://vlr.gg/player/33732/nunmeister,2025-01-27 12:00:00,1.95,0.10,1.81,287,306,60,14,14,0,5,4,1,5,4,1,+3,+3,0,92%,92%,100%,205,217,60,40%,43%,0%,3,3,0,0,0,0
107,https://vlr.gg/player/39682/wanzeru,2025-01-27 12:00:00,1.27,5.66,1.61,245,189,930,13,9,4,5,5,0,2,2,0,+2,+1,+1,77%,75%,100%,169,129,642,27%,22%,50%,4,3,1,2,2,0
108,https://vlr.gg/player/6969/gunners,2025-01-27 12:00:00,1.57,1.09,1.53,296,304,210,15,14,1,6,5,1,10,10,0,+1,+1,0,92%,92%,100%,186,193,105,38%,36%,100%,1,1,0,0,0,0
109,https://vlr.gg/player/7231/kya,2025-01-27 12:00:00,0.81,0.86,0.82,136,148,,7,7,0,5,5,0,2,2,0,+1,+1,0,69%,67%,100%,93,101,,31%,31%,,1,1,0,0,0,0
110,https://vlr.gg/player/10137/ip0tt,2025-01-27 11:30:00,2.08,1.04,1.58,300,358,239,25,16,9,15,7,8,6,3,3,+3,+2,+1,78%,83%,73%,184,208,157,45%,43%,47%,5,2,3,2,0,2
111,https://vlr.gg/player/5510/oxmann,2025-01-27 11:30:00,0.51,1.32,0.90,176,125,233,16,6,10,17,10,7,2,0,2,+3,+1,+2,65%,42%,91%,121,79,167,48%,20%,75%,3,1,2,0,0,0
112,https://vlr.gg/player/3557/skylen,2025-01-27 11:30:00,0.47,1.34,0.88,162,98,233,12,4,8,15,9,6,11,6,5,0,0,0,78%,75%,82%,110,68,156,24%,13%,30%,0,0,0,0,0,0
113,https://vlr.gg/player/22676/ventt,2025-01-27 11:30:00,0.73,0.88,0.80,175,177,173,13,6,7,19,11,8,12,7,5,+1,-1,+2,70%,67%,73%,108,128,86,38%,24%,86%,3,1,2,2,2,0
114,https://vlr.gg/player/40935/umu7,2025-01-27 11:30:00,0.93,0.34,0.65,171,195,145,13,8,5,19,8,11,2,1,1,+4,+2,+2,61%,50%,73%,100,111,88,24%,24%,22%,6,4,2,2,2,0
115,https://vlr.gg/player/10114/baha,2025-01-27 11:30:00,1.70,1.13,1.40,241,269,216,22,12,10,13,6,7,6,4,2,-4,-1,-3,70%,73%,67%,155,181,132,34%,32%,36%,1,0,1,5,1,4
116,https://vlr.gg/player/11516/drky,2025-01-27 11:30:00,0.54,1.53,1.06,191,132,245,16,5,11,14,9,5,8,4,4,0,0,0,78%,73%,83%,111,69,150,17%,5%,24%,1,0,1,1,0,1
117,https://vlr.gg/player/21584/deminatix,2025-01-27 11:30:00,0.95,0.97,0.96,211,214,209,18,8,10,15,8,7,2,1,1,-5,-5,0,57%,45%,67%,131,134,129,24%,32%,18%,3,1,2,8,6,2
118,https://vlr.gg/player/12226/sturnn,2025-01-27 11:30:00,0.75,1.08,0.92,217,164,266,15,5,10,18,9,9,9,3,6,-2,-1,-1,74%,55%,92%,145,111,177,29%,50%,22%,0,0,0,2,1,1
119,https://vlr.gg/player/16483/gloomy,2025-01-27 11:30:00,1.09,0.31,0.68,172,221,128,12,8,4,19,8,11,6,3,3,0,0,0,65%,82%,50%,120,147,95,11%,19%,0%,1,1,0,1,1,0
120,https://vlr.gg/player/341/quick,2025-01-27 11:00:00,0.93,1.48,1.21,234,183,286,38,15,23,28,15,13,8,4,4,+3,+1,+2,67%,65%,70%,148,123,173,29%,20%,40%,6,2,4,3,1,2
121,https://vlr.gg/player/15473/yuno,2025-01-27 11:00:00,0.97,1.26,1.11,177,177,178,30,15,15,27,15,12,20,6,14,-2,-1,-1,72%,65%,78%,111,101,120,21%,20%,22%,2,2,0,4,3,1
122,https://vlr.gg/player/6959/flickless,2025-01-27 11:00:00,0.93,1.18,1.05,212,183,241,33,14,19,33,17,16,18,9,9,+2,0,+2,78%,78%,78%,143,118,167,33%,34%,31%,3,1,2,1,1,0
123,https://vlr.gg/player/8834/bucher,2025-01-27 11:00:00,0.95,1.01,0.98,188,188,189,31,16,15,30,16,14,7,1,6,+1,+2,-1,70%,61%,78%,122,118,125,39%,50%,32%,6,3,3,5,1,4
124,https://vlr.gg/player/1839/polvi,2025-01-27 11:00:00,0.72,0.52,0.62,150,168,132,23,12,11,37,19,18,7,5,2,-8,-3,-5,63%,61%,65%,98,114,81,16%,19%,12%,4,3,1,12,6,6
125,https://vlr.gg/player/13435/fragger,2025-01-27 11:00:00,1.36,1.17,1.27,243,258,229,41,22,19,30,15,15,17,8,9,+1,-1,+2,74%,65%,83%,150,167,133,40%,36%,46%,5,2,3,4,3,1
126,https://vlr.gg/player/6909/jannyxd,2025-01-27 11:00:00,0.84,1.56,1.20,258,190,327,40,14,26,30,16,14,7,4,3,+2,-1,+3,67%,61%,74%,157,115,199,16%,15%,18%,9,5,4,7,6,1
127,https://vlr.gg/player/1493/starkk,2025-01-27 11:00:00,0.98,1.04,1.01,198,192,204,32,15,17,30,16,14,12,6,6,+1,+2,-1,67%,65%,70%,137,138,136,23%,30%,19%,5,2,3,4,0,4
128,https://vlr.gg/player/15376/grtw,2025-01-27 11:00:00,0.83,0.85,0.84,162,206,119,25,15,10,30,19,11,11,6,5,+1,+1,0,76%,78%,74%,118,142,95,35%,39%,31%,4,2,2,3,1,2
129,https://vlr.gg/player/5203/bati,2025-01-27 11:00:00,0.58,0.64,0.61,119,97,141,17,7,10,35,17,18,7,6,1,-1,+2,-3,57%,52%,61%,84,69,100,23%,20%,27%,2,2,0,3,0,3
130,https://vlr.gg/player/443/zeddy,2025-01-27 11:00:00,0.71,0.70,0.71,170,166,176,17,8,9,29,13,16,13,6,7,-3,-2,-1,65%,71%,59%,113,98,127,26%,23%,29%,1,1,0,4,3,1
131,https://vlr.gg/player/8808/pyrolll,2025-01-27 11:00:00,0.61,0.71,0.66,119,132,106,14,7,7,29,14,15,12,8,4,-3,-3,0,53%,59%,47%,77,99,56,24%,21%,29%,2,1,1,5,4,1
132,https://vlr.gg/player/2431/basya,2025-01-27 11:00:00,0.80,0.46,0.64,135,152,118,16,10,6,28,13,15,12,8,4,-1,0,-1,56%,76%,35%,83,86,79,13%,14%,11%,1,0,1,2,0,2
133,https://vlr.gg/player/173/l0udly,2025-01-27 11:00:00,0.89,0.17,0.53,137,230,45,15,13,2,31,15,16,4,2,2,+2,+4,-2,47%,59%,35%,80,129,31,24%,33%,7%,4,4,0,2,0,2
134,https://vlr.gg/player/363/7ssk7,2025-01-27 11:00:00,0.58,0.39,0.49,123,141,105,13,7,6,28,13,15,4,3,1,-3,0,-3,56%,71%,41%,78,93,63,26%,21%,38%,5,2,3,8,2,6
135,https://vlr.gg/player/1524/h1ber,2025-01-27 11:00:00,1.94,1.61,1.78,306,335,278,41,23,18,13,5,8,9,5,4,+4,+1,+3,79%,88%,71%,202,215,188,38%,40%,35%,5,2,3,1,1,0
136,https://vlr.gg/player/29972/michel,2025-01-27 11:00:00,1.91,1.36,1.63,318,346,292,40,22,18,18,7,11,8,5,3,+6,+6,0,82%,94%,71%,216,235,196,32%,25%,43%,11,7,4,5,1,4
137,https://vlr.gg/player/18162/serial,2025-01-27 11:00:00,1.42,1.61,1.51,258,265,252,33,16,17,16,8,8,8,7,1,+3,+2,+1,91%,94%,88%,180,192,167,45%,32%,64%,4,3,1,1,1,0
138,https://vlr.gg/player/16209/famsii,2025-01-27 11:00:00,1.40,1.06,1.23,179,178,180,24,13,11,14,5,9,9,7,2,-2,-1,-1,88%,88%,88%,126,125,127,32%,21%,48%,1,0,1,3,1,2
139,https://vlr.gg/player/8805/sacake,2025-01-27 11:00:00,0.78,0.62,0.70,76,72,81,7,3,4,15,6,9,16,9,7,-3,-1,-2,74%,76%,71%,53,47,59,21%,26%,15%,0,0,0,3,1,2
140,https://vlr.gg/player/2894/kiles,2025-01-27 11:00:00,1.13,1.39,1.29,256,268,250,16,5,11,13,5,8,3,0,3,+1,+1,0,74%,43%,92%,170,181,164,32%,46%,26%,1,1,0,0,0,0
141,https://vlr.gg/player/2700/jas,2025-01-27 11:00:00,0.54,1.28,1.01,248,173,292,16,4,12,15,7,8,1,0,1,+2,+1,+1,63%,57%,67%,163,109,194,26%,31%,24%,6,2,4,4,1,3
142,https://vlr.gg/player/562/zeek,2025-01-27 11:00:00,0.83,0.75,0.78,175,190,167,10,4,6,14,5,9,6,2,4,+1,0,+1,68%,71%,67%,127,128,126,25%,21%,27%,1,0,1,0,0,0
143,https://vlr.gg/player/1369/doma,2025-01-27 11:00:00,0.80,0.43,0.56,101,131,85,5,3,2,11,4,7,7,2,5,-3,0,-3,58%,57%,58%,87,100,80,23%,18%,27%,0,0,0,3,0,3
144,https://vlr.gg/player/1616/starki,2025-01-27 11:00:00,0.64,0.40,0.49,90,137,63,4,3,1,14,6,8,6,2,4,0,+1,-1,79%,86%,75%,66,89,53,21%,31%,9%,2,2,0,2,1,1
145,https://vlr.gg/player/22617/vitie,2025-01-27 11:00:00,1.72,1.40,1.60,222,231,207,14,10,4,7,4,3,11,7,4,0,0,0,74%,75%,71%,154,155,153,40%,43%,35%,0,0,0,0,0,0
146,https://vlr.gg/player/7106/diseased,2025-01-27 11:00:00,1.67,1.30,1.54,286,318,234,20,14,6,10,7,3,3,2,1,+4,+3,+1,84%,75%,100%,163,169,151,19%,18%,21%,4,3,1,0,0,0
147,https://vlr.gg/player/252/d3ffo,2025-01-27 11:00:00,1.25,0.87,1.11,183,173,201,13,8,5,10,5,5,3,3,0,+2,+2,0,74%,75%,71%,127,122,136,28%,27%,29%,4,3,1,2,1,1
148,https://vlr.gg/player/23098/aphun,2025-01-27 11:00:00,0.13,2.29,0.93,194,71,406,11,1,10,12,9,3,7,4,3,-2,-2,0,58%,50%,71%,133,59,259,23%,5%,36%,1,1,0,3,3,0
149,https://vlr.gg/player/30901/ianto,2025-01-27 11:00:00,0.71,0.29,0.56,120,150,71,9,7,2,12,7,5,3,2,1,-5,-1,-4,63%,75%,43%,68,83,43,20%,25%,11%,0,0,0,5,1,4
150,https://vlr.gg/player/2525/szimpli,2025-01-27 11:00:00,1.10,0.97,1.03,196,196,197,16,8,8,17,7,10,5,3,2,0,-1,+1,58%,58%,58%,132,125,139,40%,47%,33%,3,1,2,3,2,1
151,https://vlr.gg/player/10378/almo,2025-01-27 11:00:00,1.26,0.53,0.90,175,253,98,15,11,4,16,8,8,4,3,1,-1,+1,-2,67%,75%,58%,115,157,73,42%,47%,33%,1,1,0,2,0,2
152,https://vlr.gg/player/4525/stix,2025-01-27 11:00:00,0.63,1.02,0.83,184,112,256,15,4,11,19,9,10,10,7,3,-2,-1,-1,67%,67%,67%,116,60,171,17%,15%,17%,2,1,1,4,2,2
153,https://vlr.gg/player/2701/maniek,2025-01-27 11:00:00,0.81,0.69,0.75,201,165,239,14,6,8,20,9,11,6,4,2,0,+1,-1,63%,75%,50%,143,118,167,25%,13%,43%,2,1,1,2,0,2
154,https://vlr.gg/player/164/bzt,2025-01-27 11:00:00,0.96,0.52,0.74,124,174,75,12,9,3,17,7,10,3,0,3,+1,+2,-1,63%,75%,50%,77,101,54,32%,24%,57%,3,3,0,2,1,1
155,https://vlr.gg/player/7490/anguist,2025-01-27 11:00:00,1.91,1.26,1.58,238,277,200,24,15,9,11,4,7,12,6,6,+2,+2,0,92%,100%,83%,163,184,142,21%,18%,25%,2,2,0,0,0,0
156,https://vlr.gg/player/7104/juseu,2025-01-27 11:00:00,0.97,1.74,1.36,286,207,366,24,9,15,16,7,9,2,1,1,+2,+1,+1,75%,83%,67%,180,128,231,26%,21%,31%,5,3,2,3,2,1
157,https://vlr.gg/player/217/seider,2025-01-27 11:00:00,1.35,0.62,0.98,177,233,121,12,8,4,14,6,8,12,8,4,-1,0,-1,88%,92%,83%,137,190,85,28%,27%,31%,2,1,1,3,1,2
158,https://vlr.gg/player/33358/shinnok,2025-01-27 11:00:00,1.07,0.85,0.96,178,200,158,15,9,6,15,7,8,6,2,4,+1,+2,-1,79%,83%,75%,108,117,99,19%,25%,13%,3,2,1,2,0,2
159,https://vlr.gg/player/4589/burzzy,2025-01-27 11:00:00,0.73,0.50,0.62,145,181,111,13,8,5,19,10,9,9,3,6,-2,-1,-1,83%,92%,75%,94,111,76,38%,35%,42%,1,0,1,3,1,2
160,https://vlr.gg/player/37840/msh,2025-01-27 11:00:00,0.84,1.34,1.09,162,139,187,14,6,8,12,7,5,1,0,1,0,-1,+1,75%,75%,75%,107,86,129,20%,15%,25%,2,1,1,2,2,0
161,https://vlr.gg/player/8593/grmekista,2025-01-27 11:00:00,0.66,1.39,1.03,160,116,206,13,4,9,14,7,7,4,1,3,-1,0,-1,71%,75%,67%,101,69,133,34%,40%,32%,1,0,1,2,0,2
162,https://vlr.gg/player/4537/tajrex,2025-01-27 11:00:00,0.95,1.04,1.00,206,169,243,16,7,9,17,7,10,6,4,2,+1,+1,0,58%,67%,50%,145,107,183,23%,32%,20%,2,1,1,1,0,1
163,https://vlr.gg/player/3839/prti,2025-01-27 11:00:00,0.96,0.57,0.76,142,167,118,10,6,4,17,7,10,5,2,3,+1,0,+1,67%,75%,58%,102,126,79,32%,33%,29%,3,1,2,2,1,1
164,https://vlr.gg/player/25906/alexiiik,2025-01-27 11:00:00,0.64,0.58,0.61,174,181,168,14,7,7,21,10,11,4,3,1,-1,0,-1,71%,100%,42%,119,137,101,18%,17%,19%,4,3,1,5,3,2
165,https://vlr.gg/player/42702/krizz,2025-01-27 11:00:00,1.18,1.45,1.32,234,186,282,20,8,12,11,6,5,4,1,3,+3,+1,+2,79%,75%,83%,164,138,190,26%,25%,27%,4,2,2,1,1,0
166,https://vlr.gg/player/36748/czester,2025-01-27 11:00:00,1.43,0.69,1.06,219,310,129,18,14,4,15,7,8,6,3,3,-2,-1,-1,67%,75%,58%,151,193,109,45%,55%,31%,4,2,2,6,3,3
167,https://vlr.gg/player/9556/demek,2025-01-27 11:00:00,0.86,1.03,0.95,175,198,153,16,9,7,15,9,6,2,0,2,-1,0,-1,67%,50%,83%,111,130,92,22%,33%,12%,3,2,1,4,2,2
168,https://vlr.gg/player/10448/kozok,2025-01-27 11:00:00,0.69,1.14,0.92,145,149,143,11,5,6,12,8,4,8,7,1,0,0,0,79%,75%,83%,83,94,71,20%,15%,27%,1,0,1,1,0,1
169,https://vlr.gg/player/9557/nefi,2025-01-27 11:00:00,0.79,1.06,0.92,172,150,195,16,7,9,14,7,7,9,4,5,0,0,0,75%,75%,75%,107,91,124,40%,38%,41%,0,0,0,0,0,0
170,https://vlr.gg/player/27789/deyten,2025-01-27 11:00:00,1.23,1.55,1.34,271,263,286,20,12,8,13,9,4,8,5,3,+1,+1,0,84%,83%,86%,173,165,188,39%,33%,47%,2,1,1,1,0,1
171,https://vlr.gg/player/47270/darkwinjett,2025-01-27 11:00:00,0.89,1.73,1.20,183,167,210,13,7,6,11,8,3,5,4,1,0,-1,+1,89%,92%,86%,143,119,185,29%,22%,40%,1,0,1,1,1,0
172,https://vlr.gg/player/33974/appa,2025-01-27 11:00:00,1.10,1.20,1.14,241,234,254,17,10,7,13,9,4,6,5,1,0,+1,-1,74%,75%,71%,149,150,147,13%,15%,7%,2,1,1,2,0,2
173,https://vlr.gg/player/3934/eleo,2025-01-27 11:00:00,0.90,1.14,0.98,164,146,198,11,6,5,11,7,4,11,9,2,-2,-3,+1,84%,92%,71%,102,94,116,35%,36%,33%,1,0,1,3,3,0
174,https://vlr.gg/player/18384/bully,2025-01-27 11:00:00,0.91,0.98,0.93,160,170,144,11,7,4,11,7,4,2,1,1,0,0,0,74%,75%,71%,106,104,108,29%,31%,27%,3,3,0,3,3,0
175,https://vlr.gg/player/12471/kalkkuna,2025-01-27 11:00:00,1.04,1.51,1.34,279,284,277,19,7,12,13,6,7,2,1,1,+2,0,+2,74%,71%,75%,183,172,190,23%,31%,19%,5,2,3,3,2,1
176,https://vlr.gg/player/6101/999kvmil,2025-01-27 11:00:00,0.28,1.27,0.91,164,71,220,10,1,9,14,6,8,9,3,6,-3,-1,-2,68%,57%,75%,116,50,154,32%,20%,35%,0,0,0,3,1,2
177,https://vlr.gg/player/15491/maximn,2025-01-27 11:00:00,0.92,0.85,0.88,181,183,181,11,4,7,13,6,7,4,1,3,+2,+1,+1,68%,43%,83%,122,134,116,44%,45%,44%,2,1,1,0,0,0
178,https://vlr.gg/player/13024/vuubit,2025-01-27 11:00:00,0.77,0.64,0.69,192,203,186,11,5,6,17,6,11,7,2,5,+1,0,+1,74%,71%,75%,116,115,116,38%,45%,33%,2,0,2,1,0,1
179,https://vlr.gg/player/8440/puggy,2025-01-27 11:00:00,0.33,0.80,0.63,122,82,147,8,2,6,15,6,9,8,3,5,-1,-1,0,63%,57%,67%,83,63,94,40%,50%,38%,1,0,1,2,1,1
180,https://vlr.gg/player/15735/krostaly,2025-01-27 10:30:00,1.69,1.59,1.64,308,330,289,28,14,14,16,6,10,6,3,3,+2,+1,+1,83%,91%,75%,186,179,193,40%,38%,42%,2,1,1,0,0,0
181,https://vlr.gg/player/18655/best,2025-01-27 10:30:00,1.60,0.87,1.22,298,342,258,24,14,10,17,6,11,6,1,5,+1,+3,-2,83%,91%,75%,188,193,184,35%,42%,29%,7,5,2,6,2,4
182,https://vlr.gg/player/40842/ibonata,2025-01-27 10:30:00,0.99,1.05,1.02,195,179,211,16,7,9,18,8,10,18,11,7,+2,+1,+1,78%,82%,75%,119,112,125,23%,17%,28%,4,1,3,2,0,2
183,https://vlr.gg/player/31307/yigox,2025-01-27 10:30:00,0.87,0.93,0.90,183,179,187,14,6,8,16,7,9,11,5,6,-2,-2,0,74%,73%,75%,127,134,121,36%,32%,40%,0,0,0,2,2,0
184,https://vlr.gg/player/33551/slaughter,2025-01-27 10:30:00,1.05,0.51,0.77,121,138,107,9,5,4,13,5,8,13,8,5,0,0,0,83%,91%,75%,85,98,72,25%,12%,40%,0,0,0,0,0,0
185,https://vlr.gg/player/40841/kabzi,2025-01-27 10:30:00,1.17,0.81,1.00,238,268,207,19,12,7,19,9,10,11,5,6,0,+1,-1,83%,92%,73%,152,179,122,24%,37%,13%,2,1,1,2,0,2
186,https://vlr.gg/player/50776/influx,2025-01-27 10:30:00,1.22,0.74,0.99,218,256,178,18,11,7,19,10,9,4,4,0,-1,-1,0,78%,92%,64%,147,168,124,17%,15%,21%,3,1,2,4,2,2
187,https://vlr.gg/player/4894/jn3v1ce,2025-01-27 10:30:00,1.23,0.72,0.98,201,231,170,17,11,6,17,8,9,7,4,3,-2,-1,-1,78%,92%,64%,135,139,131,28%,30%,25%,0,0,0,2,1,1
188,https://vlr.gg/player/13571/musz3kk,2025-01-27 10:30:00,1.15,0.77,0.97,251,296,202,17,11,6,19,10,9,6,4,2,+1,+2,-1,65%,75%,55%,163,185,138,14%,10%,20%,5,4,1,4,2,2
189,https://vlr.gg/player/5500/docent,2025-01-27 10:30:00,0.61,0.90,0.75,122,78,170,9,3,6,17,8,9,11,6,5,-1,-1,0,70%,75%,64%,93,62,128,16%,6%,23%,0,0,0,1,1,0
190,https://vlr.gg/player/31855/celasun,2025-01-27 09:30:00,0.70,1.19,0.90,172,132,234,12,5,7,16,10,6,0,0,0,-3,-2,-1,50%,42%,63%,117,86,165,33%,43%,26%,1,1,0,4,3,1
191,https://vlr.gg/player/39357/s0pp,2025-01-27 09:30:00,0.70,0.59,0.66,175,162,196,12,6,6,18,11,7,2,2,0,0,0,0,50%,50%,50%,114,102,133,30%,29%,31%,3,2,1,3,2,1
192,https://vlr.gg/player/40843/audaz,2025-01-27 09:30:00,0.40,1.01,0.64,134,110,171,9,4,5,17,12,5,2,2,0,0,-2,+2,40%,33%,50%,92,78,112,43%,56%,36%,2,0,2,2,2,0
193,https://vlr.gg/player/16552/pckwn,2025-01-27 09:30:00,0.62,0.68,0.64,174,175,175,11,7,4,19,12,7,8,5,3,-1,-1,0,65%,58%,75%,107,107,108,37%,35%,40%,1,0,1,2,1,1
194,https://vlr.gg/player/4962/lurzy0y0,2025-01-27 09:30:00,0.83,0.17,0.57,106,126,78,7,5,2,17,10,7,5,3,2,-2,-1,-1,40%,33%,50%,73,96,37,32%,31%,33%,0,0,0,2,1,1
195,https://vlr.gg/player/8041/brave,2025-01-27 09:30:00,1.67,1.33,1.46,260,280,247,18,9,9,10,4,6,12,2,10,+1,0,+1,75%,63%,83%,170,171,169,45%,67%,37%,1,0,1,0,0,0
196,https://vlr.gg/player/10163/cyderx,2025-01-27 09:30:00,0.95,1.74,1.43,262,164,328,20,4,16,9,4,5,6,2,4,+2,0,+2,70%,50%,83%,159,117,187,63%,83%,56%,3,1,2,1,1,0
197,https://vlr.gg/player/10160/izzy,2025-01-27 09:30:00,0.91,1.55,1.29,266,247,279,17,6,11,12,7,5,9,3,6,+2,-2,+4,80%,63%,92%,174,167,178,24%,33%,18%,6,1,5,4,3,1
198,https://vlr.gg/player/10161/qutionerx,2025-01-27 09:30:00,1.80,0.88,1.25,218,333,143,16,10,6,11,5,6,12,3,9,0,+2,-2,80%,75%,83%,132,199,88,23%,19%,31%,2,2,0,2,0,2
199,https://vlr.gg/player/12774/anima,2025-01-27 09:30:00,0.79,1.50,1.21,187,82,257,16,3,13,9,4,5,6,1,5,+1,0,+1,85%,75%,92%,120,60,159,26%,25%,27%,1,0,1,0,0,0
200,https://vlr.gg/player/7437/kellys,2025-01-27 06:00:00,0.85,1.25,1.06,222,178,267,38,14,24,36,17,19,13,7,6,+3,+2,+1,70%,64%,76%,151,123,175,26%,20%,31%,6,3,3,3,1,2
201,https://vlr.gg/player/5796/kr1stal,2025-01-27 06:00:00,1.32,0.53,0.90,177,233,126,29,20,9,36,14,22,17,5,12,+2,+2,0,70%,77%,64%,117,153,86,18%,23%,12%,5,3,2,3,1,2
202,https://vlr.gg/player/9152/deryeon,2025-01-27 06:00:00,1.31,0.52,0.89,165,212,125,28,18,10,34,13,21,10,6,4,-3,-1,-2,66%,77%,56%,120,157,88,25%,27%,22%,2,1,1,5,2,3
203,https://vlr.gg/player/4428/udotan,2025-01-27 06:00:00,0.75,0.81,0.79,185,193,181,29,14,15,36,17,19,9,7,2,-8,-4,-4,62%,68%,56%,127,137,119,19%,14%,28%,5,3,2,13,7,6
204,https://vlr.gg/player/13219/papi,2025-01-27 06:00:00,0.60,0.92,0.77,137,135,138,23,10,13,34,19,15,18,11,7,0,-1,+1,70%,73%,68%,93,91,95,34%,29%,38%,2,0,2,2,1,1
205,https://vlr.gg/player/6672/meiy,2025-01-27 06:00:00,1.49,1.24,1.37,265,277,262,46,25,21,30,15,15,9,5,4,+8,+5,+3,79%,84%,73%,173,187,157,28%,36%,18%,11,8,3,3,3,0
206,https://vlr.gg/player/13002/akame,2025-01-27 06:00:00,1.02,1.49,1.24,214,188,254,36,16,20,29,16,13,15,11,4,+3,0,+3,79%,76%,82%,141,123,162,40%,36%,44%,5,1,4,2,1,1
207,https://vlr.gg/player/4052/jinboong,2025-01-27 06:00:00,1.20,0.91,1.06,216,204,214,34,18,16,31,14,17,14,10,4,+2,0,+2,77%,76%,77%,131,126,138,41%,43%,38%,4,1,3,2,1,1
208,https://vlr.gg/player/48577/gyen,2025-01-27 06:00:00,1.30,0.53,0.94,172,215,113,28,20,8,27,11,16,8,3,5,-2,+1,-3,62%,76%,45%,120,155,79,33%,31%,40%,3,3,0,5,2,3
209,https://vlr.gg/player/10627/art,2025-01-27 06:00:00,0.71,1.04,0.87,159,128,197,27,12,15,30,15,15,15,8,7,-5,-2,-3,79%,84%,73%,104,82,130,22%,26%,19%,3,1,2,8,3,5
210,https://vlr.gg/player/8497/monyet,2025-01-27 03:00:00,1.40,1.07,1.27,239,280,182,49,33,16,31,18,13,16,12,4,-2,0,-2,73%,79%,64%,151,165,130,33%,31%,39%,4,4,0,6,4,2
211,https://vlr.gg/player/25025/estrella,2025-01-27 03:00:00,1.39,1.04,1.25,211,216,188,43,29,14,28,15,13,26,14,12,-3,-2,-1,75%,76%,73%,128,132,121,29%,33%,22%,1,1,0,4,3,1
212,https://vlr.gg/player/4866/kushy,2025-01-27 03:00:00,1.08,1.29,1.16,237,209,266,43,23,20,38,22,16,20,17,3,+3,+3,0,75%,82%,64%,157,146,173,39%,31%,50%,6,4,2,3,1,2
213,https://vlr.gg/player/4871/xffero,2025-01-27 03:00:00,1.01,0.89,0.96,186,194,166,37,25,12,33,19,14,12,6,6,+1,+3,-2,79%,82%,73%,122,127,114,33%,32%,34%,7,4,3,6,1,5
214,https://vlr.gg/player/24895/jemkin,2025-01-27 03:00:00,0.81,0.97,0.87,196,181,230,41,23,18,42,24,18,5,4,1,+3,+2,+1,66%,65%,68%,122,116,133,31%,27%,41%,11,7,4,8,5,3
215,https://vlr.gg/player/2334/jessievash,2025-01-27 03:00:00,1.21,1.22,1.21,239,256,235,48,21,27,41,17,24,10,2,8,+5,+5,0,70%,73%,68%,169,162,174,33%,29%,35%,6,5,1,1,0,1
216,https://vlr.gg/player/8504/invy,2025-01-27 03:00:00,1.00,0.93,0.96,184,196,194,35,15,20,45,16,29,27,10,17,+1,+1,0,77%,86%,71%,133,121,140,38%,39%,37%,4,1,3,3,0,3
217,https://vlr.gg/player/9735/2ge,2025-01-27 03:00:00,0.96,0.66,0.78,153,184,143,30,15,15,41,15,26,18,7,11,-4,0,-4,70%,64%,74%,99,116,89,19%,36%,10%,5,2,3,9,2,7
218,https://vlr.gg/player/9740/wild0reoo,2025-01-27 03:00:00,0.56,0.91,0.75,157,86,198,27,6,21,41,15,26,4,2,2,+2,0,+2,59%,45%,68%,105,64,132,33%,22%,38%,7,2,5,5,2,3
219,https://vlr.gg/player/7405/jremy,2025-01-27 03:00:00,0.90,0.45,0.63,159,216,121,31,16,15,45,17,28,5,4,1,-6,-2,-4,59%,82%,44%,100,145,72,26%,33%,19%,5,3,2,11,5,6
220,https://vlr.gg/player/7868/lele,2025-01-26 15:15:00,0.61,1.06,0.95,201,146,218,22,4,18,25,7,18,9,1,8,-2,0,-2,61%,43%,67%,124,81,136,24%,22%,24%,2,0,2,4,0,4
221,https://vlr.gg/player/16447/d3mur,2025-01-26 15:15:00,0.12,0.96,0.76,212,88,250,22,2,20,27,7,20,1,0,1,-3,-2,-1,58%,43%,63%,137,59,160,22%,20%,22%,6,1,5,9,3,6
222,https://vlr.gg/player/4277/n-a-i-s,2025-01-26 15:15:00,0.71,0.66,0.67,158,247,135,15,5,10,27,7,20,7,1,6,0,-1,+1,48%,57%,46%,106,147,94,26%,25%,26%,2,0,2,2,1,1
223,https://vlr.gg/player/5854/z3ro,2025-01-26 15:15:00,0.24,0.54,0.45,120,87,132,10,2,8,27,7,20,6,0,6,-1,-1,0,52%,29%,58%,91,62,100,26%,40%,24%,0,0,0,1,1,0
224,https://vlr.gg/player/1472/falltw,2025-01-26 15:15:00,0.25,0.35,0.33,97,92,97,9,2,7,28,7,21,9,1,8,-5,-1,-4,45%,43%,46%,57,47,60,15%,20%,13%,0,0,0,5,1,4
225,https://vlr.gg/player/1470/simond4rk,2025-01-26 15:15:00,1.93,2.01,1.95,353,374,287,44,35,9,16,13,3,10,10,0,+6,+3,+3,84%,79%,100%,231,248,174,25%,25%,21%,8,5,3,2,2,0
226,https://vlr.gg/player/1944/cayden,2025-01-26 15:15:00,1.29,1.81,1.41,175,161,232,20,14,6,12,11,1,23,16,7,-1,-1,0,94%,92%,100%,122,119,132,26%,28%,23%,0,0,0,1,1,0
227,https://vlr.gg/player/8226/waddle,2025-01-26 15:15:00,1.29,1.51,1.34,238,233,259,26,19,7,17,14,3,15,11,4,+4,+4,0,84%,79%,100%,164,160,177,32%,37%,23%,5,5,0,1,1,0
228,https://vlr.gg/player/2190/baddyg,2025-01-26 15:15:00,1.24,1.13,1.22,205,188,245,22,15,7,17,12,5,16,15,1,+1,+1,0,87%,88%,86%,130,123,154,30%,38%,17%,3,2,1,2,1,1
229,https://vlr.gg/player/12474/tag,2025-01-26 15:15:00,1.02,1.63,1.16,188,167,259,22,16,6,16,13,3,11,6,5,+1,-1,+2,77%,71%,100%,128,114,175,31%,34%,25%,5,3,2,4,4,0
230,https://vlr.gg/player/2690/hoody,2025-01-26 14:00:00,1.14,0.58,0.92,160,174,147,22,15,7,25,12,13,6,4,2,+1,+1,0,62%,71%,47%,116,118,112,26%,24%,29%,2,1,1,1,0,1
231,https://vlr.gg/player/5292/al0rante,2025-01-26 14:00:00,1.13,0.55,0.91,188,215,147,27,20,7,28,16,12,5,2,3,-7,-4,-3,69%,75%,60%,124,142,94,56%,67%,39%,0,0,0,7,4,3
232,https://vlr.gg/player/4244/yaboilewis,2025-01-26 14:00:00,1.15,0.27,0.81,182,235,110,24,20,4,31,16,15,5,4,1,+5,+7,-2,62%,75%,40%,120,145,80,38%,47%,19%,10,9,1,5,2,3
233,https://vlr.gg/player/2658/xuss,2025-01-26 14:00:00,0.93,0.58,0.80,172,172,166,22,14,8,28,15,13,4,3,1,-5,-2,-3,54%,63%,40%,117,121,112,45%,46%,44%,2,1,1,7,3,4
234,https://vlr.gg/player/1457/mistic,2025-01-26 14:00:00,0.69,0.39,0.58,123,149,79,15,12,3,30,18,12,11,9,2,-3,-2,-1,62%,63%,60%,85,100,62,27%,28%,25%,1,1,0,4,3,1
235,https://vlr.gg/player/4325/musashi,2025-01-26 14:00:00,1.53,1.07,1.25,214,224,208,33,14,19,21,5,16,9,5,4,0,+2,-2,74%,100%,58%,136,142,133,40%,35%,44%,3,2,1,3,0,3
236,https://vlr.gg/player/9508/leosen,2025-01-26 14:00:00,1.69,0.88,1.19,188,215,167,27,12,15,21,4,17,14,10,4,0,+1,-1,72%,93%,58%,116,146,96,34%,41%,28%,2,1,1,2,0,2
237,https://vlr.gg/player/12528/disisjohn,2025-01-26 14:00:00,1.56,0.87,1.14,238,285,204,33,16,17,25,7,18,5,2,3,+7,+4,+3,74%,93%,63%,152,184,133,26%,26%,25%,11,6,5,4,2,2
238,https://vlr.gg/player/45494/proxh,2025-01-26 14:00:00,1.24,0.99,1.09,202,197,199,24,11,13,22,6,16,20,6,14,+1,+1,0,74%,80%,71%,129,112,140,25%,37%,21%,4,2,2,3,1,2
239,https://vlr.gg/player/4629/azury,2025-01-26 14:00:00,1.15,1.05,1.09,196,215,175,25,12,13,21,7,14,14,3,11,+1,+1,0,79%,93%,71%,117,134,106,30%,32%,29%,4,1,3,3,0,3
240,https://vlr.gg/player/8034/thenightche,2025-01-26 13:45:00,0.33,1.83,1.39,297,125,369,18,2,16,13,5,8,1,1,0,+1,0,+1,65%,40%,75%,193,96,234,39%,25%,42%,1,0,1,0,0,0
241,https://vlr.gg/player/6038/b3astm0d3,2025-01-26 13:45:00,0.60,0.78,0.73,150,133,158,9,3,6,14,5,9,3,0,3,-3,0,-3,59%,80%,50%,88,66,97,32%,17%,38%,0,0,0,3,0,3
242,https://vlr.gg/player/2107/russ,2025-01-26 13:45:00,0.66,0.65,0.65,150,171,142,8,2,6,15,5,10,3,2,1,-1,-1,0,59%,60%,58%,115,132,108,36%,30%,40%,0,0,0,1,1,0
243,https://vlr.gg/player/11527/noman,2025-01-26 13:45:00,0.01,0.89,0.57,160,11,222,9,0,9,15,5,10,0,0,0,-2,-2,0,53%,20%,67%,95,11,131,0%,0%,0%,2,0,2,4,2,2
244,https://vlr.gg/player/10429/luvjix,2025-01-26 13:45:00,0.22,0.02,0.04,68,130,43,3,2,1,17,5,12,3,0,3,-6,-2,-4,41%,20%,50%,43,79,29,36%,33%,38%,0,0,0,6,2,4
245,https://vlr.gg/player/2701/maniek,2025-01-26 13:45:00,1.41,1.96,1.57,348,312,437,23,14,9,12,9,3,3,2,1,+3,+1,+2,88%,83%,100%,220,194,283,17%,15%,23%,5,3,2,2,2,0
246,https://vlr.gg/player/2525/szimpli,2025-01-26 13:45:00,1.25,1.96,1.46,216,196,264,15,9,6,7,6,1,2,1,1,+3,+2,+1,76%,67%,100%,153,142,178,21%,17%,27%,3,2,1,0,0,0
247,https://vlr.gg/player/10378/almo,2025-01-26 13:45:00,1.00,1.55,1.16,211,214,206,13,10,3,10,8,2,7,2,5,0,0,0,65%,58%,80%,143,137,157,26%,30%,19%,1,1,0,1,1,0
248,https://vlr.gg/player/4525/stix,2025-01-26 13:45:00,1.00,1.39,1.11,180,219,87,12,10,2,8,8,0,6,4,2,+2,+1,+1,82%,75%,100%,119,154,36,25%,30%,0%,2,1,1,0,0,0
249,https://vlr.gg/player/164/bzt,2025-01-26 13:45:00,0.82,1.73,1.09,192,146,303,11,6,5,10,7,3,11,4,7,+3,+2,+1,88%,83%,100%,117,90,181,23%,24%,20%,3,2,1,0,0,0
250,https://vlr.gg/player/21584/deminatix,2025-01-26 13:30:00,0.70,2.25,1.22,267,164,475,16,6,10,14,10,4,4,3,1,+3,0,+3,72%,67%,83%,163,110,268,31%,22%,38%,5,1,4,2,1,1
251,https://vlr.gg/player/11516/drky,2025-01-26 13:30:00,0.85,0.57,0.76,140,146,131,10,7,3,13,9,4,2,0,2,-2,-2,0,67%,67%,67%,91,91,91,41%,53%,25%,0,0,0,2,2,0
252,https://vlr.gg/player/16483/gloomy,2025-01-26 13:30:00,0.91,0.43,0.75,127,145,94,6,5,1,13,9,4,4,2,2,0,0,0,61%,58%,67%,98,109,76,16%,24%,0%,0,0,0,0,0,0
253,https://vlr.gg/player/10114/baha,2025-01-26 13:30:00,0.43,0.87,0.57,140,113,194,10,5,5,16,11,5,3,0,3,-2,-1,-1,67%,58%,83%,95,70,145,43%,45%,40%,0,0,0,2,1,1
254,https://vlr.gg/player/12226/sturnn,2025-01-26 13:30:00,0.39,0.48,0.42,121,127,110,8,5,3,16,11,5,1,1,0,-1,-1,0,56%,50%,67%,82,85,75,35%,46%,14%,3,3,0,4,4,0
255,https://vlr.gg/player/10152/padisah,2025-01-26 13:30:00,0.45,2.02,1.49,300,161,370,20,3,17,11,6,5,2,0,2,0,-3,+3,67%,50%,75%,190,113,228,41%,33%,43%,4,0,4,4,3,1
256,https://vlr.gg/player/3549/touven,2025-01-26 13:30:00,0.85,1.66,1.39,242,135,296,15,3,12,9,4,5,4,0,4,0,0,0,78%,67%,83%,167,95,203,36%,22%,41%,1,0,1,1,0,1
257,https://vlr.gg/player/19776/jrayn,2025-01-26 13:30:00,1.64,1.00,1.22,180,287,127,11,6,5,8,4,4,11,4,7,-1,0,-1,100%,100%,100%,128,197,94,31%,41%,22%,0,0,0,1,0,1
258,https://vlr.gg/player/13545/werlass,2025-01-26 13:30:00,1.33,0.98,1.10,190,248,161,14,6,8,10,4,6,4,0,4,+4,+2,+2,100%,100%,100%,124,160,106,16%,31%,10%,4,2,2,0,0,0
259,https://vlr.gg/player/10883/baransel,2025-01-26 13:30:00,1.17,0.77,0.90,203,219,196,12,4,8,12,4,8,9,4,5,-1,-1,0,83%,83%,83%,135,146,130,28%,36%,24%,1,0,1,2,1,1
260,https://vlr.gg/player/13258/cyvoph,2025-01-26 13:15:00,1.50,1.60,1.55,290,283,300,69,35,34,42,23,19,34,19,15,+6,+2,+4,80%,80%,81%,179,181,177,24%,21%,28%,7,3,4,1,1,0
261,https://vlr.gg/player/114/enzo,2025-01-26 13:15:00,1.23,1.03,1.13,209,218,185,49,30,19,40,22,18,19,11,8,+1,+1,0,82%,83%,81%,133,133,132,25%,30%,19%,8,6,2,7,5,2
262,https://vlr.gg/player/3582/keloqz,2025-01-26 13:15:00,0.85,1.26,1.04,183,180,189,47,23,24,38,24,14,13,5,8,-1,-1,0,70%,69%,71%,117,117,118,21%,20%,24%,8,3,5,9,4,5
263,https://vlr.gg/player/1284/mikee,2025-01-26 13:15:00,0.85,0.95,0.90,186,187,185,41,22,19,47,25,22,37,13,24,-2,-3,+1,80%,83%,77%,117,128,105,25%,20%,33%,6,2,4,8,5,3
264,https://vlr.gg/player/113/hyp,2025-01-26 13:15:00,0.59,0.95,0.76,142,132,153,33,17,16,44,26,18,18,10,8,-4,-2,-2,77%,69%,87%,105,95,116,24%,27%,22%,4,2,2,8,4,4
265,https://vlr.gg/player/2653/jesse,2025-01-26 13:15:00,0.83,1.26,1.06,174,111,230,43,12,31,42,19,23,21,12,9,-2,-2,0,67%,61%,71%,118,78,153,38%,37%,39%,2,0,2,4,2,2
266,https://vlr.gg/player/440/akumaaaaa,2025-01-26 13:15:00,0.79,1.02,0.92,233,199,264,51,21,30,53,25,28,14,6,8,+1,0,+1,62%,58%,66%,151,134,166,40%,41%,39%,16,7,9,15,7,8
267,https://vlr.gg/player/4521/unfake,2025-01-26 13:15:00,1.10,0.74,0.91,198,232,173,43,25,18,49,21,28,18,5,13,+1,-1,+2,71%,68%,74%,138,158,121,41%,48%,35%,6,3,3,5,4,1
268,https://vlr.gg/player/565/starxo,2025-01-26 13:15:00,0.69,0.88,0.79,159,153,162,37,17,20,50,23,27,24,9,15,+1,-1,+2,71%,68%,74%,104,107,101,36%,37%,35%,4,0,4,3,1,2
269,https://vlr.gg/player/7162/wackie,2025-01-26 13:15:00,0.64,0.90,0.77,153,144,166,36,15,21,49,24,25,10,4,6,-1,+1,-2,67%,58%,74%,107,95,117,24%,22%,26%,5,4,1,6,3,3
270,https://vlr.gg/player/1493/starkk,2025-01-26 13:00:00,1.50,0.61,1.00,161,183,144,24,13,11,25,5,20,16,10,6,0,+2,-2,79%,89%,71%,95,101,90,12%,13%,12%,3,2,1,3,0,3
271,https://vlr.gg/player/15376/grtw,2025-01-26 13:00:00,1.30,0.70,0.97,181,210,160,28,15,13,27,7,20,9,5,4,+1,-1,+2,67%,74%,63%,116,141,96,32%,40%,26%,4,1,3,3,2,1
272,https://vlr.gg/player/13435/fragger,2025-01-26 13:00:00,1.21,0.62,0.88,149,156,143,23,12,11,28,7,21,16,9,7,-3,+1,-4,70%,89%,54%,100,102,99,26%,28%,24%,3,1,2,6,0,6
273,https://vlr.gg/player/6909/jannyxd,2025-01-26 13:00:00,1.14,0.59,0.84,184,252,129,27,17,10,32,12,20,6,4,2,+2,+3,-1,67%,84%,54%,113,146,86,31%,43%,19%,9,7,2,7,4,3
274,https://vlr.gg/player/5203/bati,2025-01-26 13:00:00,1.17,0.41,0.75,162,243,97,22,17,5,32,11,21,11,6,5,+1,+2,-1,67%,89%,50%,118,169,76,18%,23%,8%,3,2,1,2,0,2
275,https://vlr.gg/player/5199/guardy,2025-01-26 13:00:00,1.89,0.74,1.36,233,270,188,35,25,10,22,6,16,11,7,4,+1,+2,-1,79%,88%,68%,161,186,129,46%,46%,46%,6,3,3,5,1,4
276,https://vlr.gg/player/8502/olizera,2025-01-26 13:00:00,1.38,0.70,1.08,180,243,101,27,21,6,26,12,14,16,7,9,+1,+2,-1,81%,92%,68%,113,158,57,21%,23%,17%,4,3,1,3,1,2
277,https://vlr.gg/player/38424/zachkappa,2025-01-26 13:00:00,1.39,0.66,1.07,208,281,118,33,26,7,28,14,14,11,5,6,-2,0,-2,74%,88%,58%,158,209,94,24%,22%,30%,6,5,1,8,5,3
278,https://vlr.gg/player/22154/pika,2025-01-26 13:00:00,1.17,0.92,1.06,180,174,184,27,16,11,26,11,15,7,3,4,-1,0,-1,63%,75%,47%,120,124,114,49%,50%,48%,3,2,1,4,2,2
279,https://vlr.gg/player/3127/monsteerr,2025-01-26 13:00:00,1.21,0.66,0.97,136,148,122,21,13,8,22,8,14,20,16,4,0,+2,-2,77%,92%,58%,88,95,79,20%,15%,30%,2,2,0,2,0,2
280,https://vlr.gg/player/19588/neptuno,2025-01-26 13:00:00,1.43,1.18,1.30,205,220,190,32,16,16,21,10,11,10,3,7,-5,-2,-3,76%,84%,68%,146,142,149,26%,28%,24%,0,0,0,5,2,3
281,https://vlr.gg/player/6925/chadi,2025-01-26 13:00:00,0.81,1.70,1.29,236,191,267,35,12,23,25,15,10,10,5,5,+2,0,+2,83%,68%,95%,159,140,175,18%,26%,12%,10,5,5,8,5,3
282,https://vlr.gg/player/2835/kyrrz,2025-01-26 13:00:00,1.49,0.91,1.18,211,257,171,32,18,14,27,12,15,18,8,10,+5,+3,+2,83%,79%,86%,134,163,110,41%,47%,34%,5,3,2,0,0,0
283,https://vlr.gg/player/4851/rexs,2025-01-26 13:00:00,0.65,1.15,0.92,180,133,217,27,9,18,28,14,14,17,7,10,0,0,0,73%,63%,82%,114,84,140,23%,12%,31%,2,1,1,2,1,1
284,https://vlr.gg/player/24359/faska,2025-01-26 13:00:00,0.86,0.78,0.82,207,176,240,32,14,18,32,13,19,4,1,3,+1,0,+1,63%,74%,55%,127,105,146,29%,45%,22%,5,1,4,4,1,3
285,https://vlr.gg/player/8808/pyrolll,2025-01-26 13:00:00,1.23,0.81,1.04,193,226,159,28,17,11,29,16,13,18,8,10,0,+1,-1,76%,77%,74%,124,142,104,41%,46%,33%,2,1,1,2,0,2
286,https://vlr.gg/player/443/zeddy,2025-01-26 13:00:00,0.88,1.23,1.04,226,175,281,32,14,18,31,16,15,8,3,5,0,-2,+2,71%,59%,84%,144,112,181,35%,48%,27%,2,0,2,2,2,0
287,https://vlr.gg/player/173/l0udly,2025-01-26 13:00:00,0.71,1.00,0.80,156,168,148,25,14,11,30,19,11,4,3,1,+2,+3,-1,56%,64%,47%,99,101,98,27%,35%,19%,7,6,1,5,3,2
288,https://vlr.gg/player/2431/basya,2025-01-26 13:00:00,0.74,0.81,0.78,162,173,144,21,12,9,32,19,13,10,5,5,-4,-2,-2,63%,59%,68%,110,115,106,22%,20%,24%,1,0,1,5,2,3
289,https://vlr.gg/player/363/7ssk7,2025-01-26 13:00:00,0.59,0.69,0.64,182,161,212,27,12,15,36,19,17,0,0,0,-1,-2,+1,61%,59%,63%,108,100,116,22%,22%,21%,7,3,4,8,5,3
290,https://vlr.gg/player/6559/destruct1vee,2025-01-26 12:30:00,1.21,0.86,0.99,238,279,216,14,7,7,15,5,10,8,4,4,+3,+1,+2,84%,100%,75%,144,150,141,30%,33%,28%,4,1,3,1,0,1
291,https://vlr.gg/player/10125/qw1,2025-01-26 12:30:00,1.69,0.42,0.89,198,371,98,15,10,5,15,6,9,0,0,0,+1,+2,-1,63%,100%,42%,137,252,69,32%,38%,23%,3,3,0,2,1,1
292,https://vlr.gg/player/3604/mojj,2025-01-26 12:30:00,0.05,1.17,0.76,196,76,267,13,2,11,16,6,10,1,0,1,0,-2,+2,63%,71%,58%,130,57,173,36%,40%,36%,3,0,3,3,2,1
293,https://vlr.gg/player/7353/glovee,2025-01-26 12:30:00,0.04,0.89,0.57,131,68,168,8,1,7,16,7,9,10,5,5,-2,0,-2,79%,86%,75%,87,40,114,13%,14%,13%,0,0,0,2,0,2
294,https://vlr.gg/player/1399/sterben,2025-01-26 12:30:00,0.85,0.35,0.54,144,195,115,8,4,4,16,5,11,6,4,2,-1,0,-1,74%,86%,67%,100,123,87,28%,22%,36%,0,0,0,1,0,1
295,https://vlr.gg/player/569/paura,2025-01-26 12:30:00,1.51,2.28,1.80,324,278,405,23,13,10,11,7,4,5,2,3,+2,+1,+1,74%,67%,86%,217,198,250,40%,46%,34%,3,2,1,1,1,0
296,https://vlr.gg/player/50775/lava,2025-01-26 12:30:00,1.58,1.37,1.51,223,269,147,16,12,4,8,5,3,3,1,2,0,0,0,84%,83%,86%,147,158,128,23%,24%,20%,1,1,0,1,1,0
297,https://vlr.gg/player/10146/reazy,2025-01-26 12:30:00,1.04,1.60,1.25,258,198,361,18,9,9,14,8,6,7,4,3,0,0,0,79%,67%,100%,165,121,239,41%,33%,48%,2,1,1,2,1,1
298,https://vlr.gg/player/3862/deepmans,2025-01-26 12:30:00,1.28,0.36,0.94,223,274,138,15,12,3,13,7,6,2,0,2,-4,-2,-2,68%,75%,57%,139,167,91,32%,43%,10%,1,1,0,5,3,2
299,https://vlr.gg/player/568/turko,2025-01-26 12:30:00,0.60,0.32,0.49,89,87,94,6,3,3,12,7,5,4,3,1,+1,+1,0,68%,75%,57%,64,65,64,22%,20%,25%,2,1,1,1,0,1
300,https://vlr.gg/player/27789/deyten,2025-01-26 12:25:00,1.08,1.94,1.47,267,212,334,22,9,13,14,8,6,9,5,4,+1,-1,+2,73%,75%,70%,174,129,227,34%,28%,39%,2,0,2,1,1,0
301,https://vlr.gg/player/33974/appa,2025-01-26 12:25:00,0.41,2.16,1.21,267,146,413,21,5,16,17,11,6,3,2,1,-1,-2,+1,64%,42%,90%,165,98,245,38%,53%,32%,2,1,1,3,3,0
302,https://vlr.gg/player/3934/eleo,2025-01-26 12:25:00,1.08,1.16,1.11,149,166,131,13,7,6,11,7,4,5,3,2,-1,0,-1,77%,75%,80%,108,110,104,32%,26%,42%,1,1,0,2,1,1
303,https://vlr.gg/player/18384/bully,2025-01-26 12:25:00,0.95,0.79,0.88,191,202,178,14,9,5,15,8,7,3,1,2,-1,-1,0,68%,58%,80%,133,150,113,17%,23%,12%,2,0,2,3,1,2
304,https://vlr.gg/player/47270/darkwinjett,2025-01-26 12:25:00,0.83,0.42,0.64,126,142,107,10,7,3,17,8,9,10,4,6,-4,-2,-2,73%,67%,80%,88,87,89,23%,9%,50%,1,1,0,5,3,2
305,https://vlr.gg/player/28948/ninja,2025-01-26 12:25:00,1.26,1.67,1.49,260,283,242,20,9,11,13,9,4,9,6,3,+3,+1,+2,77%,70%,83%,165,211,127,26%,30%,19%,4,1,3,1,0,1
306,https://vlr.gg/player/40750/donatellooo,2025-01-26 12:25:00,0.58,1.51,1.09,305,215,381,21,7,14,20,10,10,5,2,3,+2,-1,+3,82%,70%,92%,198,139,248,32%,33%,32%,5,2,3,3,3,0
307,https://vlr.gg/player/7105/qpert,2025-01-26 12:25:00,0.49,1.20,0.88,127,109,143,10,4,6,13,8,5,10,3,7,0,-1,+1,86%,90%,83%,80,58,99,40%,57%,33%,1,0,1,1,1,0
308,https://vlr.gg/player/19526/rexxtoned,2025-01-26 12:25:00,0.69,0.86,0.79,162,171,155,15,7,8,16,8,8,0,0,0,+1,+1,0,64%,70%,58%,112,115,110,47%,35%,62%,3,2,1,2,1,1
309,https://vlr.gg/player/50813/gsr,2025-01-26 12:25:00,0.76,0.36,0.54,127,166,95,8,5,3,18,8,10,11,6,5,0,0,0,68%,80%,58%,83,114,56,27%,38%,14%,1,0,1,1,0,1
310,https://vlr.gg/player/10137/ip0tt,2025-01-26 11:30:00,1.24,2.01,1.47,263,203,410,15,9,6,9,6,3,9,4,5,0,0,0,94%,92%,100%,201,151,322,31%,33%,27%,2,1,1,2,1,1
311,https://vlr.gg/player/22676/ventt,2025-01-26 11:30:00,1.22,1.73,1.37,221,183,313,15,9,6,8,5,3,4,2,2,-1,-2,+1,88%,83%,100%,142,120,197,27%,32%,22%,1,0,1,2,2,0
312,https://vlr.gg/player/3557/skylen,2025-01-26 11:30:00,1.35,1.12,1.28,218,235,180,14,10,4,8,5,3,5,5,0,+1,+1,0,88%,83%,100%,140,165,80,36%,40%,25%,1,1,0,0,0,0
313,https://vlr.gg/player/40935/umu7,2025-01-26 11:30:00,0.88,1.53,1.07,198,183,238,13,8,5,9,7,2,2,1,1,-1,-3,+2,76%,75%,80%,122,128,107,42%,46%,33%,2,0,2,3,3,0
314,https://vlr.gg/player/5510/oxmann,2025-01-26 11:30:00,0.97,0.85,0.94,149,181,73,10,8,2,9,7,2,2,2,0,+1,+1,0,82%,83%,80%,100,124,42,45%,64%,0%,2,2,0,1,1,0
315,https://vlr.gg/player/16552/pckwn,2025-01-26 11:30:00,0.79,0.99,0.93,172,176,170,11,3,8,13,4,9,1,1,0,+1,0,+1,76%,80%,75%,106,106,106,26%,22%,28%,1,0,1,0,0,0
316,https://vlr.gg/player/31855/celasun,2025-01-26 11:30:00,1.17,0.55,0.73,152,217,126,9,5,4,14,4,10,3,1,2,+1,0,+1,53%,60%,50%,114,117,113,46%,30%,56%,1,0,1,0,0,0
317,https://vlr.gg/player/39357/s0pp,2025-01-26 11:30:00,0.10,0.93,0.69,169,62,214,9,1,8,16,5,11,4,2,2,+2,0,+2,65%,40%,75%,115,27,151,17%,33%,15%,4,1,3,2,1,1
318,https://vlr.gg/player/40843/audaz,2025-01-26 11:30:00,0.03,0.82,0.57,150,70,184,9,1,8,15,5,10,1,1,0,-1,-2,+1,53%,40%,58%,94,50,112,57%,67%,55%,1,0,1,2,2,0
319,https://vlr.gg/player/4962/lurzy0y0,2025-01-26 11:30:00,0.28,0.42,0.38,100,136,86,5,3,2,14,5,9,7,0,7,-3,-1,-2,76%,80%,75%,66,64,66,23%,40%,18%,1,0,1,4,1,3
320,https://vlr.gg/player/42638/amcar,2025-01-26 11:15:00,1.08,1.07,1.08,176,188,165,18,9,9,18,6,12,7,3,4,+2,0,+2,75%,93%,57%,129,134,124,28%,31%,26%,3,1,2,1,1,0
321,https://vlr.gg/player/4339/rare,2025-01-26 11:15:00,1.10,0.83,0.97,171,193,150,17,10,7,18,8,10,11,8,3,-4,-1,-3,57%,64%,50%,109,113,105,22%,22%,22%,0,0,0,4,1,3
322,https://vlr.gg/player/7185/nero,2025-01-26 11:15:00,1.62,0.25,0.93,186,273,100,19,15,4,20,7,13,7,4,3,-1,-1,0,71%,86%,57%,125,179,72,23%,22%,27%,1,1,0,2,2,0
323,https://vlr.gg/player/42458/bravo,2025-01-26 11:15:00,1.39,0.44,0.91,221,284,159,22,15,7,22,9,13,8,5,3,+2,+2,0,82%,100%,64%,132,170,95,42%,42%,41%,4,2,2,2,0,2
324,https://vlr.gg/player/22291/razziss,2025-01-26 11:15:00,0.46,0.72,0.59,184,184,185,15,7,8,25,12,13,7,4,3,-3,-2,-1,71%,79%,64%,117,117,118,25%,31%,22%,4,2,2,7,4,3
325,https://vlr.gg/player/9556/demek,2025-01-26 11:15:00,2.28,0.76,1.52,322,459,187,31,23,8,19,7,12,5,2,3,+5,+3,+2,68%,79%,57%,199,279,120,26%,24%,30%,6,3,3,1,0,1
326,https://vlr.gg/player/10448/kozok,2025-01-26 11:15:00,1.18,1.12,1.15,195,212,180,20,11,9,17,7,10,9,5,4,-1,-1,0,75%,86%,64%,138,152,123,32%,29%,36%,2,1,1,3,2,1
327,https://vlr.gg/player/36748/czester,2025-01-26 11:15:00,1.62,0.66,1.14,206,234,180,21,12,9,16,4,12,8,7,1,-2,-1,-1,75%,86%,64%,132,157,107,25%,21%,30%,2,0,2,4,1,3
328,https://vlr.gg/player/42702/krizz,2025-01-26 11:15:00,0.76,1.23,0.99,176,130,223,17,6,11,19,9,10,11,5,6,+1,0,+1,79%,79%,79%,115,81,148,33%,38%,30%,3,2,1,2,2,0
329,https://vlr.gg/player/9557/nefi,2025-01-26 11:15:00,0.86,0.45,0.65,126,128,126,11,6,5,20,8,12,11,6,5,+1,+1,0,75%,93%,57%,75,68,82,10%,9%,10%,3,2,1,2,1,1
330,https://vlr.gg/player/14612/lux9,2025-01-26 11:00:00,0.90,1.45,1.20,238,192,285,36,13,23,34,16,18,9,3,6,0,-1,+1,61%,65%,58%,165,137,187,29%,19%,35%,8,5,3,8,6,2
331,https://vlr.gg/player/16345/yayax,2025-01-26 11:00:00,0.52,1.19,0.88,201,143,242,32,11,21,34,17,17,7,1,6,-2,-1,-1,70%,65%,75%,126,99,149,38%,55%,32%,3,0,3,5,1,4
332,https://vlr.gg/player/2098/thebigfiz,2025-01-26 11:00:00,1.08,0.67,0.86,167,215,133,25,14,11,32,15,17,10,3,7,0,-1,+1,59%,60%,58%,112,149,80,41%,46%,34%,3,0,3,3,1,2
333,https://vlr.gg/player/3563/babax,2025-01-26 11:00:00,0.72,0.87,0.80,159,158,155,24,12,12,32,16,16,9,2,7,+2,+3,-1,66%,55%,75%,106,99,112,30%,26%,33%,5,3,2,3,0,3
334,https://vlr.gg/player/2620/ooriime,2025-01-26 11:00:00,0.61,0.10,0.33,79,131,42,13,10,3,37,17,20,6,2,4,-6,-4,-2,66%,75%,58%,58,90,30,21%,29%,7%,0,0,0,6,4,2
335,https://vlr.gg/player/2625/sh1n,2025-01-26 11:00:00,1.31,1.26,1.29,244,241,250,41,22,19,26,14,12,11,8,3,+2,+3,-1,77%,75%,80%,160,156,164,37%,33%,41%,4,3,1,2,0,2
336,https://vlr.gg/player/33902/sayonara,2025-01-26 11:00:00,1.28,1.24,1.26,244,250,234,37,20,17,25,13,12,20,16,4,+1,+1,0,86%,96%,75%,169,171,166,47%,43%,53%,3,2,1,2,1,1
337,https://vlr.gg/player/2841/foxie,2025-01-26 11:00:00,0.87,1.44,1.13,198,162,239,31,14,17,25,15,10,17,6,11,-1,-3,+2,80%,83%,75%,141,120,167,41%,44%,38%,3,0,3,4,3,1
338,https://vlr.gg/player/301/takas,2025-01-26 11:00:00,0.85,1.16,0.99,232,211,254,34,17,17,30,17,13,7,2,5,+3,+1,+2,70%,71%,70%,146,129,165,20%,25%,15%,11,7,4,8,6,2
339,https://vlr.gg/player/868/logan,2025-01-26 11:00:00,1.00,0.79,0.91,147,142,145,26,15,11,24,11,13,2,1,1,+1,0,+1,80%,83%,75%,103,111,95,52%,52%,52%,4,1,3,3,1,2
340,https://vlr.gg/player/18162/serial,2025-01-26 11:00:00,1.56,0.95,1.34,256,303,168,39,29,10,24,15,9,4,3,1,+4,+2,+2,79%,79%,79%,168,199,116,43%,38%,64%,6,4,2,2,2,0
341,https://vlr.gg/player/29972/michel,2025-01-26 11:00:00,1.36,1.09,1.26,306,315,291,39,26,13,30,18,12,9,3,6,+4,+4,0,84%,83%,86%,192,206,168,33%,34%,32%,8,7,1,4,3,1
342,https://vlr.gg/player/16209/famsii,2025-01-26 11:00:00,0.94,1.79,1.25,234,180,328,33,14,19,25,16,9,11,10,1,-1,-2,+1,63%,63%,64%,152,116,213,19%,20%,17%,6,2,4,7,4,3
343,https://vlr.gg/player/1524/h1ber,2025-01-26 11:00:00,0.98,1.25,1.08,183,151,237,25,14,11,24,14,10,17,8,9,+2,+1,+1,74%,67%,86%,116,98,146,27%,33%,21%,3,1,2,1,0,1
344,https://vlr.gg/player/8805/sacake,2025-01-26 11:00:00,0.86,0.53,0.74,137,141,112,16,12,4,26,15,11,20,11,9,+1,+1,0,71%,75%,64%,87,88,86,21%,31%,9%,1,1,0,0,0,0
345,https://vlr.gg/player/6959/flickless,2025-01-26 11:00:00,1.56,1.06,1.24,237,288,223,34,16,18,29,10,19,17,6,11,+1,+2,-1,76%,86%,71%,155,174,144,29%,31%,27%,3,2,1,2,0,2
346,https://vlr.gg/player/8834/bucher,2025-01-26 11:00:00,0.62,1.39,1.10,206,125,253,30,8,22,26,10,16,5,0,5,+1,-2,+3,74%,57%,83%,131,85,158,43%,73%,37%,3,0,3,2,2,0
347,https://vlr.gg/player/15473/yuno,2025-01-26 11:00:00,1.13,0.83,0.94,206,246,202,30,12,18,31,11,20,13,5,8,-3,0,-3,61%,79%,50%,144,163,132,29%,39%,24%,2,1,1,5,1,4
348,https://vlr.gg/player/341/quick,2025-01-26 11:00:00,0.80,0.52,0.63,149,216,108,19,9,10,31,13,18,7,5,2,-1,0,-1,63%,64%,63%,94,147,64,25%,30%,18%,4,1,3,5,1,4
349,https://vlr.gg/player/1839/polvi,2025-01-26 11:00:00,0.45,0.47,0.45,123,116,143,16,6,10,35,13,22,13,4,9,-8,-4,-4,63%,64%,63%,97,89,102,9%,12%,8%,2,1,1,10,5,5
350,https://vlr.gg/player/3784/katu,2025-01-26 11:00:00,1.33,1.07,1.21,225,241,211,37,22,15,29,15,14,4,1,3,+4,0,+4,73%,74%,71%,151,160,140,36%,47%,23%,7,2,5,3,2,1
351,https://vlr.gg/player/4519/kamisseq,2025-01-26 11:00:00,0.72,1.36,1.03,194,169,224,32,14,18,29,17,12,18,11,7,+1,0,+1,75%,70%,81%,125,115,137,28%,24%,31%,2,1,1,1,1,0
352,https://vlr.gg/player/402/insider,2025-01-26 11:00:00,0.92,1.02,0.97,202,209,201,32,17,15,33,18,15,12,6,6,+4,+2,+2,73%,74%,71%,119,121,117,29%,24%,35%,6,3,3,2,1,1
353,https://vlr.gg/player/23347/alannn,2025-01-26 11:00:00,0.75,0.70,0.72,155,173,133,21,13,8,32,18,14,12,7,5,+4,+4,0,64%,61%,67%,103,112,94,39%,48%,30%,9,6,3,5,2,3
354,https://vlr.gg/player/1155/buld,2025-01-26 11:00:00,0.71,0.64,0.68,143,144,144,21,11,10,31,17,14,12,8,4,-3,-1,-2,73%,70%,76%,97,98,96,37%,40%,33%,3,2,1,6,3,3
355,https://vlr.gg/player/292/fit1nho,2025-01-26 11:00:00,1.39,1.31,1.35,243,232,248,34,15,19,28,12,16,29,16,13,+1,0,+1,86%,86%,87%,140,134,145,42%,55%,33%,5,1,4,4,1,3
356,https://vlr.gg/player/41220/krejz,2025-01-26 11:00:00,1.29,1.34,1.31,273,280,267,43,21,22,30,15,15,6,2,4,-3,-1,-2,73%,71%,74%,182,179,185,35%,40%,32%,7,4,3,10,5,5
357,https://vlr.gg/player/20271/vorwenn,2025-01-26 11:00:00,1.01,1.21,1.12,208,185,232,33,13,20,27,13,14,6,1,5,0,0,0,70%,57%,83%,131,118,142,29%,32%,27%,2,2,0,2,2,0
358,https://vlr.gg/player/2534/lowel,2025-01-26 11:00:00,0.87,0.81,0.84,150,157,140,23,13,10,27,12,15,11,5,6,-1,-2,+1,70%,71%,70%,94,100,88,29%,20%,42%,1,0,1,2,2,0
359,https://vlr.gg/player/7220/saiz,2025-01-26 11:00:00,0.43,0.81,0.63,139,100,175,21,7,14,31,14,17,10,6,4,-7,-2,-5,61%,62%,61%,82,53,108,46%,38%,50%,2,1,1,9,3,6
360,https://vlr.gg/player/7987/kovaq,2025-01-26 11:00:00,1.50,1.18,1.34,257,283,222,52,30,22,38,16,22,20,9,11,+3,+4,-1,75%,75%,76%,160,179,142,33%,38%,28%,6,4,2,3,0,3
361,https://vlr.gg/player/7968/stavinci,2025-01-26 11:00:00,1.20,0.87,1.03,218,245,197,44,24,20,45,19,26,20,12,8,+4,+3,+1,77%,82%,72%,158,166,150,34%,40%,29%,7,5,2,3,2,1
362,https://vlr.gg/player/20302/jini,2025-01-26 11:00:00,1.18,0.59,0.88,184,210,152,34,21,13,42,17,25,20,8,12,-2,-1,-1,65%,64%,66%,117,132,103,17%,20%,13%,3,1,2,5,2,3
363,https://vlr.gg/player/12593/felix,2025-01-26 11:00:00,0.67,0.82,0.75,167,151,175,35,16,19,45,21,24,16,9,7,-3,-3,0,68%,64%,72%,109,107,110,40%,38%,42%,4,1,3,7,4,3
364,https://vlr.gg/player/122/luckerrr,2025-01-26 11:00:00,0.54,0.85,0.70,170,140,207,33,13,20,47,21,26,8,3,5,-1,-1,0,58%,57%,59%,109,85,132,22%,20%,22%,9,4,5,10,5,5
365,https://vlr.gg/player/7865/xanarchy,2025-01-26 11:00:00,1.47,0.95,1.21,202,237,169,46,28,18,35,14,21,16,9,7,+1,-1,+2,82%,97%,68%,132,161,102,24%,23%,24%,2,0,2,1,1,0
366,https://vlr.gg/player/45490/ico,2025-01-26 11:00:00,1.21,1.03,1.12,231,255,206,45,26,19,41,21,20,27,13,14,0,+1,-1,72%,76%,68%,152,167,137,32%,32%,31%,6,5,1,6,4,2
367,https://vlr.gg/player/35513/samed,2025-01-26 11:00:00,1.00,1.22,1.10,250,251,263,53,27,26,45,24,21,10,6,4,+4,+2,+2,75%,86%,64%,160,164,155,30%,27%,34%,12,6,6,8,4,4
368,https://vlr.gg/player/4969/shazeon,2025-01-26 11:00:00,0.99,1.12,1.06,223,198,250,46,22,24,41,19,22,14,8,6,-5,-3,-2,67%,62%,71%,149,140,158,30%,38%,25%,4,1,3,9,4,5
369,https://vlr.gg/player/22180/spmak,2025-01-26 11:00:00,1.19,0.58,0.89,158,189,122,27,20,7,37,16,21,25,13,12,-1,+2,-3,72%,86%,57%,105,119,90,18%,16%,21%,4,3,1,5,1,4
370,https://vlr.gg/player/1399/sterben,2025-01-26 10:25:00,1.16,1.66,1.40,264,196,340,22,8,14,14,8,6,9,4,5,+4,+2,+2,83%,67%,100%,163,126,203,23%,36%,17%,4,2,2,0,0,0
371,https://vlr.gg/player/10125/qw1,2025-01-26 10:25:00,1.14,1.58,1.35,238,202,278,21,9,12,13,9,4,2,0,2,-2,-2,0,78%,75%,82%,141,108,177,24%,42%,12%,4,1,3,6,3,3
372,https://vlr.gg/player/7353/glovee,2025-01-26 10:25:00,0.74,1.33,1.02,195,162,233,15,7,8,14,9,5,8,1,7,+1,-1,+2,74%,58%,91%,128,107,151,25%,32%,21%,3,1,2,2,2,0
373,https://vlr.gg/player/3604/mojj,2025-01-26 10:25:00,0.34,1.70,0.99,187,90,294,15,3,12,14,10,4,6,2,4,0,-1,+1,70%,42%,100%,132,72,198,27%,21%,29%,1,0,1,1,1,0
374,https://vlr.gg/player/6559/destruct1vee,2025-01-26 10:25:00,0.84,0.97,0.90,153,192,112,12,7,5,14,10,4,7,3,4,0,0,0,83%,83%,82%,98,126,67,44%,38%,67%,1,1,0,1,1,0
375,https://vlr.gg/player/31307/yigox,2025-01-26 10:25:00,0.86,1.49,1.19,250,238,262,20,9,11,16,11,5,3,0,3,+1,0,+1,65%,45%,83%,159,163,155,54%,45%,65%,3,2,1,2,2,0
376,https://vlr.gg/player/33551/slaughter,2025-01-26 10:25:00,0.96,1.11,1.04,187,159,214,14,6,8,16,9,7,15,3,12,+2,0,+2,74%,55%,92%,112,95,128,40%,50%,35%,3,0,3,1,0,1
377,https://vlr.gg/player/18655/best,2025-01-26 10:25:00,0.09,1.46,0.81,178,53,293,15,1,14,16,10,6,1,1,0,-2,-2,0,48%,27%,67%,121,47,189,13%,17%,11%,4,1,3,6,3,3
378,https://vlr.gg/player/15735/krostaly,2025-01-26 10:25:00,0.58,0.70,0.64,132,117,146,11,4,7,19,10,9,7,2,5,-1,-1,0,65%,45%,83%,84,94,75,24%,26%,21%,0,0,0,1,1,0
379,https://vlr.gg/player/40842/ibonata,2025-01-26 10:25:00,0.22,0.96,0.61,126,84,166,9,3,6,18,11,7,8,1,7,-3,-2,-1,52%,36%,67%,82,54,108,42%,50%,39%,0,0,0,3,2,1
380,https://vlr.gg/player/6101/999kvmil,2025-01-26 10:00:00,1.58,0.81,1.19,215,268,163,20,13,7,18,6,12,18,9,9,0,0,0,79%,93%,64%,144,181,108,30%,37%,23%,3,2,1,3,2,1
381,https://vlr.gg/player/8440/puggy,2025-01-26 10:00:00,0.94,1.36,1.15,191,148,234,19,7,12,17,8,9,14,10,4,-1,-2,+1,86%,86%,86%,131,103,160,32%,33%,30%,1,0,1,2,2,0
382,https://vlr.gg/player/13024/vuubit,2025-01-26 10:00:00,1.39,0.68,1.04,200,250,152,18,12,6,19,8,11,16,7,9,-2,+1,-3,86%,86%,86%,132,166,97,22%,30%,8%,1,1,0,3,0,3
383,https://vlr.gg/player/12471/kalkkuna,2025-01-26 10:00:00,0.86,1.00,0.93,238,260,216,22,12,10,24,14,10,10,5,5,-1,-1,0,82%,79%,86%,142,152,133,21%,18%,24%,5,2,3,6,3,3
384,https://vlr.gg/player/15491/maximn,2025-01-26 10:00:00,0.66,1.18,0.92,171,114,229,19,7,12,20,9,11,5,1,4,-2,-2,0,61%,57%,64%,111,72,151,32%,24%,37%,1,0,1,3,2,1
385,https://vlr.gg/player/20591/eagle,2025-01-26 10:00:00,2.05,0.93,1.49,321,400,242,31,20,11,19,8,11,7,5,2,+4,+2,+2,75%,79%,71%,217,278,155,25%,26%,22%,4,2,2,0,0,0
386,https://vlr.gg/player/27784/c4pee,2025-01-26 10:00:00,1.33,0.83,1.08,223,259,188,23,14,9,19,9,10,3,1,2,+4,+3,+1,79%,86%,71%,136,146,126,25%,26%,24%,5,4,1,1,1,0
387,https://vlr.gg/player/9505/paulus,2025-01-26 10:00:00,0.61,1.07,0.84,159,131,188,17,6,11,17,10,7,2,2,0,0,0,0,68%,71%,64%,102,94,111,28%,32%,24%,3,2,1,3,2,1
388,https://vlr.gg/player/1365/nixoon,2025-01-26 10:00:00,0.89,0.43,0.66,145,172,119,16,10,6,21,10,11,8,3,5,-2,-1,-1,71%,71%,71%,89,109,69,12%,10%,14%,1,0,1,3,1,2
389,https://vlr.gg/player/2691/nausea,2025-01-26 10:00:00,0.32,0.72,0.52,130,65,197,11,3,8,22,10,12,13,7,6,0,-2,+2,82%,93%,71%,87,44,131,37%,57%,32%,4,0,4,4,2,2
390,https://vlr.gg/player/12795/crewen,2025-01-26 09:30:00,0.92,1.74,1.47,239,178,270,16,3,13,8,4,4,7,1,6,-1,-1,0,83%,50%,100%,167,139,181,29%,19%,33%,0,0,0,1,1,0
391,https://vlr.gg/player/40591/comeback,2025-01-26 09:30:00,0.79,1.58,1.31,235,131,288,16,3,13,9,4,5,2,0,2,+3,0,+3,83%,50%,100%,163,90,199,15%,22%,11%,4,1,3,1,1,0
392,https://vlr.gg/player/24344/loita,2025-01-26 09:30:00,0.74,1.51,1.25,223,125,273,15,3,12,10,4,6,14,2,12,-1,-2,+1,89%,83%,92%,141,99,161,52%,50%,52%,2,0,2,3,2,1
393,https://vlr.gg/player/31305/lar0k,2025-01-26 09:30:00,1.09,1.30,1.23,200,220,190,13,5,8,10,4,6,10,2,8,-3,-1,-2,78%,50%,92%,144,178,127,36%,60%,26%,0,0,0,3,1,2
394,https://vlr.gg/player/5565/ros,2025-01-26 09:30:00,0.80,1.38,1.19,211,116,259,13,2,11,10,4,6,6,1,5,0,0,0,83%,67%,92%,148,77,183,35%,14%,42%,2,0,2,2,0,2
395,https://vlr.gg/player/13571/musz3kk,2025-01-26 09:30:00,0.99,1.88,1.29,289,236,397,17,9,8,15,11,4,0,0,0,+1,-1,+2,61%,50%,83%,186,153,253,23%,27%,14%,6,3,3,5,4,1
396,https://vlr.gg/player/5500/docent,2025-01-26 09:30:00,0.71,0.63,0.69,150,160,131,10,7,3,15,11,4,2,1,1,0,0,0,72%,83%,50%,104,109,96,19%,26%,13%,0,0,0,0,0,0
397,https://vlr.gg/player/40841/kabzi,2025-01-26 09:30:00,0.59,0.63,0.60,128,165,56,7,6,1,14,12,2,3,3,0,+2,+2,0,50%,42%,67%,82,100,47,20%,21%,17%,2,2,0,0,0,0
398,https://vlr.gg/player/50776/influx,2025-01-26 09:30:00,0.47,0.83,0.59,107,100,122,7,4,3,14,11,3,3,2,1,+1,0,+1,61%,58%,67%,65,69,56,17%,13%,29%,1,0,1,0,0,0
399,https://vlr.gg/player/4894/jn3v1ce,2025-01-26 09:30:00,0.04,1.39,0.47,111,58,219,6,1,5,15,12,3,5,3,2,-2,-3,+1,56%,50%,67%,70,50,110,15%,20%,13%,1,0,1,3,3,0
400,https://vlr.gg/player/9803/d4v41,2025-01-26 06:00:00,1.42,1.29,1.36,237,249,227,34,19,15,19,11,8,11,10,1,+3,+1,+2,92%,90%,94%,175,185,163,34%,40%,27%,4,2,2,1,1,0
401,https://vlr.gg/player/9801/f0rsaken,2025-01-26 06:00:00,1.06,1.63,1.32,248,213,301,36,16,20,24,13,11,18,7,11,+3,+3,0,87%,90%,83%,160,135,189,50%,39%,59%,6,4,2,3,1,2
402,https://vlr.gg/player/17086/something,2025-01-26 06:00:00,1.27,1.36,1.31,290,277,297,39,21,18,26,15,11,9,5,4,+4,+1,+3,72%,67%,78%,175,175,176,21%,30%,15%,9,4,5,5,3,2
403,https://vlr.gg/player/7378/jinggg,2025-01-26 06:00:00,1.29,1.09,1.20,215,235,192,33,20,13,21,10,11,4,2,2,-4,-1,-3,77%,71%,83%,142,140,143,16%,14%,21%,2,2,0,6,3,3
404,https://vlr.gg/player/9800/mindfreak,2025-01-26 06:00:00,1.14,0.88,1.02,168,154,186,23,12,11,22,9,13,19,12,7,+3,+1,+2,85%,90%,78%,111,104,119,28%,31%,25%,3,1,2,0,0,0
405,https://vlr.gg/player/424/dep,2025-01-26 06:00:00,1.56,0.63,1.06,229,303,175,31,19,12,31,13,18,6,4,2,-4,-1,-3,62%,67%,57%,137,186,94,37%,32%,48%,4,2,2,8,3,5
406,https://vlr.gg/player/12990/syouta,2025-01-26 06:00:00,0.19,1.28,0.78,188,101,258,26,6,20,34,18,16,1,1,0,-3,-4,+1,59%,50%,67%,124,69,171,50%,36%,56%,5,2,3,8,6,2
407,https://vlr.gg/player/6668/sugarz3ro,2025-01-26 06:00:00,0.69,0.74,0.72,176,177,173,21,11,10,34,15,19,17,9,8,-1,+1,-2,77%,83%,71%,112,107,116,27%,24%,29%,2,1,1,3,0,3
408,https://vlr.gg/player/25221/xdll,2025-01-26 06:00:00,0.53,0.74,0.65,160,142,176,22,9,13,34,16,18,4,3,1,+3,+1,+2,56%,56%,57%,110,92,125,28%,23%,32%,4,2,2,1,1,0
409,https://vlr.gg/player/2615/clz,2025-01-26 06:00:00,0.72,0.30,0.49,93,160,37,12,9,3,32,15,17,11,5,6,-4,-1,-3,62%,78%,48%,64,105,29,37%,32%,57%,0,0,0,4,1,3
410,https://vlr.gg/player/31828/francis,2025-01-26 03:00:00,1.28,1.13,1.20,224,212,229,47,24,23,34,15,19,18,5,13,-3,-4,+1,76%,75%,77%,143,143,143,28%,34%,22%,5,1,4,8,5,3
411,https://vlr.gg/player/4122/persia,2025-01-26 03:00:00,0.96,1.34,1.16,199,191,206,40,19,21,35,21,14,33,13,20,0,-1,+1,79%,79%,80%,132,119,144,21%,17%,25%,1,0,1,1,1,0
412,https://vlr.gg/player/31829/ivy,2025-01-26 03:00:00,1.09,0.90,0.99,171,206,144,39,22,17,35,19,16,14,7,7,+2,+1,+1,81%,79%,83%,102,127,79,32%,40%,24%,4,2,2,2,1,1
413,https://vlr.gg/player/31827/dambi,2025-01-26 03:00:00,0.74,1.15,0.94,227,218,223,44,20,24,42,24,18,19,9,10,+3,-3,+6,71%,68%,73%,146,128,162,17%,16%,18%,14,4,10,11,7,4
414,https://vlr.gg/player/33576/margaret,2025-01-26 03:00:00,0.84,1.04,0.94,187,179,196,39,17,22,39,21,18,9,6,3,+3,+1,+2,72%,75%,70%,127,121,134,28%,39%,23%,7,4,3,4,3,1
415,https://vlr.gg/player/4874/berserx,2025-01-26 03:00:00,1.36,0.99,1.18,207,246,172,42,25,17,36,19,17,12,6,6,-6,-2,-4,76%,73%,79%,152,170,133,23%,26%,19%,2,2,0,8,4,4
416,https://vlr.gg/player/2348/famouz,2025-01-26 03:00:00,0.62,1.32,0.96,222,139,322,43,13,30,46,23,23,13,4,9,0,-5,+5,74%,63%,86%,142,97,190,11%,12%,10%,11,3,8,11,8,3
417,https://vlr.gg/player/16215/dos9,2025-01-26 03:00:00,1.00,0.88,0.92,173,186,160,35,20,15,41,21,20,18,8,10,+3,0,+3,76%,67%,86%,100,114,86,25%,28%,22%,6,2,4,3,2,1
418,https://vlr.gg/player/10739/shiro,2025-01-26 03:00:00,0.78,0.97,0.87,166,154,192,33,14,19,43,23,20,28,16,12,+2,-2,+4,81%,73%,89%,113,98,129,28%,25%,31%,7,2,5,5,4,1
419,https://vlr.gg/player/7043/ncslasher,2025-01-26 03:00:00,0.60,0.81,0.70,151,111,196,32,13,19,43,21,22,14,3,11,-4,-2,-2,72%,73%,71%,103,70,138,32%,30%,33%,0,0,0,4,2,2
420,https://vlr.gg/player/7660/fizzy,2025-01-25 14:45:00,1.96,1.02,1.45,261,324,209,45,26,19,25,8,17,11,8,3,+5,+1,+4,70%,80%,63%,167,202,138,36%,36%,36%,8,2,6,3,1,2
421,https://vlr.gg/player/3753/obnoks,2025-01-25 14:45:00,1.41,0.99,1.18,223,224,223,38,19,19,27,9,18,11,7,4,0,+1,-1,82%,85%,79%,144,141,146,29%,28%,29%,1,1,0,1,0,1
422,https://vlr.gg/player/18400/bipo,2025-01-25 14:45:00,0.95,1.09,1.03,194,221,173,27,14,13,29,15,14,10,5,5,+2,+2,0,70%,75%,67%,135,143,129,18%,19%,18%,8,5,3,6,3,3
423,https://vlr.gg/player/3674/iluri,2025-01-25 14:45:00,1.10,0.89,0.99,160,175,149,26,12,14,28,11,17,23,13,10,-4,-2,-2,75%,75%,75%,108,118,99,40%,48%,32%,0,0,0,4,2,2
424,https://vlr.gg/player/10338/lime,2025-01-25 14:45:00,0.87,1.03,0.96,185,184,186,28,13,15,28,13,15,11,4,7,-1,0,-1,75%,70%,79%,117,110,123,31%,26%,36%,6,3,3,7,3,4
425,https://vlr.gg/player/9558/wolfen,2025-01-25 14:45:00,1.12,1.39,1.24,264,246,285,42,22,20,30,16,14,5,2,3,+1,+1,0,61%,63%,60%,165,147,186,44%,33%,54%,7,4,3,6,3,3
426,https://vlr.gg/player/10885/davih,2025-01-25 14:45:00,1.25,0.77,1.03,210,232,185,33,21,12,32,15,17,6,3,3,+3,+3,0,73%,83%,60%,137,145,128,21%,22%,19%,6,4,2,3,1,2
427,https://vlr.gg/player/1835/elllement,2025-01-25 14:45:00,1.04,0.55,0.81,177,208,139,28,19,9,34,17,17,5,3,2,-4,-3,-1,57%,71%,40%,120,143,94,27%,30%,23%,4,2,2,8,5,3
428,https://vlr.gg/player/4329/vince,2025-01-25 14:45:00,0.77,0.58,0.68,155,151,160,20,11,9,35,16,19,14,9,5,+1,+1,0,68%,79%,55%,101,95,108,22%,22%,22%,2,2,0,1,1,0
429,https://vlr.gg/player/314/ambi,2025-01-25 14:45:00,0.62,0.39,0.52,95,92,99,14,8,6,33,16,17,12,6,6,-3,-2,-1,61%,67%,55%,68,69,67,18%,24%,12%,2,0,2,5,2,3
430,https://vlr.gg/player/10160/izzy,2025-01-25 13:45:00,1.07,1.33,1.18,243,241,247,17,9,8,15,10,5,5,5,0,-6,-6,0,86%,92%,78%,169,174,162,26%,22%,33%,1,0,1,7,6,1
431,https://vlr.gg/player/10163/cyderx,2025-01-25 13:45:00,0.99,0.93,0.97,149,177,114,12,8,4,14,10,4,3,2,1,-4,-2,-2,67%,75%,56%,117,130,99,31%,26%,42%,0,0,0,4,2,2
432,https://vlr.gg/player/8041/brave,2025-01-25 13:45:00,1.38,0.30,0.92,191,282,70,12,11,1,16,9,7,10,7,3,-1,0,-1,71%,92%,44%,131,192,51,28%,33%,10%,0,0,0,1,0,1
433,https://vlr.gg/player/10161/qutionerx,2025-01-25 13:45:00,0.42,1.15,0.73,190,112,297,13,4,9,19,11,8,5,3,2,-2,-2,0,52%,58%,44%,132,90,188,34%,21%,44%,1,0,1,3,2,1
434,https://vlr.gg/player/12774/anima,2025-01-25 13:45:00,0.42,0.68,0.53,121,120,124,7,4,3,16,10,6,4,4,0,-2,-2,0,62%,67%,56%,86,84,88,25%,31%,19%,1,0,1,3,2,1
435,https://vlr.gg/player/10883/baransel,2025-01-25 13:45:00,1.89,1.17,1.48,288,366,230,21,12,9,12,5,7,10,2,8,+5,+3,+2,76%,67%,83%,189,214,170,37%,48%,29%,5,3,2,0,0,0
436,https://vlr.gg/player/13545/werlass,2025-01-25 13:45:00,0.82,1.52,1.22,199,137,247,16,4,12,10,5,5,5,1,4,+1,0,+1,76%,78%,75%,131,101,154,34%,44%,31%,1,0,1,0,0,0
437,https://vlr.gg/player/19776/jrayn,2025-01-25 13:45:00,1.32,1.00,1.14,163,197,139,10,5,5,9,3,6,17,5,12,0,0,0,90%,89%,92%,106,143,79,28%,37%,18%,0,0,0,0,0,0
438,https://vlr.gg/player/10152/padisah,2025-01-25 13:45:00,0.62,1.45,1.09,280,148,380,21,5,16,18,7,11,2,1,1,+8,+1,+7,62%,56%,67%,161,80,223,39%,20%,45%,10,3,7,2,2,0
439,https://vlr.gg/player/3549/touven,2025-01-25 13:45:00,0.75,1.17,0.99,169,140,191,12,4,8,12,5,7,6,2,4,+1,-1,+2,86%,78%,92%,114,95,129,32%,83%,18%,2,0,2,1,1,0
440,https://vlr.gg/player/22617/vitie,2025-01-25 13:15:00,1.73,1.25,1.49,246,287,206,23,14,9,16,8,8,14,5,9,0,+1,-1,73%,77%,69%,162,181,143,35%,50%,25%,2,1,1,2,0,2
441,https://vlr.gg/player/30901/ianto,2025-01-25 13:15:00,0.32,1.59,0.95,201,104,299,15,3,12,19,12,7,11,3,8,+1,-1,+2,58%,46%,69%,147,80,215,24%,16%,29%,3,0,3,2,1,1
442,https://vlr.gg/player/7106/diseased,2025-01-25 13:15:00,0.55,1.30,0.92,181,158,204,17,7,10,19,12,7,5,0,5,0,0,0,69%,54%,85%,105,87,124,30%,23%,36%,2,2,0,2,2,0
443,https://vlr.gg/player/252/d3ffo,2025-01-25 13:15:00,0.90,0.76,0.83,159,215,104,16,10,6,18,10,8,0,0,0,-4,-2,-2,62%,54%,69%,92,122,62,33%,55%,10%,2,1,1,6,3,3
444,https://vlr.gg/player/23098/aphun,2025-01-25 13:15:00,0.42,0.94,0.68,179,107,252,18,5,13,20,11,9,1,1,0,-3,-3,0,62%,54%,69%,112,60,164,28%,36%,26%,1,0,1,4,3,1
445,https://vlr.gg/player/50814/fractioned,2025-01-25 13:15:00,0.97,1.79,1.38,270,209,332,26,10,16,17,10,7,4,1,3,+5,+1,+4,73%,62%,85%,181,124,237,17%,10%,22%,10,4,6,5,3,2
446,https://vlr.gg/player/31300/drog,2025-01-25 13:15:00,1.08,1.07,1.07,216,199,234,20,9,11,19,10,9,4,1,3,+2,+1,+1,77%,69%,85%,145,134,155,33%,39%,28%,2,1,1,0,0,0
447,https://vlr.gg/player/20443/br-di,2025-01-25 13:15:00,0.67,1.26,0.96,206,181,231,17,7,10,17,10,7,12,4,8,-1,-2,+1,65%,46%,85%,146,145,146,23%,29%,18%,2,1,1,3,3,0
448,https://vlr.gg/player/42550/merix,2025-01-25 13:15:00,0.92,0.70,0.81,182,184,180,17,9,8,19,10,9,5,0,5,0,0,0,77%,77%,77%,121,130,111,35%,27%,50%,1,0,1,1,0,1
449,https://vlr.gg/player/45834/aidan,2025-01-25 13:15:00,0.50,1.00,0.75,139,97,183,12,4,8,17,10,7,3,1,2,0,+1,-1,58%,54%,62%,110,76,143,28%,33%,25%,1,1,0,1,0,1
450,https://vlr.gg/player/12928/veqaj,2025-01-25 13:05:00,0.98,1.19,1.09,256,226,285,60,25,35,53,26,27,16,8,8,+4,-1,+5,63%,53%,72%,160,134,183,18%,21%,15%,17,6,11,13,7,6
451,https://vlr.gg/player/2621/goaster,2025-01-25 13:05:00,1.15,0.90,1.02,191,220,164,47,26,21,49,23,26,12,5,7,+2,-2,+4,72%,72%,72%,138,146,130,34%,39%,31%,6,2,4,4,4,0
452,https://vlr.gg/player/5490/xitsha,2025-01-25 13:05:00,1.00,0.96,0.98,233,236,230,56,28,28,54,27,27,14,4,10,-5,-1,-4,60%,56%,64%,153,151,155,58%,61%,55%,4,2,2,9,3,6
453,https://vlr.gg/player/2252/anq,2025-01-25 13:05:00,0.59,1.20,0.91,179,154,203,42,14,28,46,28,18,24,12,12,-4,-2,-2,71%,56%,83%,122,109,133,28%,27%,29%,1,1,0,5,3,2
454,https://vlr.gg/player/6889/neskaas,2025-01-25 13:05:00,0.66,1.03,0.86,154,139,167,36,14,22,47,25,22,26,8,18,-5,-4,-1,69%,66%,72%,100,98,102,22%,23%,21%,2,0,2,7,4,3
455,https://vlr.gg/player/253/sp1ke,2025-01-25 13:05:00,0.91,1.71,1.29,283,232,340,70,29,41,49,31,18,8,6,2,+4,-1,+5,69%,58%,81%,174,137,216,21%,19%,23%,17,8,9,13,9,4
456,https://vlr.gg/player/15969/yuta,2025-01-25 13:05:00,1.15,1.36,1.25,243,227,261,60,30,30,48,26,22,13,4,9,+6,+2,+4,82%,78%,88%,164,144,185,37%,41%,34%,12,7,5,6,5,1
457,https://vlr.gg/player/126/nowaxxzang,2025-01-25 13:05:00,0.94,0.94,0.94,202,206,203,51,26,25,57,31,26,19,11,8,0,-2,+2,72%,67%,78%,135,128,143,25%,26%,24%,3,1,2,3,3,0
458,https://vlr.gg/player/854/matelian,2025-01-25 13:05:00,0.80,1.05,0.92,140,131,151,32,15,17,41,24,17,39,18,21,+1,-1,+2,84%,81%,88%,99,86,114,28%,29%,26%,2,0,2,1,1,0
459,https://vlr.gg/player/11013/balli,2025-01-25 13:05:00,0.88,0.55,0.73,144,141,146,36,21,15,48,23,25,25,17,8,-3,0,-3,75%,81%,69%,94,95,94,41%,37%,45%,4,1,3,7,1,6
460,https://vlr.gg/player/39357/s0pp,2025-01-25 12:30:00,0.98,1.38,1.18,246,232,261,23,12,11,20,11,9,8,4,4,-1,-2,+1,73%,77%,69%,167,138,197,38%,45%,32%,3,1,2,4,3,1
461,https://vlr.gg/player/40843/audaz,2025-01-25 12:30:00,1.49,0.77,1.13,221,279,163,20,12,8,16,7,9,4,4,0,-1,0,-1,62%,69%,54%,143,184,102,49%,43%,64%,1,1,0,2,1,1
462,https://vlr.gg/player/16552/pckwn,2025-01-25 12:30:00,1.08,0.69,0.89,210,274,146,18,13,5,22,11,11,10,5,5,-1,0,-1,73%,77%,69%,151,177,124,29%,36%,23%,2,1,1,3,1,2
463,https://vlr.gg/player/4962/lurzy0y0,2025-01-25 12:30:00,0.70,0.87,0.78,163,166,160,15,7,8,21,11,10,17,9,8,-1,0,-1,77%,69%,85%,104,119,90,24%,28%,20%,3,2,1,4,2,2
464,https://vlr.gg/player/31855/celasun,2025-01-25 12:30:00,0.30,0.67,0.49,136,93,179,12,4,8,24,12,12,7,3,4,0,+1,-1,65%,62%,69%,81,58,103,39%,25%,50%,2,1,1,2,0,2
465,https://vlr.gg/player/40935/umu7,2025-01-25 12:30:00,1.03,1.69,1.36,275,228,323,25,11,14,17,8,9,4,2,2,+3,+2,+1,81%,85%,77%,178,141,216,32%,36%,28%,7,4,3,4,2,2
466,https://vlr.gg/player/22676/ventt,2025-01-25 12:30:00,1.79,0.63,1.21,242,330,155,23,14,9,19,8,11,10,7,3,+1,0,+1,77%,77%,77%,146,208,85,25%,31%,14%,3,2,1,2,2,0
467,https://vlr.gg/player/10137/ip0tt,2025-01-25 12:30:00,1.17,1.19,1.18,215,187,244,20,10,10,16,7,9,11,3,8,-2,0,-2,92%,100%,85%,146,135,157,29%,26%,32%,0,0,0,2,0,2
468,https://vlr.gg/player/5510/oxmann,2025-01-25 12:30:00,0.78,1.35,1.06,230,199,262,22,10,12,20,9,11,7,0,7,+2,+1,+1,81%,69%,92%,154,130,179,40%,28%,52%,4,2,2,2,1,1
469,https://vlr.gg/player/3557/skylen,2025-01-25 12:30:00,0.84,0.96,0.90,135,116,156,12,5,7,17,8,9,18,9,9,0,0,0,81%,92%,69%,102,88,116,33%,36%,32%,1,0,1,1,0,1
470,https://vlr.gg/player/25906/alexiiik,2025-01-25 12:15:00,2.08,1.78,1.99,377,420,277,25,20,5,7,6,1,3,1,2,+6,+6,0,94%,92%,100%,241,263,189,44%,57%,9%,6,6,0,0,0,0
471,https://vlr.gg/player/4537/tajrex,2025-01-25 12:15:00,2.01,0.80,1.65,250,306,116,15,13,2,6,4,2,12,10,2,-1,+1,-2,94%,92%,100%,163,200,74,20%,23%,10%,2,2,0,3,1,2
472,https://vlr.gg/player/37840/msh,2025-01-25 12:15:00,1.08,2.49,1.50,243,147,473,18,9,9,9,6,3,4,2,2,+1,-1,+2,88%,83%,100%,159,98,305,32%,19%,45%,2,0,2,1,1,0
473,https://vlr.gg/player/3839/prti,2025-01-25 12:15:00,1.12,2.28,1.46,227,160,389,15,7,8,7,6,1,7,6,1,0,0,0,88%,92%,80%,148,112,233,21%,21%,21%,1,1,0,1,1,0
474,https://vlr.gg/player/8593/grmekista,2025-01-25 12:15:00,1.04,0.66,0.93,119,130,93,5,4,1,9,6,3,16,13,3,+1,0,+1,88%,83%,100%,78,88,54,30%,35%,17%,1,0,1,0,0,0
475,https://vlr.gg/player/39060/kodeth,2025-01-25 12:15:00,0.01,1.17,0.72,182,9,255,11,0,11,15,5,10,1,0,1,-1,-2,+1,53%,,75%,116,9,160,43%,0%,45%,2,0,2,3,2,1
476,https://vlr.gg/player/23421/laser,2025-01-25 12:15:00,0.88,0.48,0.60,127,201,97,8,4,4,16,5,11,2,0,2,+1,+1,0,65%,60%,67%,90,149,66,25%,25%,25%,2,1,1,1,0,1
477,https://vlr.gg/player/16012/akira,2025-01-25 12:15:00,0.39,0.49,0.46,130,168,115,8,3,5,15,5,10,2,1,1,-3,-1,-2,47%,60%,42%,73,88,66,24%,17%,31%,0,0,0,3,1,2
478,https://vlr.gg/player/42650/mally,2025-01-25 12:15:00,0.62,0.38,0.45,134,161,123,7,2,5,16,5,11,4,3,1,-1,+1,-2,59%,80%,50%,87,103,80,12%,15%,10%,1,1,0,2,0,2
479,https://vlr.gg/player/42651/avey,2025-01-25 12:15:00,0.23,0.16,0.18,86,73,92,4,1,3,17,5,12,5,2,3,-3,0,-3,41%,60%,33%,66,45,75,17%,17%,17%,0,0,0,3,0,3
480,https://vlr.gg/player/10152/padisah,2025-01-25 11:30:00,0.91,1.14,1.05,209,240,190,15,7,8,11,6,5,2,1,1,-3,-2,-1,50%,38%,58%,122,135,114,29%,31%,28%,3,2,1,6,4,2
481,https://vlr.gg/player/19776/jrayn,2025-01-25 11:30:00,1.04,0.95,0.99,226,241,217,15,6,9,14,6,8,2,1,1,-1,0,-1,70%,75%,67%,168,166,169,33%,25%,43%,0,0,0,1,0,1
482,https://vlr.gg/player/10883/baransel,2025-01-25 11:30:00,0.39,1.07,0.80,199,168,220,13,4,9,14,8,6,4,0,4,0,0,0,70%,38%,92%,130,103,148,25%,12%,33%,1,0,1,1,0,1
483,https://vlr.gg/player/3549/touven,2025-01-25 11:30:00,0.31,1.07,0.77,164,81,220,11,2,9,15,7,8,6,1,5,-1,-1,0,60%,50%,67%,110,57,145,32%,50%,28%,2,0,2,3,1,2
484,https://vlr.gg/player/13545/werlass,2025-01-25 11:30:00,0.28,0.63,0.49,115,85,135,7,2,5,16,7,9,3,2,1,-1,-1,0,55%,38%,67%,81,59,96,48%,33%,53%,1,0,1,2,1,1
485,https://vlr.gg/player/21584/deminatix,2025-01-25 11:30:00,0.79,2.41,1.44,295,154,508,19,6,13,14,9,5,9,3,6,+4,+1,+3,80%,75%,88%,197,96,348,27%,27%,27%,7,4,3,3,3,0
486,https://vlr.gg/player/12226/sturnn,2025-01-25 11:30:00,1.04,1.59,1.26,220,189,268,18,8,10,12,7,5,2,0,2,0,-1,+1,70%,58%,88%,142,140,147,22%,17%,29%,2,0,2,2,1,1
487,https://vlr.gg/player/11516/drky,2025-01-25 11:30:00,1.13,1.24,1.17,225,270,157,16,11,5,11,8,3,2,0,2,+1,+1,0,75%,75%,75%,152,179,112,18%,16%,25%,1,1,0,0,0,0
488,https://vlr.gg/player/16483/gloomy,2025-01-25 11:30:00,0.80,1.14,0.94,145,142,152,10,5,5,12,8,4,5,3,2,+2,+1,+1,70%,75%,63%,100,98,103,10%,9%,11%,2,1,1,0,0,0
489,https://vlr.gg/player/10114/baha,2025-01-25 11:30:00,0.86,0.69,0.79,111,134,78,7,6,1,12,8,4,8,4,4,-1,0,-1,85%,83%,88%,82,96,61,35%,55%,17%,1,1,0,2,1,1
490,https://vlr.gg/player/7231/kya,2025-01-25 11:15:00,0.27,1.82,0.93,199,84,354,14,2,12,15,12,3,3,0,3,0,-1,+1,52%,17%,100%,139,62,243,19%,17%,19%,1,0,1,1,1,0
491,https://vlr.gg/player/39682/wanzeru,2025-01-25 11:15:00,0.16,1.92,0.92,224,91,401,16,3,13,17,12,5,2,1,1,+1,-3,+4,62%,33%,100%,132,56,235,23%,20%,23%,5,1,4,4,4,0
492,https://vlr.gg/player/2832/patix,2025-01-25 11:15:00,1.04,0.68,0.88,187,240,118,11,9,2,13,10,3,9,3,6,-4,-3,-1,62%,58%,67%,125,160,79,24%,41%,5%,1,0,1,5,3,2
493,https://vlr.gg/player/33732/nunmeister,2025-01-25 11:15:00,0.55,0.85,0.68,141,141,141,10,5,5,18,12,6,4,1,3,-1,-1,0,52%,33%,78%,97,94,101,35%,33%,40%,0,0,0,1,1,0
494,https://vlr.gg/player/6969/gunners,2025-01-25 11:15:00,0.27,0.93,0.55,141,81,222,10,3,7,19,12,7,9,0,9,-1,-2,+1,48%,25%,78%,82,57,115,10%,25%,3%,1,0,1,2,2,0
495,https://vlr.gg/player/2700/jas,2025-01-25 11:15:00,0.44,2.60,1.67,326,176,438,25,5,20,11,9,2,4,2,2,+4,-2,+6,81%,56%,100%,202,111,270,37%,31%,41%,7,1,6,3,3,0
496,https://vlr.gg/player/562/zeek,2025-01-25 11:15:00,1.19,1.82,1.55,297,261,325,24,8,16,13,8,5,7,3,4,+1,-1,+2,81%,67%,92%,212,179,236,24%,19%,26%,3,1,2,2,2,0
497,https://vlr.gg/player/1616/starki,2025-01-25 11:15:00,0.27,1.61,1.03,180,79,256,13,2,11,12,9,3,9,2,7,+1,-1,+2,86%,67%,100%,117,57,162,40%,0%,61%,3,0,3,2,1,1
498,https://vlr.gg/player/2894/kiles,2025-01-25 11:15:00,1.01,0.98,0.99,206,259,167,15,7,8,12,6,6,7,0,7,0,0,0,71%,56%,83%,145,161,132,39%,35%,42%,0,0,0,0,0,0
499,https://vlr.gg/player/1369/doma,2025-01-25 11:15:00,0.55,0.67,0.62,81,74,87,5,2,3,13,7,6,9,3,6,-1,-1,0,81%,78%,83%,73,73,73,17%,25%,13%,0,0,0,1,1,0
0,https://vlr.gg/player/26837/poegii,2025-01-25 11:00:00,0.93,1.22,1.06,202,164,255,26,11,15,26,14,12,6,5,1,+1,0,+1,59%,55%,65%,142,119,168,33%,22%,47%,4,2,2,3,2,1
1,https://vlr.gg/player/31058/kpro,2025-01-25 11:00:00,0.84,0.94,0.88,170,155,191,21,10,11,26,15,11,9,8,1,-2,-2,0,70%,65%,76%,117,110,124,30%,25%,36%,2,0,2,4,2,2
2,https://vlr.gg/player/26809/tenshi,2025-01-25 11:00:00,0.95,0.66,0.82,172,177,159,21,13,8,29,15,14,15,12,3,-2,-2,0,73%,65%,82%,115,117,113,45%,56%,35%,1,0,1,3,2,1
3,https://vlr.gg/player/4307/hyperzxz,2025-01-25 11:00:00,0.95,0.35,0.68,185,249,111,21,15,6,34,19,15,8,6,2,+3,+5,-2,62%,70%,53%,132,182,73,27%,24%,35%,10,8,2,7,3,4
4,https://vlr.gg/player/39718/rouss,2025-01-25 11:00:00,0.48,0.47,0.46,98,104,102,12,7,5,30,16,14,7,4,3,+1,-1,+2,51%,60%,41%,71,67,76,29%,32%,25%,2,0,2,1,1,0
5,https://vlr.gg/player/11322/sevire,2025-01-25 11:00:00,1.43,1.43,1.43,281,281,280,36,17,19,24,12,12,13,8,5,0,-3,+3,76%,82%,70%,183,181,184,42%,53%,35%,5,1,4,5,4,1
6,https://vlr.gg/player/24439/yohpa,2025-01-25 11:00:00,1.24,1.33,1.29,200,204,200,28,14,14,17,8,9,12,2,10,0,0,0,84%,88%,80%,135,135,135,43%,52%,33%,1,1,0,1,1,0
7,https://vlr.gg/player/7173/soren,2025-01-25 11:00:00,1.38,1.11,1.23,233,258,209,32,16,16,20,9,11,4,3,1,+2,+1,+1,78%,76%,80%,155,182,133,19%,16%,22%,4,2,2,2,1,1
8,https://vlr.gg/player/21216/f4ngeer,2025-01-25 11:00:00,1.19,0.93,1.05,197,181,209,26,11,15,21,8,13,4,2,2,-2,+1,-3,73%,76%,70%,128,123,132,19%,23%,14%,5,3,2,7,2,5
9,https://vlr.gg/player/2864/ease,2025-01-25 11:00:00,0.79,1.12,0.97,157,119,187,23,8,15,19,8,11,7,5,2,-1,0,-1,78%,88%,70%,101,63,133,32%,21%,39%,3,1,2,4,1,3
10,https://vlr.gg/player/12519/ticey,2025-01-25 11:00:00,1.19,1.06,1.13,245,251,253,58,33,25,52,25,27,16,8,8,+4,+2,+2,69%,66%,72%,165,156,177,24%,29%,19%,13,9,4,9,7,2
11,https://vlr.gg/player/3649/litshii,2025-01-25 11:00:00,1.25,0.98,1.13,194,193,198,50,27,23,43,19,24,20,11,9,+2,+1,+1,70%,71%,69%,137,144,129,23%,29%,18%,6,1,5,4,0,4
12,https://vlr.gg/player/2540/happen,2025-01-25 11:00:00,1.22,0.83,1.04,212,229,174,53,34,19,49,24,25,17,8,9,-2,+2,-4,69%,74%,63%,132,145,116,20%,20%,20%,3,2,1,5,0,5
13,https://vlr.gg/player/33994/creamydreamy,2025-01-25 11:00:00,0.84,0.85,0.85,186,194,174,42,24,18,52,28,24,18,12,6,0,-1,+1,66%,71%,59%,127,138,113,22%,23%,21%,8,5,3,8,6,2
14,https://vlr.gg/player/5477/leon,2025-01-25 11:00:00,0.50,0.72,0.60,129,107,150,29,13,16,51,28,23,21,12,9,-2,-2,0,63%,66%,59%,78,62,97,22%,14%,29%,6,3,3,8,5,3
15,https://vlr.gg/player/15382/kongi,2025-01-25 11:00:00,1.61,1.17,1.37,237,273,210,62,34,28,44,17,27,35,17,18,+2,+2,0,77%,88%,68%,153,181,129,25%,31%,20%,7,2,5,5,0,5
16,https://vlr.gg/player/39062/terrox,2025-01-25 11:00:00,1.14,1.28,1.22,233,195,266,58,24,34,47,19,28,19,6,13,+4,+1,+3,76%,75%,76%,155,132,174,24%,23%,24%,8,3,5,4,2,2
17,https://vlr.gg/player/27813/zery,2025-01-25 11:00:00,1.05,1.12,1.09,234,248,226,56,28,28,47,23,24,16,8,8,-5,-5,0,67%,63%,71%,170,185,157,20%,28%,14%,9,5,4,14,10,4
18,https://vlr.gg/player/27954/movi,2025-01-25 11:00:00,1.20,0.89,1.04,166,183,149,41,22,19,42,18,24,19,9,10,+3,+2,+1,74%,84%,66%,112,108,115,19%,15%,24%,5,3,2,2,1,1
19,https://vlr.gg/player/12514/spocki,2025-01-25 11:00:00,0.76,0.69,0.72,135,151,131,30,15,15,52,24,28,34,18,16,-6,0,-6,67%,72%,63%,99,102,96,30%,31%,30%,5,3,2,11,3,8
20,https://vlr.gg/player/3862/deepmans,2025-01-25 10:30:00,2.14,1.34,1.82,371,430,283,29,21,8,13,7,6,2,0,2,+1,+2,-1,90%,100%,75%,225,260,172,44%,44%,43%,4,2,2,3,0,3
21,https://vlr.gg/player/568/turko,2025-01-25 10:30:00,1.09,1.25,1.15,183,145,241,15,7,8,10,5,5,2,1,1,+2,+1,+1,90%,100%,75%,125,103,156,36%,31%,41%,2,1,1,0,0,0
22,https://vlr.gg/player/569/paura,2025-01-25 10:30:00,1.30,0.49,0.98,188,216,148,14,10,4,13,6,7,3,3,0,0,+1,-1,80%,83%,75%,133,154,102,37%,43%,29%,2,2,0,2,1,1
23,https://vlr.gg/player/10146/reazy,2025-01-25 10:30:00,0.96,0.80,0.90,158,160,156,12,7,5,11,6,5,5,5,0,-1,0,-1,85%,92%,75%,102,117,79,52%,44%,80%,1,1,0,2,1,1
24,https://vlr.gg/player/50775/lava,2025-01-25 10:30:00,1.05,0.30,0.75,150,210,63,10,9,1,15,8,7,3,2,1,+4,+4,0,80%,92%,63%,103,137,52,30%,35%,14%,4,4,0,0,0,0
25,https://vlr.gg/player/10125/qw1,2025-01-25 10:30:00,1.60,1.16,1.34,241,297,205,18,9,9,13,4,9,3,1,2,0,+1,-1,85%,100%,75%,163,204,135,34%,28%,40%,3,2,1,3,1,2
26,https://vlr.gg/player/1399/sterben,2025-01-25 10:30:00,1.09,1.07,1.08,246,203,276,17,6,11,17,6,11,11,4,7,-1,0,-1,95%,88%,100%,153,147,156,22%,28%,19%,0,0,0,1,0,1
27,https://vlr.gg/player/7353/glovee,2025-01-25 10:30:00,1.35,0.28,0.70,160,234,112,10,7,3,17,5,12,6,3,3,-2,+1,-3,70%,100%,50%,107,128,93,24%,19%,32%,1,1,0,3,0,3
28,https://vlr.gg/player/6559/destruct1vee,2025-01-25 10:30:00,0.87,0.51,0.65,142,199,106,10,6,4,16,6,10,8,3,5,-2,-1,-1,65%,63%,67%,84,103,72,21%,36%,11%,1,1,0,3,2,1
29,https://vlr.gg/player/3604/mojj,2025-01-25 10:30:00,0.58,0.35,0.44,115,96,129,7,2,5,17,5,12,1,1,0,-1,+1,-2,50%,75%,33%,83,76,88,56%,57%,55%,2,1,1,3,0,3
30,https://vlr.gg/player/7104/juseu,2025-01-25 10:00:00,1.20,1.52,1.37,293,336,255,24,13,11,14,9,5,8,4,4,+4,+1,+3,78%,73%,83%,178,205,154,39%,41%,37%,6,3,3,2,2,0
31,https://vlr.gg/player/33358/shinnok,2025-01-25 10:00:00,1.43,1.28,1.35,265,260,271,22,10,12,12,4,8,4,2,2,+5,+3,+2,87%,91%,83%,191,195,187,47%,53%,43%,5,3,2,0,0,0
32,https://vlr.gg/player/7490/anguist,2025-01-25 10:00:00,1.25,1.26,1.25,216,194,237,18,8,10,11,5,6,5,5,0,+1,0,+1,78%,91%,67%,147,141,153,45%,33%,55%,1,0,1,0,0,0
33,https://vlr.gg/player/217/seider,2025-01-25 10:00:00,1.55,0.95,1.24,209,225,194,17,9,8,13,5,8,11,6,5,+2,+2,0,83%,100%,67%,123,128,118,33%,25%,42%,4,2,2,2,0,2
34,https://vlr.gg/player/4589/burzzy,2025-01-25 10:00:00,0.98,0.69,0.82,174,195,156,14,8,6,17,7,10,21,8,13,+1,+1,0,70%,82%,58%,104,120,89,29%,25%,36%,2,1,1,1,0,1
35,https://vlr.gg/player/31298/luca,2025-01-25 10:00:00,1.32,1.21,1.27,251,269,232,19,10,9,16,8,8,5,3,2,+1,+1,0,70%,75%,64%,174,192,156,29%,31%,26%,2,2,0,1,1,0
36,https://vlr.gg/player/12372/szoren,2025-01-25 10:00:00,0.99,1.08,1.03,243,233,255,19,10,9,20,10,10,2,2,0,0,0,0,74%,83%,64%,149,136,163,27%,29%,26%,1,0,1,1,0,1
37,https://vlr.gg/player/4214/eso177,2025-01-25 10:00:00,0.90,0.73,0.82,151,154,149,13,7,6,18,8,10,5,1,4,-1,0,-1,78%,83%,73%,93,95,91,22%,24%,21%,0,0,0,1,0,1
38,https://vlr.gg/player/34002/lukey,2025-01-25 10:00:00,0.30,0.54,0.41,113,107,121,9,5,4,21,11,10,3,1,2,-6,-5,-1,43%,33%,55%,76,71,82,47%,45%,50%,2,1,1,8,6,2
39,https://vlr.gg/player/5566/jeyj7y,2025-01-25 10:00:00,0.56,0.26,0.41,107,136,75,7,5,2,20,10,10,5,2,3,-7,-2,-5,57%,58%,55%,75,86,64,13%,14%,9%,0,0,0,7,2,5
40,https://vlr.gg/player/18655/best,2025-01-25 09:30:00,1.04,1.19,1.09,284,294,268,20,12,8,16,10,6,0,0,0,+8,+6,+2,84%,92%,71%,161,179,131,27%,34%,18%,9,7,2,1,1,0
41,https://vlr.gg/player/40842/ibonata,2025-01-25 09:30:00,1.06,0.95,1.02,223,214,239,13,8,5,16,9,7,9,5,4,+2,+1,+1,74%,75%,71%,154,145,170,20%,14%,57%,2,1,1,0,0,0
42,https://vlr.gg/player/33551/slaughter,2025-01-25 09:30:00,1.17,0.36,0.87,188,233,111,11,9,2,14,8,6,9,6,3,0,0,0,84%,92%,71%,123,147,81,35%,45%,18%,0,0,0,0,0,0
43,https://vlr.gg/player/15735/krostaly,2025-01-25 09:30:00,0.55,0.60,0.57,129,134,123,6,4,2,15,10,5,8,7,1,0,+1,-1,79%,83%,71%,93,92,95,13%,14%,13%,1,1,0,1,0,1
44,https://vlr.gg/player/31307/yigox,2025-01-25 09:30:00,0.64,0.27,0.51,127,148,94,10,8,2,14,8,6,1,0,1,-1,0,-1,42%,42%,43%,82,97,56,32%,45%,24%,2,1,1,3,1,2
45,https://vlr.gg/player/31305/lar0k,2025-01-25 09:30:00,0.96,1.63,1.38,229,152,275,14,3,11,11,4,7,10,3,7,-1,-1,0,84%,86%,83%,146,100,173,31%,17%,37%,1,0,1,2,1,1
46,https://vlr.gg/player/24344/loita,2025-01-25 09:30:00,1.30,1.42,1.38,250,206,276,18,6,12,12,3,9,12,4,8,0,0,0,79%,71%,83%,157,118,180,24%,44%,19%,0,0,0,0,0,0
47,https://vlr.gg/player/5565/ros,2025-01-25 09:30:00,1.61,1.14,1.31,245,273,230,17,8,9,12,3,9,8,3,5,-2,+1,-3,79%,86%,75%,162,166,159,21%,9%,35%,1,1,0,3,0,3
48,https://vlr.gg/player/12795/crewen,2025-01-25 09:30:00,0.95,1.17,1.09,182,168,190,13,4,9,11,4,7,6,3,3,-4,-2,-2,74%,86%,67%,112,106,116,26%,40%,20%,0,0,0,4,2,2
49,https://vlr.gg/player/40591/comeback,2025-01-25 09:30:00,1.53,0.48,0.87,190,320,115,13,9,4,14,5,9,3,1,2,-2,+1,-3,79%,86%,75%,119,211,66,33%,36%,29%,3,2,1,5,1,4
50,https://vlr.gg/player/34974/karon,2025-01-25 06:00:00,1.05,1.23,1.13,184,193,183,44,23,21,40,26,14,24,14,10,-8,-3,-5,73%,70%,76%,127,137,114,27%,25%,28%,2,1,1,10,4,6
51,https://vlr.gg/player/9196/t3xture,2025-01-25 06:00:00,0.85,1.12,0.97,215,176,271,53,24,29,49,29,20,8,5,3,-6,-6,0,62%,65%,59%,137,109,174,22%,25%,19%,13,6,7,19,12,7
52,https://vlr.gg/player/11600/foxy9,2025-01-25 06:00:00,0.78,1.18,0.96,210,182,243,49,22,27,49,30,19,6,3,3,+1,-1,+2,61%,49%,76%,129,115,147,38%,40%,36%,5,2,3,4,3,1
53,https://vlr.gg/player/2489/munchkin,2025-01-25 06:00:00,0.72,1.14,0.90,181,173,203,43,22,21,47,30,17,14,8,6,+1,-1,+2,67%,65%,69%,123,116,133,23%,28%,18%,5,3,2,4,4,0
54,https://vlr.gg/player/25081/yoman,2025-01-25 06:00:00,0.60,1.06,0.80,138,116,159,28,13,15,42,27,15,20,9,11,-2,-2,0,65%,54%,79%,91,79,107,25%,17%,35%,1,0,1,3,2,1
55,https://vlr.gg/player/4866/kushy,2025-01-25 06:00:00,0.76,1.69,1.28,241,147,315,56,15,41,40,21,19,19,6,13,+4,+1,+3,74%,62%,84%,154,94,201,37%,39%,37%,8,2,6,4,1,3
56,https://vlr.gg/player/24895/jemkin,2025-01-25 06:00:00,1.27,1.16,1.20,260,312,231,58,29,29,48,25,23,17,5,12,+12,+8,+4,82%,90%,76%,167,191,149,27%,38%,19%,18,11,7,6,3,3
57,https://vlr.gg/player/25025/estrella,2025-01-25 06:00:00,0.76,1.07,0.93,164,150,173,38,15,23,44,24,20,27,9,18,+2,+1,+1,73%,66%,78%,113,111,114,43%,44%,42%,6,2,4,4,1,3
58,https://vlr.gg/player/8497/monyet,2025-01-25 06:00:00,0.61,1.12,0.90,164,132,175,39,13,26,42,21,21,19,6,13,-5,-6,+1,67%,55%,76%,103,95,110,30%,27%,32%,3,0,3,8,6,2
59,https://vlr.gg/player/4871/xffero,2025-01-25 06:00:00,0.69,0.95,0.84,148,131,157,36,13,23,43,22,21,13,5,8,+1,-3,+4,68%,59%,76%,98,97,99,26%,33%,23%,5,0,5,4,3,1
60,https://vlr.gg/player/3045/luok1ng,2025-01-25 04:00:00,,,,206,,,74,,,68,,,38,,,,,,,,,,,,,,,,,,,,
61,https://vlr.gg/player/3021/biank,2025-01-25 04:00:00,,,,192,,,63,,,78,,,34,,,,,,,,,,,,,,,,,,,,
62,https://vlr.gg/player/4712/heybay,2025-01-25 04:00:00,,,,191,,,61,,,76,,,31,,,,,,,,,,,,,,,,,,,,
63,https://vlr.gg/player/37494/kai,2025-01-25 04:00:00,,,,183,,,65,,,73,,,17,,,,,,,,,,,,,,,,,,,,
64,https://vlr.gg/player/4770/fengf,2025-01-25 04:00:00,,,,181,,,58,,,78,,,11,,,,,,,,,,,,,,,,,,,,
65,https://vlr.gg/player/3520/zmjjkk,2025-01-25 04:00:00,,,,271,,,86,,,69,,,19,,,,,,,,,,,,,,,,,,,,
66,https://vlr.gg/player/3017/nobody,2025-01-25 04:00:00,,,,240,,,87,,,58,,,19,,,,,,,,,,,,,,,,,,,,
67,https://vlr.gg/player/4742/smoggy,2025-01-25 04:00:00,,,,210,,,73,,,66,,,39,,,,,,,,,,,,,,,,,,,,
68,https://vlr.gg/player/15559/chichoo,2025-01-25 04:00:00,,,,202,,,73,,,68,,,43,,,,,,,,,,,,,,,,,,,,
69,https://vlr.gg/player/13768/s1mon,2025-01-25 04:00:00,,,,150,,,54,,,60,,,47,,,,,,,,,,,,,,,,,,,,
70,https://vlr.gg/player/13788/jitboys,2025-01-25 03:00:00,0.84,1.50,1.12,214,186,255,50,25,25,42,29,13,17,7,10,+2,-2,+4,71%,61%,85%,132,119,149,38%,40%,37%,8,3,5,6,5,1
71,https://vlr.gg/player/25255/primmie,2025-01-25 03:00:00,1.18,1.00,1.10,225,254,188,50,32,18,39,25,14,14,9,5,+3,+3,0,81%,75%,88%,141,152,127,35%,33%,39%,4,3,1,1,0,1
72,https://vlr.gg/player/5129/ban,2025-01-25 03:00:00,0.69,1.11,0.86,176,146,216,39,18,21,40,25,15,11,6,5,-4,-6,+2,66%,53%,85%,114,98,136,44%,44%,44%,6,2,4,10,8,2
73,https://vlr.gg/player/3980/governor,2025-01-25 03:00:00,0.51,1.24,0.82,179,140,240,38,16,22,43,29,14,11,7,4,0,-6,+6,68%,61%,77%,112,87,148,24%,23%,24%,12,4,8,12,10,2
74,https://vlr.gg/player/3977/crws,2025-01-25 03:00:00,0.86,0.64,0.76,135,150,112,26,16,10,37,24,13,18,11,7,0,+1,-1,66%,69%,62%,97,109,81,29%,28%,32%,1,1,0,1,0,1
75,https://vlr.gg/player/5796/kr1stal,2025-01-25 03:00:00,0.67,1.60,1.21,217,132,276,46,11,35,36,18,18,12,1,11,+3,-2,+5,73%,62%,81%,143,93,180,25%,27%,24%,6,1,5,3,3,0
76,https://vlr.gg/player/4428/udotan,2025-01-25 03:00:00,0.91,1.36,1.17,247,193,283,54,18,36,45,19,26,7,2,5,-3,-6,+3,68%,54%,78%,153,114,181,34%,39%,31%,6,0,6,9,6,3
77,https://vlr.gg/player/13219/papi,2025-01-25 03:00:00,0.76,1.09,0.96,175,150,191,39,14,25,39,19,20,16,2,14,+1,+2,-1,74%,77%,72%,115,92,131,42%,34%,46%,6,3,3,5,1,4
78,https://vlr.gg/player/9152/deryeon,2025-01-25 03:00:00,0.52,1.05,0.83,147,126,164,34,11,23,41,21,20,8,3,5,0,-3,+3,63%,46%,75%,98,80,111,33%,33%,33%,8,2,6,8,5,3
79,https://vlr.gg/player/7437/kellys,2025-01-25 03:00:00,0.75,0.66,0.70,135,145,128,26,13,13,42,19,23,16,7,9,-2,-2,0,65%,62%,67%,89,92,87,29%,42%,23%,4,1,3,6,3,3
80,https://vlr.gg/player/796/eeiu,2025-01-24 19:00:00,1.23,0.98,1.11,204,252,161,57,34,23,44,24,20,15,3,12,+2,0,+2,81%,86%,77%,125,149,101,39%,45%,32%,5,2,3,3,2,1
81,https://vlr.gg/player/601/asuna,2025-01-24 19:00:00,0.99,0.87,0.93,196,226,170,44,25,19,49,27,22,23,11,12,-2,+1,-3,66%,66%,66%,136,155,116,25%,28%,21%,10,7,3,12,6,6
82,https://vlr.gg/player/8082/zander,2025-01-24 19:00:00,0.76,1.04,0.90,193,163,225,47,20,27,51,26,25,21,10,11,+1,-2,+3,71%,69%,74%,117,99,134,30%,32%,29%,10,3,7,9,5,4
83,https://vlr.gg/player/4147/cryocells,2025-01-24 19:00:00,0.83,0.95,0.89,194,190,202,47,23,24,51,27,24,14,7,7,+3,-1,+4,79%,71%,86%,127,115,138,29%,42%,20%,7,2,5,4,3,1
84,https://vlr.gg/player/604/boostio,2025-01-24 19:00:00,0.41,0.57,0.49,104,77,126,23,8,15,53,26,27,22,16,6,-2,-3,+1,64%,69%,60%,63,43,82,20%,20%,20%,4,1,3,6,4,2
85,https://vlr.gg/player/5132/mada,2025-01-24 19:00:00,1.25,1.67,1.46,300,271,325,73,32,41,47,27,20,14,10,4,+2,-7,+9,81%,77%,86%,184,170,198,17%,20%,14%,17,5,12,15,12,3
86,https://vlr.gg/player/21668/verno,2025-01-24 19:00:00,1.09,1.18,1.13,208,189,233,56,24,32,43,21,22,18,11,7,+1,0,+1,81%,89%,74%,134,125,144,35%,35%,35%,4,1,3,3,1,2
87,https://vlr.gg/player/4164/s0m,2025-01-24 19:00:00,1.08,1.17,1.12,196,171,218,47,21,26,43,20,23,34,13,21,+2,+3,-1,83%,80%,86%,117,103,132,20%,27%,17%,7,4,3,5,1,4
88,https://vlr.gg/player/817/finesse,2025-01-24 19:00:00,1.19,1.02,1.10,169,197,145,39,25,14,38,18,20,31,7,24,0,-1,+1,77%,80%,74%,112,131,92,14%,19%,9%,4,2,2,4,3,1
89,https://vlr.gg/player/11225/ethan,2025-01-24 19:00:00,0.84,0.70,0.77,145,138,148,33,16,17,47,22,25,24,12,12,-7,-2,-5,69%,71%,66%,100,95,104,26%,22%,29%,2,2,0,9,4,5
90,https://vlr.gg/player/2462/keznit,2025-01-24 17:00:00,1.47,1.61,1.50,295,299,286,33,26,7,16,12,4,7,4,3,+3,+1,+2,84%,79%,100%,186,180,207,23%,25%,20%,6,4,2,3,3,0
91,https://vlr.gg/player/1311/melser,2025-01-24 17:00:00,1.46,1.46,1.46,241,223,307,28,20,8,14,9,5,9,7,2,+1,0,+1,87%,88%,86%,158,151,182,42%,40%,47%,4,2,2,3,2,1
92,https://vlr.gg/player/7603/mazino,2025-01-24 17:00:00,1.40,0.69,1.24,217,254,89,23,21,2,18,14,4,22,20,2,-1,0,-1,84%,88%,71%,143,167,62,24%,27%,9%,2,2,0,3,2,1
93,https://vlr.gg/player/3826/adverso,2025-01-24 17:00:00,0.94,1.66,1.11,201,167,309,22,13,9,18,13,5,13,8,5,-2,-2,0,77%,79%,71%,123,112,161,32%,33%,32%,2,2,0,4,4,0
94,https://vlr.gg/player/24007/shyy,2025-01-24 17:00:00,0.79,1.99,1.06,193,163,299,23,15,8,19,16,3,8,4,4,+2,+1,+1,81%,75%,100%,132,108,214,24%,26%,19%,3,2,1,1,1,0
95,https://vlr.gg/player/14950/gobera,2025-01-24 17:00:00,0.47,1.27,1.09,216,156,234,23,3,20,24,7,17,10,3,7,+2,0,+2,77%,86%,75%,130,112,135,32%,40%,30%,3,0,3,1,0,1
96,https://vlr.gg/player/662/pryze,2025-01-24 17:00:00,0.48,0.96,0.85,195,155,204,19,3,16,24,7,17,8,3,5,+1,0,+1,77%,71%,79%,133,106,141,24%,16%,27%,2,0,2,1,0,1
97,https://vlr.gg/player/11921/silentzz,2025-01-24 17:00:00,0.66,0.63,0.61,169,209,155,17,5,12,28,7,21,5,1,4,-1,-2,+1,58%,57%,58%,100,139,89,41%,53%,37%,4,1,3,5,3,2
98,https://vlr.gg/player/6195/lz,2025-01-24 17:00:00,1.44,0.35,0.59,143,311,94,16,9,7,27,6,21,5,0,5,-4,+1,-5,55%,86%,46%,99,180,75,39%,58%,29%,3,1,2,7,0,7
99,https://vlr.gg/player/3169/zap,2025-01-24 17:00:00,0.02,0.68,0.47,112,31,135,10,1,9,27,8,19,11,0,11,-1,-2,+1,52%,29%,58%,81,15,100,18%,0%,20%,2,0,2,3,2,1
100,https://vlr.gg/player/23169/minny,2025-01-24 15:10:00,2.06,1.05,1.40,252,390,182,52,26,26,30,10,20,7,5,2,+7,+3,+4,82%,95%,75%,161,237,121,43%,50%,37%,11,5,6,4,2,2
101,https://vlr.gg/player/7866/click,2025-01-24 15:10:00,1.07,1.51,1.33,266,197,301,56,16,40,38,14,24,7,3,4,+2,-5,+7,82%,63%,92%,166,130,185,38%,32%,40%,9,2,7,7,7,0
102,https://vlr.gg/player/20871/k4davra,2025-01-24 15:10:00,0.85,1.32,1.16,212,173,223,41,12,29,35,15,20,23,6,17,-1,0,-1,84%,84%,83%,127,94,144,35%,23%,39%,2,1,1,3,1,2
103,https://vlr.gg/player/11/zyppan,2025-01-24 15:10:00,1.18,0.92,1.01,172,191,166,34,13,21,36,11,25,29,11,18,-5,0,-5,75%,84%,69%,108,123,100,30%,33%,28%,4,0,4,9,0,9
104,https://vlr.gg/player/5893/robbiebk,2025-01-24 15:10:00,0.69,0.95,0.86,147,118,160,25,7,18,35,13,22,20,10,10,+2,-1,+3,76%,79%,75%,112,90,124,23%,18%,26%,4,0,4,2,1,1
105,https://vlr.gg/player/101/soulcas,2025-01-24 15:10:00,0.80,1.50,1.04,205,174,285,41,21,20,42,28,14,19,12,7,+3,+1,+2,69%,72%,63%,134,119,163,33%,30%,37%,7,4,3,4,3,1
106,https://vlr.gg/player/1428/sheydos,2025-01-24 15:10:00,1.00,0.59,0.86,159,164,157,31,20,11,39,23,16,7,5,2,+3,0,+3,64%,64%,63%,111,115,104,20%,19%,22%,5,1,4,2,1,1
107,https://vlr.gg/player/4544/filu,2025-01-24 15:10:00,0.99,0.48,0.82,213,248,146,39,30,9,44,28,16,11,8,3,-6,-6,0,64%,64%,63%,140,161,101,29%,30%,24%,7,5,2,13,11,2
108,https://vlr.gg/player/5550/grubinho,2025-01-24 15:10:00,0.70,0.75,0.72,153,167,135,30,21,9,41,27,14,20,12,8,-4,-3,-1,69%,72%,63%,91,91,90,27%,26%,29%,2,2,0,6,5,1
109,https://vlr.gg/player/3685/flyuh,2025-01-24 15:10:00,0.65,0.84,0.71,157,143,203,33,19,14,42,28,14,9,4,5,-1,0,-1,69%,64%,79%,107,92,137,18%,24%,12%,4,2,2,5,2,3
110,https://vlr.gg/player/31574/srn,2025-01-24 15:00:00,1.46,1.11,1.28,294,314,271,83,45,38,67,32,35,26,12,14,+8,+5,+3,76%,79%,73%,189,196,182,24%,22%,26%,22,12,10,14,7,7
111,https://vlr.gg/player/19791/mel,2025-01-24 15:00:00,1.07,1.14,1.11,215,191,249,67,29,38,58,27,31,28,12,16,+5,+1,+4,76%,70%,82%,152,131,172,25%,29%,22%,10,3,7,5,2,3
112,https://vlr.gg/player/21435/jelly,2025-01-24 15:00:00,0.86,1.09,0.98,172,174,169,57,27,30,58,32,26,25,11,14,0,-2,+2,74%,67%,80%,118,113,123,29%,39%,21%,8,5,3,8,7,1
113,https://vlr.gg/player/11239/sayuri,2025-01-24 15:00:00,0.98,0.94,0.96,177,159,186,53,26,27,58,27,31,41,19,22,+3,-1,+4,75%,67%,82%,111,98,124,21%,24%,19%,6,1,5,3,2,1
114,https://vlr.gg/player/14685/jubs,2025-01-24 15:00:00,0.67,0.67,0.67,144,144,144,45,20,25,66,32,34,16,9,7,-1,-2,+1,67%,70%,64%,94,93,96,28%,29%,27%,5,1,4,6,3,3
115,https://vlr.gg/player/41225/kramarick,2025-01-24 15:00:00,1.10,1.44,1.27,243,208,285,76,30,46,57,29,28,34,23,11,-3,-5,+2,72%,70%,74%,162,143,183,34%,31%,36%,9,4,5,12,9,3
116,https://vlr.gg/player/41466/mixyce,2025-01-24 15:00:00,1.18,0.84,1.01,207,237,183,64,38,26,63,33,30,27,16,11,-3,-4,+1,75%,75%,74%,132,148,115,20%,30%,12%,6,3,3,9,7,2
117,https://vlr.gg/player/50786/renna,2025-01-24 15:00:00,1.06,0.96,1.01,176,187,171,54,29,25,57,30,27,25,10,15,-6,-3,-3,69%,68%,70%,124,128,119,34%,30%,40%,4,0,4,10,3,7
118,https://vlr.gg/player/45864/bruxo,2025-01-24 15:00:00,0.94,0.87,0.90,173,177,171,53,29,24,60,31,29,15,4,11,+1,-1,+2,67%,70%,63%,124,120,128,39%,44%,35%,8,3,5,7,4,3
119,https://vlr.gg/player/47551/sanoj,2025-01-24 15:00:00,0.88,0.84,0.86,192,201,178,60,31,29,68,35,33,12,7,5,-4,-1,-3,59%,59%,58%,128,141,113,34%,40%,29%,9,5,4,13,6,7
120,https://vlr.gg/player/11494/keiko,2025-01-24 12:00:00,1.17,1.64,1.43,278,225,323,65,24,41,43,21,22,28,14,14,+2,-3,+5,80%,72%,86%,188,141,226,50%,45%,54%,5,0,5,3,3,0
121,https://vlr.gg/player/309/patitek,2025-01-24 12:00:00,1.14,1.08,1.10,186,230,153,42,25,17,39,22,17,30,10,20,+2,+1,+1,77%,69%,83%,126,136,119,30%,39%,23%,5,3,2,3,2,1
122,https://vlr.gg/player/457/nats,2025-01-24 12:00:00,0.92,1.08,1.01,194,175,213,47,18,29,43,20,23,16,4,12,0,-1,+1,69%,66%,72%,133,116,147,26%,24%,27%,5,2,3,5,3,2
123,https://vlr.gg/player/1475/kamyk,2025-01-24 12:00:00,0.58,1.16,0.90,162,97,209,37,11,26,40,19,21,13,2,11,+1,-4,+5,66%,52%,78%,112,66,149,22%,19%,24%,6,0,6,5,4,1
124,https://vlr.gg/player/14681/kamo,2025-01-24 12:00:00,0.71,1.04,0.89,228,229,226,51,21,30,49,27,22,12,8,4,0,0,0,75%,79%,72%,147,147,147,23%,24%,23%,14,6,8,14,6,8
125,https://vlr.gg/player/17976/florescent,2025-01-24 12:00:00,1.07,1.41,1.23,265,251,288,62,32,30,51,30,21,14,3,11,+5,0,+5,69%,69%,69%,179,167,195,39%,39%,39%,14,8,6,9,8,1
126,https://vlr.gg/player/1507/avova,2025-01-24 12:00:00,1.10,0.80,0.97,171,201,134,39,26,13,46,27,19,20,9,11,-5,-2,-3,72%,67%,79%,124,140,104,35%,32%,40%,1,0,1,6,2,4
127,https://vlr.gg/player/1281/molsi,2025-01-24 12:00:00,0.85,1.06,0.94,161,166,158,36,20,16,45,27,18,28,11,17,-2,-2,0,83%,78%,90%,110,113,105,27%,36%,18%,1,0,1,3,2,1
128,https://vlr.gg/player/129/hype,2025-01-24 12:00:00,0.59,1.27,0.89,181,119,257,39,13,26,48,28,20,12,5,7,+3,0,+3,71%,58%,86%,122,79,174,32%,33%,31%,8,3,5,5,3,2
129,https://vlr.gg/player/18615/batujnax,2025-01-24 12:00:00,0.53,1.03,0.76,156,119,219,38,14,24,52,31,21,17,13,4,-6,-8,+2,68%,69%,66%,103,76,137,19%,26%,12%,6,1,5,12,9,3
130,https://vlr.gg/player/27244/seph1roth,2025-01-24 08:45:00,0.88,1.09,0.99,200,193,207,28,13,15,33,17,16,7,2,5,-1,+1,-2,60%,62%,57%,138,128,147,38%,48%,32%,3,3,0,4,2,2
131,https://vlr.gg/player/27254/leviathan,2025-01-24 08:45:00,0.60,1.16,0.88,193,152,234,28,11,17,35,17,18,8,7,1,0,-1,+1,62%,62%,62%,130,92,168,42%,31%,51%,3,1,2,3,2,1
132,https://vlr.gg/player/13784/killua,2025-01-24 08:45:00,0.79,0.87,0.83,174,143,207,26,11,15,35,16,19,8,4,4,+3,0,+3,52%,43%,62%,113,86,139,38%,36%,39%,6,3,3,3,3,0
133,https://vlr.gg/player/8582/laz,2025-01-24 08:45:00,1.08,0.36,0.72,159,220,98,20,16,4,35,17,18,18,6,12,-3,+1,-4,62%,71%,52%,114,154,74,14%,21%,5%,2,1,1,5,0,5
134,https://vlr.gg/player/23930/potter,2025-01-24 08:45:00,0.32,0.81,0.56,141,100,182,22,7,15,35,18,17,3,2,1,-1,-4,+3,55%,52%,57%,83,70,95,25%,35%,17%,6,1,5,7,5,2
135,https://vlr.gg/player/13220/ja,2025-01-24 08:45:00,1.45,1.43,1.44,287,318,256,44,24,20,24,14,10,7,4,3,-1,-1,0,86%,90%,81%,184,204,164,35%,42%,29%,3,0,3,4,1,3
136,https://vlr.gg/player/11704/styron,2025-01-24 08:45:00,1.11,1.64,1.38,232,175,290,34,13,21,22,10,12,26,10,16,+4,+2,+2,86%,86%,86%,141,102,181,29%,19%,38%,4,2,2,0,0,0
137,https://vlr.gg/player/1430/crazyguy,2025-01-24 08:45:00,1.09,1.07,1.08,208,236,181,33,20,13,24,14,10,11,5,6,-1,-1,0,64%,62%,67%,139,158,120,39%,32%,50%,5,2,3,6,3,3
138,https://vlr.gg/player/24653/vera,2025-01-24 08:45:00,0.98,1.06,1.02,226,234,219,34,18,16,28,14,14,10,5,5,-1,-2,+1,60%,57%,62%,134,135,133,16%,11%,24%,6,4,2,7,6,1
139,https://vlr.gg/player/24628/wayne,2025-01-24 08:45:00,0.90,1.01,0.96,181,176,186,28,13,15,26,14,12,15,9,6,+1,+1,0,81%,81%,81%,113,110,115,26%,26%,26%,4,2,2,3,1,2
140,https://vlr.gg/player/17303/fontuz,2025-01-24 06:00:00,1.22,1.21,1.22,229,237,224,48,28,20,44,25,19,34,18,16,+3,0,+3,81%,85%,75%,160,160,161,35%,48%,24%,6,2,4,3,2,1
141,https://vlr.gg/player/41701/ki1wsy,2025-01-24 06:00:00,1.48,0.87,1.21,233,264,196,52,33,19,41,21,20,18,12,6,+3,+1,+2,79%,82%,75%,148,173,118,29%,29%,29%,4,2,2,1,1,0
142,https://vlr.gg/player/31537/basbabe,2025-01-24 06:00:00,1.09,1.17,1.13,191,190,197,44,25,19,38,21,17,28,14,14,+5,+2,+3,81%,82%,79%,116,109,124,30%,31%,28%,8,4,4,3,2,1
143,https://vlr.gg/player/41694/endoist,2025-01-24 06:00:00,0.92,1.21,1.05,281,264,294,58,28,30,50,28,22,18,13,5,+4,0,+4,69%,68%,71%,177,174,181,21%,25%,17%,16,9,7,12,9,3
144,https://vlr.gg/player/20623/harddora,2025-01-24 06:00:00,1.07,0.75,0.93,183,183,139,37,24,13,41,22,19,18,13,5,+3,+1,+2,71%,71%,71%,108,130,81,38%,39%,36%,6,2,4,3,1,2
145,https://vlr.gg/player/9263/sayoo,2025-01-24 06:00:00,1.08,0.96,1.01,195,183,220,45,19,26,45,18,27,14,6,8,0,0,0,68%,71%,65%,133,125,140,37%,26%,49%,4,0,4,4,0,4
146,https://vlr.gg/player/23710/gotten,2025-01-24 06:00:00,0.97,0.90,0.93,200,219,180,42,20,22,49,22,27,26,12,14,-5,-4,-1,74%,82%,68%,125,136,116,30%,23%,37%,4,1,3,9,5,4
147,https://vlr.gg/player/2346/cud,2025-01-24 06:00:00,1.08,0.75,0.90,178,192,187,44,21,23,47,17,30,6,2,4,-2,-5,+3,65%,71%,59%,124,137,114,33%,29%,38%,4,0,4,6,5,1
148,https://vlr.gg/player/16852/nakya,2025-01-24 06:00:00,0.75,1.00,0.89,238,213,247,49,19,30,53,24,29,10,5,5,-7,-5,-2,65%,54%,74%,143,130,154,27%,20%,33%,5,3,2,12,8,4
149,https://vlr.gg/player/1745/adrnking,2025-01-24 06:00:00,0.87,0.75,0.80,140,157,144,32,16,16,45,20,25,25,10,15,-4,0,-4,73%,79%,68%,99,100,98,34%,31%,37%,5,3,2,9,3,6
150,https://vlr.gg/player/10698/nephh,2025-01-24 04:00:00,,,,229,,,46,,,49,,,21,,,,,,,,,,,,,,,,,,,,
151,https://vlr.gg/player/4774/knight,2025-01-24 04:00:00,,,,190,,,39,,,43,,,20,,,,,,,,,,,,,,,,,,,,
152,https://vlr.gg/player/40845/levius,2025-01-24 04:00:00,,,,168,,,37,,,51,,,7,,,,,,,,,,,,,,,,,,,,
153,https://vlr.gg/player/48878/rushia,2025-01-24 04:00:00,,,,160,,,38,,,49,,,22,,,,,,,,,,,,,,,,,,,,
154,https://vlr.gg/player/4885/whzy,2025-01-24 04:00:00,,,,149,,,34,,,51,,,6,,,,,,,,,,,,,,,,,,,,
155,https://vlr.gg/player/3520/zmjjkk,2025-01-24 04:00:00,,,,272,,,61,,,44,,,11,,,,,,,,,,,,,,,,,,,,
156,https://vlr.gg/player/4742/smoggy,2025-01-24 04:00:00,,,,230,,,54,,,39,,,22,,,,,,,,,,,,,,,,,,,,
157,https://vlr.gg/player/3017/nobody,2025-01-24 04:00:00,,,,212,,,47,,,40,,,13,,,,,,,,,,,,,,,,,,,,
158,https://vlr.gg/player/15559/chichoo,2025-01-24 04:00:00,,,,211,,,47,,,38,,,18,,,,,,,,,,,,,,,,,,,,
159,https://vlr.gg/player/13768/s1mon,2025-01-24 04:00:00,,,,149,,,34,,,34,,,32,,,,,,,,,,,,,,,,,,,,
160,https://vlr.gg/player/17433/v1c,2025-01-23 19:20:00,1.61,1.03,1.32,223,270,174,53,31,22,37,17,20,26,16,10,+2,0,+2,78%,81%,75%,147,184,112,28%,27%,29%,4,0,4,2,0,2
161,https://vlr.gg/player/18796/oxy,2025-01-23 19:20:00,0.72,1.34,1.04,254,222,290,57,24,33,51,27,24,11,4,7,+3,+2,+1,67%,65%,69%,163,137,187,28%,31%,27%,15,9,6,12,7,5
162,https://vlr.gg/player/6582/net,2025-01-23 19:20:00,0.94,0.76,0.85,181,182,179,40,21,19,46,21,25,22,11,11,+4,+2,+2,70%,74%,66%,116,111,121,50%,45%,55%,8,3,5,4,1,3
163,https://vlr.gg/player/612/mitch,2025-01-23 19:20:00,0.66,0.82,0.74,162,147,175,32,14,18,47,24,23,33,18,15,-6,-7,+1,68%,68%,69%,102,92,111,19%,23%,17%,4,1,3,10,8,2
164,https://vlr.gg/player/7871/xeppaa,2025-01-23 19:20:00,0.60,0.76,0.68,121,119,128,26,13,13,45,24,21,17,9,8,+1,0,+1,67%,68%,66%,87,81,92,28%,26%,29%,2,1,1,1,1,0
165,https://vlr.gg/player/8480/aspas,2025-01-23 19:20:00,1.09,1.45,1.27,246,211,287,57,23,34,40,21,19,10,7,3,-2,-3,+1,75%,72%,77%,166,144,189,21%,20%,22%,11,6,5,13,9,4
166,https://vlr.gg/player/20240/xenom,2025-01-23 19:20:00,1.27,1.06,1.17,175,186,167,43,24,19,35,18,17,27,14,13,0,+1,-1,75%,75%,74%,115,126,103,30%,28%,33%,1,1,0,1,0,1
167,https://vlr.gg/player/725/nzr,2025-01-23 19:20:00,1.28,0.95,1.12,196,202,185,41,22,19,38,18,20,24,14,10,0,0,0,75%,75%,74%,138,152,124,25%,27%,22%,3,1,2,3,1,2
168,https://vlr.gg/player/5957/artzin,2025-01-23 19:20:00,0.93,1.12,1.03,213,176,247,45,19,26,47,23,24,28,18,10,-2,-5,+3,70%,66%,74%,127,107,147,20%,26%,18%,8,1,7,10,6,4
169,https://vlr.gg/player/5395/cortezia,2025-01-23 19:20:00,0.79,0.67,0.74,154,182,133,35,20,15,48,25,23,11,6,5,0,0,0,71%,69%,74%,111,125,96,40%,40%,40%,6,3,3,6,3,3
170,https://vlr.gg/player/1711/khalil,2025-01-23 17:00:00,1.39,1.04,1.22,235,236,235,34,18,16,29,12,17,12,7,5,+4,+3,+1,80%,80%,80%,154,155,153,36%,27%,48%,4,3,1,0,0,0
171,https://vlr.gg/player/8673/heat,2025-01-23 17:00:00,0.90,0.99,0.95,189,178,201,27,13,14,27,13,14,5,2,3,+2,+1,+1,73%,70%,75%,126,125,127,46%,38%,56%,4,2,2,2,1,1
172,https://vlr.gg/player/939/mwzera,2025-01-23 17:00:00,1.20,0.46,0.83,145,194,98,19,13,6,27,11,16,13,7,6,-1,0,-1,65%,65%,65%,104,136,73,27%,27%,28%,3,1,2,4,1,3
173,https://vlr.gg/player/8706/havoc,2025-01-23 17:00:00,0.67,0.85,0.76,204,191,217,28,14,14,33,16,17,7,5,2,-3,-2,-1,63%,60%,65%,134,123,146,22%,14%,32%,5,2,3,8,4,4
174,https://vlr.gg/player/25743/raafa,2025-01-23 17:00:00,0.24,0.83,0.53,150,97,204,18,5,13,34,17,17,11,8,3,-6,-4,-2,53%,50%,55%,98,63,133,26%,15%,34%,2,1,1,8,5,3
175,https://vlr.gg/player/4927/nature,2025-01-23 17:00:00,1.39,1.09,1.24,184,215,154,29,18,11,21,10,11,13,4,9,-2,-1,-1,73%,75%,70%,125,144,107,26%,24%,31%,0,0,0,2,1,1
176,https://vlr.gg/player/8402/icy,2025-01-23 17:00:00,0.87,1.55,1.21,276,233,319,38,16,22,30,17,13,9,5,4,0,-1,+1,75%,80%,70%,177,157,198,24%,19%,30%,8,3,5,8,4,4
177,https://vlr.gg/player/881/yay,2025-01-23 17:00:00,1.23,1.16,1.20,202,231,173,28,17,11,23,12,11,12,9,3,+8,+4,+4,80%,85%,75%,133,150,115,26%,20%,36%,8,4,4,0,0,0
178,https://vlr.gg/player/1533/derrek,2025-01-23 17:00:00,0.95,1.24,1.09,205,197,213,31,14,17,27,14,13,11,6,5,-5,-3,-2,80%,80%,80%,132,127,136,36%,32%,40%,1,0,1,6,3,3
179,https://vlr.gg/player/826/supamen,2025-01-23 17:00:00,1.24,0.73,0.99,182,213,151,24,16,8,25,10,15,18,6,12,+3,+3,0,80%,85%,75%,126,133,118,46%,61%,32%,5,4,1,2,1,1
180,https://vlr.gg/player/9554/kaajak,2025-01-23 15:30:00,1.25,1.34,1.30,261,258,269,73,35,38,50,27,23,12,8,4,+3,-1,+4,76%,71%,81%,170,169,170,41%,40%,43%,12,5,7,9,6,3
181,https://vlr.gg/player/9810/alfajer,2025-01-23 15:30:00,1.30,1.25,1.27,232,237,247,59,29,30,50,24,26,22,8,14,+4,+3,+1,73%,77%,69%,159,156,162,31%,27%,35%,11,6,5,7,3,4
182,https://vlr.gg/player/458/chronicle,2025-01-23 15:30:00,1.24,0.98,1.11,230,263,192,54,29,25,49,24,25,22,9,13,+1,+3,-2,72%,77%,67%,154,179,131,21%,22%,19%,7,5,2,6,2,4
183,https://vlr.gg/player/4/crashies,2025-01-23 15:30:00,0.68,0.84,0.76,136,120,150,33,14,19,46,22,24,12,4,8,-3,-2,-1,72%,63%,81%,103,105,102,33%,35%,32%,3,1,2,6,3,3
184,https://vlr.gg/player/438/boaster,2025-01-23 15:30:00,0.52,0.98,0.75,145,108,182,35,12,23,49,26,23,35,16,19,0,-2,+2,70%,69%,72%,94,73,114,17%,16%,19%,5,1,4,5,3,2
185,https://vlr.gg/player/18677/ruxic,2025-01-23 15:30:00,0.97,1.25,1.11,214,202,235,56,26,30,49,28,21,24,13,11,-2,-2,0,72%,69%,74%,137,127,148,27%,29%,25%,7,3,4,9,5,4
186,https://vlr.gg/player/384/shao,2025-01-23 15:30:00,0.75,1.45,1.09,207,141,280,54,17,37,45,25,20,23,13,10,+1,-2,+3,68%,64%,71%,131,90,173,28%,21%,33%,5,0,5,4,2,2
187,https://vlr.gg/player/29867/hiro,2025-01-23 15:30:00,1.24,0.57,0.91,199,243,142,49,32,17,53,27,26,13,7,6,-1,+2,-3,66%,78%,54%,130,161,99,31%,35%,24%,7,5,2,8,3,5
188,https://vlr.gg/player/3722/koalanoob,2025-01-23 15:30:00,0.84,0.83,0.84,196,221,168,49,29,20,56,30,26,10,3,7,0,0,0,62%,58%,66%,131,130,133,23%,24%,21%,11,8,3,11,8,3
189,https://vlr.gg/player/109/ange1,2025-01-23 15:30:00,0.74,0.83,0.78,146,126,167,36,17,19,51,25,26,15,6,9,-3,-2,-1,62%,56%,69%,106,91,120,35%,33%,37%,3,0,3,6,2,4
190,https://vlr.gg/player/727/saadhak,2025-01-23 12:00:00,0.95,1.16,1.05,210,196,225,50,23,27,48,24,24,20,10,10,-2,-4,+2,67%,69%,65%,137,133,142,26%,29%,23%,4,1,3,6,5,1
191,https://vlr.gg/player/2858/suygetsu,2025-01-23 12:00:00,1.10,0.98,1.04,187,204,165,46,27,19,44,24,20,39,19,20,-2,-1,-1,74%,75%,74%,120,139,101,45%,42%,50%,6,3,3,8,4,4
192,https://vlr.gg/player/5654/avez,2025-01-23 12:00:00,1.05,0.90,0.98,178,177,188,42,21,21,47,23,24,27,13,14,-2,-2,0,77%,81%,74%,123,119,127,40%,45%,36%,2,1,1,4,3,1
193,https://vlr.gg/player/10307/marteen,2025-01-23 12:00:00,0.83,1.09,0.96,211,202,229,53,25,28,56,29,27,8,6,2,-1,-4,+3,60%,61%,59%,136,136,136,25%,23%,27%,14,5,9,15,9,6
194,https://vlr.gg/player/16459/elite,2025-01-23 12:00:00,1.20,0.68,0.95,140,168,115,37,24,13,40,19,21,16,8,8,-3,-1,-2,77%,75%,79%,97,103,90,34%,44%,26%,4,2,2,7,3,4
195,https://vlr.gg/player/1885/purp0,2025-01-23 12:00:00,1.19,0.97,1.08,217,250,192,56,32,24,48,23,25,10,3,7,+7,+3,+4,77%,82%,72%,145,148,142,35%,34%,35%,14,8,6,7,5,2
196,https://vlr.gg/player/19691/tomaszy,2025-01-23 12:00:00,1.18,0.97,1.07,204,219,196,51,27,24,47,21,26,32,15,17,+1,+1,0,73%,79%,67%,129,138,120,27%,30%,25%,7,3,4,6,2,4
197,https://vlr.gg/player/4181/cloud,2025-01-23 12:00:00,0.98,1.15,1.07,195,170,210,48,20,28,41,19,22,20,11,9,0,-1,+1,69%,71%,67%,126,114,137,25%,35%,19%,7,3,4,7,4,3
198,https://vlr.gg/player/21610/runner,2025-01-23 12:00:00,0.85,1.13,0.99,190,166,207,47,20,27,44,22,22,22,7,15,+1,-2,+3,77%,71%,83%,121,123,120,21%,29%,15%,6,1,5,5,3,2
199,https://vlr.gg/player/34684/westside,2025-01-23 12:00:00,0.72,0.76,0.74,142,141,141,33,17,16,48,23,25,22,11,11,+1,-3,+4,69%,68%,69%,91,91,90,29%,33%,27%,6,1,5,5,4,1
200,https://vlr.gg/player/11578/hotsauz,2025-01-23 09:00:00,0.85,1.76,1.39,239,142,303,38,9,29,21,12,9,11,4,7,+1,0,+1,80%,71%,88%,162,106,202,43%,32%,48%,4,1,3,3,1,2
201,https://vlr.gg/player/9737/kakarot,2025-01-23 09:00:00,0.89,1.50,1.25,260,218,282,39,13,26,25,13,12,9,4,5,0,-3,+3,68%,53%,79%,159,146,167,18%,27%,14%,7,2,5,7,5,2
202,https://vlr.gg/player/16953/zynd,2025-01-23 09:00:00,0.68,1.47,1.14,248,177,275,35,9,26,28,15,13,8,4,4,0,0,0,73%,47%,92%,149,111,175,20%,31%,16%,4,2,2,4,2,2
203,https://vlr.gg/player/7746/kevzii,2025-01-23 09:00:00,0.57,1.44,1.08,209,118,275,30,7,23,27,14,13,11,2,9,+3,+1,+2,68%,47%,83%,137,66,188,37%,25%,40%,5,2,3,2,1,1
204,https://vlr.gg/player/9747/emman,2025-01-23 09:00:00,0.80,0.66,0.72,138,151,134,19,9,10,28,13,15,10,2,8,-1,-1,0,68%,59%,75%,99,105,94,40%,44%,37%,2,0,2,3,1,2
205,https://vlr.gg/player/24304/kiuuuu,2025-01-23 09:00:00,0.85,1.22,1.00,220,224,207,33,19,14,31,22,9,9,3,6,-1,-1,0,71%,63%,82%,159,155,165,44%,36%,55%,1,1,0,2,2,0
206,https://vlr.gg/player/47977/chak,2025-01-23 09:00:00,0.62,1.39,0.94,176,141,250,27,12,15,34,23,11,3,2,1,0,-1,+1,54%,42%,71%,135,105,179,38%,33%,43%,3,1,2,3,2,1
207,https://vlr.gg/player/37421/riyabtw,2025-01-23 09:00:00,0.58,1.30,0.88,198,172,226,26,12,14,31,23,8,7,5,2,+3,0,+3,71%,71%,71%,134,123,151,27%,28%,25%,7,3,4,4,3,1
208,https://vlr.gg/player/7851/uta,2025-01-23 09:00:00,0.51,1.24,0.81,185,155,235,24,10,14,33,24,9,12,10,2,-1,-1,0,71%,63%,82%,126,103,158,14%,8%,32%,7,4,3,8,5,3
209,https://vlr.gg/player/24302/chimei,2025-01-23 09:00:00,0.51,0.89,0.66,130,116,158,19,9,10,32,22,10,6,3,3,-4,-3,-1,56%,46%,71%,94,87,102,23%,18%,31%,1,0,1,5,3,2
210,https://vlr.gg/player/4705/flex1n,2025-01-23 07:15:00,,,,190,,,23,,,29,,,18,,,,,,,,,,,,,,,,,,,,
211,https://vlr.gg/player/3741/vo0kashu,2025-01-23 07:15:00,,,,181,,,22,,,29,,,7,,,,,,,,,,,,,,,,,,,,
212,https://vlr.gg/player/31753/spiritz1,2025-01-23 07:15:00,,,,153,,,18,,,33,,,7,,,,,,,,,,,,,,,,,,,,
213,https://vlr.gg/player/7841/tvirusluke,2025-01-23 07:15:00,,,,147,,,21,,,33,,,2,,,,,,,,,,,,,,,,,,,,
214,https://vlr.gg/player/11524/nicc,2025-01-23 07:15:00,,,,108,,,10,,,31,,,18,,,,,,,,,,,,,,,,,,,,
215,https://vlr.gg/player/3520/zmjjkk,2025-01-23 07:15:00,,,,291,,,34,,,27,,,14,,,,,,,,,,,,,,,,,,,,
216,https://vlr.gg/player/4742/smoggy,2025-01-23 07:15:00,,,,284,,,38,,,14,,,19,,,,,,,,,,,,,,,,,,,,
217,https://vlr.gg/player/3017/nobody,2025-01-23 07:15:00,,,,251,,,36,,,16,,,8,,,,,,,,,,,,,,,,,,,,
218,https://vlr.gg/player/15559/chichoo,2025-01-23 07:15:00,,,,220,,,27,,,17,,,8,,,,,,,,,,,,,,,,,,,,
219,https://vlr.gg/player/13768/s1mon,2025-01-23 07:15:00,,,,157,,,20,,,20,,,28,,,,,,,,,,,,,,,,,,,,
220,https://vlr.gg/player/45876/fixy,2025-01-23 06:00:00,1.21,1.05,1.14,264,291,238,59,36,23,56,30,26,15,8,7,+6,+6,0,71%,73%,69%,172,185,157,27%,24%,31%,14,10,4,8,4,4
221,https://vlr.gg/player/7443/riza,2025-01-23 06:00:00,1.10,1.04,1.07,207,210,223,49,28,21,48,25,23,20,10,10,-4,-1,-3,67%,65%,69%,144,142,147,34%,37%,31%,5,4,1,9,5,4
222,https://vlr.gg/player/14209/suka,2025-01-23 06:00:00,1.13,0.57,0.88,185,216,130,44,31,13,52,27,25,21,13,8,-2,0,-2,68%,76%,59%,116,135,93,28%,24%,36%,4,3,1,6,3,3
223,https://vlr.gg/player/7513/markl,2025-01-23 06:00:00,0.98,0.68,0.85,162,182,164,42,25,17,52,26,26,13,10,3,-5,-1,-4,53%,57%,48%,107,113,99,29%,24%,35%,5,2,3,10,3,7
224,https://vlr.gg/player/5886/flaring,2025-01-23 06:00:00,0.84,0.59,0.73,151,156,160,33,18,15,53,27,26,32,24,8,+1,+1,0,74%,78%,69%,106,109,102,26%,25%,27%,3,2,1,2,1,1
225,https://vlr.gg/player/44770/cxix666,2025-01-23 06:00:00,1.39,1.13,1.24,276,295,265,66,32,34,47,18,29,13,3,10,-1,+3,-4,73%,76%,70%,181,191,173,44%,37%,50%,9,6,3,10,3,7
226,https://vlr.gg/player/40910/consz,2025-01-23 06:00:00,1.15,1.27,1.22,269,240,277,60,25,35,48,20,28,20,9,11,+5,+3,+2,76%,69%,81%,163,151,172,25%,26%,25%,10,6,4,5,3,2
227,https://vlr.gg/player/44930/nex1sphix,2025-01-23 06:00:00,1.38,0.99,1.16,195,228,185,49,24,25,42,16,26,31,19,12,-3,-1,-2,83%,90%,78%,129,146,116,30%,26%,36%,2,0,2,5,1,4
228,https://vlr.gg/player/40907/mnfear,2025-01-23 06:00:00,1.37,0.85,1.08,221,217,192,50,25,25,43,15,28,21,11,10,0,+1,-1,83%,83%,84%,143,161,128,37%,40%,35%,6,3,3,6,2,4
229,https://vlr.gg/player/40908/skyisblue,2025-01-23 06:00:00,0.90,0.64,0.76,147,197,125,36,21,15,48,20,28,28,13,15,+3,+3,0,73%,86%,62%,101,128,81,21%,18%,25%,8,4,4,5,1,4
230,https://vlr.gg/player/4774/knight,2025-01-23 04:00:00,,,,221,,,53,,,43,,,17,,,,,,,,,,,,,,,,,,,,
231,https://vlr.gg/player/10698/nephh,2025-01-23 04:00:00,,,,217,,,47,,,50,,,22,,,,,,,,,,,,,,,,,,,,
232,https://vlr.gg/player/4885/whzy,2025-01-23 04:00:00,,,,208,,,47,,,47,,,11,,,,,,,,,,,,,,,,,,,,
233,https://vlr.gg/player/40845/levius,2025-01-23 04:00:00,,,,186,,,43,,,49,,,12,,,,,,,,,,,,,,,,,,,,
234,https://vlr.gg/player/48878/rushia,2025-01-23 04:00:00,,,,156,,,36,,,50,,,22,,,,,,,,,,,,,,,,,,,,
235,https://vlr.gg/player/4770/fengf,2025-01-23 04:00:00,,,,290,,,67,,,45,,,11,,,,,,,,,,,,,,,,,,,,
236,https://vlr.gg/player/37494/kai,2025-01-23 04:00:00,,,,230,,,49,,,44,,,17,,,,,,,,,,,,,,,,,,,,
237,https://vlr.gg/player/3021/biank,2025-01-23 04:00:00,,,,204,,,43,,,48,,,24,,,,,,,,,,,,,,,,,,,,
238,https://vlr.gg/player/3045/luok1ng,2025-01-23 04:00:00,,,,190,,,40,,,46,,,43,,,,,,,,,,,,,,,,,,,,
239,https://vlr.gg/player/4712/heybay,2025-01-23 04:00:00,,,,170,,,40,,,43,,,23,,,,,,,,,,,,,,,,,,,,
240,https://vlr.gg/player/12143/bizerra,2025-01-22 18:45:00,0.74,1.30,1.03,206,157,254,28,10,18,30,15,15,8,2,6,+1,0,+1,69%,47%,90%,136,114,157,35%,38%,33%,2,1,1,1,1,0
241,https://vlr.gg/player/4807/bstrdd,2025-01-22 18:45:00,0.97,0.63,0.80,204,218,193,26,15,11,34,15,19,5,1,4,0,0,0,64%,58%,70%,135,134,136,24%,26%,21%,9,5,4,9,5,4
242,https://vlr.gg/player/14386/isaa,2025-01-22 18:45:00,0.76,0.69,0.73,138,155,120,20,10,10,28,14,14,3,3,0,0,+2,-2,56%,68%,45%,97,117,78,32%,26%,41%,3,2,1,3,0,3
243,https://vlr.gg/player/15297/joojina,2025-01-22 18:45:00,0.90,0.57,0.73,171,190,151,22,12,10,35,16,19,14,5,9,+2,+1,+1,64%,68%,60%,97,99,96,20%,10%,38%,5,2,3,3,1,2
244,https://vlr.gg/player/11232/daiki,2025-01-22 18:45:00,0.30,0.86,0.59,145,85,205,17,3,14,34,17,17,19,12,7,0,-2,+2,74%,68%,80%,97,57,135,47%,24%,62%,2,0,2,2,2,0
245,https://vlr.gg/player/47551/sanoj,2025-01-22 18:45:00,1.87,1.38,1.63,332,385,276,48,28,20,23,13,10,7,4,3,+3,+2,+1,87%,100%,74%,202,233,168,31%,31%,31%,9,4,5,6,2,4
246,https://vlr.gg/player/45864/bruxo,2025-01-22 18:45:00,1.32,1.43,1.37,235,270,200,35,20,15,20,12,8,7,3,4,+1,0,+1,77%,80%,74%,161,170,151,30%,34%,25%,6,3,3,5,3,2
247,https://vlr.gg/player/41225/kramarick,2025-01-22 18:45:00,0.73,1.48,1.10,213,140,291,27,8,19,27,15,12,28,19,9,0,-1,+1,77%,80%,74%,152,101,205,33%,35%,33%,1,0,1,1,1,0
248,https://vlr.gg/player/50786/renna,2025-01-22 18:45:00,0.89,1.25,1.06,182,160,205,26,12,14,20,12,8,10,6,4,-1,-1,0,87%,85%,89%,111,94,129,22%,24%,20%,2,2,0,3,3,0
249,https://vlr.gg/player/41466/mixyce,2025-01-22 18:45:00,1.26,0.75,1.01,166,192,138,25,16,9,23,11,12,19,9,10,-6,-2,-4,72%,70%,74%,101,118,83,16%,31%,7%,0,0,0,6,2,4
250,https://vlr.gg/player/38881/wetysao,2025-01-22 17:45:00,1.57,1.11,1.36,285,313,230,114,72,42,77,43,34,13,8,5,+6,+6,0,82%,82%,82%,177,207,140,33%,36%,27%,18,11,7,12,5,7
251,https://vlr.gg/player/38912/yuno,2025-01-22 17:45:00,0.97,1.27,1.11,202,188,230,80,39,41,73,41,32,39,24,15,+2,0,+2,74%,78%,69%,135,117,157,31%,24%,40%,9,5,4,7,5,2
252,https://vlr.gg/player/35559/pandejalea,2025-01-22 17:45:00,1.18,0.83,1.03,221,231,201,78,46,32,80,42,38,44,22,22,+6,+6,0,76%,82%,69%,140,153,123,20%,26%,14%,22,13,9,16,7,9
253,https://vlr.gg/player/8781/charlslol,2025-01-22 17:45:00,0.85,1.05,0.94,179,152,216,67,32,35,81,45,36,59,33,26,-2,-1,-1,79%,80%,78%,122,107,141,30%,28%,31%,5,2,3,7,3,4
254,https://vlr.gg/player/17676/dexuz,2025-01-22 17:45:00,0.94,0.75,0.85,168,175,159,66,40,26,80,41,39,36,18,18,-3,-3,0,73%,75%,71%,117,122,112,27%,29%,24%,5,3,2,8,6,2
255,https://vlr.gg/player/35635/shxdow,2025-01-22 17:45:00,1.37,1.15,1.24,245,253,253,96,44,52,76,32,44,31,10,21,0,-1,+1,83%,82%,85%,161,157,163,30%,30%,30%,8,4,4,8,5,3
256,https://vlr.gg/player/48551/e13,2025-01-22 17:45:00,1.07,1.10,1.09,216,188,236,79,33,46,81,34,47,56,31,25,-1,-2,+1,73%,78%,70%,147,134,157,24%,25%,23%,7,1,6,8,3,5
257,https://vlr.gg/player/7628/dieg0,2025-01-22 17:45:00,0.92,1.11,1.02,202,163,242,78,29,49,75,32,43,27,14,13,-5,-2,-3,67%,65%,68%,141,115,162,31%,33%,29%,8,2,6,13,4,9
258,https://vlr.gg/player/38914/diivz,2025-01-22 17:45:00,1.26,0.81,1.01,209,244,177,77,42,35,82,35,47,48,20,28,+4,+5,-1,76%,73%,78%,142,162,126,29%,33%,25%,9,5,4,5,0,5
259,https://vlr.gg/player/48553/yarwiz,2025-01-22 17:45:00,0.61,0.62,0.62,160,187,148,61,31,30,91,43,48,17,6,11,-7,-1,-6,65%,63%,67%,115,124,108,30%,37%,25%,18,12,6,25,13,12
260,https://vlr.gg/player/3079/alexis,2025-01-22 17:00:00,1.42,1.64,1.51,236,248,206,37,21,16,20,14,6,25,16,9,-2,-1,-1,79%,75%,84%,155,182,121,31%,30%,34%,1,1,0,3,2,1
261,https://vlr.gg/player/17397/noia,2025-01-22 17:00:00,1.52,1.11,1.34,214,232,208,37,23,14,21,11,10,10,6,4,+3,+2,+1,84%,88%,79%,144,156,130,19%,30%,12%,6,3,3,3,1,2
262,https://vlr.gg/player/3063/mel,2025-01-22 17:00:00,0.92,1.33,1.10,190,187,216,31,16,15,26,17,9,26,14,12,-2,-1,-1,81%,75%,89%,123,117,129,38%,41%,34%,2,1,1,4,2,2
263,https://vlr.gg/player/9185/dodonut,2025-01-22 17:00:00,0.93,1.13,1.02,229,238,206,33,20,13,33,20,13,7,4,3,+5,+5,0,70%,75%,63%,145,146,144,22%,30%,14%,10,7,3,5,2,3
264,https://vlr.gg/player/21486/sarahcat,2025-01-22 17:00:00,1.12,0.81,0.98,216,237,183,31,20,11,30,15,15,16,10,6,+3,-1,+4,77%,83%,68%,135,151,114,16%,20%,11%,6,2,4,3,3,0
265,https://vlr.gg/player/5035/blahst,2025-01-22 17:00:00,0.84,1.56,1.24,238,192,286,39,13,26,31,14,17,8,2,6,+3,0,+3,74%,63%,83%,161,126,189,24%,22%,25%,8,3,5,5,3,2
266,https://vlr.gg/player/20441/pyro,2025-01-22 17:00:00,0.68,1.06,0.90,197,160,221,27,10,17,33,14,19,12,4,8,-3,-2,-1,72%,68%,75%,133,106,154,24%,30%,20%,1,0,1,4,2,2
267,https://vlr.gg/player/20922/zekei,2025-01-22 17:00:00,0.66,0.90,0.79,185,184,192,28,11,17,36,16,20,7,2,5,-4,0,-4,63%,68%,58%,121,121,121,25%,33%,20%,5,3,2,9,3,6
268,https://vlr.gg/player/28870/k0rupt,2025-01-22 17:00:00,0.82,0.50,0.64,152,172,137,20,11,9,35,13,22,17,5,12,+1,+2,-1,65%,68%,63%,97,107,89,22%,27%,18%,2,2,0,1,0,1
269,https://vlr.gg/player/17751/tim,2025-01-22 17:00:00,0.80,0.43,0.60,131,145,117,16,8,8,34,12,22,16,6,10,-4,-3,-1,65%,63%,67%,84,87,82,14%,17%,11%,2,0,2,6,3,3
270,https://vlr.gg/player/18350/miniboo,2025-01-22 14:10:00,0.74,1.49,1.14,223,185,254,42,15,27,32,20,12,7,2,5,+6,-4,+10,65%,48%,79%,138,114,159,39%,38%,40%,12,1,11,6,5,1
271,https://vlr.gg/player/10971/riens,2025-01-22 14:10:00,1.15,1.11,1.13,199,227,174,39,21,18,33,18,15,13,1,12,-1,-1,0,76%,64%,86%,144,152,137,46%,48%,43%,4,2,2,5,3,2
272,https://vlr.gg/player/21328/wo0t,2025-01-22 14:10:00,0.83,1.34,1.10,183,144,220,35,11,24,33,18,15,26,12,14,+1,-1,+2,72%,64%,79%,117,93,138,32%,35%,30%,6,2,4,5,3,2
273,https://vlr.gg/player/29873/benjyfishy,2025-01-22 14:10:00,0.44,1.53,1.02,173,93,255,37,8,29,30,19,11,4,0,4,-6,-2,-4,69%,48%,86%,124,61,178,37%,44%,35%,2,2,0,8,4,4
274,https://vlr.gg/player/1144/boo,2025-01-22 14:10:00,0.57,1.01,0.81,165,131,192,29,10,19,37,20,17,33,12,21,0,-1,+1,78%,72%,83%,100,79,119,39%,44%,36%,3,1,2,3,2,1
275,https://vlr.gg/player/11/zyppan,2025-01-22 14:10:00,0.85,1.23,1.03,208,177,258,38,16,22,40,23,17,18,7,11,0,-4,+4,67%,55%,80%,136,118,157,32%,36%,28%,5,0,5,5,4,1
276,https://vlr.gg/player/20871/k4davra,2025-01-22 14:10:00,0.84,1.09,0.96,153,134,167,28,12,16,33,21,12,23,10,13,-1,0,-1,63%,55%,72%,98,95,101,33%,28%,39%,2,1,1,3,1,2
277,https://vlr.gg/player/23169/minny,2025-01-22 14:10:00,0.72,1.18,0.93,192,168,204,33,16,17,37,26,11,9,5,4,0,-1,+1,65%,52%,80%,121,115,128,39%,37%,42%,6,2,4,6,3,3
278,https://vlr.gg/player/5893/robbiebk,2025-01-22 14:10:00,0.56,1.33,0.92,144,94,207,27,9,18,33,22,11,13,6,7,0,-3,+3,61%,48%,76%,101,64,144,30%,31%,29%,3,0,3,3,3,0
279,https://vlr.gg/player/7866/click,2025-01-22 14:10:00,0.61,1.17,0.86,178,160,209,39,17,22,39,25,14,2,1,1,+1,-1,+2,61%,48%,76%,113,90,140,41%,44%,38%,11,7,4,10,8,2
280,https://vlr.gg/player/2818/neto,2025-01-22 14:00:00,1.40,1.79,1.63,324,308,337,75,28,47,34,17,17,6,3,3,+14,+3,+11,85%,80%,88%,214,212,216,36%,41%,33%,20,8,12,6,5,1
281,https://vlr.gg/player/15916/jotinha,2025-01-22 14:00:00,1.42,1.39,1.40,218,211,222,46,19,27,27,11,16,23,8,15,-2,-3,+1,85%,80%,88%,151,139,160,32%,30%,33%,2,0,2,4,3,1
282,https://vlr.gg/player/1291/bnj,2025-01-22 14:00:00,1.46,1.21,1.31,185,231,154,45,23,22,28,11,17,32,6,26,+4,+1,+3,83%,76%,88%,111,139,90,35%,43%,28%,6,1,5,2,0,2
283,https://vlr.gg/player/2403/mizu,2025-01-22 14:00:00,0.86,1.07,0.98,173,159,181,40,14,26,36,17,19,5,3,2,+1,+1,0,78%,72%,82%,115,103,124,47%,52%,44%,3,2,1,2,1,1
284,https://vlr.gg/player/2586/hanling,2025-01-22 14:00:00,0.63,0.82,0.74,130,134,128,25,10,15,39,17,22,33,12,21,+1,-1,+2,80%,68%,88%,85,91,80,26%,25%,27%,5,2,3,4,3,1
285,https://vlr.gg/player/2848/sh0twell,2025-01-22 14:00:00,1.23,0.68,1.00,194,217,154,42,25,17,41,20,21,12,4,8,0,0,0,68%,71%,64%,129,142,110,31%,27%,37%,2,2,0,2,2,0
286,https://vlr.gg/player/2469/gessito,2025-01-22 14:00:00,0.56,1.09,0.85,177,98,243,13,2,11,17,8,9,13,8,5,+3,-1,+4,64%,50%,75%,98,58,131,26%,7%,37%,4,0,4,1,1,0
287,https://vlr.gg/player/7588/ligasa,2025-01-22 14:00:00,0.62,1.10,0.83,149,123,200,37,14,23,46,24,22,3,1,2,-10,-8,-2,54%,53%,56%,108,85,139,37%,32%,44%,3,0,3,13,8,5
288,https://vlr.gg/player/35662/zebeej1,2025-01-22 14:00:00,0.94,0.47,0.74,131,158,98,29,19,10,47,24,23,19,10,9,0,0,0,64%,71%,56%,88,101,71,29%,26%,35%,1,0,1,1,0,1
289,https://vlr.gg/player/50774/darkzin,2025-01-22 14:00:00,0.39,0.81,0.57,127,79,197,29,8,21,49,26,23,14,7,7,-5,-4,-1,59%,53%,68%,87,60,124,24%,21%,26%,5,3,2,10,7,3
290,https://vlr.gg/player/8723/matis,2025-01-22 14:00:00,0.40,0.56,0.45,100,79,134,15,6,9,31,17,14,3,2,1,-6,-4,-2,49%,50%,46%,62,52,81,23%,15%,42%,3,1,2,9,5,4
291,https://vlr.gg/player/1139/qraxs,2025-01-22 12:00:00,1.18,1.32,1.25,260,261,260,37,18,19,28,15,13,15,9,6,+7,+4,+3,85%,80%,89%,171,161,182,36%,29%,45%,7,4,3,0,0,0
292,https://vlr.gg/player/8369/yetujey,2025-01-22 12:00:00,1.35,1.00,1.18,214,247,181,30,19,11,25,13,12,14,4,10,0,+1,-1,79%,80%,79%,154,178,129,25%,36%,15%,3,2,1,3,1,2
293,https://vlr.gg/player/6510/atakaptan,2025-01-22 12:00:00,1.25,1.00,1.13,212,218,205,29,16,13,26,12,14,18,6,12,0,0,0,85%,85%,84%,135,147,122,23%,25%,21%,3,1,2,3,1,2
294,https://vlr.gg/player/12793/xeus,2025-01-22 12:00:00,0.64,1.45,1.03,212,157,270,32,11,21,28,15,13,7,7,0,+1,-2,+3,79%,65%,95%,138,110,166,39%,37%,41%,8,4,4,7,6,1
295,https://vlr.gg/player/8044/mrfalin,2025-01-22 12:00:00,0.58,1.35,0.96,189,174,206,28,11,17,25,16,9,9,6,3,-1,+1,-2,72%,60%,84%,123,111,136,23%,21%,24%,2,1,1,3,0,3
296,https://vlr.gg/player/1475/kamyk,2025-01-22 12:00:00,1.25,1.13,1.19,254,265,242,34,17,17,31,16,15,13,9,4,0,+1,-1,82%,84%,80%,169,186,154,25%,33%,19%,4,2,2,4,1,3
297,https://vlr.gg/player/457/nats,2025-01-22 12:00:00,0.68,1.35,1.02,226,182,269,31,11,20,30,16,14,11,5,6,0,+1,-1,82%,84%,80%,156,126,183,29%,31%,27%,1,1,0,1,0,1
298,https://vlr.gg/player/11494/keiko,2025-01-22 12:00:00,0.91,0.83,0.86,172,167,179,23,11,12,31,14,17,11,3,8,-2,0,-2,72%,74%,70%,125,125,125,44%,43%,46%,3,0,3,5,0,5
299,https://vlr.gg/player/14681/kamo,2025-01-22 12:00:00,0.55,1.04,0.80,204,202,204,28,14,14,33,19,14,8,3,5,-3,-3,0,67%,58%,75%,126,113,138,32%,33%,30%,5,4,1,8,7,1
300,https://vlr.gg/player/309/patitek,2025-01-22 12:00:00,0.54,0.80,0.67,139,129,148,16,8,8,31,16,15,20,9,11,-2,-2,0,67%,58%,75%,98,92,104,23%,22%,24%,3,1,2,5,3,2
301,https://vlr.gg/player/36685/splash,2025-01-22 08:15:00,0.86,1.42,1.10,266,239,296,59,29,30,50,30,20,6,3,3,-5,-4,-1,66%,53%,82%,160,151,172,27%,32%,22%,8,5,3,13,9,4
302,https://vlr.gg/player/7049/natz,2025-01-22 08:15:00,1.24,0.88,1.08,234,247,221,53,31,22,47,25,22,17,8,9,+2,+2,0,75%,69%,82%,157,167,144,30%,36%,22%,8,5,3,6,3,3
303,https://vlr.gg/player/37057/woody,2025-01-22 08:15:00,1.21,0.85,1.05,161,195,119,35,25,10,37,21,16,38,21,17,0,0,0,80%,83%,75%,108,129,80,38%,41%,32%,3,2,1,3,2,1
304,https://vlr.gg/player/26826/6ixkey,2025-01-22 08:15:00,0.87,1.00,0.93,174,165,186,43,22,21,43,25,18,5,2,3,0,+4,-4,61%,58%,64%,119,111,131,25%,23%,26%,6,5,1,6,1,5
305,https://vlr.gg/player/7783/zhar,2025-01-22 08:15:00,0.65,1.00,0.81,153,123,191,32,13,19,46,27,19,27,17,10,+5,+4,+1,72%,75%,68%,94,74,119,22%,25%,20%,8,4,4,3,0,3
306,https://vlr.gg/player/24653/vera,2025-01-22 08:15:00,1.13,1.16,1.15,251,286,222,53,28,25,47,23,24,16,6,10,+9,+6,+3,77%,79%,75%,175,189,165,24%,21%,25%,17,11,6,8,5,3
307,https://vlr.gg/player/24628/wayne,2025-01-22 08:15:00,1.06,1.21,1.14,221,179,257,52,20,32,41,17,24,33,15,18,-4,0,-4,84%,86%,83%,142,111,166,29%,34%,27%,3,1,2,7,1,6
308,https://vlr.gg/player/1430/crazyguy,2025-01-22 08:15:00,0.88,1.12,1.02,217,177,248,48,15,33,45,19,26,13,10,3,-1,+2,-3,67%,57%,75%,139,122,152,32%,24%,37%,5,2,3,6,0,6
309,https://vlr.gg/player/13220/ja,2025-01-22 08:15:00,0.91,1.04,0.98,198,224,179,42,21,21,44,23,21,13,5,8,-5,-4,-1,72%,64%,78%,136,151,125,32%,34%,29%,3,1,2,8,5,3
310,https://vlr.gg/player/11704/styron,2025-01-22 08:15:00,0.78,0.83,0.81,141,129,150,28,12,16,46,20,26,24,10,14,-1,0,-1,67%,64%,69%,95,85,103,9%,11%,7%,3,1,2,4,1,3
311,https://vlr.gg/player/3520/zmjjkk,2025-01-22 07:05:00,,,,303,,,65,,,45,,,16,,,,,,,,,,,,,,,,,,,,
312,https://vlr.gg/player/3017/nobody,2025-01-22 07:05:00,,,,219,,,44,,,38,,,19,,,,,,,,,,,,,,,,,,,,
313,https://vlr.gg/player/15559/chichoo,2025-01-22 07:05:00,,,,214,,,48,,,36,,,9,,,,,,,,,,,,,,,,,,,,
314,https://vlr.gg/player/4742/smoggy,2025-01-22 07:05:00,,,,187,,,44,,,39,,,20,,,,,,,,,,,,,,,,,,,,
315,https://vlr.gg/player/13768/s1mon,2025-01-22 07:05:00,,,,132,,,27,,,37,,,35,,,,,,,,,,,,,,,,,,,,
316,https://vlr.gg/player/37927/happywei,2025-01-22 07:05:00,,,,237,,,55,,,43,,,21,,,,,,,,,,,,,,,,,,,,
317,https://vlr.gg/player/22047/rarga,2025-01-22 07:05:00,,,,234,,,54,,,50,,,9,,,,,,,,,,,,,,,,,,,,
318,https://vlr.gg/player/12365/coconut,2025-01-22 07:05:00,,,,172,,,32,,,46,,,17,,,,,,,,,,,,,,,,,,,,
319,https://vlr.gg/player/4710/you,2025-01-22 07:05:00,,,,118,,,27,,,41,,,24,,,,,,,,,,,,,,,,,,,,
320,https://vlr.gg/player/36415/viva,2025-01-22 07:05:00,,,,111,,,26,,,48,,,18,,,,,,,,,,,,,,,,,,,,
321,https://vlr.gg/player/23930/potter,2025-01-22 06:00:00,0.92,1.53,1.21,256,216,302,40,18,22,30,18,12,8,4,4,+1,0,+1,80%,83%,76%,172,150,196,28%,30%,27%,9,6,3,8,6,2
322,https://vlr.gg/player/8582/laz,2025-01-22 06:00:00,1.07,1.15,1.11,202,203,201,34,16,18,27,15,12,13,9,4,+2,+2,0,80%,78%,81%,135,127,145,26%,28%,23%,3,2,1,1,0,1
323,https://vlr.gg/player/27254/leviathan,2025-01-22 06:00:00,1.32,0.83,1.09,221,253,184,35,22,13,31,15,16,12,6,6,+5,+2,+3,73%,83%,62%,144,164,121,42%,40%,45%,8,3,5,3,1,2
324,https://vlr.gg/player/27244/seph1roth,2025-01-22 06:00:00,1.27,0.83,1.06,169,213,124,27,19,8,24,12,12,20,10,10,-2,+1,-3,80%,78%,81%,118,144,89,28%,34%,21%,2,2,0,4,1,3
325,https://vlr.gg/player/13784/killua,2025-01-22 06:00:00,0.80,1.22,1.00,191,166,218,29,14,15,29,16,13,11,2,9,0,-2,+2,68%,65%,71%,133,118,150,33%,45%,24%,3,0,3,3,2,1
326,https://vlr.gg/player/3401/ptc,2025-01-22 06:00:00,1.11,1.09,1.10,234,195,268,37,16,21,33,14,19,11,5,6,0,-2,+2,75%,71%,78%,151,133,168,35%,48%,29%,5,2,3,5,4,1
327,https://vlr.gg/player/6913/sultan,2025-01-22 06:00:00,0.95,1.20,1.08,180,135,223,28,10,18,30,14,16,16,10,6,+1,-1,+2,82%,76%,87%,119,103,133,36%,32%,39%,2,0,2,1,1,0
328,https://vlr.gg/player/7754/xavi8k,2025-01-22 06:00:00,0.89,1.00,0.95,170,165,176,24,11,13,31,15,16,17,8,9,-3,-1,-2,68%,76%,61%,121,110,131,33%,31%,35%,2,0,2,5,1,4
329,https://vlr.gg/player/16842/mojer,2025-01-22 06:00:00,1.26,0.48,0.85,206,279,142,30,19,11,35,15,20,12,8,4,-6,0,-6,68%,81%,57%,139,184,97,19%,19%,18%,6,5,1,12,5,7
330,https://vlr.gg/player/13744/patmen,2025-01-22 06:00:00,0.47,0.76,0.62,136,123,147,22,9,13,36,18,18,7,2,5,+2,+1,+1,59%,48%,70%,88,83,93,30%,23%,37%,4,2,2,2,1,1
331,https://vlr.gg/player/3028/life,2025-01-22 04:00:00,,,,321,,,63,,,42,,,14,,,,,,,,,,,,,,,,,,,,
332,https://vlr.gg/player/872/autumn,2025-01-22 04:00:00,,,,210,,,41,,,40,,,19,,,,,,,,,,,,,,,,,,,,
333,https://vlr.gg/player/6022/yosemite,2025-01-22 04:00:00,,,,184,,,38,,,42,,,12,,,,,,,,,,,,,,,,,,,,
334,https://vlr.gg/player/19530/aaaay,2025-01-22 04:00:00,,,,176,,,37,,,38,,,12,,,,,,,,,,,,,,,,,,,,
335,https://vlr.gg/player/7857/berlin,2025-01-22 04:00:00,,,,166,,,32,,,38,,,27,,,,,,,,,,,,,,,,,,,,
336,https://vlr.gg/player/3741/vo0kashu,2025-01-22 04:00:00,,,,241,,,50,,,40,,,24,,,,,,,,,,,,,,,,,,,,
337,https://vlr.gg/player/11524/nicc,2025-01-22 04:00:00,,,,213,,,43,,,38,,,31,,,,,,,,,,,,,,,,,,,,
338,https://vlr.gg/player/7841/tvirusluke,2025-01-22 04:00:00,,,,211,,,46,,,47,,,8,,,,,,,,,,,,,,,,,,,,
339,https://vlr.gg/player/4705/flex1n,2025-01-22 04:00:00,,,,161,,,32,,,40,,,20,,,,,,,,,,,,,,,,,,,,
340,https://vlr.gg/player/31753/spiritz1,2025-01-22 04:00:00,,,,135,,,29,,,46,,,10,,,,,,,,,,,,,,,,,,,,
341,https://vlr.gg/player/44149/pr0digy,2025-01-21 08:35:00,1.07,0.69,0.89,185,228,142,26,17,9,30,17,13,10,8,2,+3,+4,-1,68%,70%,67%,129,158,96,39%,37%,42%,6,5,1,3,1,2
342,https://vlr.gg/player/49001/secre,2025-01-21 08:35:00,0.79,0.87,0.82,195,197,195,25,14,11,33,18,15,6,3,3,-1,-2,+1,74%,70%,78%,127,120,135,22%,21%,22%,4,0,4,5,2,3
343,https://vlr.gg/player/14207/viness,2025-01-21 08:35:00,1.15,0.16,0.82,160,241,,11,11,0,14,10,4,2,2,0,-5,-4,-1,56%,67%,33%,85,127,,47%,47%,,0,0,0,5,4,1
344,https://vlr.gg/player/12322/ndg,2025-01-21 08:35:00,0.83,0.72,0.78,170,180,153,19,10,9,30,16,14,19,13,6,-1,0,-1,71%,80%,61%,114,127,99,36%,31%,43%,3,2,1,4,2,2
345,https://vlr.gg/player/44919/aplycs,2025-01-21 08:35:00,0.99,0.40,0.71,157,182,130,18,13,5,30,15,15,12,7,5,+2,+1,+1,58%,75%,39%,108,114,101,18%,18%,19%,2,1,1,0,0,0
346,https://vlr.gg/player/25499/rbtx,2025-01-21 08:35:00,0.44,0.56,0.51,126,114,135,7,3,4,17,7,10,5,4,1,-1,-1,0,50%,63%,42%,86,74,94,23%,25%,22%,2,1,1,3,2,1
347,https://vlr.gg/player/2346/cud,2025-01-21 08:35:00,1.38,1.14,1.25,236,223,245,34,16,18,19,8,11,6,2,4,-1,+1,-2,89%,89%,90%,155,153,158,40%,37%,43%,2,2,0,3,1,2
348,https://vlr.gg/player/16852/nakya,2025-01-21 08:35:00,1.34,1.17,1.25,283,284,278,37,17,20,26,10,16,10,6,4,+9,+4,+5,79%,78%,80%,194,197,191,31%,36%,26%,12,6,6,3,2,1
349,https://vlr.gg/player/1745/adrnking,2025-01-21 08:35:00,1.25,1.17,1.21,185,156,209,25,11,14,17,6,11,18,7,11,-2,-1,-1,84%,83%,85%,114,93,132,32%,31%,33%,1,1,0,3,2,1
350,https://vlr.gg/player/9263/sayoo,2025-01-21 08:35:00,1.21,1.03,1.12,214,172,253,29,11,18,22,6,16,11,6,5,+2,0,+2,79%,83%,75%,131,114,147,35%,40%,32%,4,0,4,2,0,2
351,https://vlr.gg/player/23710/gotten,2025-01-21 08:35:00,1.46,0.81,1.12,211,249,182,29,16,13,22,8,14,17,12,5,-5,-3,-2,79%,89%,70%,134,161,110,24%,28%,21%,1,0,1,6,3,3
352,https://vlr.gg/player/42901/thyy,2025-01-21 06:35:00,1.41,1.37,1.39,246,231,261,40,21,19,23,12,11,15,6,9,-2,-2,0,77%,78%,75%,177,171,183,46%,45%,46%,1,0,1,3,2,1
353,https://vlr.gg/player/23062/surf,2025-01-21 06:35:00,1.37,1.39,1.38,241,222,267,37,18,19,22,10,12,13,6,7,+2,+3,-1,77%,74%,80%,173,166,182,35%,33%,38%,7,6,1,5,3,2
354,https://vlr.gg/player/41702/canady,2025-01-21 06:35:00,1.18,1.35,1.26,248,253,246,40,21,19,28,16,12,14,11,3,-1,-2,+1,77%,74%,80%,168,166,170,48%,52%,43%,4,2,2,5,4,1
355,https://vlr.gg/player/46102/snappy,2025-01-21 06:35:00,1.11,0.97,1.04,252,266,239,38,21,17,33,18,15,12,8,4,0,+2,-2,65%,74%,55%,166,186,143,20%,22%,17%,7,3,4,7,1,6
356,https://vlr.gg/player/37547/tbloy,2025-01-21 06:35:00,1.05,0.59,0.84,150,177,114,22,16,6,27,13,14,13,5,8,0,0,0,79%,87%,70%,112,135,85,43%,60%,23%,2,1,1,2,1,1
357,https://vlr.gg/player/37421/riyabtw,2025-01-21 06:35:00,1.18,1.03,1.10,224,239,208,37,18,19,35,15,20,3,1,2,+3,+1,+2,74%,75%,74%,143,150,137,36%,56%,24%,7,3,4,4,2,2
358,https://vlr.gg/player/47977/chak,2025-01-21 06:35:00,0.64,0.99,0.83,190,148,219,25,9,16,35,16,19,14,4,10,+1,-1,+2,63%,65%,61%,128,110,143,28%,31%,26%,6,2,4,5,3,2
359,https://vlr.gg/player/7851/uta,2025-01-21 06:35:00,0.87,0.75,0.80,152,170,135,22,11,11,33,15,18,14,7,7,+2,+2,0,65%,65%,65%,96,107,87,30%,18%,48%,4,2,2,2,0,2
360,https://vlr.gg/player/1346/watasink,2025-01-21 06:35:00,1.03,0.51,0.75,166,213,127,25,16,9,37,16,21,10,3,7,-2,+1,-3,53%,60%,48%,112,131,95,24%,25%,24%,3,3,0,5,2,3
361,https://vlr.gg/player/24302/chimei,2025-01-21 06:35:00,0.52,0.73,0.63,157,138,185,23,9,14,38,18,20,9,5,4,-3,-1,-2,51%,70%,35%,103,93,112,14%,17%,12%,2,1,1,5,2,3
362,https://vlr.gg/player/41029/z1yan,2025-01-21 06:15:00,,,,244,,,52,,,38,,,13,,,,,,,,,,,,,,,,,,,,
363,https://vlr.gg/player/16924/stew,2025-01-21 06:15:00,,,,232,,,49,,,42,,,8,,,,,,,,,,,,,,,,,,,,
364,https://vlr.gg/player/15302/babyblue,2025-01-21 06:15:00,,,,194,,,38,,,45,,,11,,,,,,,,,,,,,,,,,,,,
365,https://vlr.gg/player/3519/jkuro,2025-01-21 06:15:00,,,,159,,,31,,,44,,,24,,,,,,,,,,,,,,,,,,,,
366,https://vlr.gg/player/37674/mrcani,2025-01-21 06:15:00,,,,127,,,27,,,46,,,14,,,,,,,,,,,,,,,,,,,,
367,https://vlr.gg/player/37927/happywei,2025-01-21 06:15:00,,,,241,,,47,,,35,,,27,,,,,,,,,,,,,,,,,,,,
368,https://vlr.gg/player/22047/rarga,2025-01-21 06:15:00,,,,227,,,45,,,47,,,9,,,,,,,,,,,,,,,,,,,,
369,https://vlr.gg/player/36415/viva,2025-01-21 06:15:00,,,,211,,,46,,,34,,,15,,,,,,,,,,,,,,,,,,,,
370,https://vlr.gg/player/4710/you,2025-01-21 06:15:00,,,,185,,,38,,,37,,,37,,,,,,,,,,,,,,,,,,,,
371,https://vlr.gg/player/12365/coconut,2025-01-21 06:15:00,,,,177,,,37,,,42,,,19,,,,,,,,,,,,,,,,,,,,
372,https://vlr.gg/player/46460/ezeir,2025-01-21 04:00:00,,,,229,,,32,,,30,,,17,,,,,,,,,,,,,,,,,,,,
373,https://vlr.gg/player/39697/cb,2025-01-21 04:00:00,,,,190,,,26,,,30,,,10,,,,,,,,,,,,,,,,,,,,
374,https://vlr.gg/player/1209/swerl,2025-01-21 04:00:00,,,,178,,,24,,,34,,,6,,,,,,,,,,,,,,,,,,,,
375,https://vlr.gg/player/41054/guang,2025-01-21 04:00:00,,,,168,,,24,,,31,,,7,,,,,,,,,,,,,,,,,,,,
376,https://vlr.gg/player/4402/o0o0o,2025-01-21 04:00:00,,,,138,,,20,,,33,,,6,,,,,,,,,,,,,,,,,,,,
377,https://vlr.gg/player/4705/flex1n,2025-01-21 04:00:00,,,,232,,,35,,,21,,,21,,,,,,,,,,,,,,,,,,,,
378,https://vlr.gg/player/3741/vo0kashu,2025-01-21 04:00:00,,,,220,,,31,,,22,,,11,,,,,,,,,,,,,,,,,,,,
379,https://vlr.gg/player/31753/spiritz1,2025-01-21 04:00:00,,,,218,,,35,,,24,,,8,,,,,,,,,,,,,,,,,,,,
380,https://vlr.gg/player/7841/tvirusluke,2025-01-21 04:00:00,,,,205,,,28,,,33,,,8,,,,,,,,,,,,,,,,,,,,
381,https://vlr.gg/player/11524/nicc,2025-01-21 04:00:00,,,,196,,,29,,,26,,,32,,,,,,,,,,,,,,,,,,,,
382,https://vlr.gg/player/3127/monsteerr,2025-01-20 15:10:00,0.89,1.10,0.97,208,193,221,28,15,13,31,19,12,17,15,2,0,-1,+1,70%,63%,81%,136,137,134,31%,32%,31%,4,1,3,4,2,2
383,https://vlr.gg/player/38424/zachkappa,2025-01-20 15:10:00,0.91,0.72,0.83,211,232,193,29,20,9,33,20,13,9,5,4,-3,-2,-1,58%,54%,63%,141,143,138,24%,16%,42%,6,4,2,9,6,3
384,https://vlr.gg/player/8502/olizera,2025-01-20 15:10:00,1.09,0.34,0.79,174,229,105,25,20,5,31,17,14,5,4,1,-2,0,-2,50%,58%,38%,122,156,72,20%,22%,15%,4,3,1,6,3,3
385,https://vlr.gg/player/5199/guardy,2025-01-20 15:10:00,0.72,0.71,0.72,164,184,141,22,13,9,31,18,13,5,3,2,0,+1,-1,55%,54%,56%,120,123,114,41%,41%,42%,1,1,0,1,0,1
386,https://vlr.gg/player/22154/pika,2025-01-20 15:10:00,0.46,0.56,0.50,93,77,109,12,6,6,29,18,11,5,3,2,-5,-4,-1,50%,50%,50%,65,54,82,28%,25%,32%,0,0,0,5,4,1
387,https://vlr.gg/player/15473/yuno,2025-01-20 15:10:00,1.35,1.54,1.46,251,227,268,37,13,24,22,9,13,24,9,15,+4,+3,+1,85%,81%,88%,160,150,166,23%,32%,19%,5,3,2,1,0,1
388,https://vlr.gg/player/8834/bucher,2025-01-20 15:10:00,1.98,1.05,1.42,232,303,184,34,19,15,20,5,15,11,3,8,+2,+2,0,83%,88%,79%,145,188,117,43%,74%,25%,4,2,2,2,0,2
389,https://vlr.gg/player/1839/polvi,2025-01-20 15:10:00,1.15,1.51,1.37,299,279,315,41,14,27,30,13,17,13,8,5,+6,0,+6,78%,81%,75%,196,180,206,15%,13%,16%,12,3,9,6,3,3
390,https://vlr.gg/player/341/quick,2025-01-20 15:10:00,1.12,0.98,1.03,165,177,159,25,11,14,23,8,15,12,7,5,-1,-1,0,83%,94%,75%,101,109,96,29%,30%,28%,3,1,2,4,2,2
391,https://vlr.gg/player/6959/flickless,2025-01-20 15:10:00,0.94,1.04,1.00,141,101,156,18,6,12,21,7,14,24,10,14,-1,0,-1,80%,75%,83%,88,56,109,29%,33%,28%,1,1,0,2,1,1
392,https://vlr.gg/player/16483/gloomy,2025-01-20 13:30:00,1.41,1.61,1.49,265,207,367,18,10,8,11,6,5,8,4,4,0,0,0,79%,83%,71%,183,157,227,23%,21%,25%,0,0,0,0,0,0
393,https://vlr.gg/player/12226/sturnn,2025-01-20 13:30:00,0.94,2.01,1.33,231,228,238,17,10,7,10,9,1,2,1,1,0,0,0,79%,67%,100%,151,142,167,33%,26%,46%,0,0,0,0,0,0
394,https://vlr.gg/player/11516/drky,2025-01-20 13:30:00,1.06,1.44,1.20,164,150,190,12,7,5,9,7,2,9,4,5,+1,0,+1,84%,75%,100%,111,99,131,20%,22%,17%,2,1,1,1,1,0
395,https://vlr.gg/player/21584/deminatix,2025-01-20 13:30:00,0.82,1.21,0.96,240,256,214,17,11,6,15,11,4,2,2,0,+4,+3,+1,74%,75%,71%,157,152,164,26%,23%,43%,7,5,2,3,2,1
396,https://vlr.gg/player/10114/baha,2025-01-20 13:30:00,0.24,1.34,0.64,163,145,193,11,6,5,16,12,4,8,2,6,0,+1,-1,68%,58%,86%,121,107,144,33%,54%,18%,3,2,1,3,1,2
397,https://vlr.gg/player/16552/pckwn,2025-01-20 13:30:00,0.58,1.41,1.10,229,141,282,15,3,12,16,6,10,7,3,4,-1,-1,0,79%,71%,83%,133,90,159,24%,23%,25%,1,0,1,2,1,1
398,https://vlr.gg/player/4962/lurzy0y0,2025-01-20 13:30:00,0.78,1.18,1.03,219,153,259,14,3,11,14,6,8,9,6,3,-1,+1,-2,63%,71%,58%,140,94,167,45%,67%,40%,2,1,1,3,0,3
399,https://vlr.gg/player/40843/audaz,2025-01-20 13:30:00,0.52,1.08,0.88,209,183,225,12,3,9,16,7,9,7,4,3,-2,-1,-1,74%,71%,75%,147,136,154,33%,36%,32%,0,0,0,2,1,1
400,https://vlr.gg/player/31855/celasun,2025-01-20 13:30:00,0.42,1.14,0.87,140,94,168,10,2,8,13,6,7,4,1,3,-1,-1,0,74%,57%,83%,112,76,133,35%,30%,38%,0,0,0,1,1,0
401,https://vlr.gg/player/39357/s0pp,2025-01-20 13:30:00,0.76,0.59,0.65,165,194,149,10,5,5,16,6,10,4,0,4,0,+1,-1,63%,43%,75%,122,144,109,31%,38%,25%,4,2,2,4,1,3
402,https://vlr.gg/player/1470/simond4rk,2025-01-20 13:00:00,1.38,1.21,1.30,275,296,257,36,20,16,25,13,12,5,3,2,+4,+4,0,70%,68%,72%,182,179,184,31%,41%,21%,12,7,5,8,3,5
403,https://vlr.gg/player/2190/baddyg,2025-01-20 13:00:00,1.25,1.31,1.28,210,201,224,29,12,17,22,11,11,16,11,5,-4,0,-4,76%,79%,72%,136,139,133,34%,33%,36%,0,0,0,4,0,4
404,https://vlr.gg/player/8226/waddle,2025-01-20 13:00:00,0.70,1.10,0.90,190,138,246,24,9,15,28,13,15,14,7,7,-2,-2,0,68%,63%,72%,136,92,182,30%,36%,26%,0,0,0,2,2,0
405,https://vlr.gg/player/12474/tag,2025-01-20 13:00:00,0.85,0.81,0.83,156,160,153,23,12,11,26,14,12,3,1,2,-2,-4,+2,68%,74%,61%,102,109,95,41%,34%,50%,3,1,2,5,5,0
406,https://vlr.gg/player/1944/cayden,2025-01-20 13:00:00,0.86,0.52,0.69,123,132,115,11,7,4,26,12,14,25,14,11,0,0,0,76%,84%,67%,87,71,103,24%,27%,21%,1,0,1,1,0,1
407,https://vlr.gg/player/13435/fragger,2025-01-20 13:00:00,1.19,1.10,1.15,249,268,228,32,17,15,28,15,13,17,9,8,0,+1,-1,81%,83%,79%,152,163,141,27%,35%,21%,1,1,0,1,0,1
408,https://vlr.gg/player/5203/bati,2025-01-20 13:00:00,0.83,1.29,1.06,172,133,207,24,9,15,20,10,10,7,2,5,0,0,0,70%,61%,79%,108,78,136,17%,19%,17%,3,1,2,3,1,2
409,https://vlr.gg/player/15376/grtw,2025-01-20 13:00:00,0.80,1.11,0.96,171,145,196,23,8,15,24,12,12,5,4,1,-1,-1,0,65%,56%,74%,114,96,132,40%,35%,44%,3,1,2,4,2,2
410,https://vlr.gg/player/6909/jannyxd,2025-01-20 13:00:00,1.05,0.75,0.90,225,243,204,27,15,12,28,13,15,7,4,3,+1,-1,+2,70%,78%,63%,142,155,130,32%,41%,23%,8,4,4,7,5,2
411,https://vlr.gg/player/1493/starkk,2025-01-20 13:00:00,1.26,0.55,0.90,164,210,122,21,15,6,28,13,15,15,5,10,+4,+3,+1,78%,83%,74%,106,134,79,19%,22%,14%,5,3,2,1,0,1
412,https://vlr.gg/player/8808/pyrolll,2025-01-20 13:00:00,0.94,0.92,0.93,178,186,166,24,16,8,28,18,10,6,3,3,-5,-3,-2,68%,75%,57%,120,126,111,40%,53%,23%,0,0,0,5,3,2
413,https://vlr.gg/player/363/7ssk7,2025-01-20 13:00:00,0.59,1.29,0.85,191,137,284,23,11,12,32,21,11,3,1,2,+4,+3,+1,53%,58%,43%,129,81,210,22%,26%,20%,6,4,2,2,1,1
414,https://vlr.gg/player/173/l0udly,2025-01-20 13:00:00,0.75,0.44,0.63,120,131,101,18,12,6,30,18,12,6,3,3,-5,-2,-3,63%,71%,50%,74,88,49,40%,37%,46%,1,0,1,6,2,4
415,https://vlr.gg/player/2431/basya,2025-01-20 13:00:00,0.61,0.58,0.60,138,140,134,17,12,5,32,20,12,7,3,4,-8,-6,-2,58%,63%,50%,92,92,90,27%,31%,20%,1,1,0,9,7,2
416,https://vlr.gg/player/443/zeddy,2025-01-20 13:00:00,0.72,0.39,0.60,144,178,87,16,12,4,34,22,12,15,12,3,-4,-4,0,74%,79%,64%,96,119,58,18%,16%,27%,2,1,1,6,5,1
417,https://vlr.gg/player/402/insider,2025-01-20 13:00:00,1.71,1.46,1.55,290,317,275,40,17,23,17,6,11,12,3,9,+4,+2,+2,87%,93%,83%,195,193,197,29%,33%,27%,7,2,5,3,0,3
418,https://vlr.gg/player/1155/buld,2025-01-20 13:00:00,1.14,1.60,1.43,277,213,315,36,11,25,21,8,13,24,6,18,+4,0,+4,84%,79%,88%,174,126,203,20%,14%,22%,7,2,5,3,2,1
419,https://vlr.gg/player/23347/alannn,2025-01-20 13:00:00,1.09,1.15,1.13,194,190,197,31,11,20,22,8,14,9,5,4,+8,+2,+6,89%,79%,96%,115,108,119,33%,29%,36%,8,2,6,0,0,0
420,https://vlr.gg/player/3784/katu,2025-01-20 13:00:00,1.05,1.15,1.11,198,196,199,31,10,21,21,7,14,9,1,8,+5,+3,+2,84%,86%,83%,134,116,145,23%,41%,15%,6,4,2,1,1,0
421,https://vlr.gg/player/4519/kamisseq,2025-01-20 13:00:00,1.14,0.93,1.00,125,155,108,18,8,10,17,6,11,24,8,16,-3,-1,-2,84%,86%,83%,77,95,67,41%,60%,32%,0,0,0,3,1,2
422,https://vlr.gg/player/10161/qutionerx,2025-01-20 12:45:00,1.42,1.06,1.08,269,480,252,12,2,10,12,1,11,2,0,2,-1,0,-1,69%,100%,67%,165,270,156,21%,50%,17%,2,0,2,3,0,3
423,https://vlr.gg/player/10160/izzy,2025-01-20 12:45:00,0.79,1.05,1.03,237,150,244,11,1,10,11,1,10,1,0,1,-1,0,-1,85%,100%,83%,150,105,154,28%,100%,25%,0,0,0,1,0,1
424,https://vlr.gg/player/8041/brave,2025-01-20 12:45:00,0.04,0.32,0.30,120,135,119,4,0,4,13,1,12,2,1,1,-1,-1,0,54%,100%,50%,79,135,74,39%,50%,38%,0,0,0,1,1,0
425,https://vlr.gg/player/10163/cyderx,2025-01-20 12:45:00,0.06,0.31,0.29,102,30,109,4,0,4,13,1,12,4,0,4,-4,0,-4,54%,100%,50%,72,30,76,40%,0%,44%,0,0,0,4,0,4
426,https://vlr.gg/player/12774/anima,2025-01-20 12:45:00,0.03,0.24,0.22,79,31,84,2,0,2,12,1,11,2,0,2,-2,0,-2,46%,,50%,66,31,69,19%,100%,13%,0,0,0,2,0,2
427,https://vlr.gg/player/40935/umu7,2025-01-20 12:45:00,1.62,3.36,1.75,335,322,508,17,15,2,8,8,0,1,0,1,+5,+4,+1,100%,100%,100%,204,201,243,34%,32%,50%,6,5,1,1,1,0
428,https://vlr.gg/player/3557/skylen,2025-01-20 12:45:00,1.32,3.99,1.53,273,260,434,12,10,2,6,6,0,7,5,2,+1,+1,0,85%,83%,100%,187,177,315,35%,30%,100%,1,1,0,0,0,0
429,https://vlr.gg/player/22676/ventt,2025-01-20 12:45:00,1.47,0.01,1.34,189,206,,10,10,0,5,4,1,6,6,0,+1,+1,0,85%,92%,,119,129,,25%,25%,,2,2,0,1,1,0
430,https://vlr.gg/player/5510/oxmann,2025-01-20 12:45:00,1.40,0.70,1.34,198,196,230,12,11,1,5,4,1,0,0,0,+1,+1,0,85%,83%,100%,130,130,135,29%,28%,50%,1,1,0,0,0,0
431,https://vlr.gg/player/10137/ip0tt,2025-01-20 12:45:00,1.16,0.02,1.07,217,236,,10,10,0,9,8,1,7,7,0,+1,+1,0,85%,92%,,159,173,,41%,41%,,1,1,0,0,0,0
432,https://vlr.gg/player/13571/musz3kk,2025-01-20 11:50:00,0.39,1.34,0.63,183,141,310,9,5,4,15,12,3,2,2,0,-3,-2,-1,63%,58%,75%,118,90,202,26%,21%,29%,0,0,0,3,2,1
433,https://vlr.gg/player/40841/kabzi,2025-01-20 11:50:00,0.84,0.02,0.62,136,155,81,6,5,1,15,11,4,2,2,0,-2,-1,-1,44%,42%,50%,97,110,59,18%,22%,10%,0,0,0,2,1,1
434,https://vlr.gg/player/5500/docent,2025-01-20 11:50:00,0.65,0.50,0.61,166,169,157,7,5,2,15,11,4,3,2,1,-3,-3,0,50%,42%,75%,123,127,112,13%,10%,22%,0,0,0,3,3,0
435,https://vlr.gg/player/50776/influx,2025-01-20 11:50:00,0.29,0.96,0.46,116,85,211,5,2,3,14,11,3,3,3,0,-4,-3,-1,31%,33%,25%,84,60,158,33%,36%,30%,0,0,0,4,3,1
436,https://vlr.gg/player/4894/jn3v1ce,2025-01-20 11:50:00,0.16,0.75,0.31,115,85,208,6,3,3,16,12,4,1,1,0,0,-1,+1,44%,42%,50%,75,59,124,29%,27%,33%,2,1,1,2,2,0
437,https://vlr.gg/player/18655/best,2025-01-20 11:50:00,3.05,2.19,2.41,430,579,381,26,9,17,4,2,2,3,0,3,+8,+3,+5,94%,100%,92%,275,417,227,19%,21%,18%,8,3,5,0,0,0
438,https://vlr.gg/player/15735/krostaly,2025-01-20 11:50:00,0.79,1.73,1.50,216,195,223,13,3,10,5,3,2,7,0,7,+1,0,+1,88%,50%,100%,139,103,151,36%,33%,36%,1,0,1,0,0,0
439,https://vlr.gg/player/33551/slaughter,2025-01-20 11:50:00,1.36,1.16,1.21,206,235,197,12,3,9,7,3,4,10,7,3,+1,0,+1,88%,100%,83%,129,150,122,48%,25%,67%,2,0,2,1,0,1
440,https://vlr.gg/player/31307/yigox,2025-01-20 11:50:00,0.33,1.51,1.21,213,74,261,14,1,13,9,3,6,4,0,4,0,-1,+1,88%,75%,92%,147,47,180,23%,17%,24%,1,0,1,1,1,0
441,https://vlr.gg/player/40842/ibonata,2025-01-20 11:50:00,1.03,1.20,1.16,180,137,195,10,2,8,8,2,6,11,2,9,+2,0,+2,88%,100%,83%,105,81,113,30%,33%,29%,2,0,2,0,0,0
442,https://vlr.gg/player/41220/krejz,2025-01-20 11:00:00,1.71,1.41,1.51,299,303,299,41,16,25,24,8,16,3,0,3,0,+1,-1,76%,92%,67%,189,207,180,34%,28%,39%,6,2,4,6,1,5
443,https://vlr.gg/player/292/fit1nho,2025-01-20 11:00:00,0.81,1.15,1.03,217,173,243,27,7,20,28,9,19,14,4,10,-1,0,-1,65%,62%,67%,149,137,156,33%,20%,43%,1,0,1,2,0,2
444,https://vlr.gg/player/20271/vorwenn,2025-01-20 11:00:00,0.72,0.98,0.89,190,154,210,26,8,18,26,10,16,9,4,5,+2,-2,+4,81%,77%,83%,121,101,132,22%,29%,19%,5,0,5,3,2,1
445,https://vlr.gg/player/2534/lowel,2025-01-20 11:00:00,0.97,0.67,0.77,143,259,83,15,10,5,24,11,13,7,4,3,0,+2,-2,65%,69%,63%,104,176,65,21%,19%,27%,3,3,0,3,1,2
446,https://vlr.gg/player/7220/saiz,2025-01-20 11:00:00,0.34,0.91,0.71,167,125,191,20,5,15,29,13,16,9,2,7,-2,0,-2,73%,69%,75%,111,80,127,37%,38%,37%,3,2,1,5,2,3
447,https://vlr.gg/player/7868/lele,2025-01-20 11:00:00,1.17,1.53,1.29,258,239,291,34,20,14,26,17,9,20,12,8,-1,-1,0,78%,75%,85%,157,142,186,30%,27%,34%,2,1,1,3,2,1
448,https://vlr.gg/player/5854/z3ro,2025-01-20 11:00:00,1.09,1.09,1.09,198,198,198,26,17,9,25,16,9,11,6,5,+1,+1,0,68%,63%,77%,130,128,134,31%,30%,33%,4,3,1,3,2,1
449,https://vlr.gg/player/16447/d3mur,2025-01-20 11:00:00,1.04,1.02,1.03,234,232,229,29,18,11,29,18,11,8,5,3,-2,-1,-1,65%,67%,62%,146,154,130,23%,23%,24%,8,5,3,10,6,4
450,https://vlr.gg/player/4277/n-a-i-s,2025-01-20 11:00:00,0.90,0.94,0.92,159,138,197,22,12,10,24,15,9,8,7,1,+1,+1,0,73%,71%,77%,109,99,127,42%,45%,38%,2,1,1,1,0,1
451,https://vlr.gg/player/1472/falltw,2025-01-20 11:00:00,0.73,1.00,0.83,158,160,154,20,13,7,25,17,8,17,7,10,+2,+2,0,73%,71%,77%,100,106,88,20%,20%,22%,3,3,0,1,1,0
452,https://vlr.gg/player/4851/rexs,2025-01-20 11:00:00,1.09,1.14,1.11,212,222,204,30,14,16,30,18,12,10,7,3,+2,+2,0,69%,55%,82%,146,144,148,28%,29%,27%,6,4,2,4,2,2
453,https://vlr.gg/player/6925/chadi,2025-01-20 11:00:00,0.58,1.52,1.06,234,152,314,33,9,24,31,18,13,8,4,4,+2,-1,+3,64%,50%,77%,144,104,180,15%,17%,14%,7,2,5,5,3,2
454,https://vlr.gg/player/2835/kyrrz,2025-01-20 11:00:00,0.42,1.15,0.80,152,104,195,24,7,17,30,18,12,9,1,8,-1,-3,+2,62%,45%,77%,105,75,133,31%,22%,38%,2,0,2,3,3,0
455,https://vlr.gg/player/24359/faska,2025-01-20 11:00:00,0.49,0.80,0.65,147,78,212,21,5,16,35,17,18,6,2,4,-1,-4,+3,67%,50%,82%,98,62,130,32%,38%,30%,4,0,4,5,4,1
456,https://vlr.gg/player/24428/harambe,2025-01-20 11:00:00,0.25,0.91,0.60,115,76,152,20,5,15,30,18,12,3,0,3,-2,-2,0,48%,20%,73%,91,66,115,32%,23%,37%,2,0,2,4,2,2
457,https://vlr.gg/player/18162/serial,2025-01-20 11:00:00,0.97,2.47,1.69,315,201,444,49,15,34,25,17,8,12,4,8,+3,-2,+5,76%,64%,90%,209,138,288,50%,61%,46%,8,2,6,5,4,1
458,https://vlr.gg/player/16209/famsii,2025-01-20 11:00:00,0.61,1.71,1.14,198,141,268,31,10,21,24,18,6,8,5,3,0,-1,+1,74%,64%,85%,142,95,195,22%,28%,17%,5,2,3,5,3,2
459,https://vlr.gg/player/29972/michel,2025-01-20 11:00:00,1.04,1.15,1.09,227,220,230,36,18,18,29,19,10,6,2,4,+1,-1,+2,64%,55%,75%,147,151,143,36%,38%,33%,5,2,3,4,3,1
460,https://vlr.gg/player/1524/h1ber,2025-01-20 11:00:00,1.03,0.85,0.94,185,234,128,23,15,8,27,18,9,16,6,10,-2,-2,0,71%,64%,80%,125,160,87,28%,31%,23%,2,1,1,4,3,1
461,https://vlr.gg/player/8805/sacake,2025-01-20 11:00:00,0.67,1.07,0.86,119,107,131,17,9,8,23,16,7,24,10,14,-2,-2,0,79%,68%,90%,68,60,77,29%,25%,31%,1,0,1,3,2,1
462,https://vlr.gg/player/40591/comeback,2025-01-20 10:30:00,0.56,1.88,1.22,276,142,412,29,7,22,23,13,10,12,6,6,+1,-3,+4,80%,60%,100%,158,89,227,25%,33%,22%,7,2,5,6,5,1
463,https://vlr.gg/player/24344/loita,2025-01-20 10:30:00,1.30,0.77,1.03,185,253,118,20,13,7,20,10,10,9,3,6,0,+2,-2,80%,73%,87%,123,164,83,37%,32%,50%,2,2,0,2,0,2
464,https://vlr.gg/player/31305/lar0k,2025-01-20 10:30:00,0.84,1.16,1.00,181,158,205,19,8,11,20,11,9,14,5,9,-1,-1,0,77%,73%,80%,126,108,143,39%,30%,48%,0,0,0,1,1,0
465,https://vlr.gg/player/5565/ros,2025-01-20 10:30:00,0.23,1.57,0.90,212,80,344,21,4,17,22,13,9,7,1,6,-2,-5,+3,70%,60%,80%,150,62,238,25%,23%,25%,4,0,4,6,5,1
466,https://vlr.gg/player/12795/crewen,2025-01-20 10:30:00,1.02,0.31,0.66,130,188,72,14,10,4,21,10,11,4,2,2,-2,0,-2,60%,60%,60%,83,118,49,37%,39%,33%,0,0,0,2,0,2
467,https://vlr.gg/player/10125/qw1,2025-01-20 10:30:00,1.34,1.70,1.52,315,317,315,34,17,17,20,13,7,5,0,5,+3,+1,+2,83%,80%,87%,189,190,189,31%,44%,19%,7,4,3,4,3,1
468,https://vlr.gg/player/6559/destruct1vee,2025-01-20 10:30:00,1.11,1.63,1.37,227,169,286,24,9,15,19,10,9,16,8,8,0,-2,+2,80%,73%,87%,154,122,186,44%,47%,42%,2,0,2,2,2,0
469,https://vlr.gg/player/7353/glovee,2025-01-20 10:30:00,0.84,0.85,0.84,152,163,141,16,9,7,20,12,8,14,9,5,-1,-1,0,57%,53%,60%,84,87,81,30%,19%,44%,2,0,2,3,1,2
470,https://vlr.gg/player/1399/sterben,2025-01-20 10:30:00,0.80,0.85,0.83,180,164,198,17,7,10,23,13,10,11,8,3,+1,0,+1,70%,67%,73%,123,122,123,35%,24%,53%,4,2,2,3,2,1
471,https://vlr.gg/player/3604/mojj,2025-01-20 10:30:00,0.61,0.85,0.73,152,158,147,15,7,8,21,13,8,11,7,4,+1,-1,+2,70%,67%,73%,93,93,93,39%,64%,23%,2,0,2,1,1,0
472,https://vlr.gg/player/50775/lava,2025-01-20 09:30:00,1.31,1.74,1.45,211,198,240,15,9,6,7,5,2,4,3,1,+1,+1,0,78%,75%,83%,151,145,161,36%,35%,38%,1,1,0,0,0,0
473,https://vlr.gg/player/3862/deepmans,2025-01-20 09:30:00,1.24,1.86,1.45,301,270,366,21,12,9,11,8,3,6,4,2,+2,+2,0,72%,67%,83%,187,178,204,39%,38%,40%,4,3,1,2,1,1
474,https://vlr.gg/player/568/turko,2025-01-20 09:30:00,1.22,1.47,1.30,190,194,184,11,8,3,7,6,1,8,3,5,-1,-1,0,78%,67%,100%,139,142,134,32%,30%,38%,1,1,0,2,2,0
475,https://vlr.gg/player/10146/reazy,2025-01-20 09:30:00,0.89,1.07,0.95,153,83,295,11,4,7,11,5,6,7,5,2,+2,0,+2,78%,67%,100%,99,53,191,37%,27%,44%,3,1,2,1,1,0
476,https://vlr.gg/player/569/paura,2025-01-20 09:30:00,0.48,1.45,0.81,104,58,197,8,3,5,10,7,3,12,6,6,0,-2,+2,67%,50%,100%,45,23,90,36%,25%,40%,2,0,2,2,2,0
477,https://vlr.gg/player/50776/influx,2025-01-20 09:30:00,0.52,1.49,1.17,209,143,242,11,3,8,12,6,6,6,1,5,+1,0,+1,61%,50%,67%,139,99,158,12%,9%,13%,2,0,2,1,0,1
478,https://vlr.gg/player/4894/jn3v1ce,2025-01-20 09:30:00,0.93,1.07,1.02,141,223,101,9,5,4,12,6,6,10,2,8,+1,0,+1,72%,100%,58%,75,111,56,20%,25%,15%,1,0,1,0,0,0
479,https://vlr.gg/player/13571/musz3kk,2025-01-20 09:30:00,0.94,1.02,0.99,218,229,213,13,5,8,13,6,7,1,1,0,-2,+1,-3,56%,67%,50%,133,116,142,45%,56%,41%,2,1,1,4,0,4
480,https://vlr.gg/player/5500/docent,2025-01-20 09:30:00,0.11,0.82,0.58,128,88,148,6,1,5,14,6,8,10,3,7,-3,-3,0,61%,67%,58%,96,68,110,25%,11%,30%,1,0,1,4,3,1
481,https://vlr.gg/player/40841/kabzi,2025-01-20 09:30:00,0.05,0.67,0.46,111,67,134,7,1,6,15,6,9,4,2,2,-1,-2,+1,56%,67%,50%,76,70,80,17%,29%,14%,1,0,1,2,2,0
482,https://vlr.gg/player/4712/heybay,2025-01-20 06:25:00,,,,286,,,35,,,15,,,10,,,,,,,,,,,,,,,,,,,,
483,https://vlr.gg/player/3021/biank,2025-01-20 06:25:00,,,,232,,,27,,,20,,,15,,,,,,,,,,,,,,,,,,,,
484,https://vlr.gg/player/4770/fengf,2025-01-20 06:25:00,,,,205,,,25,,,20,,,7,,,,,,,,,,,,,,,,,,,,
485,https://vlr.gg/player/3045/luok1ng,2025-01-20 06:25:00,,,,199,,,26,,,15,,,14,,,,,,,,,,,,,,,,,,,,
486,https://vlr.gg/player/37494/kai,2025-01-20 06:25:00,,,,189,,,25,,,19,,,11,,,,,,,,,,,,,,,,,,,,
487,https://vlr.gg/player/15559/chichoo,2025-01-20 06:25:00,,,,202,,,24,,,27,,,3,,,,,,,,,,,,,,,,,,,,
488,https://vlr.gg/player/4742/smoggy,2025-01-20 06:25:00,,,,186,,,21,,,26,,,12,,,,,,,,,,,,,,,,,,,,
489,https://vlr.gg/player/3520/zmjjkk,2025-01-20 06:25:00,,,,165,,,18,,,31,,,3,,,,,,,,,,,,,,,,,,,,
490,https://vlr.gg/player/13768/s1mon,2025-01-20 06:25:00,,,,125,,,14,,,26,,,13,,,,,,,,,,,,,,,,,,,,
491,https://vlr.gg/player/3017/nobody,2025-01-20 06:25:00,,,,99,,,12,,,28,,,4,,,,,,,,,,,,,,,,,,,,
492,https://vlr.gg/player/7378/jinggg,2025-01-20 06:15:00,1.01,1.16,1.09,233,216,242,51,21,30,47,21,26,12,8,4,+3,-1,+4,72%,82%,64%,152,155,150,16%,18%,15%,14,5,9,11,6,5
493,https://vlr.gg/player/9801/f0rsaken,2025-01-20 06:15:00,1.36,0.77,1.03,201,257,158,45,27,18,48,19,29,26,10,16,0,-1,+1,75%,86%,67%,131,160,109,29%,40%,19%,5,1,4,5,2,3
494,https://vlr.gg/player/9803/d4v41,2025-01-20 06:15:00,1.04,1.02,1.03,210,194,231,50,21,29,47,19,28,13,9,4,-1,+1,-2,80%,86%,75%,146,128,161,31%,37%,28%,5,3,2,6,2,4
495,https://vlr.gg/player/9800/mindfreak,2025-01-20 06:15:00,1.03,0.92,0.97,174,161,187,35,15,20,45,18,27,32,15,17,-2,0,-2,66%,61%,69%,116,96,131,32%,40%,28%,1,0,1,3,0,3
496,https://vlr.gg/player/17086/something,2025-01-20 06:15:00,1.00,0.73,0.85,170,203,150,39,20,19,46,20,26,17,8,9,-2,-1,-1,73%,79%,69%,112,132,96,23%,35%,15%,6,4,2,8,5,3
497,https://vlr.gg/player/485/stax,2025-01-20 06:15:00,1.06,1.48,1.25,217,169,288,46,21,25,37,20,17,32,18,14,-1,0,-1,77%,81%,71%,151,113,200,24%,22%,25%,4,2,2,5,2,3
498,https://vlr.gg/player/804/buzz,2025-01-20 06:15:00,1.34,0.83,1.11,238,261,202,55,35,20,46,24,22,11,9,2,+4,+2,+2,67%,78%,54%,153,168,133,22%,23%,21%,10,5,5,6,3,3
499,https://vlr.gg/player/29833/izu,2025-01-20 06:15:00,1.36,0.52,0.99,193,242,137,42,31,11,46,22,24,19,10,9,0,+1,-1,73%,78%,68%,136,162,102,24%,25%,23%,6,4,2,6,3,3
500,https://vlr.gg/player/13039/meteor,2025-01-20 06:15:00,0.78,1.19,0.96,210,193,234,51,26,25,48,28,20,7,5,2,+3,0,+3,70%,69%,71%,133,126,141,30%,29%,31%,9,6,3,6,6,0
501,https://vlr.gg/player/4056/sylvan,2025-01-20 06:15:00,1.05,0.77,0.93,177,185,169,38,22,16,43,22,21,39,25,14,-4,-3,-1,80%,86%,71%,115,116,114,27%,36%,18%,4,1,3,8,4,4
0,https://vlr.gg/player/10698/nephh,2025-01-20 04:00:00,,,,263,,,43,,,29,,,24,,,,,,,,,,,,,,,,,,,,
1,https://vlr.gg/player/4885/whzy,2025-01-20 04:00:00,,,,250,,,39,,,32,,,10,,,,,,,,,,,,,,,,,,,,
2,https://vlr.gg/player/4774/knight,2025-01-20 04:00:00,,,,193,,,32,,,28,,,16,,,,,,,,,,,,,,,,,,,,
3,https://vlr.gg/player/48878/rushia,2025-01-20 04:00:00,,,,163,,,28,,,27,,,17,,,,,,,,,,,,,,,,,,,,
4,https://vlr.gg/player/40845/levius,2025-01-20 04:00:00,,,,144,,,24,,,31,,,4,,,,,,,,,,,,,,,,,,,,
5,https://vlr.gg/player/6022/yosemite,2025-01-20 04:00:00,,,,262,,,45,,,31,,,5,,,,,,,,,,,,,,,,,,,,
6,https://vlr.gg/player/872/autumn,2025-01-20 04:00:00,,,,234,,,35,,,33,,,8,,,,,,,,,,,,,,,,,,,,
7,https://vlr.gg/player/3028/life,2025-01-20 04:00:00,,,,171,,,24,,,36,,,7,,,,,,,,,,,,,,,,,,,,
8,https://vlr.gg/player/19530/aaaay,2025-01-20 04:00:00,,,,159,,,27,,,35,,,4,,,,,,,,,,,,,,,,,,,,
9,https://vlr.gg/player/7857/berlin,2025-01-20 04:00:00,,,,112,,,16,,,31,,,20,,,,,,,,,,,,,,,,,,,,
10,https://vlr.gg/player/1916/free1ng,2025-01-20 03:00:00,1.09,1.23,1.17,236,217,250,58,24,34,44,20,24,13,7,6,+3,0,+3,77%,83%,72%,151,149,153,31%,28%,33%,6,0,6,3,0,3
11,https://vlr.gg/player/28400/hyunmin,2025-01-20 03:00:00,1.35,1.01,1.16,261,313,223,58,32,26,48,23,25,12,7,5,+8,+5,+3,82%,83%,81%,176,211,147,25%,33%,18%,17,10,7,9,5,4
12,https://vlr.gg/player/4462/mako,2025-01-20 03:00:00,0.84,1.15,1.01,212,182,247,46,17,29,48,22,26,26,15,11,+3,-2,+5,80%,66%,92%,138,118,154,25%,16%,33%,9,3,6,6,5,1
13,https://vlr.gg/player/35013/flashback,2025-01-20 03:00:00,0.71,0.97,0.85,183,171,189,39,17,22,44,22,22,15,9,6,-4,0,-4,78%,79%,78%,128,111,141,18%,14%,23%,3,2,1,7,2,5
14,https://vlr.gg/player/4678/beyn,2025-01-20 03:00:00,0.92,0.74,0.82,140,160,127,32,17,15,43,19,24,22,12,10,-3,-2,-1,77%,79%,75%,97,104,91,24%,26%,22%,1,0,1,4,2,2
15,https://vlr.gg/player/31828/francis,2025-01-20 03:00:00,1.15,1.36,1.24,227,220,239,52,26,26,45,25,20,30,21,9,+3,-1,+4,83%,81%,86%,149,151,145,29%,32%,26%,7,2,5,4,3,1
16,https://vlr.gg/player/31829/ivy,2025-01-20 03:00:00,1.20,1.02,1.12,207,218,193,45,30,15,42,22,20,27,10,17,+1,-1,+2,83%,83%,83%,132,134,129,27%,34%,19%,4,1,3,3,2,1
17,https://vlr.gg/player/4122/persia,2025-01-20 03:00:00,0.87,1.15,0.99,174,151,205,39,18,21,43,23,20,36,19,17,-5,-2,-3,75%,72%,79%,109,95,127,34%,33%,36%,1,1,0,6,3,3
18,https://vlr.gg/player/33576/margaret,2025-01-20 03:00:00,1.06,0.75,0.92,191,197,180,47,28,19,45,24,21,9,3,6,-1,0,-1,69%,78%,59%,122,128,115,26%,28%,23%,6,2,4,7,2,5
19,https://vlr.gg/player/31827/dambi,2025-01-20 03:00:00,0.56,0.97,0.74,205,168,253,44,19,25,58,32,26,26,12,14,-5,-2,-3,78%,72%,86%,123,100,151,21%,17%,25%,11,9,2,16,11,5
20,https://vlr.gg/player/7873/leaf,2025-01-19 19:20:00,1.46,1.62,1.56,284,279,286,44,16,28,23,10,13,7,4,3,+5,+1,+4,75%,69%,79%,187,191,185,31%,27%,33%,7,2,5,2,1,1
21,https://vlr.gg/player/4581/jonahp,2025-01-19 19:20:00,1.23,1.46,1.37,203,175,226,30,10,20,20,10,10,27,14,13,+2,+1,+1,88%,81%,92%,132,121,139,37%,38%,37%,3,1,2,1,0,1
22,https://vlr.gg/player/15500/trent,2025-01-19 19:20:00,0.90,1.37,1.18,192,111,249,31,8,23,19,8,11,5,1,4,-2,0,-2,75%,63%,83%,140,101,165,39%,35%,41%,3,2,1,5,2,3
23,https://vlr.gg/player/3993/jawgemo,2025-01-19 19:20:00,0.83,1.31,1.12,213,183,230,29,9,20,26,11,15,17,4,13,+7,+2,+5,78%,69%,83%,142,128,152,21%,15%,26%,11,4,7,4,2,2
24,https://vlr.gg/player/3885/valyn,2025-01-19 19:20:00,1.42,0.85,1.08,193,269,139,25,14,11,25,11,14,21,11,10,0,0,0,85%,81%,88%,120,158,94,17%,23%,11%,2,1,1,2,1,1
25,https://vlr.gg/player/7871/xeppaa,2025-01-19 19:20:00,1.00,1.22,1.09,203,198,208,27,15,12,28,19,9,13,7,6,-1,-1,0,70%,67%,75%,144,145,143,23%,24%,20%,1,0,1,2,1,1
26,https://vlr.gg/player/6582/net,2025-01-19 19:20:00,0.50,1.11,0.74,179,159,209,25,13,12,32,22,10,4,3,1,-5,-3,-2,53%,46%,63%,116,104,133,43%,38%,50%,2,0,2,7,3,4
27,https://vlr.gg/player/18796/oxy,2025-01-19 19:20:00,0.41,1.19,0.73,189,157,244,28,12,16,34,22,12,3,1,2,-6,-6,0,55%,46%,69%,132,108,168,24%,24%,24%,5,3,2,11,9,2
28,https://vlr.gg/player/17433/v1c,2025-01-19 19:20:00,0.71,0.58,0.66,137,139,132,16,11,5,32,19,13,17,7,10,0,+2,-2,60%,58%,63%,92,89,98,14%,13%,16%,3,2,1,3,0,3
29,https://vlr.gg/player/612/mitch,2025-01-19 19:20:00,0.67,0.56,0.63,143,158,125,17,12,5,33,20,13,18,6,12,0,0,0,60%,54%,69%,86,92,78,24%,27%,20%,3,3,0,3,3,0
30,https://vlr.gg/player/8549/kingg,2025-01-19 17:00:00,1.63,1.13,1.43,250,277,207,37,25,12,23,12,11,15,11,4,+1,0,+1,83%,88%,75%,147,172,109,41%,42%,38%,5,2,3,4,2,2
31,https://vlr.gg/player/619/c0m,2025-01-19 17:00:00,1.36,1.30,1.34,276,281,277,41,26,15,27,15,12,9,5,4,0,+1,-1,80%,83%,75%,193,193,193,26%,29%,22%,3,2,1,3,1,2
32,https://vlr.gg/player/5004/natank,2025-01-19 17:00:00,1.19,1.41,1.28,203,189,223,27,15,12,20,12,8,22,12,10,0,-2,+2,80%,79%,81%,127,129,124,27%,27%,27%,4,1,3,4,3,1
33,https://vlr.gg/player/1818/tex,2025-01-19 17:00:00,0.93,0.74,0.86,162,179,137,24,16,8,25,15,10,4,3,1,0,+1,-1,70%,75%,63%,104,119,81,31%,33%,26%,4,4,0,4,3,1
34,https://vlr.gg/player/26171/demon1,2025-01-19 17:00:00,0.75,0.88,0.80,163,164,163,22,14,8,26,16,10,5,1,4,+1,+2,-1,68%,63%,75%,112,106,121,22%,21%,22%,5,4,1,4,2,2
35,https://vlr.gg/player/1711/khalil,2025-01-19 17:00:00,1.04,0.93,0.98,188,205,179,28,12,16,29,11,18,9,4,5,0,+2,-2,78%,81%,75%,121,121,121,43%,33%,53%,3,2,1,3,0,3
36,https://vlr.gg/player/8706/havoc,2025-01-19 17:00:00,0.65,1.18,0.97,237,169,280,29,8,21,33,13,20,11,4,7,+4,+1,+3,78%,63%,88%,159,128,180,26%,23%,29%,9,4,5,5,3,2
37,https://vlr.gg/player/939/mwzera,2025-01-19 17:00:00,0.83,0.98,0.92,188,168,204,25,10,15,28,10,18,10,5,5,+1,-1,+2,68%,69%,67%,119,104,129,12%,15%,11%,4,1,3,3,2,1
38,https://vlr.gg/player/25743/raafa,2025-01-19 17:00:00,0.91,0.50,0.66,123,137,116,17,8,9,29,9,20,9,5,4,-2,-1,-1,58%,81%,42%,90,84,94,16%,16%,16%,0,0,0,2,1,1
39,https://vlr.gg/player/8673/heat,2025-01-19 17:00:00,0.95,0.41,0.63,156,226,110,22,13,9,32,12,20,2,0,2,-5,-1,-4,50%,50%,50%,106,144,82,37%,46%,29%,3,1,2,8,2,6
40,https://vlr.gg/player/2252/anq,2025-01-19 14:10:00,1.57,1.58,1.57,263,266,242,34,23,11,17,13,4,18,11,7,+4,+2,+2,81%,79%,85%,161,166,151,43%,36%,62%,4,2,2,0,0,0
41,https://vlr.gg/player/2621/goaster,2025-01-19 14:10:00,1.19,1.34,1.25,233,231,248,32,20,12,23,15,8,10,6,4,0,-2,+2,78%,71%,92%,156,150,167,32%,39%,23%,3,1,2,3,3,0
42,https://vlr.gg/player/12928/veqaj,2025-01-19 14:10:00,0.73,1.88,1.13,223,173,326,33,17,16,23,18,5,6,2,4,-2,-7,+5,73%,58%,100%,151,113,223,36%,39%,33%,7,2,5,9,9,0
43,https://vlr.gg/player/5490/xitsha,2025-01-19 14:10:00,0.93,1.06,0.97,188,185,193,26,17,9,23,16,7,4,1,3,-2,-3,+1,70%,63%,85%,135,136,134,49%,50%,48%,1,0,1,3,3,0
44,https://vlr.gg/player/6889/neskaas,2025-01-19 14:10:00,0.63,1.04,0.78,160,144,178,19,10,9,26,18,8,19,14,5,+1,-2,+3,78%,75%,85%,97,92,108,21%,21%,21%,4,1,3,3,3,0
45,https://vlr.gg/player/14612/lux9,2025-01-19 14:10:00,0.30,1.67,1.19,295,141,371,37,6,31,31,13,18,7,3,4,+4,-3,+7,81%,62%,92%,176,88,224,27%,31%,26%,8,0,8,4,3,1
46,https://vlr.gg/player/2620/ooriime,2025-01-19 14:10:00,0.77,0.91,0.86,167,131,190,20,5,15,27,10,17,14,6,8,-2,-3,+1,65%,54%,71%,113,94,124,27%,30%,25%,3,0,3,5,3,2
47,https://vlr.gg/player/2098/thebigfiz,2025-01-19 14:10:00,1.09,0.71,0.84,174,227,152,24,11,13,28,11,17,4,1,3,0,0,0,73%,62%,79%,120,159,99,36%,46%,28%,2,0,2,2,0,2
48,https://vlr.gg/player/16345/yayax,2025-01-19 14:10:00,0.74,0.85,0.81,151,148,148,20,7,13,27,11,16,3,1,2,0,-3,+3,59%,38%,71%,103,103,104,39%,47%,34%,3,0,3,3,3,0
49,https://vlr.gg/player/3563/babax,2025-01-19 14:10:00,0.23,0.51,0.41,109,82,126,11,3,8,31,12,19,18,3,15,-3,-4,+1,62%,62%,63%,75,50,88,26%,15%,29%,2,0,2,5,4,1
50,https://vlr.gg/player/5510/oxmann,2025-01-19 14:10:00,0.91,1.36,1.18,224,214,232,16,6,10,15,7,8,2,1,1,0,-1,+1,65%,63%,67%,139,124,149,59%,42%,71%,1,0,1,1,1,0
51,https://vlr.gg/player/22676/ventt,2025-01-19 14:10:00,0.31,1.62,1.09,256,146,330,15,3,12,17,8,9,10,4,6,+1,-1,+2,85%,75%,92%,174,101,223,30%,33%,29%,2,0,2,1,1,0
52,https://vlr.gg/player/10137/ip0tt,2025-01-19 14:10:00,1.19,0.71,0.90,179,240,139,14,7,7,14,6,8,5,2,3,-1,-1,0,65%,63%,67%,123,159,99,32%,29%,36%,1,0,1,2,1,1
53,https://vlr.gg/player/40935/umu7,2025-01-19 14:10:00,0.10,1.32,0.83,156,73,212,12,2,10,13,7,6,2,0,2,-3,-2,-1,70%,63%,75%,101,48,137,47%,50%,46%,3,1,2,6,3,3
54,https://vlr.gg/player/3557/skylen,2025-01-19 14:10:00,0.97,0.49,0.68,148,228,96,9,6,3,15,7,8,9,4,5,+1,+1,0,70%,75%,67%,94,135,68,24%,32%,13%,2,1,1,1,0,1
55,https://vlr.gg/player/10114/baha,2025-01-19 14:10:00,1.20,1.61,1.36,269,287,244,18,11,7,12,9,3,6,2,4,+2,+1,+1,75%,67%,88%,173,170,178,44%,52%,36%,2,1,1,0,0,0
56,https://vlr.gg/player/21584/deminatix,2025-01-19 14:10:00,1.00,1.88,1.35,320,245,433,22,10,12,15,9,6,2,2,0,+2,0,+2,70%,58%,88%,202,172,248,30%,22%,36%,5,2,3,3,2,1
57,https://vlr.gg/player/11516/drky,2025-01-19 14:10:00,0.90,1.68,1.21,189,172,216,14,7,7,13,9,4,14,6,8,+1,0,+1,80%,75%,88%,115,95,146,24%,26%,22%,1,0,1,0,0,0
58,https://vlr.gg/player/12226/sturnn,2025-01-19 14:10:00,0.96,0.87,0.92,165,164,169,13,7,6,13,7,6,6,3,3,0,0,0,70%,67%,75%,121,122,120,27%,33%,19%,2,2,0,2,2,0
59,https://vlr.gg/player/16483/gloomy,2025-01-19 14:10:00,0.48,0.75,0.59,104,81,140,7,4,3,13,8,5,4,1,3,-3,-3,0,70%,75%,63%,75,54,107,15%,25%,11%,1,0,1,4,3,1
60,https://vlr.gg/player/19527/jamter,2025-01-19 14:00:00,1.31,1.14,1.22,230,268,198,37,20,17,30,17,13,11,7,4,+1,-1,+2,77%,74%,80%,149,173,127,30%,30%,30%,4,2,2,3,3,0
61,https://vlr.gg/player/44922/golack,2025-01-19 14:00:00,1.08,1.01,1.04,217,240,192,36,19,17,38,20,18,11,7,4,-3,-2,-1,77%,74%,80%,152,164,141,39%,39%,38%,8,3,5,11,5,6
62,https://vlr.gg/player/11293/chukl9,2025-01-19 14:00:00,0.94,0.94,0.94,170,188,158,28,15,13,33,18,15,24,11,13,-1,-1,0,75%,65%,84%,114,119,109,28%,23%,34%,2,2,0,3,3,0
63,https://vlr.gg/player/39103/waken,2025-01-19 14:00:00,0.46,1.36,0.93,177,96,253,33,7,26,37,21,16,12,8,4,+1,-1,+2,67%,61%,72%,117,73,158,26%,29%,25%,4,0,4,3,1,2
64,https://vlr.gg/player/36402/kubfu,2025-01-19 14:00:00,0.34,1.06,0.72,152,74,218,24,6,18,35,19,16,7,4,3,0,-4,+4,56%,43%,68%,107,55,154,35%,30%,37%,5,0,5,5,4,1
65,https://vlr.gg/player/10448/kozok,2025-01-19 14:00:00,1.53,1.08,1.31,238,268,197,41,25,16,30,15,15,17,6,11,+3,+1,+2,79%,76%,83%,146,163,128,32%,46%,18%,5,2,3,2,1,1
66,https://vlr.gg/player/36748/czester,2025-01-19 14:00:00,0.69,1.79,1.22,216,159,283,35,11,24,27,19,8,21,9,12,-2,-4,+2,79%,68%,91%,147,114,183,43%,43%,42%,3,1,2,5,5,0
67,https://vlr.gg/player/9556/demek,2025-01-19 14:00:00,0.70,1.24,0.96,255,212,298,41,18,23,39,23,16,11,4,7,+5,+1,+4,63%,60%,65%,156,135,179,22%,23%,21%,12,6,6,7,5,2
68,https://vlr.gg/player/19505/szalony,2025-01-19 14:00:00,0.68,1.11,0.89,171,151,199,32,15,17,32,18,14,5,3,2,-1,-3,+2,69%,64%,74%,124,106,143,26%,25%,27%,4,0,4,5,3,2
69,https://vlr.gg/player/9557/nefi,2025-01-19 14:00:00,0.72,1.06,0.88,153,108,201,24,10,14,31,16,15,30,12,18,-3,-2,-1,75%,68%,83%,99,61,141,35%,33%,36%,1,0,1,4,2,2
70,https://vlr.gg/player/10885/davih,2025-01-19 13:15:00,1.23,1.37,1.31,249,243,246,49,21,28,39,19,20,25,13,12,+3,+2,+1,84%,78%,88%,168,157,176,20%,20%,21%,5,2,3,2,0,2
71,https://vlr.gg/player/1835/elllement,2025-01-19 13:15:00,1.08,1.30,1.20,251,215,265,53,20,33,39,20,19,11,8,3,0,-4,+4,72%,67%,76%,167,148,181,16%,11%,20%,10,3,7,10,7,3
72,https://vlr.gg/player/4329/vince,2025-01-19 13:15:00,1.63,0.61,1.06,189,279,117,41,29,12,38,16,22,32,14,18,+2,+1,+1,72%,81%,65%,122,185,72,14%,18%,8%,5,2,3,3,1,2
73,https://vlr.gg/player/314/ambi,2025-01-19 13:15:00,0.93,1.12,1.04,189,179,198,42,18,24,37,20,17,20,9,11,-1,-1,0,77%,70%,82%,120,110,127,29%,37%,24%,3,0,3,4,1,3
74,https://vlr.gg/player/9558/wolfen,2025-01-19 13:15:00,0.53,1.38,1.00,200,114,260,41,9,32,39,19,20,11,3,8,-3,-5,+2,67%,59%,74%,135,74,184,28%,25%,29%,8,3,5,11,8,3
75,https://vlr.gg/player/4969/shazeon,2025-01-19 13:15:00,1.16,0.82,1.01,218,233,186,46,27,19,47,27,20,17,10,7,-5,+1,-6,67%,74%,59%,144,164,120,36%,42%,28%,4,3,1,9,2,7
76,https://vlr.gg/player/35513/samed,2025-01-19 13:15:00,0.60,1.46,0.98,210,154,301,47,17,30,47,28,19,6,3,3,-2,-4,+2,62%,53%,74%,151,99,216,29%,24%,33%,7,4,3,9,8,1
77,https://vlr.gg/player/45490/ico,2025-01-19 13:15:00,1.02,0.88,0.96,197,211,197,42,26,16,47,27,20,21,9,12,+6,+1,+5,64%,53%,78%,130,124,137,23%,19%,29%,8,3,5,2,2,0
78,https://vlr.gg/player/22180/spmak,2025-01-19 13:15:00,0.94,0.81,0.88,152,159,158,32,17,15,41,23,18,20,16,4,-2,-3,+1,61%,59%,63%,102,103,102,17%,15%,19%,6,3,3,8,6,2
79,https://vlr.gg/player/7865/xanarchy,2025-01-19 13:15:00,0.68,0.79,0.73,120,92,163,25,11,14,44,24,20,25,18,7,+2,-3,+5,66%,71%,59%,78,58,103,21%,20%,23%,5,0,5,3,3,0
80,https://vlr.gg/player/4962/lurzy0y0,2025-01-19 13:05:00,1.36,0.97,1.22,237,249,216,16,11,5,14,8,6,5,5,0,-3,-2,-1,74%,92%,43%,152,155,146,38%,59%,17%,2,0,2,5,2,3
81,https://vlr.gg/player/40843/audaz,2025-01-19 13:05:00,1.01,0.52,0.83,202,228,160,13,10,3,17,10,7,5,4,1,0,0,0,74%,92%,43%,132,145,110,29%,31%,25%,0,0,0,0,0,0
82,https://vlr.gg/player/16552/pckwn,2025-01-19 13:05:00,0.64,0.49,0.58,139,147,126,6,4,2,15,9,6,3,3,0,-1,0,-1,53%,42%,71%,99,107,86,13%,15%,8%,2,2,0,3,2,1
83,https://vlr.gg/player/31855/celasun,2025-01-19 13:05:00,0.55,0.54,0.54,126,129,121,8,6,2,16,10,6,3,3,0,-2,-2,0,63%,75%,43%,85,84,87,43%,55%,30%,0,0,0,2,2,0
84,https://vlr.gg/player/39357/s0pp,2025-01-19 13:05:00,0.75,0.10,0.51,131,179,50,7,6,1,17,10,7,4,3,1,-1,0,-1,58%,75%,29%,79,106,33,21%,21%,20%,2,2,0,3,2,1
85,https://vlr.gg/player/10883/baransel,2025-01-19 13:05:00,1.64,1.40,1.49,209,222,203,15,6,9,8,2,6,10,5,5,0,-1,+1,84%,86%,83%,149,150,148,40%,33%,44%,2,0,2,2,1,1
86,https://vlr.gg/player/19776/jrayn,2025-01-19 13:05:00,1.85,1.27,1.48,294,276,305,21,7,14,9,1,8,5,3,2,+3,+2,+1,79%,100%,67%,171,157,180,41%,42%,41%,4,2,2,1,0,1
87,https://vlr.gg/player/13545/werlass,2025-01-19 13:05:00,1.41,0.90,1.09,147,173,132,11,5,6,8,1,7,4,1,3,-1,0,-1,89%,100%,83%,107,134,91,35%,40%,31%,0,0,0,1,0,1
88,https://vlr.gg/player/3549/touven,2025-01-19 13:05:00,1.32,0.93,1.08,211,323,146,15,9,6,11,5,6,4,2,2,+4,+2,+2,84%,86%,83%,126,185,91,35%,35%,36%,5,2,3,1,0,1
89,https://vlr.gg/player/10152/padisah,2025-01-19 13:05:00,0.96,1.11,1.06,245,179,284,17,5,12,14,4,10,4,1,3,+1,0,+1,79%,86%,75%,163,123,186,26%,23%,27%,2,1,1,1,1,0
90,https://vlr.gg/player/11516/drky,2025-01-19 12:00:00,1.53,1.55,1.54,266,243,293,21,11,10,13,7,6,11,6,5,-1,-1,0,86%,83%,90%,163,152,176,16%,15%,18%,0,0,0,1,1,0
91,https://vlr.gg/player/10114/baha,2025-01-19 12:00:00,0.68,1.18,0.91,185,146,234,15,6,9,15,8,7,3,1,2,-4,-3,-1,59%,67%,50%,123,102,148,32%,38%,28%,4,1,3,8,4,4
92,https://vlr.gg/player/12226/sturnn,2025-01-19 12:00:00,0.74,0.82,0.78,142,128,161,11,6,5,17,9,8,4,0,4,0,-1,+1,64%,50%,80%,95,92,100,20%,27%,15%,1,0,1,1,1,0
93,https://vlr.gg/player/21584/deminatix,2025-01-19 12:00:00,0.75,0.55,0.66,155,151,160,11,6,5,18,9,9,2,0,2,+1,+1,0,55%,58%,50%,108,99,118,28%,32%,25%,4,3,1,3,2,1
94,https://vlr.gg/player/16483/gloomy,2025-01-19 12:00:00,0.71,0.04,0.40,121,141,98,7,4,3,19,9,10,5,5,0,0,0,0,50%,67%,30%,87,108,62,18%,17%,18%,0,0,0,0,0,0
95,https://vlr.gg/player/10160/izzy,2025-01-19 12:00:00,1.62,1.28,1.44,257,295,226,21,11,10,12,5,7,3,2,1,+5,+3,+2,82%,90%,75%,158,171,147,46%,36%,58%,5,3,2,0,0,0
96,https://vlr.gg/player/12774/anima,2025-01-19 12:00:00,1.43,1.07,1.23,209,211,208,16,7,9,13,5,8,10,6,4,+1,0,+1,82%,100%,67%,137,138,136,42%,47%,38%,1,0,1,0,0,0
97,https://vlr.gg/player/10161/qutionerx,2025-01-19 12:00:00,1.39,0.99,1.17,244,327,176,19,11,8,14,9,5,2,2,0,+4,+1,+3,73%,70%,75%,164,226,112,21%,21%,20%,5,2,3,1,1,0
98,https://vlr.gg/player/10163/cyderx,2025-01-19 12:00:00,0.91,1.09,1.01,203,187,216,15,7,8,13,7,6,7,2,5,-2,-1,-1,77%,70%,83%,133,122,143,31%,53%,19%,1,0,1,3,1,2
99,https://vlr.gg/player/8041/brave,2025-01-19 12:00:00,0.61,0.82,0.73,138,116,157,11,4,7,13,6,7,5,4,1,-4,-3,-1,68%,50%,83%,97,75,115,37%,31%,41%,1,0,1,5,3,2
100,https://vlr.gg/player/114/enzo,2025-01-19 11:00:00,0.98,1.33,1.17,230,221,237,46,21,25,41,23,18,18,6,12,+4,+1,+3,73%,70%,75%,150,149,151,15%,22%,10%,10,4,6,6,3,3
101,https://vlr.gg/player/3582/keloqz,2025-01-19 11:00:00,0.97,1.26,1.12,215,192,243,47,20,27,43,21,22,13,4,9,+3,+2,+1,71%,70%,72%,148,127,169,28%,28%,29%,9,5,4,6,3,3
102,https://vlr.gg/player/1284/mikee,2025-01-19 11:00:00,1.33,0.61,0.95,178,211,147,38,23,15,43,18,25,19,11,8,-6,0,-6,65%,73%,56%,120,134,108,26%,30%,23%,4,3,1,10,3,7
103,https://vlr.gg/player/13258/cyvoph,2025-01-19 11:00:00,0.75,1.09,0.92,177,153,198,37,16,21,46,24,22,19,7,12,+1,-1,+2,65%,63%,66%,122,106,137,20%,16%,24%,6,3,3,5,4,1
104,https://vlr.gg/player/113/hyp,2025-01-19 11:00:00,0.76,0.98,0.87,167,165,169,39,17,22,45,23,22,9,4,5,-4,-2,-2,66%,63%,69%,116,114,118,22%,23%,20%,1,0,1,5,2,3
105,https://vlr.gg/player/39718/rouss,2025-01-19 11:00:00,1.10,1.16,1.13,212,195,228,49,24,25,38,19,19,13,6,7,0,-1,+1,77%,81%,73%,146,137,156,41%,44%,39%,3,1,2,3,2,1
106,https://vlr.gg/player/31058/kpro,2025-01-19 11:00:00,1.20,1.02,1.11,198,220,176,47,27,20,38,21,17,24,12,12,+3,0,+3,77%,78%,77%,121,133,108,35%,35%,35%,8,3,5,5,3,2
107,https://vlr.gg/player/4307/hyperzxz,2025-01-19 11:00:00,0.98,0.93,0.96,228,214,238,49,24,25,48,24,24,16,7,9,-1,+2,-3,65%,69%,60%,146,144,149,27%,26%,29%,9,6,3,10,4,6
108,https://vlr.gg/player/26809/tenshi,2025-01-19 11:00:00,0.51,1.24,0.86,178,133,225,38,14,24,45,26,19,25,8,17,+2,-1,+3,71%,78%,63%,113,89,138,42%,39%,45%,7,3,4,5,4,1
109,https://vlr.gg/player/26837/poegii,2025-01-19 11:00:00,0.99,0.70,0.85,155,184,128,35,20,15,38,20,18,10,5,5,-2,+2,-4,66%,66%,67%,106,120,91,19%,21%,16%,5,4,1,7,2,5
110,https://vlr.gg/player/6101/999kvmil,2025-01-19 11:00:00,1.31,1.07,1.19,218,234,218,49,24,25,40,16,24,17,12,5,+5,+4,+1,78%,93%,63%,138,147,129,18%,27%,11%,6,4,2,1,0,1
111,https://vlr.gg/player/13024/vuubit,2025-01-19 11:00:00,1.15,1.03,1.09,251,270,227,53,29,24,46,21,25,16,6,10,0,+1,-1,76%,82%,70%,159,185,134,45%,42%,48%,6,3,3,6,2,4
112,https://vlr.gg/player/12471/kalkkuna,2025-01-19 11:00:00,0.74,1.16,0.96,216,195,243,44,19,25,43,21,22,12,5,7,+1,+1,0,69%,71%,67%,137,118,155,21%,21%,21%,12,7,5,11,6,5
113,https://vlr.gg/player/8440/puggy,2025-01-19 11:00:00,0.86,0.84,0.85,146,151,144,29,14,15,39,18,21,20,11,9,-3,-1,-2,69%,71%,67%,104,111,97,26%,28%,25%,3,1,2,6,2,4
114,https://vlr.gg/player/15491/maximn,2025-01-19 11:00:00,0.95,0.63,0.78,137,164,115,28,18,10,37,17,20,13,4,9,-1,+1,-2,72%,82%,63%,93,103,83,23%,37%,16%,3,2,1,4,1,3
115,https://vlr.gg/player/1848/incredible,2025-01-19 11:00:00,1.39,0.86,1.14,205,246,170,42,27,15,41,18,23,25,13,12,-1,+3,-4,76%,87%,64%,141,158,124,22%,21%,23%,5,4,1,6,1,5
116,https://vlr.gg/player/11330/mcd,2025-01-19 11:00:00,1.15,1.09,1.12,230,221,234,48,26,22,38,18,20,12,6,6,-2,+3,-5,69%,80%,57%,152,142,163,35%,42%,30%,6,5,1,8,2,6
117,https://vlr.gg/player/10270/dev0,2025-01-19 11:00:00,0.93,0.99,0.95,172,170,185,39,19,20,41,20,21,21,13,8,-1,-1,0,76%,80%,71%,120,123,117,38%,30%,47%,3,0,3,4,1,3
118,https://vlr.gg/player/2617/leare,2025-01-19 11:00:00,1.03,0.84,0.93,221,257,168,42,26,16,45,23,22,11,8,3,+1,0,+1,71%,77%,64%,138,162,112,20%,22%,17%,9,5,4,8,5,3
119,https://vlr.gg/player/8838/chanformer,2025-01-19 11:00:00,0.60,1.17,0.87,160,118,201,34,14,20,38,20,18,17,7,10,+1,-1,+2,78%,77%,79%,94,60,131,24%,26%,24%,5,3,2,4,4,0
120,https://vlr.gg/player/47270/darkwinjett,2025-01-19 11:00:00,2.40,0.42,1.74,288,393,78,20,18,2,10,5,5,12,8,4,-1,+1,-2,83%,92%,67%,178,242,50,25%,24%,33%,1,1,0,2,0,2
121,https://vlr.gg/player/27789/deyten,2025-01-19 11:00:00,1.48,1.78,1.62,272,259,312,46,25,21,24,12,12,19,13,6,+3,+1,+2,85%,96%,72%,178,152,213,39%,32%,48%,3,1,2,0,0,0
122,https://vlr.gg/player/18384/bully,2025-01-19 11:00:00,1.37,0.88,1.15,215,223,183,30,19,11,23,10,13,9,5,4,+2,+4,-2,83%,87%,78%,137,147,125,20%,23%,18%,4,4,0,2,0,2
123,https://vlr.gg/player/3934/eleo,2025-01-19 11:00:00,1.04,1.07,1.05,159,142,187,22,10,12,22,11,11,16,13,3,+2,+2,0,93%,91%,94%,110,101,122,25%,27%,24%,3,2,1,1,0,1
124,https://vlr.gg/player/2635/mts,2025-01-19 11:00:00,1.07,0.88,0.97,128,182,79,10,6,4,13,6,7,15,10,5,-3,-2,-1,87%,91%,83%,82,109,57,33%,28%,44%,0,0,0,3,2,1
125,https://vlr.gg/player/33974/appa,2025-01-19 11:00:00,0.81,0.80,0.81,230,246,195,32,21,11,35,20,15,6,4,2,+4,+1,+3,80%,83%,78%,135,143,125,30%,37%,19%,12,7,5,8,6,2
126,https://vlr.gg/player/1620/ale,2025-01-19 11:00:00,1.34,0.72,0.99,202,234,169,28,16,12,31,11,20,12,3,9,-1,0,-1,71%,78%,65%,130,147,117,22%,28%,17%,7,3,4,8,3,5
127,https://vlr.gg/player/23198/wak1e,2025-01-19 11:00:00,0.79,0.98,0.90,184,153,217,30,9,21,32,12,20,16,5,11,+2,+2,0,66%,67%,65%,120,102,133,27%,24%,28%,2,2,0,0,0,0
128,https://vlr.gg/player/15080/f1co,2025-01-19 11:00:00,0.97,0.52,0.72,164,184,155,25,12,13,33,12,21,8,4,4,-3,-2,-1,59%,67%,52%,114,122,108,32%,44%,24%,2,1,1,5,3,2
129,https://vlr.gg/player/23197/knowbii,2025-01-19 11:00:00,0.72,0.71,0.71,154,125,168,23,8,15,32,12,20,12,4,8,-2,+2,-4,68%,67%,70%,99,76,118,23%,22%,24%,3,2,1,5,0,5
130,https://vlr.gg/player/19058/folke,2025-01-19 11:00:00,0.64,0.71,0.67,122,114,134,21,8,13,32,13,19,4,1,3,-3,-2,-1,68%,83%,57%,78,68,86,24%,31%,20%,2,0,2,5,2,3
131,https://vlr.gg/player/18400/bipo,2025-01-19 11:00:00,0.81,1.89,1.40,296,222,356,45,15,30,28,17,11,10,1,9,+2,0,+2,80%,65%,92%,186,143,221,26%,20%,29%,9,4,5,7,4,3
132,https://vlr.gg/player/10338/lime,2025-01-19 11:00:00,1.30,1.09,1.19,221,241,206,34,17,17,27,13,14,14,3,11,-2,0,-2,73%,60%,83%,160,175,147,41%,46%,36%,2,1,1,4,1,3
133,https://vlr.gg/player/7660/fizzy,2025-01-19 11:00:00,1.19,1.11,1.15,207,231,186,34,16,18,26,14,12,3,2,1,-3,-3,0,68%,65%,71%,151,177,130,39%,41%,38%,3,1,2,6,4,2
134,https://vlr.gg/player/3674/iluri,2025-01-19 11:00:00,0.87,1.26,1.08,169,140,194,26,10,16,26,14,12,33,11,22,0,-1,+1,75%,60%,88%,108,102,113,27%,26%,28%,3,1,2,3,2,1
135,https://vlr.gg/player/3753/obnoks,2025-01-19 11:00:00,0.71,1.01,0.88,213,183,236,34,13,21,35,18,17,21,8,13,-3,-2,-1,73%,70%,75%,138,127,147,39%,44%,35%,2,0,2,5,2,3
136,https://vlr.gg/player/27954/movi,2025-01-19 11:00:00,1.43,1.23,1.34,214,200,233,35,18,17,30,16,14,13,9,4,+1,+2,-1,70%,63%,80%,144,127,166,23%,19%,29%,3,2,1,2,0,2
137,https://vlr.gg/player/27813/zery,2025-01-19 11:00:00,0.65,1.36,0.97,220,173,280,36,14,22,37,22,15,4,2,2,+2,0,+2,64%,54%,75%,138,112,169,21%,20%,21%,9,5,4,7,5,2
138,https://vlr.gg/player/39062/terrox,2025-01-19 11:00:00,0.62,0.99,0.79,185,164,211,28,12,16,34,21,13,9,5,4,+2,0,+2,61%,58%,65%,119,112,128,40%,39%,41%,3,1,2,1,1,0
139,https://vlr.gg/player/15382/kongi,2025-01-19 11:00:00,0.50,0.99,0.72,144,116,173,20,9,11,36,22,14,22,8,14,+1,-1,+2,64%,54%,75%,92,77,109,25%,23%,27%,4,1,3,3,2,1
140,https://vlr.gg/player/12514/spocki,2025-01-19 11:00:00,0.69,0.65,0.68,160,170,152,23,13,10,36,21,15,16,9,7,0,-1,+1,57%,50%,65%,99,107,90,24%,19%,33%,6,3,3,6,4,2
141,https://vlr.gg/player/18655/best,2025-01-19 10:30:00,1.27,1.34,1.30,279,278,280,38,19,19,25,12,13,2,2,0,+5,+1,+4,61%,63%,58%,165,163,168,34%,31%,39%,10,4,6,5,3,2
142,https://vlr.gg/player/15735/krostaly,2025-01-19 10:30:00,0.87,1.13,1.00,199,166,233,22,8,14,27,13,14,26,18,8,0,-1,+1,82%,84%,79%,125,97,153,27%,19%,33%,4,2,2,4,3,1
143,https://vlr.gg/player/40842/ibonata,2025-01-19 10:30:00,1.25,0.64,0.94,177,219,137,22,15,7,26,11,15,13,8,5,0,-2,+2,74%,74%,74%,118,136,100,33%,33%,32%,3,1,2,3,3,0
144,https://vlr.gg/player/33551/slaughter,2025-01-19 10:30:00,0.76,0.95,0.85,139,100,178,18,6,12,25,11,14,14,9,5,-3,-1,-2,71%,63%,79%,93,68,118,33%,15%,46%,0,0,0,3,1,2
145,https://vlr.gg/player/31307/yigox,2025-01-19 10:30:00,0.92,0.75,0.83,184,186,182,25,13,12,29,13,16,3,3,0,0,0,0,66%,74%,58%,125,121,128,50%,58%,43%,3,1,2,3,1,2
146,https://vlr.gg/player/10146/reazy,2025-01-19 10:30:00,1.06,1.33,1.20,254,246,263,36,18,18,26,13,13,7,4,3,0,-3,+3,68%,68%,68%,168,156,179,42%,36%,49%,4,0,4,4,3,1
147,https://vlr.gg/player/568/turko,2025-01-19 10:30:00,1.46,0.77,1.11,211,274,149,28,18,10,24,11,13,11,8,3,0,+2,-2,68%,89%,47%,137,175,98,32%,29%,39%,3,2,1,3,0,3
148,https://vlr.gg/player/50775/lava,2025-01-19 10:30:00,1.07,1.00,1.03,182,215,151,25,15,10,24,13,11,5,4,1,0,-2,+2,74%,74%,74%,122,136,107,30%,32%,27%,2,0,2,2,2,0
149,https://vlr.gg/player/3862/deepmans,2025-01-19 10:30:00,0.96,0.94,0.95,221,223,220,28,14,14,27,14,13,5,3,2,-1,-1,0,63%,63%,63%,141,143,139,27%,26%,28%,6,4,2,7,5,2
150,https://vlr.gg/player/569/paura,2025-01-19 10:30:00,0.76,0.92,0.84,132,117,149,15,7,8,25,13,12,26,17,9,-1,-1,0,76%,79%,74%,84,75,93,29%,40%,22%,3,1,2,4,2,2
151,https://vlr.gg/player/10125/qw1,2025-01-19 09:30:00,1.62,1.45,1.55,320,328,310,25,16,9,14,8,6,1,1,0,-1,-1,0,75%,75%,75%,209,213,202,36%,54%,17%,3,2,1,4,3,1
152,https://vlr.gg/player/1399/sterben,2025-01-19 09:30:00,0.99,0.52,0.80,148,170,116,10,7,3,14,8,6,6,4,2,0,0,0,80%,83%,75%,106,123,81,14%,12%,20%,1,1,0,1,1,0
153,https://vlr.gg/player/6559/destruct1vee,2025-01-19 09:30:00,1.30,0.03,0.78,154,192,99,10,8,2,14,7,7,10,8,2,-2,+1,-3,55%,67%,38%,106,138,59,25%,29%,18%,1,1,0,3,0,3
154,https://vlr.gg/player/3604/mojj,2025-01-19 09:30:00,0.73,0.82,0.77,161,146,185,11,6,5,16,9,7,4,3,1,-2,0,-2,50%,42%,63%,106,84,139,30%,17%,56%,1,1,0,3,1,2
155,https://vlr.gg/player/7353/glovee,2025-01-19 09:30:00,0.62,0.43,0.54,159,159,161,9,5,4,20,12,8,14,13,1,-3,-2,-1,65%,75%,50%,113,113,113,16%,11%,24%,0,0,0,3,2,1
156,https://vlr.gg/player/13571/musz3kk,2025-01-19 09:30:00,1.30,1.28,1.29,280,273,285,20,8,12,14,5,9,2,0,2,+5,+2,+3,80%,88%,75%,183,176,188,20%,22%,19%,6,2,4,1,0,1
157,https://vlr.gg/player/40841/kabzi,2025-01-19 09:30:00,1.01,1.44,1.27,252,196,290,19,6,13,14,5,9,3,2,1,+2,+1,+1,75%,88%,67%,138,108,159,27%,19%,31%,2,1,1,0,0,0
158,https://vlr.gg/player/5500/docent,2025-01-19 09:30:00,1.65,0.68,1.07,198,232,176,12,7,5,12,3,9,13,4,9,-2,0,-2,95%,100%,92%,140,142,138,26%,38%,20%,0,0,0,2,0,2
159,https://vlr.gg/player/50776/influx,2025-01-19 09:30:00,1.64,0.57,1.00,180,299,101,13,8,5,12,4,8,5,2,3,+3,+3,0,75%,75%,75%,107,180,58,16%,21%,10%,5,4,1,2,1,1
160,https://vlr.gg/player/4894/jn3v1ce,2025-01-19 09:30:00,0.70,1.18,0.99,178,143,202,14,5,9,13,6,7,5,3,2,0,0,0,95%,100%,92%,134,93,162,26%,7%,38%,1,0,1,1,0,1
161,https://vlr.gg/player/41054/guang,2025-01-19 06:15:00,,,,258,,,62,,,40,,,7,,,,,,,,,,,,,,,,,,,,
162,https://vlr.gg/player/1209/swerl,2025-01-19 06:15:00,,,,227,,,54,,,39,,,11,,,,,,,,,,,,,,,,,,,,
163,https://vlr.gg/player/39697/cb,2025-01-19 06:15:00,,,,195,,,42,,,47,,,18,,,,,,,,,,,,,,,,,,,,
164,https://vlr.gg/player/46460/ezeir,2025-01-19 06:15:00,,,,187,,,40,,,43,,,28,,,,,,,,,,,,,,,,,,,,
165,https://vlr.gg/player/4402/o0o0o,2025-01-19 06:15:00,,,,161,,,36,,,45,,,33,,,,,,,,,,,,,,,,,,,,
166,https://vlr.gg/player/11218/yuicaw,2025-01-19 06:15:00,,,,209,,,44,,,49,,,26,,,,,,,,,,,,,,,,,,,,
167,https://vlr.gg/player/37489/lysoar,2025-01-19 06:15:00,,,,204,,,44,,,50,,,9,,,,,,,,,,,,,,,,,,,,
168,https://vlr.gg/player/14125/spring,2025-01-19 06:15:00,,,,201,,,44,,,47,,,10,,,,,,,,,,,,,,,,,,,,
169,https://vlr.gg/player/7426/juicy,2025-01-19 06:15:00,,,,175,,,40,,,48,,,30,,,,,,,,,,,,,,,,,,,,
170,https://vlr.gg/player/7849/siufatbb,2025-01-19 06:15:00,,,,158,,,37,,,40,,,8,,,,,,,,,,,,,,,,,,,,
171,https://vlr.gg/player/6672/meiy,2025-01-19 06:00:00,1.12,1.03,1.06,205,250,212,49,21,28,46,16,30,6,1,5,+1,+2,-1,67%,62%,70%,145,163,135,39%,43%,36%,8,4,4,7,2,5
172,https://vlr.gg/player/4052/jinboong,2025-01-19 06:00:00,0.73,0.86,0.81,162,185,160,35,15,20,41,16,25,5,0,5,-4,-1,-3,64%,57%,68%,113,109,115,34%,52%,26%,4,2,2,8,3,5
173,https://vlr.gg/player/13002/akame,2025-01-19 06:00:00,0.75,0.78,0.76,187,169,189,36,12,24,49,17,32,14,5,9,-4,+1,-5,72%,76%,70%,121,109,127,38%,30%,44%,4,3,1,8,2,6
174,https://vlr.gg/player/10627/art,2025-01-19 06:00:00,0.56,0.83,0.73,173,123,206,33,9,24,46,15,31,11,2,9,-3,-2,-1,60%,67%,57%,112,78,131,19%,14%,23%,4,1,3,7,3,4
175,https://vlr.gg/player/48577/gyen,2025-01-19 06:00:00,1.07,0.47,0.69,149,207,112,28,16,12,45,14,31,20,8,12,-2,+1,-3,62%,67%,59%,101,129,85,26%,31%,22%,3,1,2,5,0,5
176,https://vlr.gg/player/24895/jemkin,2025-01-19 06:00:00,1.34,1.92,1.55,330,301,352,70,42,28,39,26,13,8,4,4,+9,+7,+2,78%,76%,81%,201,201,202,28%,32%,22%,16,12,4,7,5,2
177,https://vlr.gg/player/4866/kushy,2025-01-19 06:00:00,1.33,1.35,1.34,230,222,241,48,31,17,32,19,13,16,10,6,+3,+2,+1,79%,76%,86%,154,156,151,39%,32%,55%,4,2,2,1,0,1
178,https://vlr.gg/player/25025/estrella,2025-01-19 06:00:00,1.21,0.65,1.01,167,173,160,34,23,11,35,17,18,30,19,11,-2,0,-2,79%,86%,67%,112,117,104,22%,32%,10%,5,3,2,7,3,4
179,https://vlr.gg/player/8497/monyet,2025-01-19 06:00:00,1.23,0.58,1.00,178,218,104,38,31,7,38,23,15,29,17,12,0,+1,-1,79%,89%,62%,113,137,70,39%,40%,36%,4,4,0,4,3,1
180,https://vlr.gg/player/4871/xffero,2025-01-19 06:00:00,0.88,1.12,0.97,173,164,186,37,22,15,37,23,14,17,9,8,+2,+3,-1,81%,76%,90%,117,105,140,34%,39%,30%,6,4,2,4,1,3
181,https://vlr.gg/player/3741/vo0kashu,2025-01-19 04:00:00,,,,238,,,37,,,24,,,9,,,,,,,,,,,,,,,,,,,,
182,https://vlr.gg/player/4705/flex1n,2025-01-19 04:00:00,,,,225,,,35,,,26,,,17,,,,,,,,,,,,,,,,,,,,
183,https://vlr.gg/player/11524/nicc,2025-01-19 04:00:00,,,,212,,,31,,,30,,,28,,,,,,,,,,,,,,,,,,,,
184,https://vlr.gg/player/7841/tvirusluke,2025-01-19 04:00:00,,,,178,,,29,,,28,,,9,,,,,,,,,,,,,,,,,,,,
185,https://vlr.gg/player/31753/spiritz1,2025-01-19 04:00:00,,,,177,,,25,,,31,,,10,,,,,,,,,,,,,,,,,,,,
186,https://vlr.gg/player/7135/hfmi0dzjc9z7,2025-01-19 04:00:00,,,,231,,,29,,,32,,,13,,,,,,,,,,,,,,,,,,,,
187,https://vlr.gg/player/41739/slowly,2025-01-19 04:00:00,,,,193,,,31,,,32,,,11,,,,,,,,,,,,,,,,,,,,
188,https://vlr.gg/player/3547/ninebody,2025-01-19 04:00:00,,,,192,,,27,,,29,,,8,,,,,,,,,,,,,,,,,,,,
189,https://vlr.gg/player/47101/5cm,2025-01-19 04:00:00,,,,183,,,26,,,33,,,14,,,,,,,,,,,,,,,,,,,,
190,https://vlr.gg/player/14444/eren,2025-01-19 04:00:00,,,,167,,,26,,,31,,,12,,,,,,,,,,,,,,,,,,,,
191,https://vlr.gg/player/13219/papi,2025-01-19 03:00:00,1.36,1.10,1.23,197,205,192,41,22,19,31,15,16,18,11,7,+5,+4,+1,73%,75%,70%,128,128,127,40%,40%,39%,5,4,1,0,0,0
192,https://vlr.gg/player/5796/kr1stal,2025-01-19 03:00:00,1.28,1.01,1.15,218,223,216,40,22,18,35,16,19,17,8,9,-2,-2,0,73%,75%,70%,153,157,148,28%,31%,24%,6,1,5,8,3,5
193,https://vlr.gg/player/9152/deryeon,2025-01-19 03:00:00,1.02,0.90,0.96,157,179,137,33,19,14,32,16,16,11,3,8,-5,-1,-4,73%,68%,78%,107,119,94,23%,18%,28%,1,1,0,6,2,4
194,https://vlr.gg/player/4428/udotan,2025-01-19 03:00:00,0.51,1.42,0.93,211,138,298,42,13,29,44,24,20,6,3,3,+1,-1,+2,67%,64%,70%,132,91,174,25%,30%,23%,11,6,5,10,7,3
195,https://vlr.gg/player/7437/kellys,2025-01-19 03:00:00,0.78,0.92,0.85,184,170,203,33,15,18,45,22,23,23,10,13,-2,0,-2,67%,68%,67%,124,116,132,22%,18%,26%,3,2,1,5,2,3
196,https://vlr.gg/player/7405/jremy,2025-01-19 03:00:00,1.30,1.02,1.16,271,303,231,52,28,24,38,21,17,4,3,1,+7,+7,0,64%,63%,64%,161,186,137,27%,31%,23%,14,10,4,7,3,4
197,https://vlr.gg/player/2334/jessievash,2025-01-19 03:00:00,0.97,1.02,0.99,197,186,213,39,19,20,39,19,20,15,9,6,-4,-2,-2,65%,74%,57%,141,135,147,42%,48%,37%,2,1,1,6,3,3
198,https://vlr.gg/player/9735/2ge,2025-01-19 03:00:00,0.97,0.83,0.90,179,189,159,33,19,14,37,18,19,19,9,10,+2,+1,+1,75%,70%,79%,104,113,95,14%,11%,16%,8,3,5,6,2,4
199,https://vlr.gg/player/9740/wild0reoo,2025-01-19 03:00:00,0.61,1.10,0.86,171,129,219,32,11,21,37,19,18,12,8,4,0,-2,+2,73%,59%,86%,120,92,147,32%,20%,43%,3,1,2,3,3,0
200,https://vlr.gg/player/8504/invy,2025-01-19 03:00:00,0.84,0.82,0.83,163,175,147,31,17,14,38,21,17,23,13,10,-2,-1,-1,82%,81%,82%,101,110,93,27%,27%,28%,2,0,2,4,1,3
201,https://vlr.gg/player/1265/johnqt,2025-01-18 19:25:00,1.33,1.36,1.34,225,246,198,51,30,21,36,22,14,15,13,2,+3,+3,0,80%,76%,85%,143,153,131,27%,25%,28%,3,3,0,0,0,0
202,https://vlr.gg/player/36245/n4rrate,2025-01-18 19:25:00,1.27,0.86,1.09,212,244,179,45,30,15,46,25,21,30,19,11,+4,+2,+2,79%,85%,70%,149,166,128,26%,24%,28%,5,3,2,1,1,0
203,https://vlr.gg/player/4004/zekken,2025-01-18 19:25:00,0.88,1.24,1.04,217,215,226,48,25,23,44,28,16,14,11,3,0,-1,+1,80%,82%,78%,144,150,136,15%,19%,9%,14,7,7,14,8,6
204,https://vlr.gg/player/3880/bang,2025-01-18 19:25:00,0.99,0.95,0.97,188,202,177,42,26,16,42,24,18,18,11,7,-1,0,-1,79%,82%,74%,129,144,110,32%,33%,31%,5,3,2,6,3,3
205,https://vlr.gg/player/729/zellsis,2025-01-18 19:25:00,1.09,0.60,0.87,164,179,140,32,21,11,41,21,20,20,15,5,-3,-2,-1,74%,76%,70%,105,114,94,27%,25%,32%,5,2,3,8,4,4
206,https://vlr.gg/player/4147/cryocells,2025-01-18 19:25:00,1.36,1.17,1.25,247,253,230,53,26,27,42,15,27,18,4,14,+3,+4,-1,80%,85%,76%,160,168,155,37%,47%,30%,10,7,3,7,3,4
207,https://vlr.gg/player/796/eeiu,2025-01-18 19:25:00,0.84,1.00,0.93,195,154,218,42,16,26,44,18,26,26,9,17,-3,-2,-1,75%,74%,76%,132,118,143,41%,38%,43%,2,1,1,5,3,2
208,https://vlr.gg/player/601/asuna,2025-01-18 19:25:00,0.72,1.08,0.92,225,191,253,47,15,32,49,21,28,13,8,5,-2,-1,-1,70%,78%,65%,142,136,147,17%,21%,15%,9,2,7,11,3,8
209,https://vlr.gg/player/8082/zander,2025-01-18 19:25:00,1.26,0.62,0.90,158,204,126,32,19,13,37,13,24,22,9,13,-2,0,-2,72%,78%,68%,99,127,77,20%,22%,17%,3,1,2,5,1,4
210,https://vlr.gg/player/604/boostio,2025-01-18 19:25:00,0.68,0.73,0.71,159,147,167,34,13,21,46,19,27,16,7,9,+1,-2,+3,64%,63%,65%,103,99,106,20%,21%,20%,5,2,3,4,4,0
211,https://vlr.gg/player/2462/keznit,2025-01-18 17:00:00,0.72,1.70,1.16,222,146,326,37,15,22,28,18,10,6,1,5,0,-3,+3,74%,58%,95%,141,87,210,25%,26%,25%,8,5,3,8,8,0
212,https://vlr.gg/player/24007/shyy,2025-01-18 17:00:00,1.14,1.17,1.15,197,208,185,31,18,13,28,17,11,9,3,6,+2,0,+2,74%,75%,74%,125,134,115,37%,39%,33%,3,1,2,1,1,0
213,https://vlr.gg/player/1311/melser,2025-01-18 17:00:00,0.75,0.82,0.78,142,131,157,19,9,10,28,18,10,12,9,3,+1,+1,0,65%,63%,68%,92,85,100,33%,38%,29%,4,1,3,3,0,3
214,https://vlr.gg/player/3826/adverso,2025-01-18 17:00:00,0.55,0.84,0.68,131,114,156,20,9,11,33,20,13,6,4,2,+1,+1,0,63%,58%,68%,97,82,117,27%,17%,40%,3,2,1,2,1,1
215,https://vlr.gg/player/7603/mazino,2025-01-18 17:00:00,0.66,0.64,0.65,168,163,184,25,12,13,35,20,15,10,8,2,-3,-1,-2,60%,67%,53%,117,107,129,30%,20%,43%,4,2,2,7,3,4
216,https://vlr.gg/player/8873/dgzin,2025-01-18 17:00:00,0.57,1.79,1.25,232,137,307,37,9,28,23,14,9,6,2,4,+1,-2,+3,74%,47%,96%,145,92,187,20%,33%,15%,7,3,4,6,5,1
217,https://vlr.gg/player/683/pancada,2025-01-18 17:00:00,1.37,0.85,1.08,187,249,137,29,17,12,24,12,12,5,3,2,0,+1,-1,74%,74%,75%,119,140,103,46%,52%,41%,4,3,1,4,2,2
218,https://vlr.gg/player/1586/v1nny,2025-01-18 17:00:00,1.15,0.94,1.03,178,187,172,29,14,15,27,12,15,15,7,8,-2,0,-2,79%,79%,79%,122,117,125,37%,43%,33%,2,0,2,4,0,4
219,https://vlr.gg/player/2408/tuyz,2025-01-18 17:00:00,0.89,1.09,1.00,191,176,201,26,10,16,29,16,13,15,8,7,-2,0,-2,70%,58%,79%,133,128,137,26%,35%,20%,3,1,2,5,1,4
220,https://vlr.gg/player/6193/cauanzin,2025-01-18 17:00:00,0.58,1.31,0.99,208,126,266,31,9,22,29,15,14,8,2,6,+2,-2,+4,70%,53%,83%,130,78,171,28%,20%,30%,5,1,4,3,3,0
221,https://vlr.gg/player/38840/lamelly,2025-01-18 15:25:00,1.23,1.07,1.16,171,183,159,38,21,17,39,20,19,37,23,14,-2,-1,-1,77%,79%,73%,105,116,93,34%,34%,33%,4,1,3,6,2,4
222,https://vlr.gg/player/50186/qu1ckz,2025-01-18 15:25:00,0.92,1.21,1.06,214,192,240,47,24,23,48,26,22,20,12,8,+3,0,+3,70%,74%,67%,142,133,153,34%,32%,36%,4,1,3,1,1,0
223,https://vlr.gg/player/11332/ara,2025-01-18 15:25:00,0.72,1.08,0.89,184,181,188,42,22,20,47,27,20,12,4,8,-3,-4,+1,67%,62%,73%,120,114,128,31%,28%,35%,11,5,6,14,9,5
224,https://vlr.gg/player/29634/cintyx,2025-01-18 15:25:00,0.99,0.68,0.85,163,200,122,37,25,12,47,26,21,13,5,8,-1,0,-1,66%,76%,53%,116,140,89,31%,41%,20%,3,1,2,4,1,3
225,https://vlr.gg/player/33292/martux,2025-01-18 15:25:00,0.62,0.94,0.77,193,187,204,40,21,19,53,30,23,20,10,10,-1,-1,0,69%,71%,67%,119,109,131,21%,27%,17%,8,6,2,9,7,2
226,https://vlr.gg/player/9556/demek,2025-01-18 15:25:00,0.90,1.53,1.23,269,228,308,61,23,38,44,22,22,11,4,7,+6,+1,+5,75%,67%,82%,170,146,192,16%,15%,17%,11,5,6,5,4,1
227,https://vlr.gg/player/10448/kozok,2025-01-18 15:25:00,1.30,0.90,1.09,194,215,178,46,24,22,39,15,24,28,15,13,-2,0,-2,80%,80%,79%,128,144,113,26%,25%,28%,3,1,2,5,1,4
228,https://vlr.gg/player/19505/szalony,2025-01-18 15:25:00,1.10,1.09,1.09,203,204,202,51,24,27,38,17,21,5,0,5,+1,-1,+2,70%,73%,68%,128,130,126,19%,19%,20%,7,2,5,6,3,3
229,https://vlr.gg/player/9557/nefi,2025-01-18 15:25:00,0.83,1.09,0.97,165,114,210,33,11,22,39,16,23,43,18,25,-2,-2,0,78%,70%,85%,104,72,133,38%,37%,39%,2,0,2,4,2,2
230,https://vlr.gg/player/36748/czester,2025-01-18 15:25:00,0.97,0.93,0.95,201,221,184,43,23,20,44,21,23,19,8,11,+1,0,+1,72%,73%,71%,133,139,128,30%,40%,23%,11,6,5,10,6,4
231,https://vlr.gg/player/15384/mot1on,2025-01-18 15:05:00,1.14,0.85,1.01,209,220,197,28,17,11,29,14,15,13,8,5,+5,+1,+4,74%,75%,72%,139,152,125,41%,37%,47%,6,2,4,1,1,0
232,https://vlr.gg/player/12103/limpe,2025-01-18 15:05:00,1.21,0.56,0.90,236,294,169,31,22,9,33,17,16,10,6,4,0,+1,-1,66%,75%,56%,151,183,115,37%,37%,36%,4,2,2,4,1,3
233,https://vlr.gg/player/2096/knightvoice,2025-01-18 15:05:00,1.00,0.58,0.80,184,211,153,24,15,9,32,15,17,11,6,5,+2,+2,0,68%,75%,61%,121,139,100,29%,41%,16%,2,2,0,0,0,0
234,https://vlr.gg/player/10403/jaf,2025-01-18 15:05:00,1.16,0.31,0.73,140,189,89,21,15,6,28,12,16,7,5,2,-4,-2,-2,61%,75%,44%,88,111,62,38%,44%,27%,2,1,1,6,3,3
235,https://vlr.gg/player/16436/maik,2025-01-18 15:05:00,0.18,0.87,0.47,135,67,216,18,4,14,33,17,16,4,3,1,-5,-6,+1,55%,45%,67%,91,49,137,31%,13%,42%,4,1,3,9,7,2
236,https://vlr.gg/player/15491/maximn,2025-01-18 15:05:00,1.45,1.16,1.30,226,214,235,32,15,17,22,7,15,8,3,5,+2,-1,+3,76%,94%,60%,143,133,152,21%,27%,18%,5,1,4,3,2,1
237,https://vlr.gg/player/8440/puggy,2025-01-18 15:05:00,1.37,1.20,1.28,202,189,218,26,12,14,22,8,14,21,10,11,0,0,0,84%,89%,80%,145,141,150,35%,33%,38%,2,1,1,2,1,1
238,https://vlr.gg/player/13024/vuubit,2025-01-18 15:05:00,1.53,1.01,1.26,249,310,198,35,20,15,26,12,14,16,10,6,+1,+2,-1,76%,83%,70%,163,198,132,35%,35%,35%,5,3,2,4,1,3
239,https://vlr.gg/player/6101/999kvmil,2025-01-18 15:05:00,1.48,1.03,1.24,220,224,218,32,17,15,21,7,14,15,9,6,0,0,0,82%,94%,70%,127,129,124,27%,38%,20%,2,1,1,2,1,1
240,https://vlr.gg/player/12471/kalkkuna,2025-01-18 15:05:00,0.96,0.89,0.92,228,246,207,30,16,14,31,15,16,9,5,4,-1,-3,+2,74%,83%,65%,144,162,128,23%,19%,29%,6,2,4,7,5,2
241,https://vlr.gg/player/23197/knowbii,2025-01-18 15:00:00,1.30,1.67,1.48,236,212,267,34,16,18,20,10,10,21,10,11,0,+1,-1,82%,85%,79%,145,131,160,21%,25%,18%,5,4,1,5,3,2
242,https://vlr.gg/player/1620/ale,2025-01-18 15:00:00,1.49,1.10,1.30,252,270,230,33,17,16,24,10,14,10,7,3,+1,+2,-1,79%,85%,74%,166,189,142,22%,20%,24%,6,5,1,5,3,2
243,https://vlr.gg/player/15080/f1co,2025-01-18 15:00:00,1.18,1.34,1.26,231,249,216,36,20,16,26,13,13,7,1,6,0,0,0,74%,75%,74%,160,177,141,36%,40%,32%,3,1,2,3,1,2
244,https://vlr.gg/player/23198/wak1e,2025-01-18 15:00:00,1.31,0.71,1.02,220,236,203,31,18,13,27,11,16,22,12,10,+1,+1,0,82%,85%,79%,132,145,118,27%,40%,16%,3,1,2,2,0,2
245,https://vlr.gg/player/19058/folke,2025-01-18 15:00:00,0.82,0.92,0.87,176,132,222,22,8,14,25,11,14,16,6,10,-3,0,-3,74%,65%,84%,122,99,145,19%,12%,26%,2,1,1,5,1,4
246,https://vlr.gg/player/7268/6ix,2025-01-18 15:00:00,0.90,1.04,0.97,168,150,186,22,10,12,29,14,15,14,7,7,-2,0,-2,69%,68%,70%,112,98,124,26%,23%,29%,0,0,0,2,0,2
247,https://vlr.gg/player/29553/dagg3r,2025-01-18 15:00:00,1.12,0.81,0.96,204,245,166,26,16,10,29,14,15,15,9,6,+1,+1,0,74%,79%,70%,130,152,109,58%,68%,45%,2,1,1,1,0,1
248,https://vlr.gg/player/5498/kipperman,2025-01-18 15:00:00,1.39,0.47,0.92,243,341,155,34,24,10,34,16,18,2,1,1,0,+4,-4,54%,74%,35%,154,197,113,16%,14%,20%,7,6,1,7,2,5
249,https://vlr.gg/player/11495/archiw0w,2025-01-18 15:00:00,0.76,0.61,0.68,179,176,183,25,12,13,32,15,17,1,1,0,+4,+3,+1,62%,63%,60%,121,125,117,31%,26%,36%,9,5,4,5,2,3
250,https://vlr.gg/player/2316/dreamas,2025-01-18 15:00:00,0.11,0.77,0.44,116,89,141,15,5,10,32,18,14,11,5,6,-2,-3,+1,64%,58%,70%,77,68,86,25%,14%,33%,2,0,2,4,3,1
251,https://vlr.gg/player/10152/padisah,2025-01-18 13:40:00,1.68,1.37,1.48,312,323,307,21,9,12,14,4,10,4,2,2,0,+1,-1,84%,86%,83%,208,209,207,32%,37%,29%,3,2,1,3,1,2
252,https://vlr.gg/player/19776/jrayn,2025-01-18 13:40:00,1.47,0.54,0.88,174,256,127,13,7,6,14,3,11,2,1,1,-3,0,-3,74%,86%,67%,110,140,93,42%,56%,36%,0,0,0,3,0,3
253,https://vlr.gg/player/13545/werlass,2025-01-18 13:40:00,0.53,0.84,0.73,165,95,207,12,3,9,15,4,11,3,0,3,0,0,0,74%,71%,75%,112,68,138,28%,25%,29%,0,0,0,0,0,0
254,https://vlr.gg/player/3549/touven,2025-01-18 13:40:00,0.97,0.57,0.72,187,232,162,11,5,6,16,5,11,5,3,2,-1,+1,-2,74%,86%,67%,130,145,121,22%,24%,20%,3,2,1,4,1,3
255,https://vlr.gg/player/10883/baransel,2025-01-18 13:40:00,0.55,0.54,0.54,107,103,110,6,1,5,14,4,10,7,4,3,-3,-1,-2,74%,86%,67%,76,79,75,53%,50%,55%,0,0,0,3,1,2
256,https://vlr.gg/player/3557/skylen,2025-01-18 13:40:00,1.87,1.73,1.82,302,312,288,20,13,7,10,6,4,9,5,4,+2,+1,+1,79%,83%,71%,212,225,190,36%,35%,38%,3,1,2,1,0,1
257,https://vlr.gg/player/5510/oxmann,2025-01-18 13:40:00,1.64,1.11,1.45,225,256,174,17,13,4,11,6,5,4,1,3,+4,+3,+1,74%,75%,71%,148,157,133,35%,38%,32%,4,3,1,0,0,0
258,https://vlr.gg/player/10137/ip0tt,2025-01-18 13:40:00,1.13,1.33,1.20,248,261,226,17,12,5,13,8,5,4,3,1,+1,+1,0,63%,67%,57%,184,177,196,48%,68%,29%,1,1,0,0,0,0
259,https://vlr.gg/player/22676/ventt,2025-01-18 13:40:00,0.77,1.01,0.86,147,147,148,12,8,4,13,9,4,7,4,3,+1,+1,0,89%,92%,86%,96,96,97,42%,40%,45%,2,2,0,1,1,0
260,https://vlr.gg/player/40935/umu7,2025-01-18 13:40:00,0.81,0.02,0.47,138,190,50,7,7,0,16,9,7,9,6,3,-1,+2,-3,68%,75%,57%,115,153,50,13%,17%,0%,3,3,0,4,1,3
261,https://vlr.gg/player/2841/foxie,2025-01-18 13:10:00,1.22,2.25,1.54,243,193,362,33,18,15,14,11,3,14,7,7,+2,+1,+1,80%,75%,91%,170,141,232,35%,37%,31%,2,1,1,0,0,0
262,https://vlr.gg/player/33902/sayonara,2025-01-18 13:10:00,1.55,1.02,1.38,286,320,211,38,30,8,21,15,6,3,1,2,+3,+5,-2,83%,83%,82%,182,201,140,36%,35%,39%,6,6,0,3,1,2
263,https://vlr.gg/player/2625/sh1n,2025-01-18 13:10:00,1.25,1.61,1.36,259,250,272,33,22,11,18,14,4,15,10,5,+3,+1,+2,83%,75%,100%,155,153,160,33%,30%,41%,5,2,3,2,1,1
264,https://vlr.gg/player/868/logan,2025-01-18 13:10:00,1.06,1.10,1.07,174,185,151,24,17,7,18,14,4,7,5,2,0,0,0,77%,75%,82%,120,130,99,36%,44%,24%,1,1,0,1,1,0
265,https://vlr.gg/player/301/takas,2025-01-18 13:10:00,0.76,1.67,1.04,205,170,282,27,15,12,22,16,6,5,3,2,+1,-3,+4,74%,67%,91%,139,121,177,29%,37%,17%,8,4,4,7,7,0
266,https://vlr.gg/player/253/sp1ke,2025-01-18 13:10:00,0.14,1.22,0.87,178,73,227,21,2,19,29,11,18,2,1,1,-1,-3,+2,51%,36%,58%,116,55,144,20%,11%,22%,5,0,5,6,3,3
267,https://vlr.gg/player/126/nowaxxzang,2025-01-18 13:10:00,0.37,0.87,0.70,171,141,187,19,5,14,32,11,21,10,1,9,-3,-2,-1,57%,64%,54%,110,85,122,25%,22%,26%,0,0,0,3,2,1
268,https://vlr.gg/player/11013/balli,2025-01-18 13:10:00,0.76,0.63,0.67,159,161,158,20,7,13,30,10,20,3,0,3,-2,0,-2,60%,73%,54%,100,101,99,31%,33%,29%,2,0,2,4,0,4
269,https://vlr.gg/player/854/matelian,2025-01-18 13:10:00,0.45,0.72,0.64,164,152,169,18,6,12,32,11,21,9,1,8,+1,0,+1,54%,45%,58%,109,82,121,37%,36%,37%,3,1,2,2,1,1
270,https://vlr.gg/player/15969/yuta,2025-01-18 13:10:00,0.41,0.57,0.52,140,96,158,15,3,12,32,10,22,6,2,4,-4,0,-4,49%,36%,54%,98,77,108,36%,23%,41%,3,2,1,7,2,5
271,https://vlr.gg/player/1457/mistic,2025-01-18 13:00:00,0.93,1.55,1.25,244,199,283,42,16,26,31,18,13,13,6,7,+5,-1,+6,78%,68%,88%,160,140,178,31%,26%,35%,6,0,6,1,1,0
272,https://vlr.gg/player/2658/xuss,2025-01-18 13:00:00,0.78,1.44,1.12,203,165,237,32,13,19,29,17,12,6,2,4,+4,0,+4,74%,64%,83%,141,108,171,27%,23%,29%,9,4,5,5,4,1
273,https://vlr.gg/player/4244/yaboilewis,2025-01-18 13:00:00,0.98,1.22,1.11,233,215,254,38,15,23,33,16,17,15,6,9,-4,-4,0,78%,68%,88%,152,140,163,34%,38%,31%,5,2,3,9,6,3
274,https://vlr.gg/player/5292/al0rante,2025-01-18 13:00:00,0.97,1.01,0.99,201,200,204,35,16,19,33,18,15,9,4,5,-5,-3,-2,67%,59%,75%,159,158,161,43%,40%,44%,1,0,1,6,3,3
275,https://vlr.gg/player/2690/hoody,2025-01-18 13:00:00,1.16,0.77,0.96,168,194,144,27,15,12,30,16,14,14,5,9,0,0,0,78%,73%,83%,114,133,96,26%,28%,23%,2,1,1,2,1,1
276,https://vlr.gg/player/2540/happen,2025-01-18 13:00:00,0.94,1.71,1.31,286,210,362,46,17,29,34,20,14,15,11,4,+1,-3,+4,70%,63%,77%,179,132,230,29%,21%,37%,7,1,6,6,4,2
277,https://vlr.gg/player/12519/ticey,2025-01-18 13:00:00,1.19,0.94,1.07,223,260,186,36,21,15,33,20,13,8,4,4,-1,0,-1,67%,71%,64%,137,161,111,17%,27%,8%,5,3,2,6,3,3
278,https://vlr.gg/player/33994/creamydreamy,2025-01-18 13:00:00,0.75,0.95,0.84,168,140,201,28,12,16,33,18,15,10,5,5,-2,-4,+2,54%,46%,64%,108,95,123,36%,46%,30%,3,0,3,5,4,1
279,https://vlr.gg/player/20032/treelover,2025-01-18 13:00:00,0.51,0.66,0.58,144,139,150,21,10,11,37,21,16,13,8,5,+4,+2,+2,61%,58%,64%,92,91,93,25%,36%,18%,5,3,2,1,1,0
280,https://vlr.gg/player/3649/litshii,2025-01-18 13:00:00,0.43,0.75,0.58,146,114,187,22,8,14,37,20,17,14,8,6,-2,-3,+1,74%,71%,77%,98,76,121,19%,11%,26%,3,1,2,5,4,1
281,https://vlr.gg/player/33974/appa,2025-01-18 13:00:00,1.12,0.50,0.90,229,270,147,28,22,6,32,19,13,5,4,1,-2,-2,0,59%,71%,38%,144,173,91,33%,36%,26%,6,4,2,8,6,2
282,https://vlr.gg/player/18384/bully,2025-01-18 13:00:00,0.71,0.79,0.74,164,175,148,21,14,7,30,20,10,2,1,1,0,0,0,54%,54%,54%,112,120,98,21%,19%,24%,2,1,1,2,1,1
283,https://vlr.gg/player/47270/darkwinjett,2025-01-18 13:00:00,0.63,0.86,0.71,166,141,231,21,11,10,31,18,13,12,10,2,-2,+1,-3,62%,63%,62%,114,86,165,24%,20%,28%,4,4,0,6,3,3
284,https://vlr.gg/player/27789/deyten,2025-01-18 13:00:00,0.82,0.41,0.68,126,122,130,17,12,5,28,15,13,7,6,1,+1,0,+1,59%,67%,46%,81,81,81,31%,50%,15%,2,1,1,1,1,0
285,https://vlr.gg/player/3934/eleo,2025-01-18 13:00:00,0.81,0.40,0.67,156,177,114,18,14,4,31,18,13,12,10,2,-2,-1,-1,65%,75%,46%,107,121,80,27%,25%,33%,2,1,1,4,2,2
286,https://vlr.gg/player/4525/stix,2025-01-18 13:00:00,2.35,1.22,1.62,280,468,177,40,25,15,18,6,12,16,5,11,0,+3,-3,86%,92%,83%,181,288,124,47%,53%,39%,5,3,2,5,0,5
287,https://vlr.gg/player/2525/szimpli,2025-01-18 13:00:00,0.78,1.56,1.29,253,149,312,35,7,28,22,8,14,6,3,3,+1,-1,+2,78%,77%,79%,164,93,202,34%,24%,37%,6,1,5,5,2,3
288,https://vlr.gg/player/2701/maniek,2025-01-18 13:00:00,1.32,1.21,1.25,247,242,249,31,10,21,25,7,18,15,9,6,+5,+2,+3,81%,85%,79%,156,146,161,34%,36%,33%,6,3,3,1,1,0
289,https://vlr.gg/player/164/bzt,2025-01-18 13:00:00,1.41,1.14,1.23,182,192,184,28,11,17,17,4,13,3,1,2,+1,+1,0,81%,100%,71%,136,139,135,35%,24%,43%,1,1,0,0,0,0
290,https://vlr.gg/player/10378/almo,2025-01-18 13:00:00,1.10,0.72,0.85,152,166,141,17,8,9,23,7,16,15,6,9,-2,-2,0,73%,85%,67%,116,136,106,34%,40%,31%,3,0,3,5,2,3
291,https://vlr.gg/player/19527/jamter,2025-01-18 13:00:00,0.91,1.35,1.12,201,157,251,32,13,19,32,17,15,13,6,7,-2,-2,0,74%,67%,82%,153,121,188,36%,33%,37%,2,1,1,4,3,1
292,https://vlr.gg/player/44922/golack,2025-01-18 13:00:00,0.58,1.38,0.96,229,181,280,36,13,23,38,22,16,9,5,4,+1,-3,+4,67%,54%,82%,148,126,172,32%,28%,35%,10,3,7,9,6,3
293,https://vlr.gg/player/11293/chukl9,2025-01-18 13:00:00,0.88,1.01,0.94,170,182,156,25,14,11,34,19,15,21,7,14,-2,-1,-1,72%,58%,86%,117,123,110,27%,33%,19%,1,0,1,3,1,2
294,https://vlr.gg/player/39103/waken,2025-01-18 13:00:00,0.84,0.97,0.90,175,156,200,29,14,15,34,18,16,12,5,7,-1,-2,+1,72%,71%,73%,112,104,119,28%,28%,28%,5,2,3,6,4,2
295,https://vlr.gg/player/36402/kubfu,2025-01-18 13:00:00,0.84,0.68,0.76,182,196,166,29,16,13,36,20,16,11,5,6,-4,-2,-2,65%,67%,64%,128,131,124,30%,31%,29%,1,1,0,5,3,2
296,https://vlr.gg/player/31298/luca,2025-01-18 13:00:00,1.22,1.53,1.38,237,230,239,39,19,20,24,14,10,9,4,5,+4,+2,+2,83%,73%,92%,156,151,160,31%,42%,25%,4,2,2,0,0,0
297,https://vlr.gg/player/4214/eso177,2025-01-18 13:00:00,1.31,1.02,1.15,210,234,186,36,20,16,28,14,14,13,5,8,+2,0,+2,72%,82%,63%,139,143,135,35%,31%,40%,3,1,2,1,1,0
298,https://vlr.gg/player/34002/lukey,2025-01-18 13:00:00,0.88,1.38,1.14,250,212,289,41,16,25,34,17,17,6,2,4,+2,-3,+5,63%,45%,79%,163,139,185,33%,34%,33%,11,3,8,9,6,3
299,https://vlr.gg/player/12372/szoren,2025-01-18 13:00:00,0.82,1.06,0.95,211,209,215,32,15,17,36,20,16,28,12,16,+1,+1,0,80%,68%,92%,140,138,142,29%,30%,27%,6,4,2,5,3,2
300,https://vlr.gg/player/5566/jeyj7y,2025-01-18 13:00:00,0.54,1.17,0.87,155,111,190,26,8,18,29,16,13,14,7,7,-1,-2,+1,76%,68%,83%,115,94,135,30%,21%,36%,3,0,3,4,2,2
301,https://vlr.gg/player/50776/influx,2025-01-18 12:50:00,0.87,1.96,1.37,261,213,319,22,9,13,13,10,3,3,1,2,+2,0,+2,77%,58%,100%,167,121,223,19%,17%,21%,4,2,2,2,2,0
302,https://vlr.gg/player/40841/kabzi,2025-01-18 12:50:00,0.63,1.59,1.07,188,127,263,16,6,10,13,10,3,6,1,5,+2,+2,0,64%,42%,90%,117,77,166,12%,18%,9%,3,3,0,1,1,0
303,https://vlr.gg/player/5500/docent,2025-01-18 12:50:00,0.68,1.44,1.03,179,117,254,15,5,10,15,10,5,6,3,3,+4,+1,+3,68%,42%,100%,117,87,154,25%,23%,27%,4,1,3,0,0,0
304,https://vlr.gg/player/13571/musz3kk,2025-01-18 12:50:00,0.64,1.40,0.99,215,161,281,16,6,10,16,11,5,5,3,2,+1,+1,0,73%,58%,90%,150,120,186,29%,26%,32%,3,2,1,2,1,1
305,https://vlr.gg/player/4894/jn3v1ce,2025-01-18 12:50:00,0.75,1.18,0.95,172,163,183,12,6,6,13,9,4,7,4,3,+1,0,+1,86%,75%,100%,109,99,121,26%,18%,38%,2,0,2,1,0,1
306,https://vlr.gg/player/12795/crewen,2025-01-18 12:50:00,0.35,2.10,1.30,246,88,380,20,2,18,14,9,5,4,2,2,-1,-2,+1,64%,40%,83%,161,57,248,25%,15%,28%,1,0,1,2,2,0
307,https://vlr.gg/player/40591/comeback,2025-01-18 12:50:00,1.53,0.74,1.10,208,301,131,16,11,5,16,9,7,4,1,3,-4,0,-4,86%,90%,83%,130,183,86,24%,35%,11%,1,1,0,5,1,4
308,https://vlr.gg/player/31305/lar0k,2025-01-18 12:50:00,0.15,1.67,0.98,216,97,316,17,3,14,16,10,6,2,1,1,+1,0,+1,59%,30%,83%,135,59,198,44%,43%,44%,2,0,2,1,0,1
309,https://vlr.gg/player/24344/loita,2025-01-18 12:50:00,0.21,1.07,0.68,112,94,128,8,3,5,16,11,5,11,1,10,-3,-2,-1,64%,40%,83%,73,53,90,40%,50%,36%,1,1,0,4,3,1
310,https://vlr.gg/player/5565/ros,2025-01-18 12:50:00,0.03,0.77,0.41,126,54,187,9,1,8,19,10,9,3,1,2,-3,-2,-1,45%,30%,58%,94,43,137,17%,14%,18%,1,0,1,4,2,2
311,https://vlr.gg/player/12774/anima,2025-01-18 11:45:00,1.37,1.42,1.39,257,244,278,18,10,8,11,7,4,7,6,1,0,0,0,90%,92%,88%,181,167,201,37%,32%,43%,0,0,0,0,0,0
312,https://vlr.gg/player/8041/brave,2025-01-18 11:45:00,0.96,1.86,1.32,260,223,318,20,11,9,13,10,3,5,3,2,+2,-1,+3,90%,83%,100%,164,137,205,30%,33%,27%,3,0,3,1,1,0
313,https://vlr.gg/player/10160/izzy,2025-01-18 11:45:00,1.25,1.31,1.27,221,235,200,15,9,6,11,7,4,5,3,2,+1,+1,0,85%,92%,75%,156,164,144,36%,33%,42%,1,1,0,0,0,0
314,https://vlr.gg/player/10161/qutionerx,2025-01-18 11:45:00,0.44,1.66,0.93,220,160,310,16,6,10,14,11,3,1,1,0,+1,0,+1,55%,50%,63%,141,99,203,29%,36%,24%,6,4,2,5,4,1
315,https://vlr.gg/player/10163/cyderx,2025-01-18 11:45:00,0.79,0.64,0.73,139,146,129,11,7,4,13,8,5,4,3,1,0,0,0,70%,67%,75%,103,105,99,30%,46%,14%,2,1,1,2,1,1
316,https://vlr.gg/player/16552/pckwn,2025-01-18 11:45:00,0.95,1.11,1.04,216,163,252,15,4,11,17,7,10,9,3,6,+1,0,+1,75%,63%,83%,121,109,130,29%,46%,21%,2,0,2,1,0,1
317,https://vlr.gg/player/4962/lurzy0y0,2025-01-18 11:45:00,0.90,1.02,0.97,220,265,190,13,7,6,15,8,7,8,1,7,-1,0,-1,60%,50%,67%,133,155,119,34%,44%,27%,3,2,1,4,2,2
318,https://vlr.gg/player/31855/celasun,2025-01-18 11:45:00,0.70,1.11,0.94,168,133,192,12,3,9,16,7,9,5,2,3,+2,0,+2,50%,38%,58%,111,99,119,33%,25%,39%,2,0,2,0,0,0
319,https://vlr.gg/player/40843/audaz,2025-01-18 11:45:00,0.43,0.93,0.73,129,126,131,10,4,6,14,7,7,6,1,5,-3,-1,-2,60%,38%,75%,85,83,87,39%,57%,31%,0,0,0,3,1,2
320,https://vlr.gg/player/39357/s0pp,2025-01-18 11:45:00,0.05,1.13,0.70,177,63,253,12,1,11,18,8,10,4,3,1,-3,-3,0,60%,38%,75%,127,46,180,43%,20%,48%,1,0,1,4,3,1
321,https://vlr.gg/player/565/starxo,2025-01-18 11:00:00,1.46,1.24,1.32,254,305,232,37,17,20,22,9,13,9,1,8,+1,-1,+2,82%,80%,83%,162,194,141,23%,25%,22%,5,0,5,4,1,3
322,https://vlr.gg/player/4521/unfake,2025-01-18 11:00:00,1.01,1.52,1.32,224,161,250,31,9,22,21,10,11,15,4,11,0,-3,+3,82%,73%,88%,148,123,163,60%,73%,54%,5,0,5,5,3,2
323,https://vlr.gg/player/2653/jesse,2025-01-18 11:00:00,0.94,1.25,1.13,215,162,252,30,9,21,24,10,14,9,5,4,+2,-1,+3,72%,87%,63%,140,103,164,35%,33%,35%,5,0,5,3,1,2
324,https://vlr.gg/player/440/akumaaaaa,2025-01-18 11:00:00,0.76,1.26,1.07,208,156,238,28,8,20,24,11,13,8,2,6,-3,-3,0,79%,67%,88%,134,95,159,35%,26%,38%,4,3,1,7,6,1
325,https://vlr.gg/player/7162/wackie,2025-01-18 11:00:00,0.74,1.29,1.07,215,159,240,29,7,22,23,11,12,14,9,5,-1,-1,0,72%,60%,79%,132,103,151,44%,30%,53%,0,0,0,1,1,0
326,https://vlr.gg/player/24439/yohpa,2025-01-18 11:00:00,0.80,0.99,0.87,162,158,170,22,13,9,28,19,9,9,4,5,0,0,0,72%,67%,80%,111,104,123,37%,37%,36%,1,0,1,1,0,1
327,https://vlr.gg/player/7173/soren,2025-01-18 11:00:00,0.69,0.97,0.79,166,164,193,25,13,12,31,21,10,2,1,1,0,-1,+1,62%,50%,80%,125,116,139,30%,29%,31%,4,2,2,4,3,1
328,https://vlr.gg/player/2864/ease,2025-01-18 11:00:00,0.65,1.02,0.79,168,140,194,23,11,12,31,21,10,14,7,7,-3,-4,+1,72%,63%,87%,102,101,104,29%,29%,29%,2,0,2,5,4,1
329,https://vlr.gg/player/21216/f4ngeer,2025-01-18 11:00:00,0.63,1.04,0.78,162,184,147,23,15,8,31,22,9,6,2,4,-1,-3,+2,59%,54%,67%,114,114,114,30%,32%,26%,4,2,2,5,5,0
330,https://vlr.gg/player/11322/sevire,2025-01-18 11:00:00,0.53,0.89,0.67,148,127,199,21,11,10,34,22,12,6,4,2,+5,0,+5,64%,58%,73%,96,69,139,48%,50%,45%,9,4,5,4,4,0
331,https://vlr.gg/player/12528/disisjohn,2025-01-18 11:00:00,1.16,1.69,1.54,327,276,351,42,10,32,20,8,12,2,2,0,+6,+1,+5,79%,80%,79%,205,156,225,18%,16%,18%,10,1,9,4,0,4
332,https://vlr.gg/player/45494/proxh,2025-01-18 11:00:00,1.93,1.20,1.41,232,231,235,30,9,21,13,1,12,10,5,5,+1,+1,0,94%,100%,92%,154,141,160,37%,53%,32%,1,1,0,0,0,0
333,https://vlr.gg/player/9508/leosen,2025-01-18 11:00:00,1.53,1.29,1.36,240,242,239,29,9,20,18,6,12,11,5,6,0,-1,+1,82%,80%,83%,158,154,160,41%,30%,47%,3,1,2,3,2,1
334,https://vlr.gg/player/4629/azury,2025-01-18 11:00:00,1.40,1.12,1.20,161,154,160,21,7,14,13,3,10,7,2,5,+1,0,+1,91%,100%,88%,118,134,111,33%,32%,33%,2,0,2,1,0,1
335,https://vlr.gg/player/4325/musashi,2025-01-18 11:00:00,0.83,1.26,1.13,199,184,207,23,6,17,19,8,11,21,6,15,+4,-1,+5,85%,80%,88%,116,111,118,21%,30%,18%,7,2,5,3,3,0
336,https://vlr.gg/player/7987/kovaq,2025-01-18 11:00:00,1.15,0.54,0.94,203,239,126,24,20,4,30,21,9,7,6,1,0,0,0,56%,58%,50%,125,146,75,32%,29%,57%,2,1,1,2,1,1
337,https://vlr.gg/player/12593/felix,2025-01-18 11:00:00,0.89,0.78,0.85,145,137,169,18,12,6,25,18,7,5,4,1,-1,-2,+1,62%,58%,70%,110,105,121,31%,32%,29%,1,0,1,2,2,0
338,https://vlr.gg/player/122/luckerrr,2025-01-18 11:00:00,0.40,0.81,0.52,156,138,202,18,11,7,31,23,8,4,3,1,-6,-5,-1,56%,50%,70%,98,89,120,18%,18%,18%,6,4,2,12,9,3
339,https://vlr.gg/player/20302/jini,2025-01-18 11:00:00,0.52,0.43,0.49,114,107,131,11,8,3,29,21,8,7,6,1,-1,-2,+1,59%,58%,60%,79,72,94,20%,29%,12%,1,0,1,2,2,0
340,https://vlr.gg/player/7968/stavinci,2025-01-18 11:00:00,0.38,0.59,0.44,113,87,190,12,6,6,30,21,9,8,7,1,-4,-3,-1,62%,54%,80%,80,62,124,22%,21%,24%,1,1,0,5,4,1
341,https://vlr.gg/player/24344/loita,2025-01-18 10:40:00,1.68,1.92,1.87,307,175,341,17,2,15,4,0,4,2,0,2,+1,+1,0,93%,100%,92%,195,105,218,60%,29%,70%,2,1,1,1,0,1
342,https://vlr.gg/player/5565/ros,2025-01-18 10:40:00,2.02,1.18,1.35,309,419,282,17,5,12,9,2,7,3,0,3,+3,0,+3,87%,100%,83%,201,303,175,22%,40%,16%,3,0,3,0,0,0
343,https://vlr.gg/player/40591/comeback,2025-01-18 10:40:00,1.02,1.41,1.33,263,161,290,13,2,11,7,2,5,3,0,3,+3,0,+3,93%,100%,92%,169,101,186,5%,17%,3%,4,0,4,1,0,1
344,https://vlr.gg/player/12795/crewen,2025-01-18 10:40:00,1.05,1.12,1.10,170,380,118,10,4,6,7,3,4,3,0,3,+2,0,+2,80%,67%,83%,95,197,70,19%,38%,11%,3,1,2,1,1,0
345,https://vlr.gg/player/31305/lar0k,2025-01-18 10:40:00,0.49,0.97,0.88,121,107,126,7,1,6,6,1,5,5,1,4,0,0,0,80%,67%,83%,92,95,92,35%,33%,36%,0,0,0,0,0,0
346,https://vlr.gg/player/10146/reazy,2025-01-18 10:40:00,1.12,0.67,1.03,214,216,205,11,9,2,11,9,2,0,0,0,-1,-1,0,53%,50%,67%,142,143,140,24%,30%,10%,0,0,0,1,1,0
347,https://vlr.gg/player/50775/lava,2025-01-18 10:40:00,0.63,0.65,0.64,115,88,224,6,4,2,11,8,3,2,1,1,-3,-3,0,73%,67%,100%,75,57,146,27%,57%,0%,0,0,0,3,3,0
348,https://vlr.gg/player/568/turko,2025-01-18 10:40:00,0.50,1.16,0.63,152,117,296,7,4,3,14,11,3,0,0,0,+1,0,+1,67%,58%,100%,104,86,176,53%,42%,80%,1,0,1,0,0,0
349,https://vlr.gg/player/3862/deepmans,2025-01-18 10:40:00,0.68,0.01,0.49,147,181,14,6,6,0,14,11,3,0,0,0,-3,-2,-1,33%,25%,67%,99,121,14,44%,50%,0%,2,2,0,5,4,1
350,https://vlr.gg/player/569/paura,2025-01-18 10:40:00,0.13,0.13,0.13,62,55,90,3,2,1,14,11,3,2,1,1,-3,-2,-1,73%,75%,67%,46,44,53,30%,22%,100%,0,0,0,3,2,1
351,https://vlr.gg/player/15735/krostaly,2025-01-18 09:30:00,1.90,0.93,1.39,283,352,222,23,14,9,13,5,8,8,3,5,+3,+1,+2,83%,91%,75%,162,198,129,45%,37%,62%,4,1,3,1,0,1
352,https://vlr.gg/player/31307/yigox,2025-01-18 09:30:00,0.60,2.05,1.36,292,148,426,24,6,18,14,7,7,4,2,2,0,0,0,70%,55%,83%,191,106,269,47%,36%,51%,1,1,0,1,1,0
353,https://vlr.gg/player/40842/ibonata,2025-01-18 09:30:00,1.21,0.69,0.93,145,147,145,11,6,5,13,5,8,14,9,5,-1,0,-1,87%,100%,75%,91,86,97,28%,25%,31%,1,0,1,2,0,2
354,https://vlr.gg/player/18655/best,2025-01-18 09:30:00,0.82,0.89,0.86,173,184,163,15,8,7,15,7,8,4,2,2,+1,+2,-1,74%,73%,75%,124,123,125,38%,44%,33%,6,4,2,5,2,3
355,https://vlr.gg/player/33551/slaughter,2025-01-18 09:30:00,1.08,0.61,0.84,148,187,112,11,6,5,14,6,8,10,6,4,0,0,0,70%,82%,58%,94,122,68,27%,36%,19%,1,1,0,1,1,0
356,https://vlr.gg/player/10125/qw1,2025-01-18 09:30:00,1.47,1.10,1.29,279,316,239,21,13,8,16,9,7,3,2,1,+3,+3,0,70%,75%,64%,176,204,145,21%,31%,11%,6,4,2,3,1,2
357,https://vlr.gg/player/6559/destruct1vee,2025-01-18 09:30:00,1.21,0.90,1.06,164,160,169,12,7,5,13,6,7,10,5,5,-2,0,-2,65%,67%,64%,104,94,114,29%,24%,35%,1,1,0,3,1,2
358,https://vlr.gg/player/1399/sterben,2025-01-18 09:30:00,0.80,1.03,0.91,146,110,185,13,5,8,16,9,7,8,6,2,-1,-1,0,74%,67%,82%,92,78,108,16%,13%,18%,1,0,1,2,1,1
359,https://vlr.gg/player/3604/mojj,2025-01-18 09:30:00,0.73,0.64,0.69,177,196,158,14,8,6,20,10,10,2,1,1,-3,-2,-1,39%,42%,36%,108,125,89,46%,50%,42%,2,1,1,5,3,2
360,https://vlr.gg/player/7353/glovee,2025-01-18 09:30:00,0.85,0.25,0.56,137,182,89,9,6,3,19,10,9,13,9,4,0,0,0,65%,75%,55%,85,113,54,22%,18%,30%,0,0,0,0,0,0
361,https://vlr.gg/player/2525/szimpli,2025-01-18 09:00:00,1.53,0.99,1.23,264,290,249,48,25,23,36,15,21,10,6,4,+6,+2,+4,80%,83%,78%,182,192,173,25%,28%,20%,12,5,7,6,3,3
362,https://vlr.gg/player/4525/stix,2025-01-18 09:00:00,1.28,0.88,1.06,219,252,191,39,21,18,36,15,21,19,11,8,-1,0,-1,78%,83%,74%,145,158,134,32%,40%,25%,2,1,1,3,1,2
363,https://vlr.gg/player/10378/almo,2025-01-18 09:00:00,1.07,0.91,0.99,200,228,184,38,21,17,36,18,18,8,4,4,+1,+1,0,72%,83%,63%,138,150,127,30%,41%,23%,4,3,1,3,2,1
364,https://vlr.gg/player/164/bzt,2025-01-18 09:00:00,0.63,1.22,0.95,172,98,232,30,7,23,33,14,19,11,8,3,+2,-1,+3,60%,57%,63%,120,67,164,29%,15%,36%,5,0,5,3,1,2
365,https://vlr.gg/player/2701/maniek,2025-01-18 09:00:00,0.71,0.54,0.62,145,143,137,22,10,12,41,18,23,23,14,9,-2,-1,-1,70%,74%,67%,85,84,86,29%,22%,37%,5,3,2,7,4,3
366,https://vlr.gg/player/33732/nunmeister,2025-01-18 09:00:00,1.20,1.26,1.23,235,213,254,41,20,21,36,20,16,29,15,14,0,-1,+1,74%,78%,70%,151,145,157,34%,35%,33%,2,0,2,2,1,1
367,https://vlr.gg/player/2832/patix,2025-01-18 09:00:00,1.17,1.26,1.21,243,238,252,43,22,21,35,18,17,18,11,7,+3,+1,+2,72%,74%,70%,162,159,165,46%,51%,41%,7,4,3,4,3,1
368,https://vlr.gg/player/39682/wanzeru,2025-01-18 09:00:00,1.38,0.92,1.17,269,300,204,46,29,17,38,21,17,6,2,4,-1,0,-1,78%,74%,83%,174,192,154,24%,30%,16%,8,4,4,9,4,5
369,https://vlr.gg/player/6969/gunners,2025-01-18 09:00:00,0.88,1.18,1.02,173,149,206,29,13,16,33,17,16,24,15,9,-1,-2,+1,72%,67%,78%,114,98,132,33%,24%,43%,4,3,1,5,5,0
370,https://vlr.gg/player/7231/kya,2025-01-18 09:00:00,0.98,0.40,0.71,121,162,88,23,18,5,35,17,18,8,2,6,-7,-3,-4,64%,67%,61%,92,119,61,26%,36%,10%,1,0,1,8,3,5
371,https://vlr.gg/player/22617/vitie,2025-01-18 09:00:00,1.29,1.09,1.20,232,216,235,53,29,24,44,20,24,31,17,14,+3,+2,+1,77%,77%,77%,142,134,153,25%,23%,28%,8,5,3,5,3,2
372,https://vlr.gg/player/252/d3ffo,2025-01-18 09:00:00,1.04,1.20,1.11,241,233,246,59,32,27,48,29,19,15,8,7,+5,+4,+1,74%,67%,84%,160,152,170,20%,18%,23%,18,12,6,13,8,5
373,https://vlr.gg/player/23098/aphun,2025-01-18 09:00:00,1.16,0.95,1.06,194,199,188,49,29,20,44,23,21,28,19,9,-1,-4,+3,77%,74%,81%,124,129,117,26%,31%,20%,5,2,3,6,6,0
374,https://vlr.gg/player/30901/ianto,2025-01-18 09:00:00,0.94,1.16,1.04,186,165,207,45,22,23,45,23,22,20,11,9,+1,-2,+3,70%,72%,68%,121,118,126,20%,23%,18%,4,0,4,3,2,1
375,https://vlr.gg/player/7106/diseased,2025-01-18 09:00:00,0.90,0.64,0.78,155,163,155,41,25,16,49,25,24,14,8,6,-2,+1,-3,73%,77%,68%,108,111,103,32%,34%,31%,3,1,2,5,0,5
376,https://vlr.gg/player/42651/avey,2025-01-18 09:00:00,1.18,1.02,1.09,198,207,198,47,23,24,48,19,29,29,14,15,+1,+1,0,74%,71%,77%,135,137,133,22%,15%,29%,5,2,3,4,1,3
377,https://vlr.gg/player/23421/laser,2025-01-18 09:00:00,1.19,1.02,1.09,219,254,195,51,27,24,47,22,25,17,7,10,+2,-1,+3,70%,65%,74%,141,163,123,26%,30%,20%,14,5,9,12,6,6
378,https://vlr.gg/player/42661/barck,2025-01-18 09:00:00,0.93,1.11,1.03,199,212,219,52,22,30,50,24,26,21,12,9,-5,-1,-4,73%,77%,69%,144,145,142,35%,34%,36%,2,1,1,7,2,5
379,https://vlr.gg/player/42650/mally,2025-01-18 09:00:00,1.05,0.91,0.97,195,203,177,47,23,24,47,20,27,17,5,12,-1,-2,+1,71%,74%,69%,119,123,117,29%,29%,29%,8,3,5,9,5,4
380,https://vlr.gg/player/16012/akira,2025-01-18 09:00:00,0.58,0.61,0.60,124,115,137,32,14,18,55,25,30,30,16,14,-3,-2,-1,70%,74%,67%,70,57,80,28%,23%,31%,3,2,1,6,4,2
381,https://vlr.gg/player/48705/chaza,2025-01-18 09:00:00,1.49,1.24,1.35,260,284,252,59,28,31,41,16,25,13,6,7,+2,+3,-1,76%,85%,69%,180,195,169,30%,31%,30%,4,3,1,2,0,2
382,https://vlr.gg/player/45769/waddlesthepig,2025-01-18 09:00:00,1.27,1.01,1.12,214,207,222,47,22,25,39,14,25,24,6,18,-1,+2,-3,78%,74%,81%,143,139,147,37%,35%,38%,4,3,1,5,1,4
383,https://vlr.gg/player/47522/kaaru,2025-01-18 09:00:00,0.80,1.19,1.02,258,210,283,55,21,34,50,22,28,6,1,5,-4,-2,-2,62%,59%,64%,172,136,199,32%,31%,32%,9,4,5,13,6,7
384,https://vlr.gg/player/31043/yasiek,2025-01-18 09:00:00,0.65,0.77,0.72,161,140,180,33,12,21,47,20,27,28,14,14,-1,-2,+1,67%,70%,64%,109,93,121,29%,20%,35%,6,2,4,7,4,3
385,https://vlr.gg/player/48654/vxyr,2025-01-18 09:00:00,0.91,0.50,0.67,136,182,107,30,18,12,44,19,25,19,8,11,-5,0,-5,68%,85%,56%,96,115,82,21%,22%,20%,4,2,2,9,2,7
386,https://vlr.gg/player/1620/ale,2025-01-18 09:00:00,1.26,1.08,1.18,228,250,210,51,32,19,43,23,20,16,8,8,+6,+6,0,68%,72%,63%,146,148,143,19%,19%,19%,14,10,4,8,4,4
387,https://vlr.gg/player/23198/wak1e,2025-01-18 09:00:00,1.36,0.92,1.17,230,240,208,52,34,18,44,22,22,18,10,8,+4,+2,+2,63%,69%,56%,150,152,148,24%,32%,15%,6,4,2,2,2,0
388,https://vlr.gg/player/19058/folke,2025-01-18 09:00:00,0.91,1.11,1.00,190,161,225,40,20,20,42,23,19,15,9,6,+1,0,+1,73%,69%,78%,118,101,140,29%,23%,36%,4,1,3,3,1,2
389,https://vlr.gg/player/15080/f1co,2025-01-18 09:00:00,0.94,1.08,1.00,196,215,179,43,26,17,48,30,18,16,8,8,-2,+1,-3,63%,64%,63%,132,140,122,28%,26%,31%,6,5,1,8,4,4
390,https://vlr.gg/player/23197/knowbii,2025-01-18 09:00:00,0.84,0.79,0.82,173,156,190,35,18,17,47,25,22,24,14,10,0,+1,-1,67%,67%,67%,110,105,116,25%,25%,25%,6,3,3,6,2,4
391,https://vlr.gg/player/12372/szoren,2025-01-18 08:00:00,1.36,1.33,1.34,269,278,262,27,13,14,18,10,8,8,6,2,+3,+2,+1,71%,79%,64%,160,165,155,27%,27%,27%,5,3,2,2,1,1
392,https://vlr.gg/player/4214/eso177,2025-01-18 08:00:00,1.32,1.05,1.19,223,257,190,21,12,9,17,8,9,9,5,4,+1,0,+1,79%,86%,71%,145,163,126,29%,37%,22%,3,1,2,2,1,1
393,https://vlr.gg/player/31298/luca,2025-01-18 08:00:00,1.48,0.88,1.18,202,259,146,20,14,6,17,9,8,12,4,8,0,+1,-1,82%,86%,79%,131,160,102,22%,28%,15%,1,1,0,1,0,1
394,https://vlr.gg/player/5566/jeyj7y,2025-01-18 08:00:00,0.79,1.00,0.90,169,176,163,17,9,8,20,11,9,12,6,6,+1,+1,0,75%,79%,71%,114,115,113,25%,29%,21%,2,1,1,1,0,1
395,https://vlr.gg/player/34002/lukey,2025-01-18 08:00:00,0.35,1.00,0.67,195,154,237,19,7,12,23,13,10,3,0,3,+1,-2,+3,68%,57%,79%,120,97,143,14%,17%,12%,6,2,4,5,4,1
396,https://vlr.gg/player/15384/mot1on,2025-01-18 08:00:00,1.64,1.27,1.45,279,294,266,28,15,13,19,9,10,6,2,4,+1,0,+1,79%,71%,86%,187,197,178,25%,24%,26%,2,0,2,1,0,1
397,https://vlr.gg/player/2096/knightvoice,2025-01-18 08:00:00,1.02,1.26,1.14,233,182,285,22,9,13,21,9,12,13,5,8,-2,0,-2,71%,71%,71%,149,128,170,23%,15%,30%,0,0,0,2,0,2
398,https://vlr.gg/player/16436/maik,2025-01-18 08:00:00,1.12,1.03,1.08,211,235,188,21,11,10,20,10,10,5,4,1,-2,-1,-1,75%,79%,71%,155,166,144,33%,48%,21%,3,2,1,5,3,2
399,https://vlr.gg/player/12103/limpe,2025-01-18 08:00:00,0.94,0.68,0.81,199,207,192,16,8,8,22,10,12,8,4,4,0,0,0,75%,71%,79%,145,151,138,25%,25%,24%,6,3,3,6,3,3
400,https://vlr.gg/player/10403/jaf,2025-01-18 08:00:00,0.16,0.71,0.44,86,32,141,8,1,7,22,11,11,13,5,8,-3,-3,0,61%,50%,71%,56,23,90,33%,20%,38%,0,0,0,3,3,0
401,https://vlr.gg/player/19527/jamter,2025-01-18 08:00:00,1.71,1.35,1.53,275,309,242,27,16,11,17,8,9,8,3,5,+1,+1,0,68%,71%,64%,180,199,162,49%,55%,42%,3,1,2,2,0,2
402,https://vlr.gg/player/36402/kubfu,2025-01-18 08:00:00,1.08,1.41,1.24,231,178,285,24,9,15,17,8,9,2,2,0,+3,-1,+4,75%,71%,79%,165,122,208,34%,50%,28%,4,0,4,1,1,0
403,https://vlr.gg/player/11293/chukl9,2025-01-18 08:00:00,0.86,1.07,0.97,184,147,221,17,7,10,21,10,11,19,10,9,-1,-1,0,68%,64%,71%,119,84,155,22%,17%,25%,1,1,0,2,2,0
404,https://vlr.gg/player/44922/golack,2025-01-18 08:00:00,1.00,0.76,0.88,203,260,148,21,13,8,21,11,10,2,1,1,-5,-3,-2,46%,43%,50%,135,156,113,30%,24%,46%,2,1,1,7,4,3
405,https://vlr.gg/player/39103/waken,2025-01-18 08:00:00,0.84,0.38,0.61,161,201,123,15,9,6,26,13,13,13,7,6,-2,0,-2,61%,71%,50%,112,152,72,33%,43%,20%,2,2,0,4,2,2
406,https://vlr.gg/player/8440/puggy,2025-01-18 08:00:00,1.82,1.51,1.67,350,365,336,32,17,15,18,9,9,8,3,5,+3,0,+3,75%,79%,71%,228,252,204,34%,39%,28%,4,1,3,1,1,0
407,https://vlr.gg/player/12471/kalkkuna,2025-01-18 08:00:00,1.56,0.76,1.16,283,350,216,28,18,10,22,10,12,5,3,2,+3,+1,+2,75%,86%,64%,165,193,138,20%,23%,15%,7,4,3,4,3,1
408,https://vlr.gg/player/6101/999kvmil,2025-01-18 08:00:00,0.88,1.03,0.96,159,140,179,16,7,9,18,8,10,13,7,6,+3,0,+3,68%,64%,71%,96,89,103,41%,47%,35%,3,0,3,0,0,0
409,https://vlr.gg/player/13024/vuubit,2025-01-18 08:00:00,0.42,1.15,0.78,198,143,254,20,6,14,23,12,11,10,3,7,-4,-2,-2,61%,43%,79%,133,101,165,41%,32%,48%,0,0,0,4,2,2
410,https://vlr.gg/player/15491/maximn,2025-01-18 08:00:00,0.41,0.08,0.25,86,101,73,6,4,2,23,11,12,3,1,2,-1,+1,-2,50%,50%,50%,68,73,63,17%,24%,11%,2,2,0,3,1,2
411,https://vlr.gg/player/36748/czester,2025-01-18 08:00:00,1.46,0.92,1.19,235,265,207,21,13,8,18,7,11,9,6,3,+4,+3,+1,73%,77%,69%,158,167,149,30%,29%,32%,7,5,2,3,2,1
412,https://vlr.gg/player/9556/demek,2025-01-18 08:00:00,0.85,1.42,1.14,265,172,359,24,8,16,19,9,10,4,4,0,+3,0,+3,69%,77%,62%,160,112,209,18%,17%,18%,6,2,4,3,2,1
413,https://vlr.gg/player/10448/kozok,2025-01-18 08:00:00,1.23,0.71,0.97,176,194,159,18,11,7,16,6,10,8,3,5,-4,-1,-3,73%,77%,69%,120,143,97,34%,29%,43%,0,0,0,4,1,3
414,https://vlr.gg/player/19505/szalony,2025-01-18 08:00:00,1.52,0.33,0.92,208,344,73,19,16,3,19,9,10,5,5,0,-1,0,-1,62%,85%,38%,149,235,64,19%,18%,24%,0,0,0,1,0,1
415,https://vlr.gg/player/9557/nefi,2025-01-18 08:00:00,0.97,0.62,0.80,116,91,143,10,4,6,16,5,11,18,10,8,-2,-1,-1,69%,77%,62%,70,60,81,30%,23%,36%,0,0,0,2,1,1
416,https://vlr.gg/player/3934/eleo,2025-01-18 08:00:00,1.70,1.32,1.51,263,268,258,24,13,11,15,5,10,11,6,5,+1,0,+1,77%,85%,69%,164,170,158,20%,23%,17%,3,0,3,2,0,2
417,https://vlr.gg/player/47270/darkwinjett,2025-01-18 08:00:00,1.12,0.94,1.03,217,218,216,20,11,9,21,9,12,15,8,7,-2,-2,0,73%,77%,69%,135,139,131,25%,39%,15%,1,0,1,3,2,1
418,https://vlr.gg/player/33974/appa,2025-01-18 08:00:00,0.92,0.93,0.92,208,228,189,18,10,8,20,10,10,6,3,3,+2,0,+2,54%,54%,54%,142,141,143,24%,27%,21%,5,3,2,3,3,0
419,https://vlr.gg/player/18384/bully,2025-01-18 08:00:00,1.57,0.23,0.90,149,254,46,14,13,1,15,5,10,2,1,1,-1,+2,-3,58%,85%,31%,100,162,38,20%,24%,8%,3,3,0,4,1,3
420,https://vlr.gg/player/2635/mts,2025-01-18 08:00:00,0.60,0.85,0.72,145,137,155,12,5,7,21,11,10,14,9,5,0,+1,-1,69%,77%,62%,82,79,86,26%,17%,38%,1,1,0,1,0,1
421,https://vlr.gg/player/37927/happywei,2025-01-18 06:20:00,,,,265,,,49,,,29,,,17,,,,,,,,,,,,,,,,,,,,
422,https://vlr.gg/player/22047/rarga,2025-01-18 06:20:00,,,,230,,,42,,,33,,,5,,,,,,,,,,,,,,,,,,,,
423,https://vlr.gg/player/12365/coconut,2025-01-18 06:20:00,,,,223,,,39,,,31,,,19,,,,,,,,,,,,,,,,,,,,
424,https://vlr.gg/player/4710/you,2025-01-18 06:20:00,,,,200,,,38,,,33,,,19,,,,,,,,,,,,,,,,,,,,
425,https://vlr.gg/player/36415/viva,2025-01-18 06:20:00,,,,169,,,31,,,26,,,15,,,,,,,,,,,,,,,,,,,,
426,https://vlr.gg/player/10821/delb,2025-01-18 06:20:00,,,,195,,,38,,,38,,,4,,,,,,,,,,,,,,,,,,,,
427,https://vlr.gg/player/14431/monk,2025-01-18 06:20:00,,,,190,,,30,,,45,,,23,,,,,,,,,,,,,,,,,,,,
428,https://vlr.gg/player/50080/lsn,2025-01-18 06:20:00,,,,176,,,33,,,39,,,18,,,,,,,,,,,,,,,,,,,,
429,https://vlr.gg/player/46748/k1ra,2025-01-18 06:20:00,,,,166,,,31,,,38,,,15,,,,,,,,,,,,,,,,,,,,
430,https://vlr.gg/player/25949/bunt,2025-01-18 06:20:00,,,,122,,,20,,,41,,,15,,,,,,,,,,,,,,,,,,,,
431,https://vlr.gg/player/2615/clz,2025-01-18 06:15:00,1.00,1.07,1.04,191,180,201,29,12,17,31,13,18,16,9,7,-4,-2,-2,77%,75%,79%,124,114,132,38%,33%,40%,1,0,1,5,2,3
432,https://vlr.gg/player/424/dep,2025-01-18 06:15:00,1.01,1.03,1.02,225,231,220,34,16,18,32,14,18,10,5,5,0,-1,+1,66%,70%,63%,134,135,133,21%,24%,20%,8,4,4,8,5,3
433,https://vlr.gg/player/6668/sugarz3ro,2025-01-18 06:15:00,0.88,0.88,0.88,176,162,189,26,12,14,31,14,17,17,7,10,+1,0,+1,68%,70%,67%,117,110,122,42%,52%,36%,3,1,2,2,1,1
434,https://vlr.gg/player/25221/xdll,2025-01-18 06:15:00,0.55,0.90,0.74,189,168,207,27,11,16,36,17,19,4,1,3,-2,-2,0,61%,55%,67%,121,108,132,38%,30%,44%,4,1,3,6,3,3
435,https://vlr.gg/player/12990/syouta,2025-01-18 06:15:00,0.80,0.68,0.73,168,185,155,27,14,13,36,17,19,8,3,5,+1,+3,-2,64%,70%,58%,105,111,100,40%,41%,39%,4,3,1,3,0,3
436,https://vlr.gg/player/4122/persia,2025-01-18 06:15:00,1.50,1.29,1.41,236,253,217,39,25,14,26,14,12,22,9,13,+2,0,+2,84%,79%,90%,152,166,136,25%,25%,25%,4,1,3,2,1,1
437,https://vlr.gg/player/31829/ivy,2025-01-18 06:15:00,1.19,1.49,1.33,250,239,264,40,21,19,27,16,11,14,6,8,+3,+2,+1,77%,75%,80%,158,149,169,27%,26%,29%,5,2,3,2,0,2
438,https://vlr.gg/player/31828/francis,2025-01-18 06:15:00,1.02,1.24,1.12,202,196,209,31,16,15,30,16,14,30,15,15,-1,0,-1,86%,83%,90%,131,130,133,21%,21%,21%,2,1,1,3,1,2
439,https://vlr.gg/player/33576/margaret,2025-01-18 06:15:00,1.16,0.91,1.05,165,186,142,27,16,11,25,13,12,12,8,4,+1,+2,-1,82%,75%,90%,101,116,83,32%,36%,28%,6,5,1,5,3,2
440,https://vlr.gg/player/31827/dambi,2025-01-18 06:15:00,0.75,0.93,0.83,218,199,241,29,13,16,35,19,16,19,12,7,-1,-2,+1,75%,71%,80%,134,130,138,12%,13%,10%,7,4,3,8,6,2
441,https://vlr.gg/player/4720/haodong,2025-01-18 04:00:00,,,,214,,,28,,,27,,,19,,,,,,,,,,,,,,,,,,,,
442,https://vlr.gg/player/488/rb,2025-01-18 04:00:00,,,,202,,,27,,,31,,,8,,,,,,,,,,,,,,,,,,,,
443,https://vlr.gg/player/30526/b1ack,2025-01-18 04:00:00,,,,160,,,21,,,30,,,18,,,,,,,,,,,,,,,,,,,,
444,https://vlr.gg/player/42235/dynamite,2025-01-18 04:00:00,,,,146,,,19,,,35,,,4,,,,,,,,,,,,,,,,,,,,
445,https://vlr.gg/player/5011/abo,2025-01-18 04:00:00,,,,134,,,17,,,31,,,6,,,,,,,,,,,,,,,,,,,,
446,https://vlr.gg/player/16924/stew,2025-01-18 04:00:00,,,,293,,,41,,,18,,,5,,,,,,,,,,,,,,,,,,,,
447,https://vlr.gg/player/3519/jkuro,2025-01-18 04:00:00,,,,261,,,34,,,24,,,21,,,,,,,,,,,,,,,,,,,,
448,https://vlr.gg/player/41029/z1yan,2025-01-18 04:00:00,,,,199,,,28,,,19,,,10,,,,,,,,,,,,,,,,,,,,
449,https://vlr.gg/player/15302/babyblue,2025-01-18 04:00:00,,,,189,,,29,,,24,,,8,,,,,,,,,,,,,,,,,,,,
450,https://vlr.gg/player/37674/mrcani,2025-01-18 04:00:00,,,,171,,,22,,,27,,,17,,,,,,,,,,,,,,,,,,,,
451,https://vlr.gg/player/2348/famouz,2025-01-18 03:00:00,0.98,1.23,1.12,239,195,265,54,19,35,45,22,23,11,4,7,0,-4,+4,69%,66%,72%,144,124,159,15%,15%,15%,13,4,9,13,8,5
452,https://vlr.gg/player/4874/berserx,2025-01-18 03:00:00,1.07,1.15,1.11,211,218,208,50,24,26,41,21,20,10,2,8,+4,-1,+5,71%,62%,78%,139,137,140,27%,30%,24%,7,2,5,3,3,0
453,https://vlr.gg/player/16215/dos9,2025-01-18 03:00:00,0.95,1.18,1.08,188,183,194,42,17,25,45,23,22,32,17,15,+1,+1,0,80%,76%,83%,127,113,138,30%,26%,33%,3,1,2,2,0,2
454,https://vlr.gg/player/10739/shiro,2025-01-18 03:00:00,0.76,1.15,0.97,183,146,214,39,11,28,45,23,22,29,16,13,+1,-2,+3,69%,59%,78%,115,93,133,16%,13%,18%,8,2,6,7,4,3
455,https://vlr.gg/player/7043/ncslasher,2025-01-18 03:00:00,0.49,0.96,0.75,144,125,164,32,11,21,47,26,21,26,12,14,-2,0,-2,69%,62%,75%,92,77,105,30%,30%,31%,3,2,1,5,2,3
456,https://vlr.gg/player/804/buzz,2025-01-18 03:00:00,0.66,1.50,1.03,214,170,270,49,20,29,43,30,13,11,6,5,0,-4,+4,68%,64%,72%,134,105,169,18%,11%,29%,10,3,7,10,7,3
457,https://vlr.gg/player/4056/sylvan,2025-01-18 03:00:00,0.95,1.11,1.02,178,169,185,43,24,19,45,26,19,32,5,27,-2,-3,+1,75%,67%,86%,119,116,123,26%,33%,18%,2,0,2,4,3,1
458,https://vlr.gg/player/29833/izu,2025-01-18 03:00:00,0.82,1.24,1.00,205,168,243,46,20,26,44,29,15,12,7,5,0,0,0,69%,64%,76%,132,119,149,28%,28%,28%,7,4,3,7,4,3
459,https://vlr.gg/player/485/stax,2025-01-18 03:00:00,0.71,1.30,0.97,155,125,195,36,16,20,41,26,15,24,10,14,0,0,0,69%,61%,79%,108,85,137,25%,27%,23%,4,2,2,4,2,2
460,https://vlr.gg/player/13039/meteor,2025-01-18 03:00:00,1.10,0.78,0.96,214,233,199,49,28,21,45,25,20,8,6,2,-2,-4,+2,63%,56%,72%,145,158,130,35%,35%,37%,8,4,4,10,8,2
461,https://vlr.gg/player/4164/s0m,2025-01-17 19:05:00,1.63,1.06,1.35,277,313,246,49,29,20,35,15,20,22,13,9,+5,+5,0,82%,84%,79%,167,186,147,26%,31%,20%,9,6,3,4,1,3
462,https://vlr.gg/player/5132/mada,2025-01-17 19:05:00,1.44,0.67,1.06,235,292,180,41,26,15,39,17,22,9,4,5,-2,+4,-6,67%,76%,58%,153,191,115,24%,27%,20%,10,7,3,12,3,9
463,https://vlr.gg/player/11225/ethan,2025-01-17 19:05:00,1.27,0.82,1.05,183,204,155,30,16,14,28,11,17,23,14,9,-1,-2,+1,73%,84%,63%,118,133,103,29%,29%,28%,1,0,1,2,2,0
464,https://vlr.gg/player/21668/verno,2025-01-17 19:05:00,0.93,0.91,0.92,174,172,174,31,17,14,31,14,17,8,3,5,+3,+1,+2,80%,80%,79%,113,111,115,35%,36%,33%,5,3,2,2,2,0
465,https://vlr.gg/player/817/finesse,2025-01-17 19:05:00,0.89,0.62,0.76,162,170,151,27,16,11,37,15,22,12,3,9,-3,-1,-2,71%,72%,71%,115,117,112,27%,34%,20%,0,0,0,3,1,2
466,https://vlr.gg/player/7871/xeppaa,2025-01-17 19:05:00,1.25,1.17,1.21,296,304,290,54,26,28,42,19,23,11,7,4,+3,0,+3,78%,88%,68%,179,199,159,17%,17%,17%,8,3,5,5,3,2
467,https://vlr.gg/player/612/mitch,2025-01-17 19:05:00,1.22,0.84,1.03,185,213,154,30,19,11,31,12,19,20,8,12,0,+4,-4,71%,92%,52%,119,135,103,18%,22%,13%,5,4,1,5,0,5
468,https://vlr.gg/player/6582/net,2025-01-17 19:05:00,0.90,0.89,0.90,161,153,164,30,15,15,32,14,18,9,3,6,-1,+1,-2,78%,92%,64%,116,109,123,27%,32%,24%,3,2,1,4,1,3
469,https://vlr.gg/player/18796/oxy,2025-01-17 19:05:00,1.07,0.58,0.82,207,251,165,33,21,12,42,17,25,16,9,7,-5,-1,-4,73%,83%,64%,135,151,120,17%,13%,26%,5,3,2,10,4,6
470,https://vlr.gg/player/17433/v1c,2025-01-17 19:05:00,1.16,0.43,0.79,137,173,103,23,18,5,32,12,20,17,5,12,+1,+2,-1,73%,83%,64%,92,104,82,27%,30%,22%,3,3,0,2,1,1
471,https://vlr.gg/player/14950/gobera,2025-01-17 17:00:00,1.33,1.08,1.21,264,284,250,35,21,14,30,16,14,10,3,7,+1,0,+1,74%,75%,72%,179,207,148,32%,38%,26%,4,1,3,3,1,2
472,https://vlr.gg/player/6195/lz,2025-01-17 17:00:00,0.91,1.05,0.98,200,202,197,26,13,13,30,17,13,13,7,6,0,0,0,66%,70%,61%,134,132,135,48%,44%,52%,5,3,2,5,3,2
473,https://vlr.gg/player/11921/silentzz,2025-01-17 17:00:00,0.60,1.16,0.86,209,171,252,27,11,16,34,19,15,6,3,3,+5,0,+5,71%,60%,83%,140,120,162,39%,45%,34%,11,5,6,6,5,1
474,https://vlr.gg/player/662/pryze,2025-01-17 17:00:00,0.62,0.53,0.58,105,120,89,13,8,5,28,15,13,13,7,6,0,0,0,66%,65%,67%,66,73,58,20%,24%,15%,0,0,0,0,0,0
475,https://vlr.gg/player/3169/zap,2025-01-17 17:00:00,0.54,0.56,0.55,145,128,162,18,10,8,30,15,15,6,2,4,-4,-2,-2,71%,75%,67%,103,99,107,19%,14%,28%,0,0,0,4,2,2
476,https://vlr.gg/player/7716/penny,2025-01-17 17:00:00,1.17,1.55,1.37,266,243,280,37,16,21,22,12,10,8,5,3,+3,0,+3,82%,78%,85%,166,150,180,24%,28%,21%,7,3,4,4,3,1
477,https://vlr.gg/player/844/bdog,2025-01-17 17:00:00,1.21,1.35,1.28,213,231,200,28,15,13,21,12,9,21,7,14,+2,+1,+1,79%,72%,85%,126,128,123,35%,43%,30%,2,1,1,0,0,0
478,https://vlr.gg/player/8742/jakee,2025-01-17 17:00:00,1.01,1.29,1.16,221,188,246,29,11,18,25,13,12,18,8,10,-3,-2,-1,82%,78%,85%,142,122,160,25%,29%,22%,1,1,0,4,3,1
479,https://vlr.gg/player/733/stellar,2025-01-17 17:00:00,1.26,0.92,1.08,205,211,198,29,16,13,24,9,15,11,3,8,-2,0,-2,76%,72%,80%,143,140,147,19%,18%,20%,4,1,3,6,1,5
480,https://vlr.gg/player/4931/add3r,2025-01-17 17:00:00,0.86,0.92,0.89,195,171,221,28,12,16,28,11,17,3,2,1,-2,-3,+1,66%,61%,70%,126,112,139,33%,32%,33%,4,1,3,6,4,2
481,https://vlr.gg/player/2168/trexx,2025-01-17 16:00:00,1.17,1.23,1.21,243,210,269,55,20,35,45,19,26,31,15,16,+5,+2,+3,71%,69%,73%,155,137,169,15%,16%,14%,7,4,3,2,2,0
482,https://vlr.gg/player/5022/derke,2025-01-17 16:00:00,1.09,1.29,1.20,252,262,259,66,28,38,54,25,29,16,7,9,0,+1,-1,72%,69%,75%,170,168,171,35%,37%,33%,13,7,6,13,6,7
483,https://vlr.gg/player/11134/kicks,2025-01-17 16:00:00,1.05,0.81,0.92,194,204,174,48,26,22,54,21,33,33,7,26,+3,+1,+2,76%,69%,83%,115,124,107,35%,50%,27%,8,2,6,5,1,4
484,https://vlr.gg/player/8447/less,2025-01-17 16:00:00,1.05,0.79,0.90,157,135,161,37,17,20,43,15,28,26,10,16,0,+1,-1,63%,63%,63%,101,91,109,30%,24%,34%,4,2,2,4,1,3
485,https://vlr.gg/player/312/sayf,2025-01-17 16:00:00,0.87,0.89,0.88,165,151,176,43,17,26,46,18,28,18,10,8,-4,-3,-1,69%,75%,65%,113,103,121,28%,29%,28%,6,2,4,10,5,5
486,https://vlr.gg/player/2858/suygetsu,2025-01-17 16:00:00,1.02,1.06,1.04,209,203,194,53,29,24,49,29,20,24,14,10,0,-1,+1,69%,65%,75%,126,136,114,42%,49%,34%,5,3,2,5,4,1
487,https://vlr.gg/player/10307/marteen,2025-01-17 16:00:00,0.86,1.06,0.95,192,196,208,50,29,21,50,29,21,16,6,10,-1,-3,+2,67%,65%,69%,127,127,128,30%,33%,26%,10,5,5,11,8,3
488,https://vlr.gg/player/16459/elite,2025-01-17 16:00:00,1.00,0.88,0.95,180,178,184,45,25,20,48,26,22,19,10,9,-4,-1,-3,78%,80%,75%,131,127,135,40%,36%,45%,5,3,2,9,4,5
489,https://vlr.gg/player/5654/avez,2025-01-17 16:00:00,1.20,0.59,0.93,196,246,127,52,38,14,55,30,25,13,6,7,+3,+3,0,68%,73%,63%,121,150,84,33%,32%,36%,7,3,4,4,0,4
490,https://vlr.gg/player/727/saadhak,2025-01-17 16:00:00,0.96,0.79,0.88,178,185,174,42,23,19,51,27,24,26,21,5,-2,0,-2,75%,78%,72%,119,119,120,27%,23%,32%,7,5,2,9,5,4
491,https://vlr.gg/player/36748/czester,2025-01-17 14:20:00,1.90,1.42,1.61,300,345,270,22,10,12,11,3,8,9,4,5,0,+1,-1,90%,100%,83%,178,192,168,53%,62%,48%,2,1,1,2,0,2
492,https://vlr.gg/player/9556/demek,2025-01-17 14:20:00,1.45,1.42,1.43,287,304,276,19,9,10,12,5,7,5,1,4,+1,-1,+2,80%,100%,67%,196,224,178,21%,33%,14%,4,2,2,3,3,0
493,https://vlr.gg/player/19505/szalony,2025-01-17 14:20:00,1.10,0.82,0.93,203,242,177,15,8,7,14,5,9,2,0,2,0,-1,+1,65%,75%,58%,127,133,122,26%,24%,28%,2,0,2,2,1,1
494,https://vlr.gg/player/9557/nefi,2025-01-17 14:20:00,0.74,0.85,0.80,136,108,155,10,3,7,11,4,7,6,3,3,-1,0,-1,75%,75%,75%,93,62,114,22%,17%,24%,0,0,0,1,0,1
495,https://vlr.gg/player/10448/kozok,2025-01-17 14:20:00,0.79,0.73,0.76,146,141,150,11,4,7,11,4,7,4,1,3,+2,+1,+1,85%,88%,83%,91,98,86,27%,36%,21%,3,1,2,1,0,1
496,https://vlr.gg/player/1620/ale,2025-01-17 14:20:00,1.50,0.62,1.15,290,359,188,18,14,4,17,9,8,5,2,3,0,+1,-1,65%,75%,50%,194,233,136,26%,25%,29%,4,3,1,4,2,2
497,https://vlr.gg/player/23197/knowbii,2025-01-17 14:20:00,1.21,0.58,0.96,133,148,111,11,8,3,13,6,7,5,3,2,-1,-1,0,60%,67%,50%,93,105,75,22%,32%,11%,1,0,1,2,1,1
498,https://vlr.gg/player/19058/folke,2025-01-17 14:20:00,0.66,0.78,0.71,119,107,138,8,4,4,14,8,6,5,2,3,-1,-2,+1,75%,75%,75%,79,82,75,23%,17%,38%,1,0,1,2,2,0
499,https://vlr.gg/player/15080/f1co,2025-01-17 14:20:00,0.77,0.56,0.69,176,207,131,13,9,4,18,11,7,4,3,1,0,+1,-1,55%,58%,50%,124,153,80,39%,45%,27%,2,2,0,2,1,1
500,https://vlr.gg/player/23198/wak1e,2025-01-17 14:20:00,0.42,0.96,0.64,136,84,214,9,3,6,15,9,6,7,4,3,0,-1,+1,75%,67%,88%,86,56,131,32%,10%,50%,1,0,1,1,1,0
0,https://vlr.gg/player/16259/tweethy,2025-01-17 14:20:00,0.97,0.75,0.78,222,309,208,8,2,6,14,2,12,7,0,7,0,0,0,50%,50%,50%,151,175,147,33%,38%,32%,2,0,2,2,0,2
1,https://vlr.gg/player/7268/6ix,2025-01-17 14:20:00,0.28,0.83,0.75,165,115,174,8,1,7,13,2,11,3,0,3,-1,-1,0,71%,50%,75%,107,80,112,35%,100%,32%,0,0,0,1,1,0
2,https://vlr.gg/player/29553/dagg3r,2025-01-17 14:20:00,0.04,0.84,0.72,168,22,193,8,0,8,13,2,11,4,0,4,+1,0,+1,57%,,67%,105,22,119,69%,0%,75%,2,0,2,1,0,1
3,https://vlr.gg/player/5498/kipperman,2025-01-17 14:20:00,0.02,0.74,0.62,125,,146,6,0,6,12,2,10,4,0,4,-4,-1,-3,57%,,67%,90,,106,31%,,31%,0,0,0,4,1,3
4,https://vlr.gg/player/2316/dreamas,2025-01-17 14:20:00,0.42,0.16,0.20,62,160,46,2,1,1,13,2,11,2,1,1,-2,0,-2,43%,100%,33%,46,88,39,11%,33%,6%,0,0,0,2,0,2
5,https://vlr.gg/player/33974/appa,2025-01-17 14:20:00,1.83,1.26,1.75,361,379,252,19,17,2,8,6,2,2,2,0,+4,+3,+1,100%,100%,100%,207,222,117,26%,26%,25%,4,3,1,0,0,0
6,https://vlr.gg/player/27789/deyten,2025-01-17 14:20:00,1.73,0.67,1.57,243,268,95,13,13,0,5,4,1,8,6,2,0,0,0,93%,92%,100%,164,178,83,35%,38%,0%,0,0,0,0,0,0
7,https://vlr.gg/player/18384/bully,2025-01-17 14:20:00,1.23,3.13,1.50,207,154,527,11,7,4,3,3,0,1,1,0,+4,+3,+1,93%,92%,100%,143,114,312,48%,41%,60%,4,3,1,0,0,0
8,https://vlr.gg/player/47270/darkwinjett,2025-01-17 14:20:00,1.09,1.80,1.19,245,239,289,13,10,3,10,9,1,12,10,2,-2,-2,0,79%,75%,100%,157,151,199,36%,32%,67%,1,1,0,3,3,0
9,https://vlr.gg/player/3934/eleo,2025-01-17 14:20:00,1.13,1.31,1.16,170,183,97,9,8,1,6,6,0,12,11,1,0,0,0,71%,67%,100%,123,135,53,35%,33%,50%,1,1,0,1,1,0
10,https://vlr.gg/player/33292/martux,2025-01-17 13:15:00,0.99,1.26,1.14,224,210,235,17,7,10,14,6,8,5,2,3,-3,-3,0,67%,56%,75%,143,133,151,25%,20%,35%,1,0,1,4,3,1
11,https://vlr.gg/player/11332/ara,2025-01-17 13:15:00,1.26,0.85,1.03,228,261,204,15,7,8,15,6,9,5,3,2,+2,0,+2,81%,89%,75%,156,185,134,15%,14%,15%,3,0,3,1,0,1
12,https://vlr.gg/player/38840/lamelly,2025-01-17 13:15:00,1.35,0.71,0.98,194,250,153,14,8,6,14,5,9,8,5,3,-1,0,-1,71%,78%,67%,114,142,93,26%,24%,28%,0,0,0,1,0,1
13,https://vlr.gg/player/29634/cintyx,2025-01-17 13:15:00,0.85,0.71,0.77,165,159,171,11,5,6,17,7,10,7,1,6,0,+3,-3,62%,67%,58%,111,94,123,33%,41%,26%,3,3,0,3,0,3
14,https://vlr.gg/player/50186/qu1ckz,2025-01-17 13:15:00,0.45,0.50,0.48,123,115,130,9,4,5,17,7,10,3,2,1,-1,-1,0,57%,56%,58%,83,80,84,38%,57%,29%,2,1,1,3,2,1
15,https://vlr.gg/player/252/d3ffo,2025-01-17 13:15:00,1.12,2.14,1.56,342,283,421,23,11,12,13,8,5,7,3,4,+1,-1,+2,81%,75%,89%,229,190,281,11%,9%,14%,3,1,2,2,2,0
16,https://vlr.gg/player/22617/vitie,2025-01-17 13:15:00,1.58,0.90,1.29,178,227,114,14,10,4,10,5,5,7,6,1,-1,-1,0,76%,83%,67%,107,127,80,32%,35%,29%,1,0,1,2,1,1
17,https://vlr.gg/player/30901/ianto,2025-01-17 13:15:00,1.46,0.83,1.19,174,220,114,11,8,3,11,6,5,11,8,3,-1,0,-1,67%,75%,56%,128,149,100,24%,21%,31%,1,1,0,2,1,1
18,https://vlr.gg/player/7106/diseased,2025-01-17 13:15:00,1.14,1.04,1.10,224,208,245,18,10,8,16,7,9,5,4,1,+2,+1,+1,81%,92%,67%,144,142,146,44%,38%,58%,3,1,2,1,0,1
19,https://vlr.gg/player/23098/aphun,2025-01-17 13:15:00,0.70,0.51,0.62,147,161,130,10,7,3,17,9,8,12,5,7,+2,+3,-1,67%,67%,67%,97,95,100,27%,21%,38%,4,4,0,2,1,1
20,https://vlr.gg/player/23421/laser,2025-01-17 13:15:00,1.50,1.45,1.47,306,285,326,25,12,13,18,7,11,8,5,3,-1,0,-1,61%,64%,58%,179,165,192,29%,22%,38%,3,2,1,4,2,2
21,https://vlr.gg/player/42651/avey,2025-01-17 13:15:00,1.77,0.89,1.31,223,279,173,21,12,9,15,6,9,7,6,1,0,0,0,70%,73%,67%,131,167,99,36%,31%,43%,0,0,0,0,0,0
22,https://vlr.gg/player/42661/barck,2025-01-17 13:15:00,1.60,0.50,1.03,201,292,119,16,12,4,16,6,10,10,6,4,+1,+3,-2,61%,73%,50%,135,185,90,25%,32%,17%,3,3,0,2,0,2
23,https://vlr.gg/player/42650/mally,2025-01-17 13:15:00,0.63,1.00,0.82,153,131,174,12,5,7,16,7,9,5,2,3,-3,-2,-1,61%,64%,58%,114,84,142,15%,5%,24%,1,0,1,4,2,2
24,https://vlr.gg/player/16012/akira,2025-01-17 13:15:00,0.63,0.54,0.58,102,104,101,7,3,4,17,7,10,7,3,4,-2,-2,0,74%,82%,67%,70,74,67,9%,6%,13%,2,0,2,4,2,2
25,https://vlr.gg/player/2617/leare,2025-01-17 13:15:00,1.35,1.26,1.31,349,331,370,28,15,13,20,9,11,3,1,2,+4,+3,+1,87%,100%,73%,223,224,222,31%,46%,18%,5,3,2,1,0,1
26,https://vlr.gg/player/8838/chanformer,2025-01-17 13:15:00,1.13,1.02,1.08,210,190,233,16,9,7,16,7,9,8,2,6,+2,+1,+1,65%,67%,64%,138,113,165,30%,30%,31%,3,2,1,1,1,0
27,https://vlr.gg/player/11330/mcd,2025-01-17 13:15:00,1.24,0.65,0.96,142,178,105,11,8,3,13,6,7,11,7,4,+1,+1,0,65%,83%,45%,100,125,74,48%,47%,50%,2,1,1,1,0,1
28,https://vlr.gg/player/1848/incredible,2025-01-17 13:15:00,0.85,0.82,0.83,172,182,162,12,6,6,17,8,9,14,8,6,+2,+2,0,74%,83%,64%,116,120,112,18%,15%,21%,3,2,1,1,0,1
29,https://vlr.gg/player/10270/dev0,2025-01-17 13:15:00,1.04,0.39,0.73,164,231,92,15,11,4,15,7,8,3,2,1,-4,-3,-1,61%,67%,55%,112,166,53,33%,37%,25%,1,0,1,5,3,2
30,https://vlr.gg/player/458/chronicle,2025-01-17 12:00:00,1.17,1.23,1.20,219,220,218,51,25,26,38,19,19,27,17,10,0,+1,-1,71%,70%,72%,150,150,149,26%,27%,26%,5,3,2,5,2,3
31,https://vlr.gg/player/438/boaster,2025-01-17 12:00:00,1.08,1.18,1.13,221,211,229,50,24,26,45,23,22,32,14,18,+1,+2,-1,74%,73%,75%,141,139,144,22%,22%,22%,9,5,4,8,3,5
32,https://vlr.gg/player/9810/alfajer,2025-01-17 12:00:00,1.19,0.94,1.07,231,255,206,54,31,23,49,24,25,22,8,14,+9,+7,+2,74%,82%,66%,150,165,135,22%,27%,17%,12,7,5,3,0,3
33,https://vlr.gg/player/4/crashies,2025-01-17 12:00:00,1.01,1.11,1.06,186,159,212,46,21,25,38,19,19,17,6,11,+2,0,+2,80%,73%,88%,129,118,140,38%,34%,41%,4,1,3,2,1,1
34,https://vlr.gg/player/9554/kaajak,2025-01-17 12:00:00,0.91,1.05,0.98,202,196,208,46,22,24,45,23,22,14,8,6,-1,-1,0,68%,67%,69%,131,128,134,29%,29%,29%,8,5,3,9,6,3
35,https://vlr.gg/player/5554/profek,2025-01-17 12:00:00,1.30,0.94,1.12,205,235,174,49,28,21,45,22,23,18,7,11,-1,+3,-4,68%,69%,67%,145,175,116,30%,37%,24%,4,4,0,5,1,4
36,https://vlr.gg/player/5568/sociablee,2025-01-17 12:00:00,1.02,1.10,1.06,225,237,214,51,25,26,51,26,25,14,10,4,0,+2,-2,68%,75%,61%,145,158,132,21%,22%,20%,5,4,1,5,2,3
37,https://vlr.gg/player/20144/lewn,2025-01-17 12:00:00,0.59,1.09,0.85,195,151,237,43,17,26,51,26,25,12,4,8,-4,-4,0,69%,69%,70%,128,97,157,41%,41%,42%,12,5,7,16,9,7
38,https://vlr.gg/player/9780/jamppi,2025-01-17 12:00:00,0.92,0.75,0.83,166,169,163,40,22,18,50,24,26,20,10,10,-3,-1,-2,72%,75%,70%,108,109,107,26%,26%,25%,3,1,2,6,2,4
39,https://vlr.gg/player/172/vakk,2025-01-17 12:00:00,0.57,0.77,0.67,142,131,158,32,15,17,50,26,24,14,7,7,-3,-2,-1,60%,53%,67%,92,84,100,38%,34%,41%,3,1,2,6,3,3
40,https://vlr.gg/player/8440/puggy,2025-01-17 12:00:00,1.14,1.50,1.31,231,193,278,19,9,10,11,6,5,9,6,3,-3,-2,-1,82%,92%,70%,166,142,194,36%,44%,30%,1,0,1,4,2,2
41,https://vlr.gg/player/12471/kalkkuna,2025-01-17 12:00:00,1.33,1.07,1.21,255,252,259,20,11,9,13,7,6,4,2,2,-3,-1,-2,73%,83%,60%,148,140,158,38%,39%,38%,2,2,0,5,3,2
42,https://vlr.gg/player/13024/vuubit,2025-01-17 12:00:00,1.22,1.18,1.20,231,267,189,17,12,5,14,8,6,10,3,7,+1,-1,+2,82%,83%,80%,160,186,129,39%,52%,24%,3,1,2,2,2,0
43,https://vlr.gg/player/6101/999kvmil,2025-01-17 12:00:00,0.67,1.38,0.99,121,90,158,10,4,6,10,7,3,13,8,5,0,-1,+1,82%,83%,80%,74,42,111,15%,7%,21%,1,0,1,1,1,0
44,https://vlr.gg/player/15491/maximn,2025-01-17 12:00:00,1.27,0.55,0.94,156,225,73,12,10,2,11,6,5,7,3,4,-3,-1,-2,82%,83%,80%,115,166,53,28%,30%,22%,0,0,0,3,1,2
45,https://vlr.gg/player/36748/czester,2025-01-17 12:00:00,1.39,0.94,1.15,181,202,165,15,8,7,14,5,9,10,5,5,+3,+1,+2,64%,60%,67%,103,128,81,48%,50%,44%,3,1,2,0,0,0
46,https://vlr.gg/player/19505/szalony,2025-01-17 12:00:00,0.65,1.58,1.15,205,114,283,17,4,13,13,6,7,2,1,1,0,-1,+1,68%,60%,75%,138,77,190,29%,21%,33%,3,1,2,3,2,1
47,https://vlr.gg/player/9556/demek,2025-01-17 12:00:00,0.59,1.27,0.96,210,179,237,17,6,11,18,8,10,2,1,1,+3,+1,+2,64%,60%,67%,134,113,152,22%,25%,21%,6,2,4,3,1,2
48,https://vlr.gg/player/10448/kozok,2025-01-17 12:00:00,0.84,0.21,0.50,82,106,63,4,3,1,15,5,10,11,6,5,+1,+1,0,64%,80%,50%,56,59,54,25%,20%,29%,1,1,0,0,0,0
49,https://vlr.gg/player/9557/nefi,2025-01-17 12:00:00,0.47,0.39,0.43,108,124,96,6,4,2,18,8,10,13,5,8,+1,0,+1,55%,50%,58%,72,77,68,33%,33%,33%,2,1,1,1,1,0
50,https://vlr.gg/player/33974/appa,2025-01-17 12:00:00,0.50,1.41,1.14,282,163,332,16,3,13,16,5,11,1,0,1,+1,-1,+2,65%,80%,58%,164,100,191,34%,13%,38%,3,0,3,2,1,1
51,https://vlr.gg/player/18384/bully,2025-01-17 12:00:00,0.97,0.76,0.82,151,268,103,9,5,4,12,4,8,0,0,0,+3,+2,+1,53%,80%,42%,109,169,83,38%,50%,35%,4,2,2,1,0,1
52,https://vlr.gg/player/47270/darkwinjett,2025-01-17 12:00:00,0.38,0.81,0.69,160,109,182,8,1,7,16,4,12,9,4,5,-1,-1,0,65%,80%,58%,113,71,131,27%,17%,30%,0,0,0,1,1,0
53,https://vlr.gg/player/3934/eleo,2025-01-17 12:00:00,0.63,0.51,0.55,168,192,159,7,3,4,14,4,10,3,1,2,-2,0,-2,59%,80%,50%,141,145,140,27%,11%,38%,0,0,0,2,0,2
54,https://vlr.gg/player/27789/deyten,2025-01-17 12:00:00,0.48,0.42,0.44,66,135,39,5,3,2,12,4,8,2,1,1,-4,-1,-3,47%,60%,42%,38,59,29,44%,75%,20%,0,0,0,4,1,3
55,https://vlr.gg/player/30901/ianto,2025-01-17 12:00:00,1.23,2.21,1.52,311,264,426,19,11,8,9,7,2,3,3,0,+3,+2,+1,76%,67%,100%,197,152,304,24%,15%,32%,4,3,1,1,1,0
56,https://vlr.gg/player/252/d3ffo,2025-01-17 12:00:00,1.73,0.86,1.47,303,363,159,19,17,2,10,6,4,2,0,2,+4,+2,+2,88%,92%,80%,187,218,111,32%,33%,25%,5,3,2,1,1,0
57,https://vlr.gg/player/7106/diseased,2025-01-17 12:00:00,0.95,1.80,1.20,170,165,183,11,7,4,6,5,1,2,1,1,0,+1,-1,82%,83%,80%,140,136,150,48%,43%,57%,1,1,0,1,0,1
58,https://vlr.gg/player/22617/vitie,2025-01-17 12:00:00,1.12,0.86,1.05,207,236,140,13,10,3,10,6,4,9,7,2,-4,-3,-1,76%,75%,80%,115,140,55,35%,47%,0%,0,0,0,4,3,1
59,https://vlr.gg/player/23098/aphun,2025-01-17 12:00:00,0.67,1.23,0.84,139,111,208,8,4,4,10,6,4,6,3,3,0,0,0,71%,67%,80%,84,71,116,19%,27%,8%,0,0,0,0,0,0
60,https://vlr.gg/player/23197/knowbii,2025-01-17 12:00:00,1.30,0.72,1.05,185,217,145,13,10,3,14,7,7,9,2,7,-3,-2,-1,86%,83%,89%,120,142,91,22%,24%,20%,0,0,0,3,2,1
61,https://vlr.gg/player/15080/f1co,2025-01-17 12:00:00,0.88,1.15,1.00,185,182,190,14,7,7,15,9,6,2,2,0,-2,-1,-1,52%,58%,44%,125,126,124,33%,32%,36%,0,0,0,2,1,1
62,https://vlr.gg/player/23198/wak1e,2025-01-17 12:00:00,1.08,0.63,0.88,185,221,138,13,9,4,15,9,6,4,3,1,-3,0,-3,57%,67%,44%,128,150,97,39%,36%,45%,1,1,0,4,1,3
63,https://vlr.gg/player/1620/ale,2025-01-17 12:00:00,0.71,0.89,0.78,200,202,199,14,8,6,19,11,8,3,2,1,+1,+1,0,76%,75%,78%,117,122,112,7%,12%,0%,3,2,1,2,1,1
64,https://vlr.gg/player/19058/folke,2025-01-17 12:00:00,0.52,0.95,0.70,163,145,188,11,5,6,18,10,8,4,3,1,-2,-2,0,62%,58%,67%,119,99,147,46%,58%,38%,2,1,1,4,3,1
65,https://vlr.gg/player/11332/ara,2025-01-17 12:00:00,1.78,1.97,1.89,428,469,398,29,14,15,13,7,6,5,2,3,+5,+3,+2,90%,78%,100%,289,315,269,18%,18%,18%,5,3,2,0,0,0
66,https://vlr.gg/player/38840/lamelly,2025-01-17 12:00:00,1.45,1.41,1.43,222,200,240,17,7,10,10,3,7,10,4,6,+2,+2,0,71%,67%,75%,129,101,149,26%,38%,22%,3,2,1,1,0,1
67,https://vlr.gg/player/33292/martux,2025-01-17 12:00:00,1.45,0.96,1.17,227,265,200,19,9,10,13,4,9,7,3,4,+3,+2,+1,81%,89%,75%,141,162,126,22%,22%,23%,5,2,3,2,0,2
68,https://vlr.gg/player/29634/cintyx,2025-01-17 12:00:00,0.44,0.89,0.70,121,63,165,9,2,7,14,6,8,6,2,4,0,-1,+1,67%,67%,67%,82,38,115,23%,25%,22%,1,0,1,1,1,0
69,https://vlr.gg/player/50186/qu1ckz,2025-01-17 12:00:00,0.65,0.42,0.52,104,96,110,7,3,4,15,6,9,11,8,3,-1,-1,0,76%,89%,67%,71,62,78,30%,50%,21%,1,0,1,2,1,1
70,https://vlr.gg/player/2525/szimpli,2025-01-17 11:00:00,2.56,1.29,1.89,336,485,200,29,21,8,13,7,6,4,1,3,+5,+2,+3,87%,91%,83%,240,335,153,47%,63%,26%,6,3,3,1,1,0
71,https://vlr.gg/player/10378/almo,2025-01-17 11:00:00,1.35,1.11,1.23,223,228,220,21,10,11,15,6,9,8,4,4,+1,0,+1,87%,82%,92%,160,164,156,29%,35%,25%,1,0,1,0,0,0
72,https://vlr.gg/player/2701/maniek,2025-01-17 11:00:00,0.29,1.57,0.96,237,123,342,17,3,14,19,10,9,9,4,5,-2,-4,+2,70%,64%,75%,167,90,237,22%,10%,30%,5,1,4,7,5,2
73,https://vlr.gg/player/4525/stix,2025-01-17 11:00:00,0.60,1.21,0.92,168,129,204,13,4,9,16,9,7,11,6,5,+2,+1,+1,91%,91%,92%,114,89,136,34%,35%,33%,2,1,1,0,0,0
74,https://vlr.gg/player/164/bzt,2025-01-17 11:00:00,0.61,1.03,0.83,137,100,171,11,4,7,14,7,7,9,4,5,+1,0,+1,83%,82%,83%,93,60,124,31%,21%,40%,1,0,1,0,0,0
75,https://vlr.gg/player/5566/jeyj7y,2025-01-17 11:00:00,1.06,1.57,1.31,290,258,326,24,11,13,18,10,8,7,3,4,+1,0,+1,83%,75%,91%,178,145,214,28%,31%,24%,2,1,1,1,1,0
76,https://vlr.gg/player/4214/eso177,2025-01-17 11:00:00,1.23,1.04,1.14,258,244,274,19,10,9,19,9,10,15,6,9,+2,0,+2,91%,92%,91%,164,147,183,25%,27%,23%,2,0,2,0,0,0
77,https://vlr.gg/player/12372/szoren,2025-01-17 11:00:00,0.61,1.24,0.91,186,159,217,14,6,8,17,10,7,10,3,7,-3,-2,-1,74%,67%,82%,129,122,138,16%,16%,15%,0,0,0,3,2,1
78,https://vlr.gg/player/31298/luca,2025-01-17 11:00:00,0.91,0.55,0.74,121,154,86,10,6,4,17,9,8,4,4,0,0,0,0,70%,75%,64%,85,107,61,22%,19%,30%,2,1,1,2,1,1
79,https://vlr.gg/player/34002/lukey,2025-01-17 11:00:00,0.22,0.48,0.34,115,97,135,10,5,5,20,11,9,1,0,1,-7,-6,-1,57%,42%,73%,80,66,96,29%,17%,38%,2,0,2,9,6,3
80,https://vlr.gg/player/11578/hotsauz,2025-01-17 08:55:00,1.29,1.19,1.24,248,259,237,34,19,15,29,15,14,12,6,6,+4,+2,+2,73%,71%,75%,169,172,166,31%,31%,30%,6,3,3,2,1,1
81,https://vlr.gg/player/7746/kevzii,2025-01-17 08:55:00,1.29,0.69,1.00,216,264,165,27,18,9,31,15,16,14,8,6,+1,+2,-1,80%,86%,75%,146,172,119,46%,45%,47%,4,3,1,3,1,2
82,https://vlr.gg/player/16953/zynd,2025-01-17 08:55:00,0.89,0.88,0.88,223,179,270,33,18,15,38,20,18,6,4,2,-3,-1,-2,61%,62%,60%,136,137,135,39%,38%,40%,5,3,2,8,4,4
83,https://vlr.gg/player/9747/emman,2025-01-17 08:55:00,0.21,1.00,0.60,121,64,180,18,5,13,33,18,15,9,4,5,0,0,0,56%,38%,75%,85,39,134,30%,15%,35%,1,0,1,1,0,1
84,https://vlr.gg/player/9737/kakarot,2025-01-17 08:55:00,0.45,0.61,0.53,132,105,161,20,9,11,35,18,17,6,3,3,-5,-2,-3,51%,57%,45%,81,73,89,23%,22%,26%,3,2,1,8,4,4
85,https://vlr.gg/player/17303/fontuz,2025-01-17 08:55:00,0.96,1.46,1.22,236,169,301,34,12,22,26,12,14,12,5,7,+2,+2,0,78%,75%,81%,149,115,182,29%,23%,33%,3,2,1,1,0,1
86,https://vlr.gg/player/41701/ki1wsy,2025-01-17 08:55:00,0.79,1.43,1.12,247,202,292,36,14,22,28,14,14,12,4,8,-1,-1,0,73%,70%,76%,159,125,191,23%,23%,24%,6,3,3,7,4,3
87,https://vlr.gg/player/31537/basbabe,2025-01-17 08:55:00,1.25,0.98,1.11,188,237,139,28,17,11,24,13,11,13,7,6,+2,0,+2,80%,90%,71%,120,150,92,38%,41%,33%,3,1,2,1,1,0
88,https://vlr.gg/player/20623/harddora,2025-01-17 08:55:00,1.63,0.61,1.11,207,268,149,32,21,11,26,10,16,9,4,5,-1,+1,-2,76%,80%,71%,138,171,106,34%,32%,38%,3,3,0,4,2,2
89,https://vlr.gg/player/41694/endoist,2025-01-17 08:55:00,0.89,1.27,1.09,242,213,270,36,16,20,28,14,14,3,0,3,+1,+2,-1,66%,65%,67%,156,136,175,39%,34%,45%,7,3,4,6,1,5
90,https://vlr.gg/player/3520/zmjjkk,2025-01-17 06:10:00,,,,305,,,49,,,31,,,10,,,,,,,,,,,,,,,,,,,,
91,https://vlr.gg/player/15559/chichoo,2025-01-17 06:10:00,,,,211,,,33,,,27,,,10,,,,,,,,,,,,,,,,,,,,
92,https://vlr.gg/player/13768/s1mon,2025-01-17 06:10:00,,,,209,,,27,,,32,,,29,,,,,,,,,,,,,,,,,,,,
93,https://vlr.gg/player/4742/smoggy,2025-01-17 06:10:00,,,,183,,,31,,,31,,,20,,,,,,,,,,,,,,,,,,,,
94,https://vlr.gg/player/3017/nobody,2025-01-17 06:10:00,,,,171,,,26,,,30,,,11,,,,,,,,,,,,,,,,,,,,
95,https://vlr.gg/player/39697/cb,2025-01-17 06:10:00,,,,257,,,39,,,35,,,12,,,,,,,,,,,,,,,,,,,,
96,https://vlr.gg/player/41054/guang,2025-01-17 06:10:00,,,,232,,,40,,,29,,,4,,,,,,,,,,,,,,,,,,,,
97,https://vlr.gg/player/46460/ezeir,2025-01-17 06:10:00,,,,219,,,27,,,35,,,25,,,,,,,,,,,,,,,,,,,,
98,https://vlr.gg/player/1209/swerl,2025-01-17 06:10:00,,,,200,,,31,,,34,,,6,,,,,,,,,,,,,,,,,,,,
99,https://vlr.gg/player/4402/o0o0o,2025-01-17 06:10:00,,,,96,,,14,,,33,,,17,,,,,,,,,,,,,,,,,,,,
100,https://vlr.gg/player/44930/nex1sphix,2025-01-17 06:00:00,1.48,1.20,1.34,235,246,222,63,33,30,46,22,24,30,16,14,+2,+2,0,77%,74%,81%,158,157,159,36%,37%,36%,4,2,2,2,0,2
101,https://vlr.gg/player/40910/consz,2025-01-17 06:00:00,1.10,1.13,1.12,224,242,199,54,29,25,47,25,22,16,5,11,+4,+5,-1,71%,71%,72%,151,159,144,25%,32%,18%,13,8,5,9,3,6
102,https://vlr.gg/player/40907/mnfear,2025-01-17 06:00:00,0.84,1.24,1.05,210,174,241,49,17,32,49,25,24,33,19,14,-3,-3,0,71%,65%,78%,136,127,145,20%,19%,20%,6,2,4,9,5,4
103,https://vlr.gg/player/40908/skyisblue,2025-01-17 06:00:00,0.71,1.11,0.91,206,185,231,54,22,32,59,31,28,21,9,12,+5,0,+5,69%,62%,75%,126,112,139,18%,18%,17%,11,5,6,6,5,1
104,https://vlr.gg/player/44770/cxix666,2025-01-17 06:00:00,0.87,0.89,0.88,157,144,169,35,17,18,46,22,24,29,15,14,-2,-4,+2,79%,76%,81%,112,108,116,22%,23%,22%,4,0,4,6,4,2
105,https://vlr.gg/player/1430/crazyguy,2025-01-17 06:00:00,1.42,0.95,1.19,242,266,221,58,35,23,50,24,26,19,11,8,+2,+2,0,76%,81%,71%,168,190,144,36%,39%,32%,10,5,5,8,3,5
106,https://vlr.gg/player/13220/ja,2025-01-17 06:00:00,0.99,1.27,1.13,224,204,246,58,28,30,46,24,22,12,3,9,-3,-3,0,73%,61%,85%,145,121,170,33%,26%,39%,4,1,3,7,4,3
107,https://vlr.gg/player/24628/wayne,2025-01-17 06:00:00,0.79,1.13,0.95,190,164,227,45,20,25,51,27,24,29,14,15,-1,-1,0,71%,72%,71%,124,103,146,25%,26%,25%,6,2,4,7,3,4
108,https://vlr.gg/player/24653/vera,2025-01-17 06:00:00,0.77,0.96,0.87,223,210,236,49,22,27,59,32,27,17,7,10,0,-1,+1,67%,56%,79%,150,134,167,14%,10%,21%,9,5,4,9,6,3
109,https://vlr.gg/player/11704/styron,2025-01-17 06:00:00,0.53,0.98,0.75,144,139,153,36,16,20,50,30,20,38,26,12,-4,-3,-1,69%,67%,71%,91,88,93,13%,11%,14%,3,2,1,7,5,2
110,https://vlr.gg/player/37494/kai,2025-01-17 04:00:00,,,,243,,,35,,,31,,,8,,,,,,,,,,,,,,,,,,,,
111,https://vlr.gg/player/4770/fengf,2025-01-17 04:00:00,,,,241,,,38,,,24,,,4,,,,,,,,,,,,,,,,,,,,
112,https://vlr.gg/player/3021/biank,2025-01-17 04:00:00,,,,240,,,34,,,27,,,16,,,,,,,,,,,,,,,,,,,,
113,https://vlr.gg/player/3045/luok1ng,2025-01-17 04:00:00,,,,212,,,31,,,22,,,28,,,,,,,,,,,,,,,,,,,,
114,https://vlr.gg/player/4712/heybay,2025-01-17 04:00:00,,,,163,,,24,,,23,,,17,,,,,,,,,,,,,,,,,,,,
115,https://vlr.gg/player/11524/nicc,2025-01-17 04:00:00,,,,234,,,35,,,29,,,14,,,,,,,,,,,,,,,,,,,,
116,https://vlr.gg/player/4705/flex1n,2025-01-17 04:00:00,,,,197,,,29,,,28,,,16,,,,,,,,,,,,,,,,,,,,
117,https://vlr.gg/player/7841/tvirusluke,2025-01-17 04:00:00,,,,180,,,25,,,36,,,6,,,,,,,,,,,,,,,,,,,,
118,https://vlr.gg/player/3741/vo0kashu,2025-01-17 04:00:00,,,,154,,,22,,,35,,,6,,,,,,,,,,,,,,,,,,,,
119,https://vlr.gg/player/31753/spiritz1,2025-01-17 04:00:00,,,,116,,,16,,,34,,,15,,,,,,,,,,,,,,,,,,,,
120,https://vlr.gg/player/8480/aspas,2025-01-16 19:45:00,1.08,1.22,1.16,232,213,264,30,12,18,29,11,18,6,3,3,-1,-1,0,72%,65%,77%,166,151,178,24%,32%,19%,4,0,4,5,1,4
121,https://vlr.gg/player/725/nzr,2025-01-16 19:45:00,0.95,0.81,0.87,167,144,174,21,9,12,28,11,17,8,3,5,-2,-1,-1,54%,47%,59%,111,98,121,31%,20%,41%,2,1,1,4,2,2
122,https://vlr.gg/player/20240/xenom,2025-01-16 19:45:00,1.47,0.25,0.73,197,312,102,25,19,6,34,12,22,16,8,8,-1,+1,-2,67%,82%,55%,121,186,71,28%,32%,22%,3,2,1,4,1,3
123,https://vlr.gg/player/5957/artzin,2025-01-16 19:45:00,0.64,0.56,0.57,135,172,115,17,9,8,33,14,19,8,6,2,-7,-5,-2,56%,71%,45%,100,118,86,31%,35%,28%,1,1,0,8,6,2
124,https://vlr.gg/player/5395/cortezia,2025-01-16 19:45:00,0.62,0.51,0.55,113,136,108,17,9,8,30,12,18,3,0,3,-6,-3,-3,46%,41%,50%,79,90,71,38%,40%,37%,1,0,1,7,3,4
125,https://vlr.gg/player/4147/cryocells,2025-01-16 19:45:00,1.62,1.26,1.46,275,301,245,38,24,14,22,11,11,9,5,4,+4,-1,+5,87%,86%,88%,193,220,158,21%,21%,22%,6,1,5,2,2,0
126,https://vlr.gg/player/601/asuna,2025-01-16 19:45:00,1.48,1.33,1.41,305,318,272,41,25,16,24,14,10,11,8,3,+10,+7,+3,82%,91%,71%,187,201,169,25%,24%,25%,14,9,5,4,2,2
127,https://vlr.gg/player/796/eeiu,2025-01-16 19:45:00,1.72,0.74,1.29,193,224,156,30,21,9,19,6,13,14,9,5,+3,+3,0,77%,95%,53%,132,160,95,43%,53%,30%,3,3,0,0,0,0
128,https://vlr.gg/player/604/boostio,2025-01-16 19:45:00,1.04,1.00,1.02,158,140,185,24,11,13,20,8,12,18,14,4,-2,-1,-1,85%,86%,82%,101,91,114,33%,26%,42%,0,0,0,2,1,1
129,https://vlr.gg/player/8082/zander,2025-01-16 19:45:00,0.90,0.83,0.87,159,161,157,21,13,8,25,13,12,13,8,5,+2,0,+2,79%,86%,71%,100,97,104,23%,24%,21%,5,2,3,3,2,1
130,https://vlr.gg/player/881/yay,2025-01-16 17:00:00,0.79,1.20,1.00,209,168,245,35,15,20,33,18,15,9,5,4,+2,0,+2,57%,46%,68%,142,115,167,29%,36%,25%,8,3,5,6,3,3
131,https://vlr.gg/player/4927/nature,2025-01-16 17:00:00,0.79,1.13,0.97,198,160,234,33,12,21,34,19,15,9,5,4,+3,+2,+1,71%,67%,76%,132,117,147,24%,19%,28%,5,3,2,2,1,1
132,https://vlr.gg/player/8402/icy,2025-01-16 17:00:00,0.69,1.19,0.95,193,163,224,34,14,20,35,20,15,7,4,3,-4,-4,0,65%,58%,72%,135,117,152,20%,27%,15%,4,2,2,8,6,2
133,https://vlr.gg/player/826/supamen,2025-01-16 17:00:00,0.80,1.06,0.93,162,160,164,30,14,16,31,18,13,14,4,10,-1,-2,+1,69%,67%,72%,95,97,93,25%,25%,24%,3,1,2,4,3,1
134,https://vlr.gg/player/1533/derrek,2025-01-16 17:00:00,0.77,0.84,0.81,161,158,163,25,13,12,34,18,16,23,12,11,-3,-2,-1,73%,71%,76%,109,102,115,31%,34%,28%,3,0,3,6,2,4
135,https://vlr.gg/player/8873/dgzin,2025-01-16 17:00:00,1.07,1.45,1.26,245,237,260,41,19,22,30,19,11,8,3,5,+7,0,+7,69%,64%,75%,165,166,163,25%,33%,15%,13,5,8,6,5,1
136,https://vlr.gg/player/6193/cauanzin,2025-01-16 17:00:00,1.30,1.14,1.22,260,276,242,41,23,18,35,19,16,11,3,8,-3,-2,-1,65%,48%,83%,172,178,165,33%,41%,25%,5,3,2,8,5,3
137,https://vlr.gg/player/1586/v1nny,2025-01-16 17:00:00,1.15,1.23,1.19,191,177,198,33,14,19,29,16,13,27,15,12,-1,0,-1,76%,68%,83%,134,129,139,30%,27%,33%,2,1,1,3,1,2
138,https://vlr.gg/player/683/pancada,2025-01-16 17:00:00,0.71,1.25,0.98,159,112,205,28,10,18,29,16,13,19,6,13,0,+1,-1,82%,68%,96%,107,73,143,37%,36%,37%,2,1,1,2,0,2
139,https://vlr.gg/player/2408/tuyz,2025-01-16 17:00:00,0.44,0.99,0.71,129,88,177,24,8,16,34,19,15,15,6,9,0,-2,+2,65%,60%,71%,85,62,108,29%,20%,34%,4,1,3,4,3,1
140,https://vlr.gg/player/17976/florescent,2025-01-16 15:10:00,1.21,0.94,1.09,244,283,189,39,24,15,36,19,17,3,3,0,+2,+3,-1,70%,76%,62%,164,191,131,35%,39%,30%,8,6,2,6,3,3
141,https://vlr.gg/player/1851/oderus,2025-01-16 15:10:00,1.13,0.64,0.90,185,225,153,31,21,10,34,16,18,13,8,5,-6,-3,-3,65%,80%,48%,133,153,108,38%,44%,31%,0,0,0,6,3,3
142,https://vlr.gg/player/1507/avova,2025-01-16 15:10:00,0.85,0.90,0.87,183,139,235,29,14,15,34,15,19,17,7,10,+4,+3,+1,78%,80%,76%,108,88,131,36%,37%,36%,6,3,3,2,0,2
143,https://vlr.gg/player/129/hype,2025-01-16 15:10:00,0.92,0.55,0.75,161,191,147,27,18,9,36,17,19,6,3,3,-4,-4,0,54%,60%,48%,110,123,95,26%,26%,25%,4,2,2,8,6,2
144,https://vlr.gg/player/1281/molsi,2025-01-16 15:10:00,1.07,0.30,0.72,133,167,90,19,14,5,34,14,20,23,15,8,-4,0,-4,74%,84%,62%,89,114,59,28%,29%,25%,1,1,0,5,1,4
145,https://vlr.gg/player/23169/minny,2025-01-16 15:10:00,1.57,1.05,1.29,237,277,206,42,23,19,29,9,20,11,4,7,+1,-2,+3,76%,81%,72%,147,166,132,37%,38%,36%,4,1,3,3,3,0
146,https://vlr.gg/player/7866/click,2025-01-16 15:10:00,1.71,0.82,1.22,261,396,150,43,29,14,33,14,19,7,4,3,+4,+6,-2,76%,90%,64%,170,244,107,34%,34%,35%,12,8,4,8,2,6
147,https://vlr.gg/player/11/zyppan,2025-01-16 15:10:00,1.49,0.92,1.18,218,226,212,39,20,19,29,9,20,16,14,2,0,+1,-1,72%,90%,56%,151,154,148,33%,31%,36%,4,2,2,4,1,3
148,https://vlr.gg/player/20871/k4davra,2025-01-16 15:10:00,1.04,0.94,0.99,153,151,152,24,12,12,27,10,17,19,11,8,+4,+1,+3,72%,76%,68%,100,102,99,34%,25%,45%,4,1,3,0,0,0
149,https://vlr.gg/player/5893/robbiebk,2025-01-16 15:10:00,0.80,1.07,0.95,180,117,216,26,9,17,27,12,15,13,4,9,-1,+1,-2,80%,81%,80%,120,86,148,36%,38%,35%,3,2,1,4,1,3
150,https://vlr.gg/player/11494/keiko,2025-01-16 12:00:00,1.56,1.48,1.52,277,275,277,65,36,29,37,20,17,23,13,10,+4,+3,+1,84%,89%,78%,173,172,175,55%,57%,53%,8,6,2,4,3,1
151,https://vlr.gg/player/309/patitek,2025-01-16 12:00:00,1.28,0.86,1.10,204,231,159,43,31,12,38,22,16,32,17,15,-2,0,-2,87%,94%,78%,139,156,117,22%,25%,18%,3,2,1,5,2,3
152,https://vlr.gg/player/1475/kamyk,2025-01-16 12:00:00,1.02,0.92,0.97,169,189,145,41,25,16,36,22,14,9,7,2,-2,-1,-1,71%,74%,67%,110,125,89,26%,26%,25%,5,2,3,7,3,4
153,https://vlr.gg/player/457/nats,2025-01-16 12:00:00,0.95,0.76,0.87,181,189,160,36,23,13,45,26,19,17,12,5,+7,+2,+5,69%,74%,63%,122,131,110,19%,16%,22%,10,3,7,3,1,2
154,https://vlr.gg/player/14681/kamo,2025-01-16 12:00:00,0.48,1.24,0.81,183,147,227,42,19,23,47,30,17,5,3,2,-1,-5,+4,65%,60%,70%,123,95,159,28%,22%,35%,8,4,4,9,9,0
155,https://vlr.gg/player/4544/filu,2025-01-16 12:00:00,0.73,1.41,1.11,245,189,280,53,17,36,49,23,26,9,4,5,-3,-6,+3,77%,70%,83%,158,128,182,28%,31%,27%,10,4,6,13,10,3
156,https://vlr.gg/player/5550/grubinho,2025-01-16 12:00:00,1.21,1.00,1.09,184,173,202,43,18,25,41,13,28,26,9,17,+1,+3,-2,74%,74%,74%,116,104,126,26%,29%,24%,7,4,3,6,1,5
157,https://vlr.gg/player/3685/flyuh,2025-01-16 12:00:00,0.86,0.79,0.82,180,182,178,37,18,19,49,21,28,20,6,14,-5,-4,-1,66%,56%,74%,117,122,113,30%,34%,27%,6,1,5,11,5,6
158,https://vlr.gg/player/1428/sheydos,2025-01-16 12:00:00,0.92,0.73,0.82,149,156,157,32,14,18,45,18,27,15,6,9,+2,0,+2,68%,74%,63%,112,108,116,33%,36%,31%,3,1,2,1,1,0
159,https://vlr.gg/player/101/soulcas,2025-01-16 12:00:00,0.87,0.76,0.81,164,148,181,38,16,22,43,18,25,9,6,3,-1,0,-1,74%,89%,63%,118,98,133,34%,31%,35%,2,0,2,3,0,3
160,https://vlr.gg/player/45876/fixy,2025-01-16 09:00:00,1.16,1.08,1.12,280,272,288,40,20,20,36,18,18,10,7,3,+7,+2,+5,77%,77%,77%,188,190,185,22%,21%,24%,14,5,9,7,3,4
161,https://vlr.gg/player/7513/markl,2025-01-16 09:00:00,1.01,0.80,0.90,164,197,131,26,17,9,30,17,13,7,3,4,-2,-1,-1,73%,64%,82%,117,140,93,27%,26%,30%,3,3,0,5,4,1
162,https://vlr.gg/player/5886/flaring,2025-01-16 09:00:00,0.86,0.89,0.88,169,145,195,26,11,15,30,15,15,17,11,6,-1,+1,-2,68%,73%,64%,117,93,140,28%,22%,33%,1,1,0,2,0,2
163,https://vlr.gg/player/7443/riza,2025-01-16 09:00:00,0.80,0.89,0.85,168,180,157,27,15,12,33,18,15,15,8,7,0,-1,+1,70%,68%,73%,115,111,120,31%,35%,27%,3,1,2,3,2,1
164,https://vlr.gg/player/14209/suka,2025-01-16 09:00:00,0.36,0.94,0.65,143,65,222,22,4,18,35,17,18,20,10,10,-4,-3,-1,68%,64%,73%,98,60,137,45%,43%,46%,1,0,1,5,3,2
165,https://vlr.gg/player/13744/patmen,2025-01-16 09:00:00,1.31,1.33,1.32,250,251,250,42,20,22,30,16,14,5,5,0,+1,-2,+3,70%,68%,73%,169,180,158,41%,30%,59%,7,2,5,6,4,2
166,https://vlr.gg/player/16842/mojer,2025-01-16 09:00:00,1.41,1.09,1.25,240,270,210,35,20,15,30,16,14,14,6,8,0,+2,-2,73%,73%,73%,169,193,145,20%,25%,14%,5,4,1,5,2,3
167,https://vlr.gg/player/7754/xavi8k,2025-01-16 09:00:00,0.98,1.34,1.16,213,174,253,31,14,17,28,15,13,21,11,10,-1,-2,+1,77%,73%,82%,147,124,169,22%,28%,18%,5,1,4,6,3,3
168,https://vlr.gg/player/3401/ptc,2025-01-16 09:00:00,0.98,1.12,1.05,169,159,180,27,12,15,25,13,12,14,7,7,-1,0,-1,66%,59%,73%,114,111,117,45%,47%,44%,3,3,0,4,3,1
169,https://vlr.gg/player/6913/sultan,2025-01-16 09:00:00,0.92,1.13,1.02,174,152,197,28,12,16,28,14,14,12,7,5,+1,0,+1,70%,59%,82%,115,89,141,43%,25%,61%,2,0,2,1,0,1
170,https://vlr.gg/player/4885/whzy,2025-01-16 07:20:00,,,,235,,,59,,,53,,,19,,,,,,,,,,,,,,,,,,,,
171,https://vlr.gg/player/10698/nephh,2025-01-16 07:20:00,,,,216,,,51,,,48,,,31,,,,,,,,,,,,,,,,,,,,
172,https://vlr.gg/player/48878/rushia,2025-01-16 07:20:00,,,,174,,,43,,,43,,,24,,,,,,,,,,,,,,,,,,,,
173,https://vlr.gg/player/4774/knight,2025-01-16 07:20:00,,,,165,,,40,,,50,,,21,,,,,,,,,,,,,,,,,,,,
174,https://vlr.gg/player/40845/levius,2025-01-16 07:20:00,,,,163,,,46,,,46,,,10,,,,,,,,,,,,,,,,,,,,
175,https://vlr.gg/player/22047/rarga,2025-01-16 07:20:00,,,,279,,,70,,,51,,,5,,,,,,,,,,,,,,,,,,,,
176,https://vlr.gg/player/37927/happywei,2025-01-16 07:20:00,,,,200,,,52,,,50,,,20,,,,,,,,,,,,,,,,,,,,
177,https://vlr.gg/player/12365/coconut,2025-01-16 07:20:00,,,,193,,,47,,,43,,,21,,,,,,,,,,,,,,,,,,,,
178,https://vlr.gg/player/4710/you,2025-01-16 07:20:00,,,,170,,,40,,,47,,,40,,,,,,,,,,,,,,,,,,,,
179,https://vlr.gg/player/36415/viva,2025-01-16 07:20:00,,,,135,,,31,,,48,,,21,,,,,,,,,,,,,,,,,,,,
180,https://vlr.gg/player/13784/killua,2025-01-16 06:00:00,1.17,1.10,1.13,233,248,216,47,25,22,43,22,21,18,7,11,+4,+3,+1,80%,71%,89%,136,143,128,41%,53%,30%,6,4,2,2,1,1
181,https://vlr.gg/player/27244/seph1roth,2025-01-16 06:00:00,1.06,1.10,1.08,194,167,223,40,18,22,38,17,21,18,7,11,+2,+1,+1,80%,79%,82%,126,113,139,29%,29%,29%,5,2,3,3,1,2
182,https://vlr.gg/player/23930/potter,2025-01-16 06:00:00,0.76,1.20,0.98,218,183,244,41,19,22,40,22,18,15,4,11,+2,-2,+4,71%,61%,82%,140,121,160,30%,47%,22%,7,2,5,5,4,1
183,https://vlr.gg/player/8582/laz,2025-01-16 06:00:00,0.97,0.92,0.94,188,187,202,39,19,20,39,19,20,11,8,3,+2,-1,+3,63%,61%,64%,130,127,132,31%,29%,33%,8,3,5,6,4,2
184,https://vlr.gg/player/27254/leviathan,2025-01-16 06:00:00,0.82,0.80,0.81,165,167,167,32,15,17,42,21,21,17,8,9,-2,-1,-1,61%,64%,57%,107,114,101,31%,38%,25%,6,3,3,8,4,4
185,https://vlr.gg/player/36685/splash,2025-01-16 06:00:00,1.38,1.31,1.35,263,296,257,54,29,25,39,20,19,11,7,4,+1,-3,+4,71%,82%,61%,181,199,163,41%,38%,45%,9,3,6,8,6,2
186,https://vlr.gg/player/7049/natz,2025-01-16 06:00:00,0.93,1.28,1.11,223,196,238,46,19,27,38,21,17,8,5,3,-1,+2,-3,70%,68%,71%,142,121,162,27%,35%,23%,5,4,1,6,2,4
187,https://vlr.gg/player/37057/woody,2025-01-16 06:00:00,1.42,0.79,1.10,197,228,174,41,25,16,39,17,22,21,9,12,+1,0,+1,79%,82%,75%,135,152,117,37%,47%,27%,1,0,1,0,0,0
188,https://vlr.gg/player/7783/zhar,2025-01-16 06:00:00,0.87,0.69,0.78,165,198,143,33,20,13,40,21,19,21,12,9,-2,-1,-1,75%,82%,68%,99,105,94,28%,33%,24%,5,1,4,7,2,5
189,https://vlr.gg/player/26826/6ixkey,2025-01-16 06:00:00,0.25,0.98,0.62,158,99,206,28,8,20,43,24,19,8,5,3,-7,-6,-1,68%,64%,71%,107,71,144,23%,11%,42%,4,2,2,11,8,3
190,https://vlr.gg/player/19530/aaaay,2025-01-16 04:00:00,,,,231,,,53,,,39,,,13,,,,,,,,,,,,,,,,,,,,
191,https://vlr.gg/player/6022/yosemite,2025-01-16 04:00:00,,,,218,,,46,,,41,,,23,,,,,,,,,,,,,,,,,,,,
192,https://vlr.gg/player/3028/life,2025-01-16 04:00:00,,,,213,,,49,,,44,,,15,,,,,,,,,,,,,,,,,,,,
193,https://vlr.gg/player/872/autumn,2025-01-16 04:00:00,,,,181,,,40,,,41,,,13,,,,,,,,,,,,,,,,,,,,
194,https://vlr.gg/player/7857/berlin,2025-01-16 04:00:00,,,,173,,,37,,,44,,,22,,,,,,,,,,,,,,,,,,,,
195,https://vlr.gg/player/30526/b1ack,2025-01-16 04:00:00,,,,233,,,50,,,41,,,40,,,,,,,,,,,,,,,,,,,,
196,https://vlr.gg/player/5011/abo,2025-01-16 04:00:00,,,,228,,,53,,,48,,,6,,,,,,,,,,,,,,,,,,,,
197,https://vlr.gg/player/4720/haodong,2025-01-16 04:00:00,,,,183,,,42,,,44,,,27,,,,,,,,,,,,,,,,,,,,
198,https://vlr.gg/player/42235/dynamite,2025-01-16 04:00:00,,,,158,,,32,,,48,,,15,,,,,,,,,,,,,,,,,,,,
199,https://vlr.gg/player/488/rb,2025-01-16 04:00:00,,,,154,,,32,,,44,,,20,,,,,,,,,,,,,,,,,,,,
200,https://vlr.gg/player/5654/avez,2025-01-15 15:30:00,1.24,1.77,1.43,252,218,301,50,26,24,31,20,11,19,12,7,-1,0,-1,82%,81%,86%,168,137,222,35%,33%,38%,4,3,1,5,3,2
201,https://vlr.gg/player/2858/suygetsu,2025-01-15 15:30:00,1.15,1.21,1.17,187,173,210,38,22,16,32,18,14,21,10,11,-1,+2,-3,82%,83%,81%,121,114,134,38%,35%,43%,5,5,0,6,3,3
202,https://vlr.gg/player/727/saadhak,2025-01-15 15:30:00,0.90,1.14,0.99,164,171,153,35,24,11,32,21,11,21,10,11,-4,-3,-1,77%,72%,86%,96,97,96,26%,28%,22%,3,2,1,7,5,2
203,https://vlr.gg/player/16459/elite,2025-01-15 15:30:00,1.08,0.81,0.98,190,199,172,38,26,12,37,23,14,12,7,5,+1,0,+1,82%,81%,86%,128,132,121,47%,51%,41%,4,2,2,3,2,1
204,https://vlr.gg/player/10307/marteen,2025-01-15 15:30:00,0.86,1.10,0.95,210,207,206,41,26,15,42,27,15,14,6,8,0,-3,+3,72%,64%,86%,142,140,146,31%,32%,29%,10,4,6,10,7,3
205,https://vlr.gg/player/384/shao,2025-01-15 15:30:00,1.05,1.04,1.05,160,174,165,36,14,22,34,13,21,15,4,11,+3,+1,+2,79%,76%,81%,108,113,105,30%,32%,29%,6,2,4,3,1,2
206,https://vlr.gg/player/18677/ruxic,2025-01-15 15:30:00,0.80,1.17,1.04,218,186,227,40,14,26,43,18,25,25,10,15,+2,+1,+1,82%,90%,78%,136,118,147,26%,33%,23%,7,2,5,5,1,4
207,https://vlr.gg/player/3722/koalanoob,2025-01-15 15:30:00,0.82,1.02,0.93,205,209,219,43,15,28,42,17,25,12,5,7,-1,-2,+1,65%,67%,64%,137,140,135,24%,31%,20%,10,4,6,11,6,5
208,https://vlr.gg/player/29867/hiro,2025-01-15 15:30:00,0.85,0.81,0.83,138,163,139,30,12,18,39,15,24,24,8,16,-1,-1,0,65%,67%,64%,108,118,103,27%,23%,30%,1,0,1,2,1,1
209,https://vlr.gg/player/109/ange1,2025-01-15 15:30:00,0.56,0.55,0.55,150,141,151,24,9,15,44,15,29,23,5,18,+2,+2,0,65%,71%,61%,92,89,94,23%,29%,20%,7,3,4,5,1,4
210,https://vlr.gg/player/20144/lewn,2025-01-15 12:00:00,1.37,1.05,1.22,251,283,225,60,36,24,43,23,20,11,8,3,+7,+4,+3,71%,77%,65%,160,170,150,45%,44%,46%,16,9,7,9,5,4
211,https://vlr.gg/player/5568/sociablee,2025-01-15 12:00:00,1.35,1.07,1.22,252,260,216,58,34,24,40,20,20,11,8,3,+3,+2,+1,80%,83%,77%,155,171,137,22%,19%,26%,8,4,4,5,2,3
212,https://vlr.gg/player/5554/profek,2025-01-15 12:00:00,1.00,1.35,1.16,237,202,269,58,27,31,43,23,20,19,11,8,+6,+2,+4,71%,66%,77%,150,127,176,29%,33%,26%,8,4,4,2,2,0
213,https://vlr.gg/player/9780/jamppi,2025-01-15 12:00:00,0.85,1.17,1.00,175,148,206,42,18,24,39,22,17,22,9,13,-4,-3,-1,77%,71%,84%,121,110,133,36%,31%,40%,3,1,2,7,4,3
214,https://vlr.gg/player/172/vakk,2025-01-15 12:00:00,0.34,0.85,0.58,114,93,144,28,13,15,47,27,20,16,4,12,-4,-2,-2,68%,63%,74%,83,69,99,22%,19%,25%,2,1,1,6,3,3
215,https://vlr.gg/player/4181/cloud,2025-01-15 12:00:00,1.23,1.20,1.22,241,251,225,52,26,26,47,25,22,13,8,5,0,0,0,65%,71%,60%,162,180,147,34%,29%,42%,9,5,4,9,5,4
216,https://vlr.gg/player/34684/westside,2025-01-15 12:00:00,1.02,0.91,0.96,176,201,161,43,23,20,49,23,26,14,5,9,-2,-1,-1,68%,71%,66%,126,143,110,39%,37%,42%,4,2,2,6,3,3
217,https://vlr.gg/player/21610/runner,2025-01-15 12:00:00,0.83,1.03,0.94,148,114,180,32,12,20,45,20,25,31,14,17,+1,0,+1,68%,68%,69%,90,74,104,34%,26%,40%,2,0,2,1,0,1
218,https://vlr.gg/player/19691/tomaszy,2025-01-15 12:00:00,0.90,0.95,0.92,179,175,196,42,18,24,51,23,28,24,13,11,-2,-2,0,70%,74%,66%,125,121,129,28%,21%,38%,4,0,4,6,2,4
219,https://vlr.gg/player/1885/purp0,2025-01-15 12:00:00,0.57,0.92,0.76,180,152,207,43,18,25,54,27,27,8,2,6,-5,-2,-3,58%,58%,57%,120,98,141,43%,49%,39%,10,6,4,15,8,7
220,https://vlr.gg/player/40910/consz,2025-01-14 08:30:00,1.36,1.02,1.21,236,247,226,58,34,24,44,21,23,17,10,7,+9,+6,+3,78%,81%,73%,151,156,144,23%,23%,25%,16,9,7,7,3,4
221,https://vlr.gg/player/44930/nex1sphix,2025-01-14 08:30:00,1.11,1.25,1.17,204,196,218,49,23,26,41,21,20,24,17,7,-2,-1,-1,75%,76%,73%,141,136,146,34%,32%,36%,3,2,1,5,3,2
222,https://vlr.gg/player/44770/cxix666,2025-01-14 08:30:00,1.33,0.81,1.10,203,224,172,50,32,18,42,19,23,15,8,7,-4,0,-4,69%,76%,60%,134,146,119,29%,28%,31%,3,2,1,7,2,5
223,https://vlr.gg/player/40907/mnfear,2025-01-14 08:30:00,0.99,1.03,1.01,199,198,206,48,29,19,46,24,22,29,14,15,0,+1,-1,72%,73%,70%,139,125,157,29%,27%,30%,6,4,2,6,3,3
224,https://vlr.gg/player/40908/skyisblue,2025-01-14 08:30:00,0.82,1.04,0.92,205,196,212,44,23,21,50,28,22,32,18,14,+2,+1,+1,75%,76%,73%,134,123,148,18%,16%,20%,8,5,3,6,4,2
225,https://vlr.gg/player/14227/nhatthong2k,2025-01-14 08:30:00,0.97,0.93,0.95,199,192,204,48,21,27,51,21,30,11,5,6,-5,+1,-6,63%,73%,54%,128,127,128,26%,27%,25%,9,6,3,14,5,9
226,https://vlr.gg/player/19154/albus,2025-01-14 08:30:00,0.96,0.95,0.95,192,195,193,45,21,24,49,21,28,13,7,6,-1,-1,0,66%,70%,62%,136,130,140,40%,44%,37%,5,3,2,6,4,2
227,https://vlr.gg/player/14587/daft,2025-01-14 08:30:00,1.04,0.83,0.92,219,259,179,47,27,20,52,25,27,16,7,9,+2,+3,-1,72%,70%,73%,141,165,121,23%,32%,13%,9,4,5,7,1,6
228,https://vlr.gg/player/7434/d1srupt,2025-01-14 08:30:00,1.00,0.84,0.91,189,201,178,43,22,21,51,22,29,26,13,13,-3,-2,-1,75%,80%,70%,123,125,121,35%,30%,40%,2,0,2,5,2,3
229,https://vlr.gg/player/23042/tripciew,2025-01-14 08:30:00,0.97,0.85,0.90,150,146,159,38,17,21,46,19,27,11,7,4,+2,+1,+1,58%,67%,51%,104,100,108,28%,30%,27%,6,3,3,4,2,2
230,https://vlr.gg/player/7513/markl,2025-01-14 06:00:00,1.11,1.32,1.21,248,267,245,48,26,22,37,21,16,12,2,10,+2,-1,+3,73%,64%,82%,165,179,152,39%,46%,33%,7,3,4,5,4,1
231,https://vlr.gg/player/14209/suka,2025-01-14 06:00:00,0.92,1.42,1.17,197,169,235,39,16,23,35,20,15,25,8,17,0,-1,+1,73%,64%,82%,144,115,172,35%,27%,42%,1,0,1,1,1,0
232,https://vlr.gg/player/45876/fixy,2025-01-14 06:00:00,0.79,1.45,1.12,249,181,317,46,16,30,43,24,19,13,8,5,+5,0,+5,75%,75%,75%,170,130,209,21%,27%,17%,12,5,7,7,5,2
233,https://vlr.gg/player/7443/riza,2025-01-14 06:00:00,1.06,1.06,1.06,188,180,181,38,20,18,34,20,14,16,9,7,-3,-3,0,79%,75%,82%,124,128,120,36%,42%,30%,6,2,4,9,5,4
234,https://vlr.gg/player/5886/flaring,2025-01-14 06:00:00,1.08,0.83,0.96,192,233,141,35,21,14,41,24,17,30,14,16,-2,-1,-1,80%,82%,79%,115,138,91,29%,29%,29%,3,1,2,5,2,3
235,https://vlr.gg/player/23042/tripciew,2025-01-14 06:00:00,0.95,1.21,1.08,201,199,214,41,19,22,38,21,17,19,5,14,+1,0,+1,77%,71%,82%,129,123,135,26%,27%,25%,4,2,2,3,2,1
236,https://vlr.gg/player/19154/albus,2025-01-14 06:00:00,0.75,1.24,1.00,241,185,317,51,17,34,48,25,23,13,9,4,+1,-1,+2,70%,57%,82%,172,134,210,37%,38%,37%,7,3,4,6,4,2
237,https://vlr.gg/player/7434/d1srupt,2025-01-14 06:00:00,0.61,1.34,0.97,187,145,230,38,13,25,39,23,16,17,7,10,-1,-4,+3,75%,64%,86%,114,93,135,27%,35%,22%,4,1,3,5,5,0
238,https://vlr.gg/player/14587/daft,2025-01-14 06:00:00,0.94,0.64,0.79,140,146,139,27,16,11,38,17,21,17,7,10,-2,-3,+1,68%,61%,75%,91,91,91,16%,14%,18%,4,0,4,6,3,3
239,https://vlr.gg/player/14227/nhatthong2k,2025-01-14 06:00:00,0.77,0.69,0.73,180,167,192,33,16,17,44,21,23,18,4,14,-1,0,-1,64%,57%,71%,133,116,151,26%,39%,18%,8,4,4,9,4,5
240,https://vlr.gg/player/8805/sacake,2025-01-13 15:35:00,1.46,1.09,1.27,230,254,206,38,22,16,31,15,16,21,7,14,0,+1,-1,69%,58%,79%,150,172,129,33%,36%,31%,3,1,2,3,0,3
241,https://vlr.gg/player/1524/h1ber,2025-01-13 15:35:00,1.12,1.01,1.07,200,199,201,35,17,18,35,16,19,22,9,13,-3,0,-3,79%,79%,79%,128,128,128,29%,36%,24%,2,2,0,5,2,3
242,https://vlr.gg/player/18162/serial,2025-01-13 15:35:00,0.73,1.27,1.00,191,128,254,31,10,21,30,14,16,14,5,9,-5,-3,-2,69%,58%,79%,126,88,164,43%,46%,42%,4,2,2,9,5,4
243,https://vlr.gg/player/16209/famsii,2025-01-13 15:35:00,0.80,1.08,0.94,189,164,216,30,12,18,37,19,18,16,6,10,-2,-3,+1,69%,71%,67%,128,107,149,30%,41%,23%,3,0,3,5,3,2
244,https://vlr.gg/player/29972/michel,2025-01-13 15:35:00,0.74,0.89,0.81,179,186,172,29,15,14,39,22,17,8,5,3,-4,-1,-3,58%,63%,54%,112,112,112,34%,44%,29%,5,4,1,9,5,4
245,https://vlr.gg/player/5199/guardy,2025-01-13 15:35:00,1.37,1.06,1.22,211,222,201,39,22,17,27,13,14,18,9,9,+2,+1,+1,73%,79%,67%,142,153,131,27%,25%,29%,3,1,2,1,0,1
246,https://vlr.gg/player/38424/zachkappa,2025-01-13 15:35:00,1.13,1.30,1.21,268,272,265,47,22,25,35,19,16,5,4,1,+8,+5,+3,73%,58%,88%,170,178,163,38%,38%,39%,14,7,7,6,2,4
247,https://vlr.gg/player/3127/monsteerr,2025-01-13 15:35:00,1.22,0.85,1.03,190,226,156,32,19,13,31,16,15,22,14,8,+3,+2,+1,77%,88%,67%,129,139,118,27%,31%,23%,3,2,1,0,0,0
248,https://vlr.gg/player/8502/olizera,2025-01-13 15:35:00,0.65,1.35,1.00,237,175,299,38,14,24,36,21,15,12,6,6,+1,0,+1,67%,58%,75%,149,112,186,27%,22%,30%,9,5,4,8,5,3
249,https://vlr.gg/player/22154/pika,2025-01-13 15:35:00,0.53,0.66,0.59,117,124,111,16,9,7,34,18,16,13,4,9,0,0,0,67%,63%,71%,89,95,82,23%,24%,21%,2,1,1,2,1,1
250,https://vlr.gg/player/8834/bucher,2025-01-13 13:30:00,0.98,1.21,1.13,220,241,212,29,10,19,28,13,15,9,3,6,+4,+3,+1,79%,71%,83%,152,153,151,36%,38%,35%,4,3,1,0,0,0
251,https://vlr.gg/player/15473/yuno,2025-01-13 13:30:00,0.69,1.38,1.12,224,143,275,30,7,23,29,12,17,11,3,8,+2,+1,+1,74%,64%,79%,143,91,173,20%,19%,20%,4,1,3,2,0,2
252,https://vlr.gg/player/341/quick,2025-01-13 13:30:00,0.45,0.76,0.64,126,89,146,15,4,11,29,11,18,3,1,2,-5,-2,-3,55%,43%,63%,99,67,118,27%,38%,23%,0,0,0,5,2,3
253,https://vlr.gg/player/6959/flickless,2025-01-13 13:30:00,0.55,0.67,0.62,139,118,150,18,6,12,31,11,20,10,3,7,+2,0,+2,76%,71%,79%,93,73,104,33%,23%,38%,3,0,3,1,0,1
254,https://vlr.gg/player/1839/polvi,2025-01-13 13:30:00,0.30,0.77,0.60,180,150,200,22,6,16,35,14,21,6,1,5,-5,-2,-3,55%,36%,67%,124,105,136,16%,18%,14%,7,3,4,12,5,7
255,https://vlr.gg/player/2190/baddyg,2025-01-13 13:30:00,1.07,2.00,1.41,251,191,349,34,16,18,21,16,5,18,13,5,+4,0,+4,82%,75%,93%,159,141,189,26%,27%,25%,5,1,4,1,1,0
256,https://vlr.gg/player/8226/waddle,2025-01-13 13:30:00,1.30,1.15,1.24,235,258,202,33,23,10,23,16,7,15,10,5,+1,0,+1,84%,83%,86%,154,153,156,26%,29%,23%,4,2,2,3,2,1
257,https://vlr.gg/player/1944/cayden,2025-01-13 13:30:00,0.95,1.50,1.15,204,193,219,29,16,13,22,16,6,19,11,8,0,+1,-1,79%,75%,86%,127,134,115,29%,34%,21%,1,1,0,1,0,1
258,https://vlr.gg/player/12474/tag,2025-01-13 13:30:00,1.02,1.23,1.10,187,189,181,28,18,10,23,16,7,11,6,5,+2,+1,+1,82%,83%,79%,116,113,121,44%,47%,41%,3,2,1,1,1,0
259,https://vlr.gg/player/1470/simond4rk,2025-01-13 13:30:00,0.87,1.09,0.95,199,196,208,27,18,9,25,17,8,7,3,4,-5,0,-5,76%,75%,79%,128,118,145,21%,26%,16%,7,7,0,12,7,5
260,https://vlr.gg/player/7868/lele,2025-01-13 13:30:00,0.88,1.20,1.07,192,168,210,31,9,22,26,11,15,15,6,9,0,0,0,85%,81%,88%,132,118,141,31%,26%,36%,2,1,1,2,1,1
261,https://vlr.gg/player/5854/z3ro,2025-01-13 13:30:00,0.77,1.20,1.03,218,153,260,28,8,20,29,13,16,19,8,11,+2,+1,+1,75%,69%,79%,145,107,171,31%,40%,28%,4,1,3,2,0,2
262,https://vlr.gg/player/16447/d3mur,2025-01-13 13:30:00,0.91,1.05,1.00,196,205,193,28,11,17,27,12,15,7,3,4,0,0,0,63%,63%,63%,129,156,111,27%,39%,19%,8,4,4,8,4,4
263,https://vlr.gg/player/4277/n-a-i-s,2025-01-13 13:30:00,1.62,0.59,1.00,201,277,145,31,19,12,28,10,18,6,3,3,-1,+1,-2,78%,94%,67%,127,187,88,22%,29%,14%,3,1,2,4,0,4
264,https://vlr.gg/player/1472/falltw,2025-01-13 13:30:00,0.85,1.03,0.96,171,168,174,24,9,15,25,11,14,11,6,5,+1,-2,+3,73%,75%,71%,114,107,118,15%,7%,22%,4,1,3,3,3,0
265,https://vlr.gg/player/173/l0udly,2025-01-13 13:30:00,1.22,0.85,1.08,170,183,153,25,16,9,28,15,13,16,7,9,-2,-3,+1,63%,58%,69%,111,125,91,33%,33%,32%,2,0,2,4,3,1
266,https://vlr.gg/player/8808/pyrolll,2025-01-13 13:30:00,0.92,1.30,1.07,201,183,233,30,16,14,27,17,10,6,3,3,+4,+2,+2,73%,67%,81%,133,125,145,49%,47%,52%,4,2,2,0,0,0
267,https://vlr.gg/player/363/7ssk7,2025-01-13 13:30:00,0.88,1.20,1.01,239,206,296,32,16,16,32,19,13,7,3,4,0,-2,+2,75%,67%,88%,149,127,181,26%,27%,24%,8,5,3,8,7,1
268,https://vlr.gg/player/2431/basya,2025-01-13 13:30:00,0.96,0.79,0.89,196,229,155,26,19,7,29,19,10,13,5,8,-5,0,-5,73%,75%,69%,140,151,122,18%,24%,11%,3,3,0,8,3,5
269,https://vlr.gg/player/443/zeddy,2025-01-13 13:30:00,0.74,1.01,0.84,165,147,192,22,11,11,27,17,10,15,10,5,+1,+1,0,78%,75%,81%,114,109,120,20%,27%,13%,2,1,1,1,0,1
270,https://vlr.gg/player/3784/katu,2025-01-13 11:00:00,1.15,1.10,1.12,244,258,234,37,17,20,32,15,17,4,1,3,+1,-1,+2,65%,63%,67%,147,161,135,30%,35%,26%,8,4,4,7,5,2
271,https://vlr.gg/player/1155/buld,2025-01-13 11:00:00,1.10,0.97,1.03,236,253,223,33,16,17,35,16,19,17,7,10,+1,+1,0,77%,74%,79%,147,159,137,26%,27%,26%,5,2,3,4,1,3
272,https://vlr.gg/player/402/insider,2025-01-13 11:00:00,0.90,0.73,0.81,166,206,134,23,12,11,29,14,15,9,5,4,-4,-2,-2,70%,74%,67%,117,142,97,31%,29%,34%,2,1,1,6,3,3
273,https://vlr.gg/player/4519/kamisseq,2025-01-13 11:00:00,0.70,0.85,0.79,158,131,178,22,8,14,31,14,17,14,8,6,-1,-2,+1,67%,79%,58%,97,86,106,41%,39%,43%,2,0,2,3,2,1
274,https://vlr.gg/player/23347/alannn,2025-01-13 11:00:00,0.37,0.70,0.55,131,93,161,21,6,15,34,17,17,4,1,3,-2,-1,-1,60%,53%,67%,83,68,94,35%,28%,39%,2,0,2,4,1,3
275,https://vlr.gg/player/6925/chadi,2025-01-13 11:00:00,0.97,1.82,1.35,275,245,310,44,21,23,28,19,9,8,4,4,+2,0,+2,74%,63%,89%,185,170,204,26%,29%,22%,7,4,3,5,4,1
276,https://vlr.gg/player/2835/kyrrz,2025-01-13 11:00:00,1.39,1.15,1.28,221,221,221,32,19,13,23,12,11,15,6,9,+2,+1,+1,81%,71%,95%,133,128,139,27%,30%,24%,6,3,3,4,2,2
277,https://vlr.gg/player/4851/rexs,2025-01-13 11:00:00,1.23,0.93,1.10,220,239,196,33,19,14,30,17,13,19,11,8,-2,0,-2,81%,92%,68%,151,165,133,28%,28%,29%,3,3,0,5,3,2
278,https://vlr.gg/player/24359/faska,2025-01-13 11:00:00,0.97,0.88,0.93,193,178,213,29,16,13,27,14,13,8,1,7,+3,0,+3,65%,63%,68%,118,105,134,32%,33%,30%,6,2,4,3,2,1
279,https://vlr.gg/player/24428/harambe,2025-01-13 11:00:00,0.61,1.10,0.82,138,103,183,23,10,13,28,15,13,9,3,6,0,-1,+1,65%,58%,74%,103,71,144,38%,43%,35%,2,0,2,2,1,1
280,https://vlr.gg/player/1493/starkk,2025-01-13 11:00:00,1.29,1.32,1.30,248,239,248,41,22,19,28,15,13,16,11,5,+5,+2,+3,83%,81%,86%,161,149,175,30%,35%,26%,7,4,3,2,2,0
281,https://vlr.gg/player/15376/grtw,2025-01-13 11:00:00,1.06,1.13,1.09,210,182,230,36,19,17,30,14,16,5,0,5,-1,-1,0,71%,85%,55%,129,118,143,34%,36%,32%,2,1,1,3,2,1
282,https://vlr.gg/player/13435/fragger,2025-01-13 11:00:00,1.27,0.83,1.07,192,231,178,32,21,11,31,15,16,17,8,9,+2,+2,0,79%,85%,73%,140,161,114,33%,38%,24%,5,3,2,3,1,2
283,https://vlr.gg/player/5203/bati,2025-01-13 11:00:00,0.66,1.20,0.91,177,132,231,29,11,18,31,17,14,11,7,4,-3,-2,-1,63%,62%,64%,114,86,147,21%,13%,27%,3,1,2,6,3,3
284,https://vlr.gg/player/6909/jannyxd,2025-01-13 11:00:00,0.86,0.91,0.89,178,180,162,31,18,13,31,17,14,10,3,7,0,0,0,71%,69%,73%,114,118,110,37%,43%,30%,8,4,4,8,4,4
285,https://vlr.gg/player/292/fit1nho,2025-01-13 11:00:00,1.50,1.20,1.34,261,278,238,44,24,20,33,15,18,8,2,6,+1,0,+1,69%,59%,77%,180,183,177,40%,48%,35%,7,2,5,6,2,4
286,https://vlr.gg/player/41220/krejz,2025-01-13 11:00:00,0.90,0.98,0.94,228,230,221,38,18,20,38,17,21,7,3,4,+1,+1,0,69%,73%,65%,149,146,151,40%,42%,38%,10,5,5,9,4,5
287,https://vlr.gg/player/7220/saiz,2025-01-13 11:00:00,1.00,0.81,0.90,164,164,178,29,14,15,34,14,20,5,1,4,0,+1,-1,63%,64%,62%,120,111,127,28%,29%,26%,2,2,0,2,1,1
288,https://vlr.gg/player/2534/lowel,2025-01-13 11:00:00,0.69,0.93,0.82,143,138,147,24,10,14,32,15,17,12,4,8,-1,-2,+1,69%,64%,73%,98,103,95,29%,28%,29%,2,1,1,3,3,0
289,https://vlr.gg/player/20271/vorwenn,2025-01-13 11:00:00,0.43,0.60,0.50,101,96,119,16,7,9,37,17,20,7,3,4,-4,-2,-2,54%,45%,62%,83,71,93,23%,20%,24%,1,0,1,5,2,3
290,https://vlr.gg/player/31537/basbabe,2025-01-13 08:15:00,0.89,1.93,1.40,262,169,360,46,14,32,31,17,14,19,7,12,0,0,0,79%,71%,87%,163,106,221,25%,23%,27%,5,3,2,5,3,2
291,https://vlr.gg/player/41694/endoist,2025-01-13 08:15:00,1.52,0.82,1.18,295,362,223,45,28,17,40,19,21,20,8,12,+7,+6,+1,79%,79%,78%,186,237,133,34%,39%,26%,13,9,4,6,3,3
292,https://vlr.gg/player/41701/ki1wsy,2025-01-13 08:15:00,1.26,0.76,1.02,209,252,167,37,24,13,33,16,17,11,6,5,-4,-2,-2,70%,75%,65%,137,157,115,20%,15%,31%,1,0,1,5,2,3
293,https://vlr.gg/player/20623/harddora,2025-01-13 08:15:00,1.06,0.72,0.89,126,142,109,18,11,7,29,14,15,25,14,11,+2,+1,+1,74%,71%,78%,84,88,79,31%,31%,31%,3,1,2,1,0,1
294,https://vlr.gg/player/17303/fontuz,2025-01-13 08:15:00,0.60,0.82,0.70,146,97,198,23,7,16,36,17,19,20,14,6,-2,-1,-1,64%,58%,70%,91,59,124,12%,7%,19%,3,1,2,5,2,3
295,https://vlr.gg/player/44770/cxix666,2025-01-13 08:15:00,1.64,1.16,1.40,267,313,226,47,27,20,29,13,16,8,3,5,+3,+4,-1,72%,78%,67%,183,216,153,35%,45%,25%,7,6,1,4,2,2
296,https://vlr.gg/player/40910/consz,2025-01-13 08:15:00,1.16,1.49,1.33,256,201,310,42,18,24,31,15,16,16,6,10,+2,+1,+1,77%,70%,83%,178,134,221,27%,33%,24%,5,1,4,3,0,3
297,https://vlr.gg/player/44930/nex1sphix,2025-01-13 08:15:00,0.93,0.74,0.83,172,189,159,28,14,14,36,18,18,19,15,4,-1,0,-1,74%,74%,75%,116,122,109,34%,32%,37%,1,0,1,2,0,2
298,https://vlr.gg/player/40907/mnfear,2025-01-13 08:15:00,0.77,0.80,0.79,151,157,147,25,13,12,37,20,17,19,10,9,-3,-2,-1,72%,70%,75%,108,117,100,23%,33%,14%,2,1,1,5,3,2
299,https://vlr.gg/player/40908/skyisblue,2025-01-13 08:15:00,0.71,0.75,0.73,165,180,151,27,14,13,36,19,17,11,8,3,-4,-2,-2,66%,70%,63%,114,123,105,26%,24%,28%,7,4,3,11,6,5
300,https://vlr.gg/player/5886/flaring,2025-01-13 06:00:00,1.45,1.57,1.50,266,266,257,41,24,17,23,14,9,17,9,8,+2,-1,+3,90%,83%,100%,173,173,172,21%,21%,22%,5,1,4,3,2,1
301,https://vlr.gg/player/7443/riza,2025-01-13 06:00:00,1.38,1.29,1.34,226,217,246,35,20,15,22,11,11,19,10,9,+4,+2,+2,86%,92%,78%,156,154,158,32%,25%,43%,6,3,3,2,1,1
302,https://vlr.gg/player/14209/suka,2025-01-13 06:00:00,0.74,2.29,1.26,212,132,373,14,6,8,12,8,4,11,7,4,-1,-1,0,72%,67%,83%,141,79,265,45%,50%,42%,0,0,0,1,1,0
303,https://vlr.gg/player/46046/iceyyy,2025-01-13 06:00:00,1.43,0.99,1.21,261,320,203,23,13,10,18,9,9,10,6,4,+1,0,+1,83%,75%,92%,153,203,102,10%,11%,9%,2,1,1,1,1,0
304,https://vlr.gg/player/45876/fixy,2025-01-13 06:00:00,0.89,0.87,0.88,208,233,177,29,19,10,33,19,14,11,7,4,0,-3,+3,71%,83%,56%,131,142,117,21%,20%,21%,8,4,4,8,7,1
305,https://vlr.gg/player/7513/markl,2025-01-13 06:00:00,0.89,0.84,0.87,178,174,177,27,17,10,26,14,12,3,0,3,-2,-1,-1,67%,75%,56%,119,113,127,25%,20%,31%,2,1,1,4,2,2
306,https://vlr.gg/player/40903/rina,2025-01-13 06:00:00,1.45,0.89,1.13,198,217,192,30,14,16,29,10,19,15,8,7,0,0,0,71%,72%,71%,122,131,115,29%,29%,30%,2,0,2,2,0,2
307,https://vlr.gg/player/40892/diky,2025-01-13 06:00:00,0.92,1.17,1.06,204,176,230,30,11,19,33,14,19,20,11,9,-1,0,-1,71%,67%,75%,136,116,152,47%,43%,49%,1,1,0,2,1,1
308,https://vlr.gg/player/40889/decoy,2025-01-13 06:00:00,0.66,0.88,0.78,184,204,178,27,13,14,35,16,19,4,3,1,0,-4,+4,60%,67%,54%,127,141,116,20%,24%,16%,5,1,4,5,5,0
309,https://vlr.gg/player/40890/cinjvv,2025-01-13 06:00:00,1.04,0.50,0.73,182,242,137,28,17,11,36,14,22,2,1,1,0,-2,+2,48%,50%,46%,121,158,93,37%,41%,33%,7,2,5,7,4,3
310,https://vlr.gg/player/40894/chintu,2025-01-13 06:00:00,0.13,0.82,0.52,146,68,200,19,4,15,36,16,20,13,6,7,-3,-2,-1,64%,61%,67%,101,49,140,36%,36%,36%,4,1,3,7,3,4
311,https://vlr.gg/player/7220/saiz,2025-01-12 15:50:00,0.76,1.38,1.08,213,167,261,38,14,24,33,19,14,7,3,4,+5,-1,+6,76%,63%,88%,138,111,164,37%,34%,38%,8,2,6,3,3,0
312,https://vlr.gg/player/41220/krejz,2025-01-12 15:50:00,0.95,1.19,1.07,230,240,220,39,20,19,32,19,13,7,3,4,0,0,0,69%,67%,72%,153,158,149,34%,35%,33%,9,5,4,9,5,4
313,https://vlr.gg/player/20271/vorwenn,2025-01-12 15:50:00,0.72,1.36,1.05,194,153,239,34,12,22,32,19,13,15,8,7,-3,-4,+1,69%,58%,80%,133,103,161,23%,21%,24%,4,1,3,7,5,2
314,https://vlr.gg/player/292/fit1nho,2025-01-12 15:50:00,0.87,1.09,0.98,166,156,174,30,13,17,28,17,11,14,8,6,-1,0,-1,69%,63%,76%,114,103,124,45%,42%,48%,3,1,2,4,1,3
315,https://vlr.gg/player/2534/lowel,2025-01-12 15:50:00,0.68,0.67,0.68,115,141,89,19,12,7,32,19,13,14,3,11,-1,-1,0,67%,58%,76%,83,100,66,27%,24%,31%,0,0,0,1,1,0
316,https://vlr.gg/player/6959/flickless,2025-01-12 15:50:00,0.95,1.51,1.22,201,151,252,33,13,20,29,16,13,25,8,17,+1,+1,0,84%,76%,92%,123,96,151,35%,28%,40%,1,1,0,0,0,0
317,https://vlr.gg/player/1839/polvi,2025-01-12 15:50:00,0.89,1.57,1.22,297,247,346,49,19,30,37,20,17,7,5,2,+5,-5,+10,71%,56%,88%,185,162,210,15%,14%,16%,17,6,11,12,11,1
318,https://vlr.gg/player/341/quick,2025-01-12 15:50:00,0.89,0.90,0.90,139,145,135,23,13,10,30,17,13,22,8,14,-5,-3,-2,71%,60%,83%,90,83,96,25%,36%,19%,0,0,0,5,3,2
319,https://vlr.gg/player/15473/yuno,2025-01-12 15:50:00,0.80,1.00,0.90,157,153,164,24,10,14,35,18,17,32,11,21,-3,+2,-5,76%,72%,79%,105,113,96,24%,32%,18%,2,2,0,5,0,5
320,https://vlr.gg/player/8834/bucher,2025-01-12 15:50:00,0.64,1.14,0.88,161,119,200,28,10,18,30,18,12,6,4,2,+2,0,+2,69%,68%,71%,106,85,127,43%,44%,43%,5,1,4,3,1,2
321,https://vlr.gg/player/1470/simond4rk,2025-01-12 13:50:00,1.28,1.24,1.26,299,286,278,42,24,18,31,18,13,13,10,3,-1,-1,0,76%,83%,67%,201,203,199,21%,22%,20%,5,4,1,6,5,1
322,https://vlr.gg/player/8226/waddle,2025-01-12 13:50:00,1.07,1.49,1.25,195,150,288,34,14,20,24,12,12,8,3,5,-4,-1,-3,71%,71%,72%,144,116,181,39%,42%,37%,3,1,2,7,2,5
323,https://vlr.gg/player/2190/baddyg,2025-01-12 13:50:00,0.97,1.61,1.24,213,170,277,31,14,17,25,15,10,17,10,7,+6,+4,+2,76%,71%,83%,141,111,180,34%,28%,39%,7,5,2,1,1,0
324,https://vlr.gg/player/1944/cayden,2025-01-12 13:50:00,0.98,0.78,0.89,190,196,171,27,16,11,32,18,14,18,10,8,-2,-1,-1,79%,79%,78%,122,128,116,25%,21%,32%,3,1,2,5,2,3
325,https://vlr.gg/player/12474/tag,2025-01-12 13:50:00,0.88,0.73,0.82,171,177,165,25,15,10,29,17,12,14,9,5,+1,+1,0,79%,79%,78%,113,113,113,29%,32%,26%,3,2,1,2,1,1
326,https://vlr.gg/player/3127/monsteerr,2025-01-12 13:50:00,1.21,1.18,1.19,225,205,246,34,14,20,29,13,16,16,12,4,+3,0,+3,74%,72%,75%,148,128,163,23%,29%,20%,4,1,3,1,1,0
327,https://vlr.gg/player/38424/zachkappa,2025-01-12 13:50:00,0.93,1.30,1.14,241,242,234,31,12,19,31,17,14,12,8,4,+1,+2,-1,76%,78%,75%,164,178,154,30%,29%,33%,8,5,3,7,3,4
328,https://vlr.gg/player/5199/guardy,2025-01-12 13:50:00,0.88,0.91,0.90,198,216,185,28,13,15,34,16,18,15,5,10,+1,+2,-1,64%,61%,67%,133,140,127,21%,23%,20%,4,3,1,3,1,2
329,https://vlr.gg/player/8502/olizera,2025-01-12 13:50:00,0.79,0.80,0.79,156,176,150,23,12,11,32,15,17,10,2,8,-1,-1,0,60%,56%,63%,99,101,98,24%,22%,25%,4,1,3,5,2,3
330,https://vlr.gg/player/22154/pika,2025-01-12 13:50:00,0.57,0.82,0.71,156,144,170,25,10,15,33,15,18,10,3,7,-4,-1,-3,62%,56%,67%,105,85,120,28%,33%,25%,1,0,1,5,1,4
331,https://vlr.gg/player/363/7ssk7,2025-01-12 13:50:00,0.70,1.17,0.96,204,180,226,27,11,16,28,14,14,2,0,2,-1,+1,-2,70%,71%,70%,131,121,139,33%,46%,19%,4,3,1,5,2,3
332,https://vlr.gg/player/8808/pyrolll,2025-01-12 13:50:00,1.12,0.76,0.92,183,205,155,22,12,10,25,10,15,11,4,7,-6,-2,-4,65%,59%,70%,122,147,102,25%,29%,21%,1,1,0,7,3,4
333,https://vlr.gg/player/443/zeddy,2025-01-12 13:50:00,0.80,0.61,0.70,142,157,135,19,9,10,29,13,16,4,2,2,-5,-1,-4,57%,53%,60%,101,111,93,21%,21%,22%,3,2,1,8,3,5
334,https://vlr.gg/player/2431/basya,2025-01-12 13:50:00,0.57,0.70,0.64,165,137,181,18,7,11,30,12,18,10,5,5,+2,-1,+3,59%,53%,65%,99,91,106,20%,30%,15%,3,0,3,1,1,0
335,https://vlr.gg/player/173/l0udly,2025-01-12 13:50:00,0.47,0.29,0.37,100,107,97,14,8,6,32,14,18,7,3,4,-3,-2,-1,62%,59%,65%,63,67,61,28%,43%,18%,1,0,1,4,2,2
336,https://vlr.gg/player/13435/fragger,2025-01-12 13:50:00,1.49,1.06,1.29,195,224,166,28,18,10,16,8,8,15,7,8,+2,+1,+1,86%,90%,82%,127,137,115,40%,47%,33%,2,1,1,0,0,0
337,https://vlr.gg/player/1493/starkk,2025-01-12 13:50:00,1.32,1.26,1.29,215,204,220,25,15,10,16,8,8,18,9,9,+6,+5,+1,86%,90%,82%,135,117,157,17%,16%,17%,7,5,2,1,0,1
338,https://vlr.gg/player/6909/jannyxd,2025-01-12 13:50:00,1.50,0.97,1.25,249,264,238,35,19,16,22,10,12,5,4,1,0,0,0,73%,90%,53%,156,174,135,26%,28%,21%,5,2,3,5,2,3
339,https://vlr.gg/player/15376/grtw,2025-01-12 13:50:00,0.65,1.37,0.98,181,146,225,29,12,17,22,14,8,5,3,2,+1,-1,+2,70%,60%,82%,103,81,129,38%,40%,36%,4,2,2,3,3,0
340,https://vlr.gg/player/5203/bati,2025-01-12 13:50:00,1.08,0.77,0.94,220,228,198,25,15,10,24,13,11,13,6,7,+4,+3,+1,81%,85%,76%,141,147,134,20%,16%,30%,7,4,3,3,1,2
341,https://vlr.gg/player/1284/mikee,2025-01-12 13:05:00,1.15,1.31,1.22,248,241,246,54,31,23,46,29,17,16,11,5,+3,+3,0,80%,83%,76%,149,147,151,30%,33%,26%,6,4,2,3,1,2
342,https://vlr.gg/player/3582/keloqz,2025-01-12 13:05:00,0.94,1.33,1.10,215,220,204,48,29,19,41,28,13,7,2,5,-2,-2,0,67%,67%,68%,132,130,135,32%,43%,18%,5,4,1,7,6,1
343,https://vlr.gg/player/113/hyp,2025-01-12 13:05:00,0.98,1.06,1.01,194,194,187,42,25,17,39,24,15,10,4,6,+2,0,+2,66%,67%,64%,126,128,122,39%,43%,35%,5,2,3,3,2,1
344,https://vlr.gg/player/13258/cyvoph,2025-01-12 13:05:00,0.98,0.68,0.86,183,204,154,38,25,13,49,29,20,29,18,11,-5,-6,+1,70%,75%,64%,124,145,93,25%,27%,20%,6,1,5,11,7,4
345,https://vlr.gg/player/114/enzo,2025-01-12 13:05:00,0.61,1.14,0.82,166,134,232,32,14,18,41,26,15,19,9,10,-3,-1,-2,64%,53%,80%,121,97,156,15%,15%,15%,6,4,2,9,5,4
346,https://vlr.gg/player/24439/yohpa,2025-01-12 13:05:00,1.18,1.18,1.18,213,206,215,45,18,27,38,16,22,20,10,10,+2,+1,+1,75%,76%,75%,145,150,142,34%,38%,31%,3,1,2,1,0,1
347,https://vlr.gg/player/11322/sevire,2025-01-12 13:05:00,1.39,0.88,1.09,239,285,215,51,25,26,44,17,27,18,8,10,0,-1,+1,75%,80%,72%,166,185,152,41%,40%,43%,8,3,5,8,4,4
348,https://vlr.gg/player/7173/soren,2025-01-12 13:05:00,0.75,1.21,1.02,213,172,230,47,16,31,43,19,24,5,3,2,-2,-2,0,61%,56%,64%,130,104,148,30%,35%,28%,6,2,4,8,4,4
349,https://vlr.gg/player/21216/f4ngeer,2025-01-12 13:05:00,0.79,1.11,0.96,197,164,234,44,14,30,45,19,26,12,4,8,+5,+1,+4,66%,56%,72%,135,104,156,23%,26%,21%,13,5,8,8,4,4
350,https://vlr.gg/player/2864/ease,2025-01-12 13:05:00,0.40,0.81,0.64,142,89,176,29,7,22,45,19,26,25,11,14,0,0,0,72%,68%,75%,89,55,113,34%,35%,33%,3,1,2,3,1,2
351,https://vlr.gg/player/15969/yuta,2025-01-12 11:00:00,1.10,1.46,1.30,264,220,286,40,16,24,32,14,18,8,3,5,+2,-2,+4,71%,70%,72%,175,156,191,31%,24%,36%,7,1,6,5,3,2
352,https://vlr.gg/player/11013/balli,2025-01-12 11:00:00,0.77,1.01,0.90,196,189,216,34,14,20,38,17,21,9,5,4,-4,-1,-3,73%,80%,68%,123,111,133,35%,36%,35%,1,1,0,5,2,3
353,https://vlr.gg/player/854/matelian,2025-01-12 11:00:00,1.07,0.71,0.87,174,218,138,28,15,13,36,15,21,19,12,7,0,-1,+1,78%,80%,76%,114,136,97,26%,26%,26%,1,0,1,1,1,0
354,https://vlr.gg/player/253/sp1ke,2025-01-12 11:00:00,1.07,0.59,0.80,190,210,186,27,15,12,38,14,24,8,2,6,+1,0,+1,69%,75%,64%,130,144,119,16%,17%,15%,6,2,4,5,2,3
355,https://vlr.gg/player/126/nowaxxzang,2025-01-12 11:00:00,0.72,0.50,0.60,158,168,156,22,10,12,38,15,23,21,13,8,-2,+2,-4,64%,80%,52%,98,102,94,22%,38%,13%,6,5,1,8,3,5
356,https://vlr.gg/player/2098/thebigfiz,2025-01-12 11:00:00,1.63,1.23,1.46,236,251,229,40,24,16,24,11,13,14,11,3,0,+1,-1,82%,88%,75%,162,180,140,33%,35%,29%,2,1,1,2,0,2
357,https://vlr.gg/player/14612/lux9,2025-01-12 11:00:00,1.40,1.38,1.39,313,352,269,50,31,19,32,20,12,4,4,0,+8,+3,+5,73%,84%,60%,198,216,176,33%,28%,41%,11,6,5,3,3,0
358,https://vlr.gg/player/3563/babax,2025-01-12 11:00:00,1.06,0.83,0.96,194,201,180,31,19,12,30,16,14,11,8,3,0,0,0,78%,88%,65%,128,130,125,26%,30%,22%,5,2,3,5,2,3
359,https://vlr.gg/player/2620/ooriime,2025-01-12 11:00:00,1.08,0.77,0.94,207,203,190,33,20,13,33,16,17,19,9,10,-2,-1,-1,69%,72%,65%,125,130,118,21%,23%,18%,3,2,1,5,3,2
360,https://vlr.gg/player/16345/yayax,2025-01-12 11:00:00,0.65,1.06,0.84,171,147,204,28,13,15,32,18,14,20,11,9,-3,-2,-1,78%,68%,90%,114,99,133,23%,25%,20%,3,2,1,6,4,2
361,https://vlr.gg/player/4851/rexs,2025-01-12 11:00:00,1.03,1.42,1.24,250,219,269,38,16,22,32,16,16,13,4,9,+1,+1,0,82%,81%,83%,165,143,185,27%,22%,30%,6,3,3,5,2,3
362,https://vlr.gg/player/24428/harambe,2025-01-12 11:00:00,1.02,1.22,1.13,258,230,282,40,16,24,35,16,19,9,5,4,+1,0,+1,67%,67%,67%,167,165,168,31%,28%,34%,5,2,3,4,2,2
363,https://vlr.gg/player/6925/chadi,2025-01-12 11:00:00,1.15,0.90,1.02,216,256,182,33,18,15,30,15,15,10,2,8,+7,+4,+3,67%,62%,71%,139,164,117,23%,17%,32%,11,6,5,4,2,2
364,https://vlr.gg/player/2835/kyrrz,2025-01-12 11:00:00,0.92,0.83,0.88,163,154,172,24,11,13,30,13,17,19,9,10,-1,-3,+2,82%,81%,83%,105,100,110,26%,37%,19%,2,0,2,3,3,0
365,https://vlr.gg/player/24359/faska,2025-01-12 11:00:00,0.33,0.78,0.57,123,67,174,21,5,16,32,16,16,6,5,1,-3,-1,-2,58%,48%,67%,90,45,130,31%,21%,35%,1,0,1,4,1,3
366,https://vlr.gg/player/4277/n-a-i-s,2025-01-12 11:00:00,1.61,1.14,1.39,242,260,230,39,22,17,27,13,14,15,11,4,-1,0,-1,71%,79%,62%,160,158,162,18%,19%,17%,3,1,2,4,1,3
367,https://vlr.gg/player/5854/z3ro,2025-01-12 11:00:00,0.94,1.38,1.15,215,218,205,35,19,16,29,19,10,14,5,9,-1,-1,0,78%,71%,86%,141,142,141,30%,32%,28%,3,2,1,4,3,1
368,https://vlr.gg/player/16447/d3mur,2025-01-12 11:00:00,0.58,1.25,0.89,228,170,290,33,13,20,37,20,17,13,7,6,-2,-2,0,64%,58%,71%,142,104,185,26%,26%,25%,7,3,4,9,5,4
369,https://vlr.gg/player/7868/lele,2025-01-12 11:00:00,0.89,0.84,0.87,172,192,153,28,17,11,32,19,13,11,5,6,-3,-2,-1,64%,67%,62%,120,132,106,31%,46%,19%,3,2,1,6,4,2
370,https://vlr.gg/player/1472/falltw,2025-01-12 11:00:00,0.71,0.97,0.83,151,148,149,24,12,12,31,19,12,19,7,12,+2,+1,+1,69%,58%,81%,92,92,92,25%,23%,28%,4,2,2,2,1,1
371,https://vlr.gg/player/1155/buld,2025-01-12 11:00:00,1.17,1.42,1.30,263,247,275,57,26,31,42,23,19,25,13,12,+1,-1,+2,69%,63%,75%,158,151,164,31%,34%,28%,9,4,5,8,5,3
372,https://vlr.gg/player/4519/kamisseq,2025-01-12 11:00:00,0.85,1.18,1.01,157,123,195,37,13,24,38,19,19,19,13,6,+2,+1,+1,75%,72%,78%,110,79,141,33%,28%,36%,5,2,3,3,1,2
373,https://vlr.gg/player/402/insider,2025-01-12 11:00:00,1.10,0.69,0.89,180,237,133,40,26,14,42,20,22,15,7,8,+1,+1,0,75%,84%,66%,120,148,93,28%,30%,25%,5,3,2,4,2,2
374,https://vlr.gg/player/23347/alannn,2025-01-12 11:00:00,0.81,0.90,0.86,191,162,222,44,20,24,46,23,23,7,4,3,-2,-3,+1,64%,66%,63%,129,110,148,35%,46%,29%,4,2,2,6,5,1
375,https://vlr.gg/player/3784/katu,2025-01-12 11:00:00,0.80,0.82,0.81,175,169,175,39,19,20,48,24,24,8,3,5,0,0,0,63%,63%,63%,110,109,111,27%,37%,20%,10,4,6,10,4,6
376,https://vlr.gg/player/18162/serial,2025-01-12 11:00:00,1.56,1.26,1.41,282,305,257,61,34,27,41,21,20,12,6,6,+9,+5,+4,89%,94%,84%,193,212,175,37%,40%,33%,10,6,4,1,1,0
377,https://vlr.gg/player/16209/famsii,2025-01-12 11:00:00,1.37,1.42,1.39,272,273,287,63,31,32,44,21,23,11,5,6,+7,+3,+4,77%,78%,75%,181,174,189,29%,38%,23%,12,6,6,5,3,2
378,https://vlr.gg/player/1524/h1ber,2025-01-12 11:00:00,0.67,0.96,0.82,151,134,165,33,14,19,43,23,20,16,8,8,-4,-2,-2,67%,69%,66%,100,95,106,25%,29%,22%,3,1,2,7,3,4
379,https://vlr.gg/player/29972/michel,2025-01-12 11:00:00,0.66,0.92,0.79,174,162,184,38,17,21,45,25,20,5,2,3,-6,-3,-3,61%,53%,69%,123,113,133,37%,38%,35%,2,0,2,8,3,5
380,https://vlr.gg/player/8805/sacake,2025-01-12 11:00:00,0.53,0.61,0.57,98,112,87,21,11,10,44,23,21,21,11,10,-8,-7,-1,64%,63%,66%,67,80,53,27%,24%,31%,4,1,3,12,8,4
381,https://vlr.gg/player/14566/16ch0ps,2025-01-12 08:30:00,1.09,0.89,0.99,213,252,175,18,11,7,21,11,10,12,4,8,-1,-1,0,77%,85%,69%,144,177,112,40%,48%,30%,2,0,2,3,1,2
382,https://vlr.gg/player/1437/yesican,2025-01-12 08:30:00,1.13,0.85,0.98,195,206,184,30,15,15,32,14,18,13,6,7,0,+1,-1,72%,71%,72%,123,137,112,30%,31%,29%,3,3,0,3,2,1
383,https://vlr.gg/player/48574/nia,2025-01-12 08:30:00,1.64,0.53,0.97,179,284,110,12,9,3,15,5,10,6,3,3,+1,+1,0,70%,88%,58%,102,140,76,29%,35%,18%,1,1,0,0,0,0
384,https://vlr.gg/player/23976/crus,2025-01-12 08:30:00,0.94,0.97,0.96,174,162,190,27,11,16,34,16,18,23,17,6,-2,-1,-1,65%,71%,60%,113,99,125,50%,48%,52%,3,1,2,5,2,3
385,https://vlr.gg/player/37639/hyuse,2025-01-12 08:30:00,0.84,1.03,0.94,224,237,232,40,18,22,39,19,20,3,3,0,0,+1,-1,65%,71%,60%,141,143,140,22%,12%,32%,9,5,4,9,4,5
386,https://vlr.gg/player/46463/twilight,2025-01-12 08:30:00,0.62,0.78,0.71,162,126,194,25,9,16,37,16,21,8,5,3,-2,-2,0,57%,52%,60%,110,93,125,26%,20%,33%,3,0,3,5,2,3
387,https://vlr.gg/player/40910/consz,2025-01-12 08:30:00,1.36,1.13,1.26,273,291,243,43,26,17,32,17,15,10,5,5,+8,+3,+5,85%,80%,90%,174,197,146,29%,31%,26%,11,5,6,3,2,1
388,https://vlr.gg/player/40907/mnfear,2025-01-12 08:30:00,1.34,1.03,1.20,250,239,258,41,22,19,33,15,18,11,4,7,+5,+4,+1,78%,76%,81%,156,150,164,37%,38%,37%,9,6,3,4,2,2
389,https://vlr.gg/player/44770/cxix666,2025-01-12 08:30:00,1.15,0.95,1.06,201,229,165,33,21,12,29,17,12,11,7,4,-5,-3,-2,70%,64%,76%,144,171,112,26%,25%,29%,1,1,0,6,4,2
390,https://vlr.gg/player/40908/skyisblue,2025-01-12 08:30:00,0.77,1.28,1.01,214,168,274,37,15,22,33,18,15,15,12,3,-2,-2,0,72%,68%,76%,132,108,159,19%,27%,14%,3,1,2,5,3,2
391,https://vlr.gg/player/44930/nex1sphix,2025-01-12 08:30:00,0.92,0.72,0.83,138,133,150,24,13,11,26,12,14,8,4,4,-2,+1,-3,76%,84%,67%,94,87,103,31%,36%,27%,1,1,0,3,0,3
392,https://vlr.gg/player/10821/delb,2025-01-12 07:25:00,,,,234,,,32,,,31,,,5,,,,,,,,,,,,,,,,,,,,
393,https://vlr.gg/player/46748/k1ra,2025-01-12 07:25:00,,,,206,,,25,,,35,,,7,,,,,,,,,,,,,,,,,,,,
394,https://vlr.gg/player/50080/lsn,2025-01-12 07:25:00,,,,148,,,23,,,30,,,14,,,,,,,,,,,,,,,,,,,,
395,https://vlr.gg/player/14431/monk,2025-01-12 07:25:00,,,,132,,,16,,,28,,,13,,,,,,,,,,,,,,,,,,,,
396,https://vlr.gg/player/4880/nizhaotzh,2025-01-12 07:25:00,,,,131,,,13,,,31,,,14,,,,,,,,,,,,,,,,,,,,
397,https://vlr.gg/player/46460/ezeir,2025-01-12 07:25:00,,,,278,,,38,,,20,,,21,,,,,,,,,,,,,,,,,,,,
398,https://vlr.gg/player/1209/swerl,2025-01-12 07:25:00,,,,272,,,33,,,25,,,10,,,,,,,,,,,,,,,,,,,,
399,https://vlr.gg/player/39697/cb,2025-01-12 07:25:00,,,,228,,,32,,,21,,,19,,,,,,,,,,,,,,,,,,,,
400,https://vlr.gg/player/41054/guang,2025-01-12 07:25:00,,,,227,,,30,,,20,,,10,,,,,,,,,,,,,,,,,,,,
401,https://vlr.gg/player/4402/o0o0o,2025-01-12 07:25:00,,,,173,,,22,,,23,,,25,,,,,,,,,,,,,,,,,,,,
402,https://vlr.gg/player/41694/endoist,2025-01-12 06:00:00,1.09,1.54,1.28,254,217,302,37,18,19,25,16,9,12,4,8,-1,0,-1,83%,75%,94%,172,136,220,27%,24%,31%,6,4,2,7,4,3
403,https://vlr.gg/player/41701/ki1wsy,2025-01-12 06:00:00,1.14,1.38,1.24,250,240,257,37,21,16,27,19,8,13,5,8,+1,+1,0,71%,67%,78%,167,162,174,35%,32%,39%,6,4,2,5,3,2
404,https://vlr.gg/player/20623/harddora,2025-01-12 06:00:00,1.20,1.21,1.20,212,216,208,35,20,15,23,15,8,14,10,4,-1,0,-1,83%,83%,83%,128,122,136,37%,41%,32%,1,0,1,2,0,2
405,https://vlr.gg/player/17303/fontuz,2025-01-12 06:00:00,0.61,1.70,1.08,168,92,272,24,6,18,24,15,9,23,9,14,+1,-1,+2,74%,58%,94%,110,68,166,22%,15%,28%,3,1,2,2,2,0
406,https://vlr.gg/player/31537/basbabe,2025-01-12 06:00:00,0.90,0.87,0.89,213,218,211,31,17,14,33,20,13,15,11,4,0,0,0,83%,79%,89%,121,130,109,32%,30%,33%,5,3,2,5,3,2
407,https://vlr.gg/player/36705/kestrel,2025-01-12 06:00:00,0.46,1.32,0.95,208,167,234,30,9,21,31,17,14,7,1,6,0,-1,+1,62%,39%,79%,146,109,173,30%,33%,28%,2,1,1,2,2,0
408,https://vlr.gg/player/7447/firstlove,2025-01-12 06:00:00,0.89,0.97,0.93,192,198,192,27,11,16,33,17,16,9,5,4,0,+1,-1,71%,78%,67%,143,144,142,26%,20%,30%,4,1,3,4,0,4
409,https://vlr.gg/player/7580/edw4rd,2025-01-12 06:00:00,1.12,0.75,0.91,179,208,159,26,14,12,32,15,17,10,2,8,0,+1,-1,60%,61%,58%,124,137,114,22%,31%,16%,1,1,0,1,0,1
410,https://vlr.gg/player/36687/miz,2025-01-12 06:00:00,0.38,1.15,0.82,202,135,256,28,7,21,35,17,18,10,6,4,-1,-1,0,52%,56%,50%,136,85,174,21%,19%,23%,11,5,6,12,6,6
411,https://vlr.gg/player/3473/benaf,2025-01-12 06:00:00,0.58,0.90,0.76,153,98,193,21,6,15,33,16,17,15,8,7,+1,0,+1,79%,78%,79%,94,61,119,25%,24%,25%,3,1,2,2,1,1
412,https://vlr.gg/player/16924/stew,2025-01-12 04:00:00,,,,240,,,58,,,46,,,13,,,,,,,,,,,,,,,,,,,,
413,https://vlr.gg/player/41029/z1yan,2025-01-12 04:00:00,,,,224,,,52,,,50,,,14,,,,,,,,,,,,,,,,,,,,
414,https://vlr.gg/player/3519/jkuro,2025-01-12 04:00:00,,,,204,,,43,,,54,,,20,,,,,,,,,,,,,,,,,,,,
415,https://vlr.gg/player/15302/babyblue,2025-01-12 04:00:00,,,,174,,,40,,,49,,,15,,,,,,,,,,,,,,,,,,,,
416,https://vlr.gg/player/37674/mrcani,2025-01-12 04:00:00,,,,110,,,26,,,50,,,16,,,,,,,,,,,,,,,,,,,,
417,https://vlr.gg/player/31753/spiritz1,2025-01-12 04:00:00,,,,259,,,62,,,40,,,19,,,,,,,,,,,,,,,,,,,,
418,https://vlr.gg/player/7841/tvirusluke,2025-01-12 04:00:00,,,,215,,,49,,,47,,,13,,,,,,,,,,,,,,,,,,,,
419,https://vlr.gg/player/3741/vo0kashu,2025-01-12 04:00:00,,,,212,,,50,,,43,,,11,,,,,,,,,,,,,,,,,,,,
420,https://vlr.gg/player/11524/nicc,2025-01-12 04:00:00,,,,192,,,43,,,41,,,42,,,,,,,,,,,,,,,,,,,,
421,https://vlr.gg/player/4705/flex1n,2025-01-12 04:00:00,,,,191,,,45,,,49,,,19,,,,,,,,,,,,,,,,,,,,
422,https://vlr.gg/player/2653/jesse,2025-01-11 13:15:00,1.62,1.84,1.67,277,284,252,34,25,9,13,11,2,11,11,0,+2,+3,-1,87%,92%,71%,178,180,175,40%,38%,50%,4,4,0,2,1,1
423,https://vlr.gg/player/7162/wackie,2025-01-11 13:15:00,1.62,1.20,1.52,246,261,192,27,23,4,13,10,3,14,8,6,+1,+1,0,87%,88%,86%,150,154,137,21%,20%,27%,2,2,0,1,1,0
424,https://vlr.gg/player/565/starxo,2025-01-11 13:15:00,1.34,1.56,1.39,248,218,348,30,21,9,13,9,4,6,6,0,+6,+3,+3,84%,83%,86%,153,148,170,25%,23%,31%,9,5,4,3,2,1
425,https://vlr.gg/player/4521/unfake,2025-01-11 13:15:00,1.26,1.10,1.22,196,212,146,23,19,4,16,13,3,12,10,2,0,+1,-1,87%,88%,86%,143,147,128,46%,44%,57%,2,2,0,2,1,1
426,https://vlr.gg/player/440/akumaaaaa,2025-01-11 13:15:00,0.97,0.97,0.97,209,221,171,22,18,4,21,16,5,9,6,3,0,0,0,84%,83%,86%,142,150,117,39%,36%,47%,3,3,0,3,3,0
427,https://vlr.gg/player/39718/rouss,2025-01-11 13:15:00,0.68,1.06,0.97,181,147,192,20,4,16,23,6,17,8,1,7,0,-1,+1,48%,43%,50%,110,86,118,47%,63%,43%,2,0,2,2,1,1
428,https://vlr.gg/player/31058/kpro,2025-01-11 13:15:00,0.33,0.94,0.80,164,85,187,15,2,13,26,6,20,5,3,2,-2,-1,-1,52%,57%,50%,113,54,130,32%,33%,32%,1,0,1,3,1,2
429,https://vlr.gg/player/26809/tenshi,2025-01-11 13:15:00,0.94,0.52,0.62,181,177,183,18,4,14,29,5,24,7,3,4,-4,-1,-3,65%,71%,63%,123,148,116,31%,20%,35%,2,0,2,6,1,5
430,https://vlr.gg/player/4307/hyperzxz,2025-01-11 13:15:00,0.80,0.25,0.38,148,245,120,14,5,9,31,7,24,5,1,4,-1,+2,-3,45%,43%,46%,101,186,76,25%,33%,21%,6,3,3,7,1,6
431,https://vlr.gg/player/26837/poegii,2025-01-11 13:15:00,0.42,0.36,0.36,90,60,97,9,2,7,27,6,21,4,0,4,-2,0,-2,45%,43%,46%,63,31,72,24%,33%,23%,0,0,0,2,0,2
432,https://vlr.gg/player/33902/sayonara,2025-01-11 11:00:00,1.74,1.59,1.67,307,301,313,44,24,20,21,8,13,20,3,17,+6,+2,+4,84%,84%,84%,198,196,200,28%,29%,27%,6,2,4,0,0,0
433,https://vlr.gg/player/868/logan,2025-01-11 11:00:00,1.20,1.28,1.24,181,176,185,27,13,14,20,9,11,14,5,9,0,-1,+1,82%,84%,79%,129,136,121,32%,30%,35%,2,0,2,2,1,1
434,https://vlr.gg/player/2841/foxie,2025-01-11 11:00:00,1.09,1.33,1.21,211,178,245,28,12,16,21,10,11,21,10,11,+1,+2,-1,76%,84%,68%,133,110,156,44%,39%,50%,5,4,1,4,2,2
435,https://vlr.gg/player/2625/sh1n,2025-01-11 11:00:00,1.16,1.03,1.09,188,189,188,26,12,14,22,9,13,20,10,10,+2,+1,+1,84%,89%,79%,126,127,125,39%,35%,43%,4,2,2,2,1,1
436,https://vlr.gg/player/301/takas,2025-01-11 11:00:00,1.16,0.66,0.91,248,305,191,32,21,11,33,17,16,8,3,5,+3,+1,+2,79%,89%,68%,150,179,121,22%,23%,21%,8,4,4,5,3,2
437,https://vlr.gg/player/12928/veqaj,2025-01-11 11:00:00,1.27,1.25,1.26,273,286,260,37,20,17,29,15,14,3,2,1,-2,0,-2,68%,68%,68%,175,179,171,34%,30%,38%,6,4,2,8,4,4
438,https://vlr.gg/player/2621/goaster,2025-01-11 11:00:00,0.98,0.81,0.90,181,212,151,25,15,10,29,15,14,7,5,2,-1,-1,0,79%,79%,79%,112,126,99,37%,30%,50%,3,1,2,4,2,2
439,https://vlr.gg/player/6889/neskaas,2025-01-11 11:00:00,0.72,0.71,0.71,176,178,174,24,13,11,34,16,18,14,5,9,-1,-2,+1,79%,84%,74%,95,90,100,26%,20%,35%,3,1,2,4,3,1
440,https://vlr.gg/player/2252/anq,2025-01-11 11:00:00,0.93,0.46,0.70,155,195,114,19,12,7,32,15,17,17,10,7,-4,-1,-3,66%,74%,58%,99,129,68,32%,40%,21%,0,0,0,4,1,3
441,https://vlr.gg/player/5490/xitsha,2025-01-11 11:00:00,0.37,0.37,0.37,101,72,131,12,4,8,33,14,19,5,3,2,-4,-3,-1,47%,63%,32%,76,57,95,29%,29%,29%,1,0,1,5,3,2
442,https://vlr.gg/player/37927/happywei,2025-01-11 06:35:00,,,,260,,,43,,,29,,,16,,,,,,,,,,,,,,,,,,,,
443,https://vlr.gg/player/22047/rarga,2025-01-11 06:35:00,,,,241,,,36,,,35,,,9,,,,,,,,,,,,,,,,,,,,
444,https://vlr.gg/player/12365/coconut,2025-01-11 06:35:00,,,,204,,,34,,,25,,,16,,,,,,,,,,,,,,,,,,,,
445,https://vlr.gg/player/36415/viva,2025-01-11 06:35:00,,,,203,,,34,,,27,,,18,,,,,,,,,,,,,,,,,,,,
446,https://vlr.gg/player/4710/you,2025-01-11 06:35:00,,,,159,,,25,,,29,,,19,,,,,,,,,,,,,,,,,,,,
447,https://vlr.gg/player/14125/spring,2025-01-11 06:35:00,,,,264,,,40,,,35,,,7,,,,,,,,,,,,,,,,,,,,
448,https://vlr.gg/player/7426/juicy,2025-01-11 06:35:00,,,,204,,,33,,,30,,,15,,,,,,,,,,,,,,,,,,,,
449,https://vlr.gg/player/37489/lysoar,2025-01-11 06:35:00,,,,191,,,27,,,39,,,13,,,,,,,,,,,,,,,,,,,,
450,https://vlr.gg/player/7849/siufatbb,2025-01-11 06:35:00,,,,145,,,23,,,35,,,19,,,,,,,,,,,,,,,,,,,,
451,https://vlr.gg/player/11218/yuicaw,2025-01-11 06:35:00,,,,138,,,22,,,33,,,12,,,,,,,,,,,,,,,,,,,,
452,https://vlr.gg/player/2346/cud,2025-01-11 06:30:00,1.24,1.18,1.21,258,270,246,46,23,23,34,16,18,11,6,5,-1,-1,0,79%,79%,79%,163,171,154,42%,55%,31%,3,0,3,4,1,3
453,https://vlr.gg/player/7807/valdyn,2025-01-11 06:30:00,1.22,1.14,1.18,227,218,235,40,20,20,33,14,19,28,17,11,+1,0,+1,75%,79%,71%,141,137,146,32%,36%,29%,4,1,3,3,1,2
454,https://vlr.gg/player/23710/gotten,2025-01-11 06:30:00,1.42,0.84,1.13,229,282,176,38,25,13,34,15,19,16,2,14,+2,+1,+1,75%,75%,75%,144,176,111,45%,50%,39%,6,2,4,4,1,3
455,https://vlr.gg/player/11666/ray4c,2025-01-11 06:30:00,1.01,1.23,1.12,243,246,241,39,20,19,34,18,16,12,7,5,-1,-5,+4,67%,63%,71%,152,146,157,12%,14%,10%,9,5,4,10,10,0
456,https://vlr.gg/player/16852/nakya,2025-01-11 06:30:00,0.86,0.53,0.70,129,151,107,21,13,8,32,14,18,15,6,9,-1,-1,0,69%,79%,58%,85,97,73,35%,30%,42%,2,1,1,3,2,1
457,https://vlr.gg/player/11578/hotsauz,2025-01-11 06:30:00,1.20,1.33,1.27,259,206,311,42,17,25,35,15,20,17,10,7,+2,-2,+4,83%,83%,83%,173,141,205,33%,36%,31%,6,1,5,4,3,1
458,https://vlr.gg/player/16953/zynd,2025-01-11 06:30:00,1.15,1.06,1.10,232,236,228,37,19,18,37,16,21,11,3,8,+5,+1,+4,71%,67%,75%,148,151,146,27%,23%,32%,10,4,6,5,3,2
459,https://vlr.gg/player/9747/emman,2025-01-11 06:30:00,1.12,0.74,0.93,176,208,144,31,19,12,37,17,20,17,11,6,+2,0,+2,67%,75%,58%,115,146,85,30%,39%,20%,3,1,2,1,1,0
460,https://vlr.gg/player/7746/kevzii,2025-01-11 06:30:00,0.81,0.76,0.78,172,174,170,28,15,13,39,19,20,24,13,11,-4,-3,-1,69%,75%,63%,114,111,116,23%,25%,21%,1,0,1,5,3,2
461,https://vlr.gg/player/9737/kakarot,2025-01-11 06:30:00,1.09,0.47,0.78,183,244,121,29,20,9,36,16,20,11,7,4,-5,-2,-3,60%,75%,46%,116,150,83,13%,17%,7%,4,3,1,9,5,4
462,https://vlr.gg/player/41739/slowly,2025-01-11 04:00:00,,,,259,,,43,,,30,,,12,,,,,,,,,,,,,,,,,,,,
463,https://vlr.gg/player/3547/ninebody,2025-01-11 04:00:00,,,,195,,,32,,,35,,,10,,,,,,,,,,,,,,,,,,,,
464,https://vlr.gg/player/7135/hfmi0dzjc9z7,2025-01-11 04:00:00,,,,176,,,28,,,35,,,16,,,,,,,,,,,,,,,,,,,,
465,https://vlr.gg/player/14444/eren,2025-01-11 04:00:00,,,,164,,,29,,,37,,,9,,,,,,,,,,,,,,,,,,,,
466,https://vlr.gg/player/47101/5cm,2025-01-11 04:00:00,,,,139,,,21,,,33,,,20,,,,,,,,,,,,,,,,,,,,
467,https://vlr.gg/player/488/rb,2025-01-11 04:00:00,,,,246,,,40,,,30,,,11,,,,,,,,,,,,,,,,,,,,
468,https://vlr.gg/player/42235/dynamite,2025-01-11 04:00:00,,,,245,,,43,,,31,,,5,,,,,,,,,,,,,,,,,,,,
469,https://vlr.gg/player/4720/haodong,2025-01-11 04:00:00,,,,206,,,32,,,28,,,29,,,,,,,,,,,,,,,,,,,,
470,https://vlr.gg/player/5011/abo,2025-01-11 04:00:00,,,,184,,,32,,,34,,,4,,,,,,,,,,,,,,,,,,,,
471,https://vlr.gg/player/30526/b1ack,2025-01-11 04:00:00,,,,154,,,23,,,30,,,22,,,,,,,,,,,,,,,,,,,,
472,https://vlr.gg/player/46046/iceyyy,2025-01-11 01:00:00,0.55,1.45,0.89,175,138,267,21,8,13,27,20,7,15,8,7,-3,-3,0,69%,55%,92%,127,101,171,28%,29%,27%,1,1,0,4,4,0
473,https://vlr.gg/player/5886/flaring,2025-01-11 01:00:00,0.98,0.59,0.83,171,198,156,22,15,7,30,19,11,13,7,6,-1,0,-1,66%,64%,69%,110,125,84,26%,23%,33%,2,1,1,3,1,2
474,https://vlr.gg/player/7443/riza,2025-01-11 01:00:00,0.48,1.00,0.67,130,123,189,18,9,9,29,21,8,7,6,1,-2,-3,+1,66%,64%,69%,96,79,123,26%,16%,47%,3,1,2,5,4,1
475,https://vlr.gg/player/7513/markl,2025-01-11 01:00:00,0.71,0.44,0.61,177,164,164,19,13,6,32,20,12,3,2,1,0,-1,+1,54%,55%,54%,119,117,121,15%,18%,11%,1,0,1,1,1,0
476,https://vlr.gg/player/45876/fixy,2025-01-11 01:00:00,0.22,0.92,0.48,117,86,211,15,5,10,30,20,10,5,4,1,-5,-7,+2,63%,59%,69%,92,70,130,22%,23%,22%,5,1,4,10,8,2
477,https://vlr.gg/player/11578/hotsauz,2025-01-11 01:00:00,1.20,1.90,1.64,285,164,305,37,9,28,16,8,8,11,3,8,+1,-1,+2,89%,69%,100%,148,92,181,35%,50%,31%,3,1,2,2,2,0
478,https://vlr.gg/player/16953/zynd,2025-01-11 01:00:00,1.33,1.71,1.57,305,255,290,34,11,23,17,9,8,11,4,7,+1,-1,+2,80%,69%,86%,200,207,196,37%,34%,38%,7,2,5,6,3,3
479,https://vlr.gg/player/7746/kevzii,2025-01-11 01:00:00,0.98,1.40,1.24,235,208,254,30,10,20,21,10,11,14,5,9,+3,0,+3,94%,92%,95%,157,129,174,33%,23%,39%,5,1,4,2,1,1
480,https://vlr.gg/player/9747/emman,2025-01-11 01:00:00,1.16,1.22,1.20,189,198,222,26,8,18,21,8,13,19,11,8,+3,0,+3,80%,77%,82%,139,134,141,38%,33%,41%,3,0,3,0,0,0
481,https://vlr.gg/player/9737/kakarot,2025-01-11 01:00:00,1.04,0.94,0.98,168,214,137,21,10,11,20,10,10,10,3,7,+3,-1,+4,83%,77%,86%,116,139,103,21%,21%,22%,5,1,4,2,2,0
482,https://vlr.gg/player/6702/bazz,2025-01-10 22:00:00,0.95,1.28,1.09,227,190,298,35,16,19,32,18,14,13,7,6,-3,-4,+1,67%,54%,83%,160,143,184,30%,27%,32%,4,0,4,7,4,3
483,https://vlr.gg/player/2400/brofeld,2025-01-10 22:00:00,0.81,1.07,0.92,248,225,258,31,15,16,37,22,15,7,4,3,0,-1,+1,60%,50%,72%,157,158,157,27%,34%,21%,5,2,3,5,3,2
484,https://vlr.gg/player/45962/ken,2025-01-10 22:00:00,0.73,1.10,0.89,170,153,177,25,11,14,29,20,9,6,5,1,-2,-2,0,62%,50%,78%,115,110,122,25%,26%,25%,4,2,2,6,4,2
485,https://vlr.gg/player/40736/kapi,2025-01-10 22:00:00,0.73,0.83,0.77,152,162,170,24,14,10,33,20,13,13,4,9,+2,+2,0,55%,50%,61%,100,94,108,36%,43%,29%,3,3,0,1,1,0
486,https://vlr.gg/player/1009/sakurai,2025-01-10 22:00:00,0.67,0.64,0.66,150,163,125,19,12,7,35,22,13,10,6,4,-1,-3,+2,62%,54%,72%,104,124,77,26%,32%,15%,3,1,2,4,4,0
487,https://vlr.gg/player/16852/nakya,2025-01-10 22:00:00,1.28,1.54,1.42,265,233,296,39,16,23,27,13,14,19,5,14,+2,+1,+1,76%,78%,75%,185,143,216,33%,35%,32%,3,1,2,1,0,1
488,https://vlr.gg/player/2346/cud,2025-01-10 22:00:00,1.46,1.29,1.36,231,268,218,37,18,19,23,11,12,10,1,9,+5,+3,+2,81%,78%,83%,155,187,132,38%,45%,33%,7,3,4,2,0,2
489,https://vlr.gg/player/7807/valdyn,2025-01-10 22:00:00,1.17,1.18,1.18,219,211,215,31,14,17,26,13,13,25,8,17,0,-1,+1,86%,89%,83%,135,139,132,16%,24%,12%,4,1,3,4,2,2
490,https://vlr.gg/player/23710/gotten,2025-01-10 22:00:00,0.53,1.38,1.01,172,126,209,28,7,21,26,14,12,24,10,14,-2,-2,0,79%,72%,83%,103,70,127,35%,37%,34%,3,1,2,5,3,2
491,https://vlr.gg/player/11666/ray4c,2025-01-10 22:00:00,0.64,1.26,0.99,254,174,293,31,9,22,32,15,17,19,5,14,-1,-5,+4,86%,89%,83%,150,111,178,17%,15%,19%,6,1,5,7,6,1
492,https://vlr.gg/player/43125/kadiri,2025-01-09 05:10:00,1.37,2.05,1.66,283,223,366,24,11,13,13,6,7,2,2,0,0,0,0,76%,75%,78%,208,162,271,41%,41%,41%,0,0,0,0,0,0
493,https://vlr.gg/player/29821/sinaway,2025-01-09 05:10:00,1.85,1.37,1.65,267,273,259,20,12,8,10,4,6,19,12,7,+2,+2,0,81%,92%,67%,181,200,157,19%,24%,13%,3,3,0,1,1,0
494,https://vlr.gg/player/31255/biggiecheese,2025-01-09 05:10:00,1.65,0.49,1.15,221,296,123,15,12,3,12,5,7,9,6,3,-1,+1,-2,81%,100%,56%,162,215,91,19%,21%,13%,3,2,1,4,1,3
495,https://vlr.gg/player/31254/feta,2025-01-09 05:10:00,1.26,0.56,0.96,217,283,131,16,14,2,15,8,7,3,0,3,-3,0,-3,81%,92%,67%,150,182,109,18%,21%,12%,3,2,1,6,2,4
496,https://vlr.gg/player/29790/zauqk,2025-01-09 05:10:00,1.04,0.46,0.79,152,190,102,10,7,3,16,9,7,14,12,2,-1,-1,0,86%,100%,67%,94,125,53,12%,9%,22%,0,0,0,1,1,0
497,https://vlr.gg/player/13221/azys,2025-01-09 05:10:00,1.50,0.67,1.02,259,342,198,18,10,8,18,6,12,6,4,2,+2,+1,+1,57%,78%,42%,162,224,115,25%,24%,29%,6,3,3,4,2,2
498,https://vlr.gg/player/3628/deathmaker,2025-01-09 05:10:00,1.14,0.85,0.97,207,214,203,15,7,8,16,5,11,3,0,3,0,+1,-1,62%,78%,50%,137,154,124,27%,23%,32%,2,1,1,2,0,2
499,https://vlr.gg/player/12947/rawfiul,2025-01-09 05:10:00,1.31,0.69,0.96,219,216,221,16,8,8,17,5,12,1,0,1,-1,+1,-2,71%,78%,67%,158,162,154,47%,47%,46%,1,1,0,2,0,2
500,https://vlr.gg/player/18704/levi,2025-01-09 05:10:00,0.79,0.67,0.72,142,139,146,9,5,4,16,6,10,6,2,4,+1,+1,0,76%,100%,58%,97,75,114,19%,38%,14%,1,1,0,0,0,0
501,https://vlr.gg/player/3269/antidote,2025-01-09 05:10:00,0.50,0.47,0.48,115,137,99,8,4,4,18,7,11,5,2,3,+1,+1,0,62%,67%,58%,89,102,79,27%,21%,33%,2,1,1,1,0,1
0,https://vlr.gg/player/48575/bucute,2025-01-09 04:40:00,1.33,1.19,1.27,185,212,147,15,10,5,11,7,4,5,3,2,-1,-2,+1,75%,67%,88%,139,156,112,36%,38%,33%,1,0,1,2,2,0
1,https://vlr.gg/player/8036/k1llers,2025-01-09 04:40:00,1.01,1.60,1.24,215,193,249,16,8,8,13,9,4,11,8,3,-1,0,-1,85%,83%,88%,163,143,192,28%,22%,37%,0,0,0,1,0,1
2,https://vlr.gg/player/14213/ting2k5,2025-01-09 04:40:00,1.00,1.47,1.19,270,257,290,19,11,8,16,10,6,4,1,3,+3,+1,+2,60%,50%,75%,178,162,202,34%,35%,33%,5,3,2,2,2,0
3,https://vlr.gg/player/1429/d0rf,2025-01-09 04:40:00,1.04,0.94,1.00,159,168,147,12,7,5,12,7,5,2,2,0,-2,-1,-1,65%,58%,75%,101,103,99,19%,17%,25%,0,0,0,2,1,1
4,https://vlr.gg/player/8240/alyal,2025-01-09 04:40:00,0.74,0.35,0.59,176,206,132,10,7,3,17,9,8,5,3,2,-1,0,-1,45%,50%,38%,126,152,88,23%,27%,19%,3,2,1,4,2,2
5,https://vlr.gg/player/27336/venka,2025-01-09 04:40:00,1.42,1.23,1.31,257,271,248,18,7,11,14,5,9,3,2,1,+2,-1,+3,75%,88%,67%,160,179,147,38%,44%,35%,6,2,4,4,3,1
6,https://vlr.gg/player/27775/techno,2025-01-09 04:40:00,1.32,0.99,1.12,235,297,195,16,8,8,15,7,8,11,6,5,+2,+1,+1,70%,75%,67%,150,185,126,20%,21%,19%,3,1,2,1,0,1
7,https://vlr.gg/player/3627/hellff,2025-01-09 04:40:00,1.05,0.95,0.99,160,196,137,13,7,6,13,6,7,6,3,3,0,+1,-1,70%,63%,75%,111,143,90,30%,22%,37%,1,1,0,1,0,1
8,https://vlr.gg/player/26376/deecee,2025-01-09 04:40:00,0.51,1.13,0.88,206,155,241,15,4,11,16,6,10,6,1,5,-1,-1,0,70%,50%,83%,149,111,173,35%,27%,39%,0,0,0,1,1,0
9,https://vlr.gg/player/3639/hoax,2025-01-09 04:40:00,0.42,0.87,0.69,139,64,190,7,1,6,14,5,9,10,3,7,-1,0,-1,70%,63%,75%,109,65,138,10%,20%,8%,1,0,1,2,0,2
10,https://vlr.gg/player/10739/shiro,2025-01-09 04:20:00,1.50,0.41,1.06,195,252,110,14,11,3,13,7,6,10,8,2,+1,+1,0,70%,75%,63%,132,172,71,31%,31%,30%,2,1,1,1,0,1
11,https://vlr.gg/player/16215/dos9,2025-01-09 04:20:00,1.18,0.83,1.04,233,254,203,17,11,6,13,8,5,6,4,2,-1,-1,0,80%,83%,75%,143,153,126,26%,21%,40%,0,0,0,1,1,0
12,https://vlr.gg/player/2348/famouz,2025-01-09 04:20:00,0.75,0.38,0.60,204,233,163,12,9,3,17,11,6,5,3,2,-2,-1,-1,65%,67%,63%,136,138,133,12%,17%,6%,2,1,1,4,2,2
13,https://vlr.gg/player/4874/berserx,2025-01-09 04:20:00,0.38,0.72,0.52,111,100,129,7,4,3,15,9,6,6,3,3,-4,-2,-2,40%,33%,50%,69,65,75,22%,44%,11%,2,2,0,6,4,2
14,https://vlr.gg/player/7043/ncslasher,2025-01-09 04:20:00,0.29,0.56,0.40,109,98,127,8,4,4,17,11,6,3,3,0,-2,-1,-1,65%,67%,63%,70,63,82,7%,0%,13%,0,0,0,2,1,1
15,https://vlr.gg/player/7746/kevzii,2025-01-09 04:20:00,1.76,1.12,1.38,200,260,162,14,7,7,9,3,6,7,3,4,+1,+1,0,70%,88%,58%,128,186,90,29%,28%,31%,2,1,1,1,0,1
16,https://vlr.gg/player/9747/emman,2025-01-09 04:20:00,0.60,1.74,1.28,268,140,354,19,4,15,16,6,10,10,3,7,+4,0,+4,85%,75%,92%,157,86,204,27%,27%,26%,4,0,4,0,0,0
17,https://vlr.gg/player/11578/hotsauz,2025-01-09 04:20:00,1.84,0.90,1.28,200,245,170,15,8,7,10,2,8,7,2,5,+2,+2,0,85%,100%,75%,139,146,133,43%,46%,41%,2,2,0,0,0,0
18,https://vlr.gg/player/16953/zynd,2025-01-09 04:20:00,1.12,1.22,1.18,188,155,211,14,5,9,9,3,6,2,0,2,-1,0,-1,80%,75%,83%,118,99,130,36%,25%,43%,2,1,1,3,1,2
19,https://vlr.gg/player/9737/kakarot,2025-01-09 04:20:00,1.15,1.07,1.10,204,226,190,13,5,8,14,5,9,6,2,4,+2,+1,+1,80%,88%,75%,134,150,123,6%,13%,0%,4,2,2,2,1,1
20,https://vlr.gg/player/8504/invy,2025-01-09 04:10:00,1.40,1.82,1.68,270,266,273,19,7,12,9,4,5,13,2,11,0,0,0,94%,100%,92%,169,166,170,40%,36%,42%,0,0,0,0,0,0
21,https://vlr.gg/player/2334/jessievash,2025-01-09 04:10:00,1.33,1.75,1.61,288,264,300,19,6,13,10,4,6,7,3,4,0,0,0,94%,100%,92%,178,135,200,25%,18%,29%,0,0,0,0,0,0
22,https://vlr.gg/player/10217/marky,2025-01-09 04:10:00,1.42,0.89,1.07,235,249,229,14,5,9,10,3,7,4,2,2,+1,+1,0,72%,83%,67%,157,155,158,32%,58%,25%,4,2,2,3,1,2
23,https://vlr.gg/player/9735/2ge,2025-01-09 04:10:00,0.63,1.12,0.96,179,186,176,13,4,9,11,5,6,3,2,1,-2,0,-2,72%,83%,67%,106,118,100,29%,27%,29%,0,0,0,2,0,2
24,https://vlr.gg/player/7405/jremy,2025-01-09 04:10:00,1.04,0.83,0.90,234,251,227,15,6,9,15,5,10,4,0,4,+5,-1,+6,89%,83%,92%,157,181,145,27%,38%,20%,7,1,6,2,2,0
25,https://vlr.gg/player/6702/bazz,2025-01-09 04:10:00,0.97,1.22,1.06,241,200,325,15,8,7,16,10,6,3,3,0,-1,-2,+1,72%,67%,83%,177,150,230,40%,36%,47%,1,0,1,2,2,0
26,https://vlr.gg/player/1009/sakurai,2025-01-09 04:10:00,0.67,1.15,0.83,170,145,222,12,6,6,16,10,6,5,3,2,-1,-1,0,56%,42%,83%,118,90,175,31%,31%,30%,1,0,1,2,1,1
27,https://vlr.gg/player/2400/brofeld,2025-01-09 04:10:00,0.59,1.02,0.73,146,117,205,10,6,4,14,9,5,5,2,3,-1,0,-1,67%,58%,83%,96,70,149,16%,18%,15%,2,1,1,3,1,2
28,https://vlr.gg/player/40736/kapi,2025-01-09 04:10:00,0.46,1.08,0.66,161,159,165,10,6,4,17,12,5,7,3,4,-1,-1,0,56%,50%,67%,100,96,107,27%,25%,30%,2,2,0,3,3,0
29,https://vlr.gg/player/45962/ken,2025-01-09 04:10:00,0.96,0.02,0.61,158,210,55,8,8,0,17,11,6,5,3,2,0,0,0,61%,75%,33%,107,133,55,21%,24%,15%,1,1,0,1,1,0
30,https://vlr.gg/player/16977/socools0da,2025-01-09 04:00:00,0.99,1.41,1.18,225,201,256,18,8,10,15,9,6,6,3,3,+2,0,+2,64%,50%,80%,140,126,156,19%,19%,19%,3,0,3,1,0,1
31,https://vlr.gg/player/12291/arpoom,2025-01-09 04:00:00,0.92,1.38,1.13,189,168,214,14,5,9,14,9,5,5,2,3,-1,0,-1,68%,58%,80%,141,124,162,34%,31%,39%,0,0,0,1,0,1
32,https://vlr.gg/player/27225/d4rf,2025-01-09 04:00:00,0.89,0.89,0.89,197,182,217,15,8,7,17,10,7,8,4,4,+1,+1,0,73%,67%,80%,120,100,145,38%,27%,47%,1,1,0,0,0,0
33,https://vlr.gg/player/31498/lorangez,2025-01-09 04:00:00,0.43,1.04,0.71,212,150,287,15,5,10,20,12,8,5,3,2,-2,-2,0,64%,58%,70%,142,112,178,11%,22%,3%,4,2,2,6,4,2
34,https://vlr.gg/player/25535/vickyz,2025-01-09 04:00:00,0.50,0.71,0.59,160,165,155,12,6,6,20,12,8,7,3,4,-2,-1,-1,73%,58%,90%,92,91,93,11%,7%,15%,2,2,0,4,3,1
35,https://vlr.gg/player/49611/saluat,2025-01-09 04:00:00,1.64,1.91,1.79,399,366,427,29,12,17,17,9,8,9,3,6,+4,+2,+2,82%,70%,92%,252,228,272,27%,29%,26%,8,3,5,4,1,3
36,https://vlr.gg/player/46462/shu,2025-01-09 04:00:00,1.23,1.49,1.37,290,262,314,23,9,14,14,8,6,8,3,5,-2,-2,0,77%,60%,92%,190,207,176,15%,22%,11%,2,1,1,4,3,1
37,https://vlr.gg/player/46327/ethan,2025-01-09 04:00:00,1.11,0.92,1.01,172,255,104,13,9,4,12,8,4,6,3,3,-2,-1,-1,82%,80%,83%,116,162,77,29%,28%,29%,0,0,0,2,1,1
38,https://vlr.gg/player/49612/croudy,2025-01-09 04:00:00,0.45,1.22,0.87,168,112,216,12,3,9,15,9,6,10,3,7,0,0,0,73%,50%,92%,108,75,136,18%,14%,19%,0,0,0,0,0,0
39,https://vlr.gg/player/2371/popoman4q,2025-01-09 04:00:00,0.40,0.89,0.67,95,46,137,9,1,8,16,8,8,9,5,4,+2,+1,+1,68%,50%,83%,53,20,80,18%,0%,23%,2,1,1,0,0,0
40,https://vlr.gg/player/16852/nakya,2025-01-09 03:30:00,1.36,1.60,1.47,279,294,263,22,12,10,14,9,5,8,5,3,+3,+1,+2,68%,67%,70%,168,183,151,36%,43%,27%,4,2,2,1,1,0
41,https://vlr.gg/player/7807/valdyn,2025-01-09 03:30:00,1.49,1.22,1.36,238,228,251,19,10,9,12,5,7,12,6,6,-1,-1,0,77%,83%,70%,157,157,157,19%,17%,24%,1,0,1,2,1,1
42,https://vlr.gg/player/2346/cud,2025-01-09 03:30:00,1.22,1.22,1.22,204,184,229,19,9,10,12,7,5,1,0,1,+2,+1,+1,82%,75%,90%,135,130,140,43%,60%,32%,2,1,1,0,0,0
43,https://vlr.gg/player/23710/gotten,2025-01-09 03:30:00,1.03,1.09,1.06,143,168,114,10,6,4,12,7,5,17,10,7,-1,-1,0,82%,83%,80%,103,116,88,25%,22%,31%,1,0,1,2,1,1
44,https://vlr.gg/player/11666/ray4c,2025-01-09 03:30:00,0.53,1.39,0.92,184,149,228,13,6,7,14,10,4,9,2,7,-3,-2,-1,73%,67%,80%,124,95,159,10%,6%,15%,3,2,1,6,4,2
45,https://vlr.gg/player/7851/uta,2025-01-09 03:30:00,1.43,1.31,1.36,262,302,229,18,9,9,15,8,7,7,4,3,+3,+3,0,64%,60%,67%,182,187,179,30%,32%,28%,4,3,1,1,0,1
46,https://vlr.gg/player/50179/kirito,2025-01-09 03:30:00,0.55,1.48,1.05,249,163,321,18,5,13,17,8,9,4,2,2,0,-3,+3,73%,60%,83%,160,112,201,30%,27%,31%,3,0,3,3,3,0
47,https://vlr.gg/player/26996/blue,2025-01-09 03:30:00,0.49,0.97,0.75,141,82,191,11,3,8,15,8,7,6,3,3,+1,-1,+2,68%,60%,75%,86,52,114,30%,60%,25%,2,0,2,1,1,0
48,https://vlr.gg/player/42541/ckuma,2025-01-09 03:30:00,0.85,0.06,0.42,79,143,27,6,5,1,17,7,10,4,2,2,-2,0,-2,68%,80%,58%,54,104,11,25%,33%,0%,1,1,0,3,1,2
49,https://vlr.gg/player/47977/chak,2025-01-09 03:30:00,0.21,0.60,0.42,131,112,148,11,4,7,19,9,10,4,0,4,-2,-1,-1,59%,50%,67%,85,67,100,11%,7%,13%,1,0,1,3,1,2
50,https://vlr.gg/player/4563/kobra,2025-01-09 03:20:00,2.33,0.51,1.38,295,450,154,26,19,7,16,5,11,3,3,0,-1,+1,-2,78%,100%,58%,190,306,84,38%,39%,36%,2,1,1,3,0,3
51,https://vlr.gg/player/4475/benecia,2025-01-09 03:20:00,1.60,0.68,1.12,222,274,175,19,12,7,17,6,11,9,6,3,+2,+1,+1,74%,91%,58%,139,176,105,27%,38%,17%,3,2,1,1,1,0
52,https://vlr.gg/player/4650/gangazi,2025-01-09 03:20:00,1.35,0.70,1.01,192,262,129,15,11,4,16,6,10,4,1,3,0,+1,-1,65%,91%,42%,133,172,97,41%,55%,29%,1,1,0,1,0,1
53,https://vlr.gg/player/10654/joohyung,2025-01-09 03:20:00,1.01,0.65,0.82,167,148,185,14,6,8,19,7,12,12,11,1,-2,0,-2,70%,91%,50%,95,86,103,8%,6%,9%,0,0,0,2,0,2
54,https://vlr.gg/player/4465/onestep,2025-01-09 03:20:00,1.02,0.35,0.67,152,165,142,11,7,4,17,5,12,3,1,2,-2,+2,-4,61%,82%,42%,99,98,100,50%,70%,38%,4,4,0,6,2,4
55,https://vlr.gg/player/49587/bugattiveyron,2025-01-09 03:20:00,2.18,0.35,1.31,336,516,141,28,23,5,18,7,11,4,3,1,0,+2,-2,74%,92%,55%,204,310,89,29%,32%,23%,4,3,1,4,1,3
56,https://vlr.gg/player/50181/big-bear,2025-01-09 03:20:00,1.51,0.65,1.10,214,229,199,18,11,7,17,6,11,7,4,3,-2,0,-2,74%,100%,45%,145,165,123,30%,26%,35%,1,1,0,3,1,2
57,https://vlr.gg/player/46749/player,2025-01-09 03:20:00,1.09,1.09,1.09,192,151,239,16,7,9,16,5,11,5,3,2,+3,+1,+2,78%,83%,73%,133,115,153,39%,47%,33%,3,1,2,0,0,0
58,https://vlr.gg/player/50183/y1,2025-01-09 03:20:00,1.06,0.45,0.77,152,159,146,13,7,6,17,6,11,6,5,1,+2,+4,-2,61%,75%,45%,101,110,91,42%,50%,36%,4,4,0,2,0,2
59,https://vlr.gg/player/50180/lan,2025-01-09 03:20:00,1.02,0.18,0.62,133,178,86,10,8,2,17,6,11,5,1,4,0,+1,-1,61%,83%,36%,100,125,74,29%,30%,25%,1,1,0,1,0,1
60,https://vlr.gg/player/45876/fixy,2025-01-09 03:00:00,1.00,1.93,1.42,240,165,332,20,7,13,14,9,5,3,2,1,0,0,0,82%,83%,80%,154,114,202,31%,35%,27%,2,0,2,2,0,2
61,https://vlr.gg/player/5886/flaring,2025-01-09 03:00:00,0.96,1.73,1.31,233,160,322,19,7,12,14,8,6,7,3,4,-1,-1,0,82%,75%,90%,148,82,226,18%,27%,16%,0,0,0,1,1,0
62,https://vlr.gg/player/7443/riza,2025-01-09 03:00:00,0.77,0.94,0.85,183,220,141,14,8,6,16,11,5,5,3,2,-2,-3,+1,68%,67%,70%,122,149,89,48%,58%,38%,3,1,2,5,4,1
63,https://vlr.gg/player/46046/iceyyy,2025-01-09 03:00:00,0.43,1.33,0.84,160,111,220,11,4,7,15,10,5,6,2,4,-4,-3,-1,68%,58%,80%,114,79,156,21%,18%,23%,1,1,0,5,4,1
64,https://vlr.gg/player/7513/markl,2025-01-09 03:00:00,0.65,0.81,0.72,116,139,91,8,5,3,15,10,5,4,1,3,-1,-1,0,64%,42%,90%,83,85,81,20%,20%,20%,1,0,1,2,1,1
65,https://vlr.gg/player/1430/crazyguy,2025-01-09 03:00:00,0.54,1.71,1.18,247,124,351,16,3,13,14,8,6,7,1,6,+2,0,+2,82%,60%,100%,173,86,246,19%,20%,19%,4,1,3,2,1,1
66,https://vlr.gg/player/13220/ja,2025-01-09 03:00:00,0.52,1.69,1.16,214,111,301,17,3,14,13,8,5,2,2,0,+3,0,+3,77%,50%,100%,144,95,184,24%,20%,26%,3,0,3,0,0,0
67,https://vlr.gg/player/11704/styron,2025-01-09 03:00:00,1.14,0.66,0.88,196,277,128,15,10,5,17,9,8,15,4,11,+2,+1,+1,73%,80%,67%,127,186,78,14%,19%,5%,3,2,1,1,1,0
68,https://vlr.gg/player/24628/wayne,2025-01-09 03:00:00,0.39,1.16,0.81,159,117,195,13,4,9,14,8,6,8,2,6,-1,0,-1,64%,40%,83%,109,70,141,24%,18%,28%,1,1,0,2,1,1
69,https://vlr.gg/player/24653/vera,2025-01-09 03:00:00,0.68,0.91,0.81,142,166,122,13,6,7,14,8,6,4,3,1,+2,-1,+3,77%,70%,83%,80,82,79,21%,25%,13%,4,1,3,2,2,0
70,https://vlr.gg/player/29790/zauqk,2025-01-09 02:45:00,2.06,1.20,1.65,297,331,262,22,14,8,12,5,7,15,8,7,0,+1,-1,74%,75%,73%,209,225,191,14%,14%,13%,1,1,0,1,0,1
71,https://vlr.gg/player/29821/sinaway,2025-01-09 02:45:00,1.45,0.93,1.20,204,227,179,18,11,7,16,7,9,8,7,1,+1,+1,0,65%,67%,64%,141,166,113,37%,33%,42%,2,1,1,1,0,1
72,https://vlr.gg/player/31255/biggiecheese,2025-01-09 02:45:00,0.67,1.73,1.18,194,96,302,16,4,12,15,7,8,7,4,3,-1,-1,0,70%,67%,73%,143,72,220,38%,33%,39%,0,0,0,1,1,0
73,https://vlr.gg/player/31254/feta,2025-01-09 02:45:00,1.37,0.24,0.83,212,303,113,17,13,4,18,8,10,5,2,3,-5,-1,-4,61%,67%,55%,141,197,81,33%,37%,23%,4,2,2,9,3,6
74,https://vlr.gg/player/43125/kadiri,2025-01-09 02:45:00,0.15,1.32,0.71,159,71,256,13,2,11,19,11,8,4,3,1,-2,-2,0,70%,58%,82%,109,53,171,31%,15%,39%,1,1,0,3,3,0
75,https://vlr.gg/player/7405/jremy,2025-01-09 02:45:00,1.46,1.03,1.24,280,374,195,23,14,9,19,10,9,3,2,1,+3,+4,-1,83%,100%,67%,167,210,128,23%,24%,21%,5,4,1,2,0,2
76,https://vlr.gg/player/2334/jessievash,2025-01-09 02:45:00,0.93,1.53,1.24,277,178,369,23,8,15,16,7,9,5,3,2,+2,-1,+3,70%,64%,75%,191,140,238,26%,23%,27%,4,0,4,2,1,1
77,https://vlr.gg/player/9735/2ge,2025-01-09 02:45:00,1.24,0.83,1.03,184,235,138,14,9,5,15,7,8,13,6,7,+1,+1,0,74%,82%,67%,114,160,72,36%,50%,22%,3,2,1,2,1,1
78,https://vlr.gg/player/8504/invy,2025-01-09 02:45:00,0.90,0.73,0.81,180,197,166,13,8,5,18,9,9,11,8,3,0,0,0,70%,73%,67%,125,124,127,29%,33%,25%,1,1,0,1,1,0
79,https://vlr.gg/player/10217/marky,2025-01-09 02:45:00,0.31,0.43,0.38,98,106,92,7,3,4,18,9,9,3,2,1,+1,+1,0,57%,64%,50%,74,85,65,33%,29%,42%,2,1,1,1,0,1
80,https://vlr.gg/player/10739/shiro,2025-01-09 02:25:00,1.45,2.30,1.79,326,273,408,23,11,12,10,6,4,6,3,3,0,-1,+1,95%,92%,100%,223,178,291,39%,45%,32%,1,0,1,1,1,0
81,https://vlr.gg/player/16215/dos9,2025-01-09 02:25:00,1.49,0.84,1.23,220,278,134,15,12,3,13,8,5,13,7,6,-1,0,-1,80%,75%,88%,131,153,98,27%,43%,10%,0,0,0,1,0,1
82,https://vlr.gg/player/2348/famouz,2025-01-09 02:25:00,0.90,1.53,1.15,230,180,307,18,8,10,12,8,4,5,3,2,-1,-2,+1,70%,67%,75%,147,119,189,34%,27%,39%,4,2,2,5,4,1
83,https://vlr.gg/player/7043/ncslasher,2025-01-09 02:25:00,0.95,1.32,1.10,206,177,250,15,7,8,13,8,5,12,6,6,+4,+2,+2,80%,83%,75%,128,120,140,32%,26%,40%,4,2,2,0,0,0
84,https://vlr.gg/player/4874/berserx,2025-01-09 02:25:00,0.66,0.94,0.77,99,62,156,8,3,5,11,6,5,6,2,4,-2,-1,-1,75%,67%,88%,76,39,132,26%,22%,28%,1,1,0,3,2,1
85,https://vlr.gg/player/4650/gangazi,2025-01-09 02:25:00,0.88,0.93,0.91,185,207,171,13,6,7,15,7,8,3,1,2,+2,+1,+1,65%,75%,58%,116,113,118,22%,45%,15%,2,1,1,0,0,0
86,https://vlr.gg/player/4475/benecia,2025-01-09 02:25:00,0.60,1.09,0.90,188,130,227,13,3,10,16,8,8,7,5,2,+2,+1,+1,75%,75%,75%,108,73,131,23%,25%,22%,3,1,2,1,0,1
87,https://vlr.gg/player/4563/kobra,2025-01-09 02:25:00,1.32,0.63,0.90,198,281,144,13,8,5,16,7,9,1,1,0,0,-1,+1,55%,50%,58%,125,178,90,28%,17%,57%,3,1,2,3,2,1
88,https://vlr.gg/player/4465/onestep,2025-01-09 02:25:00,0.16,1.08,0.71,157,81,210,12,3,9,15,8,7,1,0,1,-2,-2,0,60%,38%,75%,111,38,160,39%,40%,39%,2,0,2,4,2,2
89,https://vlr.gg/player/10654/joohyung,2025-01-09 02:25:00,0.32,0.59,0.48,128,137,122,8,3,5,17,8,9,9,3,6,-2,-1,-1,70%,63%,75%,80,84,77,18%,6%,33%,0,0,0,2,1,1
90,https://vlr.gg/player/14213/ting2k5,2025-01-09 02:20:00,1.08,1.23,1.18,231,204,248,14,4,10,14,5,9,2,2,0,-3,-2,-1,58%,71%,50%,169,168,169,27%,29%,26%,2,0,2,5,2,3
91,https://vlr.gg/player/1429/d0rf,2025-01-09 02:20:00,1.51,0.94,1.15,246,306,212,17,8,9,14,5,9,6,2,4,+2,+1,+1,68%,71%,67%,156,170,148,37%,32%,42%,2,1,1,0,0,0
92,https://vlr.gg/player/48575/bucute,2025-01-09 02:20:00,1.01,0.92,0.96,193,231,172,13,6,7,13,5,8,4,2,2,+1,+1,0,79%,71%,83%,128,145,118,36%,45%,29%,3,2,1,2,1,1
93,https://vlr.gg/player/8036/k1llers,2025-01-09 02:20:00,0.58,0.82,0.73,147,138,154,11,4,7,15,5,10,3,0,3,+1,0,+1,63%,57%,67%,97,103,94,31%,40%,26%,1,0,1,0,0,0
94,https://vlr.gg/player/8240/alyal,2025-01-09 02:20:00,0.74,0.70,0.71,145,103,170,8,2,6,14,4,10,8,3,5,-2,-1,-1,68%,71%,67%,102,90,109,9%,0%,14%,1,0,1,3,1,2
95,https://vlr.gg/player/23710/gotten,2025-01-09 02:20:00,1.87,1.14,1.60,248,298,163,18,14,4,9,5,4,7,5,2,0,0,0,89%,92%,86%,147,174,102,38%,42%,29%,0,0,0,0,0,0
96,https://vlr.gg/player/7807/valdyn,2025-01-09 02:20:00,1.13,0.95,1.06,263,246,292,17,10,7,16,9,7,9,5,4,+5,+3,+2,84%,83%,86%,170,167,175,26%,26%,27%,5,3,2,0,0,0
97,https://vlr.gg/player/11666/ray4c,2025-01-09 02:20:00,0.68,1.43,0.96,181,156,226,13,6,7,13,9,4,5,4,1,-1,-1,0,74%,83%,57%,108,101,120,14%,14%,13%,3,1,2,4,2,2
98,https://vlr.gg/player/2346/cud,2025-01-09 02:20:00,0.82,1.04,0.90,147,156,134,10,7,3,11,7,4,4,1,3,-1,-1,0,58%,50%,71%,113,107,123,41%,33%,50%,1,1,0,2,2,0
99,https://vlr.gg/player/16852/nakya,2025-01-09 02:20:00,0.85,0.64,0.77,167,197,119,12,9,3,14,9,5,9,5,4,-2,-1,-1,89%,83%,100%,100,118,71,23%,33%,8%,1,1,0,3,2,1
100,https://vlr.gg/player/12291/arpoom,2025-01-09 02:05:00,1.33,0.41,0.99,209,268,109,13,11,2,14,8,6,3,2,1,+1,+1,0,74%,83%,57%,135,165,82,28%,32%,18%,2,2,0,1,1,0
101,https://vlr.gg/player/25535/vickyz,2025-01-09 02:05:00,1.36,0.34,0.99,222,293,101,15,12,3,16,10,6,6,6,0,+1,+1,0,74%,92%,43%,138,169,84,20%,19%,25%,3,2,1,2,1,1
102,https://vlr.gg/player/16977/socools0da,2025-01-09 02:05:00,0.70,1.24,0.90,173,119,267,10,5,5,13,8,5,5,3,2,-2,-1,-1,63%,67%,57%,118,78,186,27%,50%,18%,0,0,0,2,1,1
103,https://vlr.gg/player/27225/d4rf,2025-01-09 02:05:00,0.89,0.75,0.84,224,223,227,15,9,6,16,9,7,8,7,1,0,+1,-1,79%,75%,86%,154,164,138,33%,30%,42%,1,1,0,1,0,1
104,https://vlr.gg/player/31498/lorangez,2025-01-09 02:05:00,0.68,0.36,0.56,162,156,173,9,6,3,16,9,7,4,2,2,-3,-2,-1,79%,83%,71%,123,119,129,22%,33%,11%,2,1,1,5,3,2
105,https://vlr.gg/player/46046/iceyyy,2025-01-09 02:05:00,2.01,1.76,1.85,349,344,353,26,9,17,14,4,10,6,3,3,+2,+1,+1,84%,100%,75%,213,212,213,22%,34%,15%,3,1,2,1,0,1
106,https://vlr.gg/player/7443/riza,2025-01-09 02:05:00,1.28,1.16,1.20,208,157,239,13,4,9,11,3,8,13,5,8,+1,0,+1,84%,86%,83%,135,109,151,17%,5%,26%,1,0,1,0,0,0
107,https://vlr.gg/player/45876/fixy,2025-01-09 02:05:00,1.12,0.93,1.00,226,300,184,15,8,7,14,6,8,3,0,3,+1,+2,-1,74%,86%,67%,141,177,121,28%,38%,20%,6,4,2,5,2,3
108,https://vlr.gg/player/5886/flaring,2025-01-09 02:05:00,1.35,0.76,0.97,197,256,164,13,7,6,13,4,9,7,1,6,-2,0,-2,84%,100%,75%,124,155,106,32%,38%,28%,0,0,0,2,0,2
109,https://vlr.gg/player/7513/markl,2025-01-09 02:05:00,1.24,0.61,0.84,103,108,101,8,3,5,11,2,9,10,5,5,+1,0,+1,79%,100%,67%,62,72,56,7%,22%,0%,1,0,1,0,0,0
110,https://vlr.gg/player/9747/emman,2025-01-09 01:30:00,1.83,1.04,1.54,232,327,72,17,15,2,7,5,2,13,8,5,+2,+2,0,89%,100%,71%,145,205,42,44%,52%,14%,2,2,0,0,0,0
111,https://vlr.gg/player/16953/zynd,2025-01-09 01:30:00,1.15,2.07,1.49,249,192,348,17,10,7,9,6,3,7,0,7,0,-1,+1,84%,75%,100%,180,136,256,42%,71%,28%,3,2,1,3,3,0
112,https://vlr.gg/player/9737/kakarot,2025-01-09 01:30:00,1.16,1.63,1.34,290,241,376,20,10,10,13,8,5,3,2,1,0,0,0,74%,75%,71%,199,169,249,36%,43%,28%,2,1,1,2,1,1
113,https://vlr.gg/player/7746/kevzii,2025-01-09 01:30:00,1.11,1.70,1.33,203,163,273,11,5,6,9,5,4,16,8,8,0,+1,-1,95%,92%,100%,147,108,213,32%,20%,55%,2,1,1,2,0,2
114,https://vlr.gg/player/11578/hotsauz,2025-01-09 01:30:00,1.12,1.13,1.12,135,158,96,9,7,2,8,6,2,10,5,5,+1,+2,-1,79%,83%,71%,95,119,54,21%,17%,40%,2,2,0,1,0,1
115,https://vlr.gg/player/50183/y1,2025-01-09 01:30:00,0.72,1.23,1.04,178,119,213,12,2,10,14,5,9,4,4,0,+1,+1,0,47%,57%,42%,100,75,115,55%,38%,67%,2,1,1,1,0,1
116,https://vlr.gg/player/49587/bugattiveyron,2025-01-09 01:30:00,0.83,0.71,0.75,225,262,205,14,6,8,16,6,10,3,1,2,-1,0,-1,47%,57%,42%,143,173,125,30%,37%,26%,5,3,2,6,3,3
117,https://vlr.gg/player/50181/big-bear,2025-01-09 01:30:00,0.61,0.58,0.59,94,107,87,6,3,3,14,5,9,8,3,5,-2,0,-2,63%,57%,67%,60,59,61,29%,22%,33%,0,0,0,2,0,2
118,https://vlr.gg/player/46749/player,2025-01-09 01:30:00,0.70,0.47,0.55,118,125,114,8,4,4,15,5,10,3,0,3,-1,0,-1,47%,43%,50%,78,67,84,35%,100%,21%,0,0,0,1,0,1
119,https://vlr.gg/player/50180/lan,2025-01-09 01:30:00,0.22,0.64,0.49,84,44,109,6,1,5,15,6,9,1,0,1,0,0,0,42%,29%,50%,58,34,73,36%,20%,44%,1,0,1,1,0,1
120,https://vlr.gg/player/13221/azys,2025-01-09 01:15:00,1.39,2.07,1.78,337,294,371,25,9,16,13,7,6,2,1,1,+1,-1,+2,76%,67%,83%,210,186,228,42%,61%,31%,4,1,3,3,2,1
121,https://vlr.gg/player/3628/deathmaker,2025-01-09 01:15:00,0.62,0.88,0.77,146,114,170,12,4,8,16,7,9,8,1,7,0,0,0,62%,56%,67%,88,71,100,21%,18%,22%,1,0,1,1,0,1
122,https://vlr.gg/player/3269/antidote,2025-01-09 01:15:00,0.13,1.17,0.72,147,56,216,11,1,10,16,8,8,5,3,2,-1,-2,+1,71%,56%,83%,106,54,145,28%,9%,38%,1,0,1,2,2,0
123,https://vlr.gg/player/12947/rawfiul,2025-01-09 01:15:00,1.39,0.21,0.72,170,278,90,12,9,3,16,6,10,2,1,1,0,0,0,57%,67%,50%,124,191,74,21%,18%,26%,2,1,1,2,1,1
124,https://vlr.gg/player/18704/levi,2025-01-09 01:15:00,0.17,0.51,0.36,109,59,148,6,1,5,18,7,11,9,2,7,-1,-2,+1,71%,56%,83%,72,38,97,16%,22%,14%,2,0,2,3,2,1
125,https://vlr.gg/player/2400/brofeld,2025-01-09 01:15:00,1.82,0.96,1.45,274,338,190,21,15,6,13,7,6,7,4,3,+2,+1,+1,86%,83%,89%,191,217,157,28%,27%,29%,2,1,1,0,0,0
126,https://vlr.gg/player/45962/ken,2025-01-09 01:15:00,1.40,1.06,1.25,212,260,149,17,12,5,11,7,4,1,1,0,0,-1,+1,71%,75%,67%,142,167,109,45%,52%,33%,1,0,1,1,1,0
127,https://vlr.gg/player/6702/bazz,2025-01-09 01:15:00,0.83,1.48,1.11,222,197,256,16,8,8,14,9,5,11,5,6,0,-3,+3,76%,67%,89%,136,132,143,31%,23%,42%,5,1,4,5,4,1
128,https://vlr.gg/player/1009/sakurai,2025-01-09 01:15:00,0.72,1.36,0.99,193,176,215,14,6,8,15,10,5,9,6,3,0,0,0,67%,58%,78%,138,108,176,28%,23%,33%,2,1,1,2,1,1
129,https://vlr.gg/player/40736/kapi,2025-01-09 01:15:00,0.46,1.50,0.91,144,77,235,11,3,8,13,9,4,10,7,3,-1,-1,0,67%,58%,78%,87,38,153,31%,11%,40%,1,1,0,2,2,0
130,https://vlr.gg/player/46462/shu,2025-01-09 01:15:00,1.26,1.12,1.17,215,240,203,14,5,9,15,5,10,11,4,7,+1,-1,+2,83%,100%,75%,146,170,134,33%,20%,57%,2,0,2,1,1,0
131,https://vlr.gg/player/2371/popoman4q,2025-01-09 01:15:00,1.62,0.50,0.87,192,350,113,13,8,5,15,5,10,1,1,0,-2,0,-2,61%,100%,42%,108,197,64,45%,38%,57%,0,0,0,2,0,2
132,https://vlr.gg/player/49611/saluat,2025-01-09 01:15:00,0.22,1.18,0.86,249,108,319,14,1,13,17,6,11,4,3,1,+1,0,+1,78%,67%,83%,152,86,185,33%,8%,50%,3,1,2,2,1,1
133,https://vlr.gg/player/46327/ethan,2025-01-09 01:15:00,1.06,0.48,0.67,149,225,111,9,5,4,15,5,10,4,1,3,-3,-1,-2,72%,100%,58%,105,147,84,24%,23%,24%,1,0,1,4,1,3
134,https://vlr.gg/player/49612/croudy,2025-01-09 01:15:00,0.21,0.48,0.39,132,124,137,7,3,4,16,6,10,3,0,3,-1,0,-1,50%,67%,42%,80,63,89,26%,17%,31%,1,1,0,2,1,1
135,https://vlr.gg/player/24628/wayne,2025-01-09 01:15:00,1.48,1.65,1.54,236,184,342,18,10,8,9,4,5,3,0,3,0,-1,+1,94%,100%,83%,154,133,196,25%,28%,22%,1,0,1,1,1,0
136,https://vlr.gg/player/24653/vera,2025-01-09 01:15:00,1.35,1.51,1.40,266,283,234,19,13,6,12,9,3,3,1,2,+2,+2,0,89%,92%,83%,166,172,154,23%,22%,25%,4,3,1,2,1,1
137,https://vlr.gg/player/11704/styron,2025-01-09 01:15:00,1.36,1.26,1.33,228,247,193,15,10,5,10,6,4,10,8,2,-2,-2,0,94%,92%,100%,166,173,153,25%,26%,24%,0,0,0,2,2,0
138,https://vlr.gg/player/1430/crazyguy,2025-01-09 01:15:00,1.40,0.65,1.15,251,287,180,17,13,4,12,7,5,8,4,4,+3,+3,0,89%,100%,67%,152,168,119,26%,22%,43%,3,3,0,0,0,0
139,https://vlr.gg/player/13220/ja,2025-01-09 01:15:00,0.45,0.67,0.52,139,112,195,9,5,4,14,9,5,3,1,2,+1,0,+1,72%,75%,67%,80,65,110,19%,17%,21%,3,1,2,2,1,1
140,https://vlr.gg/player/26376/deecee,2025-01-09 01:15:00,1.95,1.23,1.49,246,237,252,16,7,9,9,1,8,9,2,7,0,+1,-1,74%,100%,58%,159,142,168,20%,22%,19%,2,1,1,2,0,2
141,https://vlr.gg/player/3627/hellff,2025-01-09 01:15:00,1.43,1.25,1.32,232,170,270,16,4,12,10,2,8,8,6,2,+3,0,+3,79%,100%,67%,152,118,172,33%,25%,38%,3,0,3,0,0,0
142,https://vlr.gg/player/27336/venka,2025-01-09 01:15:00,1.21,1.27,1.25,235,241,232,18,6,12,11,4,7,2,1,1,+5,+4,+1,84%,100%,75%,161,167,158,44%,60%,33%,6,4,2,1,0,1
143,https://vlr.gg/player/3639/hoax,2025-01-09 01:15:00,1.20,1.12,1.15,199,246,172,14,7,7,10,4,6,6,2,4,+2,+1,+1,79%,86%,75%,116,134,105,40%,33%,46%,2,1,1,0,0,0
144,https://vlr.gg/player/27775/techno,2025-01-09 01:15:00,1.18,0.90,1.00,176,252,132,11,6,5,10,4,6,7,4,3,-1,-1,0,74%,86%,67%,130,180,101,41%,25%,67%,1,0,1,2,1,1
145,https://vlr.gg/player/50179/kirito,2025-01-09 01:15:00,1.33,0.72,1.11,234,256,199,15,11,4,14,8,6,2,2,0,-2,-1,-1,53%,67%,29%,151,172,115,23%,36%,9%,2,2,0,4,3,1
146,https://vlr.gg/player/47977/chak,2025-01-09 01:15:00,0.76,1.08,0.88,206,185,243,14,8,6,16,10,6,1,0,1,-4,-2,-2,58%,58%,57%,132,116,160,39%,53%,28%,1,1,0,5,3,2
147,https://vlr.gg/player/26996/blue,2025-01-09 01:15:00,0.94,0.26,0.69,149,193,74,8,7,1,14,8,6,2,2,0,-1,0,-1,53%,58%,43%,98,124,54,32%,37%,17%,0,0,0,1,0,1
148,https://vlr.gg/player/7851/uta,2025-01-09 01:15:00,0.76,0.47,0.65,115,119,109,7,5,2,15,9,6,9,7,2,-1,-1,0,58%,58%,57%,73,73,72,18%,18%,18%,1,0,1,2,1,1
149,https://vlr.gg/player/42541/ckuma,2025-01-09 01:15:00,0.39,0.42,0.40,94,101,84,6,4,2,16,10,6,1,1,0,-1,0,-1,37%,42%,29%,67,74,55,37%,45%,25%,1,1,0,2,1,1
150,https://vlr.gg/player/8504/invy,2025-01-09 00:10:00,1.36,0.89,1.24,234,239,221,14,11,3,13,9,4,4,2,2,+1,+1,0,69%,67%,75%,173,170,183,36%,45%,18%,3,2,1,2,1,1
151,https://vlr.gg/player/7405/jremy,2025-01-09 00:10:00,0.76,0.77,0.76,221,217,233,10,8,2,15,11,4,4,1,3,+2,+2,0,56%,50%,75%,157,143,200,19%,21%,13%,3,3,0,1,1,0
152,https://vlr.gg/player/2334/jessievash,2025-01-09 00:10:00,0.69,0.65,0.68,170,170,172,7,5,2,15,11,4,10,6,4,0,0,0,75%,75%,75%,121,119,124,37%,39%,29%,0,0,0,0,0,0
153,https://vlr.gg/player/9735/2ge,2025-01-09 00:10:00,0.47,0.56,0.49,103,85,158,6,4,2,14,10,4,5,0,5,0,-1,+1,50%,42%,75%,77,61,127,25%,25%,25%,3,2,1,3,3,0
154,https://vlr.gg/player/10217/marky,2025-01-09 00:10:00,0.39,0.72,0.47,129,106,200,8,4,4,15,11,4,2,2,0,+1,0,+1,56%,50%,75%,87,87,87,32%,24%,50%,1,0,1,0,0,0
155,https://vlr.gg/player/13221/azys,2025-01-09 00:10:00,2.92,1.64,1.96,354,487,311,21,7,14,8,2,6,6,4,2,-1,0,-1,81%,100%,75%,231,326,200,24%,30%,19%,1,0,1,2,0,2
156,https://vlr.gg/player/3269/antidote,2025-01-09 00:10:00,1.74,1.25,1.37,206,282,181,13,5,8,8,3,5,7,3,4,0,0,0,94%,100%,92%,138,129,141,24%,18%,27%,0,0,0,0,0,0
157,https://vlr.gg/player/3628/deathmaker,2025-01-09 00:10:00,0.52,1.46,1.23,296,94,364,16,1,15,11,3,8,11,4,7,+1,0,+1,94%,100%,92%,174,34,220,42%,33%,43%,4,1,3,3,1,2
158,https://vlr.gg/player/18704/levi,2025-01-09 00:10:00,2.28,0.74,1.12,159,384,85,10,6,4,8,2,6,9,4,5,-2,0,-2,88%,100%,83%,93,201,57,36%,31%,42%,1,0,1,3,0,3
159,https://vlr.gg/player/12947/rawfiul,2025-01-09 00:10:00,0.14,1.44,1.11,204,58,254,12,1,11,10,3,7,5,0,5,-2,-2,0,69%,50%,75%,145,64,172,30%,14%,33%,0,0,0,2,2,0
160,https://vlr.gg/player/7513/markl,2025-01-09 00:10:00,1.29,1.36,1.32,243,257,224,17,10,7,11,7,4,3,3,0,+2,+2,0,80%,75%,88%,164,182,137,16%,17%,15%,4,3,1,2,1,1
161,https://vlr.gg/player/7443/riza,2025-01-09 00:10:00,1.15,1.46,1.28,258,235,295,19,10,9,13,8,5,2,2,0,+1,+2,-1,75%,67%,88%,190,165,228,25%,18%,37%,2,2,0,1,0,1
162,https://vlr.gg/player/46046/iceyyy,2025-01-09 00:10:00,0.53,2.29,1.24,293,166,484,22,7,15,13,10,3,5,4,1,0,-2,+2,75%,67%,88%,178,111,277,26%,26%,26%,3,1,2,3,3,0
163,https://vlr.gg/player/45876/fixy,2025-01-09 00:10:00,1.20,0.53,0.93,196,263,96,14,11,3,14,9,5,0,0,0,-1,0,-1,65%,58%,75%,119,163,53,26%,31%,13%,2,1,1,3,1,2
164,https://vlr.gg/player/5886/flaring,2025-01-09 00:10:00,0.65,1.30,0.91,96,59,152,5,2,3,9,6,3,17,5,12,0,0,0,75%,58%,100%,54,33,85,14%,13%,14%,0,0,0,0,0,0
165,https://vlr.gg/player/46327/ethan,2025-01-09 00:10:00,0.81,1.52,1.24,290,228,332,18,5,13,16,8,8,7,3,4,+2,+2,0,85%,75%,92%,193,158,216,29%,14%,38%,4,3,1,2,1,1
166,https://vlr.gg/player/49611/saluat,2025-01-09 00:10:00,0.21,1.90,1.22,221,107,297,15,3,12,14,8,6,1,0,1,0,-1,+1,55%,38%,67%,160,81,212,35%,43%,32%,3,0,3,3,1,2
167,https://vlr.gg/player/46462/shu,2025-01-09 00:10:00,0.61,1.28,1.01,212,168,243,13,4,9,15,7,8,10,2,8,-1,0,-1,50%,50%,50%,164,109,201,30%,20%,34%,1,0,1,2,0,2
168,https://vlr.gg/player/49612/croudy,2025-01-09 00:10:00,1.05,0.29,0.59,130,216,74,8,6,2,17,7,10,6,1,5,0,+1,-1,50%,50%,50%,93,148,57,17%,20%,13%,1,1,0,1,0,1
169,https://vlr.gg/player/2371/popoman4q,2025-01-09 00:10:00,0.29,0.56,0.45,79,60,93,6,2,4,15,7,8,2,0,2,-3,-2,-1,45%,13%,67%,58,39,70,19%,0%,27%,0,0,0,3,2,1
170,https://vlr.gg/player/4475/benecia,2025-01-09 00:10:00,1.40,1.31,1.36,246,256,237,20,11,9,17,10,7,14,7,7,+2,+1,+1,69%,77%,62%,166,166,165,32%,40%,25%,2,1,1,0,0,0
171,https://vlr.gg/player/4465/onestep,2025-01-09 00:10:00,1.16,1.42,1.29,238,193,285,22,9,13,16,9,7,4,4,0,-1,0,-1,65%,54%,77%,158,130,187,52%,65%,44%,4,2,2,5,2,3
172,https://vlr.gg/player/4650/gangazi,2025-01-09 00:10:00,0.97,0.78,0.87,158,211,107,15,10,5,18,10,8,4,1,3,+1,+1,0,62%,69%,54%,104,125,83,70%,69%,71%,2,1,1,1,0,1
173,https://vlr.gg/player/4563/kobra,2025-01-09 00:10:00,0.61,0.96,0.79,208,197,221,19,9,10,22,14,8,3,1,2,-1,-1,0,62%,62%,62%,130,120,140,27%,23%,30%,4,2,2,5,3,2
174,https://vlr.gg/player/10654/joohyung,2025-01-09 00:10:00,0.52,0.93,0.72,160,98,222,15,4,11,21,11,10,10,7,3,-3,-2,-1,69%,69%,69%,94,52,136,26%,20%,29%,0,0,0,3,2,1
175,https://vlr.gg/player/11578/hotsauz,2025-01-09 00:10:00,1.54,0.68,1.11,238,313,165,23,15,8,18,8,10,5,1,4,0,+1,-1,77%,62%,92%,170,206,134,40%,45%,32%,3,2,1,3,1,2
176,https://vlr.gg/player/9747/emman,2025-01-09 00:10:00,1.10,1.11,1.10,201,190,213,17,9,8,16,9,7,13,5,8,+1,+1,0,73%,62%,85%,137,124,151,31%,38%,26%,1,1,0,0,0,0
177,https://vlr.gg/player/9737/kakarot,2025-01-09 00:10:00,0.64,1.49,1.06,237,139,337,21,5,16,22,11,11,5,3,2,+6,+2,+4,77%,69%,85%,142,87,198,19%,26%,16%,6,2,4,0,0,0
178,https://vlr.gg/player/16953/zynd,2025-01-09 00:10:00,0.71,1.16,0.94,183,164,202,19,8,11,17,10,7,1,1,0,-5,-3,-2,58%,46%,69%,118,98,138,37%,50%,29%,3,1,2,8,4,4
179,https://vlr.gg/player/7746/kevzii,2025-01-09 00:10:00,0.45,1.11,0.78,166,77,257,14,3,11,18,10,8,12,6,6,0,0,0,58%,54%,62%,119,49,189,28%,30%,27%,1,1,0,1,1,0
180,https://vlr.gg/player/11666/ray4c,2025-01-09 00:10:00,1.76,1.33,1.51,317,386,272,24,11,13,13,6,7,3,1,2,+4,+3,+1,80%,75%,83%,192,233,165,23%,21%,26%,6,4,2,2,1,1
181,https://vlr.gg/player/7807/valdyn,2025-01-09 00:10:00,0.97,1.55,1.32,247,169,300,19,5,14,11,5,6,6,4,2,+1,0,+1,80%,75%,83%,157,128,176,33%,38%,31%,1,0,1,0,0,0
182,https://vlr.gg/player/2346/cud,2025-01-09 00:10:00,0.98,1.26,1.14,203,175,222,15,5,10,12,5,7,7,3,4,+1,0,+1,75%,63%,83%,127,136,122,48%,46%,50%,3,1,2,2,1,1
183,https://vlr.gg/player/23710/gotten,2025-01-09 00:10:00,0.74,1.07,0.94,148,100,181,10,3,7,11,5,6,8,5,3,+1,+1,0,80%,75%,83%,83,41,112,32%,40%,30%,2,1,1,1,0,1
184,https://vlr.gg/player/16852/nakya,2025-01-09 00:10:00,1.22,0.70,0.91,153,232,101,9,6,3,12,5,7,10,2,8,-3,0,-3,80%,75%,83%,108,153,78,21%,32%,7%,0,0,0,3,0,3
185,https://vlr.gg/player/3627/hellff,2025-01-09 00:10:00,1.34,0.85,1.14,189,233,124,14,10,4,14,9,5,8,6,2,+1,+2,-1,75%,75%,75%,127,156,83,34%,36%,30%,2,2,0,1,0,1
186,https://vlr.gg/player/27775/techno,2025-01-09 00:10:00,1.30,0.85,1.12,250,245,257,18,11,7,15,8,7,5,3,2,0,+2,-2,65%,75%,50%,160,154,169,26%,32%,20%,4,3,1,4,1,3
187,https://vlr.gg/player/3639/hoax,2025-01-09 00:10:00,0.48,1.32,0.82,185,111,298,10,3,7,17,10,7,7,4,3,-3,-2,-1,65%,50%,88%,137,96,199,21%,31%,16%,0,0,0,3,2,1
188,https://vlr.gg/player/27336/venka,2025-01-09 00:10:00,0.56,0.87,0.68,163,133,210,11,5,6,16,10,6,2,1,1,-1,-1,0,55%,50%,63%,107,100,119,35%,43%,25%,1,0,1,2,1,1
189,https://vlr.gg/player/26376/deecee,2025-01-09 00:10:00,0.39,0.63,0.48,100,104,96,6,4,2,15,10,5,3,1,2,-1,-1,0,60%,42%,88%,71,63,83,22%,15%,30%,1,1,0,2,2,0
190,https://vlr.gg/player/1009/sakurai,2025-01-08 23:00:00,1.61,1.27,1.42,301,315,290,24,13,11,15,6,9,6,3,3,+5,+4,+1,82%,80%,83%,193,194,191,28%,29%,28%,7,5,2,2,1,1
191,https://vlr.gg/player/6702/bazz,2025-01-08 23:00:00,1.07,1.38,1.24,238,196,275,20,8,12,14,6,8,8,3,5,+1,+1,0,82%,90%,75%,156,135,173,42%,41%,42%,4,2,2,3,1,2
192,https://vlr.gg/player/45962/ken,2025-01-08 23:00:00,1.55,0.98,1.23,268,322,223,19,12,7,14,4,10,8,3,5,+2,+1,+1,91%,100%,83%,186,215,161,20%,23%,16%,3,1,2,1,0,1
193,https://vlr.gg/player/2400/brofeld,2025-01-08 23:00:00,0.92,0.96,0.95,175,157,191,14,5,9,14,5,9,8,6,2,+2,0,+2,82%,80%,83%,115,103,126,31%,29%,33%,2,0,2,0,0,0
194,https://vlr.gg/player/40736/kapi,2025-01-08 23:00:00,1.18,0.59,0.85,133,121,143,10,4,6,13,4,9,10,8,2,0,0,0,86%,100%,75%,100,100,99,29%,44%,21%,0,0,0,0,0,0
195,https://vlr.gg/player/29821/sinaway,2025-01-08 23:00:00,0.94,1.14,1.03,210,190,236,16,7,9,18,10,8,4,3,1,+2,+1,+1,73%,75%,70%,138,124,154,36%,40%,32%,3,2,1,1,1,0
196,https://vlr.gg/player/29790/zauqk,2025-01-08 23:00:00,0.85,1.14,0.99,182,155,217,15,8,7,17,9,8,6,2,4,-3,-2,-1,68%,67%,70%,131,114,152,28%,22%,33%,0,0,0,3,2,1
197,https://vlr.gg/player/43125/kadiri,2025-01-08 23:00:00,1.55,0.15,0.92,180,285,55,12,11,1,17,8,9,10,6,4,-2,+1,-3,68%,92%,40%,127,199,40,38%,48%,11%,1,1,0,3,0,3
198,https://vlr.gg/player/31255/biggiecheese,2025-01-08 23:00:00,1.13,0.45,0.82,179,281,58,13,12,1,16,9,7,4,2,2,-2,0,-2,55%,67%,40%,121,178,54,23%,26%,17%,1,1,0,3,1,2
199,https://vlr.gg/player/31254/feta,2025-01-08 23:00:00,0.58,0.98,0.76,176,139,221,12,5,7,19,10,9,6,5,1,-5,-4,-1,64%,67%,60%,116,92,144,14%,5%,21%,1,0,1,6,4,2
200,https://vlr.gg/player/13220/ja,2025-01-08 23:00:00,1.37,1.24,1.30,248,258,239,25,13,12,17,8,9,5,1,4,+2,0,+2,65%,62%,69%,160,163,157,23%,17%,31%,4,1,3,2,1,1
201,https://vlr.gg/player/1430/crazyguy,2025-01-08 23:00:00,0.99,0.95,0.97,172,178,167,15,8,7,16,8,8,13,6,7,+1,+1,0,77%,77%,77%,118,120,115,19%,31%,12%,3,1,2,2,0,2
202,https://vlr.gg/player/11704/styron,2025-01-08 23:00:00,0.69,1.00,0.85,146,100,193,14,5,9,17,8,9,9,4,5,+2,0,+2,69%,69%,69%,91,48,134,19%,6%,26%,3,1,2,1,1,0
203,https://vlr.gg/player/24628/wayne,2025-01-08 23:00:00,1.05,0.54,0.80,135,135,135,13,6,7,18,8,10,10,6,4,+1,0,+1,65%,69%,62%,82,92,73,25%,21%,31%,2,1,1,1,1,0
204,https://vlr.gg/player/24653/vera,2025-01-08 23:00:00,0.73,0.80,0.76,193,191,196,15,8,7,21,11,10,12,4,8,-2,-2,0,69%,69%,69%,127,129,125,31%,24%,39%,3,2,1,5,4,1
205,https://vlr.gg/player/25535/vickyz,2025-01-08 23:00:00,1.58,1.09,1.33,329,365,295,29,17,12,21,10,11,3,1,2,-1,-3,+2,69%,69%,69%,197,208,185,21%,21%,22%,4,1,3,5,4,1
206,https://vlr.gg/player/27225/d4rf,2025-01-08 23:00:00,1.29,1.17,1.23,213,267,161,19,12,7,15,9,6,15,7,8,+1,-1,+2,77%,77%,77%,128,158,97,38%,44%,29%,3,1,2,2,2,0
207,https://vlr.gg/player/12291/arpoom,2025-01-08 23:00:00,0.87,1.11,0.99,209,180,238,19,8,11,17,8,9,3,1,2,-2,-1,-1,73%,85%,62%,151,128,174,26%,16%,42%,3,1,2,5,2,3
208,https://vlr.gg/player/31498/lorangez,2025-01-08 23:00:00,0.75,0.99,0.87,127,109,146,11,4,7,16,8,8,14,7,7,-1,0,-1,77%,77%,77%,79,69,90,29%,22%,32%,1,1,0,2,1,1
209,https://vlr.gg/player/16977/socools0da,2025-01-08 23:00:00,0.80,0.87,0.84,116,99,134,11,5,6,13,7,6,1,1,0,-1,0,-1,69%,69%,69%,80,65,95,27%,11%,42%,0,0,0,1,0,1
210,https://vlr.gg/player/50180/lan,2025-01-08 23:00:00,1.49,1.29,1.39,312,345,276,23,14,9,15,7,8,7,2,5,0,+1,-1,78%,75%,82%,210,233,185,52%,46%,61%,2,1,1,2,0,2
211,https://vlr.gg/player/50183/y1,2025-01-08 23:00:00,1.35,0.53,0.96,193,281,99,17,13,4,16,8,8,5,4,1,+3,+2,+1,83%,100%,64%,124,172,71,33%,34%,27%,3,2,1,0,0,0
212,https://vlr.gg/player/50181/big-bear,2025-01-08 23:00:00,0.92,0.62,0.78,157,168,145,14,8,6,17,8,9,4,4,0,-1,-2,+1,78%,83%,73%,104,119,87,8%,12%,4%,1,0,1,2,2,0
213,https://vlr.gg/player/46749/player,2025-01-08 23:00:00,0.72,0.66,0.70,204,230,178,15,9,6,19,10,9,5,4,1,-4,-2,-2,65%,75%,55%,134,148,118,30%,24%,41%,0,0,0,4,2,2
214,https://vlr.gg/player/49587/bugattiveyron,2025-01-08 23:00:00,0.53,0.76,0.64,140,84,202,12,4,8,19,8,11,3,1,2,-5,-3,-2,65%,58%,73%,100,68,136,26%,18%,29%,2,1,1,7,4,3
215,https://vlr.gg/player/16215/dos9,2025-01-08 23:00:00,2.02,1.32,1.66,282,307,260,25,13,12,15,5,10,12,6,6,+1,0,+1,91%,91%,92%,185,205,166,26%,17%,40%,1,0,1,0,0,0
216,https://vlr.gg/player/2348/famouz,2025-01-08 23:00:00,1.56,1.36,1.46,305,317,296,24,12,12,17,7,10,9,5,4,+3,+1,+2,91%,91%,92%,216,230,202,16%,11%,22%,7,3,4,4,2,2
217,https://vlr.gg/player/7043/ncslasher,2025-01-08 23:00:00,1.38,0.73,1.04,166,207,130,13,9,4,15,5,10,13,5,8,+1,0,+1,83%,73%,92%,106,129,84,29%,35%,24%,2,1,1,1,1,0
218,https://vlr.gg/player/4874/berserx,2025-01-08 23:00:00,0.64,1.14,0.90,160,114,203,14,6,8,16,8,8,2,1,1,+1,0,+1,78%,73%,83%,109,78,137,30%,27%,31%,3,1,2,2,1,1
219,https://vlr.gg/player/10739/shiro,2025-01-08 23:00:00,0.56,0.69,0.63,139,137,141,10,5,5,18,8,10,12,3,9,+1,+2,-1,74%,64%,83%,89,86,93,33%,33%,33%,2,2,0,1,0,1
220,https://vlr.gg/player/7851/uta,2025-01-08 23:00:00,1.44,2.16,1.68,287,231,401,20,11,9,10,7,3,9,5,4,+2,-1,+3,94%,92%,100%,198,175,243,33%,27%,40%,3,0,3,1,1,0
221,https://vlr.gg/player/26996/blue,2025-01-08 23:00:00,1.22,1.20,1.21,234,224,257,16,10,6,11,7,4,5,0,5,+1,+1,0,78%,67%,100%,137,135,141,36%,47%,21%,2,2,0,1,1,0
222,https://vlr.gg/player/50179/kirito,2025-01-08 23:00:00,1.21,0.91,1.11,257,282,208,16,13,3,13,10,3,3,3,0,0,0,0,83%,75%,100%,162,199,87,21%,21%,23%,4,3,1,4,3,1
223,https://vlr.gg/player/47977/chak,2025-01-08 23:00:00,0.69,1.66,1.02,209,169,290,14,7,7,14,10,4,5,4,1,+1,+1,0,72%,75%,67%,132,118,159,27%,23%,33%,1,1,0,0,0,0
224,https://vlr.gg/player/42541/ckuma,2025-01-08 23:00:00,0.56,1.06,0.73,114,95,153,7,4,3,10,8,2,2,0,2,-2,-1,-1,61%,58%,67%,82,64,118,19%,21%,17%,0,0,0,2,1,1
225,https://vlr.gg/player/8240/alyal,2025-01-08 23:00:00,0.93,1.04,1.00,225,236,220,15,5,10,14,5,9,8,1,7,0,0,0,67%,50%,75%,137,143,134,26%,29%,25%,2,1,1,2,1,1
226,https://vlr.gg/player/48575/bucute,2025-01-08 23:00:00,1.09,0.85,0.93,217,294,179,13,6,7,13,6,7,4,1,3,0,0,0,72%,67%,75%,129,188,99,31%,46%,21%,2,0,2,2,0,2
227,https://vlr.gg/player/14213/ting2k5,2025-01-08 23:00:00,0.20,1.15,0.83,193,62,260,11,1,10,17,6,11,4,0,4,+1,0,+1,67%,50%,75%,124,49,161,32%,25%,33%,3,1,2,2,1,1
228,https://vlr.gg/player/1429/d0rf,2025-01-08 23:00:00,0.80,0.55,0.63,146,177,132,10,4,6,14,5,9,3,1,2,-2,-1,-1,56%,50%,58%,91,105,84,29%,38%,23%,0,0,0,2,1,1
229,https://vlr.gg/player/8036/k1llers,2025-01-08 23:00:00,0.02,1.01,0.63,154,39,213,9,0,9,15,6,9,5,2,3,-1,-1,0,44%,17%,58%,103,39,136,23%,0%,29%,1,0,1,2,1,1
230,https://vlr.gg/player/7447/firstlove,2025-01-05 10:10:00,1.26,1.34,1.30,254,267,259,63,31,32,47,23,24,10,3,7,+14,+5,+9,75%,78%,73%,164,164,164,17%,21%,14%,20,8,12,6,3,3
231,https://vlr.gg/player/36705/kestrel,2025-01-05 10:10:00,0.61,1.35,1.01,203,143,257,45,15,30,50,25,25,26,8,18,-3,-4,+1,58%,53%,62%,140,95,180,28%,33%,27%,4,2,2,7,6,1
232,https://vlr.gg/player/3473/benaf,2025-01-05 10:10:00,1.20,0.83,1.00,193,232,160,45,26,19,48,22,26,22,10,12,+1,0,+1,74%,69%,78%,134,156,114,20%,21%,19%,6,2,4,5,2,3
233,https://vlr.gg/player/19126/kayle,2025-01-05 10:10:00,0.97,0.73,0.84,174,175,178,43,21,22,49,22,27,13,3,10,-2,0,-2,68%,69%,68%,106,103,109,26%,23%,28%,5,3,2,7,3,4
234,https://vlr.gg/player/7580/edw4rd,2025-01-05 10:10:00,0.64,0.84,0.74,138,129,146,33,13,20,49,24,25,33,18,15,-5,-3,-2,75%,75%,76%,91,93,89,19%,20%,18%,2,0,2,7,3,4
235,https://vlr.gg/player/7371/fishball,2025-01-05 10:10:00,1.29,1.21,1.25,230,253,200,55,31,24,44,26,18,31,23,8,0,+2,-2,80%,89%,69%,154,172,133,27%,31%,21%,5,4,1,5,2,3
236,https://vlr.gg/player/17814/toggle,2025-01-05 10:10:00,1.07,1.01,1.04,210,228,180,50,30,20,45,26,19,14,8,6,-3,-5,+2,72%,68%,78%,134,151,114,16%,18%,13%,11,5,6,14,10,4
237,https://vlr.gg/player/31189/kye,2025-01-05 10:10:00,1.12,0.94,1.04,187,176,201,46,24,22,45,21,24,28,15,13,+1,0,+1,71%,81%,59%,128,112,146,31%,34%,27%,6,2,4,5,2,3
238,https://vlr.gg/player/2377/aduka,2025-01-05 10:10:00,1.04,1.00,1.02,207,200,207,46,24,22,46,24,22,22,15,7,-2,-2,0,72%,78%,66%,127,120,136,23%,22%,24%,5,1,4,7,3,4
239,https://vlr.gg/player/9179/kael,2025-01-05 10:10:00,0.57,1.17,0.85,182,131,242,46,18,28,49,26,23,12,5,7,-1,-2,+1,65%,62%,69%,122,89,161,37%,32%,40%,5,3,2,6,5,1
240,https://vlr.gg/player/7448/toy,2025-01-05 08:00:00,1.29,1.18,1.23,227,233,217,35,17,18,31,16,15,16,9,7,0,0,0,87%,82%,92%,154,152,156,30%,25%,35%,2,0,2,2,0,2
241,https://vlr.gg/player/36687/miz,2025-01-05 08:00:00,0.72,1.52,1.13,246,160,327,41,12,29,35,20,15,7,3,4,+5,+4,+1,74%,68%,79%,150,100,197,19%,9%,24%,8,5,3,3,1,2
242,https://vlr.gg/player/26965/haeart,2025-01-05 08:00:00,0.71,0.97,0.85,197,182,211,32,14,18,35,20,15,9,4,5,-1,-2,+1,59%,50%,67%,128,123,132,42%,42%,43%,6,2,4,7,4,3
243,https://vlr.gg/player/36707/bullet,2025-01-05 08:00:00,0.64,0.92,0.77,160,128,194,28,11,17,34,18,16,7,4,3,-1,-3,+2,63%,50%,75%,101,79,122,21%,40%,14%,4,1,3,5,4,1
244,https://vlr.gg/player/26969/adept,2025-01-05 08:00:00,0.45,0.78,0.62,136,107,164,20,7,13,36,18,18,17,3,14,-1,-1,0,61%,55%,67%,106,80,130,29%,16%,39%,4,2,2,5,3,2
245,https://vlr.gg/player/9179/kael,2025-01-05 08:00:00,1.49,1.33,1.41,259,288,225,46,26,20,31,18,13,10,2,8,-1,0,-1,70%,50%,91%,161,166,156,36%,36%,36%,4,3,1,5,3,2
246,https://vlr.gg/player/7371/fishball,2025-01-05 08:00:00,1.14,1.42,1.27,223,210,242,36,18,18,29,19,10,21,12,9,+3,0,+3,74%,58%,91%,137,129,145,26%,22%,32%,4,1,3,1,1,0
247,https://vlr.gg/player/17814/toggle,2025-01-05 08:00:00,1.13,0.91,1.02,230,242,215,37,20,17,32,18,14,5,3,2,0,0,0,78%,71%,86%,143,157,129,22%,35%,0%,8,4,4,8,4,4
248,https://vlr.gg/player/31189/kye,2025-01-05 08:00:00,0.32,1.47,0.87,162,81,247,28,6,22,30,20,10,11,5,6,-3,-4,+1,65%,54%,77%,101,53,153,26%,24%,28%,2,1,1,5,5,0
249,https://vlr.gg/player/2377/aduka,2025-01-05 08:00:00,0.45,0.83,0.64,154,120,190,23,9,14,34,20,14,11,6,5,-1,0,-1,70%,58%,82%,110,84,139,34%,26%,41%,4,1,3,5,1,4
250,https://vlr.gg/player/36692/azami,2025-01-05 05:00:00,0.91,1.13,1.00,191,187,209,42,25,17,45,30,15,21,13,8,-2,-3,+1,66%,61%,73%,132,118,156,28%,31%,24%,3,1,2,5,4,1
251,https://vlr.gg/player/42387/akame,2025-01-05 05:00:00,0.82,1.07,0.92,226,207,258,43,23,20,49,33,16,8,8,0,+5,+4,+1,60%,58%,64%,139,131,153,24%,29%,16%,12,9,3,7,5,2
252,https://vlr.gg/player/40499/fivm,2025-01-05 05:00:00,0.90,0.92,0.91,175,188,172,35,25,10,42,27,15,19,6,13,-2,-6,+4,67%,64%,73%,123,126,119,21%,28%,13%,5,1,4,7,7,0
253,https://vlr.gg/player/27053/ender,2025-01-05 05:00:00,0.75,0.77,0.76,146,150,157,31,19,12,46,30,16,25,14,11,-2,-2,0,62%,56%,73%,99,93,107,25%,26%,24%,2,1,1,4,3,1
254,https://vlr.gg/player/40333/ventura,2025-01-05 05:00:00,0.39,0.94,0.60,139,104,199,28,12,16,49,31,18,11,6,5,+1,-3,+4,60%,53%,73%,97,74,134,24%,18%,30%,7,1,6,6,4,2
255,https://vlr.gg/player/19126/kayle,2025-01-05 05:00:00,1.16,1.50,1.37,245,216,264,55,19,36,35,15,20,19,6,13,0,-4,+4,81%,73%,86%,153,145,158,27%,30%,25%,6,1,5,6,5,1
256,https://vlr.gg/player/3473/benaf,2025-01-05 05:00:00,1.36,1.36,1.36,238,241,231,48,20,28,31,14,17,25,7,18,+3,0,+3,84%,86%,83%,164,162,165,31%,37%,28%,4,1,3,1,1,0
257,https://vlr.gg/player/7447/firstlove,2025-01-05 05:00:00,1.27,1.05,1.13,237,267,222,51,21,30,39,15,24,6,2,4,-2,-2,0,71%,68%,72%,170,189,158,20%,17%,24%,10,2,8,12,4,8
258,https://vlr.gg/player/36705/kestrel,2025-01-05 05:00:00,0.77,1.32,1.12,236,163,267,48,13,35,39,17,22,15,8,7,0,-4,+4,69%,59%,75%,149,110,173,31%,24%,34%,7,2,5,7,6,1
259,https://vlr.gg/player/7580/edw4rd,2025-01-05 05:00:00,0.81,1.03,0.95,159,124,180,29,7,22,35,14,21,38,15,23,-1,0,-1,79%,82%,78%,106,80,122,27%,22%,28%,2,0,2,3,0,3
260,https://vlr.gg/player/36693/fragile,2025-01-04 10:00:00,1.35,0.96,1.20,281,324,210,17,13,4,17,11,6,5,1,4,+2,0,+2,74%,67%,86%,179,193,155,25%,32%,11%,7,4,3,5,4,1
261,https://vlr.gg/player/7369/jeed,2025-01-04 10:00:00,0.61,1.92,1.09,188,94,351,15,4,11,15,11,4,10,4,6,0,0,0,68%,50%,100%,90,47,164,19%,20%,19%,0,0,0,0,0,0
262,https://vlr.gg/player/24752/kooniiee,2025-01-04 10:00:00,0.37,0.82,0.54,137,109,187,9,4,5,16,11,5,0,0,0,0,0,0,58%,50%,71%,94,73,129,32%,31%,33%,1,0,1,1,0,1
263,https://vlr.gg/player/50154/hidy,2025-01-04 10:00:00,0.03,0.70,0.26,81,20,187,4,0,4,18,12,6,5,3,2,-1,-1,0,37%,17%,71%,59,20,127,11%,0%,13%,0,0,0,1,1,0
264,https://vlr.gg/player/50153/jjsayeo,2025-01-04 10:00:00,0.02,0.76,0.24,96,43,187,7,1,6,17,12,5,1,1,0,-2,-1,-1,37%,17%,71%,66,39,112,21%,22%,20%,1,1,0,3,2,1
265,https://vlr.gg/player/3473/benaf,2025-01-04 10:00:00,1.87,1.74,1.79,344,404,309,24,10,14,12,6,6,7,5,2,+1,0,+1,84%,100%,75%,220,239,208,15%,16%,15%,2,0,2,1,0,1
266,https://vlr.gg/player/19126/kayle,2025-01-04 10:00:00,0.26,2.02,1.37,255,68,365,19,2,17,9,6,3,4,1,3,-2,-2,0,79%,57%,92%,186,64,257,29%,11%,33%,1,0,1,3,2,1
267,https://vlr.gg/player/36705/kestrel,2025-01-04 10:00:00,1.33,1.38,1.36,270,266,274,17,7,10,11,6,5,6,1,5,-1,0,-1,89%,100%,83%,205,178,220,23%,26%,22%,1,0,1,2,0,2
268,https://vlr.gg/player/7447/firstlove,2025-01-04 10:00:00,1.03,1.32,1.21,199,220,188,15,6,9,10,6,4,3,0,3,+2,+1,+1,74%,57%,83%,126,137,119,28%,45%,19%,5,3,2,3,2,1
269,https://vlr.gg/player/7580/edw4rd,2025-01-04 10:00:00,0.46,1.17,0.90,129,78,159,8,1,7,10,6,4,14,7,7,+1,0,+1,84%,86%,83%,77,49,93,33%,40%,32%,1,0,1,0,0,0
270,https://vlr.gg/player/7448/toy,2025-01-04 09:00:00,1.44,1.09,1.23,281,276,285,21,9,12,16,5,11,3,2,1,0,0,0,70%,75%,67%,171,146,187,31%,22%,39%,0,0,0,0,0,0
271,https://vlr.gg/player/36687/miz,2025-01-04 09:00:00,1.69,0.30,0.85,221,354,133,16,11,5,18,6,12,5,3,2,+1,0,+1,70%,88%,58%,155,253,89,27%,25%,31%,2,0,2,1,0,1
272,https://vlr.gg/player/26969/adept,2025-01-04 09:00:00,1.14,0.66,0.85,209,246,186,14,7,7,17,6,11,8,5,3,+2,0,+2,80%,75%,83%,132,135,130,18%,6%,37%,3,1,2,1,1,0
273,https://vlr.gg/player/36707/bullet,2025-01-04 09:00:00,1.41,0.22,0.70,147,238,86,10,6,4,16,5,11,11,9,2,-3,0,-3,80%,100%,67%,100,163,57,32%,38%,27%,1,1,0,4,1,3
274,https://vlr.gg/player/26965/haeart,2025-01-04 09:00:00,0.04,1.03,0.63,236,146,297,13,2,11,21,9,12,7,5,2,-2,-4,+2,80%,75%,83%,167,126,195,10%,8%,12%,3,0,3,5,4,1
275,https://vlr.gg/player/11737/xan,2025-01-04 09:00:00,2.16,0.94,1.67,300,364,206,23,18,5,12,5,7,5,2,3,+3,+2,+1,80%,92%,63%,170,189,142,24%,24%,24%,4,3,1,1,1,0
276,https://vlr.gg/player/8137/lenne,2025-01-04 09:00:00,1.12,1.65,1.33,273,247,312,20,10,10,14,8,6,4,3,1,+1,0,+1,85%,83%,88%,175,160,199,27%,22%,38%,3,2,1,2,2,0
277,https://vlr.gg/player/24654/tempz,2025-01-04 09:00:00,1.13,1.16,1.14,270,264,280,18,11,7,17,8,9,9,5,4,-1,-2,+1,70%,67%,75%,178,176,180,33%,28%,44%,2,0,2,3,2,1
278,https://vlr.gg/player/9158/hyk,2025-01-04 09:00:00,1.27,0.81,1.09,234,228,246,18,11,7,15,8,7,1,1,0,0,0,0,70%,83%,50%,151,143,163,34%,38%,30%,0,0,0,0,0,0
279,https://vlr.gg/player/20625/h3nsem,2025-01-04 09:00:00,0.65,0.26,0.49,131,166,79,9,7,2,17,10,7,2,2,0,-1,-2,+1,65%,67%,63%,97,120,63,38%,44%,25%,2,0,2,3,2,1
280,https://vlr.gg/player/7447/firstlove,2025-01-04 08:00:00,1.92,1.40,1.62,293,388,223,23,13,10,11,5,6,4,3,1,+3,0,+3,86%,78%,92%,188,228,159,21%,24%,19%,4,1,3,1,1,0
281,https://vlr.gg/player/36705/kestrel,2025-01-04 08:00:00,1.03,1.35,1.21,256,248,263,18,7,11,15,8,7,11,4,7,-2,0,-2,76%,78%,75%,158,158,159,26%,18%,38%,1,1,0,3,1,2
282,https://vlr.gg/player/3473/benaf,2025-01-04 08:00:00,0.59,1.52,1.12,161,38,253,13,1,12,9,4,5,9,3,6,+1,-1,+2,71%,56%,83%,114,32,176,38%,17%,43%,2,0,2,1,1,0
283,https://vlr.gg/player/7580/edw4rd,2025-01-04 08:00:00,0.81,1.29,1.08,163,113,201,11,4,7,11,6,5,16,6,10,0,-1,+1,86%,78%,92%,87,52,114,31%,20%,33%,3,1,2,3,2,1
284,https://vlr.gg/player/19126/kayle,2025-01-04 08:00:00,1.03,0.85,0.93,156,171,146,13,6,7,13,6,7,3,3,0,-1,-1,0,76%,78%,75%,87,113,68,21%,45%,11%,1,0,1,2,1,1
285,https://vlr.gg/player/11737/xan,2025-01-04 08:00:00,0.98,1.44,1.18,282,253,321,20,10,10,16,10,6,7,3,4,-3,-4,+1,76%,75%,78%,190,169,218,50%,48%,52%,1,0,1,4,4,0
286,https://vlr.gg/player/9158/hyk,2025-01-04 08:00:00,0.85,1.13,0.97,191,175,213,14,7,7,15,9,6,3,1,2,+3,+2,+1,76%,83%,67%,130,114,151,35%,26%,55%,5,3,2,2,1,1
287,https://vlr.gg/player/7381/redkoh,2025-01-04 08:00:00,0.76,0.85,0.80,183,177,192,12,7,5,17,10,7,3,1,2,+3,+1,+2,67%,67%,67%,123,117,132,32%,29%,35%,3,1,2,0,0,0
288,https://vlr.gg/player/8137/lenne,2025-01-04 08:00:00,0.52,0.64,0.57,82,60,112,6,2,4,13,7,6,4,3,1,-2,0,-2,57%,58%,56%,58,40,83,36%,50%,30%,0,0,0,2,0,2
289,https://vlr.gg/player/24654/tempz,2025-01-04 08:00:00,0.31,0.71,0.48,90,82,103,7,4,3,17,11,6,3,0,3,-2,-3,+1,52%,42%,67%,63,62,64,33%,38%,29%,1,0,1,3,3,0
290,https://vlr.gg/player/26969/adept,2025-01-04 07:00:00,1.23,1.50,1.34,219,190,262,18,10,8,11,7,4,4,3,1,0,-1,+1,90%,92%,88%,160,147,180,61%,52%,80%,2,1,1,2,2,0
291,https://vlr.gg/player/7448/toy,2025-01-04 07:00:00,1.17,1.29,1.22,261,259,264,18,11,7,15,9,6,8,3,5,+1,+1,0,85%,75%,100%,186,182,191,30%,33%,25%,2,2,0,1,1,0
292,https://vlr.gg/player/36707/bullet,2025-01-04 07:00:00,0.75,1.56,1.07,212,138,323,15,6,9,12,8,4,4,3,1,+4,0,+4,80%,83%,75%,132,104,174,12%,10%,15%,4,0,4,0,0,0
293,https://vlr.gg/player/36687/miz,2025-01-04 07:00:00,0.96,1.01,0.98,248,274,209,19,12,7,14,10,4,3,3,0,+4,+2,+2,70%,67%,75%,164,183,135,19%,15%,29%,5,3,2,1,1,0
294,https://vlr.gg/player/26965/haeart,2025-01-04 07:00:00,1.08,0.73,0.94,169,224,88,11,9,2,12,8,4,8,4,4,+3,+2,+1,80%,83%,75%,108,139,61,33%,36%,25%,3,2,1,0,0,0
295,https://vlr.gg/player/50154/hidy,2025-01-04 07:00:00,1.88,1.23,1.49,281,408,197,20,11,9,14,7,7,6,3,3,0,0,0,80%,88%,75%,200,291,140,36%,44%,27%,1,0,1,1,0,1
296,https://vlr.gg/player/7369/jeed,2025-01-04 07:00:00,0.24,1.51,1.00,184,71,261,11,0,11,15,7,8,12,5,7,-2,-1,-1,90%,75%,100%,124,65,164,29%,10%,36%,0,0,0,2,1,1
297,https://vlr.gg/player/24752/kooniiee,2025-01-04 07:00:00,0.86,0.82,0.84,199,146,235,14,4,10,16,6,10,3,0,3,-1,-1,0,60%,38%,75%,115,86,135,15%,7%,19%,1,0,1,2,1,1
298,https://vlr.gg/player/36693/fragile,2025-01-04 07:00:00,0.02,1.04,0.60,131,24,203,9,1,8,17,7,10,4,0,4,-7,-5,-2,55%,38%,67%,97,16,150,18%,0%,21%,1,0,1,8,5,3
299,https://vlr.gg/player/50153/jjsayeo,2025-01-04 07:00:00,1.22,0.16,0.58,155,208,120,10,6,4,19,6,13,9,7,2,-2,-1,-1,60%,75%,50%,92,120,73,38%,31%,50%,1,0,1,3,1,2
300,https://vlr.gg/player/8137/lenne,2025-01-04 06:00:00,1.30,1.37,1.33,286,287,286,24,10,14,17,9,8,8,4,4,+3,+1,+2,82%,80%,83%,162,170,156,17%,13%,21%,3,1,2,0,0,0
301,https://vlr.gg/player/24654/tempz,2025-01-04 06:00:00,1.14,0.85,0.98,215,242,194,16,9,7,19,9,10,10,2,8,0,-2,+2,59%,70%,50%,122,133,113,29%,39%,22%,3,0,3,3,2,1
302,https://vlr.gg/player/9158/hyk,2025-01-04 06:00:00,0.17,1.54,0.92,199,107,277,16,4,12,16,10,6,3,0,3,-5,-4,-1,64%,40%,83%,129,61,186,15%,25%,13%,2,1,1,7,5,2
303,https://vlr.gg/player/7381/redkoh,2025-01-04 06:00:00,0.04,1.55,0.86,179,59,280,13,1,12,16,10,6,11,3,8,-1,-1,0,68%,40%,92%,106,47,155,21%,8%,24%,1,0,1,2,1,1
304,https://vlr.gg/player/11737/xan,2025-01-04 06:00:00,0.65,1.03,0.86,163,187,143,11,5,6,17,10,7,13,3,10,+1,0,+1,91%,90%,92%,117,137,101,28%,36%,19%,1,0,1,0,0,0
305,https://vlr.gg/player/24752/kooniiee,2025-01-04 06:00:00,1.35,1.30,1.32,255,274,234,20,11,9,14,8,6,6,2,4,-1,-1,0,86%,83%,90%,170,185,152,24%,35%,14%,1,1,0,2,2,0
306,https://vlr.gg/player/7369/jeed,2025-01-04 06:00:00,0.64,1.87,1.20,230,161,314,19,7,12,16,11,5,7,2,5,0,-1,+1,82%,67%,100%,160,102,230,27%,16%,36%,1,0,1,1,1,0
307,https://vlr.gg/player/50154/hidy,2025-01-04 06:00:00,0.73,1.69,1.16,169,104,248,15,4,11,13,9,4,8,8,0,+2,-1,+3,77%,67%,90%,121,72,180,50%,40%,55%,3,0,3,1,1,0
308,https://vlr.gg/player/36693/fragile,2025-01-04 06:00:00,1.00,0.87,0.94,273,275,272,20,11,9,21,12,9,3,0,3,+4,+1,+3,59%,50%,70%,165,164,167,17%,17%,17%,6,2,4,2,1,1
309,https://vlr.gg/player/50153/jjsayeo,2025-01-04 06:00:00,0.24,1.09,0.62,144,114,181,11,4,7,16,11,5,6,3,3,-3,-2,-1,68%,58%,80%,118,80,163,14%,18%,10%,1,1,0,4,3,1
310,https://vlr.gg/player/7448/toy,2025-01-04 05:00:00,1.51,2.32,1.67,273,245,386,15,11,4,6,5,1,11,8,3,+3,+1,+2,93%,92%,100%,165,157,195,20%,23%,13%,3,1,2,0,0,0
311,https://vlr.gg/player/26969/adept,2025-01-04 05:00:00,1.50,1.32,1.47,268,286,197,15,12,3,7,6,1,2,2,0,+1,0,+1,80%,75%,100%,176,186,137,20%,20%,25%,3,2,1,2,2,0
312,https://vlr.gg/player/36707/bullet,2025-01-04 05:00:00,1.02,2.42,1.30,189,151,344,11,6,5,6,6,0,2,2,0,0,0,0,67%,58%,100%,123,118,141,25%,36%,14%,1,1,0,1,1,0
313,https://vlr.gg/player/36687/miz,2025-01-04 05:00:00,1.48,0.53,1.29,291,315,197,17,15,2,11,8,3,2,1,1,+1,+1,0,60%,67%,33%,178,189,136,41%,44%,29%,2,2,0,1,1,0
314,https://vlr.gg/player/26965/haeart,2025-01-04 05:00:00,0.91,1.03,0.94,143,151,115,8,7,1,8,7,1,6,4,2,0,0,0,67%,58%,100%,103,109,79,27%,31%,17%,1,1,0,1,1,0
315,https://vlr.gg/player/19126/kayle,2025-01-04 05:00:00,1.36,1.06,1.12,253,336,233,13,4,9,12,3,9,1,0,1,0,0,0,73%,100%,67%,158,161,157,27%,15%,32%,2,0,2,2,0,2
316,https://vlr.gg/player/36705/kestrel,2025-01-04 05:00:00,0.32,0.87,0.76,214,106,241,10,1,9,14,3,11,1,0,1,-1,0,-1,67%,67%,67%,145,98,156,33%,20%,36%,1,0,1,2,0,2
317,https://vlr.gg/player/7580/edw4rd,2025-01-04 05:00:00,0.04,0.71,0.57,151,77,171,7,0,7,14,3,11,5,2,3,0,-1,+1,53%,67%,50%,109,77,117,48%,50%,47%,2,0,2,2,1,1
318,https://vlr.gg/player/3473/benaf,2025-01-04 05:00:00,0.28,0.34,0.33,66,108,56,4,1,3,13,3,10,0,0,0,-2,-1,-1,40%,33%,42%,36,62,30,8%,0%,14%,0,0,0,2,1,1
319,https://vlr.gg/player/7447/firstlove,2025-01-04 05:00:00,0.03,0.40,0.31,82,,103,4,0,4,13,3,10,2,0,2,-2,-1,-1,53%,67%,50%,49,,62,10%,,10%,0,0,0,2,1,1
320,https://vlr.gg/player/17814/toggle,2025-01-03 10:15:00,1.39,1.84,1.63,301,273,327,25,11,14,15,8,7,4,1,3,+3,0,+3,83%,73%,92%,202,176,226,26%,24%,29%,5,2,3,2,2,0
321,https://vlr.gg/player/31189/kye,2025-01-03 10:15:00,1.13,1.59,1.37,207,192,222,19,8,11,12,6,6,10,6,4,-2,-1,-1,70%,73%,67%,137,114,159,65%,67%,63%,0,0,0,2,1,1
322,https://vlr.gg/player/9179/kael,2025-01-03 10:15:00,1.34,1.00,1.16,238,254,224,18,9,9,18,7,11,6,3,3,-2,-1,-1,78%,82%,75%,156,160,153,31%,28%,33%,0,0,0,2,1,1
323,https://vlr.gg/player/2377/aduka,2025-01-03 10:15:00,1.15,0.73,0.93,175,236,119,12,8,4,17,9,8,13,9,4,-3,0,-3,83%,91%,75%,110,144,78,18%,23%,11%,2,2,0,5,2,3
324,https://vlr.gg/player/7371/fishball,2025-01-03 10:15:00,0.56,0.70,0.63,115,84,144,7,2,5,17,7,10,12,6,6,-5,-1,-4,74%,73%,75%,85,66,103,19%,14%,22%,0,0,0,5,1,4
325,https://vlr.gg/player/36695/twelve,2025-01-03 10:15:00,0.99,1.38,1.18,260,206,319,21,8,13,16,8,8,9,4,5,+2,+1,+1,78%,67%,91%,178,159,200,40%,35%,44%,3,1,2,1,0,1
326,https://vlr.gg/player/42389/persona11,2025-01-03 10:15:00,1.28,0.86,1.08,236,279,190,20,13,7,16,8,8,2,0,2,+1,+2,-1,65%,67%,64%,141,145,138,27%,26%,28%,6,4,2,5,2,3
327,https://vlr.gg/player/2380/zesbeew,2025-01-03 10:15:00,1.09,1.04,1.06,254,283,223,22,13,9,17,9,8,1,0,1,+4,+3,+1,65%,67%,64%,161,177,144,20%,20%,19%,5,4,1,1,1,0
328,https://vlr.gg/player/36704/impecunity,2025-01-03 10:15:00,0.70,0.48,0.59,126,143,109,9,6,3,16,8,8,3,0,3,+2,0,+2,74%,83%,64%,87,101,72,22%,33%,12%,2,0,2,0,0,0
329,https://vlr.gg/player/16942/reverie,2025-01-03 10:15:00,0.27,0.92,0.58,99,68,134,6,1,5,16,10,6,17,14,3,0,0,0,61%,50%,73%,69,33,109,26%,14%,30%,0,0,0,0,0,0
330,https://vlr.gg/player/42387/akame,2025-01-03 09:20:00,0.78,2.57,1.50,300,159,513,22,7,15,12,8,4,6,4,2,+4,+2,+2,95%,92%,100%,192,112,312,19%,29%,16%,5,3,2,1,1,0
331,https://vlr.gg/player/36692/azami,2025-01-03 09:20:00,1.46,1.40,1.44,263,270,256,18,11,7,12,6,6,17,10,7,+2,+3,-1,80%,92%,63%,160,159,161,42%,45%,38%,4,3,1,2,0,2
332,https://vlr.gg/player/27053/ender,2025-01-03 09:20:00,1.48,0.78,1.20,208,263,126,17,13,4,11,6,5,9,2,7,+1,+2,-1,75%,83%,63%,137,187,62,33%,34%,29%,2,2,0,1,0,1
333,https://vlr.gg/player/40333/ventura,2025-01-03 09:20:00,0.91,1.30,1.06,165,170,159,12,7,5,10,7,3,1,0,1,-1,0,-1,70%,67%,75%,115,125,101,26%,33%,15%,1,1,0,2,1,1
334,https://vlr.gg/player/40499/fivm,2025-01-03 09:20:00,1.05,0.60,0.87,158,182,125,10,7,3,13,7,6,6,4,2,0,+1,-1,85%,92%,75%,116,125,104,28%,22%,38%,1,1,0,1,0,1
335,https://vlr.gg/player/27073/esmonde,2025-01-03 09:20:00,1.18,0.98,1.06,206,233,190,14,7,7,16,6,10,4,1,3,+2,+1,+1,65%,75%,58%,138,158,124,28%,38%,20%,2,1,1,0,0,0
336,https://vlr.gg/player/48377/jay,2025-01-03 09:20:00,0.94,0.93,0.93,229,226,232,15,6,9,17,7,10,3,3,0,0,+1,-1,65%,88%,50%,151,144,156,41%,36%,45%,2,1,1,2,0,2
337,https://vlr.gg/player/7417/joshh,2025-01-03 09:20:00,0.55,1.16,0.91,188,146,216,13,4,9,15,7,8,2,1,1,-1,0,-1,80%,75%,83%,128,96,149,36%,38%,36%,1,1,0,2,1,1
338,https://vlr.gg/player/3735/maxxyy,2025-01-03 09:20:00,0.34,0.73,0.58,97,89,103,6,2,4,13,6,7,7,3,4,-3,-1,-2,60%,63%,58%,67,66,68,9%,9%,9%,0,0,0,3,1,2
339,https://vlr.gg/player/21195/teddy,2025-01-03 09:20:00,0.52,0.56,0.55,161,189,144,10,5,5,18,8,10,2,1,1,-4,+1,-5,65%,63%,67%,97,114,86,18%,31%,10%,2,2,0,6,1,5
340,https://vlr.gg/player/16942/reverie,2025-01-03 08:20:00,1.82,1.76,1.79,362,309,444,24,14,10,12,5,7,11,3,8,+3,+1,+2,90%,83%,100%,240,202,297,31%,50%,19%,3,1,2,0,0,0
341,https://vlr.gg/player/2380/zesbeew,2025-01-03 08:20:00,1.18,1.16,1.18,185,211,147,13,9,4,11,7,4,10,5,5,+1,+1,0,75%,67%,88%,124,130,115,35%,37%,33%,2,2,0,1,1,0
342,https://vlr.gg/player/36695/twelve,2025-01-03 08:20:00,1.17,0.99,1.10,205,230,170,15,9,6,13,7,6,11,7,4,+1,0,+1,85%,83%,88%,127,146,99,26%,27%,25%,1,0,1,0,0,0
343,https://vlr.gg/player/42389/persona11,2025-01-03 08:20:00,1.08,1.09,1.08,236,233,241,17,9,8,13,8,5,4,3,1,0,+1,-1,85%,83%,88%,164,167,160,27%,28%,25%,5,4,1,5,3,2
344,https://vlr.gg/player/36704/impecunity,2025-01-03 08:20:00,0.60,1.46,0.94,149,96,231,12,5,7,10,6,4,4,2,2,0,-1,+1,80%,75%,88%,102,80,134,30%,18%,46%,1,0,1,1,1,0
345,https://vlr.gg/player/27073/esmonde,2025-01-03 08:20:00,1.65,0.72,1.09,236,381,140,17,11,6,18,7,11,5,1,4,-2,0,-2,75%,88%,67%,156,237,103,25%,24%,26%,0,0,0,2,0,2
346,https://vlr.gg/player/3735/maxxyy,2025-01-03 08:20:00,0.82,1.06,0.96,221,210,230,14,6,8,16,7,9,6,4,2,+2,+1,+1,70%,63%,75%,171,169,172,29%,36%,26%,2,1,1,0,0,0
347,https://vlr.gg/player/7417/joshh,2025-01-03 08:20:00,0.49,1.11,0.87,165,122,194,12,4,8,15,7,8,2,1,1,-2,-1,-1,60%,63%,58%,117,101,128,46%,71%,37%,0,0,0,2,1,1
348,https://vlr.gg/player/48377/jay,2025-01-03 08:20:00,0.32,0.82,0.62,145,130,156,10,4,6,16,8,8,3,0,3,-2,-2,0,75%,75%,75%,102,92,109,31%,27%,33%,5,2,3,7,4,3
349,https://vlr.gg/player/7532/wisa,2025-01-03 08:20:00,0.40,0.38,0.39,88,87,90,6,2,4,17,6,11,5,2,3,-1,0,-1,65%,75%,58%,54,61,49,6%,13%,3%,1,0,1,2,0,2
350,https://vlr.gg/player/27053/ender,2025-01-03 07:10:00,0.98,1.59,1.29,219,204,235,23,11,12,18,12,6,14,3,11,-2,-3,+1,67%,53%,80%,145,133,157,31%,30%,31%,2,0,2,4,3,1
351,https://vlr.gg/player/42387/akame,2025-01-03 07:10:00,0.87,1.58,1.23,254,192,317,26,9,17,21,13,8,2,1,1,+6,+2,+4,57%,40%,73%,165,130,201,25%,32%,22%,7,2,5,1,0,1
352,https://vlr.gg/player/36692/azami,2025-01-03 07:10:00,0.58,1.59,1.09,214,123,305,24,6,18,21,12,9,8,5,3,-5,-5,0,63%,53%,73%,147,95,199,23%,19%,24%,1,0,1,6,5,1
353,https://vlr.gg/player/40499/fivm,2025-01-03 07:10:00,0.60,1.28,0.94,180,143,217,17,7,10,22,14,8,7,2,5,-3,-2,-1,67%,60%,73%,125,83,167,24%,15%,31%,2,1,1,5,3,2
354,https://vlr.gg/player/40333/ventura,2025-01-03 07:10:00,0.71,0.81,0.76,133,167,100,13,8,5,21,12,9,7,1,6,-2,-1,-1,67%,53%,80%,98,115,81,32%,38%,24%,0,0,0,2,1,1
355,https://vlr.gg/player/2377/aduka,2025-01-03 07:10:00,0.66,1.53,1.09,236,140,332,24,7,17,22,12,10,18,8,10,+1,-2,+3,63%,47%,80%,141,80,203,22%,39%,19%,6,2,4,5,4,1
356,https://vlr.gg/player/17814/toggle,2025-01-03 07:10:00,0.57,1.47,1.02,207,156,258,23,8,15,20,13,7,2,2,0,+5,+1,+4,60%,47%,73%,130,89,171,21%,27%,15%,7,3,4,2,2,0
357,https://vlr.gg/player/9179/kael,2025-01-03 07:10:00,0.64,1.29,0.97,219,162,276,22,8,14,21,13,8,6,2,4,+1,0,+1,73%,60%,87%,158,116,200,28%,33%,26%,3,1,2,2,1,1
358,https://vlr.gg/player/7371/fishball,2025-01-03 07:10:00,0.86,1.02,0.94,171,195,149,17,9,8,19,11,8,16,7,9,-1,-1,0,80%,73%,87%,109,122,95,20%,17%,25%,0,0,0,1,1,0
359,https://vlr.gg/player/31189/kye,2025-01-03 07:10:00,0.60,0.99,0.79,156,152,162,17,8,9,21,13,8,3,1,2,0,-1,+1,77%,73%,80%,107,106,108,32%,41%,25%,2,0,2,2,1,1
360,https://vlr.gg/player/3735/maxxyy,2025-01-03 06:00:00,1.64,1.03,1.32,302,352,257,24,14,10,18,9,9,1,1,0,+2,+1,+1,83%,100%,67%,201,245,160,29%,41%,15%,2,1,1,0,0,0
361,https://vlr.gg/player/27073/esmonde,2025-01-03 06:00:00,1.41,1.08,1.24,192,236,153,16,9,7,13,6,7,10,5,5,-1,-1,0,70%,73%,67%,125,164,90,28%,38%,19%,2,1,1,3,2,1
362,https://vlr.gg/player/48377/jay,2025-01-03 06:00:00,0.61,0.91,0.76,194,196,193,16,8,8,19,10,9,1,0,1,+3,0,+3,74%,73%,75%,127,122,132,50%,53%,47%,5,1,4,2,1,1
363,https://vlr.gg/player/7417/joshh,2025-01-03 06:00:00,0.22,1.17,0.72,190,107,268,15,4,11,19,10,9,3,0,3,-3,-3,0,52%,27%,75%,130,77,179,48%,36%,55%,2,0,2,5,3,2
364,https://vlr.gg/player/7532/wisa,2025-01-03 06:00:00,0.49,0.39,0.44,98,113,86,7,4,3,19,9,10,15,8,7,-2,-2,0,52%,55%,50%,68,81,57,30%,44%,18%,0,0,0,2,2,0
365,https://vlr.gg/player/17814/toggle,2025-01-03 06:00:00,1.30,1.61,1.44,294,296,291,23,12,11,15,8,7,4,1,3,+4,+1,+3,87%,75%,100%,183,173,193,30%,31%,29%,7,3,4,3,2,1
366,https://vlr.gg/player/2377/aduka,2025-01-03 06:00:00,1.57,0.76,1.18,242,279,203,18,11,7,16,7,9,9,7,2,+1,-1,+2,70%,67%,73%,161,186,134,15%,15%,14%,4,1,3,3,2,1
367,https://vlr.gg/player/31189/kye,2025-01-03 06:00:00,1.22,1.11,1.17,202,188,218,19,10,9,16,7,9,10,7,3,0,0,0,70%,67%,73%,147,146,149,42%,44%,40%,0,0,0,0,0,0
368,https://vlr.gg/player/7371/fishball,2025-01-03 06:00:00,0.82,1.44,1.12,163,132,198,14,5,9,15,9,6,19,11,8,-2,-3,+1,83%,83%,82%,105,92,120,30%,25%,35%,1,0,1,3,3,0
369,https://vlr.gg/player/9179/kael,2025-01-03 06:00:00,0.80,0.94,0.87,181,155,211,14,6,8,16,8,8,6,3,3,-2,-1,-1,65%,67%,64%,135,108,166,27%,27%,26%,0,0,0,2,1,1
370,https://vlr.gg/player/40499/fivm,2025-01-03 05:00:00,1.54,1.84,1.68,355,324,392,28,15,13,14,8,6,8,3,5,-1,0,-1,86%,83%,90%,213,190,241,33%,29%,38%,3,2,1,4,2,2
371,https://vlr.gg/player/42387/akame,2025-01-03 05:00:00,1.46,0.72,1.12,237,317,142,20,14,6,17,9,8,4,4,0,-2,0,-2,73%,67%,80%,156,210,92,26%,21%,35%,2,2,0,4,2,2
372,https://vlr.gg/player/40333/ventura,2025-01-03 05:00:00,0.93,1.01,0.96,182,188,177,14,8,6,16,9,7,6,3,3,+3,+2,+1,73%,83%,60%,119,117,121,28%,20%,40%,4,2,2,1,0,1
373,https://vlr.gg/player/24646/seafone,2025-01-03 05:00:00,1.28,0.54,0.95,186,231,133,12,8,4,16,8,8,11,10,1,-1,+1,-2,82%,92%,70%,135,176,86,24%,21%,33%,1,1,0,2,0,2
374,https://vlr.gg/player/27053/ender,2025-01-03 05:00:00,0.78,1.10,0.93,141,91,202,11,4,7,13,7,6,11,8,3,-1,-1,0,73%,75%,70%,107,69,152,45%,67%,38%,0,0,0,1,1,0
375,https://vlr.gg/player/42389/persona11,2025-01-03 05:00:00,1.20,1.11,1.15,236,251,225,19,9,10,16,7,9,3,1,2,+1,+2,-1,77%,70%,83%,145,157,135,28%,42%,12%,4,3,1,3,1,2
376,https://vlr.gg/player/16942/reverie,2025-01-03 05:00:00,0.94,1.30,1.14,228,181,267,19,7,12,16,7,9,7,4,3,0,0,0,82%,90%,75%,152,129,171,61%,50%,69%,2,0,2,2,0,2
377,https://vlr.gg/player/2380/zesbeew,2025-01-03 05:00:00,1.17,0.68,0.90,235,264,211,17,9,8,19,7,12,10,3,7,-1,+1,-2,86%,80%,92%,160,177,146,22%,25%,19%,2,1,1,3,0,3
378,https://vlr.gg/player/36695/twelve,2025-01-03 05:00:00,0.77,0.69,0.72,159,201,126,13,7,6,17,8,9,6,0,6,+1,+1,0,59%,70%,50%,96,126,70,32%,32%,33%,2,2,0,1,1,0
379,https://vlr.gg/player/36704/impecunity,2025-01-03 05:00:00,0.48,0.65,0.57,114,92,133,8,3,5,17,7,10,5,2,3,+1,0,+1,68%,80%,58%,81,49,108,23%,9%,32%,2,1,1,1,1,0
380,https://vlr.gg/player/49953/nastiness,2024-12-30 05:00:00,0.76,1.37,1.08,248,197,287,88,30,58,78,38,40,14,7,7,+1,-6,+7,67%,54%,77%,158,133,179,31%,37%,28%,17,5,12,16,11,5
381,https://vlr.gg/player/49951/owen,2024-12-30 05:00:00,0.88,1.05,0.98,177,165,187,65,27,38,71,32,39,46,26,20,0,-1,+1,75%,74%,77%,119,101,134,32%,37%,30%,4,1,3,4,2,2
382,https://vlr.gg/player/34183/rab1q,2024-12-30 05:00:00,0.88,0.96,0.92,198,178,215,67,28,39,80,34,46,43,19,24,-15,-7,-8,71%,67%,73%,134,112,152,25%,26%,25%,7,3,4,22,10,12
383,https://vlr.gg/player/40502/au1oek,2024-12-30 05:00:00,0.99,0.87,0.92,181,185,175,65,29,36,74,33,41,31,17,14,-3,0,-3,69%,63%,73%,126,126,126,33%,34%,33%,5,2,3,8,2,6
384,https://vlr.gg/player/50025/setrod,2024-12-30 05:00:00,0.97,0.86,0.91,190,205,176,70,34,36,76,35,41,21,10,11,+1,+2,-1,62%,59%,64%,125,135,116,36%,30%,41%,10,6,4,9,4,5
385,https://vlr.gg/player/17225/zhen,2024-12-30 05:00:00,1.03,1.49,1.24,270,256,286,99,51,48,73,44,29,12,3,9,+6,-1,+7,72%,63%,83%,168,156,183,28%,26%,31%,27,15,12,21,16,5
386,https://vlr.gg/player/11842/miluan,2024-12-30 05:00:00,1.04,1.14,1.08,203,208,198,71,40,31,66,39,27,42,22,20,+5,+4,+1,79%,84%,74%,136,139,132,28%,33%,23%,6,4,2,1,0,1
387,https://vlr.gg/player/49974/murphy,2024-12-30 05:00:00,1.19,0.91,1.06,228,256,195,81,50,31,74,40,34,26,17,9,+6,+2,+4,75%,82%,65%,148,170,122,26%,31%,19%,12,4,8,6,2,4
388,https://vlr.gg/player/17214/moon,2024-12-30 05:00:00,1.04,0.91,0.98,175,194,156,68,42,26,66,38,28,23,9,14,-1,+1,-2,73%,66%,80%,113,124,100,30%,30%,30%,5,3,2,6,2,4
389,https://vlr.gg/player/12940/ankara,2024-12-30 05:00:00,0.54,1.22,0.85,168,125,222,60,24,36,76,46,30,42,20,22,0,-2,+2,74%,70%,78%,110,84,143,34%,37%,32%,9,4,5,9,6,3
390,https://vlr.gg/player/17214/moon,2024-12-29 07:10:00,1.23,1.29,1.25,203,186,219,41,23,18,30,16,14,12,7,5,+1,+2,-1,76%,75%,77%,131,123,143,36%,40%,32%,3,3,0,2,1,1
391,https://vlr.gg/player/49974/murphy,2024-12-29 07:10:00,1.50,0.85,1.24,258,298,199,50,36,14,38,19,19,13,7,6,-3,-2,-1,69%,69%,68%,175,196,143,44%,48%,37%,5,3,2,8,5,3
392,https://vlr.gg/player/11842/miluan,2024-12-29 07:10:00,1.17,0.96,1.08,180,199,148,35,24,11,30,16,14,24,13,11,-3,-3,0,76%,75%,77%,121,137,98,41%,38%,48%,1,0,1,4,3,1
393,https://vlr.gg/player/12940/ankara,2024-12-29 07:10:00,1.11,0.80,0.98,176,194,158,33,22,11,39,21,18,26,15,11,+1,+3,-2,74%,81%,64%,112,117,104,20%,21%,18%,6,6,0,5,3,2
394,https://vlr.gg/player/17225/zhen,2024-12-29 07:10:00,0.99,0.86,0.94,216,223,209,42,26,16,42,24,18,9,5,4,+10,+8,+2,69%,72%,64%,145,152,134,28%,26%,30%,15,8,7,5,0,5
395,https://vlr.gg/player/37673/yanli,2024-12-29 07:10:00,1.43,0.68,0.99,179,218,158,35,19,16,38,11,27,15,6,9,+3,+1,+2,69%,86%,56%,116,138,100,28%,29%,27%,4,2,2,1,1,0
396,https://vlr.gg/player/1906/ra1ny,2024-12-29 07:10:00,1.01,0.84,0.91,177,186,183,35,15,20,40,15,25,15,7,8,0,0,0,72%,86%,63%,113,110,115,26%,32%,22%,4,1,3,4,1,3
397,https://vlr.gg/player/14928/chiawei,2024-12-29 07:10:00,0.68,1.03,0.89,191,112,244,39,10,29,41,14,27,11,6,5,-2,0,-2,67%,64%,69%,119,76,150,27%,21%,30%,2,1,1,4,1,3
398,https://vlr.gg/player/10870/secret,2024-12-29 07:10:00,1.10,0.70,0.86,215,290,155,40,23,17,44,17,27,6,5,1,-4,+1,-5,61%,73%,53%,134,179,103,27%,25%,30%,12,8,4,16,7,9
399,https://vlr.gg/player/34160/fyrr73,2024-12-29 07:10:00,1.09,0.62,0.81,157,202,136,29,15,14,38,13,25,20,10,10,-3,0,-3,63%,77%,53%,115,145,95,17%,20%,15%,2,0,2,5,0,5
400,https://vlr.gg/player/1906/ra1ny,2024-12-29 05:00:00,1.59,1.15,1.39,253,249,255,39,23,16,25,10,15,11,6,5,+4,+1,+3,91%,96%,85%,163,158,168,29%,31%,28%,4,1,3,0,0,0
401,https://vlr.gg/player/37673/yanli,2024-12-29 05:00:00,0.96,1.20,1.07,226,203,251,34,15,19,31,17,14,15,9,6,+1,-1,+2,72%,65%,80%,160,148,174,34%,40%,28%,2,0,2,1,1,0
402,https://vlr.gg/player/14928/chiawei,2024-12-29 05:00:00,1.03,1.09,1.06,169,164,177,27,15,12,24,14,10,16,11,5,+5,+4,+1,81%,87%,75%,110,104,118,31%,28%,33%,6,4,2,1,0,1
403,https://vlr.gg/player/10870/secret,2024-12-29 05:00:00,1.15,0.94,1.05,257,283,226,40,24,16,31,16,15,6,3,3,+5,+3,+2,77%,78%,75%,158,177,136,27%,33%,19%,16,9,7,11,6,5
404,https://vlr.gg/player/34160/fyrr73,2024-12-29 05:00:00,1.18,0.81,1.01,180,205,153,27,17,10,25,12,13,16,11,5,0,0,0,65%,61%,70%,124,147,98,25%,20%,32%,1,1,0,1,1,0
405,https://vlr.gg/player/50017/xma,2024-12-29 05:00:00,1.48,0.82,1.12,232,266,199,34,20,14,33,13,20,6,4,2,+2,0,+2,65%,65%,65%,151,164,141,21%,22%,20%,5,1,4,3,1,2
406,https://vlr.gg/player/42976/huawei1016,2024-12-29 05:00:00,0.87,1.03,0.96,184,176,194,30,14,16,31,14,17,16,7,9,-1,-1,0,72%,75%,70%,111,106,114,43%,34%,54%,2,1,1,3,2,1
407,https://vlr.gg/player/10485/anc1ent,2024-12-29 05:00:00,0.99,0.87,0.93,177,188,171,26,11,15,31,13,18,11,9,2,-4,-1,-3,74%,90%,61%,123,131,116,21%,20%,23%,2,1,1,6,2,4
408,https://vlr.gg/player/34202/t1ankong,2024-12-29 05:00:00,1.02,0.69,0.84,177,194,163,25,13,12,35,15,20,21,10,11,-3,-1,-2,67%,75%,61%,112,120,105,29%,26%,32%,1,1,0,4,2,2
409,https://vlr.gg/player/42907/only,2024-12-29 05:00:00,0.26,0.75,0.52,143,120,163,21,9,12,38,18,20,8,3,5,-9,-5,-4,49%,50%,48%,96,73,116,32%,23%,39%,4,2,2,13,7,6
410,https://vlr.gg/player/46462/shu,2024-12-28 05:00:00,1.31,1.42,1.36,259,239,304,61,31,30,48,27,21,26,16,10,+5,+4,+1,78%,78%,79%,164,150,183,33%,33%,33%,8,4,4,3,0,3
411,https://vlr.gg/player/42505/toast,2024-12-28 05:00:00,0.92,1.04,0.97,167,152,197,40,21,19,46,27,19,20,8,12,+3,+2,+1,74%,73%,75%,117,101,139,34%,35%,33%,7,4,3,4,2,2
412,https://vlr.gg/player/49612/croudy,2024-12-28 05:00:00,0.92,0.93,0.93,180,179,191,42,24,18,51,30,21,23,14,9,0,-1,+1,65%,70%,57%,116,111,124,32%,32%,33%,4,2,2,4,3,1
413,https://vlr.gg/player/42921/xuzee,2024-12-28 05:00:00,1.01,0.74,0.88,220,261,169,44,29,15,55,34,21,21,14,7,-2,0,-2,65%,65%,64%,158,182,127,26%,29%,22%,12,9,3,14,9,5
414,https://vlr.gg/player/46327/ethan,2024-12-28 05:00:00,0.74,0.90,0.81,146,129,188,35,17,18,48,27,21,18,10,8,+1,0,+1,71%,68%,75%,116,91,148,34%,28%,39%,5,2,3,4,2,2
415,https://vlr.gg/player/40502/au1oek,2024-12-28 05:00:00,1.15,1.16,1.15,215,190,234,53,20,33,41,17,24,27,11,16,0,+1,-1,85%,82%,86%,140,119,156,32%,47%,25%,2,1,1,2,0,2
416,https://vlr.gg/player/50025/setrod,2024-12-28 05:00:00,1.26,0.99,1.10,261,272,235,59,27,32,48,21,27,15,4,11,+1,+2,-1,66%,61%,70%,176,185,169,28%,30%,26%,7,3,4,6,1,5
417,https://vlr.gg/player/49951/owen,2024-12-28 05:00:00,1.11,1.06,1.08,190,180,199,48,18,30,42,17,25,21,13,8,0,+1,-1,85%,82%,86%,129,123,134,29%,27%,31%,2,1,1,2,0,2
418,https://vlr.gg/player/49953/nastiness,2024-12-28 05:00:00,1.00,0.94,0.97,193,237,168,46,24,22,45,23,22,11,3,8,-3,0,-3,72%,75%,70%,123,140,111,36%,48%,28%,12,7,5,15,7,8
419,https://vlr.gg/player/34183/rab1q,2024-12-28 05:00:00,0.61,1.21,0.95,212,143,254,42,14,28,46,22,24,22,6,16,-5,-6,+1,68%,61%,73%,145,103,177,17%,17%,17%,6,1,5,11,7,4
420,https://vlr.gg/player/27775/techno,2024-12-27 06:15:00,1.27,1.06,1.16,255,250,247,92,45,47,75,36,39,38,18,20,+1,-4,+5,81%,78%,83%,156,163,148,35%,43%,29%,18,7,11,17,11,6
421,https://vlr.gg/player/3627/hellff,2024-12-27 06:15:00,0.91,1.31,1.12,208,178,230,77,33,44,71,37,34,43,13,30,-1,-1,0,72%,66%,78%,141,110,170,28%,22%,33%,6,3,3,7,4,3
422,https://vlr.gg/player/26376/deecee,2024-12-27 06:15:00,1.15,0.97,1.06,185,220,178,75,42,33,66,34,32,26,9,17,+10,+4,+6,71%,64%,78%,134,138,131,24%,23%,26%,11,5,6,1,1,0
423,https://vlr.gg/player/3639/hoax,2024-12-27 06:15:00,0.70,1.30,1.01,191,139,233,66,22,44,65,36,29,39,14,25,+4,0,+4,73%,66%,80%,130,106,153,25%,28%,24%,8,2,6,4,2,2
424,https://vlr.gg/player/30693/makaveli,2024-12-27 06:15:00,0.63,1.10,0.87,194,160,224,71,25,46,75,41,34,18,10,8,+4,-1,+5,68%,60%,76%,124,110,138,22%,23%,21%,18,7,11,14,8,6
425,https://vlr.gg/player/13221/azys,2024-12-27 06:15:00,1.05,1.44,1.24,249,228,300,100,46,54,77,44,33,11,3,8,+2,-6,+8,65%,57%,74%,161,142,181,25%,28%,23%,18,5,13,16,11,5
426,https://vlr.gg/player/3628/deathmaker,2024-12-27 06:15:00,0.75,1.21,0.97,213,178,258,78,33,45,77,45,32,22,12,10,-3,-6,+3,65%,63%,68%,136,107,166,26%,20%,32%,9,3,6,12,9,3
427,https://vlr.gg/player/12947/rawfiul,2024-12-27 06:15:00,0.75,1.06,0.90,197,174,211,65,30,35,78,45,33,27,12,15,0,0,0,75%,69%,82%,125,111,139,35%,34%,36%,6,3,3,6,3,3
428,https://vlr.gg/player/18704/levi,2024-12-27 06:15:00,0.99,0.81,0.90,162,175,156,59,32,27,75,39,36,46,24,22,-9,-4,-5,66%,63%,70%,113,119,106,28%,31%,25%,5,2,3,14,6,8
429,https://vlr.gg/player/3269/antidote,2024-12-27 06:15:00,0.70,0.80,0.75,143,154,133,50,27,23,74,41,33,34,14,20,-8,-4,-4,67%,65%,70%,97,100,94,24%,20%,29%,5,4,1,13,8,5
430,https://vlr.gg/player/21584/deminatix,2024-12-27 06:00:00,0.73,1.27,0.96,231,200,288,32,15,17,33,19,14,9,4,5,+6,-1,+7,67%,50%,88%,142,119,172,33%,30%,37%,14,6,8,8,7,1
431,https://vlr.gg/player/12226/sturnn,2024-12-27 06:00:00,0.87,1.04,0.95,190,175,216,25,12,13,30,17,13,6,5,1,0,+2,-2,64%,64%,65%,124,112,139,34%,29%,39%,2,2,0,2,0,2
432,https://vlr.gg/player/10114/baha,2024-12-27 06:00:00,1.00,0.68,0.86,202,219,163,27,16,11,33,19,14,12,9,3,-4,-3,-1,62%,59%,65%,125,134,113,40%,50%,30%,3,2,1,7,5,2
433,https://vlr.gg/player/11516/drky,2024-12-27 06:00:00,0.65,0.73,0.68,142,139,159,20,11,9,29,18,11,5,3,2,0,0,0,54%,50%,59%,93,85,104,23%,24%,22%,0,0,0,0,0,0
434,https://vlr.gg/player/16483/gloomy,2024-12-27 06:00:00,0.74,0.57,0.67,149,154,140,17,11,6,32,17,15,10,6,4,-1,0,-1,62%,50%,76%,112,113,111,20%,16%,26%,1,0,1,2,0,2
435,https://vlr.gg/player/24344/loita,2024-12-27 06:00:00,1.26,1.62,1.46,261,282,256,40,19,21,24,13,11,17,3,14,-2,-1,-1,77%,76%,77%,176,176,177,38%,45%,33%,3,2,1,5,3,2
436,https://vlr.gg/player/40591/comeback,2024-12-27 06:00:00,1.17,1.48,1.35,289,244,313,42,16,26,25,12,13,3,1,2,+3,0,+3,79%,82%,77%,171,161,178,21%,24%,19%,7,2,5,4,2,2
437,https://vlr.gg/player/31305/lar0k,2024-12-27 06:00:00,1.06,1.33,1.21,194,197,195,25,11,14,20,10,10,16,3,13,0,-1,+1,77%,65%,86%,128,141,119,29%,31%,27%,3,1,2,3,2,1
438,https://vlr.gg/player/12795/crewen,2024-12-27 06:00:00,0.97,0.96,0.97,201,169,211,27,10,17,24,10,14,5,3,2,-1,0,-1,72%,82%,64%,133,126,140,35%,26%,42%,2,1,1,3,1,2
439,https://vlr.gg/player/5565/ros,2024-12-27 06:00:00,1.00,0.62,0.79,182,184,174,23,11,12,28,11,17,10,5,5,-1,-1,0,74%,76%,73%,114,120,109,18%,13%,24%,4,1,3,5,2,3
440,https://vlr.gg/player/49960/bosheng,2024-12-27 05:00:00,1.26,1.26,1.26,231,236,231,40,18,22,31,13,18,16,8,8,+1,-2,+3,77%,95%,64%,140,167,118,37%,41%,34%,3,0,3,2,2,0
441,https://vlr.gg/player/2829/ytao,2024-12-27 05:00:00,1.28,1.16,1.21,264,245,272,37,15,22,32,12,20,20,12,8,0,-2,+2,77%,84%,72%,175,177,174,21%,22%,20%,6,2,4,6,4,2
442,https://vlr.gg/player/2373/maou,2024-12-27 05:00:00,1.29,0.92,1.08,200,242,174,33,16,17,33,13,20,12,7,5,-4,-1,-3,73%,74%,72%,133,176,101,22%,32%,12%,2,1,1,6,2,4
443,https://vlr.gg/player/7860/0n1y,2024-12-27 05:00:00,0.78,0.62,0.69,139,136,142,20,10,10,31,12,19,8,3,5,-3,-1,-2,68%,79%,60%,94,85,101,25%,21%,28%,0,0,0,3,1,2
444,https://vlr.gg/player/49959/1111111-fu,2024-12-27 05:00:00,0.64,0.30,0.45,134,183,94,18,12,6,38,17,21,9,4,5,-8,-1,-7,68%,74%,64%,92,120,70,24%,27%,20%,4,3,1,12,4,8
445,https://vlr.gg/player/49974/murphy,2024-12-27 05:00:00,1.15,1.27,1.20,283,271,297,46,26,20,35,19,16,10,4,6,+4,+2,+2,82%,80%,84%,174,155,199,29%,32%,27%,7,3,4,3,1,2
446,https://vlr.gg/player/11842/miluan,2024-12-27 05:00:00,1.24,1.06,1.16,211,192,238,32,17,15,30,13,17,20,13,7,+2,0,+2,77%,80%,74%,140,132,150,32%,39%,26%,3,1,2,1,1,0
447,https://vlr.gg/player/17225/zhen,2024-12-27 05:00:00,1.44,0.70,1.12,255,328,132,36,28,8,30,17,13,9,8,1,+5,+1,+4,68%,80%,53%,154,206,85,26%,27%,23%,11,6,5,6,5,1
448,https://vlr.gg/player/17214/moon,2024-12-27 05:00:00,0.96,1.08,1.01,168,135,201,26,12,14,26,13,13,13,7,6,0,+1,-1,82%,84%,79%,109,82,145,31%,32%,30%,2,1,1,2,0,2
449,https://vlr.gg/player/12940/ankara,2024-12-27 05:00:00,0.90,1.02,0.96,156,165,155,25,15,10,27,15,12,23,10,13,+3,+3,0,77%,84%,68%,107,105,110,24%,38%,12%,6,5,1,3,2,1
450,https://vlr.gg/player/44128/xiaofeng,2024-12-26 06:45:00,1.48,1.66,1.56,335,334,329,44,24,20,28,19,9,1,0,1,+6,+4,+2,75%,75%,75%,209,201,220,31%,40%,20%,10,5,5,4,1,3
451,https://vlr.gg/player/42998/lock1ng,2024-12-26 06:45:00,0.28,1.93,1.01,216,85,398,27,5,22,28,18,10,7,2,5,0,-2,+2,50%,30%,75%,140,61,240,31%,32%,31%,4,1,3,4,3,1
452,https://vlr.gg/player/42979/zhannn,2024-12-26 06:45:00,0.54,1.06,0.77,164,147,197,20,8,12,29,19,10,10,7,3,-2,-2,0,58%,60%,56%,109,107,113,25%,24%,26%,1,0,1,3,2,1
453,https://vlr.gg/player/34178/queya,2024-12-26 06:45:00,0.60,0.17,0.41,118,141,77,11,9,2,31,17,14,12,6,6,-1,-1,0,64%,75%,50%,72,85,55,25%,32%,17%,1,1,0,2,2,0
454,https://vlr.gg/player/34184/yzka1,2024-12-26 06:45:00,0.28,0.41,0.31,96,91,108,11,6,5,32,19,13,6,2,4,-5,-5,0,44%,35%,56%,74,61,90,30%,36%,24%,1,0,1,6,5,1
455,https://vlr.gg/player/49953/nastiness,2024-12-26 06:45:00,1.13,2.26,1.76,347,208,449,44,13,31,21,10,11,9,0,9,+4,-2,+6,78%,50%,100%,221,139,287,20%,42%,13%,7,1,6,3,3,0
456,https://vlr.gg/player/34183/rab1q,2024-12-26 06:45:00,1.22,1.56,1.41,246,255,237,33,13,20,21,13,8,7,5,2,+3,0,+3,75%,75%,75%,160,177,145,23%,21%,25%,4,1,3,1,1,0
457,https://vlr.gg/player/49951/owen,2024-12-26 06:45:00,1.26,0.94,1.08,237,293,196,31,17,14,26,14,12,12,5,7,-1,+1,-2,75%,75%,75%,153,195,120,42%,47%,38%,2,2,0,3,1,2
458,https://vlr.gg/player/50025/setrod,2024-12-26 06:45:00,0.72,1.10,0.93,177,161,195,23,9,14,23,12,11,4,0,4,+1,-2,+3,69%,56%,80%,109,92,123,18%,10%,23%,6,2,4,5,4,1
459,https://vlr.gg/player/40502/au1oek,2024-12-26 06:45:00,0.46,0.89,0.70,136,91,170,17,4,13,23,12,11,20,9,11,-5,-1,-4,78%,69%,85%,97,63,124,32%,44%,27%,0,0,0,5,1,4
460,https://vlr.gg/player/42921/xuzee,2024-12-26 05:00:00,1.59,1.96,1.70,387,361,455,49,32,17,19,13,6,10,8,2,+4,+3,+1,85%,88%,80%,241,227,274,21%,19%,26%,8,6,2,4,3,1
461,https://vlr.gg/player/42505/toast,2024-12-26 05:00:00,1.52,1.29,1.46,221,230,193,27,21,6,12,8,4,12,7,5,+4,+3,+1,91%,96%,80%,152,161,132,40%,46%,25%,6,5,1,2,2,0
462,https://vlr.gg/player/46462/shu,2024-12-26 05:00:00,1.23,1.99,1.45,223,185,312,28,16,12,16,13,3,25,14,11,+2,+1,+1,85%,83%,90%,151,127,209,36%,27%,57%,3,2,1,1,1,0
463,https://vlr.gg/player/46327/ethan,2024-12-26 05:00:00,1.30,1.22,1.27,214,235,173,26,20,6,16,12,4,13,7,6,+3,+2,+1,85%,83%,90%,150,164,116,26%,29%,21%,5,3,2,2,1,1
464,https://vlr.gg/player/49612/croudy,2024-12-26 05:00:00,1.18,1.36,1.23,165,173,145,21,16,5,14,11,3,18,11,7,+3,+1,+2,91%,88%,100%,105,107,99,31%,32%,29%,3,1,2,0,0,0
465,https://vlr.gg/player/43012/,2024-12-26 05:00:00,0.32,0.95,0.76,174,118,199,20,4,16,31,10,21,7,1,6,-3,-1,-2,59%,50%,63%,129,90,146,30%,18%,35%,2,0,2,5,1,4
466,https://vlr.gg/player/43011/orcazz,2024-12-26 05:00:00,0.11,0.90,0.66,156,58,192,17,1,16,30,10,20,2,2,0,-2,-1,-1,44%,40%,46%,113,48,141,21%,9%,24%,1,0,1,3,1,2
467,https://vlr.gg/player/49930/asuka,2024-12-26 05:00:00,1.17,0.39,0.62,130,206,118,16,8,8,30,8,22,9,2,7,-5,-1,-4,50%,60%,46%,92,132,76,19%,26%,15%,3,1,2,8,2,6
468,https://vlr.gg/player/43008/cic,2024-12-26 05:00:00,0.62,0.54,0.56,102,128,96,12,4,8,30,9,21,7,2,5,-2,-1,-1,62%,60%,63%,73,86,67,30%,44%,25%,2,1,1,4,2,2
469,https://vlr.gg/player/49610/xzzcat,2024-12-26 05:00:00,0.32,0.54,0.48,115,84,130,12,3,9,30,9,21,4,1,3,-4,-2,-2,50%,40%,54%,91,71,100,14%,20%,13%,1,0,1,5,2,3
470,https://vlr.gg/player/27316/elixllo,2024-12-22 11:20:00,0.96,0.54,0.79,200,227,163,30,20,10,41,23,18,4,2,2,0,+2,-2,61%,63%,58%,127,137,112,33%,38%,27%,5,4,1,5,2,3
471,https://vlr.gg/player/3807/winteryrook,2024-12-22 11:20:00,0.72,0.88,0.78,186,176,201,29,16,13,41,24,17,12,6,6,-7,-3,-4,57%,63%,47%,109,106,115,34%,31%,38%,2,2,0,9,5,4
472,https://vlr.gg/player/33464/avvix,2024-12-22 11:20:00,0.58,0.69,0.61,146,127,166,19,9,10,41,24,17,7,5,2,0,+1,-1,50%,48%,53%,101,93,112,33%,29%,42%,2,1,1,2,0,2
473,https://vlr.gg/player/11914/rezy,2024-12-22 11:20:00,0.46,0.25,0.37,102,121,78,14,10,4,42,23,19,13,6,7,0,-1,+1,57%,56%,58%,71,74,65,19%,16%,23%,3,1,2,3,2,1
474,https://vlr.gg/player/7286/str1ker,2024-12-22 11:20:00,0.29,0.47,0.36,114,105,133,18,9,9,42,25,17,6,4,2,-5,-4,-1,50%,44%,58%,85,84,86,25%,24%,26%,5,3,2,10,7,3
475,https://vlr.gg/player/1618/spyzera,2024-12-22 11:20:00,1.92,1.33,1.58,259,301,227,46,22,24,19,7,12,18,9,9,+3,+2,+1,89%,95%,85%,173,198,156,32%,37%,28%,4,2,2,1,0,1
476,https://vlr.gg/player/6503/sand,2024-12-22 11:20:00,1.38,1.51,1.46,255,222,276,46,18,28,21,8,13,6,0,6,+2,+1,+1,89%,89%,89%,170,143,189,38%,39%,38%,5,2,3,3,1,2
477,https://vlr.gg/player/5599/khaalid,2024-12-22 11:20:00,1.79,1.12,1.40,199,250,162,37,19,18,17,5,12,12,6,6,0,+3,-3,76%,84%,70%,128,152,111,38%,47%,31%,5,3,2,5,0,5
478,https://vlr.gg/player/37847/fighter,2024-12-22 11:20:00,0.78,1.80,1.38,259,172,315,41,10,31,25,14,11,14,6,8,+2,+1,+1,78%,74%,81%,163,119,194,31%,31%,32%,7,4,3,5,3,2
479,https://vlr.gg/player/5600/moh,2024-12-22 11:20:00,1.22,0.94,1.05,212,255,187,37,19,18,28,12,16,18,10,8,+5,0,+5,96%,100%,93%,128,155,109,31%,30%,32%,8,2,6,3,2,1
480,https://vlr.gg/player/5600/moh,2024-12-22 06:00:00,1.23,1.22,1.22,250,255,242,56,27,29,47,21,26,32,17,15,+1,0,+1,75%,81%,69%,158,163,155,36%,29%,43%,8,3,5,7,3,4
481,https://vlr.gg/player/5599/khaalid,2024-12-22 06:00:00,1.13,1.26,1.20,222,193,252,52,21,31,46,20,26,26,14,12,+1,-2,+3,72%,71%,72%,155,142,166,37%,36%,38%,7,1,6,6,3,3
482,https://vlr.gg/player/1618/spyzera,2024-12-22 06:00:00,0.91,1.25,1.09,194,171,213,49,20,29,45,22,23,24,9,15,-2,-1,-1,79%,74%,83%,125,112,137,40%,40%,39%,3,2,1,5,3,2
483,https://vlr.gg/player/6503/sand,2024-12-22 06:00:00,1.08,0.90,0.98,207,218,199,46,24,22,47,19,28,21,5,16,+1,+1,0,69%,74%,64%,138,141,136,42%,40%,44%,4,3,1,3,2,1
484,https://vlr.gg/player/37847/fighter,2024-12-22 06:00:00,0.90,0.84,0.87,197,200,198,46,23,23,51,25,26,17,9,8,-2,-5,+3,69%,71%,67%,128,130,126,27%,31%,24%,11,3,8,13,8,5
485,https://vlr.gg/player/36073/al7b,2024-12-22 06:00:00,1.34,0.84,1.11,200,220,179,48,29,19,44,21,23,25,15,10,0,+1,-1,72%,78%,65%,129,147,109,20%,18%,23%,4,2,2,4,1,3
486,https://vlr.gg/player/35761/darwin,2024-12-22 06:00:00,1.16,0.85,1.02,199,215,180,49,29,20,47,25,22,12,9,3,+1,-1,+2,67%,61%,74%,128,142,112,27%,27%,26%,7,4,3,6,5,1
487,https://vlr.gg/player/17648/k1ng,2024-12-22 06:00:00,0.79,1.24,1.00,223,199,249,52,25,27,51,29,22,28,15,13,+3,-1,+4,79%,75%,84%,135,121,150,19%,17%,20%,5,1,4,2,2,0
488,https://vlr.gg/player/27313/rayy,2024-12-22 06:00:00,0.74,0.99,0.86,163,149,180,43,21,22,51,28,23,13,8,5,-5,-4,-1,72%,72%,71%,110,100,122,27%,27%,27%,2,0,2,7,4,3
489,https://vlr.gg/player/46250/psilence,2024-12-22 06:00:00,0.66,0.79,0.72,205,204,204,44,25,19,56,31,25,8,4,4,+2,-1,+3,55%,53%,58%,126,119,135,18%,17%,19%,16,8,8,14,9,5
490,https://vlr.gg/player/10642/jan,2024-12-22 05:35:00,1.31,1.12,1.21,206,226,197,51,26,25,47,22,25,13,4,9,+1,0,+1,74%,75%,72%,152,156,149,29%,38%,24%,4,2,2,3,2,1
491,https://vlr.gg/player/25279/sakura,2024-12-22 05:35:00,0.97,1.17,1.08,208,210,203,50,23,27,48,24,24,20,11,9,-1,0,-1,74%,72%,75%,127,129,127,43%,43%,43%,7,3,4,8,3,5
492,https://vlr.gg/player/17111/allen,2024-12-22 05:35:00,0.80,1.14,0.98,211,177,236,50,19,31,50,26,24,21,10,11,-4,-5,+1,69%,63%,75%,137,119,153,33%,35%,31%,5,1,4,9,6,3
493,https://vlr.gg/player/46355/jerry,2024-12-22 05:35:00,0.83,1.11,0.98,196,193,209,48,21,27,52,28,24,17,4,13,+4,+4,0,75%,63%,86%,136,119,150,35%,33%,37%,9,6,3,5,2,3
494,https://vlr.gg/player/43072/jinbey,2024-12-22 05:35:00,0.50,0.83,0.67,160,129,191,38,13,25,58,29,29,15,9,6,-12,-7,-5,69%,66%,72%,109,97,120,32%,29%,34%,3,0,3,15,7,8
495,https://vlr.gg/player/47482/flora,2024-12-22 05:35:00,0.99,1.55,1.25,241,206,279,61,27,34,48,30,18,17,9,8,+3,+2,+1,74%,67%,81%,163,149,180,35%,31%,40%,6,5,1,3,3,0
496,https://vlr.gg/player/31845/chay,2024-12-22 05:35:00,1.30,1.09,1.20,256,277,227,61,35,26,49,27,22,40,17,23,+5,+5,0,84%,78%,91%,167,182,150,32%,28%,40%,10,7,3,5,2,3
497,https://vlr.gg/player/37393/luca,2024-12-22 05:35:00,1.03,1.00,1.01,171,183,165,44,25,19,41,24,17,20,10,10,+1,0,+1,76%,72%,81%,118,121,114,36%,30%,45%,6,1,5,5,1,4
498,https://vlr.gg/player/45852/g4ll,2024-12-22 05:35:00,0.69,1.14,0.90,220,169,277,51,19,32,53,27,26,19,9,10,+3,-3,+6,71%,61%,81%,140,115,168,13%,12%,14%,12,4,8,9,7,2
499,https://vlr.gg/player/45853/r1va,2024-12-22 05:35:00,0.73,0.82,0.77,159,154,158,38,20,18,46,27,19,15,7,8,0,0,0,75%,72%,78%,104,106,101,25%,30%,21%,6,3,3,6,3,3
0,https://vlr.gg/player/5796/kr1stal,2024-12-22 05:00:00,1.20,1.22,1.21,234,240,236,52,27,25,44,23,21,22,9,13,-3,-1,-2,66%,61%,71%,162,154,170,22%,25%,19%,7,4,3,10,5,5
1,https://vlr.gg/player/7437/kellys,2024-12-22 05:00:00,1.16,1.20,1.18,229,217,236,55,25,30,47,23,24,12,7,5,+2,0,+2,69%,67%,71%,144,138,150,19%,14%,24%,6,3,3,4,3,1
2,https://vlr.gg/player/13219/papi,2024-12-22 05:00:00,0.84,0.98,0.91,167,155,184,44,19,25,49,24,25,22,12,10,0,-1,+1,71%,67%,74%,111,104,118,37%,38%,36%,3,0,3,3,1,2
3,https://vlr.gg/player/16621/alexy,2024-12-22 05:00:00,0.75,0.62,0.68,158,173,144,35,18,17,53,25,28,16,7,9,-4,-1,-3,59%,58%,60%,110,120,101,28%,31%,25%,7,5,2,11,6,5
4,https://vlr.gg/player/8176/enerii,2024-12-22 05:00:00,0.33,0.75,0.53,126,93,159,30,10,20,56,29,27,5,1,4,-5,-2,-3,53%,45%,60%,89,62,115,35%,37%,35%,6,2,4,11,4,7
5,https://vlr.gg/player/17086/something,2024-12-22 05:00:00,1.55,1.52,1.53,287,292,279,70,36,34,37,21,16,20,12,8,+8,+4,+4,82%,77%,88%,174,178,169,27%,34%,22%,16,8,8,8,4,4
6,https://vlr.gg/player/7378/jinggg,2024-12-22 05:00:00,0.90,1.48,1.19,267,233,303,62,27,35,48,27,21,17,8,9,+4,+2,+2,76%,77%,76%,168,154,183,28%,24%,33%,8,5,3,4,3,1
7,https://vlr.gg/player/9801/f0rsaken,2024-12-22 05:00:00,0.76,1.06,0.90,180,150,208,44,18,26,46,24,22,19,8,11,-4,-4,0,69%,66%,73%,118,103,134,34%,34%,35%,4,0,4,8,4,4
8,https://vlr.gg/player/9175/kohaibi,2024-12-22 05:00:00,1.02,0.75,0.89,157,199,113,41,26,15,41,23,18,7,4,3,0,+2,-2,74%,69%,79%,104,122,84,25%,26%,24%,5,4,1,5,2,3
9,https://vlr.gg/player/8492/tara,2024-12-22 05:00:00,0.85,0.79,0.82,129,140,120,32,18,14,44,22,22,29,14,15,+2,+1,+1,69%,74%,64%,77,80,73,27%,26%,28%,6,3,3,4,2,2
10,https://vlr.gg/player/47469/scope,2024-12-22 02:00:00,1.27,0.72,1.02,230,269,174,54,36,18,52,26,26,18,8,10,+3,+4,-1,70%,76%,63%,148,167,125,29%,38%,19%,7,5,2,4,1,3
11,https://vlr.gg/player/47467/ady,2024-12-22 02:00:00,0.62,1.34,0.95,189,122,293,52,17,35,55,29,26,24,16,8,+2,0,+2,80%,76%,84%,129,80,186,26%,22%,27%,6,1,5,4,1,3
12,https://vlr.gg/player/34785/yowamu,2024-12-22 02:00:00,1.01,0.86,0.94,222,254,188,49,29,20,52,30,22,16,13,3,-2,0,-2,66%,71%,59%,152,169,131,29%,33%,24%,18,12,6,20,12,8
13,https://vlr.gg/player/23971/ask,2024-12-22 02:00:00,0.88,0.98,0.93,175,171,195,42,23,19,48,26,22,20,8,12,+3,+4,-1,77%,82%,72%,121,113,131,22%,21%,23%,5,4,1,2,0,2
14,https://vlr.gg/player/10658/kurozooted,2024-12-22 02:00:00,0.91,0.90,0.90,163,179,153,43,23,20,49,28,21,23,18,5,-2,-2,0,74%,76%,72%,105,117,91,24%,23%,25%,1,0,1,3,2,1
15,https://vlr.gg/player/1971/oitan,2024-12-22 02:00:00,1.26,1.23,1.24,230,207,245,61,26,35,43,19,24,10,5,5,+4,+2,+2,80%,84%,76%,142,140,144,37%,44%,33%,7,2,5,3,0,3
16,https://vlr.gg/player/2671/popogachi,2024-12-22 02:00:00,1.00,1.12,1.06,242,213,256,59,26,33,52,23,29,14,4,10,-5,-3,-2,69%,66%,71%,152,139,162,30%,29%,31%,3,0,3,8,3,5
17,https://vlr.gg/player/1973/ripablo,2024-12-22 02:00:00,1.13,0.96,1.04,173,191,177,47,22,25,44,19,25,28,18,10,0,0,0,79%,84%,74%,108,109,107,21%,19%,24%,5,2,3,5,2,3
18,https://vlr.gg/player/47481/frxeez,2024-12-22 02:00:00,1.01,0.87,0.93,197,236,170,48,25,23,51,26,25,16,7,9,-2,+3,-5,76%,78%,74%,137,162,116,19%,21%,17%,13,10,3,15,7,8
19,https://vlr.gg/player/44613/yamada,2024-12-22 02:00:00,0.76,1.01,0.90,169,155,169,40,17,23,50,25,25,26,12,14,-1,0,-1,61%,59%,63%,110,102,116,30%,30%,30%,5,3,2,6,3,3
20,https://vlr.gg/player/1618/spyzera,2024-12-21 11:00:00,1.65,0.95,1.23,232,267,210,48,24,24,39,12,27,13,6,7,-7,0,-7,78%,83%,75%,165,191,148,36%,32%,39%,2,1,1,9,1,8
21,https://vlr.gg/player/6503/sand,2024-12-21 11:00:00,1.13,0.94,1.02,173,195,159,39,17,22,39,15,24,12,7,5,+1,+2,-1,68%,71%,67%,114,134,101,34%,29%,38%,4,2,2,3,0,3
22,https://vlr.gg/player/5600/moh,2024-12-21 11:00:00,0.83,1.10,0.99,192,167,213,41,13,28,46,18,28,17,8,9,+1,0,+1,67%,67%,67%,132,107,149,37%,36%,37%,7,4,3,6,4,2
23,https://vlr.gg/player/5599/khaalid,2024-12-21 11:00:00,0.85,0.93,0.89,198,155,224,42,14,28,46,16,30,9,4,5,-4,-2,-2,60%,63%,58%,134,116,147,44%,44%,44%,3,1,2,7,3,4
24,https://vlr.gg/player/37847/fighter,2024-12-21 11:00:00,0.97,0.63,0.77,181,235,143,37,21,16,47,18,29,8,2,6,-3,-2,-1,57%,63%,53%,116,148,95,27%,26%,28%,8,3,5,11,5,6
25,https://vlr.gg/player/33464/avvix,2024-12-21 11:00:00,1.32,0.92,1.16,215,234,193,48,33,15,38,20,18,10,7,3,+1,0,+1,75%,83%,63%,153,168,131,29%,30%,26%,4,2,2,3,2,1
26,https://vlr.gg/player/3807/winteryrook,2024-12-21 11:00:00,1.05,1.24,1.13,222,204,256,47,28,19,39,22,17,26,10,16,+1,+1,0,80%,81%,79%,148,134,168,27%,31%,24%,6,4,2,5,3,2
27,https://vlr.gg/player/7286/str1ker,2024-12-21 11:00:00,1.16,1.06,1.12,243,266,205,54,34,20,46,27,19,13,8,5,+3,+4,-1,72%,81%,58%,147,148,145,20%,18%,25%,12,10,2,9,6,3
28,https://vlr.gg/player/27316/elixllo,2024-12-21 11:00:00,0.83,1.00,0.90,196,186,207,40,23,17,45,28,17,12,8,4,+9,+5,+4,72%,69%,75%,128,126,130,35%,35%,35%,11,5,6,2,0,2
29,https://vlr.gg/player/11914/rezy,2024-12-21 11:00:00,0.99,0.47,0.76,140,169,98,28,20,8,39,21,18,22,14,8,-2,0,-2,78%,89%,63%,93,115,60,19%,30%,2%,3,2,1,5,2,3
30,https://vlr.gg/player/17648/k1ng,2024-12-21 08:20:00,1.10,1.29,1.19,246,259,225,52,30,22,42,24,18,30,11,19,+5,+4,+1,79%,73%,85%,149,159,138,23%,26%,21%,8,6,2,3,2,1
31,https://vlr.gg/player/36073/al7b,2024-12-21 08:20:00,1.13,1.25,1.18,208,204,215,43,22,21,36,18,18,21,7,14,-2,-1,-1,79%,73%,85%,143,139,147,30%,28%,33%,2,2,0,4,3,1
32,https://vlr.gg/player/27313/rayy,2024-12-21 08:20:00,0.97,0.97,0.97,185,184,186,36,20,16,40,20,20,21,8,13,+1,+1,0,75%,77%,73%,122,118,127,26%,30%,23%,4,2,2,3,1,2
33,https://vlr.gg/player/46250/psilence,2024-12-21 08:20:00,0.98,0.82,0.91,223,234,215,43,25,18,44,22,22,9,4,5,-1,+2,-3,68%,70%,65%,145,153,135,18%,23%,12%,11,6,5,12,4,8
34,https://vlr.gg/player/35761/darwin,2024-12-21 08:20:00,0.61,0.94,0.76,185,170,212,33,16,17,42,22,20,17,5,12,-1,-2,+1,66%,63%,69%,133,116,153,20%,22%,19%,4,1,3,5,3,2
35,https://vlr.gg/player/12331/zmart,2024-12-21 08:20:00,1.02,1.39,1.22,216,198,242,46,19,27,39,18,21,17,6,11,+3,+1,+2,80%,73%,87%,151,130,170,32%,33%,32%,6,3,3,3,2,1
36,https://vlr.gg/player/40014/waleed,2024-12-21 08:20:00,1.26,1.06,1.15,235,246,216,46,24,22,39,17,22,16,8,8,-3,0,-3,70%,73%,67%,151,169,135,35%,37%,31%,2,1,1,5,1,4
37,https://vlr.gg/player/12333/achrf,2024-12-21 08:20:00,1.09,1.06,1.07,212,201,227,42,19,23,41,17,24,22,12,10,0,+2,-2,71%,65%,77%,143,132,153,22%,29%,18%,3,3,0,3,1,2
38,https://vlr.gg/player/30503/srx,2024-12-21 08:20:00,1.03,0.81,0.91,224,245,208,42,23,19,44,20,24,9,5,4,-3,-2,-1,66%,69%,63%,148,168,130,25%,29%,20%,9,4,5,12,6,6
39,https://vlr.gg/player/19311/kuro,2024-12-21 08:20:00,0.65,0.72,0.68,132,142,128,28,13,15,44,22,22,10,7,3,+1,+1,0,68%,73%,63%,93,107,81,24%,25%,23%,7,3,4,6,2,4
40,https://vlr.gg/player/28400/hyunmin,2024-12-21 06:50:00,1.21,1.39,1.30,290,292,291,42,22,20,32,17,15,3,2,1,+6,+3,+3,72%,70%,74%,179,163,195,44%,32%,61%,10,5,5,4,2,2
41,https://vlr.gg/player/34982/athan,2024-12-21 06:50:00,0.89,0.99,0.94,181,153,209,22,9,13,29,14,15,9,5,4,-1,0,-1,67%,75%,58%,131,108,156,31%,35%,29%,1,1,0,2,1,1
42,https://vlr.gg/player/35013/flashback,2024-12-21 06:50:00,1.08,0.64,0.87,217,238,197,28,17,11,33,15,18,9,4,5,+1,0,+1,59%,75%,42%,137,145,128,18%,14%,26%,6,2,4,5,2,3
43,https://vlr.gg/player/43037/ache,2024-12-21 06:50:00,0.59,0.37,0.48,112,128,95,16,10,6,30,15,15,3,2,1,-1,0,-1,56%,60%,53%,73,88,57,35%,43%,26%,2,1,1,3,1,2
44,https://vlr.gg/player/29269/yome,2024-12-21 06:50:00,0.42,0.46,0.44,113,109,119,16,8,8,34,17,17,11,7,4,-2,-1,-1,59%,60%,58%,75,71,80,33%,33%,33%,2,2,0,4,3,1
45,https://vlr.gg/player/5796/kr1stal,2024-12-21 06:50:00,1.64,1.38,1.51,264,282,249,40,20,20,21,9,12,8,6,2,0,0,0,79%,89%,70%,174,195,155,38%,36%,39%,2,1,1,2,1,1
46,https://vlr.gg/player/13219/papi,2024-12-21 06:50:00,1.80,0.87,1.28,228,269,188,33,21,12,24,9,15,16,8,8,-3,0,-3,74%,84%,65%,152,183,121,27%,33%,20%,2,1,1,5,1,4
47,https://vlr.gg/player/7437/kellys,2024-12-21 06:50:00,1.48,1.09,1.28,255,296,221,34,20,14,26,13,13,26,14,12,0,+1,-1,82%,89%,75%,167,194,142,21%,25%,17%,2,2,0,2,1,1
48,https://vlr.gg/player/16621/alexy,2024-12-21 06:50:00,0.73,1.42,1.08,200,154,243,28,10,18,23,12,11,6,3,3,-1,-2,+1,77%,68%,85%,146,121,171,30%,26%,34%,6,3,3,7,5,2
49,https://vlr.gg/player/8176/enerii,2024-12-21 06:50:00,0.56,0.90,0.74,178,150,203,23,9,14,30,15,15,6,3,3,+1,0,+1,62%,63%,60%,118,98,137,23%,19%,26%,6,2,4,5,2,3
50,https://vlr.gg/player/48575/bucute,2024-12-21 06:10:00,1.41,1.08,1.25,242,272,212,94,54,40,71,36,35,23,11,12,+2,+3,-1,76%,77%,75%,161,178,143,45%,48%,43%,9,7,2,7,4,3
51,https://vlr.gg/player/8036/k1llers,2024-12-21 06:10:00,0.95,1.14,1.05,177,158,197,65,29,36,68,33,35,47,20,27,-3,-2,-1,72%,74%,70%,118,108,129,31%,37%,27%,2,1,1,5,3,2
52,https://vlr.gg/player/8240/alyal,2024-12-21 06:10:00,0.81,1.25,1.03,229,191,265,83,36,47,80,43,37,25,12,13,+4,+1,+3,65%,58%,72%,152,131,174,33%,31%,35%,17,9,8,13,8,5
53,https://vlr.gg/player/36180/mihlog,2024-12-21 06:10:00,1.05,0.97,1.01,190,193,181,67,33,34,70,34,36,23,12,11,-2,-1,-1,69%,75%,62%,124,123,124,29%,26%,33%,4,2,2,6,3,3
54,https://vlr.gg/player/14213/ting2k5,2024-12-21 06:10:00,1.04,0.80,0.92,227,249,201,80,48,32,84,41,43,19,6,13,+7,+4,+3,72%,75%,68%,151,169,134,28%,33%,22%,25,10,15,18,6,12
55,https://vlr.gg/player/26528/storm,2024-12-21 06:10:00,1.19,1.25,1.22,226,222,228,91,47,44,68,33,35,8,4,4,-3,-3,0,69%,72%,66%,151,145,157,40%,41%,40%,5,1,4,8,4,4
56,https://vlr.gg/player/24879/migodd,2024-12-21 06:10:00,1.17,0.95,1.06,238,258,222,89,49,40,81,40,41,21,11,10,-1,+1,-2,68%,66%,70%,154,163,145,25%,30%,20%,18,11,7,19,10,9
57,https://vlr.gg/player/48696/vuxqt,2024-12-21 06:10:00,1.05,0.90,0.98,207,194,222,74,35,39,82,37,45,42,25,17,+2,+4,-2,70%,74%,66%,136,133,140,30%,30%,29%,12,6,6,10,2,8
58,https://vlr.gg/player/49559/khoibeo,2024-12-21 06:10:00,0.77,0.84,0.81,158,146,178,59,26,33,76,37,39,26,16,10,-3,-2,-1,69%,74%,64%,116,98,134,27%,29%,25%,5,2,3,8,4,4
59,https://vlr.gg/player/48695/pr1ck,2024-12-21 06:10:00,0.67,0.83,0.74,165,162,174,59,28,31,82,42,40,32,13,19,-3,-3,0,64%,57%,72%,115,111,118,20%,22%,18%,9,5,4,12,8,4
60,https://vlr.gg/player/17086/something,2024-12-21 05:00:00,1.48,2.11,1.81,323,251,380,39,15,24,14,7,7,15,6,9,+7,+3,+4,85%,81%,89%,196,147,240,46%,28%,63%,7,3,4,0,0,0
61,https://vlr.gg/player/9801/f0rsaken,2024-12-21 05:00:00,1.66,1.50,1.58,359,421,312,46,24,22,24,12,12,8,3,5,+7,+4,+3,88%,94%,83%,235,267,206,35%,38%,32%,11,5,6,4,1,3
62,https://vlr.gg/player/8492/tara,2024-12-21 05:00:00,1.68,1.29,1.47,244,237,242,28,14,14,16,6,10,25,14,11,+3,+2,+1,88%,88%,89%,160,172,150,30%,30%,30%,4,2,2,1,0,1
63,https://vlr.gg/player/7378/jinggg,2024-12-21 05:00:00,1.31,0.99,1.14,252,288,229,30,16,14,22,11,11,11,7,4,+3,+1,+2,79%,88%,72%,187,210,168,34%,32%,36%,5,3,2,2,2,0
64,https://vlr.gg/player/9175/kohaibi,2024-12-21 05:00:00,0.84,1.21,1.03,108,68,141,16,5,11,11,5,6,8,4,4,0,0,0,85%,81%,89%,76,44,105,20%,13%,24%,0,0,0,0,0,0
65,https://vlr.gg/player/39904/serena,2024-12-21 05:00:00,0.94,0.68,0.82,203,267,130,23,16,7,32,18,14,4,1,3,-3,-1,-2,62%,72%,50%,131,164,94,28%,26%,33%,1,1,0,4,2,2
66,https://vlr.gg/player/49906/honeybunny,2024-12-21 05:00:00,0.60,0.77,0.68,175,161,188,20,9,11,31,17,14,3,3,0,-2,-3,+1,53%,61%,44%,113,102,126,21%,20%,22%,5,2,3,7,5,2
67,https://vlr.gg/player/29316/aco,2024-12-21 05:00:00,0.69,0.46,0.58,123,145,97,13,9,4,30,16,14,9,5,4,-3,0,-3,56%,50%,63%,80,91,67,23%,23%,22%,1,1,0,4,1,3
68,https://vlr.gg/player/43054/lefiedot,2024-12-21 05:00:00,0.34,0.79,0.55,149,101,204,17,6,11,33,17,16,5,2,3,-5,-3,-2,59%,50%,69%,105,72,142,29%,30%,28%,0,0,0,5,3,2
69,https://vlr.gg/player/40738/killaa,2024-12-21 05:00:00,0.37,0.44,0.40,118,103,142,14,6,8,33,17,16,5,3,2,-7,-3,-4,47%,39%,56%,77,70,84,39%,35%,42%,0,0,0,7,3,4
70,https://vlr.gg/player/1960/eko,2024-12-21 04:40:00,0.98,1.22,1.10,254,229,280,62,28,34,56,31,25,21,12,9,+7,+4,+3,82%,86%,77%,171,167,175,18%,15%,21%,14,8,6,7,4,3
71,https://vlr.gg/player/6676/thiefy,2024-12-21 04:40:00,1.29,0.87,1.08,196,220,173,50,29,21,47,23,24,15,9,6,+1,+1,0,69%,72%,66%,132,144,120,30%,28%,33%,5,2,3,4,1,3
72,https://vlr.gg/player/1027/marin,2024-12-21 04:40:00,0.77,1.32,1.04,199,165,235,50,20,30,50,28,22,14,9,5,-2,-3,+1,65%,58%,71%,138,117,160,32%,25%,40%,6,3,3,8,6,2
73,https://vlr.gg/player/1952/esperanza,2024-12-21 04:40:00,0.96,0.95,0.96,201,209,194,52,26,26,52,27,25,16,11,5,+1,0,+1,76%,75%,77%,133,139,126,29%,22%,37%,9,4,5,8,4,4
74,https://vlr.gg/player/7888/blackwiz,2024-12-21 04:40:00,0.82,1.05,0.93,167,155,181,41,21,20,48,26,22,38,16,22,-6,-2,-4,75%,72%,77%,119,109,129,26%,25%,28%,2,1,1,8,3,5
75,https://vlr.gg/player/10642/jan,2024-12-21 04:40:00,0.97,1.29,1.13,219,204,233,52,23,29,49,27,22,20,11,9,+8,+1,+7,79%,77%,81%,145,136,154,26%,21%,31%,16,6,10,8,5,3
76,https://vlr.gg/player/25279/sakura,2024-12-21 04:40:00,1.00,1.15,1.08,235,212,256,54,25,29,55,28,27,35,14,21,-4,-3,-1,75%,74%,75%,151,140,162,38%,47%,33%,3,1,2,7,4,3
77,https://vlr.gg/player/46355/jerry,2024-12-21 04:40:00,0.89,1.00,0.95,177,154,200,47,21,26,52,25,27,14,6,8,-2,0,-2,76%,74%,78%,122,107,136,44%,42%,46%,4,3,1,6,3,3
78,https://vlr.gg/player/17111/allen,2024-12-21 04:40:00,0.77,1.06,0.92,160,155,166,41,20,21,45,24,21,20,6,14,-1,-1,0,69%,71%,67%,111,100,121,23%,22%,23%,2,0,2,3,1,2
79,https://vlr.gg/player/43072/jinbey,2024-12-21 04:40:00,0.90,0.91,0.91,214,218,211,59,29,30,54,27,27,6,1,5,-2,+2,-4,66%,54%,78%,139,134,144,26%,28%,24%,10,7,3,12,5,7
80,https://vlr.gg/player/49526/invisible,2024-12-21 03:10:00,1.01,1.04,1.02,210,217,203,49,24,25,51,25,26,22,9,13,+1,-1,+2,71%,68%,74%,132,131,133,38%,39%,38%,5,0,5,4,1,3
81,https://vlr.gg/player/14227/nhatthong2k,2024-12-21 03:10:00,0.85,1.15,1.01,221,176,254,51,20,31,52,25,27,10,5,5,+2,-2,+4,73%,61%,83%,154,119,184,25%,25%,26%,15,6,9,13,8,5
82,https://vlr.gg/player/49818/kimhung2k5,2024-12-21 03:10:00,1.19,0.83,1.00,203,246,177,47,26,21,51,23,28,19,6,13,-1,-2,+1,62%,58%,66%,148,170,128,33%,38%,27%,5,2,3,6,4,2
83,https://vlr.gg/player/21840/lilhieu,2024-12-21 03:10:00,0.35,1.05,0.72,165,120,210,37,12,25,53,29,24,20,6,14,-6,-4,-2,61%,48%,71%,119,86,149,23%,29%,20%,2,0,2,8,4,4
84,https://vlr.gg/player/1432/ntk,2024-12-21 03:10:00,0.66,0.74,0.70,139,150,136,28,14,14,51,26,25,28,17,11,+4,+2,+2,68%,68%,69%,96,94,98,26%,27%,25%,6,4,2,2,2,0
85,https://vlr.gg/player/48696/vuxqt,2024-12-21 03:10:00,1.32,1.42,1.37,239,231,242,57,29,28,41,22,19,36,17,19,+3,+1,+2,80%,74%,87%,162,162,162,29%,31%,27%,4,2,2,1,1,0
86,https://vlr.gg/player/48695/pr1ck,2024-12-21 03:10:00,1.48,0.90,1.21,215,269,153,51,34,17,39,21,18,27,15,12,-2,-2,0,74%,71%,77%,141,186,91,26%,29%,21%,2,1,1,4,3,1
87,https://vlr.gg/player/26528/storm,2024-12-21 03:10:00,1.27,1.06,1.17,210,229,195,50,30,20,39,20,19,10,4,6,-1,-1,0,67%,57%,77%,142,143,140,28%,34%,23%,2,1,1,3,2,1
88,https://vlr.gg/player/24879/migodd,2024-12-21 03:10:00,0.63,1.56,1.07,247,153,338,52,16,36,48,27,21,27,14,13,-5,-7,+2,73%,66%,81%,158,108,213,17%,14%,19%,10,2,8,15,9,6
89,https://vlr.gg/player/49559/khoibeo,2024-12-21 03:10:00,0.83,1.27,1.04,197,170,245,48,21,27,45,26,19,18,6,12,+5,+2,+3,76%,71%,81%,134,110,161,36%,43%,31%,15,8,7,10,6,4
90,https://vlr.gg/player/10584/seoldam,2024-12-21 02:00:00,1.27,1.56,1.40,326,287,348,54,27,27,33,18,15,11,5,6,+7,+3,+4,81%,77%,86%,188,170,210,19%,20%,19%,11,5,6,4,2,2
91,https://vlr.gg/player/29841/caedye,2024-12-21 02:00:00,1.29,1.16,1.23,242,247,244,41,22,19,32,17,15,15,9,6,+5,+1,+4,75%,77%,73%,160,162,158,33%,36%,31%,8,4,4,3,3,0
92,https://vlr.gg/player/4663/joxjo,2024-12-21 02:00:00,0.95,1.23,1.08,204,191,222,35,17,18,32,18,14,32,13,19,+3,-1,+4,75%,65%,86%,126,131,120,31%,29%,34%,6,2,4,3,3,0
93,https://vlr.gg/player/29843/yatsuka,2024-12-21 02:00:00,0.81,1.39,1.07,171,112,239,29,10,19,26,14,12,13,5,8,-2,-3,+1,73%,73%,73%,122,81,170,43%,39%,45%,1,0,1,3,3,0
94,https://vlr.gg/player/5476/minty,2024-12-21 02:00:00,0.87,1.00,0.93,156,157,157,27,15,12,28,16,12,11,4,7,-3,-2,-1,77%,77%,77%,105,95,116,31%,38%,24%,3,1,2,6,3,3
95,https://vlr.gg/player/10658/kurozooted,2024-12-21 02:00:00,1.00,1.03,1.02,192,218,183,34,18,16,37,20,17,22,8,14,-2,-3,+1,69%,68%,69%,131,148,117,26%,28%,23%,2,0,2,4,3,1
96,https://vlr.gg/player/47469/scope,2024-12-21 02:00:00,1.07,0.74,0.89,173,224,135,32,19,13,34,17,17,5,2,3,-2,-2,0,60%,68%,54%,113,140,91,35%,37%,32%,1,0,1,3,2,1
97,https://vlr.gg/player/47467/ady,2024-12-21 02:00:00,0.49,1.15,0.85,170,122,216,26,8,18,39,20,19,21,9,12,+2,0,+2,69%,73%,65%,120,83,150,19%,18%,19%,3,0,3,1,0,1
98,https://vlr.gg/player/23971/ask,2024-12-21 02:00:00,0.78,0.81,0.80,147,162,139,26,13,13,34,17,17,11,6,5,-1,-1,0,56%,50%,62%,101,101,101,22%,29%,17%,3,0,3,4,1,3
99,https://vlr.gg/player/34785/yowamu,2024-12-21 02:00:00,0.54,1.02,0.80,231,180,266,33,10,23,42,21,21,13,7,6,-7,-6,-1,75%,73%,77%,149,130,165,29%,25%,33%,10,5,5,17,11,6
100,https://vlr.gg/player/5599/khaalid,2024-12-20 12:15:00,1.48,1.09,1.26,192,218,175,30,15,15,22,8,14,9,5,4,+1,+2,-1,83%,94%,75%,133,153,118,24%,24%,24%,3,2,1,2,0,2
101,https://vlr.gg/player/1618/spyzera,2024-12-20 12:15:00,1.42,0.90,1.12,239,293,187,35,20,15,31,12,19,11,6,5,+5,+1,+4,69%,83%,58%,150,171,134,34%,40%,28%,7,2,5,2,1,1
102,https://vlr.gg/player/6503/sand,2024-12-20 12:15:00,0.68,1.28,1.02,187,126,228,30,8,22,26,11,15,6,2,4,-2,-2,0,64%,61%,67%,133,88,168,49%,38%,55%,3,2,1,5,4,1
103,https://vlr.gg/player/5600/moh,2024-12-20 12:15:00,1.18,0.74,0.93,212,258,186,32,18,14,33,12,21,8,1,7,0,-2,+2,62%,67%,58%,146,171,128,36%,47%,27%,5,0,5,5,2,3
104,https://vlr.gg/player/37847/fighter,2024-12-20 12:15:00,1.16,0.70,0.90,194,253,149,31,17,14,29,12,17,2,2,0,+2,+1,+1,57%,67%,50%,117,153,91,38%,44%,30%,6,3,3,4,2,2
105,https://vlr.gg/player/27313/rayy,2024-12-20 12:15:00,1.11,0.96,1.05,187,182,203,27,16,11,30,15,15,16,9,7,+1,0,+1,71%,79%,61%,133,116,156,27%,32%,23%,3,2,1,2,2,0
106,https://vlr.gg/player/46250/psilence,2024-12-20 12:15:00,1.43,0.50,1.03,216,297,109,34,27,7,30,15,15,4,2,2,-3,0,-3,64%,71%,56%,131,170,80,34%,33%,36%,6,4,2,9,4,5
107,https://vlr.gg/player/35761/darwin,2024-12-20 12:15:00,0.80,1.06,0.91,190,180,205,28,14,14,32,18,14,10,7,3,-1,0,-1,71%,67%,78%,133,130,137,32%,44%,22%,2,2,0,3,2,1
108,https://vlr.gg/player/17648/k1ng,2024-12-20 12:15:00,0.98,0.75,0.88,218,213,231,33,20,13,34,17,17,9,4,5,-2,-3,+1,67%,71%,61%,139,129,152,25%,29%,21%,4,1,3,6,4,2
109,https://vlr.gg/player/36073/al7b,2024-12-20 12:15:00,0.74,0.75,0.74,152,117,191,19,9,10,32,15,17,14,7,7,-1,-3,+2,67%,67%,67%,96,75,124,23%,31%,17%,3,0,3,4,3,1
110,https://vlr.gg/player/3807/winteryrook,2024-12-20 08:20:00,1.31,1.25,1.28,263,274,245,59,29,30,43,19,24,19,8,11,+2,+5,-3,77%,74%,80%,164,160,169,36%,37%,35%,11,8,3,9,3,6
111,https://vlr.gg/player/33464/avvix,2024-12-20 08:20:00,1.46,0.97,1.20,203,242,175,52,28,24,37,15,22,17,10,7,-4,-2,-2,71%,68%,74%,136,156,118,36%,35%,38%,0,0,0,4,2,2
112,https://vlr.gg/player/27316/elixllo,2024-12-20 08:20:00,0.84,1.28,1.08,189,145,228,44,16,28,39,17,22,13,7,6,-2,-1,-1,71%,68%,74%,134,106,158,32%,36%,30%,3,1,2,5,2,3
113,https://vlr.gg/player/7286/str1ker,2024-12-20 08:20:00,0.80,1.16,0.99,214,198,231,48,21,27,44,21,23,10,5,5,-5,-3,-2,61%,58%,63%,149,140,157,24%,26%,23%,11,5,6,16,8,8
114,https://vlr.gg/player/11914/rezy,2024-12-20 08:20:00,0.93,0.56,0.73,129,133,125,30,16,14,45,18,27,20,6,14,-1,0,-1,62%,68%,57%,82,83,82,20%,24%,17%,3,1,2,4,1,3
115,https://vlr.gg/player/30503/srx,2024-12-20 08:20:00,1.30,1.10,1.20,234,253,217,58,33,25,45,23,22,6,6,0,+2,+4,-2,59%,69%,48%,153,165,141,27%,32%,22%,16,11,5,14,7,7
116,https://vlr.gg/player/12331/zmart,2024-12-20 08:20:00,1.17,0.80,1.00,196,236,154,46,29,17,48,25,23,21,14,7,+1,0,+1,68%,77%,58%,133,153,110,26%,28%,23%,6,3,3,5,3,2
117,https://vlr.gg/player/12333/achrf,2024-12-20 08:20:00,0.81,0.95,0.87,164,153,179,35,17,18,47,25,22,19,13,6,0,0,0,62%,63%,61%,118,108,131,20%,20%,19%,4,1,3,4,1,3
118,https://vlr.gg/player/19311/kuro,2024-12-20 08:20:00,0.94,0.74,0.85,185,200,168,39,25,14,48,25,23,12,5,7,+5,+4,+1,61%,63%,58%,126,130,120,26%,25%,26%,8,5,3,3,1,2
119,https://vlr.gg/player/40014/waleed,2024-12-20 08:20:00,0.64,0.90,0.76,131,121,147,30,14,16,45,25,20,12,11,1,+2,+1,+1,61%,71%,48%,92,83,102,28%,24%,33%,4,2,2,2,1,1
120,https://vlr.gg/player/5796/kr1stal,2024-12-20 07:00:00,1.23,2.07,1.66,306,226,375,36,13,23,18,10,8,14,7,7,+5,+1,+4,74%,65%,83%,216,163,265,29%,25%,32%,6,2,4,1,1,0
121,https://vlr.gg/player/13219/papi,2024-12-20 07:00:00,2.32,0.68,1.48,231,353,119,27,22,5,16,5,11,18,7,11,+2,+2,0,86%,94%,78%,161,240,87,28%,34%,17%,2,2,0,0,0,0
122,https://vlr.gg/player/16621/alexy,2024-12-20 07:00:00,1.27,1.61,1.45,259,264,254,37,17,20,20,11,9,8,3,5,+3,+1,+2,89%,88%,89%,175,180,170,26%,31%,23%,4,2,2,1,1,0
123,https://vlr.gg/player/7437/kellys,2024-12-20 07:00:00,0.91,0.95,0.93,168,150,185,21,9,12,22,10,12,16,6,10,-2,-1,-1,77%,71%,83%,109,95,123,23%,26%,21%,3,1,2,5,2,3
124,https://vlr.gg/player/8176/enerii,2024-12-20 07:00:00,0.56,0.96,0.77,185,171,198,24,11,13,26,14,12,5,1,4,-1,-4,+3,60%,59%,61%,119,106,132,31%,53%,17%,6,1,5,7,5,2
125,https://vlr.gg/player/49906/honeybunny,2024-12-20 07:00:00,0.55,1.08,0.81,224,183,271,26,10,16,30,15,15,5,2,3,+3,0,+3,60%,50%,71%,133,112,156,19%,16%,21%,6,2,4,3,2,1
126,https://vlr.gg/player/39904/serena,2024-12-20 07:00:00,0.99,0.56,0.78,161,175,146,19,10,9,28,13,15,11,8,3,-2,-2,0,60%,56%,65%,106,112,100,27%,26%,29%,2,1,1,4,3,1
127,https://vlr.gg/player/40738/killaa,2024-12-20 07:00:00,0.88,0.61,0.75,169,184,154,20,12,8,30,15,15,8,5,3,-1,-3,+2,60%,56%,65%,107,113,102,50%,52%,48%,4,1,3,5,4,1
128,https://vlr.gg/player/43054/lefiedot,2024-12-20 07:00:00,0.72,0.64,0.68,165,176,155,18,11,7,27,14,13,8,0,8,-5,-1,-4,57%,67%,47%,112,117,106,25%,36%,17%,1,0,1,6,1,5
129,https://vlr.gg/player/29316/aco,2024-12-20 07:00:00,0.58,0.72,0.65,156,150,165,19,9,10,30,16,14,6,5,1,-2,-2,0,60%,72%,47%,95,90,100,15%,16%,14%,1,1,0,3,3,0
130,https://vlr.gg/player/17086/something,2024-12-20 05:00:00,1.52,1.94,1.73,328,272,384,48,19,29,25,12,13,21,13,8,+8,+3,+5,90%,90%,90%,219,193,245,24%,28%,22%,9,3,6,1,0,1
131,https://vlr.gg/player/9801/f0rsaken,2024-12-20 05:00:00,1.68,1.27,1.48,289,332,247,44,25,19,24,11,13,16,10,6,-5,-3,-2,81%,81%,81%,194,209,179,23%,27%,19%,5,3,2,10,6,4
132,https://vlr.gg/player/7378/jinggg,2024-12-20 05:00:00,1.51,1.25,1.38,257,270,244,42,23,19,26,13,13,10,5,5,0,0,0,83%,90%,76%,181,173,189,39%,41%,37%,3,2,1,3,2,1
133,https://vlr.gg/player/8492/tara,2024-12-20 05:00:00,1.11,0.45,0.78,143,178,108,21,14,7,28,12,16,25,16,9,-1,+1,-2,71%,86%,57%,91,99,83,23%,18%,30%,2,1,1,3,0,3
134,https://vlr.gg/player/9175/kohaibi,2024-12-20 05:00:00,0.80,0.52,0.66,117,152,83,16,12,4,26,13,13,10,3,7,-6,-4,-2,76%,76%,76%,85,108,63,9%,13%,5%,0,0,0,6,4,2
135,https://vlr.gg/player/34982/athan,2024-12-20 05:00:00,0.97,1.03,1.00,221,209,233,30,14,16,34,16,18,11,5,6,+2,+1,+1,69%,67%,71%,136,125,147,20%,24%,18%,8,5,3,6,4,2
136,https://vlr.gg/player/35013/flashback,2024-12-20 05:00:00,0.99,0.95,0.97,229,230,228,34,18,16,34,16,18,6,2,4,+2,0,+2,69%,76%,62%,160,159,161,26%,31%,23%,5,2,3,3,2,1
137,https://vlr.gg/player/28400/hyunmin,2024-12-20 05:00:00,0.96,0.68,0.82,212,228,196,28,16,12,37,17,20,8,3,5,+3,+1,+2,57%,62%,52%,142,152,133,21%,22%,21%,9,4,5,6,3,3
138,https://vlr.gg/player/29269/yome,2024-12-20 05:00:00,0.78,0.45,0.61,135,137,133,21,11,10,35,15,20,10,5,5,-2,-1,-1,60%,67%,52%,93,86,100,38%,33%,42%,1,0,1,3,1,2
139,https://vlr.gg/player/43037/ache,2024-12-20 05:00:00,0.71,0.48,0.60,126,138,115,16,9,7,31,14,17,6,2,4,-1,0,-1,52%,57%,48%,90,92,88,36%,44%,28%,0,0,0,1,0,1
140,https://vlr.gg/player/39904/serena,2024-12-19 07:00:00,1.02,1.16,1.07,225,234,210,28,17,11,32,23,9,13,6,7,-2,-2,0,59%,58%,60%,142,140,145,34%,39%,27%,3,1,2,5,3,2
141,https://vlr.gg/player/49906/honeybunny,2024-12-19 07:00:00,0.65,1.12,0.83,204,170,262,28,14,14,34,23,11,5,1,4,0,-3,+3,56%,42%,80%,120,109,139,20%,29%,14%,7,3,4,7,6,1
142,https://vlr.gg/player/29316/aco,2024-12-19 07:00:00,0.50,1.17,0.76,160,146,181,22,11,11,31,23,8,10,6,4,-2,-3,+1,67%,54%,87%,94,90,102,17%,18%,16%,1,0,1,3,3,0
143,https://vlr.gg/player/40738/killaa,2024-12-19 07:00:00,0.71,0.65,0.69,115,124,104,17,12,5,33,23,10,15,7,8,-1,-2,+1,62%,50%,80%,63,64,63,34%,33%,36%,2,1,1,3,3,0
144,https://vlr.gg/player/43054/lefiedot,2024-12-19 07:00:00,0.36,1.22,0.69,158,99,251,20,6,14,32,23,9,7,6,1,-4,-4,0,62%,54%,73%,107,69,166,43%,30%,56%,2,0,2,6,4,2
145,https://vlr.gg/player/35013/flashback,2024-12-19 07:00:00,1.31,2.21,1.86,342,259,391,49,13,36,21,12,9,11,4,7,+2,-1,+3,82%,67%,92%,237,189,267,24%,29%,22%,3,0,3,1,1,0
146,https://vlr.gg/player/34982/athan,2024-12-19 07:00:00,1.42,1.44,1.43,278,251,296,38,14,24,23,9,14,21,6,15,0,-1,+1,82%,73%,88%,184,162,198,16%,17%,16%,4,1,3,4,2,2
147,https://vlr.gg/player/28400/hyunmin,2024-12-19 07:00:00,0.75,1.56,1.25,306,207,367,41,8,33,26,12,14,11,6,5,+3,-4,+7,77%,47%,96%,196,139,233,20%,29%,16%,10,1,9,7,5,2
148,https://vlr.gg/player/29269/yome,2024-12-19 07:00:00,0.74,0.80,0.78,116,104,126,16,6,10,24,11,13,26,6,20,+4,+1,+3,90%,87%,92%,63,74,57,29%,35%,26%,4,1,3,0,0,0
149,https://vlr.gg/player/43037/ache,2024-12-19 07:00:00,0.57,0.86,0.75,126,117,133,18,6,12,21,11,10,8,3,5,0,0,0,79%,67%,88%,84,69,92,19%,22%,18%,3,2,1,3,2,1
150,https://vlr.gg/player/17086/something,2024-12-19 05:00:00,1.07,0.79,0.90,200,279,170,27,15,12,33,13,20,8,2,6,+2,+3,-1,64%,73%,58%,134,148,126,23%,14%,29%,7,5,2,5,2,3
151,https://vlr.gg/player/7378/jinggg,2024-12-19 05:00:00,1.51,0.46,0.86,196,289,157,28,17,11,33,9,24,6,4,2,-2,-2,0,51%,67%,42%,142,188,114,29%,29%,30%,3,1,2,5,3,2
152,https://vlr.gg/player/9801/f0rsaken,2024-12-19 05:00:00,0.68,0.95,0.82,209,159,234,27,8,19,36,13,23,9,6,3,+2,-1,+3,72%,73%,71%,134,105,152,28%,18%,35%,6,1,5,4,2,2
153,https://vlr.gg/player/9175/kohaibi,2024-12-19 05:00:00,0.75,0.67,0.70,136,108,146,16,6,10,29,9,20,15,7,8,-1,-1,0,59%,67%,54%,94,73,106,27%,24%,29%,3,0,3,4,1,3
154,https://vlr.gg/player/8492/tara,2024-12-19 05:00:00,0.58,0.32,0.42,73,88,76,10,5,5,34,12,22,14,8,6,-2,0,-2,41%,60%,29%,53,54,53,22%,11%,31%,0,0,0,2,0,2
155,https://vlr.gg/player/13219/papi,2024-12-19 05:00:00,2.07,1.30,1.77,264,323,196,38,28,10,16,7,9,24,13,11,+2,+1,+1,87%,92%,80%,168,197,123,44%,50%,33%,3,2,1,1,1,0
156,https://vlr.gg/player/5796/kr1stal,2024-12-19 05:00:00,1.36,1.74,1.50,307,233,361,36,18,18,19,10,9,18,11,7,+2,+1,+1,87%,92%,80%,190,159,238,19%,16%,25%,5,3,2,3,2,1
157,https://vlr.gg/player/7437/kellys,2024-12-19 05:00:00,1.16,1.38,1.24,222,194,301,35,20,15,22,11,11,7,4,3,+1,0,+1,85%,88%,80%,135,115,167,14%,14%,15%,4,2,2,3,2,1
158,https://vlr.gg/player/8176/enerii,2024-12-19 05:00:00,1.21,0.64,0.99,242,291,129,33,26,7,27,16,11,7,6,1,-2,-1,-1,69%,79%,53%,165,205,101,32%,35%,25%,7,4,3,9,5,4
159,https://vlr.gg/player/16621/alexy,2024-12-19 05:00:00,1.05,0.58,0.87,155,178,121,23,17,6,24,13,11,12,7,5,-2,-1,-1,72%,79%,60%,103,118,80,32%,29%,45%,1,1,0,3,2,1
160,https://vlr.gg/player/939/mwzera,2024-12-15 15:25:00,0.97,1.56,1.28,246,194,288,68,24,44,46,24,22,12,9,3,+3,-2,+5,75%,69%,80%,161,132,186,26%,23%,29%,7,1,6,4,3,1
161,https://vlr.gg/player/8706/havoc,2024-12-15 15:25:00,1.17,1.13,1.15,225,245,210,55,30,25,49,25,24,12,4,8,+4,+3,+1,65%,63%,68%,148,151,145,33%,38%,27%,17,9,8,13,6,7
162,https://vlr.gg/player/8673/heat,2024-12-15 15:25:00,1.16,0.93,1.04,219,221,211,61,28,33,52,23,29,7,3,4,-3,-1,-2,61%,69%,55%,149,152,145,33%,40%,28%,6,3,3,9,4,5
163,https://vlr.gg/player/1711/khalil,2024-12-15 15:25:00,0.70,0.76,0.73,140,142,132,34,18,16,49,24,25,19,8,11,-5,-2,-3,68%,69%,68%,94,94,94,28%,34%,23%,1,1,0,6,3,3
164,https://vlr.gg/player/25743/raafa,2024-12-15 15:25:00,0.83,0.62,0.72,123,151,110,31,16,15,50,23,27,28,15,13,-8,-1,-7,67%,71%,63%,91,105,78,31%,31%,31%,2,2,0,10,3,7
165,https://vlr.gg/player/8480/aspas,2024-12-15 15:25:00,0.97,1.38,1.16,235,230,253,62,31,31,49,29,20,12,8,4,+5,+4,+1,77%,68%,89%,155,143,168,23%,20%,26%,14,8,6,9,4,5
166,https://vlr.gg/player/5395/cortezia,2024-12-15 15:25:00,1.09,1.07,1.08,217,217,234,61,31,30,50,25,25,7,4,3,+2,+1,+1,69%,68%,71%,149,146,151,50%,46%,54%,11,8,3,9,7,2
167,https://vlr.gg/player/725/nzr,2024-12-15 15:25:00,1.08,0.81,0.95,165,177,162,46,26,20,45,23,22,15,11,4,-2,0,-2,72%,83%,60%,110,114,105,36%,34%,38%,1,0,1,3,0,3
168,https://vlr.gg/player/5957/artzin,2024-12-15 15:25:00,0.88,0.94,0.91,173,167,181,46,25,21,52,29,23,26,15,11,+2,0,+2,69%,68%,71%,106,102,111,27%,25%,29%,11,5,6,9,5,4
169,https://vlr.gg/player/20240/xenom,2024-12-15 15:25:00,0.65,0.60,0.63,122,107,139,31,14,17,54,27,27,19,13,6,+2,+1,+1,65%,73%,57%,76,65,89,34%,32%,35%,5,2,3,3,1,2
170,https://vlr.gg/player/7603/mazino,2024-12-15 13:00:00,1.79,1.08,1.46,229,278,171,34,21,13,18,7,11,23,10,13,+2,+3,-1,77%,81%,72%,150,169,129,28%,29%,27%,3,3,0,1,0,1
171,https://vlr.gg/player/3826/adverso,2024-12-15 13:00:00,1.25,1.16,1.21,224,218,224,29,15,14,23,11,12,18,7,11,+4,+3,+1,85%,86%,83%,144,149,140,25%,25%,24%,7,4,3,3,1,2
172,https://vlr.gg/player/24007/shyy,2024-12-15 13:00:00,1.63,0.65,1.18,196,263,115,28,22,6,21,9,12,9,2,7,+2,0,+2,74%,81%,67%,125,168,74,31%,44%,8%,5,2,3,3,2,1
173,https://vlr.gg/player/1311/melser,2024-12-15 13:00:00,0.81,1.46,1.11,189,144,248,29,12,17,21,12,9,5,2,3,+5,+1,+4,79%,86%,72%,116,90,146,28%,29%,28%,6,2,4,1,1,0
174,https://vlr.gg/player/2462/keznit,2024-12-15 13:00:00,0.70,1.44,1.04,185,142,244,23,9,14,23,13,10,9,6,3,0,-4,+4,74%,71%,78%,129,100,162,15%,14%,17%,5,1,4,5,5,0
175,https://vlr.gg/player/662/pryze,2024-12-15 13:00:00,1.26,0.79,1.01,192,224,166,24,15,9,25,11,14,9,4,5,-3,-2,-1,64%,67%,62%,129,141,119,27%,22%,33%,2,0,2,5,2,3
176,https://vlr.gg/player/6195/lz,2024-12-15 13:00:00,1.04,0.75,0.88,187,190,186,23,11,12,29,13,16,10,9,1,+1,+1,0,54%,61%,48%,124,124,124,29%,17%,42%,3,2,1,2,1,1
177,https://vlr.gg/player/14950/gobera,2024-12-15 13:00:00,0.89,0.83,0.86,183,171,199,24,10,14,29,12,17,3,2,1,-4,-3,-1,54%,50%,57%,128,122,134,26%,19%,32%,2,0,2,6,3,3
178,https://vlr.gg/player/21661/spike,2024-12-15 13:00:00,0.70,0.57,0.63,143,148,142,19,9,10,29,13,16,12,9,3,+2,0,+2,74%,78%,71%,101,113,91,33%,41%,27%,4,1,3,2,1,1
179,https://vlr.gg/player/11921/silentzz,2024-12-15 13:00:00,0.44,0.45,0.45,111,153,81,16,9,7,32,15,17,4,2,2,-9,-6,-3,59%,67%,52%,84,109,62,24%,29%,17%,2,1,1,11,7,4
180,https://vlr.gg/player/24058/tokameite,2024-12-15 12:00:00,0.96,1.37,1.18,210,182,235,85,33,52,69,36,33,44,19,25,-5,-2,-3,76%,72%,79%,144,126,159,30%,29%,31%,4,2,2,9,4,5
181,https://vlr.gg/player/30186/nami,2024-12-15 12:00:00,1.10,1.03,1.07,201,217,192,80,39,41,76,36,40,42,18,24,+6,0,+6,74%,72%,75%,129,129,129,34%,39%,30%,12,2,10,6,2,4
182,https://vlr.gg/player/23049/alkyia,2024-12-15 12:00:00,0.88,1.15,1.03,240,218,262,92,35,57,82,40,42,17,8,9,+4,-1,+5,69%,70%,69%,159,144,172,22%,22%,22%,23,10,13,19,11,8
183,https://vlr.gg/player/20058/devilasxa,2024-12-15 12:00:00,0.85,1.07,0.97,192,173,209,73,29,44,81,38,43,59,24,35,-5,-5,0,75%,72%,77%,123,110,134,26%,29%,23%,6,2,4,11,7,4
184,https://vlr.gg/player/39057/safiaa,2024-12-15 12:00:00,0.73,1.08,0.92,211,192,211,80,34,46,79,41,38,17,5,12,-3,-8,+5,73%,66%,79%,139,128,147,31%,34%,29%,9,1,8,12,9,3
185,https://vlr.gg/player/30113/elysian,2024-12-15 12:00:00,1.02,1.23,1.11,205,201,213,79,42,37,74,44,30,37,19,18,+6,+2,+4,73%,72%,74%,142,140,145,31%,33%,28%,10,5,5,4,3,1
186,https://vlr.gg/player/30096/bobbiexo,2024-12-15 12:00:00,0.83,1.36,1.07,191,172,224,80,36,44,75,46,29,35,15,20,+5,+1,+4,71%,62%,82%,128,115,143,32%,32%,32%,10,5,5,5,4,1
187,https://vlr.gg/player/48660/anita,2024-12-15 12:00:00,0.92,1.02,0.96,211,202,232,85,43,42,86,50,36,17,9,8,+6,-3,+9,67%,62%,72%,138,130,147,33%,34%,32%,21,8,13,15,11,4
188,https://vlr.gg/player/42232/auri,2024-12-15 12:00:00,0.82,0.99,0.90,190,176,212,71,36,35,86,49,37,19,8,11,-10,-11,+1,68%,64%,74%,135,121,151,21%,22%,20%,9,2,7,19,13,6
189,https://vlr.gg/player/20116/jademwah,2024-12-15 12:00:00,0.83,0.85,0.84,191,192,188,71,39,32,89,51,38,42,22,20,-4,-2,-2,74%,70%,78%,118,116,121,23%,23%,22%,7,4,3,11,6,5
190,https://vlr.gg/player/12528/disisjohn,2024-12-15 12:00:00,1.10,0.77,0.92,200,221,186,31,16,15,36,15,21,5,2,3,+3,+1,+2,61%,67%,56%,128,137,119,36%,45%,30%,9,5,4,6,4,2
191,https://vlr.gg/player/4629/azury,2024-12-15 12:00:00,1.08,0.75,0.90,200,235,165,34,20,14,34,14,20,5,1,4,-2,-1,-1,65%,81%,52%,125,154,101,28%,26%,30%,2,1,1,4,2,2
192,https://vlr.gg/player/49883/agent-black,2024-12-15 12:00:00,0.75,0.93,0.85,172,130,204,27,9,18,33,14,19,13,7,6,0,+1,-1,70%,76%,64%,111,91,128,21%,18%,23%,5,2,3,5,1,4
193,https://vlr.gg/player/49884/agent-white,2024-12-15 12:00:00,0.56,0.91,0.75,138,114,169,24,8,16,34,15,19,11,6,5,-1,0,-1,57%,57%,56%,95,66,119,34%,24%,40%,4,2,2,5,2,3
194,https://vlr.gg/player/9508/leosen,2024-12-15 12:00:00,0.77,0.69,0.73,154,162,150,23,11,12,37,16,21,16,12,4,-2,0,-2,61%,67%,56%,99,94,103,56%,65%,50%,2,1,1,4,1,3
195,https://vlr.gg/player/18400/bipo,2024-12-15 12:00:00,1.47,1.10,1.30,272,332,199,44,29,15,30,18,12,3,0,3,+5,+4,+1,67%,76%,57%,175,205,139,26%,24%,33%,13,9,4,8,5,3
196,https://vlr.gg/player/3753/obnoks,2024-12-15 12:00:00,1.20,1.10,1.15,184,199,165,30,19,11,23,12,11,22,9,13,-2,0,-2,78%,76%,81%,122,138,103,32%,44%,22%,1,1,0,3,1,2
197,https://vlr.gg/player/7660/fizzy,2024-12-15 12:00:00,1.14,1.14,1.14,186,170,212,32,17,15,25,12,13,14,9,5,+3,+1,+2,74%,76%,71%,105,94,118,24%,30%,20%,6,2,4,3,1,2
198,https://vlr.gg/player/10338/lime,2024-12-15 12:00:00,0.99,1.31,1.14,228,223,232,36,18,18,30,18,12,22,13,9,-4,-2,-2,80%,80%,81%,162,153,172,31%,30%,33%,2,2,0,6,4,2
199,https://vlr.gg/player/3674/iluri,2024-12-15 12:00:00,0.98,1.03,1.00,209,188,228,32,17,15,31,15,16,21,9,12,0,0,0,78%,80%,76%,136,123,151,38%,47%,32%,2,0,2,2,0,2
200,https://vlr.gg/player/7660/fizzy,2024-12-15 09:00:00,1.82,1.09,1.44,254,314,199,57,35,22,37,15,22,18,11,7,+5,+2,+3,78%,87%,70%,168,213,128,28%,32%,22%,9,4,5,4,2,2
201,https://vlr.gg/player/18400/bipo,2024-12-15 09:00:00,1.39,1.16,1.27,259,278,243,60,30,30,44,20,24,13,11,2,+7,+3,+4,73%,87%,61%,167,185,151,25%,29%,21%,13,8,5,6,5,1
202,https://vlr.gg/player/3753/obnoks,2024-12-15 09:00:00,0.78,1.14,0.97,165,144,186,40,18,22,36,20,16,13,8,5,-1,0,-1,76%,77%,76%,106,95,116,30%,38%,25%,3,1,2,4,1,3
203,https://vlr.gg/player/3674/iluri,2024-12-15 09:00:00,1.16,0.71,0.93,181,220,147,39,24,15,42,19,23,20,9,11,+1,+2,-1,76%,93%,61%,116,125,108,21%,19%,24%,5,2,3,4,0,4
204,https://vlr.gg/player/10338/lime,2024-12-15 09:00:00,0.75,1.07,0.92,193,169,215,43,19,24,44,23,21,22,10,12,-3,-1,-2,65%,67%,64%,126,106,144,30%,20%,39%,6,3,3,9,4,5
205,https://vlr.gg/player/12593/felix,2024-12-15 09:00:00,0.97,1.20,1.08,202,186,219,48,22,26,42,20,22,7,5,2,0,+1,-1,73%,76%,70%,128,122,136,23%,15%,33%,3,1,2,3,0,3
206,https://vlr.gg/player/20302/jini,2024-12-15 09:00:00,1.35,0.76,1.07,198,216,179,44,27,17,42,16,26,24,9,15,-1,-3,+2,68%,70%,67%,125,137,113,20%,19%,21%,3,0,3,4,3,1
207,https://vlr.gg/player/7987/kovaq,2024-12-15 09:00:00,0.98,0.69,0.84,189,200,178,40,23,17,50,23,27,22,8,14,+2,+1,+1,68%,73%,63%,126,131,120,28%,37%,19%,7,4,3,5,3,2
208,https://vlr.gg/player/7968/stavinci,2024-12-15 09:00:00,0.66,0.78,0.72,146,141,151,33,17,16,51,27,24,25,9,16,-7,0,-7,67%,70%,63%,99,94,104,29%,32%,25%,3,3,0,10,3,7
209,https://vlr.gg/player/122/luckerrr,2024-12-15 09:00:00,0.61,0.81,0.71,183,165,205,38,17,21,54,27,27,4,0,4,-3,-2,-1,57%,58%,57%,124,106,143,21%,18%,25%,11,7,4,14,9,5
210,https://vlr.gg/player/6668/sugarz3ro,2024-12-15 06:50:00,1.32,1.92,1.49,218,184,302,15,9,6,9,7,2,11,10,1,+3,+3,0,88%,92%,80%,150,125,210,42%,37%,50%,3,3,0,0,0,0
211,https://vlr.gg/player/25221/xdll,2024-12-15 06:50:00,1.37,1.68,1.46,285,262,341,19,13,6,12,8,4,3,1,2,+1,0,+1,76%,75%,80%,190,172,233,29%,36%,20%,4,2,2,3,2,1
212,https://vlr.gg/player/424/dep,2024-12-15 06:50:00,1.53,1.07,1.39,275,286,252,18,13,5,10,6,4,4,3,1,+1,+1,0,82%,92%,60%,161,170,139,26%,20%,50%,2,1,1,1,0,1
213,https://vlr.gg/player/2615/clz,2024-12-15 06:50:00,0.95,1.13,1.00,156,149,175,9,6,3,10,7,3,9,7,2,0,0,0,76%,75%,80%,111,108,120,26%,24%,30%,1,1,0,1,1,0
214,https://vlr.gg/player/12990/syouta,2024-12-15 06:50:00,1.21,0.02,0.84,158,225,,10,10,0,9,6,3,1,1,0,0,0,0,76%,75%,80%,116,164,,43%,43%,,1,1,0,1,1,0
215,https://vlr.gg/player/13002/akame,2024-12-15 06:50:00,0.54,1.43,1.17,228,181,248,15,4,11,13,4,9,6,0,6,+3,0,+3,76%,80%,75%,141,125,147,44%,50%,43%,4,1,3,1,1,0
216,https://vlr.gg/player/48577/gyen,2024-12-15 06:50:00,0.84,0.74,0.77,158,231,129,9,4,5,14,5,9,9,3,6,-3,0,-3,82%,80%,83%,97,135,81,48%,50%,46%,0,0,0,3,0,3
217,https://vlr.gg/player/4052/jinboong,2024-12-15 06:50:00,1.10,0.61,0.75,167,132,183,9,2,7,14,3,11,8,3,5,-1,0,-1,71%,60%,75%,112,113,111,25%,29%,24%,0,0,0,1,0,1
218,https://vlr.gg/player/6672/meiy,2024-12-15 06:50:00,0.63,0.70,0.68,185,166,194,10,3,7,15,4,11,2,0,2,-1,-1,0,65%,40%,75%,132,135,131,25%,27%,24%,2,1,1,3,2,1
219,https://vlr.gg/player/10627/art,2024-12-15 06:50:00,0.74,0.38,0.49,138,187,118,7,3,4,15,4,11,3,0,3,-3,0,-3,53%,60%,50%,106,132,95,45%,63%,36%,0,0,0,3,0,3
220,https://vlr.gg/player/458/chronicle,2024-12-15 05:25:00,1.20,1.35,1.28,226,237,217,18,9,9,13,5,8,11,5,6,-1,0,-1,87%,100%,75%,160,159,160,24%,28%,20%,0,0,0,1,0,1
221,https://vlr.gg/player/9810/alfajer,2024-12-15 05:25:00,1.44,1.12,1.27,295,300,292,24,13,11,19,8,11,4,2,2,-1,0,-1,78%,73%,83%,208,205,210,30%,29%,31%,2,1,1,3,1,2
222,https://vlr.gg/player/438/boaster,2024-12-15 05:25:00,0.76,1.17,0.97,174,138,208,14,6,8,17,8,9,9,4,5,+1,0,+1,74%,82%,67%,114,87,138,17%,11%,22%,2,1,1,1,1,0
223,https://vlr.gg/player/4/crashies,2024-12-15 05:25:00,0.95,0.97,0.96,175,195,157,14,7,7,15,7,8,7,4,3,0,+2,-2,74%,91%,58%,119,135,104,44%,31%,64%,3,2,1,3,0,3
224,https://vlr.gg/player/9554/kaajak,2024-12-15 05:25:00,1.37,0.59,0.96,213,264,168,17,11,6,18,7,11,8,3,5,0,+3,-3,78%,91%,67%,140,176,107,37%,47%,26%,4,4,0,4,1,3
225,https://vlr.gg/player/4052/jinboong,2024-12-15 05:25:00,1.05,1.22,1.13,246,208,290,22,10,12,16,7,9,3,0,3,0,+1,-1,74%,75%,73%,149,138,161,31%,35%,29%,2,2,0,2,1,1
226,https://vlr.gg/player/10627/art,2024-12-15 05:25:00,1.52,0.72,1.13,203,270,130,17,12,5,16,7,9,4,2,2,+2,+4,-2,78%,100%,55%,122,156,84,16%,18%,11%,4,4,0,2,0,2
227,https://vlr.gg/player/6672/meiy,2024-12-15 05:25:00,1.07,0.90,0.99,230,285,171,20,13,7,19,10,9,4,1,3,-2,0,-2,65%,75%,55%,147,189,103,28%,29%,28%,1,1,0,3,1,2
228,https://vlr.gg/player/13002/akame,2024-12-15 05:25:00,0.91,0.60,0.76,203,215,192,14,8,6,19,8,11,13,4,9,0,+1,-1,78%,83%,73%,149,177,119,29%,24%,41%,3,1,2,3,0,3
229,https://vlr.gg/player/48577/gyen,2024-12-15 05:25:00,0.45,0.70,0.57,111,91,134,9,4,5,17,9,8,6,4,2,+1,0,+1,65%,75%,55%,77,66,89,30%,32%,29%,2,1,1,1,1,0
230,https://vlr.gg/player/22047/rarga,2024-12-15 05:00:00,,,,291,,,118,,,89,,,22,,,,,,,,,,,,,,,,,,,,
231,https://vlr.gg/player/37927/happywei,2024-12-15 05:00:00,,,,218,,,98,,,75,,,18,,,,,,,,,,,,,,,,,,,,
232,https://vlr.gg/player/12365/coconut,2024-12-15 05:00:00,,,,192,,,73,,,81,,,45,,,,,,,,,,,,,,,,,,,,
233,https://vlr.gg/player/4763/zixuan,2024-12-15 05:00:00,,,,189,,,81,,,74,,,54,,,,,,,,,,,,,,,,,,,,
234,https://vlr.gg/player/4710/you,2024-12-15 05:00:00,,,,164,,,65,,,87,,,65,,,,,,,,,,,,,,,,,,,,
235,https://vlr.gg/player/46460/ezeir,2024-12-15 05:00:00,,,,241,,,102,,,85,,,45,,,,,,,,,,,,,,,,,,,,
236,https://vlr.gg/player/39697/cb,2024-12-15 05:00:00,,,,210,,,84,,,83,,,38,,,,,,,,,,,,,,,,,,,,
237,https://vlr.gg/player/1209/swerl,2024-12-15 05:00:00,,,,195,,,79,,,97,,,23,,,,,,,,,,,,,,,,,,,,
238,https://vlr.gg/player/41054/guang,2024-12-15 05:00:00,,,,195,,,84,,,83,,,23,,,,,,,,,,,,,,,,,,,,
239,https://vlr.gg/player/4402/o0o0o,2024-12-15 05:00:00,,,,152,,,56,,,87,,,59,,,,,,,,,,,,,,,,,,,,
240,https://vlr.gg/player/438/boaster,2024-12-15 03:45:00,1.17,1.31,1.24,224,265,183,20,11,9,17,10,7,9,3,6,-1,-1,0,73%,62%,85%,147,162,133,38%,29%,56%,0,0,0,1,1,0
241,https://vlr.gg/player/458/chronicle,2024-12-15 03:45:00,0.37,1.71,1.04,175,93,259,13,2,11,15,10,5,12,3,9,+2,0,+2,73%,62%,85%,124,85,164,25%,19%,28%,3,0,3,1,0,1
242,https://vlr.gg/player/9810/alfajer,2024-12-15 03:45:00,0.31,1.25,0.78,205,131,281,19,5,14,23,13,10,4,2,2,-1,-3,+2,65%,46%,85%,125,83,168,30%,22%,36%,4,1,3,5,4,1
243,https://vlr.gg/player/4/crashies,2024-12-15 03:45:00,0.83,0.60,0.72,114,115,114,10,4,6,19,10,9,10,6,4,+2,+1,+1,65%,62%,69%,81,80,82,44%,38%,50%,2,1,1,0,0,0
244,https://vlr.gg/player/9554/kaajak,2024-12-15 03:45:00,0.29,0.82,0.56,160,115,206,15,5,10,23,13,10,3,1,2,-6,-4,-2,54%,31%,77%,99,67,130,38%,31%,43%,2,1,1,8,5,3
245,https://vlr.gg/player/8549/kingg,2024-12-15 03:45:00,1.27,1.72,1.50,250,220,281,23,11,12,12,9,3,6,1,5,+2,-1,+3,81%,69%,92%,162,129,194,38%,40%,36%,3,0,3,1,1,0
246,https://vlr.gg/player/26171/demon1,2024-12-15 03:45:00,0.67,1.51,1.09,226,171,281,23,8,15,17,11,6,2,2,0,+2,-1,+3,62%,38%,85%,156,112,200,46%,47%,46%,5,2,3,3,3,0
247,https://vlr.gg/player/5004/natank,2024-12-15 03:45:00,1.05,0.99,1.02,189,241,137,16,9,7,16,10,6,14,9,5,0,0,0,92%,92%,92%,132,157,106,30%,27%,35%,2,2,0,2,2,0
248,https://vlr.gg/player/619/c0m,2024-12-15 03:45:00,0.55,1.41,0.98,157,85,230,15,3,12,14,9,5,6,4,2,+1,-1,+2,92%,85%,100%,108,55,162,20%,6%,28%,2,0,2,1,1,0
249,https://vlr.gg/player/1818/tex,2024-12-15 03:45:00,0.84,1.00,0.92,210,220,200,19,9,10,18,11,7,9,6,3,-1,0,-1,81%,77%,85%,136,139,133,39%,38%,41%,3,1,2,4,1,3
250,https://vlr.gg/player/21668/verno,2024-12-15 03:00:00,1.52,1.84,1.68,261,219,303,56,25,31,22,12,10,22,11,11,+5,+1,+4,90%,90%,90%,180,159,200,28%,29%,28%,6,1,5,1,0,1
251,https://vlr.gg/player/11225/ethan,2024-12-15 03:00:00,1.25,1.30,1.28,218,246,191,45,25,20,30,18,12,22,10,12,+7,+4,+3,78%,76%,79%,144,166,122,30%,32%,27%,9,6,3,2,2,0
252,https://vlr.gg/player/4164/s0m,2024-12-15 03:00:00,1.27,1.30,1.28,235,228,229,48,24,24,33,17,16,34,18,16,+6,+2,+4,83%,86%,79%,152,160,144,35%,51%,27%,7,2,5,1,0,1
253,https://vlr.gg/player/5132/mada,2024-12-15 03:00:00,1.14,1.05,1.10,231,253,205,46,26,20,36,20,16,11,6,5,+7,+1,+6,78%,76%,79%,138,158,118,22%,35%,4%,16,8,8,9,7,2
254,https://vlr.gg/player/817/finesse,2024-12-15 03:00:00,0.71,0.88,0.80,131,139,125,28,15,13,35,19,16,12,1,11,-5,-1,-4,76%,72%,79%,87,95,79,17%,19%,16%,1,1,0,6,2,4
255,https://vlr.gg/player/11600/foxy9,2024-12-15 03:00:00,0.77,0.86,0.81,187,175,199,39,19,20,47,22,25,11,1,10,-5,-4,-1,60%,59%,62%,122,111,133,32%,29%,34%,7,2,5,12,6,6
256,https://vlr.gg/player/2489/munchkin,2024-12-15 03:00:00,0.74,0.82,0.78,148,138,175,31,13,18,42,21,21,13,6,7,-1,-1,0,64%,59%,69%,103,93,112,26%,22%,30%,4,1,3,5,2,3
257,https://vlr.gg/player/25081/yoman,2024-12-15 03:00:00,0.60,0.91,0.76,142,109,195,28,10,18,45,21,24,17,8,9,-5,-4,-1,59%,55%,62%,108,77,139,21%,18%,22%,2,0,2,7,4,3
258,https://vlr.gg/player/34974/karon,2024-12-15 03:00:00,0.65,0.78,0.71,127,128,126,24,11,13,43,22,21,22,10,12,+2,+2,0,66%,62%,69%,84,89,79,22%,19%,26%,4,3,1,2,1,1
259,https://vlr.gg/player/9196/t3xture,2024-12-15 03:00:00,0.68,0.73,0.71,151,153,164,33,16,17,46,22,24,15,7,8,-11,-6,-5,62%,59%,66%,98,89,106,26%,20%,31%,2,2,0,13,8,5
260,https://vlr.gg/player/14950/gobera,2024-12-14 18:00:00,1.71,0.98,1.39,251,281,208,37,24,13,27,13,14,10,8,2,+2,0,+2,74%,83%,63%,161,182,134,27%,23%,34%,7,3,4,5,3,2
261,https://vlr.gg/player/662/pryze,2024-12-14 18:00:00,1.45,0.91,1.21,207,227,179,31,20,11,26,12,14,12,10,2,-1,-1,0,77%,92%,58%,143,152,131,33%,37%,28%,2,0,2,3,1,2
262,https://vlr.gg/player/21661/spike,2024-12-14 18:00:00,0.68,1.56,1.07,224,170,287,31,12,19,31,19,12,17,9,8,-1,+2,-3,74%,75%,74%,139,108,179,32%,29%,34%,4,4,0,5,2,3
263,https://vlr.gg/player/6195/lz,2024-12-14 18:00:00,0.77,0.68,0.73,139,142,142,24,15,9,32,18,14,13,10,3,+1,0,+1,72%,83%,58%,93,101,84,48%,45%,53%,2,0,2,1,0,1
264,https://vlr.gg/player/11921/silentzz,2024-12-14 18:00:00,0.88,0.38,0.66,179,231,106,29,21,8,37,19,18,4,1,3,0,+1,-1,63%,71%,53%,99,129,61,30%,31%,29%,7,6,1,7,5,2
265,https://vlr.gg/player/5722/prince,2024-12-14 18:00:00,1.18,1.31,1.25,270,241,296,41,15,26,30,12,18,7,4,3,+1,-1,+2,79%,79%,79%,172,151,189,25%,20%,30%,2,0,2,1,1,0
266,https://vlr.gg/player/2486/pollo,2024-12-14 18:00:00,1.36,0.98,1.15,238,268,208,35,19,16,31,11,20,13,7,6,0,0,0,72%,74%,71%,157,183,136,40%,41%,38%,4,2,2,4,2,2
267,https://vlr.gg/player/1578/shion,2024-12-14 18:00:00,1.07,0.66,0.84,129,169,114,19,12,7,26,11,15,16,7,9,+1,+3,-2,65%,68%,63%,93,105,84,20%,16%,24%,3,3,0,2,0,2
268,https://vlr.gg/player/25858/sw,2024-12-14 18:00:00,1.03,0.66,0.82,188,187,185,29,14,15,33,12,21,13,7,6,-1,0,-1,72%,68%,75%,128,122,132,34%,43%,29%,4,1,3,5,1,4
269,https://vlr.gg/player/41224/tkzin,2024-12-14 18:00:00,0.72,0.90,0.82,188,180,190,29,12,17,32,14,18,7,1,6,-2,-1,-1,63%,63%,63%,128,123,132,32%,31%,33%,8,4,4,10,5,5
270,https://vlr.gg/player/683/pancada,2024-12-14 15:00:00,0.94,0.97,0.96,186,171,199,27,10,17,31,12,19,15,8,7,-1,-1,0,68%,71%,67%,126,117,133,46%,52%,43%,3,1,2,4,2,2
271,https://vlr.gg/player/1586/v1nny,2024-12-14 15:00:00,1.07,0.80,0.91,158,171,153,23,10,13,29,11,18,18,12,6,-1,0,-1,63%,71%,58%,104,118,94,32%,62%,17%,1,0,1,2,0,2
272,https://vlr.gg/player/8873/dgzin,2024-12-14 15:00:00,0.84,0.73,0.77,200,229,183,26,13,13,33,13,20,7,2,5,+3,+3,0,63%,65%,63%,123,143,109,40%,58%,27%,11,5,6,8,2,6
273,https://vlr.gg/player/6193/cauanzin,2024-12-14 15:00:00,0.65,0.68,0.67,164,166,162,22,10,12,36,14,22,10,3,7,+2,+1,+1,61%,65%,58%,106,105,107,36%,43%,31%,6,3,3,4,2,2
274,https://vlr.gg/player/2408/tuyz,2024-12-14 15:00:00,0.71,0.58,0.64,115,122,113,16,8,8,30,11,19,6,0,6,-2,-2,0,56%,71%,46%,75,73,77,33%,53%,24%,0,0,0,2,2,0
275,https://vlr.gg/player/8480/aspas,2024-12-14 15:00:00,1.49,1.35,1.44,257,278,233,39,25,14,22,12,10,5,4,1,0,-1,+1,80%,83%,76%,170,175,163,27%,33%,18%,8,3,5,8,4,4
276,https://vlr.gg/player/5395/cortezia,2024-12-14 15:00:00,1.39,1.33,1.37,265,274,249,43,27,16,23,13,10,4,2,2,0,0,0,76%,75%,76%,176,186,163,74%,77%,70%,4,3,1,4,3,1
277,https://vlr.gg/player/725/nzr,2024-12-14 15:00:00,1.23,1.24,1.23,218,198,237,31,17,14,22,11,11,16,11,5,-2,0,-2,76%,83%,65%,146,131,167,31%,25%,37%,2,2,0,4,2,2
278,https://vlr.gg/player/5957/artzin,2024-12-14 15:00:00,0.97,1.10,1.02,185,198,169,27,17,10,24,15,9,10,5,5,+1,+1,0,80%,83%,76%,120,131,103,36%,38%,32%,5,4,1,4,3,1
279,https://vlr.gg/player/20240/xenom,2024-12-14 15:00:00,0.94,0.72,0.85,124,134,117,19,12,7,23,12,11,18,12,6,0,0,0,68%,71%,65%,85,93,74,43%,38%,50%,1,0,1,1,0,1
280,https://vlr.gg/player/40524/star,2024-12-14 12:00:00,0.91,1.03,0.98,206,195,215,44,16,28,45,17,28,7,4,3,+5,+5,0,66%,65%,67%,133,121,141,25%,24%,25%,11,7,4,6,2,4
281,https://vlr.gg/player/20730/karina,2024-12-14 12:00:00,1.40,0.58,0.90,187,261,143,38,22,16,45,14,31,7,1,6,-2,+1,-3,63%,61%,64%,132,186,98,43%,49%,38%,2,1,1,4,0,4
282,https://vlr.gg/player/20112/kxoma,2024-12-14 12:00:00,0.90,0.75,0.81,148,168,138,31,14,17,42,16,26,18,8,10,-7,-4,-3,61%,61%,61%,103,125,89,32%,44%,24%,0,0,0,7,4,3
283,https://vlr.gg/player/24177/mimi,2024-12-14 12:00:00,0.66,0.80,0.72,181,174,188,36,13,23,47,19,28,14,5,9,0,-3,+3,71%,57%,81%,111,105,114,29%,20%,37%,6,0,6,6,3,3
284,https://vlr.gg/player/40177/leeni,2024-12-14 12:00:00,0.52,0.74,0.65,173,171,175,35,14,21,48,20,28,10,4,6,+3,+2,+1,64%,61%,67%,113,112,114,22%,31%,15%,10,4,6,7,2,5
285,https://vlr.gg/player/30113/elysian,2024-12-14 12:00:00,1.62,1.02,1.39,235,263,182,52,35,17,35,19,16,26,19,7,+5,+5,0,83%,83%,83%,152,171,123,31%,30%,33%,7,6,1,2,1,1
286,https://vlr.gg/player/20116/jademwah,2024-12-14 12:00:00,1.27,1.04,1.18,220,225,223,48,31,17,37,20,17,17,10,7,+2,0,+2,75%,75%,74%,147,152,139,25%,20%,33%,8,3,5,6,3,3
287,https://vlr.gg/player/48660/anita,2024-12-14 12:00:00,1.12,1.25,1.17,227,209,253,50,29,21,40,24,16,9,6,3,-2,-2,0,78%,81%,74%,159,153,169,44%,41%,49%,6,4,2,8,6,2
288,https://vlr.gg/player/42232/auri,2024-12-14 12:00:00,1.00,1.28,1.11,230,223,244,49,28,21,42,26,16,13,10,3,-3,0,-3,69%,75%,61%,161,152,175,32%,27%,42%,7,5,2,10,5,5
289,https://vlr.gg/player/30096/bobbiexo,2024-12-14 12:00:00,1.05,0.93,1.01,134,135,125,28,18,10,30,16,14,21,12,9,-1,-1,0,73%,75%,70%,97,110,78,33%,37%,26%,2,1,1,3,2,1
290,https://vlr.gg/player/49883/agent-black,2024-12-14 09:10:00,1.16,1.36,1.25,209,203,226,35,19,16,26,16,10,14,10,4,-1,-2,+1,91%,92%,89%,136,134,140,23%,21%,26%,2,1,1,3,3,0
291,https://vlr.gg/player/4629/azury,2024-12-14 09:10:00,1.35,0.97,1.19,249,254,216,39,25,14,32,18,14,10,6,4,0,-1,+1,73%,73%,74%,161,181,133,35%,39%,29%,5,3,2,5,4,1
292,https://vlr.gg/player/9508/leosen,2024-12-14 09:10:00,1.42,0.81,1.16,178,232,129,33,24,9,27,15,12,27,16,11,-5,-4,-1,76%,73%,79%,121,150,81,34%,39%,25%,1,0,1,6,4,2
293,https://vlr.gg/player/12528/disisjohn,2024-12-14 09:10:00,0.85,1.30,1.04,244,215,258,38,20,18,32,20,12,5,2,3,+4,+1,+3,67%,69%,63%,154,148,161,31%,38%,24%,8,3,5,4,2,2
294,https://vlr.gg/player/49884/agent-white,2024-12-14 09:10:00,0.91,1.20,1.03,246,232,239,37,20,17,33,21,12,13,10,3,+3,+2,+1,76%,81%,68%,148,142,158,33%,33%,33%,7,4,3,4,2,2
295,https://vlr.gg/player/7660/fizzy,2024-12-14 09:10:00,1.16,1.09,1.12,201,212,219,32,14,18,31,12,19,11,3,8,+2,0,+2,73%,63%,81%,137,132,141,29%,24%,32%,6,1,5,4,1,3
296,https://vlr.gg/player/3753/obnoks,2024-12-14 09:10:00,0.90,1.22,1.09,232,166,289,37,10,27,38,14,24,16,7,9,+3,-1,+4,82%,68%,92%,154,120,179,29%,32%,27%,5,0,5,2,1,1
297,https://vlr.gg/player/3674/iluri,2024-12-14 09:10:00,0.75,1.07,0.94,205,146,236,33,10,23,37,16,21,11,7,4,0,0,0,73%,84%,65%,129,86,160,39%,40%,39%,4,2,2,4,2,2
298,https://vlr.gg/player/18400/bipo,2024-12-14 09:10:00,1.03,0.45,0.69,157,245,104,28,18,10,36,15,21,7,2,5,+2,+1,+1,60%,63%,58%,105,143,77,27%,27%,27%,7,4,3,5,3,2
299,https://vlr.gg/player/10338/lime,2024-12-14 09:10:00,0.28,0.62,0.48,129,118,146,20,8,12,40,17,23,15,6,9,-8,-5,-3,60%,63%,58%,88,72,100,31%,25%,34%,0,0,0,8,5,3
300,https://vlr.gg/player/9810/alfajer,2024-12-14 07:00:00,3.77,1.93,2.30,384,639,321,22,8,14,4,0,4,4,0,4,+3,0,+3,87%,100%,83%,247,381,214,28%,31%,26%,3,0,3,0,0,0
301,https://vlr.gg/player/438/boaster,2024-12-14 07:00:00,1.30,1.53,1.48,187,144,198,11,2,9,4,1,3,7,2,5,+1,0,+1,87%,100%,83%,130,111,135,31%,20%,33%,1,0,1,0,0,0
302,https://vlr.gg/player/33902/sayonara,2024-12-14 07:00:00,0.80,1.50,1.36,248,90,288,13,1,12,7,1,6,4,2,2,+2,0,+2,93%,100%,92%,179,68,207,43%,25%,46%,2,0,2,0,0,0
303,https://vlr.gg/player/9554/kaajak,2024-12-14 07:00:00,1.10,1.22,1.19,164,128,174,10,2,8,6,2,4,2,0,2,-1,0,-1,73%,100%,67%,129,105,135,43%,33%,45%,2,0,2,3,0,3
304,https://vlr.gg/player/458/chronicle,2024-12-14 07:00:00,1.05,1.01,1.01,171,204,164,10,2,8,7,2,5,1,1,0,0,+1,-1,93%,100%,92%,130,141,128,17%,13%,18%,2,2,0,2,1,1
305,https://vlr.gg/player/2615/clz,2024-12-14 07:00:00,0.90,0.96,0.91,191,174,260,10,7,3,12,9,3,3,3,0,0,-1,+1,60%,50%,100%,131,125,158,50%,39%,100%,1,0,1,1,1,0
306,https://vlr.gg/player/424/dep,2024-12-14 07:00:00,0.82,0.03,0.65,160,183,68,7,7,0,13,10,3,3,3,0,0,0,0,33%,42%,,124,138,68,32%,39%,0%,3,3,0,3,3,0
307,https://vlr.gg/player/6668/sugarz3ro,2024-12-14 07:00:00,0.56,0.46,0.54,108,106,117,6,5,1,14,11,3,1,0,1,+1,+1,0,40%,33%,67%,69,61,102,14%,13%,20%,1,1,0,0,0,0
308,https://vlr.gg/player/25221/xdll,2024-12-14 07:00:00,0.30,0.29,0.30,74,69,93,2,1,1,13,10,3,3,3,0,-1,-1,0,33%,33%,33%,59,60,53,7%,10%,0%,0,0,0,1,1,0
309,https://vlr.gg/player/12990/syouta,2024-12-14 07:00:00,0.08,0.03,0.06,66,63,83,3,2,1,14,11,3,0,0,0,-5,-3,-2,13%,8%,33%,52,54,45,21%,15%,33%,0,0,0,5,3,2
310,https://vlr.gg/player/28400/hyunmin,2024-12-14 06:35:00,1.00,1.03,1.02,261,244,268,33,13,20,33,13,20,7,4,3,-1,0,-1,61%,75%,50%,159,168,153,32%,29%,34%,11,5,6,12,5,7
311,https://vlr.gg/player/1916/free1ng,2024-12-14 06:35:00,0.85,0.90,0.88,168,173,155,20,10,10,25,11,14,11,6,5,0,-1,+1,71%,69%,73%,111,107,114,24%,21%,26%,4,0,4,4,1,3
312,https://vlr.gg/player/35013/flashback,2024-12-14 06:35:00,1.53,0.40,0.87,165,261,108,23,16,7,27,8,19,8,4,4,+3,+3,0,68%,100%,45%,117,169,80,25%,26%,24%,3,3,0,0,0,0
313,https://vlr.gg/player/4462/mako,2024-12-14 06:35:00,1.31,0.30,0.72,131,194,73,15,11,4,29,10,19,19,11,8,-1,+1,-2,66%,88%,50%,93,145,55,22%,27%,15%,1,1,0,2,0,2
314,https://vlr.gg/player/34982/athan,2024-12-14 06:35:00,0.76,0.65,0.69,148,115,172,17,6,11,29,10,19,9,3,6,-1,-1,0,76%,81%,73%,98,74,115,15%,14%,16%,0,0,0,1,1,0
315,https://vlr.gg/player/9196/t3xture,2024-12-14 06:35:00,1.79,1.31,1.57,318,353,284,43,28,15,21,11,10,7,4,3,+3,+2,+1,87%,86%,88%,211,227,189,31%,34%,27%,8,5,3,5,3,2
316,https://vlr.gg/player/34974/karon,2024-12-14 06:35:00,1.61,1.27,1.47,203,199,214,32,20,12,15,6,9,21,12,9,-2,0,-2,87%,91%,81%,129,125,135,24%,47%,15%,1,0,1,3,0,3
317,https://vlr.gg/player/2489/munchkin,2024-12-14 06:35:00,1.14,0.90,1.04,197,181,219,24,13,11,25,11,14,21,11,10,-1,0,-1,74%,77%,69%,120,109,136,19%,15%,24%,4,3,1,5,3,2
318,https://vlr.gg/player/11600/foxy9,2024-12-14 06:35:00,1.22,0.54,0.93,211,235,136,27,19,8,26,13,13,1,1,0,0,+1,-1,74%,82%,63%,127,150,94,40%,45%,32%,3,3,0,3,2,1
319,https://vlr.gg/player/25081/yoman,2024-12-14 06:35:00,1.00,0.70,0.87,140,161,100,17,11,6,21,11,10,12,9,3,0,-1,+1,79%,77%,81%,107,132,73,17%,18%,14%,3,1,2,3,2,1
320,https://vlr.gg/player/619/c0m,2024-12-14 05:45:00,0.86,1.35,1.06,239,197,303,18,8,10,15,10,5,5,3,2,0,-1,+1,90%,83%,100%,158,140,185,40%,41%,40%,1,0,1,1,1,0
321,https://vlr.gg/player/5004/natank,2024-12-14 05:45:00,1.12,0.49,0.87,162,197,109,12,9,3,14,8,6,4,1,3,-3,-1,-2,55%,50%,63%,101,118,76,26%,30%,18%,0,0,0,3,1,2
322,https://vlr.gg/player/26171/demon1,2024-12-14 05:45:00,0.80,0.65,0.74,167,187,137,11,8,3,16,9,7,4,1,3,-1,-2,+1,50%,50%,50%,114,127,95,34%,47%,20%,1,0,1,2,2,0
323,https://vlr.gg/player/1818/tex,2024-12-14 05:45:00,0.43,0.79,0.57,154,148,164,9,5,4,17,11,6,5,2,3,-3,-2,-1,60%,58%,63%,110,109,112,35%,41%,29%,2,2,0,5,4,1
324,https://vlr.gg/player/8549/kingg,2024-12-14 05:45:00,0.55,0.41,0.50,154,150,160,10,6,4,19,11,8,3,2,1,-3,0,-3,60%,75%,38%,106,92,126,43%,38%,50%,1,1,0,4,1,3
325,https://vlr.gg/player/424/dep,2024-12-14 05:45:00,1.11,1.57,1.38,353,311,382,24,9,15,15,7,8,4,1,3,+6,+3,+3,80%,75%,83%,197,179,209,22%,32%,18%,10,5,5,4,2,2
326,https://vlr.gg/player/25221/xdll,2024-12-14 05:45:00,0.79,1.75,1.37,216,97,296,17,3,14,10,5,5,5,2,3,0,0,0,85%,88%,83%,148,74,197,32%,27%,33%,1,0,1,1,0,1
327,https://vlr.gg/player/6668/sugarz3ro,2024-12-14 05:45:00,0.71,1.33,1.08,188,89,255,13,3,10,10,4,6,8,3,5,+2,0,+2,80%,88%,75%,117,75,145,33%,22%,38%,2,0,2,0,0,0
328,https://vlr.gg/player/2615/clz,2024-12-14 05:45:00,1.65,0.70,1.08,186,253,142,14,7,7,13,4,9,9,7,2,+1,0,+1,65%,88%,50%,128,166,104,31%,30%,31%,1,0,1,0,0,0
329,https://vlr.gg/player/12990/syouta,2024-12-14 05:45:00,1.71,0.45,0.96,164,301,73,13,10,3,12,4,8,7,5,2,+1,+1,0,80%,100%,67%,90,169,38,38%,44%,25%,1,1,0,0,0,0
330,https://vlr.gg/player/1209/swerl,2024-12-14 05:00:00,,,,285,,,91,,,59,,,15,,,,,,,,,,,,,,,,,,,,
331,https://vlr.gg/player/46460/ezeir,2024-12-14 05:00:00,,,,230,,,68,,,59,,,34,,,,,,,,,,,,,,,,,,,,
332,https://vlr.gg/player/41054/guang,2024-12-14 05:00:00,,,,228,,,69,,,61,,,13,,,,,,,,,,,,,,,,,,,,
333,https://vlr.gg/player/39697/cb,2024-12-14 05:00:00,,,,193,,,55,,,53,,,30,,,,,,,,,,,,,,,,,,,,
334,https://vlr.gg/player/4402/o0o0o,2024-12-14 05:00:00,,,,152,,,44,,,60,,,48,,,,,,,,,,,,,,,,,,,,
335,https://vlr.gg/player/13768/s1mon,2024-12-14 05:00:00,,,,215,,,65,,,67,,,21,,,,,,,,,,,,,,,,,,,,
336,https://vlr.gg/player/15559/chichoo,2024-12-14 05:00:00,,,,200,,,60,,,68,,,17,,,,,,,,,,,,,,,,,,,,
337,https://vlr.gg/player/4742/smoggy,2024-12-14 05:00:00,,,,190,,,59,,,59,,,16,,,,,,,,,,,,,,,,,,,,
338,https://vlr.gg/player/3017/nobody,2024-12-14 05:00:00,,,,184,,,55,,,68,,,16,,,,,,,,,,,,,,,,,,,,
339,https://vlr.gg/player/3520/zmjjkk,2024-12-14 05:00:00,,,,180,,,52,,,66,,,24,,,,,,,,,,,,,,,,,,,,
340,https://vlr.gg/player/619/c0m,2024-12-14 04:15:00,1.33,0.93,1.10,245,240,249,17,8,9,18,7,11,4,0,4,0,0,0,71%,67%,75%,144,136,150,33%,30%,36%,2,1,1,2,1,1
341,https://vlr.gg/player/5004/natank,2024-12-14 04:15:00,0.99,1.00,1.00,190,209,176,14,6,8,19,8,11,8,4,4,+2,0,+2,67%,56%,75%,136,141,132,22%,12%,33%,4,1,3,2,1,1
342,https://vlr.gg/player/26171/demon1,2024-12-14 04:15:00,0.66,0.86,0.77,173,164,181,12,4,8,18,8,10,5,3,2,+3,+1,+2,62%,67%,58%,118,115,121,21%,24%,20%,4,1,3,1,0,1
343,https://vlr.gg/player/8549/kingg,2024-12-14 04:15:00,0.86,0.54,0.68,126,173,92,9,5,4,17,8,9,8,5,3,0,0,0,57%,56%,58%,84,119,57,7%,7%,7%,0,0,0,0,0,0
344,https://vlr.gg/player/1818/tex,2024-12-14 04:15:00,0.39,0.88,0.67,173,106,224,12,4,8,18,8,10,4,1,3,-4,-4,0,57%,56%,58%,127,92,153,30%,23%,33%,1,0,1,5,4,1
345,https://vlr.gg/player/6672/meiy,2024-12-14 04:15:00,1.93,1.39,1.70,320,330,309,26,16,10,12,6,6,2,0,2,+4,+1,+3,95%,92%,100%,213,217,208,28%,32%,23%,4,1,3,0,0,0
346,https://vlr.gg/player/4052/jinboong,2024-12-14 04:15:00,1.61,1.40,1.52,252,285,210,20,12,8,9,5,4,7,5,2,0,0,0,90%,92%,89%,166,176,153,44%,45%,43%,2,1,1,2,1,1
347,https://vlr.gg/player/13002/akame,2024-12-14 04:15:00,0.72,1.07,0.87,237,230,248,18,10,8,15,9,6,5,3,2,-2,-1,-1,76%,75%,78%,156,143,173,16%,18%,13%,2,1,1,4,2,2
348,https://vlr.gg/player/21438/ssees,2024-12-14 04:15:00,0.81,0.91,0.86,153,136,176,13,7,6,12,7,5,5,3,2,+1,0,+1,81%,83%,78%,85,76,96,38%,23%,63%,2,1,1,1,1,0
349,https://vlr.gg/player/48577/gyen,2024-12-14 04:15:00,0.50,1.08,0.75,165,139,201,13,6,7,16,10,6,4,2,2,-4,-4,0,67%,50%,89%,124,95,163,33%,17%,48%,0,0,0,4,4,0
350,https://vlr.gg/player/24679/cgrs,2024-12-14 03:00:00,0.94,1.12,1.02,184,172,203,39,19,20,43,26,17,22,12,10,+2,0,+2,69%,68%,70%,126,115,138,23%,27%,19%,4,1,3,2,1,1
351,https://vlr.gg/player/13784/killua,2024-12-14 03:00:00,0.70,1.39,1.02,181,141,226,43,16,27,45,27,18,16,8,8,-2,-2,0,72%,59%,87%,128,99,162,38%,38%,37%,5,2,3,7,4,3
352,https://vlr.gg/player/27244/seph1roth,2024-12-14 03:00:00,0.90,1.03,0.96,197,193,219,51,26,25,48,26,22,16,7,9,+3,0,+3,70%,68%,73%,126,122,129,25%,34%,20%,7,2,5,4,2,2
353,https://vlr.gg/player/12098/kadoom,2024-12-14 03:00:00,0.72,1.08,0.89,181,174,199,40,20,20,46,28,18,15,6,9,+1,-4,+5,67%,59%,77%,124,110,139,21%,23%,18%,12,6,6,11,10,1
354,https://vlr.gg/player/8582/laz,2024-12-14 03:00:00,0.41,1.06,0.72,123,85,171,29,9,20,43,26,17,18,7,11,-4,-4,0,67%,53%,83%,89,57,124,24%,17%,28%,4,1,3,8,5,3
355,https://vlr.gg/player/21668/verno,2024-12-14 03:00:00,1.45,1.34,1.39,210,240,180,51,26,25,28,16,12,20,11,9,-4,-2,-2,73%,77%,71%,135,152,120,33%,43%,23%,2,0,2,6,2,4
356,https://vlr.gg/player/11225/ethan,2024-12-14 03:00:00,1.02,1.54,1.30,255,214,275,55,21,34,44,25,19,36,14,22,+3,+1,+2,75%,70%,79%,160,140,179,28%,29%,27%,5,3,2,2,2,0
357,https://vlr.gg/player/4164/s0m,2024-12-14 03:00:00,1.03,0.97,1.00,186,172,199,44,20,24,45,20,25,26,8,18,+2,+1,+1,77%,77%,76%,124,118,129,30%,36%,27%,6,2,4,4,1,3
358,https://vlr.gg/player/5132/mada,2024-12-14 03:00:00,0.52,1.30,0.93,193,151,227,41,14,27,42,25,17,13,5,8,-2,-8,+6,67%,50%,82%,123,96,147,20%,33%,14%,15,5,10,17,13,4
359,https://vlr.gg/player/817/finesse,2024-12-14 03:00:00,0.34,1.15,0.77,148,103,190,34,11,23,43,26,17,14,6,8,+1,-2,+3,70%,60%,79%,97,69,121,11%,18%,8%,4,0,4,3,2,1
360,https://vlr.gg/player/8480/aspas,2024-12-13 18:10:00,1.55,1.59,1.57,279,287,260,40,22,18,19,11,8,5,3,2,+6,+3,+3,81%,80%,82%,181,182,181,36%,37%,33%,8,4,4,2,1,1
361,https://vlr.gg/player/20240/xenom,2024-12-13 18:10:00,1.22,1.23,1.23,238,182,307,33,15,18,22,10,12,11,5,6,-3,0,-3,76%,85%,65%,160,112,217,32%,34%,31%,3,1,2,6,1,5
362,https://vlr.gg/player/5957/artzin,2024-12-13 18:10:00,0.99,1.40,1.18,252,235,276,31,16,15,25,15,10,13,6,7,+3,0,+3,73%,70%,76%,173,159,188,33%,31%,37%,6,3,3,3,3,0
363,https://vlr.gg/player/5395/cortezia,2024-12-13 18:10:00,1.13,1.16,1.14,205,255,151,29,19,10,20,14,6,3,2,1,+3,+2,+1,86%,75%,100%,127,162,87,53%,46%,75%,5,4,1,2,2,0
364,https://vlr.gg/player/725/nzr,2024-12-13 18:10:00,0.51,1.17,0.81,132,101,174,17,7,10,24,15,9,14,6,8,-2,-1,-1,76%,65%,88%,106,83,133,26%,27%,25%,0,0,0,2,1,1
365,https://vlr.gg/player/25858/sw,2024-12-13 18:10:00,1.10,1.12,1.10,221,246,211,30,14,16,29,14,15,11,5,6,-3,-1,-2,65%,71%,60%,148,146,149,44%,45%,42%,2,1,1,5,2,3
366,https://vlr.gg/player/5722/prince,2024-12-13 18:10:00,0.99,0.98,0.98,203,170,228,24,11,13,29,12,17,14,4,10,+2,+2,0,81%,82%,80%,134,114,151,24%,22%,26%,4,2,2,2,0,2
367,https://vlr.gg/player/41224/tkzin,2024-12-13 18:10:00,0.56,0.95,0.73,173,133,209,22,7,15,32,15,17,5,3,2,-3,-2,-1,65%,53%,75%,119,86,147,38%,47%,34%,6,4,2,9,6,3
368,https://vlr.gg/player/2486/pollo,2024-12-13 18:10:00,0.37,0.88,0.64,152,115,177,20,8,12,32,16,16,8,1,7,+1,0,+1,65%,47%,80%,100,76,120,33%,44%,29%,2,0,2,1,0,1
369,https://vlr.gg/player/1578/shion,2024-12-13 18:10:00,0.40,0.52,0.46,114,89,138,13,4,9,32,14,18,15,7,8,-4,-2,-2,65%,65%,65%,78,60,94,33%,19%,42%,1,0,1,5,2,3
370,https://vlr.gg/player/17669/pompz,2024-12-13 16:00:00,1.19,0.95,1.07,229,245,216,88,48,40,90,41,49,34,18,16,+12,+11,+1,76%,76%,76%,149,154,145,31%,29%,34%,18,13,5,6,2,4
371,https://vlr.gg/player/24013/navarro,2024-12-13 16:00:00,1.02,1.06,1.04,203,180,220,78,37,41,76,35,41,31,15,16,-3,-1,-2,75%,78%,71%,133,119,147,27%,25%,29%,4,1,3,7,2,5
372,https://vlr.gg/player/48012/hada,2024-12-13 16:00:00,0.84,0.84,0.84,211,231,197,80,42,38,90,44,46,21,14,7,-3,-3,0,60%,67%,53%,144,164,126,26%,32%,20%,19,9,10,22,12,10
373,https://vlr.gg/player/48551/e13,2024-12-13 16:00:00,0.80,0.88,0.84,157,159,173,65,31,34,86,40,46,42,23,19,+1,+1,0,73%,76%,69%,115,111,118,27%,24%,29%,7,3,4,6,2,4
374,https://vlr.gg/player/1328/javiierh,2024-12-13 16:00:00,1.06,0.61,0.83,183,237,143,75,47,28,91,42,49,23,12,11,-3,-1,-2,67%,78%,56%,124,159,92,29%,35%,22%,11,5,6,14,6,8
375,https://vlr.gg/player/7618/theory,2024-12-13 16:00:00,1.33,1.20,1.27,231,227,236,93,50,43,68,30,38,28,14,14,+1,+2,-1,76%,78%,75%,155,154,155,41%,39%,42%,9,5,4,8,3,5
376,https://vlr.gg/player/46891/sventy,2024-12-13 16:00:00,1.10,1.12,1.11,257,252,251,101,54,47,89,45,44,21,12,9,-4,-1,-3,75%,80%,71%,168,172,165,34%,34%,35%,19,11,8,23,12,11
377,https://vlr.gg/player/12955/danger,2024-12-13 16:00:00,1.21,0.92,1.07,228,241,201,88,50,38,82,39,43,54,26,28,+2,+2,0,76%,78%,75%,142,158,126,26%,31%,21%,9,5,4,7,3,4
378,https://vlr.gg/player/8057/josegxbo,2024-12-13 16:00:00,1.09,1.01,1.05,192,184,206,78,38,40,72,32,40,45,23,22,+1,0,+1,77%,78%,76%,126,121,132,33%,44%,26%,12,6,6,11,6,5
379,https://vlr.gg/player/35583/edu,2024-12-13 16:00:00,1.00,0.97,0.98,164,170,173,72,38,34,75,35,40,32,14,18,-4,0,-4,74%,80%,67%,118,113,122,46%,38%,57%,6,4,2,10,4,6
380,https://vlr.gg/player/6193/cauanzin,2024-12-13 15:00:00,0.81,1.22,1.03,209,184,240,40,16,24,40,21,19,12,4,8,-1,-1,0,68%,63%,72%,138,118,157,38%,46%,33%,4,1,3,5,2,3
381,https://vlr.gg/player/1586/v1nny,2024-12-13 15:00:00,0.85,1.13,0.99,186,171,198,36,14,22,39,20,19,29,15,14,-8,-5,-3,73%,67%,79%,126,111,140,30%,28%,33%,0,0,0,8,5,3
382,https://vlr.gg/player/2408/tuyz,2024-12-13 15:00:00,0.97,0.87,0.92,169,201,143,33,19,14,41,23,18,13,5,8,+1,+1,0,63%,52%,72%,109,130,89,30%,35%,26%,2,2,0,1,1,0
383,https://vlr.gg/player/683/pancada,2024-12-13 15:00:00,0.66,1.13,0.91,177,112,244,35,11,24,41,20,21,15,4,11,+1,0,+1,64%,48%,79%,118,79,155,42%,55%,37%,4,1,3,3,1,2
384,https://vlr.gg/player/8873/dgzin,2024-12-13 15:00:00,0.69,0.97,0.81,203,173,233,40,15,25,47,26,21,9,4,5,-7,-4,-3,63%,52%,72%,125,106,142,34%,50%,23%,11,5,6,18,9,9
385,https://vlr.gg/player/6195/lz,2024-12-13 15:00:00,1.06,1.67,1.35,224,171,277,48,18,30,31,19,12,27,19,8,-1,-1,0,77%,72%,81%,148,110,188,36%,37%,36%,4,1,3,5,2,3
386,https://vlr.gg/player/21661/spike,2024-12-13 15:00:00,1.48,1.06,1.28,271,317,229,54,33,21,42,23,19,27,11,16,+9,+6,+3,88%,90%,85%,169,190,148,27%,25%,31%,12,6,6,3,0,3
387,https://vlr.gg/player/14950/gobera,2024-12-13 15:00:00,1.03,1.18,1.10,200,207,190,42,23,19,34,21,13,15,6,9,+3,0,+3,70%,62%,78%,129,128,129,24%,31%,17%,6,3,3,3,3,0
388,https://vlr.gg/player/11921/silentzz,2024-12-13 15:00:00,0.59,1.17,0.87,191,159,216,37,14,23,41,25,16,12,8,4,+3,+1,+2,70%,62%,78%,129,113,146,26%,28%,24%,9,6,3,6,5,1
389,https://vlr.gg/player/662/pryze,2024-12-13 15:00:00,0.66,0.95,0.80,139,118,164,27,10,17,36,21,15,16,11,5,0,-1,+1,70%,59%,81%,90,79,102,23%,13%,34%,4,1,3,4,2,2
390,https://vlr.gg/player/2690/hoody,2024-12-13 14:45:00,1.10,1.02,1.05,207,194,227,28,9,19,28,10,18,8,4,4,-1,0,-1,63%,71%,58%,137,129,142,39%,41%,38%,2,0,2,3,0,3
391,https://vlr.gg/player/2658/xuss,2024-12-13 14:45:00,0.67,1.24,1.03,215,155,249,29,8,21,28,11,17,5,1,4,+1,0,+1,63%,50%,71%,149,96,180,30%,46%,27%,4,1,3,3,1,2
392,https://vlr.gg/player/5292/al0rante,2024-12-13 14:45:00,0.68,0.69,0.68,148,159,140,19,8,11,29,12,17,9,1,8,-3,0,-3,63%,71%,58%,104,107,102,30%,41%,24%,1,1,0,4,1,3
393,https://vlr.gg/player/4244/yaboilewis,2024-12-13 14:45:00,0.74,0.58,0.64,158,144,161,20,7,13,34,11,23,6,3,3,-4,-2,-2,58%,64%,54%,102,103,102,41%,41%,42%,4,2,2,8,4,4
394,https://vlr.gg/player/1457/mistic,2024-12-13 14:45:00,0.28,0.76,0.58,131,68,171,17,3,14,32,12,20,10,2,8,-1,0,-1,63%,50%,71%,86,41,113,33%,33%,33%,4,2,2,5,2,3
395,https://vlr.gg/player/4629/azury,2024-12-13 14:45:00,1.80,1.21,1.58,268,300,204,36,26,10,18,11,7,13,6,7,0,0,0,79%,79%,79%,186,211,144,29%,27%,39%,2,1,1,2,1,1
396,https://vlr.gg/player/12528/disisjohn,2024-12-13 14:45:00,1.41,1.52,1.45,332,350,300,45,30,15,27,20,7,6,3,3,+11,+9,+2,87%,88%,86%,198,213,171,25%,31%,13%,15,11,4,4,2,2
397,https://vlr.gg/player/49883/agent-black,2024-12-13 14:45:00,1.11,1.59,1.29,235,211,273,34,20,14,22,15,7,19,10,9,0,-1,+1,74%,67%,86%,140,129,159,18%,28%,9%,4,2,2,4,3,1
398,https://vlr.gg/player/49884/agent-white,2024-12-13 14:45:00,0.77,1.10,0.89,172,160,189,22,13,9,25,17,8,16,8,8,-2,-1,-1,79%,79%,79%,104,95,118,28%,24%,32%,2,1,1,4,2,2
399,https://vlr.gg/player/9508/leosen,2024-12-13 14:45:00,0.47,1.06,0.69,101,87,128,14,6,8,21,15,6,18,13,5,-1,-1,0,84%,83%,86%,69,63,81,20%,13%,33%,0,0,0,1,1,0
400,https://vlr.gg/player/30186/nami,2024-12-13 14:20:00,1.37,1.60,1.50,273,213,321,44,17,27,24,9,15,13,7,6,+3,0,+3,85%,79%,91%,185,162,205,46%,43%,49%,4,0,4,1,0,1
401,https://vlr.gg/player/23049/alkyia,2024-12-13 14:20:00,1.35,1.43,1.39,271,281,259,42,20,22,23,12,11,4,1,3,+5,+3,+2,73%,63%,82%,188,180,194,29%,31%,27%,9,6,3,4,3,1
402,https://vlr.gg/player/39057/safiaa,2024-12-13 14:20:00,1.75,0.73,1.20,214,315,125,32,22,10,23,11,12,8,5,3,+2,+3,-1,68%,68%,68%,144,206,91,29%,29%,29%,7,4,3,5,1,4
403,https://vlr.gg/player/20058/devilasxa,2024-12-13 14:20:00,1.08,1.13,1.11,197,176,218,28,11,17,23,10,13,20,12,8,0,-1,+1,78%,79%,77%,121,96,143,48%,41%,55%,4,2,2,4,3,1
404,https://vlr.gg/player/24058/tokameite,2024-12-13 14:20:00,0.50,1.06,0.80,137,63,201,18,3,15,24,11,13,16,8,8,-1,0,-1,78%,74%,82%,89,37,133,25%,13%,30%,1,0,1,2,0,2
405,https://vlr.gg/player/40177/leeni,2024-12-13 14:20:00,0.91,1.12,1.00,198,187,203,27,13,14,31,18,13,3,2,1,-1,+1,-2,56%,50%,63%,132,133,131,31%,21%,48%,5,3,2,6,2,4
406,https://vlr.gg/player/40524/star,2024-12-13 14:20:00,0.97,0.90,0.94,175,169,177,29,15,14,31,17,14,4,4,0,-2,-2,0,61%,59%,63%,128,128,127,42%,38%,46%,1,1,0,3,3,0
407,https://vlr.gg/player/20112/kxoma,2024-12-13 14:20:00,1.21,0.55,0.91,193,236,147,26,19,7,33,17,16,9,4,5,0,+2,-2,66%,68%,63%,132,162,98,27%,36%,12%,3,3,0,3,1,2
408,https://vlr.gg/player/20730/karina,2024-12-13 14:20:00,0.60,0.89,0.74,151,120,196,22,10,12,31,17,14,4,2,2,+2,-1,+3,66%,59%,74%,104,89,121,34%,24%,47%,5,1,4,3,2,1
409,https://vlr.gg/player/24177/mimi,2024-12-13 14:20:00,0.28,0.40,0.30,95,105,89,13,7,6,38,22,16,12,7,5,-8,-4,-4,44%,41%,47%,62,69,54,24%,29%,18%,2,1,1,10,5,5
410,https://vlr.gg/player/21328/wo0t,2024-12-13 13:30:00,1.03,1.19,1.11,228,201,256,38,16,22,33,15,18,14,11,3,+3,+1,+2,72%,70%,75%,142,113,170,39%,41%,37%,9,4,5,6,3,3
411,https://vlr.gg/player/1144/boo,2024-12-13 13:30:00,0.93,1.15,1.04,221,164,274,38,15,23,33,15,18,6,2,4,+2,0,+2,64%,57%,71%,140,109,170,45%,48%,42%,4,2,2,2,2,0
412,https://vlr.gg/player/29873/benjyfishy,2024-12-13 13:30:00,0.96,0.83,0.90,186,196,175,32,18,14,35,16,19,15,6,9,-7,0,-7,74%,83%,67%,117,123,113,45%,59%,35%,2,2,0,9,2,7
413,https://vlr.gg/player/10971/riens,2024-12-13 13:30:00,1.23,0.40,0.81,187,255,121,30,22,8,37,16,21,16,8,8,-2,-1,-1,68%,78%,58%,123,163,86,38%,47%,24%,1,0,1,3,1,2
414,https://vlr.gg/player/18350/miniboo,2024-12-13 13:30:00,0.74,0.77,0.75,170,177,162,25,12,13,36,17,19,22,15,7,-5,-3,-2,81%,83%,79%,115,116,114,35%,34%,35%,3,2,1,8,5,3
415,https://vlr.gg/player/5893/robbiebk,2024-12-13 13:30:00,1.53,1.12,1.33,217,222,208,37,21,16,27,11,16,14,7,7,+5,+3,+2,79%,75%,83%,142,145,139,28%,32%,24%,7,4,3,2,1,1
416,https://vlr.gg/player/20871/k4davra,2024-12-13 13:30:00,1.40,1.23,1.32,230,259,201,40,23,17,31,17,14,21,12,9,-1,0,-1,77%,79%,74%,157,172,142,38%,34%,44%,1,1,0,2,1,1
417,https://vlr.gg/player/23169/minny,2024-12-13 13:30:00,0.92,1.16,1.04,222,209,239,38,18,20,35,17,18,5,5,0,+8,+2,+6,72%,71%,74%,132,123,142,32%,32%,31%,8,2,6,0,0,0
418,https://vlr.gg/player/11/zyppan,2024-12-13 13:30:00,1.13,0.55,0.84,160,210,109,25,18,7,34,15,19,26,12,14,-3,+2,-5,77%,92%,61%,103,133,71,30%,38%,19%,4,4,0,7,2,5
419,https://vlr.gg/player/7866/click,2024-12-13 13:30:00,0.60,1.02,0.80,208,179,239,33,14,19,38,20,18,7,6,1,0,-1,+1,70%,71%,70%,129,113,146,36%,29%,45%,8,4,4,8,5,3
420,https://vlr.gg/player/30113/elysian,2024-12-13 12:00:00,1.51,1.91,1.71,310,267,348,45,20,25,21,11,10,19,4,15,+6,+3,+3,93%,90%,95%,211,181,239,36%,33%,39%,9,4,5,3,1,2
421,https://vlr.gg/player/20116/jademwah,2024-12-13 12:00:00,0.96,1.53,1.25,227,189,263,34,13,21,23,13,10,19,8,11,+4,+2,+2,73%,60%,86%,138,116,158,22%,23%,21%,6,3,3,2,1,1
422,https://vlr.gg/player/48660/anita,2024-12-13 12:00:00,1.25,0.89,1.07,201,246,161,29,17,12,28,15,13,9,4,5,+4,+1,+3,73%,70%,76%,140,160,121,33%,38%,28%,5,2,3,1,1,0
423,https://vlr.gg/player/42232/auri,2024-12-13 12:00:00,0.81,0.98,0.90,195,187,202,30,14,16,30,16,14,7,4,3,-4,-4,0,73%,70%,76%,128,133,124,31%,31%,30%,2,0,2,6,4,2
424,https://vlr.gg/player/30096/bobbiexo,2024-12-13 12:00:00,0.62,1.15,0.89,133,91,174,21,7,14,26,14,12,14,7,7,-1,-2,+1,71%,55%,86%,83,55,109,33%,40%,30%,3,1,2,4,3,1
425,https://vlr.gg/player/29442/wens,2024-12-13 12:00:00,1.26,0.82,1.05,219,281,155,31,21,10,30,17,13,11,7,4,-3,-2,-1,68%,67%,70%,144,168,119,24%,24%,24%,4,3,1,7,5,2
426,https://vlr.gg/player/17408/lateu,2024-12-13 12:00:00,0.56,1.17,0.86,143,95,197,24,7,17,28,16,12,8,4,4,-3,-3,0,63%,57%,70%,89,74,105,20%,19%,22%,0,0,0,3,3,0
427,https://vlr.gg/player/38133/anesilia,2024-12-13 12:00:00,0.95,0.68,0.82,210,215,204,29,16,13,33,17,16,11,3,8,-3,-1,-2,61%,52%,70%,132,129,136,34%,36%,32%,3,1,2,6,2,4
428,https://vlr.gg/player/24100/anva,2024-12-13 12:00:00,0.29,1.05,0.66,172,121,226,24,7,17,35,20,15,6,6,0,-4,-4,0,59%,38%,80%,114,93,137,27%,15%,46%,4,0,4,8,4,4
429,https://vlr.gg/player/17326/htm,2024-12-13 12:00:00,0.40,0.86,0.62,161,126,200,20,8,12,33,18,15,11,3,8,+4,+1,+3,61%,57%,65%,108,88,130,25%,18%,31%,5,2,3,1,1,0
430,https://vlr.gg/player/49884/agent-white,2024-12-13 12:00:00,1.32,1.38,1.35,244,238,264,55,29,26,36,20,16,17,8,9,0,0,0,78%,82%,72%,161,147,178,31%,32%,29%,5,2,3,5,2,3
431,https://vlr.gg/player/9508/leosen,2024-12-13 12:00:00,1.11,1.15,1.13,189,177,216,45,22,23,39,21,18,25,13,12,+1,0,+1,83%,82%,83%,126,116,137,40%,35%,45%,2,1,1,1,1,0
432,https://vlr.gg/player/4629/azury,2024-12-13 12:00:00,1.12,1.07,1.10,171,169,183,40,21,19,34,17,17,15,7,8,+3,-1,+4,79%,76%,83%,114,121,106,38%,36%,41%,7,2,5,4,3,1
433,https://vlr.gg/player/12528/disisjohn,2024-12-13 12:00:00,1.04,1.04,1.04,257,273,213,55,32,23,47,28,19,11,7,4,+2,0,+2,75%,71%,79%,146,164,126,28%,32%,23%,15,9,6,13,9,4
434,https://vlr.gg/player/49883/agent-black,2024-12-13 12:00:00,0.84,0.82,0.83,157,140,167,36,19,17,40,23,17,16,11,5,-3,-3,0,67%,71%,62%,98,95,100,23%,23%,24%,4,1,3,7,4,3
435,https://vlr.gg/player/7987/kovaq,2024-12-13 12:00:00,1.11,1.22,1.17,232,213,262,54,24,30,45,21,24,14,8,6,+2,-2,+4,76%,69%,82%,151,127,172,33%,23%,41%,11,3,8,9,5,4
436,https://vlr.gg/player/122/luckerrr,2024-12-13 12:00:00,0.80,1.04,0.93,176,169,189,39,17,22,45,22,23,13,4,9,0,+1,-1,70%,69%,71%,118,110,125,19%,18%,20%,8,5,3,8,4,4
437,https://vlr.gg/player/7968/stavinci,2024-12-13 12:00:00,1.00,0.83,0.91,188,195,176,43,20,23,48,22,26,10,4,6,-1,0,-1,67%,69%,65%,125,129,121,35%,31%,40%,3,3,0,4,3,1
438,https://vlr.gg/player/12593/felix,2024-12-13 12:00:00,0.63,0.95,0.80,160,131,183,33,12,21,47,23,24,16,6,10,-2,-3,+1,68%,59%,76%,112,89,133,26%,38%,21%,5,0,5,7,3,4
439,https://vlr.gg/player/20302/jini,2024-12-13 12:00:00,0.81,0.48,0.63,119,127,119,27,14,13,46,20,26,18,11,7,-2,-3,+1,62%,66%,59%,83,89,78,23%,31%,19%,3,0,3,5,3,2
440,https://vlr.gg/player/18400/bipo,2024-12-13 12:00:00,0.68,2.24,1.44,309,206,415,45,14,31,24,17,7,8,4,4,+4,-2,+6,85%,75%,95%,183,121,248,19%,14%,22%,11,4,7,7,6,1
441,https://vlr.gg/player/10338/lime,2024-12-13 12:00:00,1.60,0.91,1.26,235,314,152,34,23,11,23,12,11,14,6,8,-1,-1,0,85%,85%,84%,150,199,98,31%,30%,33%,1,0,1,2,1,1
442,https://vlr.gg/player/7660/fizzy,2024-12-13 12:00:00,1.14,1.31,1.23,219,176,265,32,14,18,22,11,11,10,3,7,0,-2,+2,69%,55%,84%,147,115,181,36%,29%,44%,5,1,4,5,3,2
443,https://vlr.gg/player/3753/obnoks,2024-12-13 12:00:00,0.77,1.37,1.06,198,178,224,27,12,15,24,16,8,20,7,13,+2,+1,+1,77%,70%,84%,142,130,155,31%,31%,30%,3,2,1,1,1,0
444,https://vlr.gg/player/3674/iluri,2024-12-13 12:00:00,1.06,0.98,1.02,176,192,157,25,14,11,25,14,11,18,10,8,0,0,0,74%,70%,79%,114,130,97,42%,47%,35%,2,1,1,2,1,1
445,https://vlr.gg/player/13383/pitou,2024-12-13 12:00:00,1.52,1.05,1.28,252,311,195,35,20,15,30,16,14,9,7,2,+2,+1,+1,69%,68%,70%,163,192,135,33%,32%,35%,8,3,5,6,2,4
446,https://vlr.gg/player/33875/spexleon,2024-12-13 12:00:00,0.66,1.03,0.85,211,178,244,27,10,17,34,17,17,6,3,3,+1,-1,+2,72%,63%,80%,152,126,176,24%,36%,20%,3,1,2,2,2,0
447,https://vlr.gg/player/31377/allthewaypat,2024-12-13 12:00:00,0.46,0.73,0.60,130,127,135,19,8,11,32,18,14,5,2,3,0,0,0,49%,42%,55%,83,74,92,28%,19%,37%,2,1,1,2,1,1
448,https://vlr.gg/player/41846/shiro,2024-12-13 12:00:00,0.12,0.99,0.57,143,95,188,19,5,14,35,19,16,6,2,4,-7,-7,0,51%,32%,70%,96,66,125,35%,20%,46%,2,0,2,9,7,2
449,https://vlr.gg/player/40587/nyshaa,2024-12-13 12:00:00,0.29,0.80,0.55,124,59,186,18,5,13,32,16,16,4,2,2,-1,-2,+1,44%,42%,45%,78,40,115,32%,56%,27%,2,0,2,3,2,1
450,https://vlr.gg/player/3017/nobody,2024-12-13 06:40:00,,,,303,,,44,,,33,,,18,,,,,,,,,,,,,,,,,,,,
451,https://vlr.gg/player/15559/chichoo,2024-12-13 06:40:00,,,,281,,,44,,,26,,,13,,,,,,,,,,,,,,,,,,,,
452,https://vlr.gg/player/3520/zmjjkk,2024-12-13 06:40:00,,,,242,,,40,,,35,,,12,,,,,,,,,,,,,,,,,,,,
453,https://vlr.gg/player/13768/s1mon,2024-12-13 06:40:00,,,,191,,,33,,,34,,,20,,,,,,,,,,,,,,,,,,,,
454,https://vlr.gg/player/4742/smoggy,2024-12-13 06:40:00,,,,148,,,21,,,33,,,22,,,,,,,,,,,,,,,,,,,,
455,https://vlr.gg/player/37494/kai,2024-12-13 06:40:00,,,,298,,,45,,,39,,,13,,,,,,,,,,,,,,,,,,,,
456,https://vlr.gg/player/4712/heybay,2024-12-13 06:40:00,,,,236,,,35,,,35,,,9,,,,,,,,,,,,,,,,,,,,
457,https://vlr.gg/player/3021/biank,2024-12-13 06:40:00,,,,199,,,30,,,42,,,16,,,,,,,,,,,,,,,,,,,,
458,https://vlr.gg/player/3045/luok1ng,2024-12-13 06:40:00,,,,181,,,28,,,31,,,10,,,,,,,,,,,,,,,,,,,,
459,https://vlr.gg/player/4770/fengf,2024-12-13 06:40:00,,,,163,,,23,,,35,,,8,,,,,,,,,,,,,,,,,,,,
460,https://vlr.gg/player/14209/suka,2024-12-13 06:00:00,1.12,1.02,1.07,206,203,207,32,17,15,30,16,14,12,5,7,0,0,0,68%,64%,74%,129,133,125,34%,39%,30%,1,1,0,1,1,0
461,https://vlr.gg/player/14254/gin,2024-12-13 06:00:00,1.11,0.92,1.02,189,230,147,28,18,10,29,17,12,6,2,4,+1,0,+1,80%,77%,84%,129,150,103,28%,30%,21%,6,3,3,5,3,2
462,https://vlr.gg/player/23042/tripciew,2024-12-13 06:00:00,0.63,0.92,0.77,163,134,202,23,11,12,32,17,15,9,2,7,+1,-2,+3,63%,50%,79%,111,92,134,28%,24%,30%,3,0,3,2,2,0
463,https://vlr.gg/player/19154/albus,2024-12-13 06:00:00,0.59,0.86,0.72,143,120,179,21,10,11,32,18,14,12,3,9,-3,-2,-1,68%,68%,68%,102,88,119,29%,34%,25%,3,1,2,6,3,3
464,https://vlr.gg/player/44149/pr0digy,2024-12-13 06:00:00,0.52,0.71,0.61,158,164,146,21,12,9,35,20,15,14,7,7,-4,-2,-2,68%,68%,68%,97,106,88,23%,33%,13%,5,3,2,9,5,4
465,https://vlr.gg/player/21668/verno,2024-12-13 06:00:00,1.45,1.59,1.52,240,207,266,38,16,22,17,7,10,9,2,7,+2,+1,+1,83%,74%,91%,151,134,167,25%,26%,25%,4,2,2,2,1,1
466,https://vlr.gg/player/11225/ethan,2024-12-13 06:00:00,1.66,1.06,1.34,229,305,161,32,20,12,24,11,13,21,9,12,+2,0,+2,85%,84%,86%,146,182,116,24%,25%,23%,3,0,3,1,0,1
467,https://vlr.gg/player/4164/s0m,2024-12-13 06:00:00,1.14,1.49,1.33,264,211,308,38,13,25,27,13,14,21,12,9,+4,+2,+2,73%,74%,73%,165,145,182,27%,22%,31%,6,2,4,2,0,2
468,https://vlr.gg/player/817/finesse,2024-12-13 06:00:00,1.07,0.67,0.86,162,196,127,22,14,8,26,11,15,13,4,9,0,-1,+1,73%,79%,68%,101,125,80,17%,26%,10%,4,2,2,4,3,1
469,https://vlr.gg/player/5132/mada,2024-12-13 06:00:00,0.37,1.18,0.81,188,102,260,28,7,21,31,15,16,12,3,9,-3,-3,0,68%,53%,82%,122,67,170,32%,21%,37%,6,3,3,9,6,3
470,https://vlr.gg/player/37927/happywei,2024-12-13 04:00:00,,,,249,,,45,,,31,,,10,,,,,,,,,,,,,,,,,,,,
471,https://vlr.gg/player/22047/rarga,2024-12-13 04:00:00,,,,238,,,44,,,35,,,6,,,,,,,,,,,,,,,,,,,,
472,https://vlr.gg/player/4710/you,2024-12-13 04:00:00,,,,194,,,40,,,32,,,21,,,,,,,,,,,,,,,,,,,,
473,https://vlr.gg/player/12365/coconut,2024-12-13 04:00:00,,,,194,,,33,,,30,,,15,,,,,,,,,,,,,,,,,,,,
474,https://vlr.gg/player/4763/zixuan,2024-12-13 04:00:00,,,,192,,,28,,,31,,,31,,,,,,,,,,,,,,,,,,,,
475,https://vlr.gg/player/46460/ezeir,2024-12-13 04:00:00,,,,201,,,37,,,38,,,17,,,,,,,,,,,,,,,,,,,,
476,https://vlr.gg/player/1209/swerl,2024-12-13 04:00:00,,,,192,,,34,,,40,,,10,,,,,,,,,,,,,,,,,,,,
477,https://vlr.gg/player/39697/cb,2024-12-13 04:00:00,,,,172,,,33,,,37,,,15,,,,,,,,,,,,,,,,,,,,
478,https://vlr.gg/player/41054/guang,2024-12-13 04:00:00,,,,170,,,32,,,38,,,9,,,,,,,,,,,,,,,,,,,,
479,https://vlr.gg/player/4402/o0o0o,2024-12-13 04:00:00,,,,142,,,23,,,37,,,16,,,,,,,,,,,,,,,,,,,,
480,https://vlr.gg/player/21668/verno,2024-12-13 02:15:00,0.90,1.52,1.19,200,145,258,49,17,32,38,23,15,19,8,11,+3,-2,+5,73%,66%,81%,142,108,180,29%,21%,35%,7,1,6,4,3,1
481,https://vlr.gg/player/4164/s0m,2024-12-13 02:15:00,0.90,1.50,1.19,219,184,255,53,23,30,45,29,16,20,8,12,+3,+2,+1,72%,69%,75%,146,116,179,25%,27%,25%,5,3,2,2,1,1
482,https://vlr.gg/player/5132/mada,2024-12-13 02:15:00,0.77,1.36,1.05,217,190,244,50,22,28,47,30,17,11,5,6,-3,-5,+2,72%,60%,84%,141,125,159,21%,25%,18%,14,6,8,17,11,6
483,https://vlr.gg/player/11225/ethan,2024-12-13 02:15:00,0.64,1.46,1.03,173,128,223,44,16,28,42,28,14,20,9,11,0,-2,+2,73%,63%,84%,116,91,143,24%,25%,24%,6,3,3,6,5,1
484,https://vlr.gg/player/817/finesse,2024-12-13 02:15:00,0.70,0.91,0.80,136,120,153,30,12,18,44,25,19,13,8,5,0,0,0,63%,51%,75%,97,82,114,17%,12%,21%,3,1,2,3,1,2
485,https://vlr.gg/player/10698/nephh,2024-12-13 02:15:00,0.64,1.37,1.02,189,158,218,47,16,31,45,28,17,24,5,19,+3,+4,-1,67%,50%,83%,121,102,138,19%,20%,19%,6,4,2,3,0,3
486,https://vlr.gg/player/48878/rushia,2024-12-13 02:15:00,0.44,1.37,0.92,162,93,222,37,10,27,43,27,16,21,5,16,-1,-4,+3,70%,50%,89%,102,64,136,24%,23%,24%,3,0,3,4,4,0
487,https://vlr.gg/player/4885/whzy,2024-12-13 02:15:00,0.55,1.22,0.90,179,144,218,47,16,31,45,27,18,10,2,8,-6,-2,-4,64%,53%,74%,116,101,131,21%,24%,19%,8,4,4,14,6,8
488,https://vlr.gg/player/4774/knight,2024-12-13 02:15:00,0.82,0.98,0.90,193,189,200,47,23,24,47,27,20,13,3,10,+4,-3,+7,76%,66%,86%,112,109,116,21%,25%,19%,11,2,9,7,5,2
489,https://vlr.gg/player/40845/levius,2024-12-13 02:15:00,0.67,1.07,0.88,175,169,183,38,16,22,47,28,19,19,9,10,-3,-5,+2,69%,56%,80%,119,118,120,25%,23%,27%,4,1,3,7,6,1
490,https://vlr.gg/player/23042/tripciew,2024-12-13 00:00:00,1.69,0.64,0.97,155,251,114,21,11,10,23,5,18,7,2,5,+1,+1,0,66%,73%,63%,102,165,73,48%,78%,29%,2,1,1,1,0,1
491,https://vlr.gg/player/19154/albus,2024-12-13 00:00:00,0.60,0.86,0.78,168,117,193,20,4,16,30,8,22,7,4,3,-1,0,-1,69%,55%,75%,115,85,129,27%,31%,25%,1,1,0,2,1,1
492,https://vlr.gg/player/44149/pr0digy,2024-12-13 00:00:00,1.00,0.56,0.70,173,197,165,20,8,12,30,7,23,7,0,7,0,+1,-1,66%,64%,67%,119,121,118,22%,19%,23%,6,2,4,6,1,5
493,https://vlr.gg/player/14254/gin,2024-12-13 00:00:00,0.21,0.89,0.67,160,78,199,20,3,17,29,9,20,9,1,8,-3,-5,+2,60%,45%,67%,102,53,125,25%,36%,22%,4,0,4,7,5,2
494,https://vlr.gg/player/14209/suka,2024-12-13 00:00:00,0.60,0.70,0.67,157,132,168,19,6,13,31,9,22,12,2,10,+2,0,+2,66%,64%,67%,96,75,106,33%,75%,26%,4,0,4,2,0,2
495,https://vlr.gg/player/35013/flashback,2024-12-13 00:00:00,1.67,1.16,1.51,283,292,264,38,28,10,18,11,7,3,1,2,+5,+5,0,83%,88%,73%,191,207,154,35%,38%,30%,6,5,1,1,0,1
496,https://vlr.gg/player/1916/free1ng,2024-12-13 00:00:00,1.43,1.45,1.44,238,239,237,28,19,9,18,12,6,18,16,2,-1,-2,+1,91%,96%,82%,166,168,162,39%,35%,50%,2,0,2,3,2,1
497,https://vlr.gg/player/4462/mako,2024-12-13 00:00:00,1.06,1.71,1.26,216,190,269,27,17,10,19,14,5,17,10,7,-1,-3,+2,80%,75%,91%,140,124,176,44%,39%,52%,2,0,2,3,3,0
498,https://vlr.gg/player/28400/hyunmin,2024-12-13 00:00:00,1.16,0.92,1.09,251,294,159,32,25,7,24,18,6,5,4,1,0,0,0,80%,88%,64%,165,191,110,31%,27%,50%,6,5,1,6,5,1
499,https://vlr.gg/player/34982/athan,2024-12-13 00:00:00,1.13,0.49,0.93,163,188,109,18,16,2,21,13,8,17,13,4,-2,-2,0,71%,79%,55%,103,115,76,27%,33%,12%,2,1,1,4,3,1
0,https://vlr.gg/player/6193/cauanzin,2024-12-12 18:15:00,1.19,1.71,1.39,272,228,367,37,20,17,25,16,9,16,6,10,+3,+2,+1,85%,88%,80%,175,140,231,36%,47%,28%,6,3,3,3,1,2
1,https://vlr.gg/player/8873/dgzin,2024-12-12 18:15:00,1.14,1.68,1.34,282,285,259,40,25,15,24,18,6,5,0,5,+6,+5,+1,77%,71%,87%,176,174,178,34%,38%,28%,9,7,2,3,2,1
2,https://vlr.gg/player/683/pancada,2024-12-12 18:15:00,1.26,1.45,1.33,221,211,233,34,20,14,20,13,7,10,6,4,-3,-1,-2,74%,71%,80%,132,131,134,35%,35%,34%,3,2,1,6,3,3
3,https://vlr.gg/player/2408/tuyz,2024-12-12 18:15:00,1.01,1.08,1.04,190,225,136,27,18,9,23,16,7,8,3,5,+1,+2,-1,74%,71%,80%,129,151,94,30%,28%,38%,3,3,0,2,1,1
4,https://vlr.gg/player/1586/v1nny,2024-12-12 18:15:00,0.34,0.81,0.52,90,75,107,13,6,7,26,17,9,14,10,4,-4,-2,-2,64%,63%,67%,63,47,90,35%,28%,44%,0,0,0,4,2,2
5,https://vlr.gg/player/25858/sw,2024-12-12 18:15:00,0.45,1.34,1.00,194,124,254,27,5,22,29,13,16,14,6,8,-1,0,-1,67%,67%,67%,145,93,177,34%,25%,38%,5,2,3,6,2,4
6,https://vlr.gg/player/41224/tkzin,2024-12-12 18:15:00,0.84,1.03,0.96,205,151,232,27,8,19,32,11,21,7,1,6,0,+2,-2,62%,60%,63%,140,98,166,32%,50%,26%,5,3,2,5,1,4
7,https://vlr.gg/player/1578/shion,2024-12-12 18:15:00,0.65,0.98,0.86,167,131,187,22,8,14,29,11,18,8,1,7,0,0,0,59%,53%,63%,121,100,133,20%,23%,19%,3,1,2,3,1,2
8,https://vlr.gg/player/2486/pollo,2024-12-12 18:15:00,0.82,0.79,0.80,167,216,131,23,11,12,31,14,17,7,3,4,-1,0,-1,69%,60%,75%,106,140,84,32%,34%,29%,3,2,1,4,2,2
9,https://vlr.gg/player/5722/prince,2024-12-12 18:15:00,0.47,0.71,0.62,129,99,146,19,6,13,30,13,17,5,2,3,-1,+1,-2,46%,40%,50%,77,64,85,28%,36%,25%,2,1,1,3,0,3
10,https://vlr.gg/player/17669/pompz,2024-12-12 18:10:00,1.71,1.20,1.46,304,365,243,58,37,21,36,18,18,13,4,9,+3,+3,0,77%,85%,69%,194,230,157,27%,28%,26%,8,5,3,5,2,3
11,https://vlr.gg/player/1328/javiierh,2024-12-12 18:10:00,1.13,1.03,1.08,215,219,212,41,21,20,35,17,18,10,6,4,-1,-1,0,75%,88%,62%,132,138,126,18%,16%,22%,7,3,4,8,4,4
12,https://vlr.gg/player/24013/navarro,2024-12-12 18:10:00,0.83,1.08,0.95,155,119,191,30,12,18,33,16,17,14,9,5,-1,0,-1,83%,85%,81%,101,77,125,27%,25%,28%,2,1,1,3,1,2
13,https://vlr.gg/player/48551/e13,2024-12-12 18:10:00,1.00,0.77,0.88,190,236,145,31,20,11,36,20,16,19,15,4,-3,-4,+1,69%,73%,65%,135,162,109,28%,26%,32%,2,1,1,5,5,0
14,https://vlr.gg/player/48012/hada,2024-12-12 18:10:00,0.84,0.89,0.86,208,196,220,38,19,19,43,22,21,7,4,3,-2,-4,+2,71%,77%,65%,141,141,141,24%,22%,26%,5,0,5,7,4,3
15,https://vlr.gg/player/45358/yearn,2024-12-12 18:10:00,1.27,1.02,1.15,266,293,239,47,26,21,44,21,23,8,3,5,+8,+3,+5,63%,62%,65%,198,209,187,41%,42%,41%,11,6,5,3,3,0
16,https://vlr.gg/player/21428/crunch,2024-12-12 18:10:00,1.21,1.00,1.10,238,258,219,44,24,20,37,17,20,6,5,1,+2,+1,+1,63%,69%,58%,160,167,153,29%,27%,32%,7,3,4,5,2,3
17,https://vlr.gg/player/44075/dedmos,2024-12-12 18:10:00,0.77,1.02,0.90,178,116,239,33,12,21,37,16,21,8,3,5,+1,-1,+2,62%,50%,73%,121,75,167,25%,29%,24%,6,2,4,5,3,2
18,https://vlr.gg/player/35619/sxnti,2024-12-12 18:10:00,0.83,0.91,0.87,185,164,207,33,16,17,41,18,23,18,8,10,-2,-2,0,71%,73%,69%,127,107,146,25%,24%,26%,3,1,2,5,3,2
19,https://vlr.gg/player/39246/allu,2024-12-12 18:10:00,0.82,0.74,0.78,156,136,176,25,11,14,39,17,22,17,11,6,-5,-3,-2,62%,65%,58%,109,91,126,27%,25%,27%,1,0,1,6,3,3
20,https://vlr.gg/player/8057/josegxbo,2024-12-12 16:00:00,1.47,1.42,1.45,250,264,230,38,24,14,24,15,9,11,6,5,+1,+2,-1,76%,75%,76%,177,176,178,49%,59%,38%,4,3,1,3,1,2
21,https://vlr.gg/player/7618/theory,2024-12-12 16:00:00,1.23,1.04,1.15,209,227,179,32,20,12,23,14,9,3,3,0,-1,0,-1,71%,79%,59%,144,163,118,41%,41%,39%,2,1,1,3,1,2
22,https://vlr.gg/player/46891/sventy,2024-12-12 16:00:00,1.14,0.88,1.03,246,273,204,37,25,12,31,18,13,6,1,5,-1,-1,0,76%,71%,82%,165,178,148,30%,35%,23%,9,5,4,10,6,4
23,https://vlr.gg/player/12955/danger,2024-12-12 16:00:00,0.84,1.30,1.03,206,208,209,31,18,13,29,20,9,24,14,10,-2,-1,-1,76%,75%,76%,134,132,137,37%,37%,38%,2,2,0,4,3,1
24,https://vlr.gg/player/35583/edu,2024-12-12 16:00:00,0.56,1.47,0.94,164,78,288,23,6,17,25,16,9,8,5,3,0,0,0,80%,83%,76%,109,52,190,44%,29%,52%,2,1,1,2,1,1
25,https://vlr.gg/player/8781/charlslol,2024-12-12 16:00:00,0.71,1.26,1.03,202,133,250,28,7,21,32,13,19,14,6,8,+1,+2,-1,73%,71%,75%,127,84,157,23%,28%,21%,2,2,0,1,0,1
26,https://vlr.gg/player/38921/fotzy,2024-12-12 16:00:00,0.79,1.07,0.95,210,183,227,32,10,22,33,15,18,8,5,3,-3,-1,-2,51%,47%,54%,138,123,148,35%,33%,37%,2,0,2,5,1,4
27,https://vlr.gg/player/15934/feels,2024-12-12 16:00:00,0.71,0.94,0.85,170,164,171,25,10,15,30,13,17,8,2,6,+1,0,+1,63%,59%,67%,125,125,126,53%,45%,59%,2,1,1,1,1,0
28,https://vlr.gg/player/10581/ryu,2024-12-12 16:00:00,0.87,0.83,0.85,163,169,161,20,9,11,32,13,19,12,2,10,0,0,0,51%,47%,54%,126,126,126,31%,33%,30%,6,2,4,6,2,4
29,https://vlr.gg/player/35559/pandejalea,2024-12-12 16:00:00,0.89,0.72,0.79,195,217,185,27,13,14,35,14,21,9,3,6,+4,+2,+2,76%,71%,79%,140,132,145,25%,26%,23%,10,5,5,6,3,3
30,https://vlr.gg/player/38025/addi,2024-12-12 15:45:00,0.66,1.10,0.92,215,195,236,33,12,21,34,15,19,7,3,4,+1,-5,+6,56%,53%,58%,131,127,134,27%,40%,20%,9,0,9,8,5,3
31,https://vlr.gg/player/38116/xanti,2024-12-12 15:45:00,0.82,0.84,0.83,139,140,136,23,10,13,28,12,16,4,0,4,-1,0,-1,66%,65%,67%,98,93,102,29%,25%,32%,0,0,0,1,0,1
32,https://vlr.gg/player/43884/mali,2024-12-12 15:45:00,0.54,1.02,0.82,183,133,210,26,7,19,33,14,19,7,3,4,0,-3,+3,71%,76%,67%,116,77,144,32%,17%,41%,6,1,5,6,4,2
33,https://vlr.gg/player/21163/ninzakar,2024-12-12 15:45:00,0.66,0.86,0.78,191,180,207,27,10,17,36,15,21,7,4,3,-2,-2,0,63%,59%,67%,128,125,130,39%,50%,33%,1,1,0,3,3,0
34,https://vlr.gg/player/30240/noze,2024-12-12 15:45:00,0.60,0.57,0.58,133,138,128,17,8,9,33,14,19,11,2,9,+1,+1,0,61%,53%,67%,90,90,91,22%,33%,15%,4,2,2,3,1,2
35,https://vlr.gg/player/40524/star,2024-12-12 15:45:00,1.32,1.85,1.54,274,253,315,41,21,20,21,14,7,6,5,1,+3,+1,+2,73%,71%,76%,176,171,183,31%,27%,37%,6,3,3,3,2,1
36,https://vlr.gg/player/24177/mimi,2024-12-12 15:45:00,1.37,1.07,1.24,225,256,188,33,22,11,26,16,10,19,12,7,+3,+1,+2,78%,79%,76%,147,160,129,45%,40%,55%,5,2,3,2,1,1
37,https://vlr.gg/player/20730/karina,2024-12-12 15:45:00,1.07,1.20,1.13,218,207,238,34,19,15,26,15,11,6,3,3,-2,-4,+2,66%,58%,76%,153,149,159,56%,53%,61%,2,0,2,4,4,0
38,https://vlr.gg/player/20112/kxoma,2024-12-12 15:45:00,1.13,1.00,1.08,185,189,167,27,17,10,26,16,10,22,11,11,+1,0,+1,80%,83%,76%,125,131,117,46%,45%,48%,1,0,1,0,0,0
39,https://vlr.gg/player/40177/leeni,2024-12-12 15:45:00,0.68,1.45,1.00,204,183,228,29,15,14,27,18,9,8,4,4,-4,-6,+2,68%,58%,82%,140,125,162,29%,29%,28%,7,3,4,11,9,2
40,https://vlr.gg/player/8480/aspas,2024-12-12 15:00:00,1.68,1.00,1.33,256,331,186,58,37,21,42,18,24,12,6,6,+8,+4,+4,78%,87%,71%,168,213,128,35%,40%,27%,12,7,5,4,3,1
41,https://vlr.gg/player/5957/artzin,2024-12-12 15:00:00,1.60,0.69,1.12,251,309,208,58,34,24,46,17,29,31,20,11,+3,+2,+1,82%,94%,71%,159,194,127,28%,33%,23%,6,2,4,3,0,3
42,https://vlr.gg/player/20240/xenom,2024-12-12 15:00:00,0.89,1.21,1.06,177,125,228,41,13,28,37,16,21,25,16,9,-1,-3,+2,78%,84%,74%,106,78,131,42%,26%,53%,8,2,6,9,5,4
43,https://vlr.gg/player/5395/cortezia,2024-12-12 15:00:00,1.00,0.88,0.94,193,180,202,43,20,23,43,17,26,9,6,3,-4,-3,-1,65%,71%,59%,136,142,132,39%,41%,38%,5,2,3,9,5,4
44,https://vlr.gg/player/725/nzr,2024-12-12 15:00:00,1.00,0.57,0.78,158,181,139,38,23,15,44,18,26,16,8,8,+1,+3,-2,69%,81%,59%,109,120,98,27%,31%,24%,5,4,1,4,1,3
45,https://vlr.gg/player/14950/gobera,2024-12-12 15:00:00,1.35,0.91,1.15,224,255,204,35,23,12,29,14,15,7,4,3,0,-1,+1,67%,79%,53%,146,154,136,33%,31%,36%,4,1,3,4,2,2
46,https://vlr.gg/player/662/pryze,2024-12-12 15:00:00,0.95,0.98,0.97,151,135,163,35,19,16,38,18,20,16,4,12,-3,-1,-2,68%,65%,71%,104,94,115,28%,25%,32%,1,1,0,4,2,2
47,https://vlr.gg/player/6195/lz,2024-12-12 15:00:00,1.19,0.70,0.95,169,181,152,39,23,16,45,18,27,25,19,6,-2,-1,-1,69%,76%,61%,110,117,102,44%,43%,47%,2,1,1,4,2,2
48,https://vlr.gg/player/11921/silentzz,2024-12-12 15:00:00,0.94,0.88,0.91,225,258,190,50,30,20,52,28,24,8,5,3,+1,0,+1,69%,79%,58%,142,158,125,35%,38%,33%,11,8,3,10,8,2
49,https://vlr.gg/player/21661/spike,2024-12-12 15:00:00,0.98,0.73,0.86,217,218,207,47,26,21,54,25,29,12,8,4,-1,0,-1,69%,76%,61%,134,136,130,31%,32%,30%,11,4,7,12,4,8
50,https://vlr.gg/player/14482/faithz0r,2024-12-12 15:00:00,0.69,0.03,0.29,76,124,36,6,5,1,20,8,12,2,1,1,-2,-1,-1,41%,50%,33%,53,86,25,32%,38%,17%,0,0,0,2,1,1
51,https://vlr.gg/player/30107/fluxxy,2024-12-12 12:00:00,1.47,1.27,1.36,227,228,229,60,29,31,44,19,25,35,18,17,+4,+4,0,80%,78%,82%,150,157,143,28%,39%,20%,9,5,4,5,1,4
52,https://vlr.gg/player/19362/lyda,2024-12-12 12:00:00,1.18,1.07,1.12,188,190,184,52,24,28,46,21,25,19,12,7,0,+1,-1,73%,78%,68%,131,132,130,33%,26%,40%,3,1,2,3,0,3
53,https://vlr.gg/player/9431/cille,2024-12-12 12:00:00,1.20,0.88,1.03,194,221,166,45,27,18,53,25,28,45,19,26,0,0,0,77%,78%,76%,118,130,107,21%,27%,16%,6,3,3,6,3,3
54,https://vlr.gg/player/24140/superphrog,2024-12-12 12:00:00,1.06,0.73,0.89,178,194,163,49,28,21,55,25,30,22,11,11,-2,-2,0,65%,64%,66%,120,125,114,36%,41%,32%,4,1,3,6,3,3
55,https://vlr.gg/player/37990/adora,2024-12-12 12:00:00,0.67,1.07,0.87,223,203,245,55,24,31,63,30,33,20,8,12,-6,-5,-1,68%,67%,68%,149,134,163,29%,27%,30%,13,7,6,19,12,7
56,https://vlr.gg/player/20116/jademwah,2024-12-12 12:00:00,1.60,1.13,1.37,273,305,237,68,42,26,48,23,25,34,15,19,+4,+2,+2,85%,87%,83%,172,193,150,23%,29%,16%,10,4,6,6,2,4
57,https://vlr.gg/player/30096/bobbiexo,2024-12-12 12:00:00,1.06,0.99,1.02,168,143,191,45,22,23,43,19,24,32,13,19,+6,+4,+2,74%,79%,69%,105,86,125,29%,24%,33%,7,4,3,1,0,1
58,https://vlr.gg/player/39506/cabbit,2024-12-12 12:00:00,0.88,0.94,0.91,182,170,198,49,24,25,52,26,26,16,11,5,+2,+1,+1,69%,68%,69%,127,119,135,34%,30%,39%,6,4,2,4,3,1
59,https://vlr.gg/player/42232/auri,2024-12-12 12:00:00,0.94,0.86,0.90,220,243,200,56,30,26,59,30,29,16,12,4,+1,-4,+5,68%,71%,64%,151,167,134,32%,33%,31%,10,3,7,9,7,2
60,https://vlr.gg/player/30113/elysian,2024-12-12 12:00:00,0.66,0.77,0.71,166,179,162,43,23,20,59,31,28,26,15,11,-9,-1,-8,66%,66%,67%,113,109,116,20%,14%,29%,6,5,1,15,6,9
61,https://vlr.gg/player/729/zellsis,2024-12-12 06:15:00,1.08,1.38,1.23,223,223,224,34,16,18,31,19,12,27,9,18,+2,0,+2,85%,70%,100%,135,128,142,20%,22%,18%,3,1,2,1,1,0
62,https://vlr.gg/player/36245/n4rrate,2024-12-12 06:15:00,1.12,1.00,1.06,220,232,209,36,19,17,32,17,15,11,3,8,-4,-3,-1,70%,70%,71%,139,144,135,26%,35%,20%,3,1,2,7,4,3
63,https://vlr.gg/player/1265/johnqt,2024-12-12 06:15:00,0.47,1.55,1.02,181,121,236,29,9,20,29,20,9,16,5,11,0,-1,+1,68%,52%,83%,121,90,150,22%,14%,27%,3,1,2,3,2,1
64,https://vlr.gg/player/4004/zekken,2024-12-12 06:15:00,0.34,1.37,0.86,197,114,280,34,8,26,36,21,15,12,6,6,0,-2,+2,62%,43%,79%,121,78,163,18%,17%,18%,10,4,6,10,6,4
65,https://vlr.gg/player/3880/bang,2024-12-12 06:15:00,0.64,1.07,0.86,180,145,215,30,11,19,40,22,18,23,12,11,-1,-1,0,74%,65%,83%,109,83,134,36%,39%,33%,3,1,2,4,2,2
66,https://vlr.gg/player/9196/t3xture,2024-12-12 06:15:00,0.82,1.73,1.26,261,202,320,47,19,28,32,21,11,7,3,4,+3,-2,+5,74%,58%,91%,159,121,198,28%,33%,24%,12,5,7,9,7,2
67,https://vlr.gg/player/34974/karon,2024-12-12 06:15:00,0.84,1.32,1.08,206,171,242,36,15,21,32,21,11,9,7,2,+2,+1,+1,72%,58%,87%,129,108,152,23%,38%,17%,5,2,3,3,1,2
68,https://vlr.gg/player/2489/munchkin,2024-12-12 06:15:00,0.69,1.43,1.05,190,161,225,30,10,20,30,20,10,23,10,13,-3,-3,0,70%,63%,78%,127,114,141,19%,24%,14%,1,1,0,4,4,0
69,https://vlr.gg/player/25081/yoman,2024-12-12 06:15:00,0.86,0.92,0.89,163,164,162,28,14,14,32,18,14,11,6,5,-3,0,-3,70%,63%,78%,116,117,116,28%,35%,23%,1,1,0,4,1,3
70,https://vlr.gg/player/11600/foxy9,2024-12-12 06:15:00,0.54,0.92,0.72,173,141,208,27,11,16,37,20,17,9,4,5,+4,0,+4,66%,67%,65%,117,98,137,41%,48%,37%,6,1,5,2,1,1
71,https://vlr.gg/player/25081/yoman,2024-12-12 04:00:00,2.12,1.40,1.64,264,386,197,34,17,17,16,8,8,16,3,13,+3,+2,+1,89%,83%,92%,169,249,128,21%,33%,12%,4,2,2,1,0,1
72,https://vlr.gg/player/2489/munchkin,2024-12-12 04:00:00,0.83,1.97,1.59,294,119,357,39,6,33,15,6,9,16,3,13,+4,-1,+5,78%,58%,88%,190,91,239,32%,29%,33%,7,1,6,3,2,1
73,https://vlr.gg/player/34974/karon,2024-12-12 04:00:00,1.16,1.43,1.34,225,179,234,28,8,20,19,8,11,16,5,11,+3,+1,+2,72%,67%,75%,134,119,141,19%,33%,15%,4,1,3,1,0,1
74,https://vlr.gg/player/9196/t3xture,2024-12-12 04:00:00,0.92,1.46,1.28,248,213,264,32,9,23,20,9,11,5,1,4,+5,+2,+3,81%,58%,92%,162,137,175,26%,29%,24%,8,3,5,3,1,2
75,https://vlr.gg/player/11600/foxy9,2024-12-12 04:00:00,0.54,0.89,0.77,108,74,131,16,3,13,20,8,12,3,2,1,-5,-2,-3,72%,67%,75%,86,67,95,37%,27%,43%,0,0,0,5,2,3
76,https://vlr.gg/player/3977/crws,2024-12-12 04:00:00,1.11,0.92,1.05,211,229,192,24,16,8,30,21,9,11,9,2,+4,+3,+1,67%,71%,58%,146,155,130,30%,30%,30%,5,4,1,1,1,0
77,https://vlr.gg/player/13788/jitboys,2024-12-12 04:00:00,0.49,1.02,0.67,128,115,171,17,9,8,28,21,7,9,6,3,-3,-2,-1,53%,46%,67%,81,69,105,36%,35%,38%,2,1,1,5,3,2
78,https://vlr.gg/player/3980/governor,2024-12-12 04:00:00,0.45,0.90,0.60,124,85,213,15,6,9,29,20,9,9,6,3,-1,0,-1,61%,54%,75%,84,55,143,33%,22%,41%,2,1,1,3,1,2
79,https://vlr.gg/player/25255/primmie,2024-12-12 04:00:00,0.40,0.83,0.54,156,132,234,19,9,10,32,22,10,6,5,1,-9,-8,-1,61%,58%,67%,113,93,151,23%,23%,22%,3,1,2,12,9,3
80,https://vlr.gg/player/5129/ban,2024-12-12 04:00:00,0.45,0.67,0.53,127,136,116,15,11,4,30,22,8,4,0,4,-1,-1,0,47%,38%,67%,91,90,92,31%,39%,19%,1,1,0,2,2,0
81,https://vlr.gg/player/3880/bang,2024-12-12 00:00:00,1.09,1.19,1.13,228,209,236,61,31,30,52,29,23,25,15,10,+6,+3,+3,76%,75%,76%,137,128,147,35%,38%,33%,10,5,5,4,2,2
82,https://vlr.gg/player/729/zellsis,2024-12-12 00:00:00,1.33,0.83,1.10,191,250,144,51,36,15,47,27,20,36,21,15,-1,0,-1,81%,88%,74%,132,165,93,24%,27%,18%,5,2,3,6,2,4
83,https://vlr.gg/player/36245/n4rrate,2024-12-12 00:00:00,0.86,0.82,0.84,194,210,168,47,28,19,55,31,24,14,7,7,-2,0,-2,66%,68%,65%,135,153,113,23%,27%,18%,6,4,2,8,4,4
84,https://vlr.gg/player/4004/zekken,2024-12-12 00:00:00,0.74,0.91,0.82,190,179,195,47,25,22,56,32,24,14,9,5,-3,-6,+3,57%,55%,59%,117,109,126,14%,13%,16%,12,5,7,15,11,4
85,https://vlr.gg/player/1265/johnqt,2024-12-12 00:00:00,0.59,1.04,0.80,175,138,220,45,19,26,53,30,23,23,12,11,0,-1,+1,72%,73%,71%,114,88,145,28%,22%,32%,4,2,2,4,3,1
86,https://vlr.gg/player/13784/killua,2024-12-12 00:00:00,1.38,1.16,1.26,233,248,226,65,33,32,50,22,28,20,9,11,+2,-1,+3,74%,79%,70%,164,164,164,41%,50%,35%,7,3,4,5,4,1
87,https://vlr.gg/player/8582/laz,2024-12-12 00:00:00,1.07,1.38,1.24,234,196,263,64,26,38,48,22,26,6,1,5,+6,+5,+1,73%,74%,73%,143,114,168,35%,35%,35%,10,6,4,4,1,3
88,https://vlr.gg/player/24679/cgrs,2024-12-12 00:00:00,0.95,0.95,0.95,189,166,200,46,20,26,48,21,27,25,9,16,+2,0,+2,69%,71%,68%,127,116,136,26%,25%,27%,5,1,4,3,1,2
89,https://vlr.gg/player/27244/seph1roth,2024-12-12 00:00:00,0.95,0.77,0.85,158,176,152,40,19,21,51,23,28,27,19,8,+1,+1,0,68%,76%,60%,109,114,105,36%,46%,29%,5,1,4,4,0,4
90,https://vlr.gg/player/12098/kadoom,2024-12-12 00:00:00,0.61,1.04,0.83,184,149,227,47,15,32,54,24,30,13,5,8,-11,-9,-2,61%,44%,75%,130,103,153,28%,28%,27%,10,4,6,21,13,8
91,https://vlr.gg/player/45358/yearn,2024-12-11 19:45:00,1.23,1.40,1.32,284,267,299,38,17,21,23,12,11,4,2,2,-3,-2,-1,72%,71%,74%,189,174,202,39%,46%,34%,2,1,1,5,3,2
92,https://vlr.gg/player/35619/sxnti,2024-12-11 19:45:00,1.12,1.30,1.22,230,181,276,31,11,20,24,11,13,12,7,5,-1,+1,-2,81%,76%,84%,146,113,176,48%,58%,44%,1,1,0,2,0,2
93,https://vlr.gg/player/21428/crunch,2024-12-11 19:45:00,1.05,1.36,1.21,281,279,281,35,16,19,29,16,13,10,5,5,+6,+5,+1,81%,82%,79%,188,182,193,23%,19%,26%,11,7,4,5,2,3
94,https://vlr.gg/player/39246/allu,2024-12-11 19:45:00,1.02,1.33,1.18,226,198,248,31,13,18,21,11,10,8,5,3,+1,+1,0,75%,76%,74%,143,129,156,24%,27%,22%,3,1,2,2,0,2
95,https://vlr.gg/player/44075/dedmos,2024-12-11 19:45:00,1.01,1.02,1.02,163,152,171,22,10,12,21,10,11,11,5,6,-1,-2,+1,75%,71%,79%,112,105,118,18%,26%,13%,2,0,2,3,2,1
96,https://vlr.gg/player/38921/fotzy,2024-12-11 19:45:00,0.95,1.13,1.03,212,210,210,26,14,12,30,17,13,7,2,5,+1,0,+1,64%,63%,65%,137,145,128,35%,34%,36%,6,3,3,5,3,2
97,https://vlr.gg/player/15934/feels,2024-12-11 19:45:00,1.01,0.79,0.91,216,217,215,29,15,14,31,17,14,2,2,0,+1,+2,-1,56%,58%,53%,133,139,127,35%,54%,15%,5,2,3,4,0,4
98,https://vlr.gg/player/35559/pandejalea,2024-12-11 19:45:00,0.59,1.25,0.90,221,196,251,25,11,14,31,18,13,8,1,7,-2,0,-2,61%,68%,53%,159,148,172,28%,25%,32%,3,3,0,5,3,2
99,https://vlr.gg/player/10581/ryu,2024-12-11 19:45:00,0.72,0.56,0.64,158,199,113,19,12,7,31,19,12,14,6,8,+1,+2,-1,67%,74%,59%,113,136,86,28%,35%,17%,2,2,0,1,0,1
100,https://vlr.gg/player/8781/charlslol,2024-12-11 19:45:00,0.22,0.91,0.54,167,112,233,18,6,12,35,19,16,18,7,11,-3,-3,0,67%,68%,65%,106,82,133,25%,25%,26%,1,0,1,4,3,1
101,https://vlr.gg/player/28716/lukxo,2024-12-11 18:10:00,1.32,0.93,1.17,243,218,247,49,31,18,37,19,18,7,5,2,+1,0,+1,67%,75%,55%,149,148,151,41%,35%,53%,9,4,5,8,4,4
102,https://vlr.gg/player/5351/rglmeister,2024-12-11 18:10:00,1.23,1.08,1.17,197,190,224,41,25,16,33,18,15,23,20,3,-3,0,-3,81%,92%,64%,146,142,151,33%,36%,29%,2,2,0,5,2,3
103,https://vlr.gg/player/21659/sato,2024-12-11 18:10:00,1.45,0.55,1.11,234,329,87,51,44,7,40,25,15,6,5,1,+4,+4,0,67%,72%,59%,148,203,59,42%,41%,46%,9,8,1,5,4,1
104,https://vlr.gg/player/6238/urango,2024-12-11 18:10:00,1.04,0.66,0.85,174,183,142,33,24,9,41,24,17,8,7,1,-2,-2,0,69%,75%,59%,124,136,105,30%,38%,20%,5,3,2,7,5,2
105,https://vlr.gg/player/1566/prozin,2024-12-11 18:10:00,0.91,0.56,0.78,146,173,97,29,21,8,39,24,15,24,23,1,-6,-4,-2,64%,75%,45%,97,122,56,21%,17%,39%,1,0,1,7,4,3
106,https://vlr.gg/player/8892/snw,2024-12-11 18:10:00,0.99,1.23,1.14,252,215,270,49,17,32,44,15,29,8,3,5,+5,0,+5,71%,73%,69%,166,137,183,21%,16%,24%,16,5,11,11,5,6
107,https://vlr.gg/player/12872/david,2024-12-11 18:10:00,1.30,0.97,1.09,211,220,217,45,18,27,39,10,29,19,7,12,+7,+3,+4,78%,82%,75%,148,147,148,40%,40%,41%,9,4,5,2,1,1
108,https://vlr.gg/player/783/murizzz,2024-12-11 18:10:00,1.47,0.63,0.95,177,260,149,37,21,16,44,12,32,12,4,8,-2,+2,-4,62%,77%,53%,122,167,94,22%,27%,18%,3,2,1,5,0,5
109,https://vlr.gg/player/13860/rubkkoide,2024-12-11 18:10:00,1.17,0.77,0.92,166,153,172,33,13,20,40,11,29,22,10,12,-3,0,-3,78%,82%,75%,111,105,115,29%,27%,31%,2,1,1,5,1,4
110,https://vlr.gg/player/46901/maxhinh9,2024-12-11 18:10:00,0.95,0.62,0.74,127,135,130,26,11,15,40,10,30,10,2,8,-1,-1,0,71%,77%,67%,94,95,94,22%,21%,22%,2,1,1,3,2,1
111,https://vlr.gg/player/17694/prask,2024-12-11 18:00:00,1.02,1.18,1.11,234,198,260,35,14,21,35,16,19,7,3,4,+3,+1,+2,66%,65%,67%,155,128,177,43%,43%,43%,4,1,3,1,0,1
112,https://vlr.gg/player/8792/xhowi,2024-12-11 18:00:00,0.75,1.17,0.98,257,209,306,39,14,25,38,18,20,6,3,3,+3,0,+3,70%,70%,71%,176,142,204,38%,29%,44%,11,4,7,8,4,4
113,https://vlr.gg/player/1323/rainmaker,2024-12-11 18:00:00,0.90,0.90,0.90,181,164,203,26,11,15,34,16,18,9,3,6,+1,-1,+2,59%,65%,54%,139,123,152,45%,53%,41%,3,1,2,2,2,0
114,https://vlr.gg/player/15924/winter,2024-12-11 18:00:00,1.16,0.61,0.86,195,245,154,28,16,12,35,15,20,16,7,9,-8,-3,-5,59%,60%,58%,124,159,96,30%,29%,30%,2,1,1,10,4,6
115,https://vlr.gg/player/49876/mora,2024-12-11 18:00:00,0.67,0.91,0.80,165,151,175,26,11,15,36,17,19,13,7,6,-3,-3,0,70%,70%,71%,112,96,126,30%,43%,23%,0,0,0,3,3,0
116,https://vlr.gg/player/17669/pompz,2024-12-11 18:00:00,1.38,1.66,1.51,321,301,353,52,27,25,33,20,13,20,11,9,+1,-2,+3,84%,79%,90%,213,199,230,26%,29%,23%,4,0,4,3,2,1
117,https://vlr.gg/player/48012/hada,2024-12-11 18:00:00,1.32,1.16,1.24,262,270,243,40,23,17,32,18,14,14,8,6,+1,0,+1,77%,79%,75%,168,173,161,31%,29%,35%,8,5,3,7,5,2
118,https://vlr.gg/player/1328/javiierh,2024-12-11 18:00:00,1.13,1.00,1.07,240,248,229,37,20,17,32,17,15,21,11,10,0,0,0,82%,79%,85%,152,153,152,17%,17%,16%,7,4,3,7,4,3
119,https://vlr.gg/player/24013/navarro,2024-12-11 18:00:00,0.88,0.97,0.92,163,147,179,26,13,13,29,16,13,24,14,10,+1,0,+1,89%,92%,85%,93,88,99,20%,14%,30%,2,0,2,1,0,1
120,https://vlr.gg/player/48551/e13,2024-12-11 18:00:00,0.78,0.92,0.84,151,150,153,23,13,10,28,17,11,16,10,6,+1,0,+1,70%,71%,70%,99,98,99,40%,37%,43%,3,2,1,2,2,0
121,https://vlr.gg/player/45358/yearn,2024-12-11 16:00:00,1.07,1.38,1.25,283,219,318,42,14,28,30,13,17,6,4,2,-1,-1,0,68%,67%,70%,176,134,208,45%,31%,54%,5,2,3,6,3,3
122,https://vlr.gg/player/21428/crunch,2024-12-11 16:00:00,0.98,1.06,1.03,235,197,248,34,14,20,32,13,19,6,3,3,-3,-4,+1,59%,61%,57%,156,146,165,31%,34%,29%,6,1,5,9,5,4
123,https://vlr.gg/player/39246/allu,2024-12-11 16:00:00,0.90,0.70,0.79,179,224,153,24,13,11,31,14,17,12,5,7,-7,-3,-4,63%,67%,61%,138,159,121,31%,38%,22%,2,2,0,9,5,4
124,https://vlr.gg/player/44075/dedmos,2024-12-11 16:00:00,0.95,0.60,0.76,132,197,90,20,14,6,29,14,15,11,5,6,0,0,0,61%,61%,61%,84,117,58,9%,14%,3%,1,0,1,1,0,1
125,https://vlr.gg/player/35619/sxnti,2024-12-11 16:00:00,0.76,0.71,0.74,157,135,173,24,10,14,34,14,20,10,4,6,-2,0,-2,56%,56%,57%,115,89,136,28%,22%,33%,0,0,0,2,0,2
126,https://vlr.gg/player/8790/mininiwde,2024-12-11 16:00:00,1.56,1.39,1.48,271,294,261,41,24,17,27,14,13,19,14,5,+4,+2,+2,83%,91%,72%,169,175,161,27%,27%,27%,4,2,2,0,0,0
127,https://vlr.gg/player/24026/generalsteak,2024-12-11 16:00:00,1.66,1.23,1.47,286,328,231,42,27,15,29,16,13,21,12,9,+5,+2,+3,80%,87%,72%,184,206,155,49%,48%,50%,5,2,3,0,0,0
128,https://vlr.gg/player/2490/jfoen,2024-12-11 16:00:00,1.13,1.10,1.12,202,174,246,29,15,14,27,13,14,26,16,10,0,-1,+1,78%,83%,72%,136,104,176,26%,18%,34%,1,0,1,1,1,0
129,https://vlr.gg/player/10556/drakk,2024-12-11 16:00:00,0.59,1.33,0.92,204,161,271,29,12,17,31,20,11,7,5,2,+2,0,+2,63%,57%,72%,136,94,190,17%,11%,22%,10,5,5,8,5,3
130,https://vlr.gg/player/8902/vapes,2024-12-11 16:00:00,0.73,0.42,0.60,113,129,94,15,10,5,30,16,14,11,5,6,+2,+2,0,63%,65%,61%,70,78,60,33%,32%,33%,7,5,2,5,3,2
131,https://vlr.gg/player/1311/melser,2024-12-11 15:00:00,0.86,1.21,1.04,166,164,169,38,17,21,37,22,15,14,8,6,+3,+1,+2,68%,59%,77%,99,100,99,29%,23%,35%,7,3,4,4,2,2
132,https://vlr.gg/player/2462/keznit,2024-12-11 15:00:00,0.65,1.39,1.03,228,179,270,46,16,30,49,26,23,14,7,7,-4,-9,+5,62%,59%,65%,157,124,188,18%,18%,19%,8,1,7,12,10,2
133,https://vlr.gg/player/7603/mazino,2024-12-11 15:00:00,1.04,0.60,0.81,156,200,127,34,22,12,46,23,23,20,7,13,-1,-1,0,58%,59%,58%,103,130,77,23%,26%,18%,5,2,3,6,3,3
134,https://vlr.gg/player/24007/shyy,2024-12-11 15:00:00,0.54,0.78,0.67,126,126,129,24,11,13,45,25,20,14,7,7,-2,0,-2,70%,62%,77%,89,87,92,20%,26%,16%,3,1,2,5,1,4
135,https://vlr.gg/player/3826/adverso,2024-12-11 15:00:00,0.49,0.78,0.63,138,99,176,29,10,19,47,24,23,13,4,9,-6,-6,0,52%,48%,55%,84,60,106,19%,23%,17%,2,0,2,8,6,2
136,https://vlr.gg/player/939/mwzera,2024-12-11 15:00:00,1.12,1.42,1.26,240,194,278,53,23,30,33,16,17,14,6,8,+3,+1,+2,82%,81%,83%,149,117,184,22%,21%,24%,5,1,4,2,0,2
137,https://vlr.gg/player/8706/havoc,2024-12-11 15:00:00,1.10,1.28,1.19,245,237,249,50,24,26,39,22,17,9,5,4,+8,0,+8,80%,77%,83%,162,162,162,30%,38%,23%,17,8,9,9,8,1
138,https://vlr.gg/player/1711/khalil,2024-12-11 15:00:00,1.11,1.19,1.15,195,203,184,40,21,19,31,18,13,24,8,16,+2,+1,+1,85%,77%,93%,122,125,119,31%,39%,26%,2,1,1,0,0,0
139,https://vlr.gg/player/8673/heat,2024-12-11 15:00:00,1.09,1.13,1.11,177,190,167,42,21,21,31,18,13,5,1,4,+1,-1,+2,70%,65%,76%,127,143,109,34%,35%,33%,5,1,4,4,2,2
140,https://vlr.gg/player/25743/raafa,2024-12-11 15:00:00,0.66,1.27,0.96,183,127,245,38,14,24,37,21,16,18,5,13,-4,-6,+2,73%,58%,90%,122,90,156,25%,34%,21%,6,2,4,10,8,2
141,https://vlr.gg/player/35013/flashback,2024-12-11 06:15:00,1.25,1.50,1.39,234,222,251,60,22,38,40,18,22,16,6,10,+3,+1,+2,87%,74%,97%,163,163,163,30%,33%,27%,5,2,3,2,1,1
142,https://vlr.gg/player/4462/mako,2024-12-11 06:15:00,1.51,1.11,1.28,191,238,150,54,26,28,37,17,20,26,13,13,-2,-1,-1,86%,81%,89%,123,156,98,38%,54%,24%,3,0,3,5,1,4
143,https://vlr.gg/player/1916/free1ng,2024-12-11 06:15:00,0.89,0.99,0.95,150,171,137,35,17,18,40,19,21,15,8,7,-6,-4,-2,73%,70%,75%,101,109,95,38%,40%,35%,2,1,1,8,5,3
144,https://vlr.gg/player/28400/hyunmin,2024-12-11 06:15:00,0.57,1.17,0.91,199,179,216,45,16,29,50,25,25,19,11,8,-6,-8,+2,76%,67%,83%,127,110,140,32%,30%,33%,8,3,5,14,11,3
145,https://vlr.gg/player/34982/athan,2024-12-11 06:15:00,0.73,0.88,0.82,144,155,143,37,13,24,43,21,22,25,9,16,-2,-3,+1,71%,59%,81%,98,110,89,28%,32%,24%,4,0,4,6,3,3
146,https://vlr.gg/player/10698/nephh,2024-12-11 06:15:00,1.01,1.24,1.11,191,175,220,49,21,28,45,23,22,28,14,14,+3,-1,+4,79%,78%,81%,129,120,141,20%,19%,21%,4,0,4,1,1,0
147,https://vlr.gg/player/4774/knight,2024-12-11 06:15:00,0.83,1.26,1.02,170,125,238,40,15,25,43,21,22,25,12,13,+4,-1,+5,79%,83%,74%,113,86,149,17%,16%,18%,7,2,5,3,3,0
148,https://vlr.gg/player/4885/whzy,2024-12-11 06:15:00,0.66,1.16,0.87,211,147,302,53,17,36,51,26,25,15,5,10,+7,+1,+6,75%,81%,67%,145,99,207,30%,36%,27%,16,7,9,9,6,3
149,https://vlr.gg/player/40845/levius,2024-12-11 06:15:00,0.83,0.85,0.84,173,167,181,38,20,18,48,23,25,16,3,13,+3,+2,+1,70%,69%,70%,108,101,116,22%,31%,14%,5,4,1,2,2,0
150,https://vlr.gg/player/48878/rushia,2024-12-11 06:15:00,0.75,0.69,0.73,114,109,123,30,14,16,44,23,21,34,11,23,-4,-3,-1,75%,72%,78%,71,65,78,18%,23%,14%,3,1,2,7,4,3
151,https://vlr.gg/player/22047/rarga,2024-12-11 06:00:00,,,,262,,,48,,,34,,,18,,,,,,,,,,,,,,,,,,,,
152,https://vlr.gg/player/37927/happywei,2024-12-11 06:00:00,,,,240,,,40,,,43,,,10,,,,,,,,,,,,,,,,,,,,
153,https://vlr.gg/player/12365/coconut,2024-12-11 06:00:00,,,,222,,,40,,,31,,,11,,,,,,,,,,,,,,,,,,,,
154,https://vlr.gg/player/4763/zixuan,2024-12-11 06:00:00,,,,209,,,32,,,44,,,25,,,,,,,,,,,,,,,,,,,,
155,https://vlr.gg/player/4710/you,2024-12-11 06:00:00,,,,182,,,30,,,35,,,19,,,,,,,,,,,,,,,,,,,,
156,https://vlr.gg/player/13768/s1mon,2024-12-11 06:00:00,,,,249,,,41,,,37,,,17,,,,,,,,,,,,,,,,,,,,
157,https://vlr.gg/player/3520/zmjjkk,2024-12-11 06:00:00,,,,224,,,40,,,42,,,6,,,,,,,,,,,,,,,,,,,,
158,https://vlr.gg/player/3017/nobody,2024-12-11 06:00:00,,,,211,,,37,,,38,,,9,,,,,,,,,,,,,,,,,,,,
159,https://vlr.gg/player/4742/smoggy,2024-12-11 06:00:00,,,,210,,,38,,,32,,,11,,,,,,,,,,,,,,,,,,,,
160,https://vlr.gg/player/15559/chichoo,2024-12-11 06:00:00,,,,178,,,31,,,41,,,14,,,,,,,,,,,,,,,,,,,,
161,https://vlr.gg/player/37494/kai,2024-12-11 04:10:00,,,,336,,,46,,,31,,,5,,,,,,,,,,,,,,,,,,,,
162,https://vlr.gg/player/4770/fengf,2024-12-11 04:10:00,,,,239,,,34,,,24,,,12,,,,,,,,,,,,,,,,,,,,
163,https://vlr.gg/player/3021/biank,2024-12-11 04:10:00,,,,224,,,29,,,27,,,16,,,,,,,,,,,,,,,,,,,,
164,https://vlr.gg/player/3045/luok1ng,2024-12-11 04:10:00,,,,194,,,26,,,16,,,27,,,,,,,,,,,,,,,,,,,,
165,https://vlr.gg/player/4712/heybay,2024-12-11 04:10:00,,,,153,,,23,,,23,,,15,,,,,,,,,,,,,,,,,,,,
166,https://vlr.gg/player/10821/delb,2024-12-11 04:10:00,,,,229,,,34,,,29,,,3,,,,,,,,,,,,,,,,,,,,
167,https://vlr.gg/player/46748/k1ra,2024-12-11 04:10:00,,,,185,,,24,,,33,,,12,,,,,,,,,,,,,,,,,,,,
168,https://vlr.gg/player/14431/monk,2024-12-11 04:10:00,,,,179,,,21,,,31,,,17,,,,,,,,,,,,,,,,,,,,
169,https://vlr.gg/player/4880/nizhaotzh,2024-12-11 04:10:00,,,,147,,,22,,,32,,,10,,,,,,,,,,,,,,,,,,,,
170,https://vlr.gg/player/49870/carl,2024-12-11 04:10:00,,,,131,,,20,,,33,,,2,,,,,,,,,,,,,,,,,,,,
171,https://vlr.gg/player/14209/suka,2024-12-11 03:00:00,1.46,0.96,1.20,214,249,178,47,29,18,36,15,21,27,14,13,0,0,0,78%,79%,77%,148,171,126,37%,36%,37%,3,2,1,3,2,1
172,https://vlr.gg/player/14254/gin,2024-12-11 03:00:00,1.00,1.33,1.17,221,227,218,49,25,24,39,21,18,6,3,3,+8,+2,+6,72%,69%,74%,146,146,145,41%,39%,43%,14,6,8,6,4,2
173,https://vlr.gg/player/23042/tripciew,2024-12-11 03:00:00,1.07,0.86,0.96,171,163,183,35,16,19,36,14,22,19,9,10,-2,+1,-3,68%,76%,61%,116,110,122,34%,35%,33%,4,2,2,6,1,5
174,https://vlr.gg/player/19154/albus,2024-12-11 03:00:00,1.09,0.83,0.96,179,194,165,37,21,16,40,18,22,23,13,10,0,+2,-2,72%,79%,65%,120,124,116,21%,23%,19%,4,3,1,4,1,3
175,https://vlr.gg/player/44149/pr0digy,2024-12-11 03:00:00,0.83,0.89,0.86,184,170,192,42,19,23,46,21,25,12,5,7,-6,-4,-2,62%,69%,55%,113,107,119,32%,28%,35%,5,2,3,11,6,5
176,https://vlr.gg/player/21668/verno,2024-12-11 03:00:00,1.41,1.22,1.32,229,241,219,47,27,20,35,17,18,23,11,12,+3,+3,0,77%,81%,72%,149,151,145,25%,26%,25%,6,4,2,3,1,2
177,https://vlr.gg/player/817/finesse,2024-12-11 03:00:00,1.10,1.16,1.13,217,194,242,43,20,23,41,18,23,23,11,12,+2,0,+2,77%,71%,83%,151,142,160,26%,38%,19%,5,1,4,3,1,2
178,https://vlr.gg/player/4164/s0m,2024-12-11 03:00:00,0.76,1.09,0.92,163,150,177,37,17,20,42,22,20,27,12,15,-4,-3,-1,72%,71%,72%,105,102,108,41%,34%,48%,4,3,1,8,6,2
179,https://vlr.gg/player/11225/ethan,2024-12-11 03:00:00,0.88,0.82,0.85,166,158,178,32,16,16,46,21,25,32,21,11,+1,-1,+2,72%,81%,62%,110,110,111,25%,29%,21%,7,3,4,6,4,2
180,https://vlr.gg/player/5132/mada,2024-12-11 03:00:00,1.17,0.45,0.82,187,244,127,38,28,10,46,22,24,19,7,12,-2,+2,-4,67%,74%,59%,116,144,87,23%,28%,12%,8,5,3,10,3,7
181,https://vlr.gg/player/3547/ninebody,2024-12-11 02:00:00,,,,260,,,31,,,31,,,7,,,,,,,,,,,,,,,,,,,,
182,https://vlr.gg/player/47101/5cm,2024-12-11 02:00:00,,,,178,,,23,,,32,,,11,,,,,,,,,,,,,,,,,,,,
183,https://vlr.gg/player/6024/glxad,2024-12-11 02:00:00,,,,155,,,19,,,30,,,14,,,,,,,,,,,,,,,,,,,,
184,https://vlr.gg/player/41739/slowly,2024-12-11 02:00:00,,,,140,,,18,,,32,,,6,,,,,,,,,,,,,,,,,,,,
185,https://vlr.gg/player/7135/hfmi0dzjc9z7,2024-12-11 02:00:00,,,,119,,,14,,,34,,,9,,,,,,,,,,,,,,,,,,,,
186,https://vlr.gg/player/41054/guang,2024-12-11 02:00:00,,,,323,,,45,,,18,,,8,,,,,,,,,,,,,,,,,,,,
187,https://vlr.gg/player/39697/cb,2024-12-11 02:00:00,,,,271,,,36,,,22,,,13,,,,,,,,,,,,,,,,,,,,
188,https://vlr.gg/player/36670/obone,2024-12-11 02:00:00,,,,214,,,27,,,23,,,22,,,,,,,,,,,,,,,,,,,,
189,https://vlr.gg/player/1209/swerl,2024-12-11 02:00:00,,,,212,,,28,,,21,,,8,,,,,,,,,,,,,,,,,,,,
190,https://vlr.gg/player/4402/o0o0o,2024-12-11 02:00:00,,,,179,,,23,,,21,,,20,,,,,,,,,,,,,,,,,,,,
191,https://vlr.gg/player/8057/josegxbo,2024-12-10 20:00:00,1.47,1.15,1.35,258,283,250,35,24,11,27,16,11,19,9,10,+2,+1,+1,87%,88%,86%,185,195,168,37%,38%,34%,3,2,1,1,1,0
192,https://vlr.gg/player/46891/sventy,2024-12-10 20:00:00,1.35,0.87,1.17,274,292,225,38,26,12,30,18,12,4,3,1,-2,+1,-3,79%,83%,71%,184,195,164,33%,37%,27%,5,4,1,7,3,4
193,https://vlr.gg/player/7618/theory,2024-12-10 20:00:00,0.82,1.75,1.16,190,117,318,30,12,18,23,14,9,10,6,4,-1,-1,0,74%,67%,86%,126,81,204,45%,43%,46%,3,2,1,4,3,1
194,https://vlr.gg/player/12955/danger,2024-12-10 20:00:00,1.21,0.67,1.01,225,240,168,28,21,7,29,17,12,11,6,5,-1,-1,0,68%,67%,71%,144,164,110,28%,31%,22%,5,3,2,6,4,2
195,https://vlr.gg/player/35583/edu,2024-12-10 20:00:00,0.74,0.81,0.76,141,137,138,20,12,8,28,17,11,19,12,7,-2,-2,0,76%,79%,71%,97,92,107,41%,36%,53%,1,0,1,3,2,1
196,https://vlr.gg/player/1328/javiierh,2024-12-10 20:00:00,0.72,1.40,1.15,275,231,321,39,13,26,31,12,19,8,4,4,+3,-2,+5,68%,64%,71%,174,129,199,26%,19%,29%,8,1,7,5,3,2
197,https://vlr.gg/player/17669/pompz,2024-12-10 20:00:00,1.19,0.92,1.02,202,218,186,29,11,18,28,9,19,6,2,4,-4,-1,-3,71%,79%,67%,146,159,139,26%,38%,22%,0,0,0,4,1,3
198,https://vlr.gg/player/48012/hada,2024-12-10 20:00:00,1.46,0.67,0.96,197,342,131,26,16,10,29,12,17,10,5,5,+4,+5,-1,74%,86%,67%,138,212,94,16%,18%,14%,6,5,1,2,0,2
199,https://vlr.gg/player/24013/navarro,2024-12-10 20:00:00,0.89,0.83,0.85,165,152,180,21,7,14,30,11,19,22,9,13,0,+1,-1,79%,93%,71%,108,89,120,26%,22%,29%,3,1,2,3,0,3
200,https://vlr.gg/player/35567/toro,2024-12-10 20:00:00,0.75,0.66,0.69,185,160,188,22,8,14,33,12,21,18,9,9,+1,-1,+2,74%,71%,75%,106,95,113,33%,44%,28%,4,1,3,3,2,1
201,https://vlr.gg/player/2490/jfoen,2024-12-10 18:00:00,1.10,1.31,1.20,223,195,249,39,16,23,33,18,15,24,16,8,-1,-1,0,79%,74%,83%,137,109,164,26%,17%,32%,5,2,3,6,3,3
202,https://vlr.gg/player/24026/generalsteak,2024-12-10 18:00:00,1.06,1.19,1.13,211,221,201,33,17,16,32,19,13,25,10,15,-2,-1,-1,83%,83%,83%,131,137,126,38%,38%,39%,2,1,1,4,2,2
203,https://vlr.gg/player/8790/mininiwde,2024-12-10 18:00:00,1.08,0.97,1.02,213,219,208,35,17,18,37,19,18,16,5,11,-3,-1,-2,79%,87%,71%,138,137,139,24%,28%,21%,1,0,1,4,1,3
204,https://vlr.gg/player/10556/drakk,2024-12-10 18:00:00,0.60,1.14,0.88,230,186,273,37,14,23,40,21,19,10,4,6,-2,-7,+5,72%,61%,83%,148,118,177,27%,29%,26%,8,3,5,10,10,0
205,https://vlr.gg/player/8902/vapes,2024-12-10 18:00:00,0.44,1.27,0.86,186,119,249,30,9,21,37,22,15,13,4,9,+3,-1,+4,77%,65%,88%,126,92,159,30%,30%,30%,5,0,5,2,1,1
206,https://vlr.gg/player/15934/feels,2024-12-10 18:00:00,1.11,1.22,1.17,223,208,239,37,17,20,32,18,14,13,9,4,-1,-2,+1,77%,71%,83%,152,152,152,29%,29%,30%,4,2,2,5,4,1
207,https://vlr.gg/player/8781/charlslol,2024-12-10 18:00:00,0.93,1.35,1.13,247,235,261,42,19,23,36,22,14,17,8,9,+3,+1,+2,83%,79%,87%,153,143,165,26%,25%,27%,5,3,2,2,2,0
208,https://vlr.gg/player/35559/pandejalea,2024-12-10 18:00:00,0.79,1.32,1.05,227,196,258,38,15,23,36,21,15,16,8,8,0,-1,+1,74%,71%,78%,137,117,158,31%,28%,33%,6,3,3,6,4,2
209,https://vlr.gg/player/10581/ryu,2024-12-10 18:00:00,1.03,1.05,1.04,213,197,234,38,19,19,32,17,15,9,3,6,+3,-1,+4,77%,71%,83%,144,140,148,30%,38%,24%,5,0,5,2,1,1
210,https://vlr.gg/player/38921/fotzy,2024-12-10 18:00:00,0.28,0.80,0.53,146,118,173,24,10,14,39,23,16,12,3,9,0,-3,+3,66%,54%,78%,90,75,106,41%,40%,41%,6,1,5,6,4,2
211,https://vlr.gg/player/8706/havoc,2024-12-10 17:15:00,1.15,1.43,1.28,245,223,259,51,23,28,34,18,16,2,1,1,+5,+2,+3,68%,62%,75%,155,147,164,32%,31%,32%,11,5,6,6,3,3
212,https://vlr.gg/player/939/mwzera,2024-12-10 17:15:00,1.09,1.36,1.22,208,196,225,43,19,24,33,17,16,17,6,11,+7,+4,+3,82%,76%,89%,131,112,149,23%,22%,25%,7,4,3,0,0,0
213,https://vlr.gg/player/25743/raafa,2024-12-10 17:15:00,0.91,1.21,1.06,206,205,199,40,21,19,40,23,17,25,10,15,+4,+2,+2,68%,66%,71%,124,126,121,18%,14%,23%,8,4,4,4,2,2
214,https://vlr.gg/player/1711/khalil,2024-12-10 17:15:00,0.99,0.96,0.97,172,171,179,37,19,18,38,17,21,20,8,12,-3,-4,+1,81%,76%,86%,112,105,120,26%,27%,25%,2,0,2,5,4,1
215,https://vlr.gg/player/8673/heat,2024-12-10 17:15:00,0.80,0.86,0.83,178,173,181,35,17,18,41,19,22,10,2,8,-4,-1,-3,65%,66%,64%,122,126,117,41%,40%,42%,5,3,2,9,4,5
216,https://vlr.gg/player/8892/snw,2024-12-10 17:15:00,1.13,1.21,1.17,257,294,235,55,30,25,44,23,21,4,1,3,+1,-2,+3,68%,75%,62%,161,174,148,40%,35%,48%,14,7,7,13,9,4
217,https://vlr.gg/player/783/murizzz,2024-12-10 17:15:00,0.87,1.16,1.02,203,172,231,40,16,24,40,20,20,13,8,5,-4,-2,-2,70%,75%,66%,140,125,154,31%,35%,29%,4,1,3,8,3,5
218,https://vlr.gg/player/13860/rubkkoide,2024-12-10 17:15:00,0.84,1.08,0.96,181,176,190,36,18,18,39,21,18,21,12,9,+3,+2,+1,75%,71%,79%,123,116,129,37%,39%,36%,4,3,1,1,1,0
219,https://vlr.gg/player/12872/david,2024-12-10 17:15:00,0.89,0.66,0.77,162,194,136,32,18,14,43,22,21,18,14,4,-3,-1,-2,70%,79%,62%,120,131,109,45%,38%,59%,1,0,1,4,1,3
220,https://vlr.gg/player/46901/maxhinh9,2024-12-10 17:15:00,0.50,0.68,0.58,119,99,141,23,10,13,41,21,20,10,4,6,-6,-3,-3,70%,71%,69%,80,68,91,15%,28%,9%,1,0,1,7,3,4
221,https://vlr.gg/player/46891/sventy,2024-12-10 16:00:00,1.20,1.40,1.29,277,260,297,45,23,22,33,19,14,11,5,6,+6,+1,+5,78%,79%,76%,171,164,178,41%,39%,44%,11,4,7,5,3,2
222,https://vlr.gg/player/7618/theory,2024-12-10 16:00:00,0.90,1.54,1.20,223,187,266,36,16,20,26,16,10,8,2,6,-5,-3,-2,69%,67%,71%,155,127,186,32%,36%,29%,2,2,0,7,5,2
223,https://vlr.gg/player/35583/edu,2024-12-10 16:00:00,0.55,1.57,1.03,181,117,253,28,9,19,27,18,9,13,8,5,-1,-2,+1,73%,63%,86%,126,85,174,29%,28%,29%,4,1,3,5,3,2
224,https://vlr.gg/player/8057/josegxbo,2024-12-10 16:00:00,0.90,1.00,0.95,180,169,188,27,13,14,30,18,12,23,10,13,+2,+1,+1,69%,63%,76%,130,131,129,30%,29%,31%,2,1,1,0,0,0
225,https://vlr.gg/player/12955/danger,2024-12-10 16:00:00,0.88,0.88,0.88,173,182,162,26,14,12,34,19,15,15,6,9,+3,+3,0,64%,63%,67%,113,123,102,30%,37%,23%,6,4,2,3,1,2
226,https://vlr.gg/player/49876/mora,2024-12-10 16:00:00,1.17,1.59,1.39,245,218,273,40,15,25,29,15,14,14,4,10,0,0,0,73%,52%,92%,153,136,168,31%,29%,33%,1,1,0,1,1,0
227,https://vlr.gg/player/17694/prask,2024-12-10 16:00:00,0.94,1.10,1.02,228,231,224,37,17,20,33,18,15,6,2,4,+2,0,+2,69%,71%,67%,142,151,134,33%,44%,24%,6,2,4,4,2,2
228,https://vlr.gg/player/586/sickly,2024-12-10 16:00:00,0.75,1.23,1.01,188,174,198,30,13,17,27,16,11,11,4,7,+1,-1,+2,73%,57%,88%,108,107,109,36%,48%,28%,4,2,2,3,3,0
229,https://vlr.gg/player/1323/rainmaker,2024-12-10 16:00:00,0.65,1.03,0.85,152,129,171,23,10,13,32,17,15,15,3,12,-4,-1,-3,69%,57%,79%,100,82,116,45%,45%,44%,2,1,1,6,2,4
230,https://vlr.gg/player/15924/winter,2024-12-10 16:00:00,0.11,0.82,0.48,160,94,215,20,5,15,41,21,20,14,2,12,-4,-3,-1,62%,48%,75%,115,69,156,30%,23%,33%,7,2,5,11,5,6
231,https://vlr.gg/player/2462/keznit,2024-12-10 15:00:00,2.23,1.25,1.61,295,418,227,42,22,20,20,6,14,9,4,5,+11,+6,+5,82%,86%,79%,186,257,144,19%,35%,6%,12,6,6,1,0,1
232,https://vlr.gg/player/1311/melser,2024-12-10 15:00:00,1.35,1.51,1.45,239,165,274,32,8,24,16,4,12,12,7,5,+4,+2,+2,82%,86%,79%,155,123,174,28%,39%,25%,5,2,3,1,0,1
233,https://vlr.gg/player/7603/mazino,2024-12-10 15:00:00,1.30,1.52,1.44,235,209,249,34,11,23,22,7,15,24,10,14,+2,-1,+3,87%,86%,88%,156,138,167,35%,31%,37%,3,0,3,1,1,0
234,https://vlr.gg/player/24007/shyy,2024-12-10 15:00:00,1.60,0.92,1.17,227,209,234,31,12,19,22,4,18,14,5,9,0,0,0,84%,79%,88%,144,133,150,26%,37%,22%,3,1,2,3,1,2
235,https://vlr.gg/player/3826/adverso,2024-12-10 15:00:00,0.96,0.52,0.68,144,159,130,18,9,9,24,8,16,10,3,7,-1,-1,0,76%,71%,79%,94,114,83,25%,27%,23%,4,1,3,5,2,3
236,https://vlr.gg/player/5351/rglmeister,2024-12-10 15:00:00,1.50,0.85,1.26,214,228,180,26,19,7,25,14,11,18,16,2,-1,0,-1,66%,79%,43%,136,139,130,32%,38%,24%,1,0,1,2,0,2
237,https://vlr.gg/player/28716/lukxo,2024-12-10 15:00:00,1.27,0.67,1.05,241,280,180,31,24,7,31,19,12,6,4,2,-5,-3,-2,61%,67%,50%,166,188,130,26%,23%,40%,3,2,1,8,5,3
238,https://vlr.gg/player/21659/sato,2024-12-10 15:00:00,0.97,0.70,0.87,208,248,183,28,20,8,33,20,13,5,4,1,-3,-2,-1,68%,75%,57%,141,154,117,28%,30%,22%,5,3,2,8,5,3
239,https://vlr.gg/player/1566/prozin,2024-12-10 15:00:00,0.36,0.34,0.35,89,85,95,10,5,5,34,21,13,11,8,3,-2,-1,-1,61%,67%,50%,60,59,61,17%,12%,27%,0,0,0,2,1,1
240,https://vlr.gg/player/6238/urango,2024-12-10 15:00:00,0.29,0.08,0.18,85,99,52,9,7,2,34,21,13,6,6,0,-5,-4,-1,42%,54%,21%,56,68,36,17%,23%,6%,2,2,0,7,6,1
241,https://vlr.gg/player/24679/cgrs,2024-12-10 06:30:00,0.98,1.42,1.19,199,163,237,47,19,28,37,20,17,15,8,7,+2,-1,+3,77%,69%,87%,123,98,150,23%,24%,22%,5,1,4,3,2,1
242,https://vlr.gg/player/12098/kadoom,2024-12-10 06:30:00,0.94,1.25,1.09,236,229,245,48,24,24,46,27,19,12,2,10,-1,+3,-4,69%,59%,80%,162,148,177,23%,27%,19%,12,9,3,13,6,7
243,https://vlr.gg/player/13784/killua,2024-12-10 06:30:00,0.91,1.13,1.02,200,206,193,43,22,21,43,24,19,13,2,11,-2,+2,-4,66%,66%,67%,142,138,146,33%,30%,37%,4,4,0,6,2,4
244,https://vlr.gg/player/8582/laz,2024-12-10 06:30:00,0.82,1.19,1.00,187,170,206,42,20,22,43,24,19,14,7,7,-2,-3,+1,77%,72%,83%,129,111,149,30%,34%,28%,3,0,3,5,3,2
245,https://vlr.gg/player/27244/seph1roth,2024-12-10 06:30:00,0.77,0.88,0.82,140,113,171,33,14,19,39,21,18,20,10,10,-7,-3,-4,65%,63%,67%,90,77,105,27%,32%,24%,2,1,1,9,4,5
246,https://vlr.gg/player/25255/primmie,2024-12-10 06:30:00,1.02,1.52,1.27,272,260,287,65,30,35,41,24,17,3,0,3,+5,0,+5,77%,70%,84%,162,155,169,27%,33%,22%,11,4,7,6,4,2
247,https://vlr.gg/player/13788/jitboys,2024-12-10 06:30:00,0.88,1.09,0.99,166,158,173,34,16,18,41,22,19,28,8,20,-1,+2,-3,63%,60%,66%,114,112,116,25%,29%,23%,4,3,1,5,1,4
248,https://vlr.gg/player/3980/governor,2024-12-10 06:30:00,0.75,1.14,0.96,188,129,244,41,14,27,41,20,21,12,3,9,-3,-3,0,65%,57%,72%,120,89,150,30%,35%,28%,6,1,5,9,4,5
249,https://vlr.gg/player/5129/ban,2024-12-10 06:30:00,0.88,0.83,0.86,194,221,172,43,22,21,47,24,23,6,4,2,+6,+5,+1,68%,63%,72%,139,156,122,31%,35%,27%,9,7,2,3,2,1
250,https://vlr.gg/player/3977/crws,2024-12-10 06:30:00,0.57,0.88,0.73,133,128,138,25,10,15,43,24,19,26,10,16,+3,+4,-1,63%,50%,75%,94,91,96,26%,28%,25%,6,4,2,3,0,3
251,https://vlr.gg/player/4770/fengf,2024-12-10 06:00:00,,,,236,,,47,,,46,,,12,,,,,,,,,,,,,,,,,,,,
252,https://vlr.gg/player/3045/luok1ng,2024-12-10 06:00:00,,,,233,,,47,,,35,,,37,,,,,,,,,,,,,,,,,,,,
253,https://vlr.gg/player/3021/biank,2024-12-10 06:00:00,,,,183,,,42,,,44,,,24,,,,,,,,,,,,,,,,,,,,
254,https://vlr.gg/player/4712/heybay,2024-12-10 06:00:00,,,,174,,,38,,,39,,,30,,,,,,,,,,,,,,,,,,,,
255,https://vlr.gg/player/37494/kai,2024-12-10 06:00:00,,,,173,,,36,,,47,,,13,,,,,,,,,,,,,,,,,,,,
256,https://vlr.gg/player/1209/swerl,2024-12-10 06:00:00,,,,235,,,51,,,43,,,13,,,,,,,,,,,,,,,,,,,,
257,https://vlr.gg/player/46460/ezeir,2024-12-10 06:00:00,,,,225,,,47,,,42,,,32,,,,,,,,,,,,,,,,,,,,
258,https://vlr.gg/player/41054/guang,2024-12-10 06:00:00,,,,213,,,49,,,38,,,11,,,,,,,,,,,,,,,,,,,,
259,https://vlr.gg/player/4402/o0o0o,2024-12-10 06:00:00,,,,159,,,37,,,41,,,13,,,,,,,,,,,,,,,,,,,,
260,https://vlr.gg/player/39697/cb,2024-12-10 06:00:00,,,,140,,,25,,,46,,,22,,,,,,,,,,,,,,,,,,,,
261,https://vlr.gg/player/41739/slowly,2024-12-10 04:00:00,,,,234,,,31,,,30,,,2,,,,,,,,,,,,,,,,,,,,
262,https://vlr.gg/player/7135/hfmi0dzjc9z7,2024-12-10 04:00:00,,,,207,,,28,,,32,,,10,,,,,,,,,,,,,,,,,,,,
263,https://vlr.gg/player/47101/5cm,2024-12-10 04:00:00,,,,163,,,20,,,34,,,12,,,,,,,,,,,,,,,,,,,,
264,https://vlr.gg/player/3547/ninebody,2024-12-10 04:00:00,,,,151,,,19,,,31,,,4,,,,,,,,,,,,,,,,,,,,
265,https://vlr.gg/player/6024/glxad,2024-12-10 04:00:00,,,,102,,,13,,,32,,,9,,,,,,,,,,,,,,,,,,,,
266,https://vlr.gg/player/14431/monk,2024-12-10 04:00:00,,,,261,,,36,,,23,,,10,,,,,,,,,,,,,,,,,,,,
267,https://vlr.gg/player/49870/carl,2024-12-10 04:00:00,,,,250,,,32,,,26,,,10,,,,,,,,,,,,,,,,,,,,
268,https://vlr.gg/player/4880/nizhaotzh,2024-12-10 04:00:00,,,,223,,,37,,,19,,,8,,,,,,,,,,,,,,,,,,,,
269,https://vlr.gg/player/46748/k1ra,2024-12-10 04:00:00,,,,199,,,27,,,22,,,18,,,,,,,,,,,,,,,,,,,,
270,https://vlr.gg/player/10821/delb,2024-12-10 04:00:00,,,,185,,,27,,,21,,,4,,,,,,,,,,,,,,,,,,,,
271,https://vlr.gg/player/1265/johnqt,2024-12-10 03:00:00,1.23,1.19,1.21,180,189,167,33,18,15,27,15,12,20,11,9,-1,0,-1,86%,77%,96%,131,135,126,32%,34%,29%,0,0,0,1,0,1
272,https://vlr.gg/player/36245/n4rrate,2024-12-10 03:00:00,1.03,1.27,1.14,235,215,249,40,19,21,30,18,12,21,12,9,-3,-4,+1,78%,69%,88%,149,134,166,24%,27%,21%,5,2,3,8,6,2
273,https://vlr.gg/player/4004/zekken,2024-12-10 03:00:00,0.90,1.30,1.09,222,204,257,40,18,22,36,21,15,9,6,3,+5,+1,+4,72%,65%,79%,141,126,157,23%,28%,20%,11,6,5,6,5,1
274,https://vlr.gg/player/729/zellsis,2024-12-10 03:00:00,1.08,1.08,1.08,196,183,205,30,15,15,32,15,17,40,17,23,-3,-1,-2,80%,69%,92%,127,119,137,23%,28%,20%,3,1,2,6,2,4
275,https://vlr.gg/player/3880/bang,2024-12-10 03:00:00,0.83,1.32,1.07,208,156,260,37,14,23,33,17,16,17,8,9,+1,-2,+3,70%,62%,79%,123,101,147,24%,20%,28%,5,1,4,4,3,1
276,https://vlr.gg/player/34974/karon,2024-12-10 03:00:00,0.88,1.16,1.03,189,165,200,31,14,17,36,19,17,24,7,17,+3,+1,+2,72%,71%,73%,114,102,126,35%,39%,31%,4,1,3,1,0,1
277,https://vlr.gg/player/2489/munchkin,2024-12-10 03:00:00,0.75,1.08,0.92,174,162,196,32,15,17,35,19,16,13,4,9,0,0,0,66%,58%,73%,115,92,137,32%,34%,31%,2,1,1,2,1,1
278,https://vlr.gg/player/25081/yoman,2024-12-10 03:00:00,1.05,0.78,0.91,156,180,131,28,16,12,33,16,17,14,8,6,-3,-2,-1,66%,71%,62%,107,126,90,17%,23%,13%,1,1,0,4,3,1
279,https://vlr.gg/player/9196/t3xture,2024-12-10 03:00:00,0.48,1.05,0.77,181,145,217,31,11,20,37,21,16,4,3,1,-3,-7,+4,66%,63%,69%,111,93,127,29%,28%,30%,11,2,9,14,9,5
280,https://vlr.gg/player/11600/foxy9,2024-12-10 03:00:00,0.54,0.95,0.76,177,139,209,31,11,20,39,21,18,7,3,4,+4,+3,+1,66%,63%,69%,122,97,146,29%,21%,34%,7,4,3,3,1,2
281,https://vlr.gg/player/3519/jkuro,2024-12-10 02:00:00,,,,311,,,39,,,22,,,9,,,,,,,,,,,,,,,,,,,,
282,https://vlr.gg/player/41029/z1yan,2024-12-10 02:00:00,,,,250,,,30,,,15,,,18,,,,,,,,,,,,,,,,,,,,
283,https://vlr.gg/player/16924/stew,2024-12-10 02:00:00,,,,247,,,29,,,19,,,15,,,,,,,,,,,,,,,,,,,,
284,https://vlr.gg/player/36415/viva,2024-12-10 02:00:00,,,,247,,,30,,,15,,,15,,,,,,,,,,,,,,,,,,,,
285,https://vlr.gg/player/3049/sword9,2024-12-10 02:00:00,,,,175,,,19,,,16,,,21,,,,,,,,,,,,,,,,,,,,
286,https://vlr.gg/player/42235/dynamite,2024-12-10 02:00:00,,,,215,,,22,,,30,,,9,,,,,,,,,,,,,,,,,,,,
287,https://vlr.gg/player/30526/b1ack,2024-12-10 02:00:00,,,,165,,,16,,,29,,,10,,,,,,,,,,,,,,,,,,,,
288,https://vlr.gg/player/4720/haodong,2024-12-10 02:00:00,,,,159,,,15,,,30,,,15,,,,,,,,,,,,,,,,,,,,
289,https://vlr.gg/player/488/rb,2024-12-10 02:00:00,,,,154,,,16,,,30,,,7,,,,,,,,,,,,,,,,,,,,
290,https://vlr.gg/player/5011/abo,2024-12-10 02:00:00,,,,131,,,17,,,28,,,2,,,,,,,,,,,,,,,,,,,,
291,https://vlr.gg/player/8673/heat,2024-12-09 18:15:00,1.41,1.37,1.38,269,280,264,61,26,35,44,18,26,11,2,9,+6,0,+6,79%,76%,82%,190,188,191,38%,43%,35%,10,2,8,4,2,2
292,https://vlr.gg/player/939/mwzera,2024-12-09 18:15:00,0.78,1.37,1.13,202,161,236,46,14,32,42,20,22,18,5,13,+1,+2,-1,68%,52%,79%,132,108,148,26%,22%,28%,2,2,0,1,0,1
293,https://vlr.gg/player/8706/havoc,2024-12-09 18:15:00,0.61,1.15,0.94,209,191,219,47,16,31,45,21,24,5,2,3,+13,+4,+9,71%,60%,79%,131,116,141,41%,52%,36%,23,11,12,10,7,3
294,https://vlr.gg/player/25743/raafa,2024-12-09 18:15:00,0.69,1.07,0.92,164,126,196,33,9,24,41,18,23,40,19,21,+1,-1,+2,68%,56%,76%,109,82,127,22%,26%,20%,4,0,4,3,1,2
295,https://vlr.gg/player/1711/khalil,2024-12-09 18:15:00,0.88,0.80,0.83,139,156,132,31,13,18,42,18,24,27,10,17,-4,0,-4,68%,68%,68%,95,104,90,34%,35%,33%,1,0,1,5,0,5
296,https://vlr.gg/player/21659/sato,2024-12-09 18:15:00,0.94,1.91,1.33,272,220,364,61,29,32,42,29,13,10,3,7,+3,0,+3,68%,63%,76%,175,144,221,33%,40%,25%,14,7,7,11,7,4
297,https://vlr.gg/player/28716/lukxo,2024-12-09 18:15:00,0.91,1.01,0.95,216,225,189,50,32,18,45,30,15,8,5,3,-11,-7,-4,63%,61%,68%,138,146,125,39%,45%,29%,3,3,0,14,10,4
298,https://vlr.gg/player/5351/rglmeister,2024-12-09 18:15:00,0.83,1.13,0.95,153,139,189,36,19,17,40,25,15,18,9,9,-2,-2,0,67%,68%,64%,106,91,130,33%,41%,26%,2,1,1,4,3,1
299,https://vlr.gg/player/6238/urango,2024-12-09 18:15:00,0.91,0.75,0.85,169,176,167,39,24,15,46,28,18,14,7,7,-4,-2,-2,63%,63%,64%,118,129,103,26%,36%,16%,1,0,1,5,2,3
300,https://vlr.gg/player/1566/prozin,2024-12-09 18:15:00,0.63,0.90,0.74,136,116,156,28,15,13,45,28,17,18,9,9,-3,-1,-2,67%,61%,76%,92,79,112,33%,39%,29%,3,2,1,6,3,3
301,https://vlr.gg/player/7603/mazino,2024-12-09 15:00:00,1.08,1.39,1.24,243,202,285,48,20,28,36,19,17,22,15,7,+1,+2,-1,75%,81%,69%,159,129,188,26%,19%,35%,6,3,3,5,1,4
302,https://vlr.gg/player/2462/keznit,2024-12-09 15:00:00,1.17,1.19,1.18,229,238,215,42,22,20,34,17,17,5,2,3,+8,+5,+3,77%,69%,85%,145,148,143,20%,23%,16%,15,10,5,7,5,2
303,https://vlr.gg/player/1311/melser,2024-12-09 15:00:00,0.73,1.26,1.00,186,140,233,32,11,21,35,18,17,21,7,14,+2,0,+2,69%,62%,77%,131,107,155,20%,21%,20%,5,0,5,3,0,3
304,https://vlr.gg/player/3826/adverso,2024-12-09 15:00:00,0.88,1.06,0.97,207,236,183,36,20,16,38,21,17,15,4,11,+2,+1,+1,71%,69%,73%,140,151,129,25%,23%,27%,5,3,2,3,2,1
305,https://vlr.gg/player/24007/shyy,2024-12-09 15:00:00,0.87,1.05,0.96,182,159,204,33,14,19,34,16,18,12,4,8,-1,-2,+1,77%,69%,85%,120,106,134,33%,35%,31%,1,0,1,2,2,0
306,https://vlr.gg/player/12872/david,2024-12-09 15:00:00,1.03,1.48,1.26,230,203,260,41,17,24,34,19,15,27,15,12,-1,+1,-2,75%,77%,73%,156,135,177,30%,27%,32%,5,2,3,6,1,5
307,https://vlr.gg/player/8892/snw,2024-12-09 15:00:00,0.78,1.31,1.05,235,195,277,44,17,27,38,21,17,2,1,1,-1,-2,+1,65%,62%,69%,152,127,178,34%,51%,22%,9,4,5,10,6,4
308,https://vlr.gg/player/13860/rubkkoide,2024-12-09 15:00:00,1.07,0.75,0.91,194,256,134,32,22,10,40,22,18,22,7,15,-1,0,-1,71%,65%,77%,131,171,90,35%,36%,33%,2,2,0,3,2,1
309,https://vlr.gg/player/783/murizzz,2024-12-09 15:00:00,0.89,0.89,0.89,189,184,189,33,17,16,40,20,20,11,6,5,-6,-1,-5,58%,62%,54%,128,117,138,38%,40%,36%,1,1,0,7,2,5
310,https://vlr.gg/player/46901/maxhinh9,2024-12-09 15:00:00,0.40,0.79,0.59,136,118,158,26,12,14,39,22,17,4,2,2,-3,-4,+1,62%,58%,65%,91,73,108,18%,8%,27%,3,1,2,6,5,1
311,https://vlr.gg/player/39697/cb,2024-12-09 07:30:00,,,,275,,,40,,,27,,,17,,,,,,,,,,,,,,,,,,,,
312,https://vlr.gg/player/1209/swerl,2024-12-09 07:30:00,,,,236,,,35,,,31,,,11,,,,,,,,,,,,,,,,,,,,
313,https://vlr.gg/player/46460/ezeir,2024-12-09 07:30:00,,,,207,,,30,,,31,,,21,,,,,,,,,,,,,,,,,,,,
314,https://vlr.gg/player/4402/o0o0o,2024-12-09 07:30:00,,,,190,,,28,,,26,,,24,,,,,,,,,,,,,,,,,,,,
315,https://vlr.gg/player/41054/guang,2024-12-09 07:30:00,,,,185,,,30,,,31,,,7,,,,,,,,,,,,,,,,,,,,
316,https://vlr.gg/player/10821/delb,2024-12-09 07:30:00,,,,313,,,46,,,28,,,10,,,,,,,,,,,,,,,,,,,,
317,https://vlr.gg/player/46748/k1ra,2024-12-09 07:30:00,,,,208,,,31,,,31,,,14,,,,,,,,,,,,,,,,,,,,
318,https://vlr.gg/player/4880/nizhaotzh,2024-12-09 07:30:00,,,,196,,,27,,,34,,,8,,,,,,,,,,,,,,,,,,,,
319,https://vlr.gg/player/49870/carl,2024-12-09 07:30:00,,,,180,,,27,,,35,,,8,,,,,,,,,,,,,,,,,,,,
320,https://vlr.gg/player/3031/septem7,2024-12-09 07:30:00,,,,110,,,14,,,35,,,18,,,,,,,,,,,,,,,,,,,,
321,https://vlr.gg/player/3519/jkuro,2024-12-09 04:10:00,,,,244,,,54,,,53,,,16,,,,,,,,,,,,,,,,,,,,
322,https://vlr.gg/player/3049/sword9,2024-12-09 04:10:00,,,,225,,,54,,,49,,,20,,,,,,,,,,,,,,,,,,,,
323,https://vlr.gg/player/36415/viva,2024-12-09 04:10:00,,,,210,,,50,,,44,,,14,,,,,,,,,,,,,,,,,,,,
324,https://vlr.gg/player/16924/stew,2024-12-09 04:10:00,,,,190,,,42,,,47,,,15,,,,,,,,,,,,,,,,,,,,
325,https://vlr.gg/player/41029/z1yan,2024-12-09 04:10:00,,,,171,,,40,,,50,,,26,,,,,,,,,,,,,,,,,,,,
326,https://vlr.gg/player/3017/nobody,2024-12-09 04:10:00,,,,218,,,51,,,51,,,19,,,,,,,,,,,,,,,,,,,,
327,https://vlr.gg/player/3520/zmjjkk,2024-12-09 04:10:00,,,,214,,,50,,,52,,,15,,,,,,,,,,,,,,,,,,,,
328,https://vlr.gg/player/4742/smoggy,2024-12-09 04:10:00,,,,214,,,53,,,37,,,24,,,,,,,,,,,,,,,,,,,,
329,https://vlr.gg/player/15559/chichoo,2024-12-09 04:10:00,,,,193,,,45,,,49,,,26,,,,,,,,,,,,,,,,,,,,
330,https://vlr.gg/player/13768/s1mon,2024-12-09 04:10:00,,,,180,,,44,,,52,,,24,,,,,,,,,,,,,,,,,,,,
331,https://vlr.gg/player/22047/rarga,2024-12-09 02:00:00,,,,235,,,28,,,28,,,5,,,,,,,,,,,,,,,,,,,,
332,https://vlr.gg/player/37927/happywei,2024-12-09 02:00:00,,,,177,,,21,,,30,,,6,,,,,,,,,,,,,,,,,,,,
333,https://vlr.gg/player/12365/coconut,2024-12-09 02:00:00,,,,173,,,21,,,30,,,6,,,,,,,,,,,,,,,,,,,,
334,https://vlr.gg/player/4763/zixuan,2024-12-09 02:00:00,,,,136,,,14,,,25,,,15,,,,,,,,,,,,,,,,,,,,
335,https://vlr.gg/player/4710/you,2024-12-09 02:00:00,,,,132,,,16,,,29,,,12,,,,,,,,,,,,,,,,,,,,
336,https://vlr.gg/player/5011/abo,2024-12-09 02:00:00,,,,258,,,35,,,17,,,8,,,,,,,,,,,,,,,,,,,,
337,https://vlr.gg/player/30526/b1ack,2024-12-09 02:00:00,,,,240,,,28,,,25,,,27,,,,,,,,,,,,,,,,,,,,
338,https://vlr.gg/player/42235/dynamite,2024-12-09 02:00:00,,,,222,,,31,,,20,,,8,,,,,,,,,,,,,,,,,,,,
339,https://vlr.gg/player/488/rb,2024-12-09 02:00:00,,,,203,,,28,,,21,,,12,,,,,,,,,,,,,,,,,,,,
340,https://vlr.gg/player/4720/haodong,2024-12-09 02:00:00,,,,158,,,20,,,17,,,22,,,,,,,,,,,,,,,,,,,,
341,https://vlr.gg/player/18796/oxy,2024-12-08 17:00:00,1.83,0.87,1.35,279,367,194,52,36,16,38,17,21,23,13,10,+4,+1,+3,77%,82%,71%,184,236,131,21%,25%,12%,14,7,7,10,6,4
342,https://vlr.gg/player/21486/sarahcat,2024-12-08 17:00:00,1.17,1.01,1.09,202,201,205,41,21,20,37,16,21,20,4,16,0,+1,-1,73%,64%,82%,133,115,151,22%,18%,25%,4,1,3,4,0,4
343,https://vlr.gg/player/17433/v1c,2024-12-08 17:00:00,1.00,0.97,0.99,197,178,208,38,17,21,38,18,20,21,12,9,-3,-1,-2,75%,71%,79%,128,119,136,29%,25%,33%,2,1,1,5,2,3
344,https://vlr.gg/player/7458/moose,2024-12-08 17:00:00,0.91,0.90,0.90,194,192,190,34,18,16,36,18,18,11,4,7,+1,-2,+3,66%,68%,64%,129,127,132,18%,18%,19%,5,2,3,4,4,0
345,https://vlr.gg/player/3079/alexis,2024-12-08 17:00:00,0.51,1.17,0.84,153,109,203,32,11,21,40,23,17,16,7,9,-4,-3,-1,66%,54%,79%,108,76,139,33%,24%,39%,2,1,1,6,4,2
346,https://vlr.gg/player/7873/leaf,2024-12-08 17:00:00,1.61,1.14,1.37,255,271,231,48,28,20,35,16,19,22,11,11,+4,+1,+3,73%,86%,61%,160,172,149,35%,36%,33%,9,2,7,5,1,4
347,https://vlr.gg/player/3993/jawgemo,2024-12-08 17:00:00,1.01,1.17,1.09,275,257,262,52,24,28,44,23,21,9,6,3,+1,-1,+2,71%,68%,75%,169,168,170,27%,26%,29%,11,8,3,10,9,1
348,https://vlr.gg/player/15500/trent,2024-12-08 17:00:00,0.92,0.93,0.92,171,154,193,30,11,19,39,18,21,22,16,6,0,0,0,70%,71%,68%,119,108,129,32%,34%,30%,2,1,1,2,1,1
349,https://vlr.gg/player/17323/mimi,2024-12-08 17:00:00,1.04,0.56,0.80,149,172,130,30,17,13,38,18,20,22,16,6,0,0,0,64%,82%,46%,100,118,82,29%,26%,33%,5,2,3,5,2,3
350,https://vlr.gg/player/24149/amy,2024-12-08 17:00:00,0.84,0.65,0.74,148,169,147,29,17,12,41,19,22,6,1,5,-3,-2,-1,63%,68%,57%,105,108,103,27%,35%,21%,2,0,2,5,2,3
351,https://vlr.gg/player/1291/bnj,2024-12-08 15:25:00,1.50,1.41,1.44,192,227,174,38,15,23,23,9,14,34,12,22,+1,+1,0,88%,79%,93%,126,144,114,37%,37%,37%,4,3,1,3,2,1
352,https://vlr.gg/player/2818/neto,2024-12-08 15:25:00,1.88,1.11,1.41,268,437,176,63,32,31,30,13,17,8,1,7,+9,+6,+3,86%,79%,90%,171,248,122,27%,30%,22%,15,8,7,6,2,4
353,https://vlr.gg/player/15916/jotinha,2024-12-08 15:25:00,1.20,1.39,1.32,186,152,210,44,11,33,19,7,12,21,7,14,0,-1,+1,90%,84%,93%,133,112,147,30%,36%,27%,1,0,1,1,1,0
354,https://vlr.gg/player/2403/mizu,2024-12-08 15:25:00,1.03,1.26,1.17,182,177,189,37,12,25,28,9,19,13,3,10,+2,0,+2,86%,74%,93%,126,111,135,34%,45%,28%,4,1,3,2,1,1
355,https://vlr.gg/player/2586/hanling,2024-12-08 15:25:00,1.24,1.06,1.13,144,179,127,39,12,27,22,8,14,27,10,17,+2,+1,+1,84%,84%,83%,97,121,82,28%,23%,35%,3,1,2,1,0,1
356,https://vlr.gg/player/41134/nx1,2024-12-08 15:25:00,0.77,1.03,0.87,159,129,221,25,12,13,44,20,24,17,9,8,+2,+1,+1,76%,83%,63%,111,87,148,29%,36%,24%,4,2,2,2,1,1
357,https://vlr.gg/player/36052/haitam,2024-12-08 15:25:00,0.89,0.50,0.74,126,123,144,25,13,12,43,17,26,7,5,2,-1,-1,0,67%,73%,58%,92,92,91,47%,54%,40%,1,0,1,2,1,1
358,https://vlr.gg/player/48864/mrtn,2024-12-08 15:25:00,0.68,0.71,0.64,104,91,138,27,10,17,43,19,24,2,1,1,-3,-2,-1,61%,63%,58%,89,74,113,34%,32%,36%,2,1,1,5,3,2
359,https://vlr.gg/player/49799/tafg,2024-12-08 15:25:00,0.43,0.79,0.60,175,164,187,20,10,10,31,18,13,6,1,5,-1,0,-1,56%,44%,69%,113,108,119,41%,50%,33%,6,4,2,7,4,3
360,https://vlr.gg/player/47403/angel,2024-12-08 15:25:00,0.60,0.01,0.44,27,,135,7,0,7,14,3,11,2,0,2,-2,-2,0,73%,83%,33%,20,,102,13%,,13%,0,0,0,2,2,0
361,https://vlr.gg/player/48984/kramz,2024-12-08 15:25:00,0.49,0.18,0.37,73,65,90,17,7,10,46,19,27,12,2,10,-9,-3,-6,53%,57%,47%,55,49,64,18%,21%,16%,0,0,0,9,3,6
362,https://vlr.gg/player/5351/rglmeister,2024-12-08 15:00:00,1.41,1.09,1.28,200,205,193,61,39,22,45,24,21,27,13,14,+2,+1,+1,73%,75%,71%,132,137,125,28%,25%,32%,4,2,2,2,1,1
363,https://vlr.gg/player/21659/sato,2024-12-08 15:00:00,1.01,1.36,1.15,213,210,219,61,35,26,54,34,20,11,8,3,+5,+2,+3,65%,69%,59%,141,137,148,35%,35%,34%,14,7,7,9,5,4
364,https://vlr.gg/player/1566/prozin,2024-12-08 15:00:00,1.00,0.82,0.93,168,181,145,47,29,18,54,32,22,34,24,10,-8,-2,-6,67%,69%,65%,104,117,85,31%,39%,19%,2,2,0,10,4,6
365,https://vlr.gg/player/28716/lukxo,2024-12-08 15:00:00,0.87,0.97,0.91,204,211,196,58,35,23,59,35,24,13,10,3,-4,-5,+1,66%,71%,59%,135,133,138,29%,28%,30%,9,6,3,13,11,2
366,https://vlr.gg/player/6238/urango,2024-12-08 15:00:00,1.05,0.67,0.89,205,200,198,56,35,21,62,31,31,10,6,4,-9,-4,-5,61%,67%,53%,132,133,131,28%,33%,23%,5,3,2,14,7,7
367,https://vlr.gg/player/5722/prince,2024-12-08 15:00:00,0.86,1.09,0.99,200,169,224,54,18,36,52,21,31,13,5,8,+4,+3,+1,68%,68%,69%,141,126,152,24%,23%,24%,9,4,5,5,1,4
368,https://vlr.gg/player/41224/tkzin,2024-12-08 15:00:00,1.02,0.93,0.97,218,228,213,62,29,33,62,25,37,19,8,11,+2,-4,+6,72%,79%,67%,141,151,134,26%,35%,21%,17,5,12,15,9,6
369,https://vlr.gg/player/2486/pollo,2024-12-08 15:00:00,1.06,0.88,0.96,195,201,193,56,23,33,58,21,37,16,7,9,+3,+2,+1,68%,71%,67%,133,134,133,28%,29%,28%,6,4,2,3,2,1
370,https://vlr.gg/player/1578/shion,2024-12-08 15:00:00,1.02,0.90,0.95,183,195,175,52,24,28,55,20,35,35,15,20,+4,+2,+2,73%,76%,71%,120,122,119,30%,24%,35%,8,3,5,4,1,3
371,https://vlr.gg/player/25858/sw,2024-12-08 15:00:00,1.02,0.71,0.84,166,190,156,50,24,26,56,23,33,21,11,10,+1,+3,-2,63%,71%,58%,114,122,109,34%,37%,31%,8,4,4,7,1,6
372,https://vlr.gg/player/3753/obnoks,2024-12-08 11:30:00,1.13,1.04,1.08,212,206,217,46,20,26,46,20,26,19,8,11,+4,+1,+3,71%,70%,72%,137,137,136,31%,36%,27%,5,2,3,1,1,0
373,https://vlr.gg/player/10338/lime,2024-12-08 11:30:00,0.62,1.35,1.04,212,126,277,46,11,35,46,21,25,20,7,13,+1,-3,+4,65%,63%,67%,137,89,172,35%,50%,31%,9,2,7,8,5,3
374,https://vlr.gg/player/18400/bipo,2024-12-08 11:30:00,1.18,0.93,1.04,208,251,183,47,24,23,47,21,26,11,3,8,+4,+4,0,70%,70%,69%,125,150,106,29%,28%,30%,12,7,5,8,3,5
375,https://vlr.gg/player/7660/fizzy,2024-12-08 11:30:00,0.86,0.80,0.83,192,210,183,44,21,23,47,22,25,11,4,7,+2,-2,+4,60%,59%,61%,113,127,103,24%,35%,18%,8,2,6,6,4,2
376,https://vlr.gg/player/3674/iluri,2024-12-08 11:30:00,0.44,0.70,0.59,107,90,123,20,7,13,45,21,24,28,5,23,-2,-1,-1,62%,63%,61%,71,66,74,21%,36%,15%,2,0,2,4,1,3
377,https://vlr.gg/player/5292/al0rante,2024-12-08 11:30:00,1.44,1.23,1.35,272,267,278,65,36,29,41,22,19,8,4,4,+3,+2,+1,76%,72%,81%,174,172,177,41%,35%,48%,6,4,2,3,2,1
378,https://vlr.gg/player/1457/mistic,2024-12-08 11:30:00,1.21,1.11,1.17,192,192,190,44,26,18,33,19,14,18,10,8,+1,0,+1,75%,78%,70%,127,136,116,29%,30%,27%,7,3,4,6,3,3
379,https://vlr.gg/player/4244/yaboilewis,2024-12-08 11:30:00,0.71,1.35,0.98,175,131,244,39,15,24,41,24,17,12,5,7,-5,-5,0,65%,53%,81%,118,96,147,43%,30%,61%,2,0,2,7,5,2
380,https://vlr.gg/player/2658/xuss,2024-12-08 11:30:00,0.94,0.87,0.91,218,227,191,49,30,19,46,28,18,6,4,2,-6,-5,-1,65%,69%,59%,134,146,118,23%,23%,24%,7,3,4,13,8,5
381,https://vlr.gg/player/2690/hoody,2024-12-08 11:30:00,0.68,0.95,0.80,153,149,154,34,19,15,42,27,15,21,11,10,-2,-2,0,67%,61%,74%,106,99,115,22%,23%,22%,5,3,2,7,5,2
382,https://vlr.gg/player/26829/damaraa,2024-12-08 07:00:00,1.28,0.98,1.16,291,312,245,101,70,31,83,50,33,26,12,14,-2,-4,+2,75%,73%,79%,182,197,157,26%,28%,22%,19,12,7,21,16,5
383,https://vlr.gg/player/4872/frostmind,2024-12-08 07:00:00,1.19,0.74,1.02,193,212,149,67,48,19,68,37,31,32,25,7,+3,+1,+2,74%,78%,67%,127,143,102,44%,47%,38%,6,3,3,3,2,1
384,https://vlr.gg/player/9263/sayoo,2024-12-08 07:00:00,1.04,0.89,0.98,186,211,168,73,48,25,73,43,30,20,14,6,-9,-6,-3,73%,75%,69%,134,140,124,42%,42%,43%,3,1,2,12,7,5
385,https://vlr.gg/player/9290/madelyn,2024-12-08 07:00:00,1.01,0.87,0.96,167,171,179,57,35,22,68,38,30,63,37,26,-7,-2,-5,74%,73%,74%,112,109,115,18%,19%,18%,4,3,1,11,5,6
386,https://vlr.gg/player/10749/k1ngkappa,2024-12-08 07:00:00,0.75,1.24,0.94,177,147,235,65,32,33,73,44,29,20,9,11,+9,+4,+5,73%,68%,79%,120,97,158,30%,33%,26%,16,9,7,7,5,2
387,https://vlr.gg/player/1430/crazyguy,2024-12-08 07:00:00,1.59,0.92,1.18,234,300,200,82,43,39,72,25,47,29,15,14,+5,+1,+4,71%,82%,63%,165,200,143,30%,36%,25%,12,3,9,7,2,5
388,https://vlr.gg/player/11704/styron,2024-12-08 07:00:00,1.10,1.18,1.15,205,199,218,77,28,49,68,24,44,46,18,28,+2,0,+2,75%,82%,71%,135,129,138,24%,22%,26%,8,1,7,6,1,5
389,https://vlr.gg/player/24628/wayne,2024-12-08 07:00:00,1.03,1.01,1.02,210,204,209,79,31,48,77,29,48,45,25,20,+3,-1,+4,80%,79%,81%,130,124,133,34%,31%,36%,11,2,9,8,3,5
390,https://vlr.gg/player/24653/vera,2024-12-08 07:00:00,1.12,0.93,1.00,227,251,216,78,33,45,79,30,49,32,16,16,+5,+5,0,69%,74%,65%,147,152,145,23%,22%,24%,21,12,9,16,7,9
391,https://vlr.gg/player/9152/deryeon,2024-12-08 07:00:00,0.83,0.76,0.79,141,127,143,47,16,31,67,22,45,27,14,13,-9,-6,-3,69%,69%,68%,96,93,97,31%,27%,35%,2,1,1,11,7,4
392,https://vlr.gg/player/4742/smoggy,2024-12-08 06:40:00,,,,293,,,39,,,26,,,10,,,,,,,,,,,,,,,,,,,,
393,https://vlr.gg/player/3017/nobody,2024-12-08 06:40:00,,,,243,,,35,,,27,,,3,,,,,,,,,,,,,,,,,,,,
394,https://vlr.gg/player/3520/zmjjkk,2024-12-08 06:40:00,,,,203,,,30,,,22,,,14,,,,,,,,,,,,,,,,,,,,
395,https://vlr.gg/player/13768/s1mon,2024-12-08 06:40:00,,,,187,,,27,,,23,,,7,,,,,,,,,,,,,,,,,,,,
396,https://vlr.gg/player/15559/chichoo,2024-12-08 06:40:00,,,,166,,,26,,,28,,,8,,,,,,,,,,,,,,,,,,,,
397,https://vlr.gg/player/5011/abo,2024-12-08 06:40:00,,,,221,,,31,,,32,,,7,,,,,,,,,,,,,,,,,,,,
398,https://vlr.gg/player/4720/haodong,2024-12-08 06:40:00,,,,201,,,27,,,32,,,14,,,,,,,,,,,,,,,,,,,,
399,https://vlr.gg/player/488/rb,2024-12-08 06:40:00,,,,186,,,24,,,31,,,15,,,,,,,,,,,,,,,,,,,,
400,https://vlr.gg/player/42235/dynamite,2024-12-08 06:40:00,,,,186,,,24,,,29,,,6,,,,,,,,,,,,,,,,,,,,
401,https://vlr.gg/player/30526/b1ack,2024-12-08 06:40:00,,,,169,,,20,,,33,,,19,,,,,,,,,,,,,,,,,,,,
402,https://vlr.gg/player/37393/luca,2024-12-08 05:05:00,1.44,1.02,1.22,243,266,221,58,31,27,48,19,29,26,16,10,+3,+3,0,78%,85%,71%,159,180,139,39%,41%,36%,7,3,4,4,0,4
403,https://vlr.gg/player/45852/g4ll,2024-12-08 05:05:00,1.23,1.08,1.15,215,227,205,53,29,24,46,20,26,20,12,8,-5,-1,-4,71%,76%,66%,136,138,134,16%,15%,18%,8,7,1,13,8,5
404,https://vlr.gg/player/31845/chay,2024-12-08 05:05:00,1.19,1.10,1.14,227,234,222,54,29,25,49,22,27,24,8,16,+3,+5,-2,72%,74%,71%,155,152,157,41%,40%,42%,7,6,1,4,1,3
405,https://vlr.gg/player/45853/r1va,2024-12-08 05:05:00,1.06,0.63,0.85,198,221,177,48,28,20,52,20,32,16,11,5,+1,+3,-2,62%,76%,49%,126,134,119,26%,27%,24%,7,4,3,6,1,5
406,https://vlr.gg/player/47482/flora,2024-12-08 05:05:00,0.93,0.72,0.82,173,186,161,41,22,19,51,21,30,20,12,8,+1,+2,-1,65%,82%,49%,118,131,105,30%,31%,29%,7,3,4,6,1,5
407,https://vlr.gg/player/27458/esco,2024-12-08 05:05:00,1.68,1.08,1.39,297,363,230,79,48,31,49,23,26,6,4,2,+3,+7,-4,74%,91%,56%,174,222,124,13%,17%,9%,12,10,2,9,3,6
408,https://vlr.gg/player/34825/han,2024-12-08 05:05:00,1.11,0.80,0.96,168,184,152,41,24,17,46,20,26,21,16,5,-1,-1,0,65%,77%,53%,124,133,115,28%,26%,30%,1,0,1,2,1,1
409,https://vlr.gg/player/29837/caspell,2024-12-08 05:05:00,0.90,0.88,0.89,219,226,213,50,28,22,58,28,30,21,9,12,0,+4,-4,70%,74%,65%,142,142,142,22%,23%,21%,10,6,4,10,2,8
410,https://vlr.gg/player/43066/niki,2024-12-08 05:05:00,0.81,0.84,0.83,174,170,180,42,21,21,50,22,28,8,3,5,-1,-1,0,57%,63%,50%,115,116,113,31%,41%,24%,8,4,4,9,5,4
411,https://vlr.gg/player/49679/abu,2024-12-08 05:05:00,0.99,0.42,0.71,137,177,96,34,23,11,51,22,29,17,10,7,-4,0,-4,70%,77%,62%,92,122,62,29%,29%,31%,2,2,0,6,2,4
412,https://vlr.gg/player/16924/stew,2024-12-08 04:20:00,,,,236,,,35,,,31,,,13,,,,,,,,,,,,,,,,,,,,
413,https://vlr.gg/player/3519/jkuro,2024-12-08 04:20:00,,,,235,,,35,,,36,,,15,,,,,,,,,,,,,,,,,,,,
414,https://vlr.gg/player/36415/viva,2024-12-08 04:20:00,,,,195,,,32,,,28,,,11,,,,,,,,,,,,,,,,,,,,
415,https://vlr.gg/player/41029/z1yan,2024-12-08 04:20:00,,,,172,,,25,,,29,,,16,,,,,,,,,,,,,,,,,,,,
416,https://vlr.gg/player/3049/sword9,2024-12-08 04:20:00,,,,124,,,15,,,34,,,12,,,,,,,,,,,,,,,,,,,,
417,https://vlr.gg/player/37927/happywei,2024-12-08 04:20:00,,,,300,,,48,,,25,,,17,,,,,,,,,,,,,,,,,,,,
418,https://vlr.gg/player/22047/rarga,2024-12-08 04:20:00,,,,249,,,36,,,38,,,5,,,,,,,,,,,,,,,,,,,,
419,https://vlr.gg/player/4710/you,2024-12-08 04:20:00,,,,181,,,27,,,27,,,19,,,,,,,,,,,,,,,,,,,,
420,https://vlr.gg/player/4763/zixuan,2024-12-08 04:20:00,,,,165,,,22,,,26,,,19,,,,,,,,,,,,,,,,,,,,
421,https://vlr.gg/player/12365/coconut,2024-12-08 04:20:00,,,,156,,,25,,,26,,,8,,,,,,,,,,,,,,,,,,,,
422,https://vlr.gg/player/49681/keisu,2024-12-08 02:00:00,0.97,1.42,1.17,255,226,306,46,21,25,41,24,17,12,7,5,0,+1,-1,69%,63%,75%,170,146,200,26%,29%,24%,9,5,4,9,4,5
423,https://vlr.gg/player/34705/e9lair,2024-12-08 02:00:00,0.69,1.24,0.93,188,139,256,34,12,22,41,24,17,13,7,6,+1,0,+1,65%,63%,67%,130,104,162,24%,20%,26%,4,1,3,3,1,2
424,https://vlr.gg/player/32823/lafura,2024-12-08 02:00:00,1.01,0.83,0.93,209,240,175,41,27,14,43,26,17,8,3,5,0,+1,-1,65%,53%,79%,133,151,112,27%,29%,24%,7,5,2,7,4,3
425,https://vlr.gg/player/2508/kenmohororo,2024-12-08 02:00:00,0.68,0.71,0.69,124,116,132,21,12,9,42,25,17,20,10,10,-2,-1,-1,61%,60%,63%,73,61,87,25%,41%,14%,1,1,0,3,2,1
426,https://vlr.gg/player/17091/zan,2024-12-08 02:00:00,0.38,0.75,0.55,126,114,147,23,10,13,46,28,18,23,11,12,-7,-5,-2,57%,47%,71%,77,69,87,27%,24%,31%,2,1,1,9,6,3
427,https://vlr.gg/player/2671/popogachi,2024-12-08 02:00:00,1.28,1.88,1.62,342,273,386,63,24,39,32,17,15,18,7,11,+5,+2,+3,80%,79%,80%,214,182,240,26%,33%,23%,9,4,5,4,2,2
428,https://vlr.gg/player/1971/oitan,2024-12-08 02:00:00,0.99,1.39,1.21,196,181,205,41,15,26,27,15,12,12,2,10,0,+2,-2,80%,71%,87%,133,132,135,44%,46%,42%,3,3,0,3,1,2
429,https://vlr.gg/player/44613/yamada,2024-12-08 02:00:00,1.15,0.92,1.02,187,225,159,35,18,17,34,16,18,27,9,18,-1,0,-1,83%,79%,87%,125,150,104,21%,27%,16%,5,2,3,6,2,4
430,https://vlr.gg/player/47481/frxeez,2024-12-08 02:00:00,0.74,1.23,1.01,217,174,259,41,15,26,37,19,18,12,3,9,+5,0,+5,80%,75%,83%,137,115,154,14%,12%,16%,11,3,8,6,3,3
431,https://vlr.gg/player/1973/ripablo,2024-12-08 02:00:00,0.93,0.86,0.89,155,153,153,32,14,18,35,16,19,19,8,11,-1,0,-1,78%,75%,80%,92,96,90,29%,32%,27%,3,2,1,4,2,2
432,https://vlr.gg/player/3021/biank,2024-12-08 02:00:00,,,,238,,,36,,,34,,,21,,,,,,,,,,,,,,,,,,,,
433,https://vlr.gg/player/4770/fengf,2024-12-08 02:00:00,,,,214,,,34,,,35,,,15,,,,,,,,,,,,,,,,,,,,
434,https://vlr.gg/player/37494/kai,2024-12-08 02:00:00,,,,212,,,38,,,30,,,9,,,,,,,,,,,,,,,,,,,,
435,https://vlr.gg/player/4712/heybay,2024-12-08 02:00:00,,,,196,,,35,,,25,,,10,,,,,,,,,,,,,,,,,,,,
436,https://vlr.gg/player/3045/luok1ng,2024-12-08 02:00:00,,,,161,,,27,,,32,,,14,,,,,,,,,,,,,,,,,,,,
437,https://vlr.gg/player/41739/slowly,2024-12-08 02:00:00,,,,266,,,42,,,34,,,9,,,,,,,,,,,,,,,,,,,,
438,https://vlr.gg/player/3547/ninebody,2024-12-08 02:00:00,,,,220,,,34,,,37,,,8,,,,,,,,,,,,,,,,,,,,
439,https://vlr.gg/player/47101/5cm,2024-12-08 02:00:00,,,,193,,,32,,,35,,,12,,,,,,,,,,,,,,,,,,,,
440,https://vlr.gg/player/7135/hfmi0dzjc9z7,2024-12-08 02:00:00,,,,167,,,26,,,31,,,14,,,,,,,,,,,,,,,,,,,,
441,https://vlr.gg/player/6024/glxad,2024-12-08 02:00:00,,,,141,,,22,,,33,,,19,,,,,,,,,,,,,,,,,,,,
442,https://vlr.gg/player/9185/dodonut,2024-12-07 19:10:00,1.23,1.42,1.33,274,263,286,49,21,28,36,20,16,4,2,2,+2,+1,+1,72%,70%,75%,177,171,184,34%,30%,39%,7,5,2,5,4,1
443,https://vlr.gg/player/8849/sonder,2024-12-07 19:10:00,0.67,1.34,1.01,192,152,231,33,12,21,32,19,13,16,8,8,-1,-3,+2,74%,61%,88%,125,107,143,24%,35%,18%,4,2,2,5,5,0
444,https://vlr.gg/player/11968/l4ce,2024-12-07 19:10:00,0.69,1.16,0.93,167,136,199,26,9,17,35,19,16,15,4,11,-1,-1,0,70%,52%,88%,115,95,133,28%,23%,31%,1,0,1,2,1,1
445,https://vlr.gg/player/619/c0m,2024-12-07 19:10:00,0.77,0.81,0.79,170,156,182,23,11,12,35,18,17,14,6,8,0,-1,+1,66%,57%,75%,124,105,142,17%,31%,12%,4,0,4,4,1,3
446,https://vlr.gg/player/1818/tex,2024-12-07 19:10:00,0.42,0.95,0.69,191,151,230,28,11,17,40,22,18,9,3,6,-1,-3,+2,55%,48%,63%,129,100,157,35%,37%,34%,7,1,6,8,4,4
447,https://vlr.gg/player/15500/trent,2024-12-07 19:10:00,1.64,1.67,1.66,339,354,327,55,27,28,31,19,12,19,12,7,+2,0,+2,87%,88%,87%,226,244,208,28%,30%,24%,8,3,5,6,3,3
448,https://vlr.gg/player/7873/leaf,2024-12-07 19:10:00,1.03,1.38,1.20,227,236,218,37,19,18,29,19,10,14,7,7,0,-1,+1,70%,58%,83%,150,149,151,28%,29%,28%,6,3,3,6,4,2
449,https://vlr.gg/player/4581/jonahp,2024-12-07 19:10:00,0.67,1.29,0.97,185,159,214,28,11,17,31,19,12,35,19,16,-3,-3,0,77%,71%,83%,119,100,139,19%,22%,16%,1,1,0,4,4,0
450,https://vlr.gg/player/17323/mimi,2024-12-07 19:10:00,0.74,1.03,0.89,182,149,217,32,13,19,34,19,15,15,9,6,-2,-2,0,66%,58%,74%,115,87,144,28%,18%,36%,3,0,3,5,2,3
451,https://vlr.gg/player/24149/amy,2024-12-07 19:10:00,0.63,0.93,0.78,158,114,201,26,10,16,34,19,15,12,7,5,+4,0,+4,70%,75%,65%,99,71,129,25%,26%,25%,6,2,4,2,2,0
452,https://vlr.gg/player/18796/oxy,2024-12-07 17:00:00,1.32,1.65,1.46,302,310,310,46,27,19,27,17,10,4,2,2,+2,+1,+1,80%,79%,82%,194,188,201,32%,34%,28%,5,4,1,3,3,0
453,https://vlr.gg/player/7458/moose,2024-12-07 17:00:00,1.32,1.26,1.30,187,178,192,27,18,9,17,10,7,17,6,11,+1,0,+1,83%,79%,88%,135,134,136,15%,14%,16%,2,0,2,1,0,1
454,https://vlr.gg/player/3079/alexis,2024-12-07 17:00:00,1.09,1.36,1.20,195,214,150,30,19,11,23,17,6,21,9,12,-3,-2,-1,78%,75%,82%,124,137,105,46%,45%,48%,2,2,0,5,4,1
455,https://vlr.gg/player/17433/v1c,2024-12-07 17:00:00,0.87,1.28,1.04,175,139,223,23,10,13,26,15,11,26,14,12,+1,0,+1,73%,79%,65%,116,102,136,28%,27%,29%,5,1,4,4,1,3
456,https://vlr.gg/player/21486/sarahcat,2024-12-07 17:00:00,0.67,0.92,0.77,167,169,159,24,13,11,28,19,9,12,10,2,-2,-1,-1,73%,75%,71%,103,111,91,15%,15%,16%,6,4,2,8,5,3
457,https://vlr.gg/player/725/nzr,2024-12-07 17:00:00,1.39,0.88,1.09,213,268,185,32,17,15,29,12,17,8,6,2,-2,+1,-3,63%,76%,54%,140,170,119,31%,44%,20%,4,3,1,6,2,4
458,https://vlr.gg/player/21435/jelly,2024-12-07 17:00:00,0.88,1.20,1.06,212,179,237,30,10,20,30,13,17,17,10,7,+1,+1,0,71%,71%,71%,144,125,158,36%,24%,45%,1,1,0,0,0,0
459,https://vlr.gg/player/31574/srn,2024-12-07 17:00:00,0.82,1.07,0.97,222,179,257,30,9,21,33,12,21,7,4,3,+6,+1,+5,66%,59%,71%,149,127,164,23%,20%,26%,13,4,9,7,3,4
460,https://vlr.gg/player/11239/sayuri,2024-12-07 17:00:00,0.63,0.83,0.75,135,106,152,19,5,14,28,12,16,18,10,8,-2,-2,0,73%,76%,71%,92,67,110,28%,19%,33%,2,0,2,4,2,2
461,https://vlr.gg/player/5957/artzin,2024-12-07 17:00:00,0.23,0.66,0.46,100,43,135,10,2,8,30,14,16,7,1,6,-2,-2,0,56%,41%,67%,72,33,99,14%,10%,15%,1,0,1,3,2,1
462,https://vlr.gg/player/1578/shion,2024-12-07 15:00:00,1.49,1.21,1.35,251,258,241,53,28,25,36,15,21,29,16,13,+1,-1,+2,77%,83%,71%,159,169,149,24%,16%,34%,5,1,4,4,2,2
463,https://vlr.gg/player/5722/prince,2024-12-07 15:00:00,1.26,0.96,1.11,182,204,164,42,23,19,33,16,17,17,11,6,-2,+2,-4,75%,83%,68%,123,132,113,34%,45%,25%,2,2,0,4,0,4
464,https://vlr.gg/player/2486/pollo,2024-12-07 15:00:00,0.89,1.33,1.11,203,194,228,47,20,27,37,21,16,11,4,7,-2,-1,-1,75%,77%,74%,146,127,164,35%,35%,34%,4,3,1,6,4,2
465,https://vlr.gg/player/41224/tkzin,2024-12-07 15:00:00,1.28,0.85,1.06,234,269,192,50,30,20,43,20,23,5,2,3,-1,-2,+1,72%,80%,65%,140,162,120,28%,32%,23%,12,5,7,13,7,6
466,https://vlr.gg/player/25858/sw,2024-12-07 15:00:00,0.91,1.06,0.99,206,190,217,45,22,23,45,22,23,16,6,10,+1,+2,-1,70%,70%,71%,135,130,139,32%,34%,30%,6,4,2,5,2,3
467,https://vlr.gg/player/1581/guhrvn,2024-12-07 15:00:00,1.01,0.95,0.98,219,237,198,44,25,19,47,24,23,16,6,10,+2,+1,+1,62%,68%,57%,147,146,149,36%,33%,40%,8,4,4,6,3,3
468,https://vlr.gg/player/8881/leozin,2024-12-07 15:00:00,1.10,0.85,0.98,214,234,188,44,26,18,47,21,26,13,3,10,+4,+3,+1,66%,68%,63%,134,143,126,29%,32%,25%,6,4,2,2,1,1
469,https://vlr.gg/player/15361/swag,2024-12-07 15:00:00,0.88,0.78,0.83,150,142,158,29,13,16,43,19,24,19,11,8,-1,0,-1,67%,68%,67%,109,108,109,30%,34%,26%,6,2,4,7,2,5
470,https://vlr.gg/player/13093/jzz,2024-12-07 15:00:00,0.78,0.86,0.82,167,160,176,37,18,19,47,24,23,14,6,8,0,-1,+1,67%,61%,73%,109,106,113,31%,37%,27%,4,2,2,4,3,1
471,https://vlr.gg/player/3455/zanatsu,2024-12-07 15:00:00,0.58,0.74,0.65,168,157,195,38,16,22,53,26,27,5,2,3,-2,0,-2,59%,58%,60%,114,100,129,28%,20%,35%,8,5,3,10,5,5
472,https://vlr.gg/player/29903/madv,2024-12-07 11:00:00,1.14,1.22,1.18,216,205,215,87,43,44,71,37,34,35,20,15,-1,+1,-2,75%,77%,73%,142,139,145,33%,31%,35%,6,2,4,7,1,6
473,https://vlr.gg/player/20055/toki,2024-12-07 11:00:00,1.09,1.13,1.11,200,214,183,77,43,34,69,36,33,47,16,31,+5,+3,+2,78%,82%,75%,127,145,108,35%,43%,27%,11,5,6,6,2,4
474,https://vlr.gg/player/17333/mary,2024-12-07 11:00:00,0.96,1.27,1.11,258,239,277,102,49,53,80,41,39,20,7,13,-2,-4,+2,66%,68%,64%,163,154,172,21%,25%,19%,19,10,9,21,14,7
475,https://vlr.gg/player/28675/noor,2024-12-07 11:00:00,0.84,1.01,0.93,200,207,199,81,41,40,80,41,39,16,6,10,-2,-1,-1,71%,73%,69%,132,136,128,27%,30%,25%,8,4,4,10,5,5
476,https://vlr.gg/player/28679/reta,2024-12-07 11:00:00,1.03,0.73,0.89,177,209,141,64,39,25,76,38,38,33,17,16,-3,+5,-8,70%,71%,69%,125,142,108,24%,30%,16%,10,9,1,13,4,9
477,https://vlr.gg/player/37970/leyre,2024-12-07 11:00:00,1.15,1.18,1.17,215,216,223,87,40,47,77,37,40,32,20,12,+2,+2,0,70%,62%,79%,142,143,141,34%,38%,32%,10,7,3,8,5,3
478,https://vlr.gg/player/40225/rue,2024-12-07 11:00:00,0.80,1.25,1.03,190,147,242,74,29,45,77,37,40,20,7,13,+1,0,+1,67%,62%,71%,133,99,167,24%,24%,23%,7,2,5,6,2,4
479,https://vlr.gg/player/38185/vam,2024-12-07 11:00:00,1.03,0.94,0.98,180,178,181,67,31,36,74,33,41,46,28,18,+4,+2,+2,76%,78%,73%,117,116,118,36%,38%,34%,8,4,4,4,2,2
480,https://vlr.gg/player/39026/golden,2024-12-07 11:00:00,0.89,0.86,0.88,202,223,199,78,42,36,92,44,48,21,9,12,0,0,0,59%,64%,54%,136,145,126,27%,25%,28%,16,8,8,16,8,8
481,https://vlr.gg/player/26663/yukina,2024-12-07 11:00:00,0.86,0.69,0.77,195,222,167,70,41,29,91,45,46,24,10,14,-4,+3,-7,59%,65%,54%,139,157,122,19%,22%,17%,16,10,6,20,7,13
482,https://vlr.gg/player/8497/monyet,2024-12-07 07:10:00,2.57,1.87,2.08,354,409,331,23,9,14,10,3,7,12,2,10,+2,+1,+1,94%,100%,92%,238,247,234,27%,23%,30%,3,1,2,1,0,1
483,https://vlr.gg/player/4874/berserx,2024-12-07 07:10:00,1.80,1.37,1.49,239,270,227,18,6,12,8,2,6,4,1,3,+1,+1,0,76%,80%,75%,168,192,158,23%,11%,31%,1,1,0,0,0,0
484,https://vlr.gg/player/7043/ncslasher,2024-12-07 07:10:00,1.32,1.38,1.36,329,329,330,18,5,13,12,3,9,4,3,1,+7,0,+7,88%,80%,92%,208,207,208,18%,10%,24%,8,1,7,1,1,0
485,https://vlr.gg/player/10816/xccurate,2024-12-07 07:10:00,0.57,1.12,0.96,196,130,224,11,1,10,12,4,8,12,5,7,0,0,0,82%,80%,83%,151,127,161,16%,13%,17%,1,0,1,1,0,1
486,https://vlr.gg/player/8492/tara,2024-12-07 07:10:00,0.68,0.86,0.81,143,152,140,8,3,5,11,4,7,7,2,5,+1,+1,0,76%,80%,75%,98,100,97,29%,43%,24%,1,1,0,0,0,0
487,https://vlr.gg/player/10739/shiro,2024-12-07 07:10:00,1.31,1.55,1.38,270,241,342,15,9,6,13,9,4,6,4,2,0,-1,+1,76%,67%,100%,171,163,189,20%,35%,7%,1,0,1,1,1,0
488,https://vlr.gg/player/4871/xffero,2024-12-07 07:10:00,0.82,0.86,0.83,221,216,237,14,9,5,18,12,6,5,4,1,-3,-2,-1,65%,67%,60%,119,123,111,38%,40%,33%,1,1,0,4,3,1
489,https://vlr.gg/player/2348/famouz,2024-12-07 07:10:00,0.79,0.78,0.78,198,184,233,12,8,4,15,10,5,1,0,1,-1,-1,0,65%,58%,80%,130,124,144,10%,10%,11%,0,0,0,1,1,0
490,https://vlr.gg/player/11666/ray4c,2024-12-07 07:10:00,0.41,0.04,0.29,152,171,109,7,7,0,17,12,5,6,3,3,-4,-2,-2,59%,67%,40%,97,92,110,7%,11%,0%,1,1,0,5,3,2
491,https://vlr.gg/player/4866/kushy,2024-12-07 07:10:00,0.33,0.05,0.24,92,106,60,5,4,1,16,11,5,2,1,1,-3,-2,-1,47%,50%,40%,66,75,45,33%,40%,20%,0,0,0,3,2,1
492,https://vlr.gg/player/9152/deryeon,2024-12-07 05:45:00,2.01,0.90,1.61,262,307,120,39,32,7,15,7,8,6,5,1,+3,+5,-2,82%,96%,57%,150,189,80,27%,28%,23%,6,6,0,3,1,2
493,https://vlr.gg/player/11704/styron,2024-12-07 05:45:00,1.30,1.42,1.34,234,205,251,34,21,13,19,10,9,14,6,8,+2,+1,+1,92%,96%,86%,134,127,148,21%,15%,32%,3,2,1,1,1,0
494,https://vlr.gg/player/24628/wayne,2024-12-07 05:45:00,1.36,0.77,1.14,185,223,134,27,20,7,21,11,10,23,19,4,+1,+1,0,77%,88%,57%,125,142,96,30%,27%,38%,4,3,1,3,2,1
495,https://vlr.gg/player/1430/crazyguy,2024-12-07 05:45:00,1.34,0.69,1.11,182,223,168,28,20,8,22,10,12,14,8,6,-1,0,-1,82%,92%,64%,130,146,101,23%,23%,24%,3,2,1,4,2,2
496,https://vlr.gg/player/24653/vera,2024-12-07 05:45:00,0.94,1.28,1.06,273,218,307,30,18,12,28,16,12,19,12,7,+2,-2,+4,82%,80%,86%,172,156,201,22%,21%,24%,7,2,5,5,4,1
497,https://vlr.gg/player/3639/hoax,2024-12-07 05:45:00,1.51,0.67,0.97,181,249,169,25,13,12,29,7,22,9,6,3,0,0,0,62%,79%,52%,137,153,129,17%,12%,21%,2,0,2,2,0,2
498,https://vlr.gg/player/26376/deecee,2024-12-07 05:45:00,1.64,0.46,0.89,149,322,82,26,18,8,30,9,21,5,3,2,-4,0,-4,51%,79%,36%,108,186,65,28%,22%,41%,0,0,0,4,0,4
499,https://vlr.gg/player/27775/techno,2024-12-07 05:45:00,0.62,0.78,0.71,145,139,176,19,6,13,34,11,23,17,7,10,-2,0,-2,64%,71%,60%,103,79,116,23%,27%,22%,3,2,1,5,2,3
500,https://vlr.gg/player/3627/hellff,2024-12-07 05:45:00,0.65,0.60,0.62,94,116,103,12,5,7,31,10,21,19,9,10,0,-1,+1,62%,71%,56%,78,74,80,19%,8%,26%,2,0,2,2,1,1
501,https://vlr.gg/player/27336/venka,2024-12-07 05:45:00,0.69,0.59,0.62,161,175,170,23,9,14,34,10,24,2,2,0,-1,-1,0,46%,50%,44%,107,115,102,40%,57%,33%,9,4,5,10,5,5
0,https://vlr.gg/player/10816/xccurate,2024-12-07 05:30:00,1.20,1.56,1.35,219,207,235,21,11,10,13,8,5,2,2,0,0,0,0,86%,83%,89%,153,153,153,18%,18%,18%,2,1,1,2,1,1
1,https://vlr.gg/player/4871/xffero,2024-12-07 05:30:00,0.82,1.78,1.23,317,237,425,22,9,13,19,12,7,13,6,7,+3,+1,+2,86%,75%,100%,218,168,284,24%,38%,18%,3,1,2,0,0,0
2,https://vlr.gg/player/24895/jemkin,2024-12-07 05:30:00,1.20,1.11,1.16,205,251,143,15,11,4,13,9,4,8,2,6,-1,0,-1,86%,75%,100%,151,163,136,29%,32%,25%,1,1,0,2,1,1
3,https://vlr.gg/player/4866/kushy,2024-12-07 05:30:00,0.66,1.75,1.13,260,182,365,20,6,14,17,11,6,7,5,2,0,-3,+3,81%,67%,100%,165,124,219,32%,23%,41%,4,1,3,4,4,0
4,,2024-12-07 05:30:00,0.80,0.49,0.67,168,235,79,13,10,3,17,11,6,2,1,1,-1,0,-1,62%,67%,56%,124,165,69,38%,39%,33%,1,1,0,2,1,1
5,https://vlr.gg/player/16215/dos9,2024-12-07 05:30:00,0.85,1.53,1.24,237,180,280,18,5,13,16,8,8,6,3,3,+2,+1,+1,86%,78%,92%,139,128,147,11%,23%,7%,3,2,1,1,1,0
6,https://vlr.gg/player/2348/famouz,2024-12-07 05:30:00,0.79,1.32,1.09,319,286,344,22,9,13,22,11,11,11,3,8,0,0,0,86%,89%,83%,213,200,223,14%,13%,14%,2,0,2,2,0,2
7,https://vlr.gg/player/4874/berserx,2024-12-07 05:30:00,1.09,0.76,0.90,171,188,159,12,6,6,17,7,10,9,4,5,-3,-3,0,71%,78%,67%,114,129,103,26%,38%,17%,2,0,2,5,3,2
8,https://vlr.gg/player/7043/ncslasher,2024-12-07 05:30:00,0.16,1.22,0.76,195,69,290,13,1,12,18,9,9,6,3,3,0,-1,+1,71%,56%,83%,128,63,178,34%,20%,36%,2,0,2,2,1,1
9,https://vlr.gg/player/10739/shiro,2024-12-07 05:30:00,0.68,0.75,0.72,169,198,147,14,7,7,18,9,9,4,0,4,0,0,0,67%,56%,75%,98,110,89,27%,50%,11%,1,1,0,1,1,0
10,https://vlr.gg/player/22047/rarga,2024-12-07 05:00:00,,,,251,,,37,,,34,,,3,,,,,,,,,,,,,,,,,,,,
11,https://vlr.gg/player/37927/happywei,2024-12-07 05:00:00,,,,247,,,37,,,32,,,9,,,,,,,,,,,,,,,,,,,,
12,https://vlr.gg/player/37674/mrcani,2024-12-07 05:00:00,,,,184,,,28,,,31,,,16,,,,,,,,,,,,,,,,,,,,
13,https://vlr.gg/player/4710/you,2024-12-07 05:00:00,,,,169,,,26,,,31,,,11,,,,,,,,,,,,,,,,,,,,
14,https://vlr.gg/player/4763/zixuan,2024-12-07 05:00:00,,,,143,,,19,,,30,,,15,,,,,,,,,,,,,,,,,,,,
15,https://vlr.gg/player/14125/spring,2024-12-07 05:00:00,,,,297,,,42,,,35,,,8,,,,,,,,,,,,,,,,,,,,
16,https://vlr.gg/player/37489/lysoar,2024-12-07 05:00:00,,,,244,,,37,,,29,,,8,,,,,,,,,,,,,,,,,,,,
17,https://vlr.gg/player/7849/siufatbb,2024-12-07 05:00:00,,,,179,,,29,,,25,,,12,,,,,,,,,,,,,,,,,,,,
18,https://vlr.gg/player/11218/yuicaw,2024-12-07 05:00:00,,,,169,,,27,,,33,,,11,,,,,,,,,,,,,,,,,,,,
19,https://vlr.gg/player/7426/juicy,2024-12-07 05:00:00,,,,149,,,23,,,25,,,20,,,,,,,,,,,,,,,,,,,,
20,https://vlr.gg/player/49679/abu,2024-12-07 04:15:00,0.93,0.91,0.92,181,156,226,27,15,12,33,19,14,8,5,3,+2,0,+2,65%,58%,75%,119,111,132,45%,54%,38%,3,1,2,1,1,0
21,https://vlr.gg/player/43066/niki,2024-12-07 04:15:00,0.93,0.85,0.90,173,176,172,23,14,9,32,19,13,12,6,6,-3,-2,-1,60%,63%,56%,117,113,124,34%,40%,28%,1,1,0,4,3,1
22,https://vlr.gg/player/29837/caspell,2024-12-07 04:15:00,1.18,0.30,0.83,196,272,75,25,21,4,33,20,13,12,8,4,-5,-3,-2,58%,58%,56%,131,181,56,23%,26%,11%,2,1,1,7,4,3
23,https://vlr.gg/player/34825/han,2024-12-07 04:15:00,0.43,1.00,0.66,142,96,218,21,8,13,33,20,13,4,3,1,0,-1,+1,65%,54%,81%,105,69,159,23%,15%,29%,4,2,2,4,3,1
24,https://vlr.gg/player/27458/esco,2024-12-07 04:15:00,0.47,0.67,0.55,134,108,156,15,7,8,34,21,13,6,4,2,-3,-4,+1,50%,50%,50%,90,75,112,22%,22%,22%,5,2,3,8,6,2
25,https://vlr.gg/player/10642/jan,2024-12-07 04:15:00,1.75,1.32,1.49,213,269,182,33,19,14,14,5,9,12,2,10,+4,+2,+2,88%,88%,88%,143,174,122,31%,41%,22%,5,3,2,1,1,0
26,https://vlr.gg/player/25279/sakura,2024-12-07 04:15:00,1.66,1.28,1.43,296,344,265,42,20,22,25,10,15,19,7,12,+1,+1,0,83%,75%,88%,182,210,163,38%,36%,41%,5,1,4,4,0,4
27,https://vlr.gg/player/17111/allen,2024-12-07 04:15:00,1.34,1.31,1.32,205,168,220,29,9,20,17,6,11,23,10,13,+1,0,+1,93%,88%,96%,132,107,149,25%,19%,27%,2,0,2,1,0,1
28,https://vlr.gg/player/43072/jinbey,2024-12-07 04:15:00,0.36,1.49,1.04,243,133,299,32,7,25,29,14,15,14,4,10,+3,-3,+6,75%,63%,83%,152,83,197,21%,21%,20%,11,3,8,8,6,2
29,https://vlr.gg/player/46355/jerry,2024-12-07 04:15:00,1.10,0.85,0.95,188,209,172,29,12,17,27,11,16,11,4,7,0,0,0,78%,81%,75%,124,153,105,35%,30%,41%,2,1,1,2,1,1
30,https://vlr.gg/player/9290/madelyn,2024-12-07 03:30:00,1.42,1.25,1.36,198,216,175,26,18,8,18,12,6,28,24,4,+3,+2,+1,78%,83%,69%,117,111,130,21%,20%,22%,3,2,1,0,0,0
31,https://vlr.gg/player/10749/k1ngkappa,2024-12-07 03:30:00,1.03,1.66,1.25,236,207,305,32,19,13,23,16,7,8,3,5,+1,0,+1,73%,75%,69%,173,155,207,41%,45%,36%,2,1,1,1,1,0
32,https://vlr.gg/player/4872/frostmind,2024-12-07 03:30:00,1.24,1.08,1.18,186,185,192,26,17,9,20,12,8,13,8,5,+2,+1,+1,86%,92%,77%,133,133,132,41%,41%,42%,3,1,2,1,0,1
33,https://vlr.gg/player/9263/sayoo,2024-12-07 03:30:00,1.18,0.98,1.11,234,233,211,30,20,10,25,16,9,14,13,1,+5,+3,+2,78%,88%,62%,144,149,134,29%,28%,31%,7,4,3,2,1,1
34,https://vlr.gg/player/26829/damaraa,2024-12-07 03:30:00,1.21,0.62,1.01,263,322,147,35,28,7,29,19,10,3,3,0,0,0,0,73%,83%,54%,158,197,87,23%,26%,16%,9,7,2,9,7,2
35,https://vlr.gg/player/18704/levi,2024-12-07 03:30:00,0.70,1.36,1.13,248,133,307,31,6,25,28,9,19,12,6,6,0,-3,+3,73%,69%,75%,148,77,187,36%,28%,38%,3,0,3,3,3,0
36,https://vlr.gg/player/12947/rawfiul,2024-12-07 03:30:00,1.17,1.08,1.11,236,269,216,31,12,19,29,10,19,6,2,4,-2,-1,-1,65%,69%,63%,152,172,142,36%,36%,37%,5,2,3,7,3,4
37,https://vlr.gg/player/13221/azys,2024-12-07 03:30:00,1.69,0.69,1.04,234,346,171,30,16,14,30,8,22,6,0,6,-2,+1,-3,70%,77%,67%,156,226,118,43%,43%,44%,5,2,3,7,1,6
38,https://vlr.gg/player/3628/deathmaker,2024-12-07 03:30:00,0.36,0.64,0.54,130,57,173,14,3,11,32,10,22,11,1,10,-4,0,-4,65%,69%,63%,92,32,125,13%,0%,16%,0,0,0,4,0,4
39,https://vlr.gg/player/3269/antidote,2024-12-07 03:30:00,0.38,0.38,0.38,88,93,85,9,3,6,30,10,20,8,4,4,-3,-2,-1,54%,62%,50%,64,70,62,21%,10%,30%,0,0,0,3,2,1
40,https://vlr.gg/player/37393/luca,2024-12-07 02:00:00,0.92,1.44,1.16,235,177,303,31,13,18,27,15,12,12,6,6,-4,-3,-1,68%,60%,76%,153,112,202,32%,30%,33%,0,0,0,4,3,1
41,https://vlr.gg/player/47482/flora,2024-12-07 02:00:00,0.80,1.10,0.94,186,162,209,23,11,12,27,15,12,8,2,6,-1,-2,+1,62%,50%,76%,111,101,122,32%,44%,24%,3,1,2,4,3,1
42,https://vlr.gg/player/31845/chay,2024-12-07 02:00:00,0.92,0.91,0.88,181,190,176,25,13,12,30,16,14,8,3,5,-5,-3,-2,68%,70%,65%,126,126,126,31%,34%,27%,0,0,0,5,3,2
43,https://vlr.gg/player/45853/r1va,2024-12-07 02:00:00,0.65,0.97,0.80,161,157,167,20,9,11,29,16,13,6,2,4,-1,+1,-2,57%,45%,71%,113,111,116,36%,36%,36%,2,1,1,3,0,3
44,https://vlr.gg/player/45852/g4ll,2024-12-07 02:00:00,0.26,0.44,0.34,131,95,176,14,6,8,36,19,17,9,1,8,0,+1,-1,57%,45%,71%,82,60,108,10%,8%,12%,8,5,3,8,4,4
45,https://vlr.gg/player/1960/eko,2024-12-07 02:00:00,1.62,1.54,1.58,339,378,309,43,22,21,26,14,12,11,6,5,+5,+3,+2,92%,94%,90%,204,215,194,20%,18%,23%,6,4,2,1,1,0
46,https://vlr.gg/player/6676/thiefy,2024-12-07 02:00:00,1.37,1.10,1.23,227,257,203,32,16,16,23,11,12,9,5,4,+3,0,+3,76%,76%,75%,147,168,129,32%,31%,32%,4,1,3,1,1,0
47,https://vlr.gg/player/1027/marin,2024-12-07 02:00:00,0.97,1.23,1.11,178,193,167,24,11,13,18,11,7,8,4,4,+2,+1,+1,76%,71%,80%,128,144,115,31%,25%,40%,4,2,2,2,1,1
48,https://vlr.gg/player/1952/esperanza,2024-12-07 02:00:00,0.68,1.26,0.99,212,144,266,28,9,19,24,12,12,8,2,6,-3,0,-3,70%,65%,75%,134,85,176,26%,21%,28%,5,2,3,8,2,6
49,https://vlr.gg/player/7888/blackwiz,2024-12-07 02:00:00,0.72,1.16,0.95,156,150,160,22,10,12,22,13,9,18,8,10,+4,+1,+3,76%,71%,80%,102,97,107,25%,21%,28%,5,2,3,1,1,0
50,https://vlr.gg/player/7873/leaf,2024-12-06 23:45:00,0.66,1.80,1.15,267,205,352,20,8,12,18,12,6,3,1,2,+2,0,+2,57%,50%,67%,172,112,253,32%,29%,34%,6,3,3,4,3,1
51,https://vlr.gg/player/17323/mimi,2024-12-06 23:45:00,0.87,1.44,1.11,169,156,189,14,7,7,13,9,4,10,5,5,0,0,0,81%,75%,89%,109,82,145,32%,27%,37%,1,0,1,1,0,1
52,https://vlr.gg/player/15500/trent,2024-12-06 23:45:00,0.89,0.81,0.85,209,229,183,13,8,5,18,11,7,9,4,5,-2,-2,0,57%,58%,56%,144,159,123,24%,47%,13%,0,0,0,2,2,0
53,https://vlr.gg/player/24149/amy,2024-12-06 23:45:00,0.86,0.71,0.79,171,189,148,13,8,5,16,10,6,1,0,1,-2,-1,-1,62%,50%,78%,112,112,111,50%,53%,46%,0,0,0,2,1,1
54,https://vlr.gg/player/4581/jonahp,2024-12-06 23:45:00,0.64,0.92,0.76,186,146,239,13,6,7,17,10,7,7,3,4,+1,+1,0,71%,58%,89%,117,91,153,37%,35%,39%,3,2,1,2,1,1
55,https://vlr.gg/player/1818/tex,2024-12-06 23:45:00,0.50,1.90,1.30,269,141,366,19,4,15,13,8,5,5,0,5,+2,-1,+3,67%,56%,75%,158,97,205,35%,44%,33%,6,2,4,4,3,1
56,https://vlr.gg/player/9185/dodonut,2024-12-06 23:45:00,0.55,1.51,1.10,202,158,236,16,4,12,14,8,6,4,2,2,+1,+1,0,81%,78%,83%,142,104,171,40%,36%,43%,2,1,1,1,0,1
57,https://vlr.gg/player/26171/demon1,2024-12-06 23:45:00,1.17,0.94,1.04,220,202,235,18,7,11,15,6,9,6,4,2,-1,-1,0,67%,56%,75%,139,142,137,54%,53%,56%,2,0,2,3,1,2
58,https://vlr.gg/player/8849/sonder,2024-12-06 23:45:00,1.14,0.82,0.96,201,233,178,14,8,6,15,7,8,7,1,6,-1,0,-1,71%,78%,67%,136,146,128,31%,41%,25%,0,0,0,1,0,1
59,https://vlr.gg/player/619/c0m,2024-12-06 23:45:00,1.19,0.77,0.95,193,213,180,15,7,8,16,7,9,4,3,1,0,0,0,71%,67%,75%,130,145,119,38%,36%,39%,1,1,0,1,1,0
60,https://vlr.gg/player/18796/oxy,2024-12-06 22:30:00,1.59,2.36,1.98,438,392,485,37,15,22,16,10,6,5,4,1,+6,+2,+4,92%,92%,92%,280,273,287,42%,39%,46%,7,3,4,1,1,0
61,https://vlr.gg/player/17433/v1c,2024-12-06 22:30:00,1.52,1.04,1.28,246,283,210,21,13,8,16,8,8,13,9,4,-3,-2,-1,79%,83%,75%,164,179,149,33%,24%,45%,1,0,1,4,2,2
62,https://vlr.gg/player/21486/sarahcat,2024-12-06 22:30:00,1.23,0.33,0.78,151,228,74,12,10,2,17,8,9,4,1,3,+1,+1,0,71%,83%,58%,119,171,68,34%,43%,18%,1,1,0,0,0,0
63,https://vlr.gg/player/3079/alexis,2024-12-06 22:30:00,0.64,0.60,0.62,101,132,71,8,5,3,17,9,8,14,10,4,0,+1,-1,75%,92%,58%,64,77,51,32%,25%,43%,1,1,0,1,0,1
64,https://vlr.gg/player/7458/moose,2024-12-06 22:30:00,0.05,0.95,0.50,131,40,223,10,2,8,20,10,10,7,0,7,0,0,0,58%,42%,75%,86,21,151,27%,33%,26%,4,2,2,4,2,2
65,https://vlr.gg/player/31574/srn,2024-12-06 22:30:00,1.00,1.39,1.20,295,204,388,25,9,16,19,9,10,0,0,0,+1,-1,+2,58%,50%,67%,191,138,244,27%,47%,19%,7,2,5,6,3,3
66,https://vlr.gg/player/5957/artzin,2024-12-06 22:30:00,1.18,1.05,1.12,215,213,219,19,10,9,16,7,9,4,1,3,0,+1,-1,75%,83%,67%,125,124,125,28%,26%,30%,2,2,0,2,1,1
67,https://vlr.gg/player/21435/jelly,2024-12-06 22:30:00,1.10,1.08,1.09,215,184,248,17,7,10,18,9,9,12,7,5,-1,+1,-2,75%,75%,75%,149,136,161,38%,36%,40%,1,1,0,2,0,2
68,https://vlr.gg/player/725/nzr,2024-12-06 22:30:00,0.83,1.05,0.94,180,218,143,16,9,7,18,10,8,6,3,3,-1,0,-1,79%,92%,67%,120,155,85,20%,20%,20%,0,0,0,1,0,1
69,https://vlr.gg/player/11239/sayuri,2024-12-06 22:30:00,0.79,0.59,0.69,101,136,66,9,6,3,17,8,9,10,5,5,-3,-3,0,79%,75%,83%,74,100,47,32%,47%,10%,0,0,0,3,3,0
70,https://vlr.gg/player/18796/oxy,2024-12-06 21:15:00,1.49,1.61,1.55,325,348,303,31,17,14,17,9,8,2,1,1,+8,+4,+4,81%,77%,85%,193,208,177,27%,26%,30%,11,6,5,3,2,1
71,https://vlr.gg/player/7458/moose,2024-12-06 21:15:00,1.41,0.85,1.13,198,302,94,19,14,5,14,8,6,3,3,0,+1,+1,0,73%,85%,62%,115,171,59,25%,24%,27%,2,2,0,1,1,0
72,https://vlr.gg/player/17433/v1c,2024-12-06 21:15:00,1.02,0.79,0.91,181,184,178,15,8,7,16,7,9,13,7,6,-4,-2,-2,69%,85%,54%,114,119,108,22%,18%,27%,0,0,0,4,2,2
73,https://vlr.gg/player/3079/alexis,2024-12-06 21:15:00,1.21,0.59,0.90,144,154,134,11,7,4,16,5,11,16,11,5,-1,0,-1,65%,85%,46%,99,97,101,21%,19%,23%,1,0,1,2,0,2
74,https://vlr.gg/player/21486/sarahcat,2024-12-06 21:15:00,1.13,0.64,0.88,195,217,174,18,11,7,17,7,10,5,2,3,0,0,0,77%,77%,77%,122,136,109,25%,28%,21%,1,0,1,1,0,1
75,https://vlr.gg/player/15500/trent,2024-12-06 21:15:00,1.37,1.90,1.64,283,190,376,23,7,16,15,5,10,11,5,6,0,+1,-1,81%,85%,77%,184,137,231,12%,9%,13%,2,1,1,2,0,2
76,https://vlr.gg/player/7873/leaf,2024-12-06 21:15:00,1.15,0.80,0.98,199,233,165,17,10,7,19,8,11,10,5,5,-1,-2,+1,62%,69%,54%,132,154,110,26%,23%,32%,4,2,2,5,4,1
77,https://vlr.gg/player/4581/jonahp,2024-12-06 21:15:00,1.07,0.51,0.79,138,136,141,13,8,5,17,5,12,5,2,3,-1,0,-1,69%,77%,62%,89,80,98,33%,33%,32%,2,1,1,3,1,2
78,https://vlr.gg/player/17323/mimi,2024-12-06 21:15:00,0.92,0.49,0.71,163,203,125,14,9,5,22,10,12,10,4,6,0,0,0,69%,77%,62%,117,154,79,27%,26%,28%,2,1,1,2,1,1
79,https://vlr.gg/player/24149/amy,2024-12-06 21:15:00,0.79,0.23,0.51,139,209,70,13,10,3,21,9,12,5,2,3,-2,0,-2,58%,69%,46%,83,115,52,24%,32%,13%,1,1,0,3,1,2
80,https://vlr.gg/player/31574/srn,2024-12-06 20:15:00,1.26,0.64,1.08,263,306,163,15,12,3,14,9,5,1,0,1,+2,+3,-1,71%,67%,80%,162,186,105,45%,38%,80%,4,4,0,2,1,1
81,https://vlr.gg/player/5957/artzin,2024-12-06 20:15:00,1.13,0.55,0.96,245,261,209,14,11,3,14,9,5,1,1,0,+1,+1,0,76%,83%,60%,156,161,146,41%,39%,44%,4,3,1,3,2,1
82,https://vlr.gg/player/21435/jelly,2024-12-06 20:15:00,0.89,0.80,0.86,154,135,200,9,5,4,13,8,5,7,7,0,+1,0,+1,71%,67%,80%,100,91,123,33%,29%,43%,1,0,1,0,0,0
83,https://vlr.gg/player/725/nzr,2024-12-06 20:15:00,0.73,0.06,0.53,118,145,53,6,5,1,14,9,5,3,3,0,-1,-1,0,47%,58%,20%,84,105,32,19%,17%,25%,0,0,0,1,1,0
84,https://vlr.gg/player/11239/sayuri,2024-12-06 20:15:00,0.27,0.02,0.17,37,40,32,2,2,0,13,8,5,3,0,3,-2,-1,-1,47%,50%,40%,26,30,17,33%,67%,0%,0,0,0,2,1,1
85,https://vlr.gg/player/26171/demon1,2024-12-06 20:15:00,3.00,1.63,2.04,305,437,251,20,9,11,7,1,6,6,4,2,+1,+1,0,71%,100%,58%,224,312,187,44%,59%,35%,3,1,2,2,0,2
86,https://vlr.gg/player/8849/sonder,2024-12-06 20:15:00,1.88,1.24,1.43,225,239,220,14,5,9,8,1,7,5,0,5,+2,+1,+1,82%,100%,75%,152,126,163,31%,33%,30%,2,1,1,0,0,0
87,https://vlr.gg/player/9185/dodonut,2024-12-06 20:15:00,1.30,1.26,1.27,176,134,195,12,3,9,7,1,6,3,2,1,0,0,0,76%,80%,75%,136,119,143,36%,25%,41%,0,0,0,0,0,0
88,https://vlr.gg/player/619/c0m,2024-12-06 20:15:00,1.58,0.83,1.05,243,324,210,16,6,10,12,4,8,3,2,1,-1,+1,-2,65%,100%,50%,159,251,120,37%,46%,29%,2,1,1,3,0,3
89,https://vlr.gg/player/1818/tex,2024-12-06 20:15:00,0.21,0.63,0.50,104,100,106,6,2,4,12,4,8,3,1,2,-3,-2,-1,59%,60%,58%,83,81,83,33%,40%,31%,1,0,1,4,2,2
90,https://vlr.gg/player/18796/oxy,2024-12-06 18:40:00,1.19,1.13,1.16,264,282,247,25,14,11,19,9,10,6,1,5,0,0,0,77%,77%,77%,171,168,175,22%,25%,19%,4,3,1,4,3,1
91,https://vlr.gg/player/17433/v1c,2024-12-06 18:40:00,0.85,1.42,1.13,195,143,247,17,6,11,17,9,8,15,5,10,0,0,0,81%,85%,77%,126,97,154,33%,39%,29%,0,0,0,0,0,0
92,https://vlr.gg/player/7458/moose,2024-12-06 18:40:00,1.05,1.15,1.10,211,218,204,18,10,8,16,10,6,3,0,3,-2,0,-2,69%,62%,77%,149,161,136,27%,31%,24%,1,1,0,3,1,2
93,https://vlr.gg/player/3079/alexis,2024-12-06 18:40:00,1.21,0.98,1.10,194,222,167,17,9,8,17,8,9,23,11,12,-1,0,-1,85%,77%,92%,115,144,85,35%,27%,55%,4,2,2,5,2,3
94,https://vlr.gg/player/21486/sarahcat,2024-12-06 18:40:00,0.80,1.22,1.01,208,161,255,20,7,13,18,10,8,4,1,3,+1,-1,+2,77%,69%,85%,135,112,159,27%,46%,19%,3,0,3,2,1,1
95,https://vlr.gg/player/26171/demon1,2024-12-06 18:40:00,0.94,1.54,1.24,233,203,264,21,9,12,18,10,8,7,3,4,+2,0,+2,69%,69%,69%,174,152,196,24%,18%,29%,2,0,2,0,0,0
96,https://vlr.gg/player/9185/dodonut,2024-12-06 18:40:00,1.35,1.04,1.19,223,253,194,21,11,10,18,9,9,7,4,3,+3,+2,+1,77%,85%,69%,163,188,138,30%,31%,29%,4,2,2,1,0,1
97,https://vlr.gg/player/1818/tex,2024-12-06 18:40:00,0.90,1.19,1.04,241,217,265,21,9,12,22,12,10,8,5,3,+2,+2,0,77%,77%,77%,168,134,203,29%,27%,31%,4,3,1,2,1,1
98,https://vlr.gg/player/8849/sonder,2024-12-06 18:40:00,0.96,0.38,0.67,143,188,98,13,10,3,20,9,11,10,2,8,+1,+2,-1,73%,77%,69%,108,129,87,18%,25%,14%,3,2,1,2,0,2
99,https://vlr.gg/player/619/c0m,2024-12-06 18:40:00,0.09,1.00,0.55,117,61,174,11,2,9,19,11,8,5,4,1,-6,-5,-1,65%,69%,62%,73,39,107,21%,25%,19%,1,0,1,7,5,2
100,https://vlr.gg/player/25858/sw,2024-12-06 18:00:00,1.20,0.87,1.05,216,265,153,48,33,15,41,25,16,13,8,5,+3,+1,+2,73%,74%,70%,137,163,102,41%,39%,47%,9,4,5,6,3,3
101,https://vlr.gg/player/5722/prince,2024-12-06 18:00:00,0.97,1.12,1.04,203,183,241,46,23,23,44,24,20,19,13,6,0,-2,+2,74%,77%,70%,139,121,162,32%,27%,36%,5,1,4,5,3,2
102,https://vlr.gg/player/2486/pollo,2024-12-06 18:00:00,1.01,0.89,0.95,197,194,200,44,26,18,44,23,21,7,4,3,-1,-1,0,66%,66%,67%,126,126,127,32%,35%,30%,6,3,3,7,4,3
103,https://vlr.gg/player/1578/shion,2024-12-06 18:00:00,0.90,0.95,0.92,176,186,166,37,22,15,42,24,18,27,15,12,-3,-3,0,77%,80%,74%,113,114,112,19%,23%,13%,3,2,1,6,5,1
104,https://vlr.gg/player/41224/tkzin,2024-12-06 18:00:00,0.86,0.81,0.84,183,193,177,39,23,16,49,28,21,17,10,7,-6,-6,0,69%,71%,67%,126,122,132,23%,24%,21%,4,2,2,10,8,2
105,https://vlr.gg/player/21659/sato,2024-12-06 18:00:00,1.16,1.10,1.13,231,237,224,49,22,27,42,18,24,16,8,8,+3,-3,+6,76%,74%,77%,141,144,138,28%,33%,23%,10,2,8,7,5,2
106,https://vlr.gg/player/1566/prozin,2024-12-06 18:00:00,0.81,1.22,1.04,206,135,252,46,15,31,42,17,25,11,3,8,+4,0,+4,65%,59%,69%,131,90,162,36%,33%,38%,7,2,5,3,2,1
107,https://vlr.gg/player/28716/lukxo,2024-12-06 18:00:00,1.13,0.89,1.00,234,265,215,53,26,27,48,21,27,10,6,4,+1,0,+1,68%,70%,66%,159,183,140,37%,33%,42%,11,5,6,10,5,5
108,https://vlr.gg/player/5351/rglmeister,2024-12-06 18:00:00,0.90,1.00,0.96,158,153,167,35,13,22,40,16,24,27,12,15,+1,-1,+2,71%,74%,69%,103,97,107,29%,23%,33%,2,0,2,1,1,0
109,https://vlr.gg/player/6238/urango,2024-12-06 18:00:00,0.89,0.70,0.78,148,147,149,32,15,17,42,15,27,10,5,5,-2,0,-2,60%,67%,54%,103,98,107,32%,29%,35%,4,2,2,6,2,4
110,https://vlr.gg/player/36052/haitam,2024-12-06 17:40:00,1.02,1.86,1.45,265,198,330,44,15,29,25,15,10,10,3,7,+7,0,+7,81%,65%,96%,176,137,213,28%,37%,23%,9,2,7,2,2,0
111,https://vlr.gg/player/49799/tafg,2024-12-06 17:40:00,0.75,1.51,1.14,265,221,302,44,17,27,34,19,15,12,4,8,+3,0,+3,70%,61%,79%,159,146,172,29%,35%,24%,9,5,4,6,5,1
112,https://vlr.gg/player/48984/kramz,2024-12-06 17:40:00,1.20,0.97,1.08,207,258,159,36,24,12,31,18,13,16,1,15,+1,0,+1,72%,65%,79%,125,155,97,13%,12%,14%,4,1,3,3,1,2
113,https://vlr.gg/player/41134/nx1,2024-12-06 17:40:00,0.79,1.28,1.04,174,156,194,29,12,17,29,17,12,27,8,19,+2,0,+2,70%,65%,75%,115,100,130,27%,29%,26%,4,1,3,2,1,1
114,https://vlr.gg/player/48864/mrtn,2024-12-06 17:40:00,0.74,0.89,0.82,139,110,167,21,8,13,32,16,16,18,9,9,-2,+1,-3,70%,70%,71%,94,71,115,17%,14%,19%,3,3,0,5,2,3
115,https://vlr.gg/player/49825/ic0nic,2024-12-06 17:40:00,1.20,1.11,1.15,220,241,199,37,20,17,31,17,14,13,7,6,-1,0,-1,77%,79%,74%,145,157,132,28%,26%,31%,3,1,2,4,1,3
116,https://vlr.gg/player/49826/tortitatriste,2024-12-06 17:40:00,0.78,1.22,1.00,203,183,226,35,16,19,34,20,14,5,2,3,-5,-4,-1,62%,54%,70%,141,124,159,24%,28%,20%,8,4,4,13,8,5
117,https://vlr.gg/player/38364/grimmjow,2024-12-06 17:40:00,0.55,1.34,0.94,197,130,267,32,9,23,37,21,16,11,6,5,+1,-1,+2,68%,54%,83%,131,95,170,21%,15%,27%,2,0,2,1,1,0
118,https://vlr.gg/player/38359/lojan,2024-12-06 17:40:00,0.78,0.92,0.85,185,179,191,26,13,13,35,20,15,20,8,12,-2,-2,0,60%,50%,70%,125,127,123,22%,23%,22%,5,2,3,7,4,3
119,https://vlr.gg/player/33573/necro,2024-12-06 17:40:00,0.51,0.89,0.69,144,124,163,21,8,13,37,20,17,13,6,7,-4,-3,-1,64%,54%,74%,99,87,112,17%,16%,18%,0,0,0,4,3,1
120,https://vlr.gg/player/5957/artzin,2024-12-06 17:00:00,2.40,0.60,1.54,303,412,184,24,18,6,15,4,11,7,6,1,+2,+3,-1,70%,92%,45%,191,263,114,28%,29%,28%,6,4,2,4,1,3
121,https://vlr.gg/player/21435/jelly,2024-12-06 17:00:00,1.44,0.65,1.06,190,201,179,15,9,6,15,4,11,8,6,2,+1,+2,-1,74%,92%,55%,110,104,116,26%,15%,47%,2,2,0,1,0,1
122,https://vlr.gg/player/725/nzr,2024-12-06 17:00:00,1.34,0.44,0.91,182,224,137,15,10,5,15,5,10,5,5,0,+2,0,+2,65%,92%,36%,132,170,90,33%,33%,33%,2,0,2,0,0,0
123,https://vlr.gg/player/11239/sayuri,2024-12-06 17:00:00,1.19,0.39,0.80,139,172,105,12,8,4,16,6,10,13,9,4,-2,-2,0,65%,83%,45%,107,122,89,24%,13%,45%,0,0,0,2,2,0
124,https://vlr.gg/player/31574/srn,2024-12-06 17:00:00,1.14,0.26,0.72,196,257,132,15,11,4,18,7,11,5,3,2,+2,+1,+1,74%,83%,64%,133,182,80,30%,33%,20%,4,2,2,2,1,1
125,https://vlr.gg/player/15500/trent,2024-12-06 17:00:00,1.73,0.85,1.27,219,245,196,17,10,7,12,2,10,7,4,3,-1,0,-1,70%,82%,58%,150,165,137,25%,21%,35%,0,0,0,1,0,1
126,https://vlr.gg/player/4581/jonahp,2024-12-06 17:00:00,1.60,0.62,1.09,226,282,175,18,12,6,17,5,12,5,3,2,-1,0,-1,65%,82%,50%,146,181,114,26%,37%,17%,2,1,1,3,1,2
127,https://vlr.gg/player/24149/amy,2024-12-06 17:00:00,1.98,0.22,1.06,192,314,80,17,14,3,15,4,11,7,4,3,-2,0,-2,65%,91%,42%,128,211,53,38%,34%,50%,0,0,0,2,0,2
128,https://vlr.gg/player/7873/leaf,2024-12-06 17:00:00,1.44,0.44,0.92,243,336,159,18,13,5,20,8,12,6,4,2,+3,+1,+2,61%,91%,33%,151,196,111,25%,37%,13%,6,4,2,3,3,0
129,https://vlr.gg/player/17323/mimi,2024-12-06 17:00:00,0.80,0.56,0.67,107,94,121,9,4,5,17,6,11,13,9,4,-4,-2,-2,65%,82%,50%,73,60,85,39%,40%,38%,1,0,1,5,2,3
130,https://vlr.gg/player/15916/jotinha,2024-12-06 15:25:00,1.14,1.36,1.24,242,205,264,36,19,17,27,14,13,11,4,7,-1,0,-1,61%,56%,68%,147,131,168,29%,33%,26%,4,1,3,5,1,4
131,https://vlr.gg/player/2586/hanling,2024-12-06 15:25:00,1.34,1.05,1.21,215,246,142,31,22,9,24,14,10,23,18,5,-3,-1,-2,84%,92%,74%,129,157,92,28%,29%,28%,1,0,1,4,1,3
132,https://vlr.gg/player/2818/neto,2024-12-06 15:25:00,0.89,1.23,1.04,210,207,223,36,21,15,29,17,12,10,1,9,-1,-1,0,70%,68%,74%,138,133,145,41%,45%,34%,6,5,1,7,6,1
133,https://vlr.gg/player/2403/mizu,2024-12-06 15:25:00,0.83,1.27,1.02,205,194,231,33,16,17,29,18,11,8,4,4,+1,0,+1,64%,52%,79%,131,116,152,42%,50%,33%,6,3,3,5,3,2
134,https://vlr.gg/player/1291/bnj,2024-12-06 15:25:00,1.02,1.02,1.02,180,218,149,28,18,10,29,19,10,16,12,4,0,+1,-1,77%,76%,79%,133,159,100,48%,41%,67%,3,3,0,3,2,1
135,https://vlr.gg/player/8730/1kuzohh,2024-12-06 15:25:00,1.09,1.26,1.19,249,246,249,39,17,22,33,16,17,8,3,5,+5,+2,+3,70%,68%,72%,151,138,161,20%,20%,19%,13,6,7,8,4,4
136,https://vlr.gg/player/2931/vaiz,2024-12-06 15:25:00,0.95,0.81,0.87,191,175,195,26,11,15,31,12,19,15,8,7,0,0,0,73%,74%,72%,119,110,126,15%,16%,14%,5,2,3,5,2,3
137,https://vlr.gg/player/8278/knzy,2024-12-06 15:25:00,0.70,0.86,0.79,166,166,173,28,12,16,36,17,19,6,2,4,-2,-1,-1,61%,63%,60%,112,105,116,19%,36%,12%,1,0,1,3,1,2
138,https://vlr.gg/player/1309/tio,2024-12-06 15:25:00,0.91,0.64,0.76,159,161,149,23,10,13,31,12,19,15,9,6,+2,+2,0,73%,84%,64%,97,104,92,19%,33%,11%,3,2,1,1,0,1
139,https://vlr.gg/player/2909/alca,2024-12-06 15:25:00,0.29,0.92,0.63,129,69,180,20,5,15,34,13,21,7,2,5,-1,0,-1,59%,58%,60%,95,53,127,34%,20%,40%,2,1,1,3,1,2
140,https://vlr.gg/player/8881/leozin,2024-12-06 15:00:00,1.48,1.63,1.56,261,243,278,39,17,22,22,8,14,22,9,13,+1,-1,+2,82%,89%,75%,180,166,193,35%,59%,22%,3,0,3,2,1,1
141,https://vlr.gg/player/1581/guhrvn,2024-12-06 15:00:00,1.60,1.24,1.42,230,217,243,32,15,17,22,6,16,18,5,13,+4,+1,+3,90%,79%,100%,169,163,175,37%,44%,33%,6,3,3,2,2,0
142,https://vlr.gg/player/13093/jzz,2024-12-06 15:00:00,1.12,1.26,1.19,188,140,232,32,10,22,19,7,12,10,4,6,+1,0,+1,82%,79%,85%,115,84,145,28%,24%,31%,2,0,2,1,0,1
143,https://vlr.gg/player/3455/zanatsu,2024-12-06 15:00:00,0.73,1.50,1.13,236,155,309,36,9,27,28,13,15,9,7,2,0,-3,+3,85%,84%,85%,153,104,200,25%,23%,25%,6,1,5,6,4,2
144,https://vlr.gg/player/15361/swag,2024-12-06 15:00:00,1.34,0.70,1.01,147,175,119,24,12,12,22,7,15,21,8,13,-3,0,-3,82%,95%,70%,92,98,88,20%,29%,13%,2,2,0,5,2,3
145,https://vlr.gg/player/36433/phc,2024-12-06 15:00:00,0.99,1.17,1.08,181,186,174,28,14,14,29,15,14,10,3,7,+2,0,+2,72%,60%,84%,112,123,101,35%,32%,38%,3,0,3,1,0,1
146,https://vlr.gg/player/3424/siduzord,2024-12-06 15:00:00,1.05,0.80,0.93,175,221,125,26,15,11,31,18,13,7,4,3,-1,-1,0,72%,70%,74%,113,147,77,23%,26%,18%,3,1,2,4,2,2
147,https://vlr.gg/player/1567/bezn1,2024-12-06 15:00:00,0.55,0.69,0.62,135,150,123,18,9,9,34,19,15,14,7,7,-1,-1,0,69%,65%,74%,101,105,97,22%,21%,24%,2,1,1,3,2,1
148,https://vlr.gg/player/6202/guuih,2024-12-06 15:00:00,0.84,0.18,0.60,133,155,98,9,7,2,16,9,7,2,2,0,0,-1,+1,47%,50%,43%,89,106,59,35%,36%,33%,2,1,1,2,2,0
149,https://vlr.gg/player/32675/kring,2024-12-06 15:00:00,0.62,0.56,0.59,182,197,169,30,11,19,35,19,16,5,4,1,-1,-3,+2,56%,55%,58%,120,125,116,39%,41%,37%,6,4,2,7,7,0
150,https://vlr.gg/player/33035/dgx,2024-12-06 15:00:00,0.11,0.30,0.23,41,28,51,2,1,1,18,6,12,2,0,2,-2,0,-2,45%,38%,50%,38,26,46,14%,25%,10%,0,0,0,2,0,2
151,https://vlr.gg/player/1428/sheydos,2024-12-06 11:50:00,0.92,1.04,0.96,185,161,227,11,6,5,15,9,6,4,3,1,0,0,0,68%,67%,71%,145,123,184,22%,11%,39%,0,0,0,0,0,0
152,https://vlr.gg/player/101/soulcas,2024-12-06 11:50:00,0.47,1.21,0.74,189,104,336,13,5,8,17,10,7,2,1,1,-2,-3,+1,47%,33%,71%,126,82,201,32%,50%,24%,2,0,2,4,3,1
153,https://vlr.gg/player/5550/grubinho,2024-12-06 11:50:00,1.05,0.15,0.72,138,196,40,9,9,0,14,9,5,6,3,3,-3,-1,-2,47%,50%,43%,88,115,42,24%,25%,20%,0,0,0,3,1,2
154,https://vlr.gg/player/4544/filu,2024-12-06 11:50:00,0.27,0.77,0.46,158,136,198,10,5,5,17,12,5,2,1,1,-4,-4,0,47%,25%,86%,95,72,135,22%,21%,22%,2,1,1,6,5,1
155,https://vlr.gg/player/3685/flyuh,2024-12-06 11:50:00,0.26,0.68,0.42,97,88,114,6,3,3,16,11,5,6,2,4,-2,-2,0,63%,50%,86%,64,54,82,13%,6%,29%,0,0,0,2,2,0
156,https://vlr.gg/player/16459/elite,2024-12-06 11:50:00,1.75,1.30,1.46,243,291,216,19,8,11,8,3,5,7,5,2,+1,0,+1,89%,86%,92%,153,154,152,55%,50%,58%,1,0,1,0,0,0
157,https://vlr.gg/player/2858/suygetsu,2024-12-06 11:50:00,1.26,1.52,1.42,177,158,189,13,5,8,6,3,3,8,1,7,+1,0,+1,89%,71%,100%,124,126,122,32%,38%,28%,2,1,1,1,1,0
158,https://vlr.gg/player/727/saadhak,2024-12-06 11:50:00,0.87,1.74,1.42,228,102,303,14,2,12,10,4,6,8,3,5,+3,-1,+4,74%,57%,83%,151,95,185,27%,14%,32%,4,0,4,1,1,0
159,https://vlr.gg/player/10307/marteen,2024-12-06 11:50:00,1.07,1.28,1.20,264,288,251,20,8,12,14,7,7,5,1,4,+4,+2,+2,84%,86%,83%,164,177,156,28%,26%,30%,5,2,3,1,0,1
160,https://vlr.gg/player/5654/avez,2024-12-06 11:50:00,1.29,1.05,1.14,194,231,174,13,5,8,11,4,7,8,3,5,+2,0,+2,84%,86%,83%,118,150,100,38%,42%,35%,3,1,2,1,1,0
161,https://vlr.gg/player/3639/hoax,2024-12-06 07:30:00,0.97,1.54,1.30,234,157,287,43,12,31,31,14,17,27,9,18,+1,-1,+2,85%,77%,90%,155,110,189,26%,29%,24%,3,1,2,2,2,0
162,https://vlr.gg/player/27775/techno,2024-12-06 07:30:00,1.27,1.23,1.25,220,237,207,41,19,22,33,14,19,25,9,16,+2,+1,+1,79%,86%,73%,142,154,132,26%,25%,26%,4,2,2,2,1,1
163,https://vlr.gg/player/26376/deecee,2024-12-06 07:30:00,1.66,0.90,1.22,226,315,165,43,25,18,33,13,20,13,7,6,+1,+5,-4,77%,86%,70%,152,193,122,21%,15%,33%,7,5,2,6,0,6
164,https://vlr.gg/player/3627/hellff,2024-12-06 07:30:00,1.16,1.05,1.10,196,207,186,36,18,18,31,13,18,16,5,11,+2,+2,0,73%,68%,77%,124,137,115,28%,33%,24%,6,2,4,4,0,4
165,https://vlr.gg/player/30693/makaveli,2024-12-06 07:30:00,0.52,0.81,0.69,164,142,175,29,11,18,37,16,21,9,4,5,-8,-7,-1,58%,50%,63%,112,88,130,30%,20%,38%,5,1,4,13,8,5
166,https://vlr.gg/player/30575/r1sen,2024-12-06 07:30:00,1.24,0.97,1.13,212,217,208,38,23,15,38,20,18,12,4,8,+5,+5,0,73%,70%,77%,137,135,140,37%,41%,31%,7,6,1,2,1,1
167,https://vlr.gg/player/40912/123,2024-12-06 07:30:00,0.91,1.39,1.11,273,255,310,51,28,23,42,25,17,13,5,8,+2,+1,+1,73%,67%,82%,170,152,194,28%,26%,31%,12,6,6,10,5,5
168,https://vlr.gg/player/18702/deadly10,2024-12-06 07:30:00,0.81,0.90,0.85,166,160,175,32,18,14,38,22,16,8,2,6,+2,+2,0,75%,70%,82%,105,100,112,29%,24%,36%,4,2,2,2,0,2
169,https://vlr.gg/player/44919/aplycs,2024-12-06 07:30:00,0.95,0.51,0.75,118,149,75,19,15,4,36,19,17,23,11,12,-2,-2,0,63%,67%,59%,80,104,46,18%,24%,5%,3,2,1,5,4,1
170,https://vlr.gg/player/19231/kibojn,2024-12-06 07:30:00,0.55,0.84,0.67,133,108,171,25,11,14,38,21,17,20,9,11,-5,-4,-1,60%,63%,55%,79,66,98,26%,30%,24%,1,0,1,6,4,2
171,https://vlr.gg/player/9801/f0rsaken,2024-12-06 06:30:00,,,,244,,,59,,,46,,,21,,,,,,,,,,,,,,,,,,,,
172,https://vlr.gg/player/9800/mindfreak,2024-12-06 06:30:00,,,,208,,,48,,,45,,,36,,,,,,,,,,,,,,,,,,,,
173,https://vlr.gg/player/9803/d4v41,2024-12-06 06:30:00,,,,204,,,51,,,50,,,23,,,,,,,,,,,,,,,,,,,,
174,https://vlr.gg/player/7378/jinggg,2024-12-06 06:30:00,,,,203,,,48,,,46,,,18,,,,,,,,,,,,,,,,,,,,
175,https://vlr.gg/player/17086/something,2024-12-06 06:30:00,,,,179,,,45,,,43,,,10,,,,,,,,,,,,,,,,,,,,
176,https://vlr.gg/player/14125/spring,2024-12-06 06:30:00,,,,223,,,49,,,53,,,17,,,,,,,,,,,,,,,,,,,,
177,https://vlr.gg/player/37489/lysoar,2024-12-06 06:30:00,,,,211,,,48,,,55,,,17,,,,,,,,,,,,,,,,,,,,
178,https://vlr.gg/player/7849/siufatbb,2024-12-06 06:30:00,,,,210,,,53,,,39,,,20,,,,,,,,,,,,,,,,,,,,
179,https://vlr.gg/player/7426/juicy,2024-12-06 06:30:00,,,,178,,,44,,,51,,,25,,,,,,,,,,,,,,,,,,,,
180,https://vlr.gg/player/11218/yuicaw,2024-12-06 06:30:00,,,,154,,,36,,,53,,,20,,,,,,,,,,,,,,,,,,,,
181,https://vlr.gg/player/47467/ady,2024-12-06 04:05:00,1.14,1.33,1.23,225,220,237,60,28,32,46,25,21,29,15,14,+1,+1,0,79%,81%,78%,149,152,147,20%,21%,19%,4,2,2,3,1,2
182,https://vlr.gg/player/10658/kurozooted,2024-12-06 04:05:00,1.00,1.08,1.04,194,182,214,53,25,28,50,25,25,29,6,23,-3,-2,-1,74%,69%,78%,128,123,133,25%,33%,18%,1,0,1,4,2,2
183,https://vlr.gg/player/47469/scope,2024-12-06 04:05:00,1.03,1.02,1.02,215,209,238,59,29,30,55,25,30,16,2,14,+1,-2,+3,70%,67%,73%,143,127,159,31%,41%,26%,10,3,7,9,5,4
184,https://vlr.gg/player/23971/ask,2024-12-06 04:05:00,0.68,1.14,0.88,188,136,222,39,14,25,50,27,23,24,11,13,-2,-2,0,73%,58%,86%,128,106,150,19%,22%,18%,2,0,2,4,2,2
185,https://vlr.gg/player/34785/yowamu,2024-12-06 04:05:00,0.65,0.79,0.72,171,190,156,42,21,21,57,32,25,14,7,7,0,+1,-1,66%,64%,68%,112,118,106,31%,29%,34%,18,11,7,18,10,8
186,https://vlr.gg/player/2671/popogachi,2024-12-06 04:05:00,1.44,1.74,1.59,311,300,343,81,37,44,46,25,21,21,11,10,+9,+2,+7,78%,70%,86%,214,201,227,26%,30%,24%,18,9,9,9,7,2
187,https://vlr.gg/player/47481/frxeez,2024-12-06 04:05:00,0.93,1.26,1.09,246,235,241,60,29,31,56,33,23,14,10,4,-1,-1,0,82%,84%,81%,153,150,156,26%,24%,28%,12,5,7,13,6,7
188,https://vlr.gg/player/44613/yamada,2024-12-06 04:05:00,0.87,1.23,1.04,184,162,213,47,20,27,49,26,23,42,20,22,+1,0,+1,79%,76%,83%,118,96,141,22%,11%,32%,2,1,1,1,1,0
189,https://vlr.gg/player/1971/oitan,2024-12-06 04:05:00,1.03,0.69,0.86,155,162,137,39,24,15,48,23,25,20,6,14,-6,-3,-3,64%,65%,64%,106,125,86,26%,28%,24%,2,1,1,8,4,4
190,https://vlr.gg/player/1973/ripablo,2024-12-06 04:05:00,0.57,0.70,0.63,107,108,123,29,14,15,54,29,25,32,13,19,0,+1,-1,71%,73%,69%,75,68,83,31%,34%,28%,4,2,2,4,1,3
191,https://vlr.gg/player/13221/azys,2024-12-06 03:30:00,1.40,1.50,1.45,310,294,327,87,39,48,52,27,25,11,8,3,+10,+3,+7,69%,67%,72%,199,199,198,33%,31%,35%,18,7,11,8,4,4
192,https://vlr.gg/player/18704/levi,2024-12-06 03:30:00,0.91,1.20,1.06,193,160,227,52,21,31,50,27,23,27,17,10,-1,-2,+1,72%,67%,77%,119,100,137,26%,19%,33%,5,2,3,6,4,2
193,https://vlr.gg/player/12947/rawfiul,2024-12-06 03:30:00,0.88,1.01,0.95,178,179,177,49,26,23,51,28,23,8,3,5,-2,-3,+1,71%,62%,79%,124,118,130,38%,44%,34%,7,3,4,9,6,3
194,https://vlr.gg/player/3269/antidote,2024-12-06 03:30:00,1.04,0.69,0.86,164,185,144,46,27,19,52,25,27,22,10,12,-1,+1,-2,67%,67%,67%,107,117,98,27%,31%,24%,6,5,1,7,4,3
195,https://vlr.gg/player/3628/deathmaker,2024-12-06 03:30:00,0.67,1.01,0.84,158,139,177,40,17,23,52,28,24,19,6,13,0,0,0,68%,64%,72%,111,99,123,28%,26%,30%,6,2,4,6,2,4
196,https://vlr.gg/player/3639/hoax,2024-12-06 03:30:00,1.11,1.03,1.07,184,184,185,48,25,23,51,25,26,26,11,15,+1,-3,+4,65%,64%,67%,131,131,131,30%,30%,29%,5,1,4,4,4,0
197,https://vlr.gg/player/3627/hellff,2024-12-06 03:30:00,0.92,1.03,0.98,195,185,205,52,25,27,56,31,25,27,13,14,+3,+3,0,76%,79%,72%,134,124,144,31%,29%,33%,8,5,3,5,2,3
198,https://vlr.gg/player/27336/venka,2024-12-06 03:30:00,1.12,0.84,0.98,226,247,206,64,34,30,61,30,31,9,6,3,-3,-1,-2,64%,64%,64%,143,162,124,25%,30%,19%,13,6,7,16,7,9
199,https://vlr.gg/player/26376/deecee,2024-12-06 03:30:00,0.73,1.14,0.93,178,133,225,50,19,31,53,28,25,13,11,2,-3,-5,+2,71%,67%,74%,123,95,151,21%,27%,18%,6,2,4,9,7,2
200,https://vlr.gg/player/27775/techno,2024-12-06 03:30:00,0.70,1.03,0.86,163,157,170,43,19,24,53,30,23,25,13,12,-4,-1,-3,68%,69%,67%,109,100,117,32%,29%,35%,4,2,2,8,3,5
201,https://vlr.gg/player/24979/cloy,2024-12-06 03:00:00,1.22,1.23,1.23,241,249,233,92,42,50,69,35,34,36,18,18,+4,0,+4,77%,78%,75%,161,170,154,32%,41%,26%,14,4,10,10,4,6
202,https://vlr.gg/player/25048/sid,2024-12-06 03:00:00,1.01,1.25,1.14,218,227,225,86,39,47,68,38,30,16,7,9,+6,0,+6,76%,70%,81%,141,132,147,23%,26%,19%,16,7,9,10,7,3
203,https://vlr.gg/player/42772/xross,2024-12-06 03:00:00,1.05,1.13,1.10,238,208,253,85,35,50,71,32,39,28,12,16,+3,+2,+1,75%,72%,77%,152,136,165,29%,24%,33%,16,7,9,13,5,8
204,https://vlr.gg/player/42793/kally,2024-12-06 03:00:00,0.88,1.16,1.04,190,158,205,67,25,42,62,31,31,38,15,23,-1,-2,+1,74%,72%,75%,129,113,142,32%,31%,33%,4,0,4,5,2,3
205,https://vlr.gg/player/27444/banger,2024-12-06 03:00:00,0.77,1.16,0.99,162,134,176,61,20,41,63,32,31,36,11,25,+2,-1,+3,82%,76%,86%,106,93,117,41%,41%,42%,8,4,4,6,5,1
206,https://vlr.gg/player/17049/hermes,2024-12-06 03:00:00,0.85,1.28,1.05,232,201,280,82,37,45,84,50,34,34,15,19,+6,0,+6,69%,65%,74%,145,124,170,19%,19%,19%,19,8,11,13,8,5
207,https://vlr.gg/player/4127/felix,2024-12-06 03:00:00,0.99,1.02,1.00,196,184,206,69,38,31,74,43,31,35,16,19,-1,-2,+1,72%,70%,74%,135,128,143,20%,22%,17%,6,2,4,7,4,3
208,https://vlr.gg/player/25089/cabeza,2024-12-06 03:00:00,0.58,1.34,0.92,172,144,222,68,28,40,73,49,24,23,10,13,-8,-7,-1,62%,54%,72%,118,96,146,28%,33%,25%,6,3,3,14,10,4
209,https://vlr.gg/player/25082/rico,2024-12-06 03:00:00,0.95,0.55,0.77,180,207,140,60,39,21,82,46,36,30,11,19,-6,-6,0,71%,68%,74%,119,137,96,23%,27%,18%,4,1,3,10,7,3
210,https://vlr.gg/player/25080/empty,2024-12-06 03:00:00,0.49,0.74,0.60,139,120,168,48,22,26,84,49,35,29,13,16,-5,-1,-4,71%,65%,78%,93,76,114,19%,23%,17%,10,7,3,15,8,7
211,https://vlr.gg/player/15559/chichoo,2024-12-06 03:00:00,,,,232,,,40,,,42,,,10,,,,,,,,,,,,,,,,,,,,
212,https://vlr.gg/player/3520/zmjjkk,2024-12-06 03:00:00,,,,225,,,36,,,36,,,10,,,,,,,,,,,,,,,,,,,,
213,https://vlr.gg/player/4742/smoggy,2024-12-06 03:00:00,,,,180,,,32,,,37,,,10,,,,,,,,,,,,,,,,,,,,
214,https://vlr.gg/player/3017/nobody,2024-12-06 03:00:00,,,,162,,,28,,,42,,,7,,,,,,,,,,,,,,,,,,,,
215,https://vlr.gg/player/13768/s1mon,2024-12-06 03:00:00,,,,146,,,23,,,40,,,15,,,,,,,,,,,,,,,,,,,,
216,https://vlr.gg/player/22047/rarga,2024-12-06 03:00:00,,,,315,,,55,,,38,,,9,,,,,,,,,,,,,,,,,,,,
217,https://vlr.gg/player/37927/happywei,2024-12-06 03:00:00,,,,273,,,43,,,32,,,15,,,,,,,,,,,,,,,,,,,,
218,https://vlr.gg/player/4710/you,2024-12-06 03:00:00,,,,251,,,42,,,28,,,17,,,,,,,,,,,,,,,,,,,,
219,https://vlr.gg/player/37674/mrcani,2024-12-06 03:00:00,,,,167,,,32,,,31,,,26,,,,,,,,,,,,,,,,,,,,
220,https://vlr.gg/player/4763/zixuan,2024-12-06 03:00:00,,,,158,,,25,,,30,,,33,,,,,,,,,,,,,,,,,,,,
221,https://vlr.gg/player/29841/caedye,2024-12-06 02:00:00,2.26,1.33,1.97,373,436,196,49,41,8,15,9,6,5,2,3,+5,+2,+3,86%,88%,82%,230,280,120,37%,35%,50%,8,5,3,3,3,0
222,https://vlr.gg/player/29843/yatsuka,2024-12-06 02:00:00,1.08,1.86,1.32,208,153,370,29,14,15,19,12,7,7,4,3,+1,+1,0,77%,71%,91%,154,111,247,36%,41%,31%,2,1,1,1,0,1
223,https://vlr.gg/player/10584/seoldam,2024-12-06 02:00:00,1.22,1.44,1.29,274,282,238,37,26,11,23,18,5,3,2,1,+3,+3,0,80%,83%,73%,171,178,155,23%,24%,21%,6,6,0,3,3,0
224,https://vlr.gg/player/5476/minty,2024-12-06 02:00:00,1.16,0.69,1.01,160,178,116,20,16,4,16,10,6,12,9,3,-3,-1,-2,80%,88%,64%,114,129,82,24%,23%,27%,1,1,0,4,2,2
225,https://vlr.gg/player/4663/joxjo,2024-12-06 02:00:00,1.01,0.77,0.93,159,162,140,15,11,4,21,14,7,26,20,6,+3,+3,0,80%,79%,82%,106,110,99,21%,23%,18%,5,3,2,2,0,2
226,https://vlr.gg/player/32823/lafura,2024-12-06 02:00:00,0.81,1.10,1.01,246,179,267,28,7,21,30,8,22,7,2,5,0,-1,+1,66%,64%,67%,161,115,182,33%,20%,39%,2,0,2,2,1,1
227,https://vlr.gg/player/34705/e9lair,2024-12-06 02:00:00,1.05,0.72,0.82,150,196,138,17,7,10,26,7,19,6,1,5,-2,0,-2,60%,64%,58%,108,133,97,18%,22%,16%,0,0,0,2,0,2
228,https://vlr.gg/player/2508/kenmohororo,2024-12-06 02:00:00,0.93,0.47,0.60,127,144,122,15,5,10,31,8,23,7,4,3,+1,+1,0,54%,45%,58%,82,93,77,20%,14%,24%,3,1,2,2,0,2
229,https://vlr.gg/player/49681/keisu,2024-12-06 02:00:00,0.55,0.59,0.57,191,209,181,21,7,14,32,10,22,4,3,1,-7,-2,-5,57%,55%,58%,123,133,119,46%,37%,55%,6,2,4,13,4,9
230,https://vlr.gg/player/17091/zan,2024-12-06 02:00:00,0.67,0.37,0.46,108,120,108,13,5,8,31,9,22,10,5,5,-1,+1,-2,46%,64%,38%,72,74,72,11%,17%,8%,2,2,0,3,1,2
231,https://vlr.gg/player/41107/zeravla,2024-12-05 19:20:00,1.20,1.07,1.14,239,243,281,43,24,19,40,20,20,16,7,9,-5,-6,+1,71%,63%,81%,161,149,175,29%,29%,29%,5,1,4,10,7,3
232,https://vlr.gg/player/48862/cl4yerr,2024-12-05 19:20:00,1.08,0.99,1.04,181,199,167,32,18,14,34,19,15,15,9,6,-5,-2,-3,60%,70%,48%,128,139,115,33%,34%,30%,1,1,0,6,3,3
233,https://vlr.gg/player/35665/miyeon,2024-12-05 19:20:00,1.08,0.87,0.99,232,247,192,38,23,15,40,22,18,8,2,6,-4,-3,-1,58%,56%,62%,142,153,127,39%,40%,38%,5,3,2,9,6,3
234,https://vlr.gg/player/49817/brast,2024-12-05 19:20:00,0.80,0.67,0.74,164,172,172,27,16,11,39,21,18,21,12,9,-1,-1,0,75%,74%,76%,110,96,127,26%,27%,24%,2,1,1,3,2,1
235,https://vlr.gg/player/48863/mystizip,2024-12-05 19:20:00,0.60,0.49,0.55,113,109,138,16,8,8,41,22,19,21,15,6,-1,-1,0,60%,63%,57%,87,84,91,23%,26%,19%,3,1,2,4,2,2
236,https://vlr.gg/player/38359/lojan,2024-12-05 19:20:00,2.02,1.40,1.67,302,367,279,56,29,27,29,13,16,27,16,11,+5,+2,+3,88%,95%,81%,200,211,191,25%,25%,25%,5,2,3,0,0,0
237,https://vlr.gg/player/38364/grimmjow,2024-12-05 19:20:00,1.58,0.86,1.17,232,274,193,39,23,16,33,12,21,21,8,13,+1,0,+1,79%,86%,74%,153,176,134,25%,30%,20%,5,1,4,4,1,3
238,https://vlr.gg/player/24003/w1chi,2024-12-05 19:20:00,1.45,0.94,1.16,242,254,221,41,20,21,30,10,20,16,7,9,+3,+2,+1,75%,81%,70%,148,142,153,29%,30%,29%,7,3,4,4,1,3
239,https://vlr.gg/player/10550/xuto,2024-12-05 19:20:00,0.62,1.28,0.99,211,170,220,31,10,21,30,16,14,12,9,3,+4,-2,+6,75%,71%,78%,128,107,144,21%,17%,28%,11,4,7,7,6,1
240,https://vlr.gg/player/33573/necro,2024-12-05 19:20:00,0.74,0.97,0.87,172,142,193,27,8,19,34,16,18,30,23,7,+3,+1,+2,81%,86%,78%,99,79,115,24%,21%,26%,4,2,2,1,1,0
241,https://vlr.gg/player/13093/jzz,2024-12-05 17:10:00,1.58,1.52,1.56,272,246,295,40,22,18,21,11,10,11,7,4,+5,+2,+3,90%,91%,88%,179,162,203,27%,28%,27%,5,2,3,0,0,0
242,https://vlr.gg/player/3455/zanatsu,2024-12-05 17:10:00,1.39,1.40,1.39,297,299,300,41,25,16,28,16,12,8,5,3,+2,0,+2,78%,70%,88%,193,186,204,22%,29%,16%,10,6,4,8,6,2
243,https://vlr.gg/player/8881/leozin,2024-12-05 17:10:00,1.29,0.89,1.12,216,257,169,34,23,11,26,14,12,12,6,6,-1,0,-1,70%,74%,65%,137,159,108,26%,25%,26%,2,1,1,3,1,2
244,https://vlr.gg/player/1581/guhrvn,2024-12-05 17:10:00,0.88,0.92,0.89,144,151,141,19,11,8,23,13,10,18,12,6,-6,-5,-1,73%,70%,76%,101,112,86,29%,30%,27%,1,0,1,7,5,2
245,https://vlr.gg/player/15361/swag,2024-12-05 17:10:00,0.63,0.96,0.77,190,165,193,22,12,10,29,17,12,9,4,5,+2,+2,0,70%,65%,76%,116,105,132,18%,12%,27%,3,2,1,1,0,1
246,https://vlr.gg/player/46568/above,2024-12-05 17:10:00,1.55,0.95,1.21,233,294,190,34,19,15,28,10,18,13,4,9,0,0,0,70%,88%,57%,151,179,130,42%,41%,43%,2,1,1,2,1,1
247,https://vlr.gg/player/37354/basic,2024-12-05 17:10:00,0.90,0.90,0.90,177,166,180,25,11,14,32,12,20,17,5,12,+3,+1,+2,75%,71%,78%,109,101,115,31%,38%,27%,4,1,3,1,0,1
248,https://vlr.gg/player/37098/tiezzi,2024-12-05 17:10:00,0.52,1.17,0.89,226,146,270,29,9,20,32,14,18,2,1,1,-4,-1,-3,63%,59%,65%,144,98,177,29%,38%,25%,7,4,3,11,5,6
249,https://vlr.gg/player/37091/peixeh,2024-12-05 17:10:00,0.93,0.65,0.77,151,184,143,23,11,12,31,12,19,6,5,1,+1,-2,+3,48%,47%,48%,107,120,97,29%,29%,28%,5,1,4,4,3,1
250,https://vlr.gg/player/1673/guiih9,2024-12-05 17:10:00,0.45,0.65,0.57,145,120,163,16,6,10,33,15,18,12,9,3,-2,-1,-1,60%,59%,61%,99,66,124,24%,19%,26%,1,0,1,3,1,2
251,https://vlr.gg/player/8730/1kuzohh,2024-12-05 17:00:00,1.31,1.53,1.43,308,302,317,47,20,27,32,15,17,16,10,6,+3,0,+3,82%,80%,83%,198,185,209,25%,27%,24%,10,3,7,7,3,4
252,https://vlr.gg/player/2931/vaiz,2024-12-05 17:00:00,0.99,1.77,1.42,258,179,323,39,13,26,24,12,12,24,8,16,+1,-2,+3,82%,80%,83%,163,116,203,20%,33%,16%,3,0,3,2,2,0
253,https://vlr.gg/player/1309/tio,2024-12-05 17:00:00,1.25,0.87,1.04,181,243,132,27,18,9,26,13,13,24,9,15,+1,+1,0,75%,70%,79%,125,145,108,28%,29%,27%,3,2,1,2,1,1
254,https://vlr.gg/player/8278/knzy,2024-12-05 17:00:00,0.59,1.12,0.88,171,140,197,27,9,18,29,14,15,8,3,5,+2,-1,+3,68%,55%,79%,116,96,133,20%,22%,20%,4,1,3,2,2,0
255,https://vlr.gg/player/2909/alca,2024-12-05 17:00:00,0.98,0.78,0.87,191,201,170,29,15,14,34,16,18,8,2,6,-3,-2,-1,66%,75%,58%,123,125,122,31%,43%,24%,4,2,2,7,4,3
256,https://vlr.gg/player/35729/thaend,2024-12-05 17:00:00,1.00,1.58,1.26,229,202,262,35,17,18,31,18,13,24,7,17,+2,-1,+3,84%,79%,90%,151,135,170,33%,29%,37%,4,1,3,2,2,0
257,https://vlr.gg/player/35732/bixitto,2024-12-05 17:00:00,1.04,1.01,1.03,207,221,185,32,20,12,30,17,13,10,6,4,-3,-2,-1,68%,75%,60%,143,149,136,24%,25%,22%,2,1,1,5,3,2
258,https://vlr.gg/player/33567/reac,2024-12-05 17:00:00,0.80,1.02,0.90,180,147,221,28,13,15,33,17,16,10,4,6,0,-1,+1,66%,67%,65%,120,91,156,34%,42%,29%,4,1,3,4,2,2
259,https://vlr.gg/player/43919/washi,2024-12-05 17:00:00,0.68,0.88,0.77,184,153,230,27,11,16,37,19,18,7,5,2,-6,-5,-1,61%,63%,60%,127,107,151,23%,21%,26%,4,2,2,10,7,3
260,https://vlr.gg/player/49798/syncro,2024-12-05 17:00:00,0.59,0.63,0.61,162,174,152,23,14,9,38,23,15,8,5,3,+3,+1,+2,64%,63%,65%,98,94,103,38%,32%,46%,6,3,3,3,2,1
261,https://vlr.gg/player/36433/phc,2024-12-05 15:00:00,1.62,1.44,1.53,289,302,273,40,22,18,20,11,9,16,6,10,+2,0,+2,78%,79%,78%,177,178,177,40%,45%,36%,3,1,2,1,1,0
262,https://vlr.gg/player/1567/bezn1,2024-12-05 15:00:00,1.20,1.64,1.42,303,297,306,41,20,21,23,14,9,10,5,5,+7,+3,+4,89%,89%,89%,195,186,204,27%,29%,25%,10,5,5,3,2,1
263,https://vlr.gg/player/3424/siduzord,2024-12-05 15:00:00,1.01,1.17,1.09,176,148,207,24,10,14,19,10,9,18,14,4,-1,-1,0,78%,84%,72%,113,93,134,24%,30%,20%,1,0,1,2,1,1
264,https://vlr.gg/player/32675/kring,2024-12-05 15:00:00,0.70,1.26,0.97,194,155,241,23,9,14,23,14,9,8,4,4,+1,-3,+4,76%,63%,89%,125,106,144,22%,36%,11%,7,2,5,6,5,1
265,https://vlr.gg/player/6202/guuih,2024-12-05 15:00:00,0.92,0.87,0.90,129,121,140,18,9,9,18,9,9,6,1,5,0,0,0,68%,58%,78%,84,88,79,26%,32%,18%,2,1,1,2,1,1
266,https://vlr.gg/player/25683/desire,2024-12-05 15:00:00,0.78,1.16,0.97,215,175,253,27,10,17,29,16,13,11,6,5,-2,-2,0,65%,56%,74%,144,116,171,39%,33%,43%,3,1,2,5,3,2
267,https://vlr.gg/player/20251/vit9ine,2024-12-05 15:00:00,0.91,0.76,0.83,182,192,173,23,12,11,32,15,17,10,3,7,0,-2,+2,59%,56%,63%,118,124,112,41%,32%,52%,4,0,4,4,2,2
268,https://vlr.gg/player/36105/needy,2024-12-05 15:00:00,0.53,1.03,0.79,190,148,232,24,9,15,28,15,13,4,3,1,-2,-2,0,57%,44%,68%,122,100,142,25%,20%,33%,4,2,2,6,4,2
269,https://vlr.gg/player/1605/champzera,2024-12-05 15:00:00,0.57,0.75,0.66,128,106,147,14,6,8,28,15,13,14,5,9,-1,-2,+1,62%,56%,68%,80,64,94,21%,21%,21%,1,0,1,2,2,0
270,https://vlr.gg/player/1595/myssen,2024-12-05 15:00:00,0.50,0.55,0.53,113,129,102,15,8,7,29,15,14,7,0,7,-4,-2,-2,57%,44%,68%,76,79,72,22%,29%,17%,2,1,1,6,3,3
271,https://vlr.gg/player/35740/sekiro,2024-12-05 15:00:00,1.14,1.36,1.27,279,253,303,37,13,24,30,12,18,9,4,5,+11,+3,+8,79%,87%,74%,181,157,196,25%,15%,34%,11,3,8,0,0,0
272,https://vlr.gg/player/41100/siro,2024-12-05 15:00:00,0.59,1.42,1.09,229,113,289,30,6,24,29,10,19,6,2,4,0,-2,+2,66%,67%,65%,145,70,194,42%,28%,47%,5,2,3,5,4,1
273,https://vlr.gg/player/43953/bugh1nio,2024-12-05 15:00:00,1.44,0.64,0.94,162,237,128,23,15,8,27,9,18,8,4,4,+1,+1,0,76%,87%,70%,119,156,95,40%,50%,32%,2,2,0,1,1,0
274,https://vlr.gg/player/13840/franzera,2024-12-05 15:00:00,0.90,0.85,0.87,175,198,181,24,11,13,28,11,17,12,3,9,-2,0,-2,68%,73%,65%,121,114,125,14%,13%,15%,4,1,3,6,1,5
275,https://vlr.gg/player/26933/nacho,2024-12-05 15:00:00,0.95,0.69,0.79,145,160,141,17,7,10,26,9,17,18,9,9,+2,+1,+1,68%,87%,57%,102,107,99,27%,35%,23%,3,1,2,1,0,1
276,https://vlr.gg/player/15916/jotinha,2024-12-05 15:00:00,1.22,1.07,1.16,204,238,170,30,20,10,25,16,9,10,5,5,-4,-3,-1,66%,70%,60%,149,170,117,40%,45%,32%,2,2,0,6,5,1
277,https://vlr.gg/player/1291/bnj,2024-12-05 15:00:00,1.37,0.83,1.16,250,267,200,33,23,10,27,14,13,10,6,4,-4,-3,-1,61%,61%,60%,151,160,138,37%,38%,33%,2,1,1,6,4,2
278,https://vlr.gg/player/2403/mizu,2024-12-05 15:00:00,0.93,1.01,0.96,215,204,186,26,17,9,25,16,9,13,5,8,+1,+2,-1,76%,74%,80%,122,121,124,44%,52%,33%,6,4,2,5,2,3
279,https://vlr.gg/player/2818/neto,2024-12-05 15:00:00,0.95,0.96,0.96,228,224,199,30,19,11,29,17,12,10,6,4,-4,-5,+1,74%,78%,67%,145,155,129,40%,54%,19%,3,0,3,7,5,2
280,https://vlr.gg/player/2586/hanling,2024-12-05 15:00:00,0.70,1.16,0.88,162,136,207,21,10,11,25,16,9,13,9,4,-1,0,-1,71%,70%,73%,128,117,145,42%,43%,40%,0,0,0,1,0,1
281,https://vlr.gg/player/19231/kibojn,2024-12-05 08:15:00,1.16,1.03,1.10,202,219,189,46,27,19,39,20,19,19,10,9,+2,+2,0,73%,85%,59%,130,142,118,38%,39%,35%,4,3,1,2,1,1
282,https://vlr.gg/player/44919/aplycs,2024-12-05 08:15:00,1.07,0.92,1.00,187,204,167,42,26,16,45,24,21,32,15,17,+2,+3,-1,76%,79%,72%,125,133,116,31%,32%,29%,4,3,1,2,0,2
283,https://vlr.gg/player/40912/123,2024-12-05 08:15:00,0.96,0.92,0.95,236,228,240,48,25,23,49,25,24,13,7,6,+1,+2,-1,69%,76%,62%,149,149,150,27%,31%,23%,9,5,4,8,3,5
284,https://vlr.gg/player/30575/r1sen,2024-12-05 08:15:00,1.14,0.46,0.82,167,215,123,39,26,13,46,21,25,12,9,3,-7,-3,-4,69%,82%,55%,117,147,82,38%,37%,38%,3,2,1,10,5,5
285,https://vlr.gg/player/18702/deadly10,2024-12-05 08:15:00,0.75,0.71,0.73,161,171,151,33,19,14,45,25,20,12,9,3,-6,-3,-3,65%,70%,59%,103,111,94,23%,27%,16%,7,4,3,13,7,6
286,https://vlr.gg/player/46121/marcai,2024-12-05 08:15:00,1.25,1.65,1.46,327,280,349,70,30,40,46,20,26,9,2,7,+6,-1,+7,76%,76%,76%,201,175,224,29%,33%,27%,15,5,10,9,6,3
287,https://vlr.gg/player/1770/wat,2024-12-05 08:15:00,1.18,1.06,1.12,187,170,208,44,19,25,38,16,22,21,13,8,+2,+3,-1,81%,93%,70%,117,106,127,42%,40%,43%,4,3,1,2,0,2
288,https://vlr.gg/player/12323/rvk,2024-12-05 08:15:00,1.05,0.76,0.90,167,170,154,35,17,18,40,16,24,17,12,5,-4,0,-4,71%,79%,64%,105,114,97,27%,36%,20%,4,2,2,8,2,6
289,https://vlr.gg/player/46048/r0meo,2024-12-05 08:15:00,0.98,0.77,0.87,175,223,140,39,25,14,42,19,23,11,1,10,+2,+3,-1,76%,69%,82%,128,144,114,25%,31%,20%,6,4,2,4,1,3
290,https://vlr.gg/player/3502/ri0,2024-12-05 08:15:00,1.16,0.61,0.87,166,172,157,36,18,18,42,14,28,19,9,10,+2,+4,-2,69%,72%,67%,99,96,102,29%,25%,33%,6,5,1,4,1,3
291,https://vlr.gg/player/3627/hellff,2024-12-05 06:15:00,1.19,1.91,1.59,264,189,303,32,11,21,18,9,9,26,8,18,+2,+1,+1,79%,80%,79%,156,118,187,34%,36%,33%,3,2,1,1,1,0
292,https://vlr.gg/player/3639/hoax,2024-12-05 06:15:00,1.15,1.82,1.53,264,216,294,30,11,19,18,10,8,19,7,12,+3,+1,+2,85%,73%,95%,186,139,223,19%,13%,26%,3,1,2,0,0,0
293,https://vlr.gg/player/27775/techno,2024-12-05 06:15:00,1.13,1.51,1.34,243,193,278,32,10,22,17,8,9,15,7,8,-1,0,-1,68%,67%,68%,151,125,171,26%,19%,30%,3,1,2,4,1,3
294,https://vlr.gg/player/26376/deecee,2024-12-05 06:15:00,0.77,1.11,0.96,168,150,193,21,9,12,20,9,11,10,1,9,+2,+1,+1,76%,67%,84%,104,93,113,21%,23%,20%,3,2,1,1,1,0
295,https://vlr.gg/player/27336/venka,2024-12-05 06:15:00,0.65,0.72,0.69,195,181,207,23,10,13,28,13,15,7,3,4,0,-2,+2,76%,73%,79%,128,123,131,30%,27%,32%,8,2,6,8,4,4
296,https://vlr.gg/player/12323/rvk,2024-12-05 06:15:00,0.98,1.11,1.04,195,184,207,24,13,11,24,15,9,6,4,2,+2,+1,+1,79%,84%,73%,129,122,137,29%,40%,19%,2,1,1,0,0,0
297,https://vlr.gg/player/46121/marcai,2024-12-05 06:15:00,1.01,1.03,1.02,227,243,214,26,16,10,28,17,11,12,5,7,-5,-4,-1,68%,74%,60%,147,141,154,27%,27%,26%,4,3,1,9,7,2
298,https://vlr.gg/player/1770/wat,2024-12-05 06:15:00,0.64,1.04,0.82,188,172,230,22,10,12,29,19,10,9,5,4,+2,+1,+1,65%,63%,67%,120,115,126,47%,46%,48%,4,2,2,2,1,1
299,https://vlr.gg/player/46048/r0meo,2024-12-05 06:15:00,0.42,0.90,0.63,134,110,184,14,5,9,27,17,10,9,8,1,-1,0,-1,65%,58%,73%,99,78,126,21%,16%,26%,4,1,3,5,1,4
300,https://vlr.gg/player/3502/ri0,2024-12-05 06:15:00,0.39,0.74,0.47,143,133,144,15,8,7,30,19,11,12,2,10,-4,-3,-1,59%,42%,80%,99,94,104,37%,33%,41%,0,0,0,4,3,1
301,https://vlr.gg/player/30575/r1sen,2024-12-05 03:30:00,0.97,1.22,1.07,198,185,222,25,13,12,29,20,9,14,10,4,+2,0,+2,66%,54%,86%,141,135,152,39%,33%,48%,3,1,2,1,1,0
302,https://vlr.gg/player/40912/123,2024-12-05 03:30:00,0.86,0.95,0.90,207,216,196,28,18,10,32,21,11,10,6,4,-1,-2,+1,61%,58%,64%,150,150,149,39%,36%,45%,5,3,2,6,5,1
303,https://vlr.gg/player/18702/deadly10,2024-12-05 03:30:00,0.56,1.24,0.80,192,153,244,23,11,12,31,22,9,7,5,2,-3,-6,+3,58%,54%,64%,116,98,147,32%,21%,52%,5,2,3,8,8,0
304,https://vlr.gg/player/19231/kibojn,2024-12-05 03:30:00,0.78,0.55,0.70,157,179,124,22,15,7,32,22,10,6,5,1,-2,-1,-1,61%,63%,57%,104,115,84,35%,31%,47%,3,1,2,5,2,3
305,https://vlr.gg/player/44919/aplycs,2024-12-05 03:30:00,0.31,0.75,0.43,108,76,170,14,5,9,33,22,11,16,7,9,-2,-1,-1,58%,50%,71%,63,46,91,15%,14%,15%,0,0,0,2,1,1
306,https://vlr.gg/player/13221/azys,2024-12-05 03:30:00,2.07,2.05,2.06,394,387,394,58,21,37,21,10,11,10,7,3,+3,0,+3,84%,86%,83%,238,225,245,31%,38%,28%,6,2,4,3,2,1
307,https://vlr.gg/player/3269/antidote,2024-12-05 03:30:00,1.13,1.50,1.36,246,205,269,31,8,23,21,9,12,19,8,11,+3,-1,+4,89%,79%,96%,151,136,159,22%,24%,21%,5,1,4,2,2,0
308,https://vlr.gg/player/18704/levi,2024-12-05 03:30:00,0.75,1.14,1.00,170,120,201,24,7,17,22,10,12,14,6,8,0,0,0,79%,71%,83%,111,71,134,28%,46%,24%,3,0,3,3,0,3
309,https://vlr.gg/player/12947/rawfiul,2024-12-05 03:30:00,0.64,1.06,0.90,171,156,184,22,7,15,25,11,14,7,1,6,+1,-1,+2,66%,50%,75%,122,103,132,25%,24%,26%,4,1,3,3,2,1
310,https://vlr.gg/player/3628/deathmaker,2024-12-05 03:30:00,0.76,0.97,0.89,164,160,163,22,7,15,23,10,13,10,6,4,-1,-2,+1,71%,64%,75%,122,99,135,29%,16%,37%,4,1,3,5,3,2
311,https://vlr.gg/player/37532/zexy,2024-12-05 03:00:00,0.81,1.04,0.93,209,201,232,49,23,26,54,27,27,6,1,5,+1,-2,+3,63%,60%,66%,137,122,150,36%,31%,41%,13,6,7,12,8,4
312,https://vlr.gg/player/34926/oonzmlp,2024-12-05 03:00:00,0.57,1.03,0.81,199,167,227,39,14,25,54,28,26,21,10,11,+2,+1,+1,68%,70%,66%,122,111,131,26%,26%,27%,10,4,6,8,3,5
313,https://vlr.gg/player/42733/xuna,2024-12-05 03:00:00,0.65,0.75,0.70,133,125,151,30,13,17,48,23,25,10,4,6,0,0,0,55%,47%,63%,106,100,112,22%,29%,17%,2,1,1,2,1,1
314,https://vlr.gg/player/2149/c1nder,2024-12-05 03:00:00,0.76,0.57,0.66,135,148,123,27,15,12,48,23,25,20,8,12,-5,-3,-2,69%,63%,75%,89,94,84,15%,16%,14%,0,0,0,5,3,2
315,https://vlr.gg/player/4426/klaus,2024-12-05 03:00:00,0.47,0.82,0.65,139,107,170,29,10,19,50,24,26,8,6,2,-2,-2,0,52%,50%,53%,97,78,114,39%,39%,39%,4,1,3,6,3,3
316,https://vlr.gg/player/4127/felix,2024-12-05 03:00:00,1.51,1.90,1.70,292,276,326,70,33,37,32,19,13,15,8,7,+2,+1,+1,89%,81%,97%,195,190,201,28%,33%,23%,3,2,1,1,1,0
317,https://vlr.gg/player/25089/cabeza,2024-12-05 03:00:00,1.13,1.39,1.25,203,184,215,47,22,25,29,17,12,20,13,7,+1,-2,+3,85%,81%,90%,131,114,149,25%,23%,27%,6,1,5,5,3,2
318,https://vlr.gg/player/25082/rico,2024-12-05 03:00:00,1.02,1.23,1.12,177,167,195,37,17,20,31,18,13,32,18,14,-1,-1,0,82%,81%,83%,121,109,134,19%,16%,23%,1,0,1,2,1,1
319,https://vlr.gg/player/25080/empty,2024-12-05 03:00:00,0.87,1.29,1.07,227,206,231,47,21,26,37,22,15,23,8,15,+1,+2,-1,85%,78%,93%,146,145,146,24%,25%,24%,13,8,5,12,6,6
320,https://vlr.gg/player/17049/hermes,2024-12-05 03:00:00,1.25,0.77,1.02,236,300,174,53,36,17,45,23,22,12,3,9,+1,-2,+3,77%,75%,80%,150,180,118,20%,25%,13%,10,4,6,9,6,3
321,https://vlr.gg/player/43953/bugh1nio,2024-12-04 18:50:00,1.56,1.47,1.51,256,243,268,43,19,24,28,13,15,14,9,5,+3,+1,+2,73%,73%,74%,176,174,178,39%,34%,44%,4,1,3,1,0,1
322,https://vlr.gg/player/35740/sekiro,2024-12-04 18:50:00,1.23,1.26,1.25,254,248,259,41,20,21,31,16,15,11,4,7,-1,-2,+1,69%,68%,70%,167,164,171,37%,41%,34%,6,2,4,7,4,3
323,https://vlr.gg/player/26933/nacho,2024-12-04 18:50:00,1.07,1.27,1.17,222,205,238,33,14,19,29,15,14,24,8,16,-2,-1,-1,71%,59%,83%,144,137,151,19%,24%,16%,2,2,0,4,3,1
324,https://vlr.gg/player/41100/siro,2024-12-04 18:50:00,0.90,0.81,0.85,190,201,181,30,16,14,33,16,17,8,2,6,+2,0,+2,71%,68%,74%,122,129,116,31%,37%,26%,7,3,4,5,3,2
325,https://vlr.gg/player/13840/franzera,2024-12-04 18:50:00,0.51,0.79,0.66,147,112,182,20,7,13,34,17,17,18,11,7,-1,-4,+3,58%,55%,61%,102,77,127,21%,10%,29%,4,0,4,5,4,1
326,https://vlr.gg/player/43908/levi,2024-12-04 18:50:00,1.54,0.83,1.19,233,285,183,39,24,15,32,16,16,9,6,3,+5,+3,+2,69%,78%,59%,151,186,113,31%,38%,21%,5,3,2,0,0,0
327,https://vlr.gg/player/21646/nash,2024-12-04 18:50:00,0.98,1.07,1.02,196,182,210,33,16,17,33,18,15,3,2,1,-1,-3,+2,69%,70%,68%,131,123,139,34%,31%,37%,2,0,2,3,3,0
328,https://vlr.gg/player/45955/ego1st,2024-12-04 18:50:00,0.73,1.25,0.98,208,176,240,33,13,20,34,19,15,16,9,7,-2,-3,+1,69%,65%,73%,140,128,153,27%,24%,29%,3,1,2,5,4,1
329,https://vlr.gg/player/41128/mathi,2024-12-04 18:50:00,1.01,0.94,0.98,204,210,197,27,15,12,33,18,15,24,9,15,+1,-1,+2,78%,78%,77%,138,140,137,29%,25%,33%,6,1,5,5,2,3
330,https://vlr.gg/player/49796/mommy,2024-12-04 18:50:00,0.41,0.83,0.61,154,133,175,23,10,13,35,20,15,13,7,6,-4,-3,-1,67%,61%,73%,107,89,127,24%,24%,25%,6,3,3,10,6,4
331,https://vlr.gg/player/1581/guhrvn,2024-12-04 18:45:00,0.59,1.28,1.05,207,143,240,36,8,28,37,15,22,19,5,14,-2,-4,+2,72%,61%,78%,136,107,151,31%,33%,30%,5,0,5,7,4,3
332,https://vlr.gg/player/13093/jzz,2024-12-04 18:45:00,1.17,0.75,0.88,179,219,161,33,14,19,38,13,25,14,5,9,-2,-2,0,65%,67%,64%,126,166,106,28%,33%,23%,1,0,1,3,2,1
333,https://vlr.gg/player/8881/leozin,2024-12-04 18:45:00,0.64,0.99,0.88,169,134,188,33,7,26,40,15,25,16,7,9,-1,0,-1,61%,50%,67%,107,88,117,34%,47%,31%,5,3,2,6,3,3
334,https://vlr.gg/player/15361/swag,2024-12-04 18:45:00,0.82,0.87,0.85,184,201,177,32,12,20,41,16,25,22,8,14,+3,+1,+2,76%,78%,75%,121,125,119,20%,28%,15%,6,1,5,3,0,3
335,https://vlr.gg/player/3455/zanatsu,2024-12-04 18:45:00,0.84,0.79,0.81,195,198,206,41,13,28,42,14,28,7,3,4,-4,-5,+1,67%,56%,72%,125,127,125,34%,38%,32%,7,0,7,11,5,6
336,https://vlr.gg/player/1566/prozin,2024-12-04 18:45:00,1.30,1.25,1.28,199,201,192,38,26,12,28,19,9,11,6,5,+3,+1,+2,78%,78%,78%,122,127,113,38%,43%,29%,5,3,2,2,2,0
337,https://vlr.gg/player/21659/sato,2024-12-04 18:45:00,1.04,1.56,1.22,281,264,323,54,33,21,40,28,12,9,7,2,+2,-3,+5,83%,81%,89%,183,175,200,37%,40%,31%,13,6,7,11,9,2
338,https://vlr.gg/player/28716/lukxo,2024-12-04 18:45:00,1.27,1.04,1.20,239,247,192,45,32,13,36,25,11,8,7,1,+3,+2,+1,72%,75%,67%,154,167,127,37%,38%,33%,7,5,2,4,3,1
339,https://vlr.gg/player/6238/urango,2024-12-04 18:45:00,0.82,1.06,0.90,173,159,201,35,20,15,39,27,12,14,12,2,-3,-4,+1,67%,67%,67%,118,109,136,31%,32%,30%,2,0,2,5,4,1
340,https://vlr.gg/player/5351/rglmeister,2024-12-04 18:45:00,0.83,0.95,0.87,138,123,164,26,15,11,33,22,11,28,24,4,+1,0,+1,72%,78%,61%,84,77,98,31%,25%,43%,3,2,1,2,2,0
341,https://vlr.gg/player/1309/tio,2024-12-04 17:00:00,1.30,1.68,1.48,187,166,218,24,10,14,13,8,5,23,14,9,+2,+1,+1,88%,83%,94%,141,114,172,31%,33%,30%,2,1,1,0,0,0
342,https://vlr.gg/player/8730/1kuzohh,2024-12-04 17:00:00,1.00,1.82,1.39,318,248,397,38,16,22,22,13,9,7,4,3,+2,+1,+1,71%,72%,69%,201,148,260,25%,24%,25%,10,5,5,8,4,4
343,https://vlr.gg/player/8278/knzy,2024-12-04 17:00:00,1.49,1.14,1.33,247,294,197,30,20,10,19,10,9,7,4,3,+6,+3,+3,79%,83%,75%,161,184,135,19%,25%,14%,6,3,3,0,0,0
344,https://vlr.gg/player/2931/vaiz,2024-12-04 17:00:00,1.44,1.07,1.27,223,275,163,28,18,10,20,11,9,9,5,4,+1,0,+1,82%,83%,81%,146,178,109,22%,18%,32%,2,1,1,1,1,0
345,https://vlr.gg/player/2909/alca,2024-12-04 17:00:00,1.11,0.87,0.99,194,207,172,24,14,10,20,11,9,12,6,6,-1,+1,-2,74%,78%,69%,118,127,107,37%,44%,29%,2,2,0,3,1,2
346,https://vlr.gg/player/49815/xithus,2024-12-04 17:00:00,0.86,0.93,0.90,213,186,234,23,9,14,31,14,17,12,6,6,0,+2,-2,59%,56%,61%,137,123,150,26%,40%,17%,3,3,0,3,1,2
347,https://vlr.gg/player/24003/w1chi,2024-12-04 17:00:00,1.19,0.55,0.85,179,221,146,20,12,8,28,12,16,13,6,7,+1,0,+1,71%,69%,72%,119,137,103,36%,31%,43%,3,1,2,2,1,1
348,https://vlr.gg/player/10550/xuto,2024-12-04 17:00:00,0.55,0.85,0.71,164,120,203,20,8,12,28,13,15,1,1,0,-4,-2,-2,47%,44%,50%,114,79,146,30%,25%,33%,4,1,3,8,3,5
349,https://vlr.gg/player/33573/necro,2024-12-04 17:00:00,0.67,0.61,0.64,135,143,129,15,8,7,28,13,15,12,4,8,-2,+1,-3,65%,63%,67%,91,103,80,21%,28%,14%,1,1,0,3,0,3
350,https://vlr.gg/player/38364/grimmjow,2024-12-04 17:00:00,0.21,1.00,0.61,156,78,216,16,4,12,29,14,15,8,2,6,-5,-5,0,47%,44%,50%,102,55,145,16%,13%,18%,1,0,1,6,5,1
351,https://vlr.gg/player/1567/bezn1,2024-12-04 15:00:00,1.34,0.95,1.13,248,222,257,51,22,29,44,17,27,14,10,4,0,0,0,75%,75%,74%,149,140,157,39%,35%,43%,6,4,2,6,4,2
352,https://vlr.gg/player/32675/kring,2024-12-04 15:00:00,0.85,1.13,1.00,267,223,290,48,20,28,48,22,26,15,6,9,-1,-4,+3,71%,68%,74%,174,149,196,26%,39%,18%,12,3,9,13,7,6
353,https://vlr.gg/player/3424/siduzord,2024-12-04 15:00:00,1.00,0.99,0.99,165,152,180,37,16,21,40,18,22,15,11,4,+1,0,+1,63%,64%,61%,110,100,119,30%,23%,36%,4,1,3,3,1,2
354,https://vlr.gg/player/6202/guuih,2024-12-04 15:00:00,1.13,0.77,0.94,168,180,152,37,20,17,38,16,22,8,5,3,+4,0,+4,59%,68%,52%,109,127,93,38%,45%,31%,7,3,4,3,3,0
355,https://vlr.gg/player/36433/phc,2024-12-04 15:00:00,1.22,0.44,0.76,122,153,112,19,10,9,23,5,18,13,7,6,-1,0,-1,67%,75%,61%,92,104,83,27%,53%,14%,2,1,1,3,1,2
356,https://vlr.gg/player/2210/phonics,2024-12-04 15:00:00,0.50,0.27,0.41,108,118,95,6,4,2,18,10,8,7,3,4,0,0,0,45%,42%,50%,76,86,61,9%,4%,18%,0,0,0,0,0,0
357,https://vlr.gg/player/1578/shion,2024-12-04 15:00:00,1.52,0.70,1.13,195,252,127,38,27,11,37,19,18,29,17,12,+1,+1,0,75%,77%,71%,126,169,80,33%,38%,24%,5,2,3,4,1,3
358,https://vlr.gg/player/2486/pollo,2024-12-04 15:00:00,0.96,1.26,1.11,247,224,266,50,25,25,43,24,19,11,5,6,0,-4,+4,75%,74%,75%,149,137,163,30%,35%,26%,5,1,4,5,5,0
359,https://vlr.gg/player/25858/sw,2024-12-04 15:00:00,1.27,0.88,1.09,210,248,193,45,27,18,41,21,20,19,9,10,+1,-1,+2,69%,77%,61%,151,173,127,32%,33%,31%,7,4,3,6,5,1
360,https://vlr.gg/player/5722/prince,2024-12-04 15:00:00,1.23,0.84,1.05,170,200,131,37,24,13,36,20,16,13,5,8,+3,+2,+1,76%,81%,71%,109,131,85,34%,39%,26%,5,2,3,2,0,2
361,https://vlr.gg/player/41224/tkzin,2024-12-04 15:00:00,0.73,1.03,0.87,194,184,221,41,20,21,44,25,19,13,7,6,-8,-5,-3,69%,68%,71%,138,129,149,28%,38%,21%,6,3,3,14,8,6
362,https://vlr.gg/player/35665/miyeon,2024-12-04 15:00:00,2.17,1.88,2.05,389,412,354,54,33,21,17,9,8,10,7,3,+1,0,+1,81%,82%,80%,240,250,226,42%,40%,46%,7,5,2,6,5,1
363,https://vlr.gg/player/48862/cl4yerr,2024-12-04 15:00:00,1.55,1.51,1.53,253,242,264,35,21,14,17,9,8,10,3,7,+1,+1,0,81%,82%,80%,165,165,164,39%,48%,31%,2,1,1,1,0,1
364,https://vlr.gg/player/48863/mystizip,2024-12-04 15:00:00,0.89,1.29,1.05,163,120,232,22,10,12,21,12,9,19,9,10,-1,+1,-2,86%,91%,80%,87,64,121,18%,15%,20%,1,1,0,2,0,2
365,https://vlr.gg/player/41107/zeravla,2024-12-04 15:00:00,1.10,0.74,0.96,257,285,186,29,21,8,29,16,13,13,7,6,+1,+2,-1,84%,82%,87%,156,172,132,32%,38%,19%,8,5,3,7,3,4
366,https://vlr.gg/player/48865/nezek,2024-12-04 15:00:00,0.94,0.62,0.81,121,138,107,17,13,4,25,14,11,22,15,7,-1,0,-1,81%,86%,73%,84,92,73,31%,32%,29%,1,1,0,2,1,1
367,https://vlr.gg/player/35732/bixitto,2024-12-04 15:00:00,0.75,0.91,0.84,186,180,193,25,10,15,31,13,18,8,3,5,-1,0,-1,81%,87%,77%,121,121,120,31%,22%,38%,2,1,1,3,1,2
368,https://vlr.gg/player/49814/ilsoniic,2024-12-04 15:00:00,0.80,0.80,0.80,198,227,198,25,12,13,32,13,19,11,4,7,-1,+1,-2,65%,73%,59%,138,141,137,34%,42%,28%,8,5,3,9,4,5
369,https://vlr.gg/player/49798/syncro,2024-12-04 15:00:00,0.85,0.74,0.78,215,199,221,26,11,15,33,11,22,4,2,2,+2,0,+2,62%,67%,59%,133,114,146,29%,27%,31%,3,0,3,1,0,1
370,https://vlr.gg/player/35729/thaend,2024-12-04 15:00:00,1.08,0.34,0.64,119,207,78,16,11,5,30,11,19,13,6,7,-2,+1,-3,59%,73%,50%,91,137,59,39%,50%,25%,2,2,0,4,1,3
371,https://vlr.gg/player/33567/reac,2024-12-04 15:00:00,0.59,0.61,0.58,123,106,144,17,5,12,31,11,20,9,4,5,+1,+1,0,54%,53%,55%,80,70,88,23%,15%,28%,3,1,2,2,0,2
372,https://vlr.gg/player/1430/crazyguy,2024-12-04 06:15:00,0.66,1.72,1.23,264,147,370,40,10,30,29,15,14,16,6,10,+3,-1,+4,81%,65%,96%,172,89,243,18%,28%,15%,6,1,5,3,2,1
373,https://vlr.gg/player/11704/styron,2024-12-04 06:15:00,1.15,1.19,1.17,178,192,168,29,14,15,23,13,10,16,6,10,-1,-2,+1,79%,70%,87%,129,141,119,18%,17%,20%,1,0,1,2,2,0
374,https://vlr.gg/player/9152/deryeon,2024-12-04 06:15:00,1.10,1.20,1.16,223,236,209,33,17,16,25,15,10,7,2,5,+1,-1,+2,79%,75%,83%,146,162,132,24%,37%,19%,4,2,2,3,3,0
375,https://vlr.gg/player/24653/vera,2024-12-04 06:15:00,1.36,0.96,1.15,228,259,192,32,17,15,27,14,13,13,7,6,+4,+4,0,70%,70%,70%,149,177,124,24%,29%,19%,10,5,5,6,1,5
376,https://vlr.gg/player/24628/wayne,2024-12-04 06:15:00,0.78,1.17,0.99,174,149,204,30,10,20,28,14,14,14,5,9,0,0,0,72%,60%,83%,111,90,129,32%,42%,28%,4,2,2,4,2,2
377,https://vlr.gg/player/14674/kntz,2024-12-04 06:15:00,0.68,1.30,0.97,179,130,240,29,10,19,30,19,11,4,3,1,0,0,0,63%,52%,75%,112,87,139,40%,39%,40%,2,1,1,2,1,1
378,https://vlr.gg/player/10790/lby,2024-12-04 06:15:00,0.89,0.88,0.89,182,171,195,26,13,13,32,18,14,17,8,9,-1,-1,0,65%,74%,55%,105,99,111,18%,19%,18%,1,0,1,2,1,1
379,https://vlr.gg/player/14677/qq,2024-12-04 06:15:00,0.97,0.76,0.87,190,211,165,24,15,9,34,19,15,16,6,10,-5,-3,-2,65%,65%,65%,138,161,111,23%,30%,14%,6,2,4,11,5,6
380,https://vlr.gg/player/19150/niffy,2024-12-04 06:15:00,0.87,0.84,0.86,197,190,204,29,15,14,35,19,16,8,2,6,+1,+1,0,65%,65%,65%,127,121,134,32%,35%,30%,6,5,1,5,4,1
381,https://vlr.gg/player/12289/siraww,2024-12-04 06:15:00,0.35,1.04,0.67,174,120,235,24,8,16,33,21,12,9,5,4,-2,-4,+2,60%,43%,80%,112,79,151,18%,23%,15%,3,0,3,5,4,1
382,https://vlr.gg/player/4666/acme,2024-12-04 05:25:00,0.91,1.27,1.09,227,194,259,34,15,19,36,20,16,22,11,11,-2,-3,+1,74%,67%,83%,142,118,167,23%,20%,25%,2,1,1,4,4,0
383,https://vlr.gg/player/42710/froz,2024-12-04 05:25:00,0.94,0.79,0.87,167,178,157,29,16,13,35,18,17,8,4,4,-3,-2,-1,64%,63%,65%,120,125,114,37%,38%,34%,4,1,3,7,3,4
384,https://vlr.gg/player/42769/wezzy,2024-12-04 05:25:00,0.81,0.89,0.85,192,188,198,30,14,16,39,21,18,10,5,5,-5,-4,-1,64%,67%,61%,134,127,142,38%,40%,35%,2,0,2,7,4,3
385,https://vlr.gg/player/4060/daegi,2024-12-04 05:25:00,0.38,1.07,0.72,166,115,220,28,10,18,36,20,16,10,3,7,-4,-7,+3,70%,58%,83%,103,69,139,17%,11%,21%,5,0,5,9,7,2
386,https://vlr.gg/player/42771/nameless,2024-12-04 05:25:00,0.60,0.75,0.67,163,149,178,26,12,14,37,19,18,11,6,5,-1,-2,+1,60%,50%,70%,107,96,118,31%,31%,32%,3,1,2,4,3,1
387,https://vlr.gg/player/17049/hermes,2024-12-04 05:25:00,0.98,1.58,1.29,250,204,293,44,18,26,29,17,12,15,7,8,+3,-2,+5,74%,65%,83%,163,126,199,26%,15%,36%,9,4,5,6,6,0
388,https://vlr.gg/player/25082/rico,2024-12-04 05:25:00,1.05,1.44,1.25,240,191,287,41,14,27,31,15,16,25,15,10,+5,+1,+4,85%,83%,88%,139,126,152,17%,12%,21%,7,1,6,2,0,2
389,https://vlr.gg/player/4127/felix,2024-12-04 05:25:00,1.25,1.22,1.24,200,212,189,37,21,16,24,14,10,15,6,9,0,-1,+1,83%,78%,88%,135,135,134,18%,27%,13%,3,1,2,3,2,1
390,https://vlr.gg/player/25089/cabeza,2024-12-04 05:25:00,1.08,0.96,1.02,186,204,171,28,15,13,30,17,13,18,9,9,0,-2,+2,79%,78%,79%,123,128,117,23%,31%,18%,3,1,2,3,3,0
391,https://vlr.gg/player/25080/empty,2024-12-04 05:25:00,1.10,0.87,0.98,214,231,197,33,17,16,33,17,16,17,10,7,+7,+1,+6,72%,70%,75%,135,157,114,19%,22%,17%,9,3,6,2,2,0
392,https://vlr.gg/player/23930/potter,2024-12-04 03:30:00,1.49,1.46,1.47,318,366,274,51,29,22,34,17,17,4,0,4,-3,0,-3,67%,68%,67%,198,214,184,23%,20%,25%,7,7,0,10,7,3
393,https://vlr.gg/player/4377/johnolsen,2024-12-04 03:30:00,1.12,0.83,0.97,187,210,167,31,17,14,31,13,18,13,7,6,-4,-1,-3,70%,73%,67%,126,130,122,31%,23%,39%,1,0,1,5,1,4
394,https://vlr.gg/player/27254/leviathan,2024-12-04 03:30:00,0.68,1.15,0.93,178,132,220,29,10,19,34,17,17,14,11,3,-1,-2,+1,65%,73%,58%,116,92,139,32%,25%,36%,3,0,3,4,2,2
395,https://vlr.gg/player/3342/sushiboys,2024-12-04 03:30:00,0.70,0.53,0.61,114,118,110,14,8,6,33,14,19,20,7,13,-7,-2,-5,63%,68%,58%,76,74,79,18%,28%,11%,2,1,1,9,3,6
396,https://vlr.gg/player/2366/alert,2024-12-04 03:30:00,0.64,0.55,0.59,135,141,130,19,10,9,37,16,21,15,8,7,+1,+1,0,63%,64%,63%,99,102,97,21%,22%,20%,3,1,2,2,0,2
397,https://vlr.gg/player/10749/k1ngkappa,2024-12-04 03:30:00,1.33,1.29,1.31,265,270,259,45,25,20,30,15,15,11,5,6,+7,+5,+2,80%,88%,73%,172,186,158,34%,47%,19%,8,5,3,1,0,1
398,https://vlr.gg/player/9290/madelyn,2024-12-04 03:30:00,1.28,1.33,1.30,222,195,251,37,18,19,25,11,14,20,14,6,+1,0,+1,85%,88%,82%,133,115,153,24%,22%,26%,5,1,4,4,1,3
399,https://vlr.gg/player/4872/frostmind,2024-12-04 03:30:00,1.24,1.00,1.13,193,213,172,30,19,11,26,13,13,18,8,10,+4,+2,+2,83%,88%,77%,130,142,116,38%,54%,24%,4,2,2,0,0,0
400,https://vlr.gg/player/9263/sayoo,2024-12-04 03:30:00,0.81,0.98,0.89,165,157,174,24,12,12,29,15,14,9,5,4,+1,+2,-1,72%,71%,73%,107,100,115,18%,15%,21%,5,3,2,4,1,3
401,https://vlr.gg/player/26829/damaraa,2024-12-04 03:30:00,0.97,0.79,0.88,206,222,189,33,18,15,34,16,18,12,10,2,+1,+1,0,70%,92%,45%,134,143,124,29%,28%,31%,8,6,2,7,5,2
402,https://vlr.gg/player/2149/c1nder,2024-12-04 03:00:00,0.79,0.94,0.83,158,139,211,17,10,7,28,18,10,7,6,1,-2,-2,0,59%,58%,60%,102,92,125,28%,36%,19%,1,1,0,3,3,0
403,https://vlr.gg/player/34926/oonzmlp,2024-12-04 03:00:00,0.83,0.44,0.72,150,171,114,20,16,4,30,21,9,3,3,0,-3,-1,-2,47%,50%,40%,99,107,79,46%,46%,45%,1,1,0,4,2,2
404,https://vlr.gg/player/37532/zexy,2024-12-04 03:00:00,0.96,0.17,0.71,204,245,77,20,18,2,31,21,10,10,6,4,-6,-3,-3,62%,67%,50%,125,155,52,31%,33%,25%,2,2,0,8,5,3
405,https://vlr.gg/player/42733/xuna,2024-12-04 03:00:00,0.75,0.26,0.59,137,156,112,14,11,3,30,20,10,6,5,1,-3,-3,0,41%,46%,30%,94,103,70,36%,35%,38%,2,1,1,5,4,1
406,https://vlr.gg/player/4426/klaus,2024-12-04 03:00:00,0.43,0.77,0.53,108,72,214,14,7,7,29,19,10,3,2,1,-5,-4,-1,56%,54%,60%,84,56,151,55%,47%,63%,1,0,1,6,4,2
407,https://vlr.gg/player/42772/xross,2024-12-04 03:00:00,1.40,1.35,1.37,244,280,220,29,11,18,16,6,10,10,3,7,+4,+3,+1,88%,90%,88%,171,192,162,24%,33%,21%,5,3,2,1,0,1
408,https://vlr.gg/player/27444/banger,2024-12-04 03:00:00,1.24,1.41,1.36,274,267,275,36,11,25,20,6,14,7,2,5,+3,-1,+4,88%,80%,92%,191,173,198,47%,50%,45%,5,0,5,2,1,1
409,https://vlr.gg/player/25048/sid,2024-12-04 03:00:00,1.25,1.34,1.32,276,206,298,34,9,25,19,6,13,7,2,5,+5,+1,+4,82%,100%,75%,177,128,197,26%,29%,25%,9,2,7,4,1,3
410,https://vlr.gg/player/24979/cloy,2024-12-04 03:00:00,1.72,1.12,1.29,200,208,202,27,8,19,14,2,12,13,6,7,+3,0,+3,85%,100%,79%,132,127,134,39%,38%,40%,3,0,3,0,0,0
411,https://vlr.gg/player/42793/kally,2024-12-04 03:00:00,1.84,0.77,1.09,165,267,125,22,10,12,16,3,13,18,7,11,+4,+3,+1,79%,100%,71%,111,176,84,42%,60%,30%,4,3,1,0,0,0
412,https://vlr.gg/player/2909/alca,2024-12-03 19:30:00,0.80,1.92,1.53,312,203,381,43,10,33,27,11,16,11,3,8,+2,+1,+1,81%,77%,83%,206,136,244,36%,31%,38%,5,1,4,3,0,3
413,https://vlr.gg/player/1309/tio,2024-12-03 19:30:00,1.46,1.34,1.38,268,283,231,34,14,20,21,9,12,17,3,14,+1,-1,+2,92%,100%,88%,180,207,166,25%,33%,21%,2,0,2,1,1,0
414,https://vlr.gg/player/8730/1kuzohh,2024-12-03 19:30:00,0.88,1.17,1.07,272,239,263,34,12,22,28,11,17,9,0,9,-1,-3,+2,78%,85%,75%,165,140,179,29%,31%,28%,7,2,5,8,5,3
415,https://vlr.gg/player/2931/vaiz,2024-12-03 19:30:00,0.90,1.01,0.97,198,230,174,24,9,15,25,11,14,20,10,10,-3,-1,-2,78%,92%,71%,134,153,123,15%,16%,14%,1,0,1,4,1,3
416,https://vlr.gg/player/8278/knzy,2024-12-03 19:30:00,0.41,0.50,0.47,105,97,107,12,4,8,27,10,17,4,1,3,-4,-3,-1,57%,46%,63%,70,70,70,12%,7%,15%,1,0,1,5,3,2
417,https://vlr.gg/player/48863/mystizip,2024-12-03 19:30:00,1.01,1.35,1.13,223,225,198,28,18,10,27,20,7,11,7,4,+1,0,+1,78%,71%,92%,137,144,124,27%,29%,22%,2,1,1,1,1,0
418,https://vlr.gg/player/41107/zeravla,2024-12-03 19:30:00,0.97,0.87,0.93,220,253,203,29,19,10,32,21,11,13,9,4,+3,+4,-1,81%,79%,85%,153,175,112,31%,31%,29%,6,5,1,3,1,2
419,https://vlr.gg/player/48862/cl4yerr,2024-12-03 19:30:00,0.77,0.93,0.83,181,174,205,24,14,10,28,19,9,8,4,4,-1,-2,+1,70%,67%,77%,113,105,126,19%,17%,23%,2,1,1,3,3,0
420,https://vlr.gg/player/35665/miyeon,2024-12-03 19:30:00,0.80,0.89,0.83,198,172,258,27,15,12,31,19,12,4,3,1,+3,-2,+5,73%,71%,77%,144,117,194,39%,37%,43%,9,3,6,6,5,1
421,https://vlr.gg/player/48865/nezek,2024-12-03 19:30:00,0.55,1.14,0.76,124,102,227,20,10,10,29,19,10,13,7,6,-1,-2,+1,59%,46%,85%,104,72,164,34%,35%,33%,2,1,1,3,3,0
422,https://vlr.gg/player/36105/needy,2024-12-03 19:00:00,1.16,1.71,1.42,299,284,310,45,22,23,32,20,12,15,6,9,+8,+1,+7,80%,75%,86%,183,177,190,21%,24%,19%,11,4,7,3,3,0
423,https://vlr.gg/player/1605/champzera,2024-12-03 19:00:00,0.89,1.53,1.19,208,156,270,35,14,21,28,18,10,21,9,12,+4,+1,+3,78%,58%,100%,141,98,190,27%,36%,22%,5,2,3,1,1,0
424,https://vlr.gg/player/25683/desire,2024-12-03 19:00:00,1.26,1.05,1.17,226,265,179,39,25,14,31,20,11,8,2,6,+1,-1,+2,73%,71%,76%,145,163,125,46%,50%,40%,5,1,4,4,2,2
425,https://vlr.gg/player/1595/myssen,2024-12-03 19:00:00,1.04,1.11,1.07,180,177,182,29,15,14,27,16,11,17,10,7,-1,-4,+3,71%,63%,81%,125,123,127,42%,43%,42%,4,1,3,5,5,0
426,https://vlr.gg/player/20251/vit9ine,2024-12-03 19:00:00,0.28,0.96,0.60,131,81,192,20,5,15,33,20,13,14,4,10,-3,-3,0,62%,50%,76%,85,62,111,26%,24%,27%,2,1,1,5,4,1
427,https://vlr.gg/player/9266/tisora,2024-12-03 19:00:00,0.75,1.88,1.35,303,209,381,49,14,35,34,19,15,8,2,6,+3,-1,+4,78%,62%,92%,185,137,227,19%,22%,18%,7,2,5,4,3,1
428,https://vlr.gg/player/23001/zaninzs,2024-12-03 19:00:00,0.70,1.29,1.02,217,168,259,35,14,21,33,17,16,9,3,6,-3,-3,0,62%,48%,75%,146,116,173,34%,26%,40%,3,0,3,6,3,3
429,https://vlr.gg/player/2021/axeddy,2024-12-03 19:00:00,0.95,0.89,0.92,159,165,158,24,10,14,30,15,15,26,13,13,-3,-1,-2,71%,57%,83%,116,120,112,17%,11%,26%,1,0,1,4,1,3
430,https://vlr.gg/player/37105/loss,2024-12-03 19:00:00,0.74,0.97,0.86,192,187,193,29,13,16,36,19,17,14,6,8,-4,-7,+3,69%,57%,79%,126,125,127,22%,22%,23%,6,1,5,10,8,2
431,https://vlr.gg/player/33121/stwz1,2024-12-03 19:00:00,0.49,0.33,0.41,102,98,105,14,7,7,36,17,19,13,6,7,-2,-3,+1,62%,57%,67%,70,62,77,10%,4%,14%,1,0,1,3,3,0
432,https://vlr.gg/player/26933/nacho,2024-12-03 17:30:00,0.79,1.37,1.09,209,180,237,32,13,19,31,20,11,16,10,6,+2,+3,-1,77%,67%,87%,127,108,145,31%,34%,29%,4,4,0,2,1,1
433,https://vlr.gg/player/41100/siro,2024-12-03 17:30:00,1.15,0.93,1.04,223,239,207,36,18,18,33,17,16,9,3,6,-2,-2,0,61%,62%,61%,150,164,137,33%,31%,35%,3,0,3,5,2,3
434,https://vlr.gg/player/13840/franzera,2024-12-03 17:30:00,0.65,1.09,0.88,188,151,221,29,11,18,34,19,15,12,4,8,-1,-3,+2,59%,52%,65%,129,100,156,25%,23%,26%,4,0,4,5,3,2
435,https://vlr.gg/player/43953/bugh1nio,2024-12-03 17:30:00,0.51,1.12,0.83,149,123,173,23,8,15,30,19,11,16,6,10,-4,-3,-1,75%,62%,87%,103,78,125,30%,26%,32%,1,0,1,5,3,2
436,https://vlr.gg/player/35740/sekiro,2024-12-03 17:30:00,0.36,1.17,0.78,193,127,254,28,7,21,33,19,14,8,5,3,-3,-6,+3,66%,38%,91%,121,85,154,39%,45%,35%,6,1,5,9,7,2
437,https://vlr.gg/player/41134/nx1,2024-12-03 17:30:00,0.86,1.87,1.35,234,172,301,34,12,22,30,19,11,32,12,20,+3,-2,+5,82%,65%,100%,142,108,180,23%,19%,26%,6,1,5,3,3,0
438,https://vlr.gg/player/48864/mrtn,2024-12-03 17:30:00,0.80,1.42,1.10,200,161,244,33,13,20,27,17,10,6,2,4,+1,0,+1,73%,61%,86%,138,114,163,27%,30%,25%,3,2,1,2,2,0
439,https://vlr.gg/player/49799/tafg,2024-12-03 17:30:00,0.83,1.39,1.10,216,174,262,34,13,21,29,18,11,11,5,6,+1,-1,+2,70%,57%,86%,144,120,170,37%,41%,34%,8,4,4,7,5,2
440,https://vlr.gg/player/36052/haitam,2024-12-03 17:30:00,0.97,1.01,0.99,157,149,167,25,13,12,27,16,11,13,4,9,+1,0,+1,70%,61%,81%,112,103,120,29%,33%,23%,3,1,2,2,1,1
441,https://vlr.gg/player/48984/kramz,2024-12-03 17:30:00,0.84,1.05,0.94,219,204,241,35,16,19,35,21,14,11,2,9,+2,0,+2,66%,57%,76%,137,135,140,31%,38%,26%,6,2,4,4,2,2
442,https://vlr.gg/player/16620/bruninej,2024-12-03 15:00:00,1.21,1.15,1.18,227,253,206,55,31,24,50,24,26,25,10,15,+5,-1,+6,80%,79%,81%,157,167,148,32%,27%,39%,13,4,9,8,5,3
443,https://vlr.gg/player/5342/duht,2024-12-03 15:00:00,0.99,1.19,1.10,207,172,242,48,19,29,47,20,27,27,14,13,+3,0,+3,81%,85%,78%,134,111,155,25%,22%,26%,7,3,4,4,3,1
444,https://vlr.gg/player/8896/loweed,2024-12-03 15:00:00,1.39,0.77,1.06,189,229,154,46,28,18,42,16,26,21,13,8,+1,+3,-2,74%,82%,67%,129,156,104,30%,32%,26%,6,4,2,5,1,4
445,https://vlr.gg/player/6222/ginilson,2024-12-03 15:00:00,1.16,0.78,0.96,177,195,160,43,24,19,48,20,28,14,3,11,+1,0,+1,68%,76%,61%,122,126,118,33%,34%,32%,6,3,3,5,3,2
446,https://vlr.gg/player/1999/rnd,2024-12-03 15:00:00,0.67,0.79,0.73,186,159,211,41,17,24,57,25,32,13,6,7,-5,-3,-2,62%,64%,61%,129,116,140,15%,20%,12%,5,2,3,10,5,5
447,https://vlr.gg/player/37354/basic,2024-12-03 15:00:00,1.78,1.19,1.50,276,328,223,65,43,22,43,21,22,39,19,20,+3,+1,+2,81%,81%,82%,184,215,149,34%,35%,32%,4,2,2,1,1,0
448,https://vlr.gg/player/37091/peixeh,2024-12-03 15:00:00,1.22,1.06,1.14,198,188,207,48,27,21,40,19,21,8,2,6,+1,-1,+2,67%,67%,67%,148,143,153,32%,33%,30%,7,1,6,6,2,4
449,https://vlr.gg/player/46568/above,2024-12-03 15:00:00,0.93,1.07,0.99,178,152,208,47,25,22,45,23,22,26,11,15,-2,-2,0,65%,69%,61%,115,112,119,33%,29%,39%,4,1,3,6,3,3
450,https://vlr.gg/player/37098/tiezzi,2024-12-03 15:00:00,0.67,1.00,0.83,228,205,249,49,22,27,60,31,29,22,15,7,-2,-2,0,71%,72%,70%,151,142,161,27%,33%,22%,12,8,4,14,10,4
451,https://vlr.gg/player/1673/guiih9,2024-12-03 15:00:00,0.94,0.46,0.71,138,169,110,35,22,13,45,20,25,9,7,2,-5,-2,-3,67%,78%,55%,91,106,73,27%,28%,25%,5,3,2,10,5,5
452,https://vlr.gg/player/1437/yesican,2024-12-03 09:10:00,1.29,1.66,1.45,264,242,289,65,33,32,44,26,18,24,12,12,+6,+3,+3,84%,82%,87%,172,152,197,37%,33%,43%,6,3,3,0,0,0
453,https://vlr.gg/player/23976/crus,2024-12-03 09:10:00,1.22,1.17,1.19,188,188,197,47,27,20,44,26,18,39,24,15,+2,+1,+1,79%,84%,73%,125,131,118,35%,31%,43%,4,2,2,2,1,1
454,https://vlr.gg/player/46463/twilight,2024-12-03 09:10:00,1.13,0.90,1.03,243,255,210,55,35,20,52,27,25,25,11,14,+2,+1,+1,63%,68%,57%,160,167,150,36%,38%,34%,8,5,3,6,4,2
455,https://vlr.gg/player/48574/nia,2024-12-03 09:10:00,0.94,0.62,0.80,197,221,140,40,27,13,54,30,24,17,10,7,+1,-1,+2,62%,61%,63%,123,147,93,34%,37%,29%,11,6,5,10,7,3
456,https://vlr.gg/player/37639/hyuse,2024-12-03 09:10:00,0.49,0.97,0.70,144,125,189,38,17,21,52,31,21,15,10,5,-3,-8,+5,62%,58%,67%,98,82,118,26%,20%,32%,9,1,8,12,9,3
457,https://vlr.gg/player/14677/qq,2024-12-03 09:10:00,0.83,1.34,1.11,216,162,271,55,18,37,51,22,29,22,9,13,+3,-2,+5,69%,63%,74%,145,105,177,24%,22%,25%,12,3,9,9,5,4
458,https://vlr.gg/player/12289/siraww,2024-12-03 09:10:00,1.08,1.11,1.09,214,214,224,50,21,29,48,20,28,25,9,16,-4,-4,0,68%,67%,68%,145,146,145,20%,20%,21%,3,0,3,7,4,3
459,https://vlr.gg/player/19150/niffy,2024-12-03 09:10:00,0.97,1.02,1.00,215,226,213,51,22,29,49,24,25,13,8,5,-2,-2,0,66%,63%,68%,150,155,146,26%,25%,27%,9,5,4,11,7,4
460,https://vlr.gg/player/10790/lby,2024-12-03 09:10:00,1.02,0.94,0.97,183,197,179,48,23,25,49,21,28,31,12,19,-5,-3,-2,71%,67%,74%,128,132,125,33%,44%,26%,1,0,1,6,3,3
461,https://vlr.gg/player/14674/kntz,2024-12-03 09:10:00,1.02,0.79,0.89,175,181,176,42,22,20,49,20,29,24,11,13,0,-1,+1,74%,73%,74%,118,110,124,30%,29%,30%,5,1,4,5,2,3
462,https://vlr.gg/player/16852/nakya,2024-12-03 06:30:00,1.18,1.42,1.28,260,259,258,40,22,18,31,21,10,8,4,4,-4,-1,-3,66%,71%,59%,185,194,173,34%,30%,42%,3,2,1,7,3,4
463,https://vlr.gg/player/7807/valdyn,2024-12-03 06:30:00,0.82,0.81,0.81,144,151,137,19,12,7,31,19,12,19,10,9,-3,-3,0,56%,50%,65%,109,124,89,24%,27%,19%,1,0,1,4,3,1
464,https://vlr.gg/player/23710/gotten,2024-12-03 06:30:00,0.61,1.09,0.81,201,169,251,27,13,14,36,23,13,12,7,5,+2,0,+2,63%,54%,76%,131,107,165,37%,27%,48%,4,0,4,2,0,2
465,https://vlr.gg/player/9296/roseau,2024-12-03 06:30:00,0.46,0.73,0.57,136,137,133,19,11,8,34,22,12,12,5,7,-1,0,-1,59%,58%,59%,88,85,92,18%,22%,13%,1,1,0,2,1,1
466,https://vlr.gg/player/11666/ray4c,2024-12-03 06:30:00,0.27,0.79,0.49,163,147,182,20,10,10,39,25,14,11,6,5,-9,-8,-1,51%,46%,59%,106,94,124,17%,21%,13%,4,3,1,13,11,2
467,https://vlr.gg/player/1430/crazyguy,2024-12-03 06:30:00,1.37,1.68,1.55,279,250,295,42,16,26,25,11,14,12,0,12,+5,+4,+1,80%,71%,88%,196,186,204,21%,32%,16%,8,4,4,3,0,3
468,https://vlr.gg/player/9152/deryeon,2024-12-03 06:30:00,1.43,1.19,1.29,218,270,184,36,18,18,22,10,12,15,1,14,+2,+1,+1,78%,71%,83%,143,185,113,35%,52%,23%,2,1,1,0,0,0
469,https://vlr.gg/player/24653/vera,2024-12-03 06:30:00,1.17,1.31,1.25,282,263,299,39,16,23,28,12,16,13,1,12,+3,0,+3,83%,71%,92%,184,159,202,29%,41%,22%,9,4,5,6,4,2
470,https://vlr.gg/player/11704/styron,2024-12-03 06:30:00,0.77,1.46,1.17,163,116,198,22,5,17,22,11,11,31,12,19,+3,-1,+4,95%,94%,96%,119,88,142,27%,19%,33%,4,0,4,1,1,0
471,https://vlr.gg/player/24628/wayne,2024-12-03 06:30:00,0.62,1.54,1.16,208,125,267,31,6,25,28,13,15,23,12,11,+2,-1,+3,80%,71%,88%,135,76,177,23%,23%,24%,5,1,4,3,2,1
472,https://vlr.gg/player/4038/bangnan,2024-12-03 05:35:00,1.10,1.13,1.11,245,252,237,56,32,24,42,25,17,9,6,3,+3,+4,-1,77%,79%,74%,153,152,154,44%,42%,47%,7,6,1,4,2,2
473,https://vlr.gg/player/38369/only1,2024-12-03 05:35:00,1.10,0.83,0.98,215,240,202,47,29,18,47,27,20,13,7,6,+6,+2,+4,74%,68%,81%,143,145,140,28%,28%,30%,16,7,9,10,5,5
474,https://vlr.gg/player/34727/kayle,2024-12-03 05:35:00,0.87,0.89,0.88,171,176,168,39,21,18,43,26,17,19,14,5,-2,-1,-1,67%,74%,59%,111,112,108,18%,24%,13%,4,3,1,6,4,2
475,https://vlr.gg/player/13000/redlight,2024-12-03 05:35:00,0.93,0.67,0.82,148,148,167,33,19,14,47,25,22,33,17,16,-2,-2,0,77%,76%,78%,106,105,107,23%,29%,18%,4,1,3,6,3,3
476,https://vlr.gg/player/40279/ngen,2024-12-03 05:35:00,0.71,0.65,0.69,119,108,128,23,12,11,39,23,16,19,12,7,-2,-3,+1,69%,68%,70%,76,71,84,21%,27%,16%,1,0,1,3,3,0
477,https://vlr.gg/player/25089/cabeza,2024-12-03 05:35:00,1.88,1.06,1.42,263,345,208,59,33,26,38,15,23,9,4,5,+4,+4,0,80%,81%,79%,178,218,147,30%,31%,30%,6,5,1,2,1,1
478,https://vlr.gg/player/25082/rico,2024-12-03 05:35:00,1.02,1.06,1.04,182,168,196,38,16,22,42,18,24,30,11,19,-1,0,-1,84%,81%,85%,123,113,131,25%,26%,24%,5,1,4,6,1,5
479,https://vlr.gg/player/4127/felix,2024-12-03 05:35:00,0.97,1.00,0.99,180,154,192,38,15,23,36,15,21,11,4,7,-2,+2,-4,74%,67%,79%,110,92,125,21%,24%,19%,5,3,2,7,1,6
480,https://vlr.gg/player/25080/empty,2024-12-03 05:35:00,0.60,1.11,0.88,180,123,213,36,11,25,40,19,21,13,4,9,-5,-5,0,70%,74%,68%,110,82,132,20%,13%,24%,3,0,3,8,5,3
481,https://vlr.gg/player/17049/hermes,2024-12-03 05:35:00,0.69,1.00,0.86,209,169,222,42,17,25,46,22,24,13,4,9,+1,-4,+5,72%,63%,79%,124,94,148,23%,13%,33%,10,3,7,9,7,2
482,https://vlr.gg/player/985/efina,2024-12-03 03:00:00,1.39,0.89,1.10,210,268,169,31,18,13,28,10,18,17,10,7,-2,0,-2,71%,82%,63%,129,157,109,28%,43%,16%,2,1,1,4,1,3
483,https://vlr.gg/player/5283/bunny,2024-12-03 03:00:00,1.25,0.80,0.99,226,255,205,31,15,16,33,11,22,10,6,4,-3,0,-3,66%,71%,63%,136,160,120,10%,11%,9%,6,4,2,9,4,5
484,https://vlr.gg/player/4827/goddead,2024-12-03 03:00:00,1.54,0.56,0.97,209,299,146,30,19,11,34,12,22,24,14,10,+3,+1,+2,68%,82%,58%,136,190,97,30%,28%,32%,4,1,3,1,0,1
485,https://vlr.gg/player/9783/doenmo,2024-12-03 03:00:00,0.72,0.91,0.83,159,124,184,19,6,13,33,12,21,33,14,19,+1,+1,0,66%,71%,63%,101,74,121,27%,42%,21%,1,1,0,0,0,0
486,https://vlr.gg/player/28401/pkm,2024-12-03 03:00:00,0.52,0.74,0.65,158,115,187,23,8,15,33,12,21,4,2,2,-2,-1,-1,66%,65%,67%,106,89,119,21%,20%,21%,6,2,4,8,3,5
487,https://vlr.gg/player/4666/acme,2024-12-03 03:00:00,1.69,1.05,1.42,276,321,207,39,29,10,26,13,13,18,6,12,0,0,0,88%,92%,82%,187,221,138,31%,34%,24%,5,4,1,5,4,1
488,https://vlr.gg/player/4060/daegi,2024-12-03 03:00:00,1.30,1.08,1.21,252,282,213,36,24,12,27,14,13,10,7,3,+2,+2,0,78%,83%,71%,166,185,140,21%,19%,25%,8,5,3,6,3,3
489,https://vlr.gg/player/42771/nameless,2024-12-03 03:00:00,0.85,1.45,1.10,184,119,273,26,9,17,25,12,13,11,9,2,+3,+2,+1,73%,83%,59%,121,75,186,44%,29%,55%,3,2,1,0,0,0
490,https://vlr.gg/player/42710/froz,2024-12-03 03:00:00,1.13,0.81,1.00,189,203,171,32,21,11,25,12,13,3,1,2,-2,-2,0,71%,79%,59%,135,148,118,40%,38%,43%,2,0,2,4,2,2
491,https://vlr.gg/player/42769/wezzy,2024-12-03 03:00:00,1.04,0.61,0.86,193,247,119,28,21,7,31,17,14,11,5,6,0,+2,-2,76%,88%,59%,126,155,85,22%,24%,18%,4,3,1,4,1,3
492,https://vlr.gg/player/5292/al0rante,2024-12-02 12:00:00,0.95,1.52,1.28,256,225,280,39,15,24,25,12,13,8,2,6,+1,+1,0,78%,71%,83%,164,147,177,40%,67%,31%,4,2,2,3,1,2
493,https://vlr.gg/player/4244/yaboilewis,2024-12-02 12:00:00,1.30,1.25,1.27,219,192,233,32,12,20,23,7,16,13,5,8,+2,+3,-1,83%,88%,78%,146,125,162,48%,71%,36%,8,6,2,6,3,3
494,https://vlr.gg/player/1457/mistic,2024-12-02 12:00:00,1.63,0.79,1.14,213,276,162,31,18,13,25,8,17,18,7,11,-2,-1,-1,78%,76%,78%,143,196,104,29%,34%,24%,3,1,2,5,2,3
495,https://vlr.gg/player/2690/hoody,2024-12-02 12:00:00,1.08,1.19,1.14,204,170,226,28,10,18,25,8,17,17,8,9,+2,0,+2,78%,71%,83%,126,105,142,27%,29%,26%,2,0,2,0,0,0
496,https://vlr.gg/player/2658/xuss,2024-12-02 12:00:00,1.30,0.98,1.12,219,247,202,32,16,16,26,9,17,9,1,8,+3,0,+3,78%,76%,78%,140,154,129,19%,11%,26%,6,1,5,3,1,2
497,https://vlr.gg/player/4525/stix,2024-12-02 12:00:00,1.01,0.84,0.94,185,175,210,28,16,12,30,16,14,12,9,3,+3,0,+3,65%,70%,59%,121,113,132,39%,32%,49%,4,0,4,1,0,1
498,https://vlr.gg/player/5477/leon,2024-12-02 12:00:00,0.97,0.88,0.93,169,201,145,25,16,9,30,16,14,5,5,0,0,-1,+1,63%,70%,53%,121,133,104,27%,25%,32%,2,1,1,2,2,0
499,https://vlr.gg/player/22180/spmak,2024-12-02 12:00:00,1.33,0.36,0.90,178,272,70,24,21,3,31,18,13,13,11,2,-1,+2,-3,65%,78%,47%,122,170,56,19%,22%,14%,4,4,0,5,2,3
500,https://vlr.gg/player/30754/karma,2024-12-02 12:00:00,0.82,0.99,0.89,196,191,202,26,15,11,33,19,14,12,7,5,-3,0,-3,70%,78%,59%,137,127,151,25%,26%,24%,2,2,0,5,2,3
501,https://vlr.gg/player/45490/ico,2024-12-02 12:00:00,0.33,0.48,0.39,155,150,157,21,12,9,38,22,16,6,6,0,-5,-4,-1,60%,61%,59%,93,91,96,32%,23%,50%,5,3,2,10,7,3
0,https://vlr.gg/player/292/fit1nho,2024-12-02 11:00:00,1.01,1.33,1.14,242,242,254,55,30,25,50,31,19,4,2,2,+4,0,+4,68%,64%,73%,152,145,162,35%,44%,24%,13,8,5,9,8,1
1,https://vlr.gg/player/2864/ease,2024-12-02 11:00:00,1.08,0.97,1.04,203,213,186,42,27,15,44,25,19,23,9,14,-3,-5,+2,66%,64%,69%,131,143,115,26%,24%,30%,3,0,3,6,5,1
2,https://vlr.gg/player/7220/saiz,2024-12-02 11:00:00,0.97,0.81,0.90,201,220,185,44,28,16,50,29,21,4,1,3,-2,-2,0,63%,64%,62%,141,154,122,37%,41%,31%,4,2,2,6,4,2
3,https://vlr.gg/player/5199/guardy,2024-12-02 11:00:00,0.72,1.03,0.85,178,159,214,36,17,19,49,30,19,24,12,12,-1,0,-1,68%,69%,65%,123,106,147,31%,38%,25%,5,2,3,6,2,4
4,https://vlr.gg/player/20055/toki,2024-12-02 11:00:00,0.61,0.85,0.73,165,130,201,12,5,7,19,9,10,6,4,2,-1,-2,+1,58%,67%,50%,100,75,125,27%,22%,30%,3,1,2,4,3,1
5,https://vlr.gg/player/20058/devilasxa,2024-12-02 11:00:00,0.42,0.39,0.41,96,108,64,12,8,4,32,21,11,8,4,4,-1,+1,-2,58%,54%,64%,70,76,59,31%,26%,50%,1,1,0,2,0,2
6,https://vlr.gg/player/573/cned,2024-12-02 11:00:00,1.46,1.71,1.61,343,307,353,75,29,46,41,18,23,20,8,12,+9,+1,+8,85%,77%,92%,204,199,208,27%,35%,22%,16,5,11,7,4,3
7,https://vlr.gg/player/21328/wo0t,2024-12-02 11:00:00,3.10,0.70,1.30,256,487,180,17,9,8,8,0,8,1,0,1,0,+1,-1,75%,100%,67%,156,275,116,48%,53%,44%,2,1,1,2,0,2
8,https://vlr.gg/player/3557/skylen,2024-12-02 11:00:00,1.02,1.20,1.12,237,209,257,55,21,34,45,19,26,26,10,16,-2,-2,0,81%,77%,83%,155,134,170,44%,43%,44%,7,1,6,9,3,6
9,https://vlr.gg/player/19776/jrayn,2024-12-02 11:00:00,0.94,1.07,1.01,168,180,162,38,17,21,35,17,18,20,10,10,-1,-2,+1,77%,69%,83%,113,120,107,29%,27%,32%,2,1,1,3,3,0
10,https://vlr.gg/player/22792/jiex,2024-12-02 11:00:00,0.91,0.93,0.92,165,160,174,30,13,17,32,15,17,11,6,5,-3,0,-3,63%,68%,58%,121,104,136,39%,38%,40%,1,1,0,4,1,3
11,https://vlr.gg/player/19362/lyda,2024-12-02 11:00:00,0.61,0.86,0.75,135,117,148,29,10,19,40,17,23,19,4,15,+1,-2,+3,65%,62%,67%,90,77,99,26%,21%,29%,5,2,3,4,4,0
12,https://vlr.gg/player/9290/madelyn,2024-12-02 09:30:00,1.55,1.88,1.67,250,229,309,36,21,15,15,9,6,20,15,5,+2,+2,0,86%,92%,77%,155,147,169,22%,23%,20%,4,3,1,2,1,1
13,https://vlr.gg/player/4872/frostmind,2024-12-02 09:30:00,1.28,1.54,1.37,231,191,303,31,17,14,19,11,8,26,19,7,+1,-1,+2,76%,79%,69%,154,126,207,47%,44%,50%,2,0,2,1,1,0
14,https://vlr.gg/player/26829/damaraa,2024-12-02 09:30:00,1.51,0.79,1.25,323,358,258,41,29,12,29,18,11,11,9,2,+5,+3,+2,76%,79%,69%,207,236,153,21%,25%,12%,13,9,4,8,6,2
15,https://vlr.gg/player/10749/k1ngkappa,2024-12-02 09:30:00,0.94,1.23,1.04,191,192,193,26,17,9,22,16,6,5,3,2,0,0,0,78%,75%,85%,136,134,139,32%,26%,50%,2,1,1,2,1,1
16,https://vlr.gg/player/9263/sayoo,2024-12-02 09:30:00,1.22,0.35,0.90,224,272,120,30,24,6,27,15,12,14,12,2,-1,0,-1,76%,83%,62%,142,183,68,28%,30%,24%,1,1,0,2,1,1
17,https://vlr.gg/player/14209/suka,2024-12-02 09:30:00,1.30,1.15,1.20,229,229,227,28,11,17,28,9,19,13,4,9,-3,-1,-2,65%,69%,63%,150,149,151,26%,33%,23%,1,0,1,4,1,3
18,https://vlr.gg/player/14587/daft,2024-12-02 09:30:00,1.36,0.89,1.05,242,300,205,29,14,15,32,12,20,4,1,3,+2,+2,0,70%,69%,71%,164,213,137,36%,52%,27%,4,2,2,2,0,2
19,https://vlr.gg/player/44149/pr0digy,2024-12-02 09:30:00,0.23,0.80,0.60,164,83,212,21,4,17,37,12,25,9,2,7,-1,-3,+2,62%,46%,71%,113,71,136,42%,38%,43%,4,0,4,5,3,2
20,https://vlr.gg/player/14254/gin,2024-12-02 09:30:00,0.70,0.43,0.52,143,201,111,17,9,8,34,12,22,6,2,4,-2,0,-2,59%,62%,58%,102,136,83,24%,40%,13%,2,2,0,4,2,2
21,https://vlr.gg/player/19154/albus,2024-12-02 09:30:00,0.55,0.50,0.51,119,114,129,17,5,12,33,11,22,6,2,4,-3,-1,-2,70%,85%,63%,78,76,79,44%,37%,53%,4,1,3,7,2,5
22,https://vlr.gg/player/36013/hydrakid,2024-12-02 07:00:00,0.78,0.89,0.86,187,171,193,24,7,17,28,10,18,3,1,2,-2,-1,-1,57%,64%,54%,125,124,125,21%,19%,22%,4,0,4,6,1,5
23,https://vlr.gg/player/7746/kevzii,2024-12-02 07:00:00,1.02,0.67,0.78,193,238,171,20,8,12,33,10,23,9,2,7,-1,0,-1,57%,64%,54%,138,178,120,33%,35%,31%,3,1,2,4,1,3
24,https://vlr.gg/player/9737/kakarot,2024-12-02 07:00:00,0.72,0.68,0.69,154,156,158,17,6,11,30,9,21,12,4,8,-4,-3,-1,54%,64%,50%,95,73,104,23%,33%,20%,2,0,2,6,3,3
25,https://vlr.gg/player/16953/zynd,2024-12-02 07:00:00,0.28,0.81,0.65,159,117,185,18,4,14,30,11,19,5,2,3,0,0,0,51%,55%,50%,117,91,129,42%,31%,47%,3,2,1,3,2,1
26,https://vlr.gg/player/21677/jeee,2024-12-02 07:00:00,0.71,0.51,0.57,119,143,113,13,5,8,29,9,20,10,4,6,0,+1,-1,51%,64%,46%,87,82,89,35%,50%,29%,2,1,1,2,0,2
27,https://vlr.gg/player/27254/leviathan,2024-12-02 07:00:00,1.93,1.29,1.73,311,349,219,42,32,10,15,10,5,6,4,2,+2,+1,+1,80%,83%,73%,206,235,142,49%,50%,47%,5,4,1,3,3,0
28,https://vlr.gg/player/23930/potter,2024-12-02 07:00:00,1.36,1.43,1.38,292,274,333,36,24,12,21,13,8,8,4,4,+5,+2,+3,80%,79%,82%,192,182,215,40%,45%,31%,9,5,4,4,3,1
29,https://vlr.gg/player/4377/johnolsen,2024-12-02 07:00:00,1.31,1.40,1.34,214,219,211,29,19,10,17,12,5,14,11,3,0,+1,-1,86%,83%,91%,151,149,155,36%,37%,35%,3,2,1,3,1,2
30,https://vlr.gg/player/3342/sushiboys,2024-12-02 07:00:00,1.04,1.02,1.03,159,157,157,20,13,7,19,13,6,16,13,3,-1,-1,0,86%,88%,82%,104,105,102,35%,33%,40%,1,1,0,2,2,0
31,https://vlr.gg/player/2366/alert,2024-12-02 07:00:00,0.83,1.37,1.00,179,148,244,23,13,10,20,14,6,9,5,4,+1,+1,0,83%,83%,82%,128,110,167,34%,41%,25%,3,2,1,2,1,1
32,https://vlr.gg/player/10758/kohliii,2024-12-02 03:30:00,1.11,1.51,1.29,237,216,279,61,31,30,44,24,20,30,15,15,0,-1,+1,82%,80%,84%,162,142,187,27%,32%,24%,2,0,2,2,1,1
33,https://vlr.gg/player/28612/tricky,2024-12-02 03:30:00,1.38,1.09,1.25,265,310,232,66,43,23,53,29,24,10,4,6,+2,+3,-1,75%,80%,69%,177,198,151,27%,37%,15%,16,11,5,14,8,6
34,https://vlr.gg/player/43404/snipst,2024-12-02 03:30:00,0.97,1.31,1.12,225,195,250,61,30,31,47,25,22,13,6,7,+1,-1,+2,75%,78%,72%,142,126,163,41%,38%,43%,5,1,4,4,2,2
35,https://vlr.gg/player/10463/paradox,2024-12-02 03:30:00,1.23,0.90,1.08,257,258,209,55,35,20,55,28,27,39,22,17,-1,-2,+1,74%,80%,66%,151,164,135,29%,31%,26%,6,3,3,7,5,2
36,https://vlr.gg/player/4089/doxz3r,2024-12-02 03:30:00,0.68,0.65,0.66,131,130,128,33,19,14,54,29,25,28,16,12,+2,-3,+5,69%,73%,66%,82,85,77,27%,30%,23%,9,3,6,7,6,1
37,https://vlr.gg/player/43398/river,2024-12-02 03:30:00,1.19,1.12,1.15,205,211,201,53,24,29,46,18,28,30,14,16,+1,0,+1,78%,78%,78%,132,132,132,32%,31%,32%,4,2,2,3,2,1
38,https://vlr.gg/player/22054/wave,2024-12-02 03:30:00,1.14,0.91,1.01,238,265,209,59,32,27,56,24,32,14,6,8,-3,-2,-1,74%,78%,70%,147,163,134,33%,35%,31%,8,4,4,11,6,5
39,https://vlr.gg/player/43389/yash,2024-12-02 03:30:00,0.64,1.12,0.90,225,164,271,52,17,35,61,27,34,13,6,7,+4,0,+4,68%,69%,68%,145,115,170,23%,17%,29%,14,3,11,10,3,7
40,https://vlr.gg/player/49570/rinsat,2024-12-02 03:30:00,0.90,0.76,0.80,172,204,186,50,25,25,64,27,37,19,11,8,-3,-5,+2,65%,72%,60%,125,135,116,42%,53%,34%,6,2,4,9,7,2
41,https://vlr.gg/player/27755/icarus,2024-12-02 03:30:00,0.86,0.69,0.77,144,176,122,39,21,18,51,23,28,8,4,4,-3,-1,-2,67%,72%,63%,106,126,90,24%,29%,20%,2,1,1,5,2,3
42,https://vlr.gg/player/36560/canezerra,2024-12-01 18:40:00,1.31,1.52,1.39,292,261,327,41,22,19,25,13,12,8,6,2,-4,-2,-2,75%,75%,75%,199,190,213,33%,34%,32%,4,3,1,8,5,3
43,https://vlr.gg/player/41798/nightz,2024-12-01 18:40:00,1.38,0.92,1.20,248,277,190,36,26,10,30,16,14,22,10,12,+3,+2,+1,78%,88%,63%,153,177,117,51%,56%,41%,6,3,3,3,1,2
44,https://vlr.gg/player/21778/p0ppin,2024-12-01 18:40:00,1.11,1.01,1.07,175,142,240,24,12,12,24,11,13,13,8,5,0,0,0,83%,79%,88%,127,96,173,25%,19%,30%,2,0,2,2,0,2
45,https://vlr.gg/player/53/inspire,2024-12-01 18:40:00,1.08,0.90,1.01,207,228,159,28,19,9,25,15,10,6,4,2,+3,+2,+1,75%,75%,75%,130,146,106,39%,39%,40%,6,4,2,3,2,1
46,https://vlr.gg/player/35302/eggsterr,2024-12-01 18:40:00,0.97,0.86,0.93,164,193,147,29,19,10,27,16,11,8,5,3,+2,+2,0,90%,92%,88%,106,121,83,22%,36%,9%,4,4,0,2,2,0
47,https://vlr.gg/player/7716/penny,2024-12-01 18:40:00,0.88,0.96,0.93,220,230,231,31,13,18,33,12,21,7,2,5,-1,+1,-2,73%,69%,75%,145,145,144,14%,24%,8%,7,5,2,8,4,4
48,https://vlr.gg/player/733/stellar,2024-12-01 18:40:00,1.08,0.81,0.92,166,189,155,24,11,13,27,10,17,7,5,2,0,0,0,78%,88%,71%,108,111,107,21%,19%,23%,1,0,1,1,0,1
49,https://vlr.gg/player/8742/jakee,2024-12-01 18:40:00,0.50,1.11,0.85,207,159,254,29,8,21,37,16,21,15,9,6,+3,0,+3,75%,69%,79%,126,85,153,20%,12%,24%,8,2,6,5,2,3
50,https://vlr.gg/player/69/thief,2024-12-01 18:40:00,1.20,0.58,0.83,160,227,129,25,14,11,31,11,20,10,4,6,-4,-2,-2,65%,69%,63%,124,158,101,43%,38%,48%,1,0,1,5,2,3
51,https://vlr.gg/player/739/fiziq,2024-12-01 18:40:00,1.26,0.51,0.81,160,225,123,21,13,8,30,11,19,14,8,6,-2,+1,-3,68%,88%,54%,117,140,101,25%,27%,23%,1,1,0,3,0,3
52,https://vlr.gg/player/5351/rglmeister,2024-12-01 17:20:00,1.52,1.83,1.65,256,236,284,40,21,19,19,12,7,22,17,5,+2,+1,+1,88%,88%,88%,169,159,184,31%,30%,31%,2,1,1,0,0,0
53,https://vlr.gg/player/21659/sato,2024-12-01 17:20:00,1.06,1.55,1.26,260,242,286,38,19,19,27,18,9,8,6,2,+5,0,+5,88%,83%,94%,167,161,176,26%,26%,26%,10,4,6,5,4,1
54,https://vlr.gg/player/1566/prozin,2024-12-01 17:20:00,1.37,0.89,1.17,212,266,134,32,23,9,23,14,9,10,4,6,+1,+2,-1,83%,88%,76%,122,154,77,28%,28%,28%,3,2,1,2,0,2
55,https://vlr.gg/player/28716/lukxo,2024-12-01 17:20:00,1.21,0.78,1.03,210,226,188,32,20,12,27,15,12,7,6,1,0,0,0,73%,75%,71%,135,151,113,26%,25%,27%,4,3,1,4,3,1
56,https://vlr.gg/player/6238/urango,2024-12-01 17:20:00,0.62,1.09,0.82,164,130,212,23,11,12,27,17,10,16,9,7,-1,-5,+4,78%,79%,76%,117,102,139,24%,24%,23%,5,1,4,6,6,0
57,https://vlr.gg/player/9266/tisora,2024-12-01 17:20:00,0.86,1.11,0.99,233,177,273,31,10,21,34,14,20,22,10,12,-2,-4,+2,66%,71%,63%,153,114,181,28%,31%,26%,6,1,5,8,5,3
58,https://vlr.gg/player/33121/stwz1,2024-12-01 17:20:00,0.70,1.13,0.95,198,150,231,26,8,18,34,15,19,11,4,7,+1,0,+1,66%,76%,58%,127,93,151,36%,23%,44%,2,1,1,1,1,0
59,https://vlr.gg/player/37105/loss,2024-12-01 17:20:00,0.62,0.95,0.81,171,161,182,25,10,15,34,16,18,15,3,12,+1,-2,+3,66%,53%,75%,99,92,105,23%,16%,29%,6,1,5,5,3,2
60,https://vlr.gg/player/23001/zaninzs,2024-12-01 17:20:00,0.84,0.59,0.69,153,197,121,22,11,11,31,13,18,2,1,1,-6,-2,-4,59%,53%,63%,100,129,79,27%,36%,19%,2,1,1,8,3,5
61,https://vlr.gg/player/2021/axeddy,2024-12-01 17:20:00,0.69,0.66,0.67,135,145,129,19,8,11,32,13,19,10,3,7,-1,-1,0,59%,65%,54%,96,110,86,27%,26%,29%,1,0,1,2,1,1
62,https://vlr.gg/player/7616/feniz,2024-12-01 17:00:00,1.62,1.19,1.38,266,286,251,100,49,51,66,24,42,29,10,19,+15,+7,+8,86%,89%,83%,170,179,163,35%,35%,35%,17,7,10,2,0,2
63,https://vlr.gg/player/8056/mited,2024-12-01 17:00:00,1.27,1.20,1.23,222,207,223,76,32,44,54,21,33,46,23,23,+2,+4,-2,78%,83%,74%,147,136,156,19%,19%,19%,7,4,3,5,0,5
64,https://vlr.gg/player/10557/darker,2024-12-01 17:00:00,1.24,1.23,1.23,240,227,238,93,42,51,69,27,42,44,15,29,+1,-4,+5,82%,78%,84%,157,152,161,31%,28%,33%,7,0,7,6,4,2
65,https://vlr.gg/player/24865/acrian,2024-12-01 17:00:00,1.18,0.81,0.97,172,193,148,61,34,27,67,26,41,53,21,32,+5,+4,+1,77%,85%,71%,101,113,91,17%,20%,14%,8,4,4,3,0,3
66,https://vlr.gg/player/3983/virtyy,2024-12-01 17:00:00,0.93,0.90,0.91,201,199,203,74,33,41,71,30,41,18,8,10,-3,-3,0,70%,72%,69%,134,128,140,24%,26%,22%,23,12,11,26,15,11
67,https://vlr.gg/player/10718/rowancy,2024-12-01 17:00:00,0.97,0.95,0.95,183,186,204,74,42,32,78,40,38,26,12,14,-1,-2,+1,67%,69%,65%,127,123,131,29%,30%,27%,7,3,4,8,5,3
68,https://vlr.gg/player/26757/otaq,2024-12-01 17:00:00,0.89,0.90,0.89,174,173,183,62,35,27,75,42,33,36,24,12,-6,-4,-2,73%,78%,67%,114,110,119,16%,18%,14%,7,2,5,13,6,7
69,https://vlr.gg/player/20809/p4nd4,2024-12-01 17:00:00,0.89,0.82,0.86,182,175,191,61,34,27,84,45,39,47,30,17,-2,-3,+1,70%,71%,70%,118,119,117,28%,26%,31%,7,2,5,9,5,4
70,https://vlr.gg/player/31476/mephisto,2024-12-01 17:00:00,1.19,0.43,0.85,203,269,130,73,54,19,87,44,43,22,14,8,-9,-2,-7,67%,74%,59%,131,166,86,23%,22%,27%,14,11,3,23,13,10
71,https://vlr.gg/player/15931/peloncito,2024-12-01 17:00:00,0.87,0.69,0.79,169,173,167,57,35,22,81,43,38,26,16,10,-2,-1,-1,64%,71%,57%,116,113,120,37%,46%,29%,7,5,2,9,6,3
72,https://vlr.gg/player/10053/fireballops,2024-12-01 16:00:00,1.11,1.07,1.09,227,207,236,38,16,22,35,13,22,11,6,5,-2,-3,+1,69%,81%,59%,148,134,159,31%,28%,34%,3,0,3,5,3,2
73,https://vlr.gg/player/62/huynh,2024-12-01 16:00:00,1.22,0.78,0.97,214,248,190,35,18,17,36,14,22,22,12,10,0,+2,-2,79%,81%,78%,126,143,113,17%,30%,10%,5,4,1,5,2,3
74,https://vlr.gg/player/48025/alym,2024-12-01 16:00:00,1.30,0.64,0.93,200,294,149,35,21,14,37,15,22,11,6,5,-4,-1,-3,67%,86%,52%,145,205,98,28%,23%,37%,6,3,3,10,4,6
75,https://vlr.gg/player/9094/kess,2024-12-01 16:00:00,1.14,0.67,0.88,169,188,162,26,12,14,35,12,23,29,20,9,-4,-2,-2,67%,76%,59%,110,112,109,15%,10%,20%,2,0,2,6,2,4
76,https://vlr.gg/player/6445/sogo,2024-12-01 16:00:00,0.96,0.59,0.75,147,163,142,24,12,12,35,12,23,14,7,7,-2,-1,-1,63%,76%,52%,96,96,96,31%,23%,38%,2,1,1,4,2,2
77,https://vlr.gg/player/733/stellar,2024-12-01 16:00:00,1.53,0.88,1.25,238,257,180,39,26,13,28,12,16,14,8,6,+2,+1,+1,75%,85%,62%,137,159,108,29%,35%,20%,4,2,2,2,1,1
78,https://vlr.gg/player/8742/jakee,2024-12-01 16:00:00,1.45,0.60,1.08,190,269,96,33,27,6,29,15,14,17,13,4,+2,+2,0,65%,78%,48%,124,163,73,28%,38%,9%,5,3,2,3,1,2
79,https://vlr.gg/player/7716/penny,2024-12-01 16:00:00,1.07,1.05,1.07,231,235,246,38,23,15,36,19,17,8,2,6,+4,+1,+3,69%,70%,67%,166,163,169,21%,26%,17%,8,5,3,4,4,0
80,https://vlr.gg/player/69/thief,2024-12-01 16:00:00,1.15,0.96,1.07,214,216,223,38,20,18,32,16,16,7,7,0,+2,+1,+1,77%,81%,71%,142,146,138,34%,46%,24%,6,2,4,4,1,3
81,https://vlr.gg/player/739/fiziq,2024-12-01 16:00:00,0.93,0.96,0.94,199,184,195,30,16,14,33,17,16,15,10,5,+2,+2,0,63%,67%,57%,130,127,135,19%,19%,18%,7,5,2,5,3,2
82,https://vlr.gg/player/1581/guhrvn,2024-12-01 15:00:00,1.37,1.30,1.33,213,207,221,32,15,17,20,8,12,16,4,12,0,0,0,85%,79%,90%,141,140,142,39%,25%,54%,2,0,2,2,0,2
83,https://vlr.gg/player/13093/jzz,2024-12-01 15:00:00,1.06,1.39,1.23,218,137,289,33,10,23,21,9,12,13,6,7,-1,-3,+2,78%,74%,81%,143,106,176,30%,45%,24%,4,0,4,5,3,2
84,https://vlr.gg/player/15361/swag,2024-12-01 15:00:00,1.49,0.85,1.16,239,307,185,33,20,13,28,14,14,12,8,4,-1,0,-1,88%,89%,86%,157,200,118,30%,33%,25%,1,1,0,2,1,1
85,https://vlr.gg/player/8881/leozin,2024-12-01 15:00:00,1.21,1.00,1.10,229,283,181,34,21,13,25,13,12,16,8,8,-2,-2,0,75%,84%,67%,139,159,122,28%,34%,22%,2,0,2,4,2,2
86,https://vlr.gg/player/3455/zanatsu,2024-12-01 15:00:00,0.66,1.43,1.07,269,218,310,38,14,24,33,18,15,9,3,6,0,+2,-2,73%,63%,81%,177,131,218,24%,24%,24%,9,7,2,9,5,4
87,https://vlr.gg/player/25683/desire,2024-12-01 15:00:00,1.02,1.06,1.04,230,219,246,29,16,13,34,17,17,20,7,13,+2,0,+2,75%,67%,84%,156,142,171,35%,44%,28%,6,1,5,4,1,3
88,https://vlr.gg/player/20251/vit9ine,2024-12-01 15:00:00,0.76,0.94,0.84,165,168,166,24,12,12,32,18,14,6,3,3,+3,+2,+1,53%,52%,53%,106,110,101,24%,33%,15%,6,5,1,3,3,0
89,https://vlr.gg/player/1605/champzera,2024-12-01 15:00:00,0.95,0.70,0.83,174,189,165,27,14,13,34,17,17,6,1,5,-1,+1,-2,58%,48%,68%,115,123,106,34%,32%,37%,1,1,0,2,0,2
90,https://vlr.gg/player/36105/needy,2024-12-01 15:00:00,0.56,1.03,0.78,202,186,213,26,12,14,35,20,15,6,1,5,-1,-1,0,55%,48%,63%,132,115,152,39%,38%,41%,6,3,3,7,4,3
91,https://vlr.gg/player/1595/myssen,2024-12-01 15:00:00,0.67,0.65,0.66,157,152,161,21,11,10,35,18,17,13,6,7,+1,-1,+2,60%,62%,58%,100,97,103,46%,50%,42%,3,1,2,2,2,0
92,https://vlr.gg/player/3649/litshii,2024-12-01 14:20:00,1.01,1.24,1.14,208,179,246,43,16,27,38,20,18,18,13,5,+5,0,+5,76%,68%,84%,140,118,160,22%,19%,25%,8,2,6,3,2,1
93,https://vlr.gg/player/2540/happen,2024-12-01 14:20:00,0.80,0.98,0.90,177,185,176,34,17,17,41,22,19,15,4,11,-4,-3,-1,69%,61%,77%,124,133,117,30%,26%,35%,1,0,1,5,3,2
94,https://vlr.gg/player/13238/shiio,2024-12-01 14:20:00,0.90,0.73,0.81,144,180,125,32,17,15,41,22,19,3,2,1,+1,+2,-1,61%,61%,61%,105,121,91,34%,33%,34%,4,3,1,3,1,2
95,https://vlr.gg/player/20032/treelover,2024-12-01 14:20:00,0.62,0.97,0.80,149,121,181,33,11,22,40,21,19,13,10,3,-1,-2,+1,54%,50%,58%,102,79,122,31%,27%,33%,6,2,4,7,4,3
96,https://vlr.gg/player/47270/darkwinjett,2024-12-01 14:20:00,0.30,0.89,0.61,145,110,184,30,11,19,46,24,22,9,2,7,-8,-5,-3,51%,46%,55%,100,70,127,16%,15%,16%,7,3,4,15,8,7
97,https://vlr.gg/player/4525/stix,2024-12-01 14:20:00,1.28,1.42,1.34,227,210,226,46,24,22,29,17,12,21,5,16,+1,+1,0,78%,68%,89%,136,133,140,29%,50%,20%,6,2,4,5,1,4
98,https://vlr.gg/player/30754/karma,2024-12-01 14:20:00,1.15,1.29,1.22,241,233,238,51,27,24,36,20,16,13,6,7,+2,0,+2,73%,71%,75%,155,152,159,26%,33%,20%,9,6,3,7,6,1
99,https://vlr.gg/player/45490/ico,2024-12-01 14:20:00,0.83,1.27,1.04,197,170,236,39,16,23,38,21,17,10,5,5,+6,0,+6,69%,65%,75%,135,106,166,25%,19%,31%,12,4,8,6,4,2
100,https://vlr.gg/player/5477/leon,2024-12-01 14:20:00,0.85,1.19,1.01,166,136,207,35,15,20,32,18,14,15,6,9,-1,0,-1,75%,74%,75%,116,100,134,37%,44%,32%,3,2,1,4,2,2
101,https://vlr.gg/player/22180/spmak,2024-12-01 14:20:00,0.72,1.30,0.99,180,156,203,35,15,20,37,24,13,21,11,10,-1,-2,+1,71%,71%,71%,118,105,133,16%,15%,17%,3,1,2,4,3,1
102,https://vlr.gg/player/21328/wo0t,2024-12-01 12:45:00,1.42,1.72,1.60,272,291,284,52,20,32,25,14,11,9,4,5,+9,+3,+6,88%,85%,90%,181,186,178,33%,32%,33%,10,4,6,1,1,0
103,https://vlr.gg/player/3557/skylen,2024-12-01 12:45:00,1.00,1.50,1.30,296,172,302,45,13,32,32,14,18,18,8,10,+3,-2,+5,69%,55%,79%,164,115,198,39%,50%,35%,8,0,8,5,2,3
104,https://vlr.gg/player/573/cned,2024-12-01 12:45:00,1.08,1.45,1.29,239,250,242,43,18,25,29,16,13,10,1,9,+6,0,+6,82%,70%,90%,164,165,164,30%,40%,22%,11,5,6,5,5,0
105,https://vlr.gg/player/19776/jrayn,2024-12-01 12:45:00,0.54,1.39,1.05,163,73,218,29,5,24,26,14,12,11,3,8,-1,-2,+1,80%,65%,90%,115,63,151,42%,20%,49%,2,0,2,3,2,1
106,https://vlr.gg/player/19362/lyda,2024-12-01 12:45:00,0.65,1.01,0.94,159,190,152,7,2,5,8,2,6,9,0,9,+1,0,+1,87%,67%,92%,117,121,116,23%,40%,19%,1,0,1,0,0,0
107,https://vlr.gg/player/22792/jiex,2024-12-01 12:45:00,0.49,0.86,0.67,127,74,181,14,3,11,26,14,12,22,14,8,-1,-1,0,71%,53%,88%,82,44,119,33%,42%,30%,1,0,1,2,1,1
108,https://vlr.gg/player/114/enzo,2024-12-01 12:45:00,0.86,1.21,1.01,199,192,244,33,17,16,37,25,12,13,6,7,0,0,0,65%,52%,85%,142,128,162,20%,23%,16%,2,0,2,2,0,2
109,https://vlr.gg/player/13258/cyvoph,2024-12-01 12:45:00,0.81,1.18,0.96,210,209,236,33,18,15,39,26,13,14,9,5,-4,-4,0,71%,69%,75%,135,127,146,22%,22%,22%,5,2,3,9,6,3
110,https://vlr.gg/player/1284/mikee,2024-12-01 12:45:00,0.54,1.14,0.78,148,133,217,29,12,17,38,26,12,3,2,1,+2,0,+2,59%,52%,70%,115,100,138,23%,27%,21%,2,0,2,0,0,0
111,https://vlr.gg/player/16321/nelo,2024-12-01 12:45:00,0.26,1.27,0.76,168,76,262,21,4,17,25,15,10,16,9,7,-5,-5,0,68%,59%,76%,106,49,162,32%,33%,32%,2,0,2,7,5,2
112,https://vlr.gg/player/257/bramz,2024-12-01 12:45:00,0.63,0.89,0.74,166,176,141,26,17,9,37,26,11,13,4,9,-9,-9,0,63%,55%,75%,102,106,95,20%,20%,19%,5,3,2,14,12,2
113,https://vlr.gg/player/30186/nami,2024-12-01 12:45:00,0.32,0.02,0.22,83,97,30,4,4,0,14,11,3,1,1,0,-1,-1,0,40%,42%,33%,66,75,30,58%,60%,50%,0,0,0,1,1,0
114,https://vlr.gg/player/4525/stix,2024-12-01 11:00:00,1.17,1.59,1.38,237,183,297,47,17,30,36,18,18,31,13,18,+2,0,+2,80%,70%,90%,163,126,201,29%,22%,34%,4,1,3,2,1,1
115,https://vlr.gg/player/30754/karma,2024-12-01 11:00:00,0.92,1.22,1.07,194,170,221,45,21,24,41,22,19,18,5,13,-1,0,-1,71%,70%,72%,121,108,133,35%,29%,40%,3,1,2,4,1,3
116,https://vlr.gg/player/22180/spmak,2024-12-01 11:00:00,1.05,0.92,0.99,193,209,170,39,22,17,40,22,18,18,6,12,+1,+1,0,63%,57%,69%,122,130,113,19%,25%,12%,11,7,4,10,6,4
117,https://vlr.gg/player/45490/ico,2024-12-01 11:00:00,0.61,1.21,0.90,220,151,294,46,16,30,47,24,23,14,6,8,+3,-3,+6,63%,57%,69%,134,89,180,21%,19%,22%,9,2,7,6,5,1
118,https://vlr.gg/player/5477/leon,2024-12-01 11:00:00,0.57,1.16,0.86,141,127,157,32,15,17,40,25,15,20,7,13,-2,-2,0,64%,57%,72%,92,73,111,23%,25%,21%,4,2,2,6,4,2
119,https://vlr.gg/player/9508/leosen,2024-12-01 11:00:00,1.31,0.91,1.11,240,280,194,49,30,19,43,22,21,13,2,11,+3,+3,0,68%,72%,63%,158,183,134,38%,31%,51%,10,5,5,7,2,5
120,https://vlr.gg/player/12528/disisjohn,2024-12-01 11:00:00,0.41,1.61,1.00,217,117,316,48,11,37,43,25,18,13,7,6,-5,-8,+3,68%,59%,77%,144,82,203,23%,24%,23%,8,2,6,13,10,3
121,https://vlr.gg/player/4629/azury,2024-12-01 11:00:00,0.77,1.17,0.98,185,163,214,41,17,24,39,23,16,6,3,3,-1,0,-1,69%,59%,80%,129,115,143,33%,35%,32%,2,1,1,3,1,2
122,https://vlr.gg/player/4969/shazeon,2024-12-01 11:00:00,0.65,1.01,0.83,176,158,190,39,19,20,46,25,21,19,7,12,+3,+1,+2,68%,48%,87%,104,91,118,28%,32%,25%,6,3,3,3,2,1
123,https://vlr.gg/player/7865/xanarchy,2024-12-01 11:00:00,0.80,0.81,0.80,146,178,123,27,16,11,38,23,15,14,6,8,-3,-3,0,71%,69%,73%,106,130,83,27%,23%,34%,2,0,2,5,3,2
124,https://vlr.gg/player/4325/musashi,2024-12-01 10:00:00,1.33,1.25,1.30,282,294,261,62,39,23,41,24,17,22,13,9,-1,-4,+3,80%,78%,84%,177,187,162,29%,29%,30%,7,4,3,8,8,0
125,https://vlr.gg/player/3753/obnoks,2024-12-01 10:00:00,1.41,0.90,1.20,250,289,196,53,35,18,44,27,17,22,17,5,+1,+6,-5,72%,81%,60%,168,194,130,19%,23%,14%,6,6,0,5,0,5
126,https://vlr.gg/player/12593/felix,2024-12-01 10:00:00,1.15,0.98,1.08,214,212,212,45,27,18,40,23,17,11,7,4,+3,+1,+2,66%,67%,64%,132,134,129,21%,23%,18%,7,3,4,4,2,2
127,https://vlr.gg/player/37969/ellie,2024-12-01 10:00:00,0.65,1.12,0.84,169,134,219,36,17,19,42,25,17,11,6,5,+2,-3,+5,74%,69%,80%,116,95,147,25%,26%,23%,9,3,6,7,6,1
128,https://vlr.gg/player/30042/harmonee,2024-12-01 10:00:00,0.33,0.44,0.37,70,67,76,15,9,6,45,28,17,11,6,5,-6,-4,-2,59%,61%,56%,44,43,45,21%,29%,13%,1,0,1,7,4,3
129,https://vlr.gg/player/20055/toki,2024-12-01 10:00:00,1.34,1.17,1.24,222,210,235,49,18,31,42,14,28,21,9,12,+3,-1,+4,69%,76%,64%,156,157,155,32%,38%,29%,6,0,6,3,1,2
130,https://vlr.gg/player/292/fit1nho,2024-12-01 10:00:00,1.34,1.17,1.24,246,276,229,54,25,29,39,17,22,10,5,5,+2,-1,+3,66%,68%,64%,152,175,137,34%,38%,30%,13,5,8,11,6,5
131,https://vlr.gg/player/5199/guardy,2024-12-01 10:00:00,1.04,1.18,1.12,232,217,245,47,18,29,47,19,28,30,11,19,+1,+1,0,75%,76%,75%,158,144,167,32%,30%,33%,6,3,3,5,2,3
132,https://vlr.gg/player/2864/ease,2024-12-01 10:00:00,1.14,0.79,0.93,171,195,156,36,19,17,40,14,26,22,8,14,-4,0,-4,67%,72%,64%,111,114,109,29%,35%,25%,3,2,1,7,2,5
133,https://vlr.gg/player/20058/devilasxa,2024-12-01 10:00:00,0.36,0.94,0.70,112,66,144,26,5,21,43,20,23,14,6,8,-1,-2,+1,70%,56%,81%,78,43,102,37%,21%,44%,3,1,2,4,3,1
134,https://vlr.gg/player/27775/techno,2024-12-01 09:20:00,1.42,1.46,1.44,239,264,215,35,20,15,20,13,7,17,8,9,-1,0,-1,79%,70%,89%,148,144,153,32%,32%,32%,5,2,3,6,2,4
135,https://vlr.gg/player/3639/hoax,2024-12-01 09:20:00,0.99,1.31,1.15,197,197,188,26,13,13,22,15,7,9,6,3,+2,0,+2,82%,80%,83%,134,136,131,33%,35%,30%,2,0,2,0,0,0
136,https://vlr.gg/player/27336/venka,2024-12-01 09:20:00,0.81,1.46,1.12,276,197,367,37,14,23,28,16,12,5,1,4,-2,-5,+3,58%,45%,72%,189,133,251,31%,32%,31%,7,2,5,9,7,2
137,https://vlr.gg/player/3627/hellff,2024-12-01 09:20:00,0.84,1.25,1.04,183,168,194,25,11,14,21,14,7,12,9,3,-3,-2,-1,68%,60%,78%,115,105,125,15%,5%,28%,0,0,0,3,2,1
138,https://vlr.gg/player/26376/deecee,2024-12-01 09:20:00,0.72,1.22,0.96,160,151,171,23,11,12,22,15,7,13,8,5,-2,-3,+1,68%,55%,83%,103,101,105,26%,26%,27%,2,1,1,4,4,0
139,https://vlr.gg/player/46056/jaggi,2024-12-01 09:20:00,1.05,1.19,1.12,226,225,232,27,13,14,30,17,13,10,3,7,+4,+1,+3,76%,72%,80%,153,139,165,33%,41%,30%,7,3,4,3,2,1
140,https://vlr.gg/player/46105/cyrax,2024-12-01 09:20:00,0.58,1.33,0.98,221,128,301,28,8,20,29,15,14,5,3,2,+4,-1,+5,68%,61%,75%,146,88,197,20%,21%,20%,7,2,5,3,3,0
141,https://vlr.gg/player/46055/ginola,2024-12-01 09:20:00,0.80,1.10,0.96,196,155,230,27,9,18,28,14,14,11,4,7,0,-2,+2,68%,56%,80%,138,105,168,27%,30%,25%,4,1,3,4,3,1
142,https://vlr.gg/player/40059/xeon,2024-12-01 09:20:00,0.41,0.96,0.70,142,95,183,20,6,14,28,15,13,1,1,0,-2,-1,-1,45%,28%,60%,96,70,119,29%,24%,34%,1,0,1,3,1,2
143,https://vlr.gg/player/24912/neko,2024-12-01 09:20:00,0.33,0.63,0.49,104,92,111,11,4,7,31,16,15,9,5,4,0,-1,+1,58%,50%,65%,71,56,85,25%,26%,24%,3,1,2,3,2,1
144,https://vlr.gg/player/5568/sociablee,2024-12-01 09:00:00,1.05,1.29,1.17,233,225,243,74,36,38,63,34,29,24,9,15,+1,-4,+5,72%,68%,75%,152,144,160,27%,30%,25%,10,1,9,9,5,4
145,https://vlr.gg/player/9780/jamppi,2024-12-01 09:00:00,1.19,1.07,1.13,200,217,180,65,35,30,53,26,27,29,13,16,-6,-2,-4,73%,80%,66%,128,140,117,36%,38%,34%,6,4,2,12,6,6
146,https://vlr.gg/player/5554/profek,2024-12-01 09:00:00,0.82,1.22,1.02,184,152,215,53,21,32,58,32,26,34,18,16,+3,+3,0,70%,64%,77%,124,104,145,18%,18%,18%,8,5,3,5,2,3
147,https://vlr.gg/player/321/chiwa,2024-12-01 09:00:00,1.12,0.87,1.00,195,192,196,61,31,30,64,30,34,23,14,9,+5,+2,+3,69%,70%,68%,134,142,126,29%,29%,29%,7,3,4,2,1,1
148,https://vlr.gg/player/20144/lewn,2024-12-01 09:00:00,0.75,1.11,0.93,209,216,200,66,34,32,64,38,26,18,9,9,+1,-3,+4,64%,52%,75%,142,144,139,34%,38%,29%,15,7,8,14,10,4
149,https://vlr.gg/player/19691/tomaszy,2024-12-01 09:00:00,1.06,1.09,1.07,208,205,210,67,33,34,62,30,32,30,11,19,-6,-4,-2,77%,75%,80%,136,139,133,35%,42%,29%,3,1,2,9,5,4
150,https://vlr.gg/player/1885/purp0,2024-12-01 09:00:00,0.97,1.16,1.06,232,226,243,72,36,36,66,35,31,12,6,6,+5,-1,+6,66%,66%,66%,148,138,158,35%,38%,33%,21,11,10,16,12,4
151,https://vlr.gg/player/34684/westside,2024-12-01 09:00:00,1.19,0.87,1.03,208,244,167,67,39,28,63,33,30,16,5,11,+3,+4,-1,72%,80%,64%,137,159,115,41%,44%,37%,8,6,2,5,2,3
152,https://vlr.gg/player/4181/cloud,2024-12-01 09:00:00,0.61,1.20,0.91,185,126,248,58,19,39,64,31,33,28,8,20,-4,-4,0,68%,66%,70%,124,84,164,27%,23%,28%,5,0,5,9,4,5
153,https://vlr.gg/player/21610/runner,2024-12-01 09:00:00,0.59,0.87,0.73,139,115,166,38,15,23,64,33,31,41,18,23,-2,-3,+1,77%,75%,80%,95,80,111,21%,15%,27%,5,0,5,7,3,4
154,https://vlr.gg/player/1770/wat,2024-12-01 07:20:00,1.21,2.07,1.84,340,203,393,43,8,35,17,5,12,20,5,15,+3,+1,+2,91%,89%,92%,223,115,264,36%,13%,44%,4,1,3,1,0,1
155,https://vlr.gg/player/46048/r0meo,2024-12-01 07:20:00,1.45,1.64,1.59,254,238,261,34,8,26,14,4,10,9,5,4,+3,0,+3,94%,100%,92%,166,162,167,16%,10%,20%,6,1,5,3,1,2
156,https://vlr.gg/player/12323/rvk,2024-12-01 07:20:00,2.36,0.88,1.28,210,342,163,23,12,11,16,2,14,19,5,14,-1,0,-1,85%,100%,79%,157,219,134,20%,24%,17%,0,0,0,1,0,1
157,https://vlr.gg/player/3502/ri0,2024-12-01 07:20:00,1.21,1.24,1.23,189,154,200,23,6,17,16,5,11,13,4,9,+4,+1,+3,85%,100%,79%,128,117,132,29%,27%,30%,7,2,5,3,1,2
158,https://vlr.gg/player/46121/marcai,2024-12-01 07:20:00,1.50,0.91,1.07,213,293,182,26,10,16,20,5,15,7,4,3,+2,+1,+1,76%,78%,75%,144,195,125,26%,20%,30%,5,2,3,3,1,2
159,https://vlr.gg/player/46058/s1mple,2024-12-01 07:20:00,1.00,0.40,0.84,181,201,131,21,17,4,29,20,9,8,6,2,+1,+2,-1,61%,63%,56%,118,129,88,46%,46%,44%,3,3,0,2,1,1
160,https://vlr.gg/player/43406/arjunn,2024-12-01 07:20:00,0.81,0.82,0.81,170,165,182,18,13,5,28,20,8,8,7,1,-4,-3,-1,61%,67%,44%,121,118,131,34%,30%,50%,5,3,2,9,6,3
161,https://vlr.gg/player/43403/silon,2024-12-01 07:20:00,0.80,0.37,0.65,179,197,134,17,14,3,30,21,9,4,2,2,0,0,0,52%,58%,33%,122,132,95,26%,29%,17%,2,2,0,2,2,0
162,https://vlr.gg/player/40060/rage,2024-12-01 07:20:00,0.41,0.60,0.46,113,104,141,13,9,4,31,22,9,5,4,1,-3,-2,-1,52%,54%,44%,72,67,88,17%,25%,11%,0,0,0,3,2,1
163,https://vlr.gg/player/43405/lavish,2024-12-01 07:20:00,0.40,0.39,0.39,131,115,177,14,9,5,31,22,9,5,4,1,-5,-5,0,52%,46%,67%,86,79,104,22%,30%,15%,1,0,1,6,5,1
164,https://vlr.gg/player/17169/muto,2024-12-01 05:15:00,1.23,1.77,1.54,315,263,351,69,25,44,41,22,19,12,3,9,+8,+1,+7,89%,77%,97%,201,160,231,34%,34%,34%,11,2,9,3,1,2
165,https://vlr.gg/player/25915/brian,2024-12-01 05:15:00,1.11,1.74,1.47,343,263,399,72,22,50,51,26,25,16,6,10,+13,+3,+10,82%,69%,91%,226,166,271,26%,27%,25%,17,6,11,4,3,1
166,https://vlr.gg/player/37390/bnn,2024-12-01 05:15:00,0.79,1.03,0.93,164,151,173,35,14,21,39,21,18,17,5,12,+1,+2,-1,77%,58%,91%,114,109,118,37%,33%,41%,3,2,1,2,0,2
167,https://vlr.gg/player/25027/icebear,2024-12-01 05:15:00,0.34,1.24,0.85,161,107,196,37,9,28,39,23,16,5,3,2,-4,-6,+2,64%,38%,83%,117,85,142,26%,28%,25%,5,1,4,9,7,2
168,https://vlr.gg/player/31841/take,2024-12-01 05:15:00,0.46,0.93,0.73,112,112,110,22,7,15,36,22,14,24,12,12,-5,-2,-3,79%,69%,86%,77,79,76,28%,33%,23%,1,1,0,6,3,3
169,https://vlr.gg/player/45962/ken,2024-12-01 05:15:00,0.96,1.35,1.13,224,216,237,47,26,21,43,30,13,18,9,9,+6,+2,+4,74%,63%,88%,144,135,155,27%,28%,26%,11,6,5,5,4,1
170,https://vlr.gg/player/1009/sakurai,2024-12-01 05:15:00,0.64,1.42,0.98,219,162,291,44,16,28,51,33,18,27,16,11,-2,-2,0,72%,69%,77%,143,103,197,25%,25%,25%,6,2,4,8,4,4
171,https://vlr.gg/player/40736/kapi,2024-12-01 05:15:00,0.79,1.13,0.94,167,144,212,39,19,20,44,29,15,19,10,9,-7,-5,-2,74%,66%,85%,116,91,149,39%,53%,30%,4,1,3,11,6,5
172,https://vlr.gg/player/6702/bazz,2024-12-01 05:15:00,0.60,1.31,0.90,195,160,238,43,17,26,48,33,15,18,10,8,-7,-5,-2,77%,74%,81%,133,113,159,29%,29%,29%,1,1,0,8,6,2
173,https://vlr.gg/player/2400/brofeld,2024-12-01 05:15:00,0.35,0.99,0.62,147,115,193,33,14,19,49,33,16,13,1,12,-3,-5,+2,61%,51%,73%,102,76,138,22%,21%,23%,2,0,2,5,5,0
174,https://vlr.gg/player/34825/han,2024-12-01 05:00:00,1.31,1.33,1.32,278,264,288,65,36,29,49,28,21,16,5,11,+2,0,+2,77%,67%,90%,183,169,200,26%,22%,30%,5,1,4,3,1,2
175,https://vlr.gg/player/29837/caspell,2024-12-01 05:00:00,0.64,1.32,0.94,209,145,296,47,16,31,55,33,22,17,11,6,+2,-1,+3,69%,58%,83%,148,100,207,31%,25%,35%,8,3,5,6,4,2
176,https://vlr.gg/player/27458/esco,2024-12-01 05:00:00,0.96,0.89,0.93,212,242,185,48,29,19,53,33,20,16,11,5,+5,-1,+6,71%,67%,76%,140,154,124,19%,23%,15%,15,9,6,10,10,0
177,https://vlr.gg/player/43066/niki,2024-12-01 05:00:00,0.61,0.90,0.74,134,117,176,30,12,18,47,29,18,18,6,12,-2,-1,-1,57%,42%,76%,100,86,118,33%,29%,37%,4,2,2,6,3,3
178,https://vlr.gg/player/49679/abu,2024-12-01 05:00:00,0.65,0.75,0.69,133,117,155,31,14,17,49,28,21,16,9,7,+2,+1,+1,60%,53%,69%,90,82,99,44%,47%,41%,5,2,3,3,1,2
179,https://vlr.gg/player/17091/zan,2024-12-01 05:00:00,1.32,1.36,1.34,242,248,242,54,26,28,42,22,20,51,18,33,-4,-4,0,78%,76%,81%,145,145,146,22%,23%,21%,6,2,4,10,6,4
180,https://vlr.gg/player/2508/kenmohororo,2024-12-01 05:00:00,1.02,1.46,1.26,255,201,286,59,20,39,44,24,20,31,18,13,+4,0,+4,82%,76%,86%,158,138,174,29%,32%,27%,6,2,4,2,2,0
181,https://vlr.gg/player/34705/e9lair,2024-12-01 05:00:00,1.19,1.04,1.11,178,187,171,43,22,21,37,17,20,24,9,15,-2,-1,-1,71%,69%,72%,122,123,121,19%,16%,21%,2,0,2,4,1,3
182,https://vlr.gg/player/49681/keisu,2024-12-01 05:00:00,0.83,1.06,0.96,221,193,236,49,20,29,50,26,24,13,6,7,-8,-5,-3,74%,72%,75%,143,120,163,25%,28%,24%,8,3,5,16,8,8
183,https://vlr.gg/player/32823/lafura,2024-12-01 05:00:00,0.57,1.19,0.91,210,138,263,48,14,34,48,25,23,13,7,6,+1,-1,+2,69%,62%,75%,140,88,183,23%,18%,25%,6,2,4,5,3,2
184,https://vlr.gg/player/10769/nobita,2024-12-01 04:50:00,1.61,1.04,1.33,264,293,236,67,39,28,48,20,28,29,18,11,+8,+5,+3,81%,86%,75%,165,184,147,17%,22%,11%,13,7,6,5,2,3
185,https://vlr.gg/player/29840/yuran,2024-12-01 04:50:00,1.47,0.87,1.17,224,268,180,58,37,21,48,19,29,16,10,6,+8,+7,+1,74%,86%,61%,148,164,132,29%,28%,32%,13,8,5,5,1,4
186,https://vlr.gg/player/48431/kippei,2024-12-01 04:50:00,1.38,0.77,1.08,186,205,168,50,28,22,49,19,30,34,24,10,0,+4,-4,74%,81%,67%,112,127,98,30%,27%,35%,4,4,0,4,0,4
187,https://vlr.gg/player/40726/gwangboong,2024-12-01 04:50:00,1.03,0.94,0.98,217,235,201,55,30,25,58,28,30,12,8,4,+1,+3,-2,65%,78%,53%,147,154,140,20%,19%,22%,8,7,1,7,4,3
188,https://vlr.gg/player/10628/misaya,2024-12-01 04:50:00,0.72,0.54,0.63,121,103,140,25,11,14,52,19,33,42,23,19,-1,-1,0,78%,78%,78%,78,68,88,19%,13%,23%,6,1,5,7,2,5
189,https://vlr.gg/player/6676/thiefy,2024-12-01 04:50:00,1.06,1.26,1.16,186,160,212,45,18,27,42,19,23,35,26,9,-3,-2,-1,75%,78%,72%,136,116,157,30%,29%,30%,1,0,1,4,2,2
190,https://vlr.gg/player/1960/eko,2024-12-01 04:50:00,1.41,0.84,1.13,254,312,196,63,40,23,55,24,31,18,8,10,-1,+4,-5,78%,83%,72%,153,184,122,17%,19%,14%,15,12,3,16,8,8
191,https://vlr.gg/player/7888/blackwiz,2024-12-01 04:50:00,1.36,0.72,1.04,201,246,157,51,32,19,52,21,31,37,26,11,-3,0,-3,76%,92%,61%,126,157,95,22%,31%,14%,1,1,0,4,1,3
192,https://vlr.gg/player/1027/marin,2024-12-01 04:50:00,1.42,0.64,1.03,213,256,171,57,38,19,51,21,30,12,6,6,-3,0,-3,71%,89%,53%,145,172,117,33%,37%,28%,7,3,4,10,3,7
193,https://vlr.gg/player/1952/esperanza,2024-12-01 04:50:00,0.79,0.50,0.64,152,162,143,39,22,17,55,25,30,14,7,7,-6,0,-6,63%,72%,53%,102,113,92,31%,40%,22%,4,3,1,10,3,7
194,https://vlr.gg/player/6672/meiy,2024-12-01 04:00:00,,,,229,,,66,,,56,,,12,,,,,,,,,,,,,,,,,,,,
195,https://vlr.gg/player/13002/akame,2024-12-01 04:00:00,,,,185,,,52,,,60,,,43,,,,,,,,,,,,,,,,,,,,
196,https://vlr.gg/player/10627/art,2024-12-01 04:00:00,,,,183,,,46,,,56,,,22,,,,,,,,,,,,,,,,,,,,
197,https://vlr.gg/player/4052/jinboong,2024-12-01 04:00:00,,,,167,,,42,,,57,,,12,,,,,,,,,,,,,,,,,,,,
198,https://vlr.gg/player/21438/ssees,2024-12-01 04:00:00,,,,149,,,39,,,55,,,28,,,,,,,,,,,,,,,,,,,,
199,https://vlr.gg/player/9801/f0rsaken,2024-12-01 04:00:00,,,,221,,,57,,,51,,,22,,,,,,,,,,,,,,,,,,,,
200,https://vlr.gg/player/9803/d4v41,2024-12-01 04:00:00,,,,209,,,59,,,48,,,36,,,,,,,,,,,,,,,,,,,,
201,https://vlr.gg/player/9800/mindfreak,2024-12-01 04:00:00,,,,200,,,58,,,46,,,37,,,,,,,,,,,,,,,,,,,,
202,https://vlr.gg/player/7378/jinggg,2024-12-01 04:00:00,,,,198,,,53,,,45,,,18,,,,,,,,,,,,,,,,,,,,
203,https://vlr.gg/player/17086/something,2024-12-01 04:00:00,,,,197,,,56,,,55,,,11,,,,,,,,,,,,,,,,,,,,
204,https://vlr.gg/player/5476/minty,2024-12-01 04:00:00,1.11,1.09,1.10,205,202,211,56,27,29,49,23,26,21,4,17,+8,+4,+4,68%,64%,73%,131,133,129,31%,28%,34%,11,5,6,3,1,2
205,https://vlr.gg/player/4663/joxjo,2024-12-01 04:00:00,1.08,1.07,1.08,208,193,220,48,23,25,48,24,24,35,17,18,+1,-1,+2,68%,64%,73%,138,133,143,22%,26%,20%,5,2,3,4,3,1
206,https://vlr.gg/player/10584/seoldam,2024-12-01 04:00:00,1.22,0.92,1.07,232,250,213,61,32,29,50,23,27,5,4,1,+2,0,+2,64%,75%,54%,150,162,138,18%,20%,16%,11,6,5,9,6,3
207,https://vlr.gg/player/29843/yatsuka,2024-12-01 04:00:00,0.79,1.26,1.03,184,149,224,46,18,28,46,24,22,22,8,14,+2,0,+2,67%,67%,68%,119,92,146,33%,50%,26%,7,2,5,5,2,3
208,https://vlr.gg/player/29841/caedye,2024-12-01 04:00:00,0.92,0.94,0.93,213,226,201,52,27,25,52,28,24,12,6,6,0,-1,+1,66%,61%,70%,143,151,135,32%,38%,26%,9,4,5,9,5,4
209,https://vlr.gg/player/33417/fukuken,2024-12-01 04:00:00,1.22,1.05,1.14,203,196,214,51,26,25,47,23,24,26,16,10,+4,+3,+1,71%,78%,64%,135,133,137,37%,30%,46%,7,4,3,3,1,2
210,https://vlr.gg/player/40734/hands,2024-12-01 04:00:00,1.01,1.19,1.10,220,201,237,54,26,28,52,28,24,18,7,11,+4,+2,+2,74%,70%,78%,147,133,161,35%,39%,31%,6,3,3,2,1,1
211,https://vlr.gg/player/49680/airy,2024-12-01 04:00:00,1.20,0.94,1.07,224,276,168,60,37,23,51,27,24,12,4,8,-5,-3,-2,63%,54%,72%,141,171,110,41%,46%,35%,5,4,1,10,7,3
212,https://vlr.gg/player/10661/phantom,2024-12-01 04:00:00,0.92,1.09,1.00,192,175,213,50,22,28,50,26,24,25,13,12,-8,-5,-3,64%,73%,56%,124,110,139,22%,20%,23%,4,0,4,12,5,7
213,https://vlr.gg/player/48430/rui,2024-12-01 04:00:00,0.35,0.56,0.43,125,102,152,30,12,18,63,32,31,13,9,4,-8,-8,0,56%,65%,47%,78,64,93,24%,17%,33%,8,2,6,16,10,6
214,https://vlr.gg/player/10760/smokea,2024-12-01 03:30:00,1.14,1.30,1.22,252,243,263,59,29,30,49,25,24,17,6,11,+3,+2,+1,71%,59%,82%,167,164,170,34%,33%,34%,10,5,5,7,3,4
215,https://vlr.gg/player/30877/lilboii,2024-12-01 03:30:00,1.08,1.21,1.15,191,185,199,49,21,28,42,21,21,23,16,7,0,0,0,84%,88%,79%,120,122,119,28%,23%,36%,4,2,2,4,2,2
216,https://vlr.gg/player/48108/mrdeagle,2024-12-01 03:30:00,0.99,0.89,0.94,180,187,175,47,25,22,48,23,25,9,7,2,-3,-3,0,66%,59%,74%,128,135,120,46%,53%,39%,4,1,3,7,4,3
217,https://vlr.gg/player/37375/chanyboi,2024-12-01 03:30:00,0.80,0.97,0.89,184,157,211,41,18,23,46,23,23,11,7,4,-2,-1,-1,71%,71%,71%,129,111,147,42%,53%,36%,4,2,2,6,3,3
218,https://vlr.gg/player/46062/hyperfiction,2024-12-01 03:30:00,0.80,0.82,0.81,186,181,191,43,21,22,52,25,27,7,3,4,+2,+2,0,63%,59%,68%,129,119,139,33%,39%,27%,12,7,5,10,5,5
219,https://vlr.gg/player/17294/hybr1d,2024-12-01 03:30:00,1.22,1.09,1.16,206,208,205,19,10,9,14,7,7,8,6,2,-2,-1,-1,74%,75%,73%,139,126,153,37%,30%,47%,0,0,0,2,1,1
220,https://vlr.gg/player/30286/karam1l,2024-12-01 03:30:00,0.89,1.42,1.16,219,159,280,51,19,32,44,22,22,14,5,9,0,-4,+4,69%,65%,74%,154,127,182,28%,28%,28%,7,1,6,7,5,2
221,https://vlr.gg/player/31355/acestarrrrr,2024-12-01 03:30:00,1.26,0.90,1.08,219,258,181,44,27,17,47,24,23,31,20,11,+4,+6,-2,72%,82%,62%,159,172,146,18%,16%,21%,7,6,1,3,0,3
222,https://vlr.gg/player/46104/envy2k,2024-12-01 03:30:00,1.01,1.06,1.04,255,285,227,42,23,19,37,20,17,5,2,3,+4,+2,+2,71%,73%,70%,156,184,129,29%,25%,36%,9,5,4,5,3,2
223,https://vlr.gg/player/5009/wstvirginia,2024-12-01 03:30:00,0.86,1.05,0.95,190,166,214,45,20,25,52,27,25,34,21,13,0,0,0,79%,76%,82%,123,110,137,32%,25%,39%,5,2,3,5,2,3
224,https://vlr.gg/player/43390/d1sease,2024-12-01 03:30:00,0.99,0.89,0.94,160,195,126,36,21,15,45,25,20,45,27,18,-6,-3,-3,71%,74%,68%,108,123,93,17%,22%,11%,6,3,3,12,6,6
225,https://vlr.gg/player/43072/jinbey,2024-12-01 02:00:00,1.34,1.61,1.50,277,246,293,39,15,24,17,7,10,11,4,7,+4,-2,+6,87%,75%,96%,162,147,173,15%,16%,14%,9,1,8,5,3,2
226,https://vlr.gg/player/25279/sakura,2024-12-01 02:00:00,1.16,1.28,1.23,253,218,259,34,13,21,24,9,15,10,4,6,0,-2,+2,72%,69%,74%,161,132,182,40%,44%,38%,3,0,3,3,2,1
227,https://vlr.gg/player/17111/allen,2024-12-01 02:00:00,1.27,1.15,1.20,175,170,178,25,9,16,18,7,11,21,12,9,-1,-1,0,85%,94%,78%,120,111,126,31%,39%,27%,0,0,0,1,1,0
228,https://vlr.gg/player/46355/jerry,2024-12-01 02:00:00,0.88,1.09,1.00,223,235,208,30,14,16,28,14,14,6,0,6,+1,+1,0,69%,69%,70%,147,143,150,43%,42%,43%,5,3,2,4,2,2
229,https://vlr.gg/player/10642/jan,2024-12-01 02:00:00,0.78,1.09,0.96,141,113,171,22,6,16,23,9,14,9,6,3,+1,+2,-1,79%,75%,83%,93,67,110,28%,28%,28%,5,3,2,4,1,3
230,https://vlr.gg/player/34760/meatpien,2024-12-01 02:00:00,0.71,1.25,0.93,222,195,255,28,14,14,34,22,12,11,9,2,+3,+2,+1,77%,74%,81%,141,110,185,38%,43%,34%,5,2,3,2,0,2
231,https://vlr.gg/player/25543/alois,2024-12-01 02:00:00,0.93,1.01,0.90,178,202,205,28,16,12,29,18,11,3,2,1,-3,-4,+1,51%,48%,56%,125,130,117,24%,22%,33%,7,4,3,10,8,2
232,https://vlr.gg/player/34779/marble,2024-12-01 02:00:00,0.85,0.77,0.82,173,189,161,23,15,8,28,17,11,3,1,2,-3,-3,0,56%,48%,69%,109,115,102,28%,34%,21%,2,1,1,5,4,1
233,https://vlr.gg/player/13008/serment,2024-12-01 02:00:00,0.50,0.87,0.65,110,89,132,15,6,9,29,18,11,10,7,3,0,-1,+1,59%,57%,63%,66,54,84,23%,28%,19%,1,0,1,1,1,0
234,https://vlr.gg/player/25544/rheify,2024-12-01 02:00:00,0.75,0.41,0.61,136,162,81,16,13,3,30,18,12,8,3,5,-2,-1,-1,56%,57%,56%,83,101,58,28%,35%,18%,2,1,1,4,2,2
235,https://vlr.gg/player/47482/flora,2024-12-01 02:00:00,1.34,1.67,1.53,282,233,312,59,20,39,38,16,22,21,9,12,+3,0,+3,81%,75%,85%,200,177,217,28%,26%,29%,8,3,5,5,3,2
236,https://vlr.gg/player/31845/chay,2024-12-01 02:00:00,1.29,1.01,1.13,208,246,180,43,22,21,37,17,20,24,12,12,+3,+2,+1,74%,79%,71%,121,142,106,21%,21%,21%,9,4,5,6,2,4
237,https://vlr.gg/player/45853/r1va,2024-12-01 02:00:00,1.00,1.20,1.11,194,182,192,37,15,22,35,17,18,25,11,14,+2,+1,+1,79%,79%,79%,133,130,135,31%,25%,37%,5,1,4,3,0,3
238,https://vlr.gg/player/45852/g4ll,2024-12-01 02:00:00,0.91,1.08,1.01,230,233,227,48,19,29,43,19,24,18,9,9,-3,-3,0,72%,75%,71%,136,135,138,11%,9%,14%,7,3,4,10,6,4
239,https://vlr.gg/player/37393/luca,2024-12-01 02:00:00,0.91,1.02,0.98,168,131,187,33,12,21,36,14,22,31,12,19,+1,-2,+3,79%,75%,82%,103,68,128,20%,12%,25%,3,0,3,2,2,0
240,https://vlr.gg/player/2671/popogachi,2024-12-01 02:00:00,1.23,0.86,1.08,260,290,221,50,32,18,44,26,18,18,13,5,-3,-3,0,72%,79%,63%,172,186,151,16%,17%,16%,4,1,3,7,4,3
241,https://vlr.gg/player/47481/frxeez,2024-12-01 02:00:00,1.22,0.81,1.05,231,267,193,50,34,16,45,26,19,11,7,4,-2,-2,0,62%,62%,63%,148,167,120,18%,22%,11%,11,6,5,13,8,5
242,https://vlr.gg/player/1971/oitan,2024-12-01 02:00:00,0.77,1.35,1.01,187,142,259,37,16,21,42,25,17,18,10,8,+1,-1,+2,69%,62%,79%,132,96,184,42%,46%,39%,6,2,4,5,3,2
243,https://vlr.gg/player/1973/ripablo,2024-12-01 02:00:00,0.61,0.88,0.72,140,129,172,27,12,15,44,27,17,21,16,5,0,0,0,60%,53%,71%,99,88,114,26%,20%,35%,3,3,0,3,3,0
244,https://vlr.gg/player/44613/yamada,2024-12-01 02:00:00,0.52,0.97,0.69,127,111,160,25,12,13,45,28,17,28,14,14,-2,-2,0,59%,59%,58%,81,69,98,22%,27%,18%,2,1,1,4,3,1
245,https://vlr.gg/player/23971/ask,2024-12-01 02:00:00,1.37,1.17,1.30,268,233,312,55,32,23,37,19,18,15,11,4,+4,+3,+1,81%,86%,71%,178,167,198,26%,25%,28%,7,4,3,3,1,2
246,https://vlr.gg/player/47467/ady,2024-12-01 02:00:00,1.40,1.07,1.28,220,221,216,41,26,15,33,16,17,33,23,10,+3,+3,0,83%,86%,76%,145,147,141,20%,20%,20%,6,4,2,3,1,2
247,https://vlr.gg/player/10658/kurozooted,2024-12-01 02:00:00,1.18,1.21,1.19,190,188,160,41,28,13,31,21,10,21,13,8,+1,+3,-2,72%,68%,81%,120,122,116,25%,21%,35%,3,3,0,2,0,2
248,https://vlr.gg/player/34785/yowamu,2024-12-01 02:00:00,1.28,0.86,1.13,274,295,202,54,39,15,45,28,17,12,7,5,+8,+8,0,79%,78%,81%,166,185,132,24%,24%,24%,17,13,4,9,5,4
249,https://vlr.gg/player/47469/scope,2024-12-01 02:00:00,0.99,0.67,0.87,133,146,121,29,20,9,33,18,15,8,5,3,0,-2,+2,64%,68%,57%,95,106,74,30%,34%,23%,4,2,2,4,4,0
250,https://vlr.gg/player/2137/skyfull,2024-12-01 02:00:00,1.67,0.71,1.06,206,344,148,41,25,16,42,14,28,21,8,13,+1,+2,-1,69%,76%,65%,141,216,99,29%,35%,22%,4,3,1,3,1,2
251,https://vlr.gg/player/17145/paint,2024-12-01 02:00:00,1.35,0.61,0.88,169,232,139,36,18,18,42,12,30,13,8,5,-2,0,-2,72%,95%,59%,107,142,87,36%,45%,29%,2,0,2,4,0,4
252,https://vlr.gg/player/10640/kurolia,2024-12-01 02:00:00,0.60,0.87,0.76,149,111,184,32,10,22,43,16,27,10,4,6,-8,-2,-6,67%,71%,65%,103,69,122,38%,24%,45%,1,0,1,9,2,7
253,https://vlr.gg/player/43019/ming,2024-12-01 02:00:00,0.82,0.71,0.75,180,176,182,34,12,22,46,15,31,8,4,4,-3,+2,-5,60%,76%,51%,121,138,111,47%,43%,50%,5,2,3,8,0,8
254,https://vlr.gg/player/40739/xui,2024-12-01 02:00:00,0.63,0.81,0.74,176,176,187,36,12,24,47,18,29,8,3,5,-4,-3,-1,59%,71%,51%,111,108,113,14%,15%,13%,9,5,4,13,8,5
255,https://vlr.gg/player/2399/fifty,2024-12-01 02:00:00,1.67,1.11,1.40,249,272,237,56,31,25,34,13,21,16,6,10,-1,0,-1,81%,87%,76%,164,181,147,28%,30%,26%,4,2,2,5,2,3
256,https://vlr.gg/player/11625/muushock,2024-12-01 02:00:00,1.20,1.29,1.24,239,235,251,53,27,26,40,18,22,31,17,14,0,0,0,85%,87%,83%,155,156,154,37%,40%,33%,6,3,3,6,3,3
257,https://vlr.gg/player/43036/whizz,2024-12-01 02:00:00,1.14,1.19,1.17,267,262,268,56,28,28,40,20,20,10,5,5,-1,-1,0,71%,70%,72%,170,170,170,30%,36%,26%,10,4,6,11,5,6
258,https://vlr.gg/player/49682/kaily,2024-12-01 02:00:00,1.04,0.92,0.98,162,181,136,35,20,15,37,18,19,26,12,14,+1,+1,0,71%,77%,66%,94,109,78,30%,28%,32%,3,2,1,2,1,1
259,https://vlr.gg/player/43041/zerurun,2024-12-01 02:00:00,0.75,1.12,0.93,173,142,207,32,14,18,38,20,18,21,8,13,-3,-2,-1,66%,60%,72%,126,95,158,18%,18%,19%,5,3,2,8,5,3
260,https://vlr.gg/player/25259/masa,2024-12-01 02:00:00,1.24,0.89,1.06,180,198,166,38,22,16,39,18,21,14,9,5,-1,+1,-2,75%,76%,73%,123,135,112,38%,39%,37%,3,2,1,4,1,3
261,https://vlr.gg/player/48346/ikura,2024-12-01 02:00:00,0.75,1.09,0.93,224,204,251,46,20,26,50,25,25,7,3,4,+7,0,+7,63%,66%,60%,160,153,166,37%,42%,33%,14,6,8,7,6,1
262,https://vlr.gg/player/40733/raysen,2024-12-01 02:00:00,0.96,0.80,0.88,186,228,153,40,25,15,45,23,22,8,5,3,-3,0,-3,68%,69%,67%,129,150,109,31%,28%,38%,6,4,2,9,4,5
263,https://vlr.gg/player/48347/mrsa,2024-12-01 02:00:00,0.61,0.79,0.70,163,148,179,33,15,18,50,24,26,12,6,6,+3,0,+3,64%,69%,60%,110,94,124,37%,39%,36%,5,1,4,2,1,1
264,https://vlr.gg/player/48348/yuu,2024-12-01 02:00:00,0.83,0.54,0.68,150,168,138,31,18,13,49,23,26,10,6,4,-2,0,-2,59%,66%,53%,112,123,101,29%,31%,27%,3,2,1,5,2,3
265,https://vlr.gg/player/8742/jakee,2024-11-30 19:20:00,0.90,1.34,1.12,213,175,252,50,21,29,47,27,20,27,11,16,-4,-7,+3,69%,65%,74%,132,99,166,18%,16%,19%,4,0,4,8,7,1
266,https://vlr.gg/player/69/thief,2024-11-30 19:20:00,0.69,1.36,1.02,217,175,262,51,22,29,50,29,21,18,4,14,-1,-5,+4,63%,53%,74%,136,104,167,35%,42%,31%,6,1,5,7,6,1
267,https://vlr.gg/player/733/stellar,2024-11-30 19:20:00,0.60,1.34,0.97,153,105,202,39,13,26,42,26,16,22,9,13,-6,-3,-3,71%,59%,82%,98,58,139,25%,29%,23%,0,0,0,6,3,3
268,https://vlr.gg/player/739/fiziq,2024-11-30 19:20:00,0.82,1.03,0.93,191,178,205,41,19,22,51,28,23,23,10,13,-1,-4,+3,72%,68%,76%,131,123,140,23%,20%,26%,7,1,6,8,5,3
269,https://vlr.gg/player/7716/penny,2024-11-30 19:20:00,0.55,0.84,0.69,162,159,163,38,17,21,50,30,20,5,4,1,-6,-3,-3,53%,44%,62%,105,99,112,18%,16%,19%,8,4,4,14,7,7
270,https://vlr.gg/player/26848/zeek,2024-11-30 19:20:00,1.10,1.45,1.27,238,204,274,60,25,35,43,25,18,23,10,13,+8,+2,+6,79%,74%,85%,144,127,161,33%,46%,24%,9,3,6,1,1,0
271,https://vlr.gg/player/873/bob,2024-11-30 19:20:00,0.98,1.46,1.22,264,250,279,63,27,36,47,29,18,15,7,8,+12,+4,+8,74%,68%,79%,163,149,178,20%,33%,13%,20,10,10,8,6,2
272,https://vlr.gg/player/16671/welyy,2024-11-30 19:20:00,0.77,1.38,1.07,183,137,230,42,15,27,41,24,17,26,11,15,+4,-2,+6,75%,65%,85%,124,96,152,25%,20%,29%,7,0,7,3,2,1
273,https://vlr.gg/player/25902/shondex,2024-11-30 19:20:00,0.73,1.04,0.88,175,158,194,43,19,24,43,24,19,13,5,8,-3,-4,+1,65%,59%,71%,115,105,125,28%,30%,26%,5,2,3,8,6,2
274,https://vlr.gg/player/11696/zoestol,2024-11-30 19:20:00,0.65,0.94,0.79,135,119,152,32,14,18,45,25,20,24,10,14,-3,-4,+1,71%,68%,74%,93,82,103,23%,25%,21%,2,0,2,5,4,1
275,https://vlr.gg/player/25858/sw,2024-11-30 18:30:00,0.67,1.98,1.42,291,156,359,43,10,33,24,14,10,8,3,5,+2,-3,+5,71%,61%,79%,167,105,214,27%,23%,29%,7,1,6,5,4,1
276,https://vlr.gg/player/41224/tkzin,2024-11-30 18:30:00,1.30,1.36,1.33,267,278,280,42,17,25,26,12,14,9,4,5,+2,+1,+1,86%,89%,83%,192,196,189,30%,29%,30%,11,5,6,9,4,5
277,https://vlr.gg/player/1578/shion,2024-11-30 18:30:00,0.61,1.46,1.10,176,127,214,26,8,18,25,14,11,20,8,12,+1,0,+1,81%,83%,79%,117,75,148,21%,30%,18%,2,1,1,1,1,0
278,https://vlr.gg/player/2486/pollo,2024-11-30 18:30:00,1.04,0.88,0.95,167,154,170,25,11,14,25,10,15,7,2,5,+4,+1,+3,71%,61%,79%,120,124,118,45%,46%,44%,4,1,3,0,0,0
279,https://vlr.gg/player/5722/prince,2024-11-30 18:30:00,1.03,0.51,0.73,139,208,98,18,12,6,29,13,16,8,4,4,-1,+1,-2,62%,67%,58%,100,135,73,20%,22%,17%,1,1,0,2,0,2
280,https://vlr.gg/player/46568/above,2024-11-30 18:30:00,0.99,1.12,1.04,187,197,178,27,15,12,28,17,11,16,6,10,+1,-1,+2,67%,63%,72%,114,120,106,41%,49%,32%,3,1,2,2,2,0
281,https://vlr.gg/player/1673/guiih9,2024-11-30 18:30:00,0.79,1.25,0.99,217,173,255,31,14,17,30,19,11,8,6,2,+1,-2,+3,62%,63%,61%,138,126,154,36%,26%,46%,4,0,4,3,2,1
282,https://vlr.gg/player/37354/basic,2024-11-30 18:30:00,0.73,1.17,0.92,162,149,209,26,13,13,30,19,11,4,1,3,+1,+1,0,60%,54%,67%,118,99,143,27%,32%,23%,2,2,0,1,1,0
283,https://vlr.gg/player/37091/peixeh,2024-11-30 18:30:00,0.66,0.89,0.76,154,159,157,22,12,10,30,19,11,5,3,2,-3,-1,-2,69%,63%,78%,99,99,99,25%,24%,26%,3,2,1,6,3,3
284,https://vlr.gg/player/37098/tiezzi,2024-11-30 18:30:00,0.48,0.87,0.65,177,151,198,23,12,11,36,22,14,8,3,5,-8,-5,-3,57%,50%,67%,113,93,139,27%,35%,20%,5,3,2,13,8,5
285,https://vlr.gg/player/6450/korsonix,2024-11-30 17:00:00,1.04,1.36,1.21,254,234,271,97,42,55,80,41,39,22,9,13,+10,+3,+7,71%,67%,74%,166,155,175,21%,21%,20%,23,10,13,13,7,6
286,https://vlr.gg/player/8792/xhowi,2024-11-30 17:00:00,1.05,0.85,0.94,192,227,166,77,41,36,82,40,42,29,14,15,-2,+1,-3,69%,71%,67%,129,153,109,41%,42%,38%,10,6,4,12,5,7
287,https://vlr.gg/player/8286/glyph,2024-11-30 17:00:00,0.87,0.98,0.93,206,180,236,79,32,47,83,37,46,32,14,18,-2,-6,+4,70%,65%,74%,145,125,163,20%,18%,21%,9,0,9,11,6,5
288,https://vlr.gg/player/17694/prask,2024-11-30 17:00:00,0.86,0.84,0.85,188,205,172,76,38,38,88,41,47,19,6,13,-5,0,-5,60%,65%,56%,119,135,106,33%,35%,31%,7,5,2,12,5,7
289,https://vlr.gg/player/586/sickly,2024-11-30 17:00:00,0.46,0.74,0.61,113,83,138,45,16,29,80,38,42,28,9,19,-6,-4,-2,56%,52%,59%,74,54,90,29%,29%,28%,5,2,3,11,6,5
290,https://vlr.gg/player/31476/mephisto,2024-11-30 17:00:00,1.05,1.31,1.17,265,267,264,107,57,50,84,47,37,24,14,10,-5,-5,0,67%,64%,71%,173,171,176,33%,33%,32%,20,12,8,25,17,8
291,https://vlr.gg/player/15931/peloncito,2024-11-30 17:00:00,1.13,1.14,1.14,216,202,240,84,43,41,78,39,39,37,18,19,+4,+3,+1,75%,72%,79%,143,134,153,40%,39%,41%,12,5,7,8,2,6
292,https://vlr.gg/player/26757/otaq,2024-11-30 17:00:00,1.06,1.19,1.12,209,194,223,77,38,39,71,38,33,61,33,28,+5,+1,+4,79%,79%,79%,127,120,136,19%,21%,16%,10,4,6,5,3,2
293,https://vlr.gg/player/10718/rowancy,2024-11-30 17:00:00,1.20,0.98,1.10,200,227,167,83,52,31,74,41,33,30,12,18,+4,-2,+6,68%,70%,65%,133,149,115,26%,28%,23%,11,5,6,7,7,0
294,https://vlr.gg/player/20809/p4nd4,2024-11-30 17:00:00,0.91,1.12,1.01,167,150,184,60,26,34,67,40,27,54,41,13,-3,+2,-5,70%,74%,65%,111,101,122,32%,26%,39%,6,4,2,9,2,7
295,https://vlr.gg/player/9094/kess,2024-11-30 16:00:00,1.09,0.85,0.97,188,206,173,31,17,14,32,15,17,12,6,6,-3,-2,-1,63%,71%,55%,123,132,114,22%,25%,19%,1,0,1,4,2,2
296,https://vlr.gg/player/48025/alym,2024-11-30 16:00:00,1.02,0.89,0.95,219,171,265,32,16,16,34,16,18,6,4,2,+2,+2,0,60%,67%,55%,146,130,162,29%,34%,25%,9,6,3,7,4,3
297,https://vlr.gg/player/10053/fireballops,2024-11-30 16:00:00,0.93,0.70,0.81,168,190,147,24,13,11,33,15,18,7,4,3,+4,+2,+2,67%,71%,64%,109,122,97,45%,48%,41%,5,2,3,1,0,1
298,https://vlr.gg/player/6445/sogo,2024-11-30 16:00:00,1.02,0.54,0.78,169,178,159,24,14,10,34,15,19,7,3,4,-1,0,-1,65%,76%,55%,118,129,107,26%,30%,23%,4,2,2,5,2,3
299,https://vlr.gg/player/62/huynh,2024-11-30 16:00:00,0.75,0.82,0.78,152,141,164,22,10,12,33,15,18,18,10,8,-3,-1,-2,63%,62%,64%,103,108,97,25%,28%,22%,2,1,1,5,2,3
300,https://vlr.gg/player/21778/p0ppin,2024-11-30 16:00:00,2.05,0.82,1.45,261,328,188,40,28,12,24,8,16,14,8,6,-1,-2,+1,77%,91%,62%,165,190,140,28%,32%,24%,3,1,2,4,3,1
301,https://vlr.gg/player/36560/canezerra,2024-11-30 16:00:00,1.62,0.91,1.28,259,316,200,39,25,14,27,12,15,14,8,6,+3,+2,+1,77%,77%,76%,182,213,150,46%,51%,40%,7,4,3,4,2,2
302,https://vlr.gg/player/35302/eggsterr,2024-11-30 16:00:00,1.21,1.09,1.15,215,243,185,32,18,14,24,13,11,13,9,4,-1,-1,0,74%,77%,71%,140,163,117,26%,20%,34%,5,2,3,6,3,3
303,https://vlr.gg/player/53/inspire,2024-11-30 16:00:00,0.61,1.28,0.94,155,100,214,24,7,17,26,14,12,7,4,3,-1,+1,-2,72%,68%,76%,100,61,141,20%,35%,16%,2,2,0,3,1,2
304,https://vlr.gg/player/41798/nightz,2024-11-30 16:00:00,0.69,0.96,0.82,197,159,240,31,12,19,33,17,16,10,6,4,+1,+2,-1,84%,82%,86%,119,96,143,48%,46%,50%,5,3,2,4,1,3
305,https://vlr.gg/player/69/thief,2024-11-30 16:00:00,1.12,1.24,1.18,225,242,210,57,29,28,46,27,19,15,5,10,-3,0,-3,72%,66%,79%,153,171,135,29%,36%,24%,5,3,2,8,3,5
306,https://vlr.gg/player/733/stellar,2024-11-30 16:00:00,1.12,0.98,1.05,167,183,151,42,24,18,41,22,19,36,12,24,-4,-1,-3,77%,77%,76%,106,110,102,24%,32%,16%,1,1,0,5,2,3
307,https://vlr.gg/player/8742/jakee,2024-11-30 16:00:00,1.07,1.01,1.04,221,249,194,54,30,24,49,27,22,19,8,11,+4,+1,+3,67%,74%,59%,135,148,121,26%,30%,22%,8,3,5,4,2,2
308,https://vlr.gg/player/739/fiziq,2024-11-30 16:00:00,0.60,1.44,1.01,193,141,252,43,15,28,45,27,18,27,14,13,+2,-1,+3,81%,69%,94%,133,107,160,18%,20%,17%,5,2,3,3,3,0
309,https://vlr.gg/player/7716/penny,2024-11-30 16:00:00,0.78,1.22,0.97,235,190,279,56,23,33,54,28,26,16,4,12,+3,-2,+5,67%,54%,79%,144,124,164,18%,16%,19%,17,7,10,14,9,5
310,https://vlr.gg/player/8397/dip,2024-11-30 16:00:00,0.65,1.61,1.13,221,138,303,53,14,39,48,27,21,22,10,12,+3,-2,+5,72%,62%,83%,154,98,208,22%,20%,23%,7,1,6,4,3,1
311,https://vlr.gg/player/8434/nabil,2024-11-30 16:00:00,1.03,1.07,1.05,208,223,195,49,25,24,49,27,22,13,6,7,+7,+3,+4,71%,65%,77%,140,146,134,29%,26%,32%,10,4,6,3,1,2
312,https://vlr.gg/player/8758/benjii,2024-11-30 16:00:00,1.10,0.93,1.01,166,172,162,43,21,22,47,23,24,27,15,12,+2,+3,-1,68%,71%,66%,98,100,97,35%,36%,33%,3,3,0,1,0,1
313,https://vlr.gg/player/21886/furbsa,2024-11-30 16:00:00,0.74,1.19,0.97,226,198,258,57,24,33,53,27,26,15,4,11,-10,-8,-2,61%,50%,71%,143,128,158,46%,57%,39%,6,2,4,16,10,6
314,https://vlr.gg/player/6437/dark3st,2024-11-30 16:00:00,0.80,0.57,0.67,155,170,141,32,19,13,56,29,27,25,12,13,-4,-2,-2,67%,71%,63%,106,112,100,25%,30%,21%,7,4,3,11,6,5
315,https://vlr.gg/player/9063/infiltrator,2024-11-30 16:00:00,1.00,1.33,1.16,249,224,277,43,21,22,35,18,17,9,6,3,-2,-4,+2,73%,72%,74%,148,136,161,26%,26%,26%,7,3,4,9,7,2
316,https://vlr.gg/player/17865/nahsie,2024-11-30 16:00:00,1.31,0.71,1.03,195,231,156,34,23,11,35,16,19,19,8,11,-1,+1,-2,79%,88%,70%,125,140,108,15%,10%,21%,1,1,0,2,0,2
317,https://vlr.gg/player/765/jerk,2024-11-30 16:00:00,0.84,1.04,0.94,164,157,173,28,13,15,34,18,16,13,8,5,-2,-2,0,73%,72%,74%,110,106,114,31%,31%,31%,1,0,1,3,2,1
318,https://vlr.gg/player/9837/flare,2024-11-30 16:00:00,0.93,0.54,0.74,158,195,124,25,15,10,37,18,19,17,11,6,+1,+1,0,67%,80%,52%,102,132,69,18%,19%,18%,4,2,2,3,1,2
319,https://vlr.gg/player/9017/moobs,2024-11-30 16:00:00,0.75,0.64,0.70,198,208,177,32,19,13,42,23,19,11,6,5,-10,-5,-5,56%,56%,57%,123,130,115,27%,35%,20%,4,2,2,14,7,7
320,https://vlr.gg/player/16671/welyy,2024-11-30 16:00:00,1.13,1.48,1.31,239,166,301,37,13,24,28,12,16,19,7,12,+1,0,+1,73%,65%,80%,162,118,202,17%,21%,15%,4,1,3,3,1,2
321,https://vlr.gg/player/873/bob,2024-11-30 16:00:00,1.32,1.22,1.27,269,315,226,48,25,23,33,16,17,7,3,4,+7,+4,+3,71%,61%,80%,173,207,141,24%,32%,15%,11,6,5,4,2,2
322,https://vlr.gg/player/25902/shondex,2024-11-30 16:00:00,1.26,1.03,1.14,213,216,207,38,20,18,32,13,19,13,2,11,+1,0,+1,75%,74%,76%,144,147,142,46%,51%,42%,5,3,2,4,3,1
323,https://vlr.gg/player/26848/zeek,2024-11-30 16:00:00,1.16,0.69,0.91,207,258,168,34,21,13,37,16,21,22,10,12,+2,+3,-1,77%,83%,72%,127,152,105,23%,27%,18%,5,4,1,3,1,2
324,https://vlr.gg/player/11696/zoestol,2024-11-30 16:00:00,0.78,0.90,0.84,172,146,193,26,11,15,32,14,18,20,7,13,+3,-2,+5,67%,52%,80%,109,99,117,16%,20%,13%,6,0,6,3,2,1
325,https://vlr.gg/player/5342/duht,2024-11-30 15:00:00,1.04,1.17,1.11,192,170,222,48,23,25,49,23,26,37,15,22,0,-1,+1,76%,70%,82%,143,122,163,26%,29%,24%,4,1,3,4,2,2
326,https://vlr.gg/player/8896/loweed,2024-11-30 15:00:00,1.29,0.86,1.07,190,212,166,50,28,22,50,23,27,34,17,17,+1,+2,-1,77%,73%,82%,129,135,123,31%,30%,32%,4,2,2,3,0,3
327,https://vlr.gg/player/1999/rnd,2024-11-30 15:00:00,0.61,1.28,0.95,213,140,282,57,17,40,55,27,28,11,6,5,-1,-4,+3,75%,76%,74%,129,90,166,16%,15%,16%,13,5,8,14,9,5
328,https://vlr.gg/player/16620/bruninej,2024-11-30 15:00:00,0.98,0.88,0.93,203,197,207,53,26,27,58,27,31,20,7,13,-2,-3,+1,68%,62%,74%,140,136,145,30%,33%,27%,11,5,6,13,8,5
329,https://vlr.gg/player/6222/ginilson,2024-11-30 15:00:00,1.08,0.66,0.87,164,210,120,42,26,16,53,26,27,18,9,9,-3,-1,-2,63%,62%,63%,113,139,88,29%,33%,25%,3,2,1,6,3,3
330,https://vlr.gg/player/3424/siduzord,2024-11-30 15:00:00,1.62,1.30,1.46,244,260,227,66,36,30,38,19,19,21,14,7,+3,+1,+2,76%,76%,76%,151,166,135,29%,27%,31%,7,2,5,4,1,3
331,https://vlr.gg/player/36433/phc,2024-11-30 15:00:00,1.40,1.15,1.28,236,265,213,65,35,30,49,25,24,31,21,10,+4,+4,0,77%,84%,70%,161,169,152,30%,28%,33%,9,7,2,5,3,2
332,https://vlr.gg/player/6202/guuih,2024-11-30 15:00:00,1.17,0.85,1.01,193,214,174,52,31,21,50,24,26,18,7,11,0,-1,+1,76%,79%,73%,126,140,112,30%,32%,27%,7,3,4,7,4,3
333,https://vlr.gg/player/1567/bezn1,2024-11-30 15:00:00,0.78,0.83,0.80,170,173,168,41,22,19,56,29,27,33,18,15,+5,+2,+3,73%,74%,73%,112,112,113,19%,29%,13%,9,4,5,4,2,2
334,https://vlr.gg/player/32675/kring,2024-11-30 15:00:00,0.41,0.93,0.65,168,126,207,41,15,26,57,33,24,12,8,4,-7,-8,+1,67%,66%,68%,113,89,137,27%,26%,28%,8,2,6,15,10,5
335,https://vlr.gg/player/3649/litshii,2024-11-30 13:00:00,0.89,1.38,1.13,195,175,212,40,18,22,40,24,16,27,14,13,+6,+3,+3,74%,80%,68%,116,97,137,19%,14%,24%,7,4,3,1,1,0
336,https://vlr.gg/player/2540/happen,2024-11-30 13:00:00,0.60,1.44,1.00,170,138,200,35,14,21,37,26,11,20,7,13,-2,-3,+1,69%,57%,82%,123,98,150,20%,18%,21%,2,0,2,4,3,1
337,https://vlr.gg/player/13238/shiio,2024-11-30 13:00:00,0.86,1.04,0.95,173,127,222,38,14,24,41,21,20,13,6,7,+3,0,+3,74%,70%,79%,113,89,138,21%,19%,23%,5,1,4,2,1,1
338,https://vlr.gg/player/47270/darkwinjett,2024-11-30 13:00:00,0.64,0.96,0.80,187,178,200,36,17,19,46,26,20,12,3,9,-3,-5,+2,64%,53%,75%,124,111,137,23%,24%,21%,10,5,5,13,10,3
339,https://vlr.gg/player/20032/treelover,2024-11-30 13:00:00,0.72,0.83,0.78,161,143,176,31,14,17,43,24,19,21,14,7,+4,+1,+3,62%,60%,64%,101,94,109,27%,21%,34%,9,3,6,5,2,3
340,https://vlr.gg/player/5292/al0rante,2024-11-30 13:00:00,0.98,1.66,1.33,240,199,281,51,19,32,33,21,12,13,7,6,0,-2,+2,83%,71%,93%,157,128,185,37%,44%,33%,5,2,3,5,4,1
341,https://vlr.gg/player/1457/mistic,2024-11-30 13:00:00,1.31,1.12,1.21,204,243,171,45,26,19,35,19,16,19,6,13,0,-1,+1,74%,71%,77%,135,165,107,46%,49%,40%,1,0,1,1,1,0
342,https://vlr.gg/player/2690/hoody,2024-11-30 13:00:00,0.85,1.18,1.02,166,159,173,31,14,17,32,19,13,30,13,17,-2,-1,-1,86%,82%,90%,107,98,116,20%,22%,19%,2,0,2,4,1,3
343,https://vlr.gg/player/2658/xuss,2024-11-30 13:00:00,0.64,1.31,0.98,214,145,282,43,12,31,40,22,18,10,6,4,-5,-6,+1,71%,64%,77%,137,100,171,21%,27%,17%,11,4,7,16,10,6
344,https://vlr.gg/player/4244/yaboilewis,2024-11-30 13:00:00,0.64,1.08,0.87,175,150,202,37,15,22,40,22,18,11,3,8,-1,-2,+1,67%,57%,77%,123,94,151,37%,48%,33%,6,2,4,7,4,3
345,https://vlr.gg/player/11494/keiko,2024-11-30 12:00:00,1.16,1.32,1.24,254,237,272,49,24,25,39,19,20,24,11,13,0,0,0,72%,74%,70%,165,155,175,38%,40%,36%,4,2,2,4,2,2
346,https://vlr.gg/player/457/nats,2024-11-30 12:00:00,1.32,0.57,0.94,188,253,122,37,26,11,37,16,21,13,8,5,-3,+2,-5,61%,70%,52%,117,150,84,22%,22%,23%,3,3,0,6,1,5
347,https://vlr.gg/player/1475/kamyk,2024-11-30 12:00:00,0.99,0.82,0.90,174,185,169,35,18,17,39,17,22,8,6,2,-1,+1,-2,70%,70%,70%,129,132,126,30%,28%,33%,1,1,0,2,0,2
348,https://vlr.gg/player/309/patitek,2024-11-30 12:00:00,0.83,0.81,0.82,165,147,184,30,14,16,39,18,21,21,12,9,-2,+1,-3,78%,85%,70%,103,83,123,24%,24%,24%,4,2,2,6,1,5
349,https://vlr.gg/player/14681/kamo,2024-11-30 12:00:00,0.98,0.55,0.77,223,277,167,37,24,13,46,22,24,10,6,4,-6,-5,-1,61%,63%,59%,145,190,100,38%,46%,25%,9,5,4,15,10,5
350,https://vlr.gg/player/4181/cloud,2024-11-30 12:00:00,1.40,1.34,1.37,236,225,250,44,21,23,34,14,20,21,11,10,+5,+2,+3,81%,85%,78%,158,154,161,21%,27%,16%,5,2,3,0,0,0
351,https://vlr.gg/player/1885/purp0,2024-11-30 12:00:00,1.19,1.40,1.30,281,264,299,52,26,26,40,20,20,9,4,5,+10,+7,+3,67%,67%,67%,184,170,199,38%,49%,29%,15,9,6,5,2,3
352,https://vlr.gg/player/21610/runner,2024-11-30 12:00:00,1.40,1.19,1.29,232,238,227,46,24,22,35,15,20,28,15,13,+5,+3,+2,83%,89%,78%,153,147,159,28%,31%,25%,8,5,3,3,2,1
353,https://vlr.gg/player/34684/westside,2024-11-30 12:00:00,1.18,0.62,0.90,162,208,116,33,21,12,36,15,21,6,2,4,-1,0,-1,67%,70%,63%,111,149,73,38%,43%,30%,5,3,2,6,3,3
354,https://vlr.gg/player/19691/tomaszy,2024-11-30 12:00:00,0.82,0.42,0.62,152,172,129,25,16,9,43,18,25,20,6,14,-7,-1,-6,63%,67%,59%,102,113,91,38%,43%,32%,0,0,0,7,1,6
355,https://vlr.gg/player/7865/xanarchy,2024-11-30 11:00:00,1.24,1.78,1.54,273,229,312,36,13,23,16,8,8,9,5,4,0,-1,+1,85%,80%,89%,169,134,197,38%,33%,41%,1,0,1,1,1,0
356,https://vlr.gg/player/9508/leosen,2024-11-30 11:00:00,1.61,1.13,1.34,258,292,226,32,17,15,22,8,14,14,5,9,+4,+1,+3,76%,73%,79%,158,175,145,29%,42%,21%,5,2,3,1,1,0
357,https://vlr.gg/player/4629/azury,2024-11-30 11:00:00,1.50,1.09,1.27,201,250,164,29,15,14,18,7,11,5,1,4,+2,+1,+1,85%,87%,84%,141,150,134,38%,41%,34%,2,1,1,0,0,0
358,https://vlr.gg/player/12528/disisjohn,2024-11-30 11:00:00,0.97,1.28,1.15,285,254,310,35,13,22,25,11,14,6,2,4,+7,+3,+4,76%,60%,89%,176,165,186,25%,39%,19%,10,4,6,3,1,2
359,https://vlr.gg/player/4969/shazeon,2024-11-30 11:00:00,0.76,0.90,0.84,166,121,194,18,5,13,23,10,13,19,10,9,+1,-1,+2,79%,67%,89%,106,84,122,32%,41%,27%,6,2,4,5,3,2
360,https://vlr.gg/player/45494/proxh,2024-11-30 11:00:00,1.16,1.02,1.09,242,265,208,25,15,10,28,17,11,20,9,11,-4,-2,-2,74%,84%,60%,159,170,144,29%,34%,24%,1,1,0,5,3,2
361,https://vlr.gg/player/33974/appa,2024-11-30 11:00:00,0.82,0.92,0.87,210,204,198,24,14,10,29,17,12,5,3,2,-3,-4,+1,68%,68%,67%,137,128,148,26%,23%,30%,4,1,3,7,5,2
362,https://vlr.gg/player/7991/hyperr,2024-11-30 11:00:00,0.83,0.84,0.83,187,176,206,22,11,11,30,16,14,19,12,7,-3,-1,-2,74%,74%,73%,118,112,124,21%,30%,13%,2,1,1,5,2,3
363,https://vlr.gg/player/22518/mimori,2024-11-30 11:00:00,0.63,0.54,0.59,143,163,115,18,12,6,32,19,13,4,3,1,-1,-1,0,62%,74%,47%,102,111,92,40%,44%,35%,1,1,0,2,2,0
364,https://vlr.gg/player/8831/noumit,2024-11-30 11:00:00,0.42,0.64,0.52,143,142,150,15,8,7,31,18,13,4,2,2,-3,-3,0,62%,63%,60%,99,100,99,13%,12%,14%,2,0,2,5,3,2
365,https://vlr.gg/player/321/chiwa,2024-11-30 08:00:00,1.41,1.12,1.25,240,280,206,59,31,28,40,20,20,22,6,16,0,0,0,79%,77%,81%,160,182,143,32%,34%,30%,6,3,3,6,3,3
366,https://vlr.gg/player/20144/lewn,2024-11-30 08:00:00,1.11,1.22,1.17,250,235,262,61,24,37,47,23,24,12,6,6,+11,+6,+5,75%,70%,78%,161,144,175,30%,31%,29%,15,8,7,4,2,2
367,https://vlr.gg/player/5568/sociablee,2024-11-30 08:00:00,0.71,1.41,1.10,227,142,285,51,15,36,43,23,20,15,4,11,-4,-6,+2,72%,63%,78%,151,100,193,22%,22%,22%,5,0,5,9,6,3
368,https://vlr.gg/player/5554/profek,2024-11-30 08:00:00,1.01,1.13,1.08,213,189,215,49,19,30,43,20,23,32,18,14,+5,0,+5,81%,77%,84%,143,136,149,22%,21%,23%,9,2,7,4,2,2
369,https://vlr.gg/player/9780/jamppi,2024-11-30 08:00:00,0.80,1.01,0.92,171,151,197,42,17,25,46,23,23,24,8,16,+1,-2,+3,75%,63%,84%,111,98,121,19%,27%,15%,5,1,4,4,3,1
370,https://vlr.gg/player/22676/ventt,2024-11-30 08:00:00,0.85,1.43,1.11,214,183,265,49,20,29,51,32,19,31,19,12,+8,+1,+7,75%,68%,83%,144,121,173,33%,28%,39%,11,4,7,3,3,0
371,https://vlr.gg/player/3557/skylen,2024-11-30 08:00:00,1.15,0.80,1.00,200,211,193,48,28,20,54,30,24,22,13,9,-7,-4,-3,70%,70%,70%,130,127,133,32%,38%,26%,1,0,1,8,4,4
372,https://vlr.gg/player/31855/celasun,2024-11-30 08:00:00,0.80,1.03,0.90,173,155,187,39,20,19,51,31,20,13,6,7,-3,-3,0,61%,54%,70%,118,104,135,32%,22%,45%,2,1,1,5,4,1
373,https://vlr.gg/player/10137/ip0tt,2024-11-30 08:00:00,0.98,0.69,0.85,177,190,153,40,24,16,53,30,23,18,12,6,0,+3,-3,72%,78%,63%,119,123,114,41%,49%,33%,6,4,2,6,1,5
374,https://vlr.gg/player/40935/umu7,2024-11-30 08:00:00,0.53,1.07,0.77,173,155,219,43,18,25,53,33,20,13,6,7,-11,-12,+1,63%,54%,73%,117,98,140,17%,13%,21%,7,2,5,18,14,4
375,https://vlr.gg/player/28401/pkm,2024-11-30 06:45:00,1.22,1.19,1.20,238,264,203,34,23,11,28,18,10,6,2,4,0,+2,-2,68%,71%,63%,177,189,160,30%,30%,28%,5,4,1,5,2,3
376,https://vlr.gg/player/985/efina,2024-11-30 06:45:00,0.80,1.12,0.92,157,156,186,22,12,10,30,19,11,11,5,6,+1,0,+1,60%,63%,56%,120,118,123,28%,36%,18%,3,1,2,2,1,1
377,https://vlr.gg/player/4827/goddead,2024-11-30 06:45:00,0.64,0.94,0.76,163,127,205,19,9,10,31,18,13,14,11,3,-2,-3,+1,75%,75%,75%,106,77,150,24%,30%,21%,1,0,1,3,3,0
378,https://vlr.gg/player/5283/bunny,2024-11-30 06:45:00,0.73,0.41,0.60,155,168,132,18,12,6,35,19,16,13,8,5,-1,-3,+2,58%,58%,56%,92,103,76,15%,20%,8%,6,2,4,7,5,2
379,https://vlr.gg/player/9783/doenmo,2024-11-30 06:45:00,0.59,0.35,0.49,122,138,85,15,11,4,34,21,13,18,11,7,-8,-6,-2,58%,63%,50%,74,86,55,18%,16%,24%,0,0,0,8,6,2
380,https://vlr.gg/player/42793/kally,2024-11-30 06:45:00,1.47,1.70,1.61,262,252,265,41,15,26,18,8,10,12,6,6,0,-1,+1,85%,81%,88%,171,156,180,33%,24%,39%,3,0,3,3,1,2
381,https://vlr.gg/player/42772/xross,2024-11-30 06:45:00,1.37,1.49,1.44,246,272,236,36,16,20,19,8,11,15,6,9,+3,-1,+4,85%,88%,83%,168,166,170,17%,11%,21%,8,3,5,5,4,1
382,https://vlr.gg/player/27444/banger,2024-11-30 06:45:00,1.20,1.20,1.20,202,172,206,29,11,18,20,7,13,15,5,10,+2,+1,+1,83%,81%,83%,128,93,151,31%,30%,31%,2,1,1,0,0,0
383,https://vlr.gg/player/25048/sid,2024-11-30 06:45:00,1.28,1.06,1.14,232,251,215,29,13,16,25,9,16,21,10,11,+2,0,+2,78%,88%,71%,161,176,151,18%,20%,18%,7,3,4,5,3,2
384,https://vlr.gg/player/24979/cloy,2024-11-30 06:45:00,0.99,0.84,0.90,182,177,188,23,8,15,26,9,17,18,12,6,+3,+1,+2,78%,94%,67%,115,103,123,27%,24%,30%,5,1,4,2,0,2
385,https://vlr.gg/player/40912/123,2024-11-30 05:45:00,1.83,1.11,1.41,277,355,204,36,21,15,22,9,13,13,6,7,+3,-1,+4,82%,81%,82%,183,241,140,30%,35%,25%,6,2,4,3,3,0
386,https://vlr.gg/player/18702/deadly10,2024-11-30 05:45:00,1.27,1.47,1.39,279,258,317,39,15,24,27,12,15,14,5,9,+2,-1,+3,84%,88%,82%,184,168,195,33%,44%,27%,9,1,8,7,2,5
387,https://vlr.gg/player/19231/kibojn,2024-11-30 05:45:00,0.74,1.73,1.31,231,150,281,34,9,25,22,12,10,18,5,13,0,-1,+1,76%,69%,82%,144,85,187,30%,47%,25%,2,1,1,2,2,0
388,https://vlr.gg/player/30575/r1sen,2024-11-30 05:45:00,1.09,1.36,1.25,208,182,218,27,10,17,19,9,10,10,2,8,+4,+2,+2,76%,81%,73%,136,109,155,31%,39%,27%,5,3,2,1,1,0
389,https://vlr.gg/player/44919/aplycs,2024-11-30 05:45:00,1.01,1.13,1.08,158,148,172,23,9,14,21,10,11,18,7,11,+1,+1,0,87%,88%,86%,117,107,124,32%,38%,30%,2,1,1,1,0,1
390,https://vlr.gg/player/46058/s1mple,2024-11-30 05:45:00,0.90,1.03,0.95,226,212,244,31,17,14,31,18,13,6,3,3,-1,-4,+3,68%,59%,81%,140,123,163,30%,40%,23%,5,1,4,6,5,1
391,https://vlr.gg/player/43406/arjunn,2024-11-30 05:45:00,0.79,0.82,0.80,151,146,160,21,11,10,31,18,13,11,7,4,+1,+1,0,68%,68%,69%,105,104,107,23%,28%,16%,2,1,1,1,0,1
392,https://vlr.gg/player/40060/rage,2024-11-30 05:45:00,0.60,1.05,0.79,180,154,226,24,11,13,33,20,13,10,7,3,-2,-2,0,63%,68%,56%,117,96,146,27%,16%,43%,1,0,1,3,2,1
393,https://vlr.gg/player/31333/gauransh,2024-11-30 05:45:00,0.70,0.44,0.59,178,179,159,20,13,7,33,19,14,7,3,4,-3,-1,-2,55%,55%,56%,118,125,108,27%,31%,21%,2,2,0,5,3,2
394,https://vlr.gg/player/43403/silon,2024-11-30 05:45:00,0.38,0.73,0.50,132,123,166,15,7,8,31,20,11,9,6,3,-5,-4,-1,53%,45%,63%,90,78,106,14%,13%,17%,4,2,2,9,6,3
395,https://vlr.gg/player/17169/muto,2024-11-30 05:35:00,0.87,1.18,1.02,232,203,270,29,13,16,29,16,13,12,6,6,-1,-1,0,71%,60%,83%,153,137,171,35%,39%,31%,2,2,0,3,3,0
396,https://vlr.gg/player/25915/brian,2024-11-30 05:35:00,0.85,1.02,0.92,195,200,201,27,14,13,31,17,14,8,3,5,-2,-1,-1,66%,65%,67%,143,131,156,41%,38%,44%,5,2,3,7,3,4
397,https://vlr.gg/player/31841/take,2024-11-30 05:35:00,0.66,0.92,0.78,133,110,159,17,7,10,27,16,11,13,9,4,+4,+2,+2,71%,65%,78%,86,62,112,32%,28%,38%,5,2,3,1,0,1
398,https://vlr.gg/player/37390/bnn,2024-11-30 05:35:00,0.70,0.74,0.72,154,166,137,21,11,10,30,17,13,5,1,4,-5,-2,-3,61%,50%,72%,100,106,93,34%,41%,28%,1,1,0,6,3,3
399,https://vlr.gg/player/25027/icebear,2024-11-30 05:35:00,0.26,1.04,0.63,174,112,240,23,8,15,32,18,14,7,3,4,-2,0,-2,58%,50%,67%,111,74,152,24%,19%,28%,3,2,1,5,2,3
400,https://vlr.gg/player/31845/chay,2024-11-30 05:35:00,1.17,1.77,1.48,248,224,266,35,15,20,19,11,8,17,5,12,-1,0,-1,82%,83%,80%,174,146,200,32%,31%,33%,2,2,0,3,2,1
401,https://vlr.gg/player/45852/g4ll,2024-11-30 05:35:00,1.18,1.29,1.24,251,259,250,34,16,18,29,15,14,8,3,5,+2,0,+2,84%,78%,90%,170,174,167,21%,19%,23%,7,3,4,5,3,2
402,https://vlr.gg/player/37393/luca,2024-11-30 05:35:00,1.05,1.15,1.11,172,170,172,24,12,12,20,11,9,14,7,7,-1,+1,-2,71%,61%,80%,118,110,125,26%,25%,28%,1,1,0,2,0,2
403,https://vlr.gg/player/45853/r1va,2024-11-30 05:35:00,0.83,1.27,1.06,200,150,244,29,11,18,25,13,12,4,2,2,+5,+2,+3,74%,61%,85%,134,87,176,35%,25%,42%,6,2,4,1,0,1
404,https://vlr.gg/player/47482/flora,2024-11-30 05:35:00,0.67,1.23,0.97,184,169,196,27,11,16,24,14,10,6,1,5,+1,+1,0,79%,72%,85%,117,110,124,30%,24%,35%,6,3,3,5,2,3
405,https://vlr.gg/player/10584/seoldam,2024-11-30 05:20:00,1.47,1.21,1.37,310,312,284,70,44,26,40,22,18,9,7,2,+2,0,+2,73%,78%,67%,170,185,148,19%,25%,11%,13,7,6,11,7,4
406,https://vlr.gg/player/29841/caedye,2024-11-30 05:20:00,1.11,1.36,1.21,258,237,273,53,30,23,41,25,16,10,7,3,+8,+4,+4,77%,75%,79%,170,160,187,33%,30%,36%,11,6,5,3,2,1
407,https://vlr.gg/player/4663/joxjo,2024-11-30 05:20:00,1.07,1.07,1.07,195,187,217,39,22,17,40,23,17,35,23,12,+7,+5,+2,78%,81%,75%,136,133,140,21%,21%,21%,7,5,2,0,0,0
408,https://vlr.gg/player/29843/yatsuka,2024-11-30 05:20:00,0.95,1.21,1.05,157,152,176,38,23,15,33,20,13,16,6,10,-3,-2,-1,82%,81%,83%,115,113,119,38%,38%,38%,1,0,1,4,2,2
409,https://vlr.gg/player/5476/minty,2024-11-30 05:20:00,1.05,0.90,0.99,190,203,163,39,25,14,42,25,17,29,15,14,0,+1,-1,78%,75%,83%,124,141,100,26%,25%,27%,5,4,1,5,3,2
410,https://vlr.gg/player/46355/jerry,2024-11-30 05:20:00,1.38,0.81,1.04,223,308,189,50,27,23,48,19,29,3,2,1,-1,-1,0,65%,79%,56%,155,194,130,41%,47%,36%,7,2,5,8,3,5
411,https://vlr.gg/player/17111/allen,2024-11-30 05:20:00,1.11,0.73,0.88,159,206,142,33,17,16,43,16,27,24,12,12,-3,+1,-4,68%,79%,61%,115,131,104,25%,20%,31%,1,1,0,4,0,4
412,https://vlr.gg/player/25279/sakura,2024-11-30 05:20:00,0.71,0.90,0.82,190,183,195,41,16,25,50,19,31,21,11,10,-4,+1,-5,68%,83%,58%,119,116,121,43%,53%,37%,3,2,1,7,1,6
413,https://vlr.gg/player/43072/jinbey,2024-11-30 05:20:00,0.46,1.01,0.79,185,134,222,38,12,26,51,22,29,10,4,6,-3,-5,+2,60%,71%,53%,117,82,141,28%,38%,24%,10,4,6,13,9,4
414,https://vlr.gg/player/10642/jan,2024-11-30 05:20:00,0.52,0.96,0.79,168,124,211,34,10,24,48,19,29,19,10,9,-3,-2,-1,65%,71%,61%,120,93,137,24%,23%,25%,2,0,2,5,2,3
415,https://vlr.gg/player/29837/caspell,2024-11-30 05:05:00,1.62,0.92,1.26,265,323,213,63,40,23,48,21,27,22,6,16,+6,+6,0,75%,79%,71%,173,203,143,26%,31%,21%,12,7,5,6,1,5
416,https://vlr.gg/player/43066/niki,2024-11-30 05:05:00,0.86,1.14,1.01,230,186,267,53,20,33,48,23,25,14,8,6,+4,+2,+2,72%,70%,74%,153,135,169,38%,37%,39%,7,4,3,3,2,1
417,https://vlr.gg/player/34825/han,2024-11-30 05:05:00,0.90,0.96,0.93,201,195,208,48,22,26,52,24,28,19,9,10,+4,+1,+3,76%,79%,74%,134,131,137,26%,29%,24%,8,3,5,4,2,2
418,https://vlr.gg/player/27458/esco,2024-11-30 05:05:00,0.80,1.04,0.92,187,189,188,46,22,24,45,24,21,7,3,4,+1,-1,+2,62%,61%,63%,125,123,127,17%,20%,14%,9,4,5,8,5,3
419,https://vlr.gg/player/49679/abu,2024-11-30 05:05:00,0.75,0.87,0.81,159,167,155,40,20,20,51,26,25,38,20,18,-1,+1,-2,75%,82%,69%,103,103,104,36%,37%,36%,5,3,2,6,2,4
420,https://vlr.gg/player/2399/fifty,2024-11-30 05:05:00,1.40,1.23,1.32,236,257,213,57,32,25,43,22,21,25,17,8,-2,-2,0,72%,80%,64%,150,155,145,20%,17%,25%,1,0,1,3,2,1
421,https://vlr.gg/player/49682/kaily,2024-11-30 05:05:00,1.00,1.19,1.09,222,195,255,54,24,30,52,25,27,21,11,10,-4,-1,-3,71%,77%,64%,141,130,153,27%,20%,34%,5,1,4,9,2,7
422,https://vlr.gg/player/11625/muushock,2024-11-30 05:05:00,1.16,1.00,1.08,189,206,178,46,26,20,47,25,22,20,12,8,-2,-1,-1,74%,80%,67%,130,137,124,34%,35%,32%,6,4,2,8,5,3
423,https://vlr.gg/player/43036/whizz,2024-11-30 05:05:00,0.98,0.74,0.87,211,227,192,51,28,23,55,27,28,11,8,3,-3,+1,-4,68%,71%,64%,136,147,126,24%,27%,20%,11,7,4,14,6,8
424,https://vlr.gg/player/43041/zerurun,2024-11-30 05:05:00,0.67,0.87,0.77,163,137,189,36,16,20,53,27,26,20,9,11,-3,-2,-1,66%,63%,70%,103,87,120,18%,14%,22%,4,3,1,7,5,2
425,https://vlr.gg/player/9801/f0rsaken,2024-11-30 04:00:00,,,,296,,,62,,,38,,,28,,,,,,,,,,,,,,,,,,,,
426,https://vlr.gg/player/17086/something,2024-11-30 04:00:00,,,,218,,,44,,,33,,,16,,,,,,,,,,,,,,,,,,,,
427,https://vlr.gg/player/9803/d4v41,2024-11-30 04:00:00,,,,206,,,47,,,34,,,31,,,,,,,,,,,,,,,,,,,,
428,https://vlr.gg/player/7378/jinggg,2024-11-30 04:00:00,,,,203,,,45,,,35,,,13,,,,,,,,,,,,,,,,,,,,
429,https://vlr.gg/player/9800/mindfreak,2024-11-30 04:00:00,,,,195,,,43,,,34,,,11,,,,,,,,,,,,,,,,,,,,
430,https://vlr.gg/player/37494/kai,2024-11-30 04:00:00,,,,216,,,43,,,49,,,12,,,,,,,,,,,,,,,,,,,,
431,https://vlr.gg/player/4712/heybay,2024-11-30 04:00:00,,,,195,,,42,,,46,,,15,,,,,,,,,,,,,,,,,,,,
432,https://vlr.gg/player/3045/luok1ng,2024-11-30 04:00:00,,,,188,,,36,,,46,,,18,,,,,,,,,,,,,,,,,,,,
433,https://vlr.gg/player/4770/fengf,2024-11-30 04:00:00,,,,151,,,27,,,51,,,18,,,,,,,,,,,,,,,,,,,,
434,https://vlr.gg/player/3021/biank,2024-11-30 04:00:00,,,,142,,,26,,,49,,,13,,,,,,,,,,,,,,,,,,,,
435,https://vlr.gg/player/10769/nobita,2024-11-30 04:00:00,0.84,1.03,0.93,178,168,189,25,10,15,31,17,14,10,5,5,0,+2,-2,59%,55%,62%,116,111,122,31%,38%,26%,3,2,1,3,0,3
436,https://vlr.gg/player/40726/gwangboong,2024-11-30 04:00:00,0.38,1.31,0.86,200,92,300,27,6,21,35,18,17,8,4,4,-8,-7,-1,59%,45%,71%,132,71,191,27%,32%,24%,3,1,2,11,8,3
437,https://vlr.gg/player/48431/kippei,2024-11-30 04:00:00,0.60,0.87,0.74,135,134,137,19,9,10,33,18,15,13,4,9,-1,-1,0,54%,40%,67%,91,90,93,24%,23%,25%,3,0,3,4,1,3
438,https://vlr.gg/player/29840/yuran,2024-11-30 04:00:00,0.56,0.81,0.69,158,171,147,21,11,10,37,20,17,9,2,7,+2,+2,0,59%,50%,67%,105,107,103,23%,23%,23%,5,3,2,3,1,2
439,https://vlr.gg/player/10628/misaya,2024-11-30 04:00:00,0.45,0.75,0.60,140,140,142,17,9,8,37,20,17,14,3,11,-2,-2,0,56%,45%,67%,97,89,105,15%,19%,13%,2,1,1,4,3,1
440,https://vlr.gg/player/47469/scope,2024-11-30 04:00:00,1.25,1.85,1.54,283,256,312,44,20,24,20,14,6,10,4,6,+6,+3,+3,90%,81%,100%,190,174,208,33%,40%,28%,6,3,3,0,0,0
441,https://vlr.gg/player/23971/ask,2024-11-30 04:00:00,1.20,1.51,1.35,239,227,257,35,17,18,21,12,9,20,9,11,+4,+1,+3,93%,86%,100%,147,139,156,19%,12%,25%,5,1,4,1,0,1
442,https://vlr.gg/player/47467/ady,2024-11-30 04:00:00,1.00,1.62,1.30,205,141,274,34,12,22,20,11,9,23,13,10,+1,-1,+2,85%,76%,95%,119,98,141,22%,22%,23%,2,0,2,1,1,0
443,https://vlr.gg/player/34785/yowamu,2024-11-30 04:00:00,1.19,1.36,1.27,272,282,262,42,22,20,23,14,9,6,2,4,+1,+2,-1,78%,76%,80%,180,175,184,32%,27%,38%,11,7,4,10,5,5
444,https://vlr.gg/player/10658/kurozooted,2024-11-30 04:00:00,0.77,0.79,0.78,126,125,127,18,9,9,25,13,12,21,7,14,-3,-2,-1,83%,90%,75%,84,81,86,19%,17%,23%,1,1,0,4,3,1
445,https://vlr.gg/player/13221/azys,2024-11-30 03:30:00,1.61,1.92,1.79,356,337,372,45,19,26,21,8,13,7,2,5,+7,+1,+6,83%,80%,85%,241,218,257,30%,26%,34%,9,3,6,2,2,0
446,https://vlr.gg/player/18704/levi,2024-11-30 03:30:00,1.81,1.06,1.38,239,260,218,32,15,17,18,4,14,11,8,3,+1,0,+1,74%,80%,70%,145,162,132,32%,31%,33%,3,1,2,2,1,1
447,https://vlr.gg/player/3269/antidote,2024-11-30 03:30:00,1.54,1.10,1.29,205,265,157,27,15,12,16,7,9,16,10,6,+1,+2,-1,83%,87%,80%,126,162,99,20%,21%,20%,2,2,0,1,0,1
448,https://vlr.gg/player/3628/deathmaker,2024-11-30 03:30:00,1.27,1.11,1.18,216,205,231,29,12,17,19,6,13,6,1,5,-2,0,-2,71%,80%,65%,149,138,157,35%,40%,33%,2,1,1,4,1,3
449,https://vlr.gg/player/12947/rawfiul,2024-11-30 03:30:00,0.91,1.11,1.03,207,158,241,26,9,17,20,8,12,5,2,3,+4,0,+4,86%,93%,80%,134,106,155,32%,33%,31%,7,2,5,3,2,1
450,https://vlr.gg/player/46056/jaggi,2024-11-30 03:30:00,1.33,0.64,1.04,259,305,166,30,21,9,32,18,14,6,4,2,+1,+1,0,66%,85%,40%,154,190,106,43%,43%,42%,4,2,2,3,1,2
451,https://vlr.gg/player/46055/ginola,2024-11-30 03:30:00,1.37,0.49,0.85,224,305,171,13,8,5,18,6,12,3,1,2,+5,+2,+3,55%,75%,42%,140,170,121,20%,20%,19%,6,2,4,1,0,1
452,https://vlr.gg/player/24912/neko,2024-11-30 03:30:00,0.70,0.58,0.65,125,152,94,17,12,5,30,17,13,5,3,2,-5,-2,-3,51%,50%,53%,94,108,74,46%,55%,31%,0,0,0,5,2,3
453,https://vlr.gg/player/40059/xeon,2024-11-30 03:30:00,0.62,0.49,0.52,129,152,101,16,11,5,31,17,14,2,2,0,-8,-6,-2,40%,45%,33%,87,98,71,45%,55%,31%,1,1,0,9,7,2
454,https://vlr.gg/player/46105/cyrax,2024-11-30 03:30:00,0.43,0.57,0.49,152,153,152,16,9,7,33,19,14,7,4,3,-3,-2,-1,54%,50%,60%,107,107,108,17%,16%,18%,1,1,0,4,3,1
455,https://vlr.gg/player/47783/shera,2024-11-30 03:30:00,0.02,0.57,0.04,64,25,220,2,0,2,15,12,3,3,3,0,-1,-1,0,40%,33%,67%,45,23,133,17%,0%,27%,0,0,0,1,1,0
456,https://vlr.gg/player/4038/bangnan,2024-11-30 03:00:00,1.48,0.99,1.25,253,289,224,61,38,23,45,23,22,14,6,8,+5,+4,+1,73%,74%,71%,157,169,143,29%,36%,22%,10,6,4,5,2,3
457,https://vlr.gg/player/34727/kayle,2024-11-30 03:00:00,1.40,0.80,1.12,233,265,193,52,34,18,48,24,24,30,13,17,+8,+6,+2,82%,77%,87%,152,177,124,21%,26%,16%,11,7,4,3,1,2
458,https://vlr.gg/player/13000/redlight,2024-11-30 03:00:00,0.75,1.07,0.90,187,164,217,45,19,26,51,29,22,31,16,15,-1,0,-1,71%,69%,74%,122,106,140,21%,14%,29%,3,2,1,4,2,2
459,https://vlr.gg/player/40279/ngen,2024-11-30 03:00:00,0.67,1.06,0.86,176,134,215,37,14,23,46,26,20,22,15,7,-1,-1,0,68%,69%,68%,118,91,149,23%,22%,24%,2,1,1,3,2,1
460,https://vlr.gg/player/38369/only1,2024-11-30 03:00:00,0.50,1.04,0.76,191,166,242,44,18,26,55,31,24,20,12,8,-5,-6,+1,68%,66%,71%,129,118,143,14%,13%,15%,10,3,7,15,9,6
461,https://vlr.gg/player/4426/klaus,2024-11-30 03:00:00,1.27,1.30,1.28,259,234,257,58,25,33,44,22,22,19,13,6,+2,+3,-1,74%,74%,74%,168,153,182,35%,34%,36%,7,5,2,5,2,3
462,https://vlr.gg/player/37532/zexy,2024-11-30 03:00:00,1.24,1.00,1.11,274,307,245,61,33,28,55,26,29,18,8,10,-4,0,-4,68%,71%,66%,176,198,157,25%,26%,23%,9,5,4,13,5,8
463,https://vlr.gg/player/42733/xuna,2024-11-30 03:00:00,0.90,1.10,1.00,195,171,229,47,20,27,46,21,25,14,5,9,+1,-1,+2,71%,61%,80%,133,114,149,33%,34%,32%,5,2,3,4,3,1
464,https://vlr.gg/player/2149/c1nder,2024-11-30 03:00:00,1.12,0.81,0.95,179,201,147,39,23,16,46,21,25,32,13,19,-3,-3,0,73%,84%,63%,109,125,95,32%,40%,25%,3,1,2,6,4,2
465,https://vlr.gg/player/34926/oonzmlp,2024-11-30 03:00:00,0.50,1.21,0.87,171,127,219,39,11,28,49,27,22,27,11,16,-2,-2,0,64%,65%,63%,109,84,132,19%,12%,25%,6,1,5,8,3,5
466,https://vlr.gg/player/10661/phantom,2024-11-30 02:00:00,1.51,0.73,1.16,226,301,156,55,41,14,50,26,24,38,25,13,+1,+1,0,77%,90%,61%,163,204,111,26%,27%,25%,5,2,3,4,1,3
467,https://vlr.gg/player/40734/hands,2024-11-30 02:00:00,1.17,0.97,1.08,257,241,202,56,35,21,49,27,22,16,8,8,+7,+1,+6,74%,77%,71%,141,152,128,34%,37%,29%,10,4,6,3,3,0
468,https://vlr.gg/player/48430/rui,2024-11-30 02:00:00,0.85,1.35,1.07,249,231,260,61,32,29,48,31,17,11,6,5,+2,+3,-1,71%,72%,71%,148,140,158,34%,30%,39%,15,11,4,13,8,5
469,https://vlr.gg/player/49680/airy,2024-11-30 02:00:00,0.86,1.00,0.92,178,157,194,46,23,23,46,27,19,11,8,3,-2,-1,-1,71%,74%,68%,115,95,140,40%,42%,38%,4,2,2,6,3,3
470,https://vlr.gg/player/33417/fukuken,2024-11-30 02:00:00,0.80,1.08,0.92,148,126,199,38,15,23,48,27,21,38,29,9,-4,-3,-1,70%,77%,61%,111,89,140,24%,24%,25%,3,1,2,7,4,3
471,https://vlr.gg/player/13008/serment,2024-11-30 02:00:00,0.99,1.48,1.26,229,177,281,56,16,40,48,22,26,32,21,11,+5,+1,+4,79%,77%,79%,153,113,185,32%,31%,33%,10,3,7,5,2,3
472,https://vlr.gg/player/34760/meatpien,2024-11-30 02:00:00,1.25,0.90,1.05,196,257,177,49,27,22,51,23,28,34,12,22,-7,-1,-6,69%,68%,69%,138,155,125,28%,38%,21%,4,3,1,11,4,7
473,https://vlr.gg/player/25543/alois,2024-11-30 02:00:00,1.14,0.90,1.01,229,253,221,56,27,29,57,23,34,15,4,11,+4,+4,0,66%,68%,64%,153,160,148,27%,31%,24%,13,7,6,9,3,6
474,https://vlr.gg/player/25544/rheify,2024-11-30 02:00:00,1.01,1.03,1.00,196,185,205,48,21,27,49,21,28,18,11,7,+1,-1,+2,67%,68%,67%,130,127,133,36%,45%,30%,3,1,2,2,2,0
475,https://vlr.gg/player/34779/marble,2024-11-30 02:00:00,0.62,0.68,0.66,109,105,139,32,12,20,52,22,30,17,7,10,-7,-6,-1,66%,65%,67%,81,68,92,26%,24%,28%,3,0,3,10,6,4
476,https://vlr.gg/player/1009/sakurai,2024-11-30 02:00:00,0.89,1.26,1.08,198,169,225,52,22,30,51,29,22,21,9,12,0,-2,+2,64%,56%,71%,128,100,153,28%,26%,29%,6,2,4,6,4,2
477,https://vlr.gg/player/2400/brofeld,2024-11-30 02:00:00,0.60,1.33,0.98,178,161,198,46,17,29,47,30,17,12,5,7,+1,-3,+4,71%,59%,82%,119,107,129,26%,30%,23%,7,3,4,6,6,0
478,https://vlr.gg/player/6702/bazz,2024-11-30 02:00:00,0.97,0.98,0.98,222,198,244,55,23,32,52,26,26,26,12,14,-2,-3,+1,75%,71%,79%,143,134,151,23%,26%,22%,6,2,4,8,5,3
479,https://vlr.gg/player/45962/ken,2024-11-30 02:00:00,0.54,1.34,0.97,207,153,256,48,17,31,54,31,23,22,7,15,0,-7,+7,64%,44%,82%,139,102,172,18%,28%,13%,15,2,13,15,9,6
480,https://vlr.gg/player/40736/kapi,2024-11-30 02:00:00,0.75,1.10,0.94,186,141,220,46,15,31,53,28,25,27,14,13,+1,+1,0,71%,65%,76%,121,89,149,31%,30%,31%,2,1,1,1,0,1
481,https://vlr.gg/player/44613/yamada,2024-11-30 02:00:00,0.89,1.60,1.23,226,175,286,62,24,38,45,28,17,31,13,18,0,-1,+1,74%,61%,88%,148,113,188,24%,25%,24%,4,2,2,4,3,1
482,https://vlr.gg/player/2671/popogachi,2024-11-30 02:00:00,0.98,1.46,1.21,254,209,306,59,26,33,49,30,19,26,9,17,+1,-4,+5,71%,61%,82%,168,149,190,26%,27%,25%,8,0,8,7,4,3
483,https://vlr.gg/player/1971/oitan,2024-11-30 02:00:00,0.72,1.33,1.00,164,144,195,48,21,27,47,32,15,13,7,6,-1,-2,+1,74%,66%,82%,122,104,142,30%,32%,29%,3,1,2,4,3,1
484,https://vlr.gg/player/1973/ripablo,2024-11-30 02:00:00,0.96,0.97,0.96,176,186,164,44,25,19,47,29,18,25,9,16,+3,0,+3,74%,66%,82%,106,116,95,21%,20%,23%,7,3,4,4,3,1
485,https://vlr.gg/player/47481/frxeez,2024-11-30 02:00:00,0.53,0.98,0.74,182,153,216,44,17,27,59,34,25,15,9,6,-3,-7,+4,60%,50%,71%,118,102,136,25%,25%,25%,14,6,8,17,13,4
486,https://vlr.gg/player/1027/marin,2024-11-30 02:00:00,1.68,1.44,1.60,302,313,244,40,29,11,20,13,7,8,4,4,0,0,0,79%,79%,79%,213,233,179,40%,40%,39%,4,3,1,4,3,1
487,https://vlr.gg/player/7888/blackwiz,2024-11-30 02:00:00,1.45,0.91,1.25,231,264,175,34,24,10,24,16,8,14,13,1,+1,+2,-1,79%,79%,79%,148,163,123,36%,31%,48%,4,4,0,3,2,1
488,https://vlr.gg/player/1952/esperanza,2024-11-30 02:00:00,1.09,1.43,1.22,223,203,297,34,19,15,24,16,8,5,5,0,+5,+1,+4,84%,83%,86%,140,127,162,35%,43%,20%,8,3,5,3,2,1
489,https://vlr.gg/player/1960/eko,2024-11-30 02:00:00,1.30,1.07,1.21,308,298,282,35,23,12,27,17,10,15,11,4,+1,+3,-2,79%,83%,71%,198,207,184,17%,17%,15%,4,3,1,3,0,3
490,https://vlr.gg/player/6676/thiefy,2024-11-30 02:00:00,1.12,1.21,1.16,148,142,179,21,13,8,20,12,8,27,13,14,+1,0,+1,92%,96%,86%,101,96,109,29%,21%,47%,3,2,1,2,2,0
491,https://vlr.gg/player/17145/paint,2024-11-30 02:00:00,1.11,0.81,0.92,195,218,193,25,9,16,30,10,20,10,7,3,-1,-1,0,76%,86%,71%,121,138,111,30%,39%,25%,2,0,2,3,1,2
492,https://vlr.gg/player/2137/skyfull,2024-11-30 02:00:00,0.94,0.72,0.80,168,131,193,21,7,14,30,9,21,12,3,9,-3,-1,-2,63%,57%,67%,111,86,125,15%,33%,11%,3,1,2,6,2,4
493,https://vlr.gg/player/10640/kurolia,2024-11-30 02:00:00,0.78,0.78,0.78,173,187,174,25,10,15,34,13,21,10,3,7,-5,-1,-4,61%,64%,58%,121,118,123,41%,32%,46%,1,0,1,6,1,5
494,https://vlr.gg/player/43019/ming,2024-11-30 02:00:00,0.53,0.69,0.61,148,71,198,19,3,16,32,10,22,8,6,2,0,-2,+2,53%,50%,54%,97,43,129,38%,30%,39%,3,1,2,3,3,0
495,https://vlr.gg/player/40739/xui,2024-11-30 02:00:00,0.78,0.44,0.57,177,245,163,25,12,13,38,14,24,6,2,4,+1,+3,-2,55%,57%,54%,128,160,110,45%,56%,36%,6,4,2,5,1,4
496,https://vlr.gg/player/2508/kenmohororo,2024-11-30 02:00:00,1.20,1.30,1.25,237,220,255,48,22,26,42,19,23,25,10,15,-1,-3,+2,77%,72%,81%,153,133,172,30%,33%,27%,3,0,3,4,3,1
497,https://vlr.gg/player/17091/zan,2024-11-30 02:00:00,0.65,1.57,1.13,234,151,305,48,14,34,47,25,22,24,13,11,+4,0,+4,68%,62%,74%,151,104,194,24%,20%,26%,8,2,6,4,2,2
498,https://vlr.gg/player/32823/lafura,2024-11-30 02:00:00,1.25,0.80,1.01,190,234,159,41,25,16,42,20,22,13,4,9,-1,-1,0,58%,59%,58%,138,160,117,31%,38%,25%,4,3,1,5,4,1
499,https://vlr.gg/player/34705/e9lair,2024-11-30 02:00:00,0.86,0.97,0.92,178,167,186,36,15,21,44,22,22,19,11,8,+2,0,+2,63%,48%,77%,116,109,122,22%,27%,19%,6,3,3,4,3,1
500,https://vlr.gg/player/49681/keisu,2024-11-30 02:00:00,0.85,0.49,0.66,148,193,114,33,20,13,46,23,23,13,7,6,-8,-1,-7,48%,52%,45%,99,120,79,26%,23%,33%,7,4,3,15,5,10
501,https://vlr.gg/player/48346/ikura,2024-11-30 02:00:00,1.25,1.43,1.33,335,338,329,68,35,33,49,28,21,12,9,3,+9,+4,+5,82%,81%,83%,207,207,207,48%,49%,48%,14,8,6,5,4,1
502,https://vlr.gg/player/48347/mrsa,2024-11-30 02:00:00,1.29,0.87,1.09,206,229,169,42,26,16,38,19,19,12,8,4,-1,-1,0,75%,77%,72%,136,159,112,22%,30%,14%,3,1,2,4,2,2
503,https://vlr.gg/player/48348/yuu,2024-11-30 02:00:00,0.79,1.05,0.91,179,152,216,41,17,24,41,21,20,16,8,8,-1,-2,+1,75%,77%,72%,125,108,143,36%,43%,31%,4,1,3,5,3,2
504,https://vlr.gg/player/25259/masa,2024-11-30 02:00:00,0.96,0.75,0.86,157,187,132,35,21,14,39,21,18,14,5,9,-2,+1,-3,73%,74%,72%,100,119,79,29%,32%,24%,5,3,2,7,2,5
505,https://vlr.gg/player/40733/raysen,2024-11-30 02:00:00,0.65,1.01,0.82,169,138,206,35,14,21,42,23,19,19,11,8,-1,-3,+2,75%,77%,72%,113,89,139,31%,31%,31%,6,2,4,7,5,2
0,https://vlr.gg/player/7618/theory,2024-11-29 19:50:00,1.46,1.11,1.33,274,295,205,33,24,9,28,20,8,5,4,1,-2,-2,0,62%,58%,69%,176,192,146,40%,43%,33%,1,1,0,3,3,0
1,https://vlr.gg/player/12955/danger,2024-11-29 19:50:00,0.58,1.25,0.82,176,164,203,23,13,10,31,23,8,12,7,5,+1,0,+1,59%,50%,77%,116,101,143,25%,26%,24%,2,0,2,1,0,1
2,https://vlr.gg/player/35583/edu,2024-11-29 19:50:00,0.92,0.24,0.68,143,188,58,16,14,2,32,21,11,12,9,3,-3,-1,-2,62%,63%,62%,96,129,35,33%,37%,14%,0,0,0,3,1,2
3,https://vlr.gg/player/8057/josegxbo,2024-11-29 19:50:00,0.42,1.10,0.66,147,116,204,19,10,9,30,21,9,9,4,5,-2,-2,0,62%,50%,85%,94,80,120,33%,35%,32%,2,1,1,4,3,1
4,https://vlr.gg/player/38921/fotzy,2024-11-29 19:50:00,0.23,1.31,0.61,170,91,337,21,6,15,34,24,10,7,5,2,-7,-9,+2,65%,58%,77%,120,70,211,41%,42%,41%,7,3,4,14,12,2
5,https://vlr.gg/player/31476/mephisto,2024-11-29 19:50:00,1.09,1.91,1.62,321,235,369,46,11,35,21,9,12,10,5,5,+3,-2,+5,81%,69%,88%,209,165,232,27%,35%,24%,11,3,8,8,5,3
6,https://vlr.gg/player/10718/rowancy,2024-11-29 19:50:00,1.41,1.47,1.45,257,199,283,33,10,23,20,6,14,16,2,14,+3,+1,+2,81%,69%,88%,168,129,189,23%,18%,25%,4,2,2,1,1,0
7,https://vlr.gg/player/20809/p4nd4,2024-11-29 19:50:00,0.87,1.36,1.19,214,158,236,27,5,22,22,10,12,25,15,10,+2,0,+2,84%,69%,92%,124,111,131,25%,21%,27%,4,1,3,2,1,1
8,https://vlr.gg/player/26757/otaq,2024-11-29 19:50:00,0.94,1.29,1.17,217,174,231,26,8,18,26,11,15,37,11,26,+4,0,+4,86%,77%,92%,128,87,150,20%,31%,18%,4,0,4,0,0,0
9,https://vlr.gg/player/15931/peloncito,2024-11-29 19:50:00,1.17,0.75,0.90,173,248,139,23,12,11,23,9,14,15,7,8,+1,0,+1,76%,77%,75%,136,182,111,31%,36%,27%,2,0,2,1,0,1
10,https://vlr.gg/player/9063/infiltrator,2024-11-29 19:30:00,0.80,1.49,1.15,253,188,316,42,16,26,34,20,14,3,0,3,+2,-3,+5,62%,52%,71%,152,113,189,27%,32%,22%,10,3,7,8,6,2
11,https://vlr.gg/player/765/jerk,2024-11-29 19:30:00,0.90,1.25,1.08,174,159,188,28,11,17,27,16,11,16,5,11,-4,-3,-1,68%,52%,83%,114,113,114,22%,17%,27%,1,0,1,5,3,2
12,https://vlr.gg/player/9837/flare,2024-11-29 19:30:00,0.65,1.13,0.89,173,144,202,29,11,18,34,21,13,12,6,6,+2,+1,+1,70%,61%,79%,117,96,136,25%,29%,23%,2,1,1,0,0,0
13,https://vlr.gg/player/9017/moobs,2024-11-29 19:30:00,0.69,0.91,0.80,177,166,188,29,13,16,39,21,18,11,2,9,-3,-6,+3,66%,52%,79%,118,111,124,34%,37%,32%,4,0,4,7,6,1
14,https://vlr.gg/player/17865/nahsie,2024-11-29 19:30:00,0.57,0.98,0.78,164,147,179,25,10,15,35,21,14,16,8,8,-4,-4,0,64%,65%,63%,107,103,111,28%,28%,29%,3,0,3,7,4,3
15,https://vlr.gg/player/10053/fireballops,2024-11-29 19:30:00,0.84,1.46,1.15,236,171,305,38,15,23,34,19,15,20,7,13,+1,-2,+3,81%,67%,96%,155,109,203,35%,37%,34%,4,1,3,3,3,0
16,https://vlr.gg/player/6445/sogo,2024-11-29 19:30:00,1.25,1.02,1.14,213,233,191,35,20,15,30,18,12,10,4,6,+4,+1,+3,70%,71%,70%,139,156,122,33%,31%,35%,5,2,3,1,1,0
17,https://vlr.gg/player/48025/alym,2024-11-29 19:30:00,0.39,1.88,1.12,232,132,335,41,10,31,29,20,9,5,3,2,+1,-5,+6,70%,58%,83%,138,80,198,28%,26%,29%,12,3,9,11,8,3
18,https://vlr.gg/player/9094/kess,2024-11-29 19:30:00,0.98,1.12,1.05,197,193,204,30,13,17,30,17,13,22,13,9,+1,-2,+3,74%,67%,83%,137,135,140,23%,21%,25%,3,0,3,2,2,0
19,https://vlr.gg/player/62/huynh,2024-11-29 19:30:00,0.76,0.97,0.86,147,138,156,25,12,13,30,18,12,24,10,14,0,0,0,70%,58%,83%,84,72,96,17%,18%,16%,3,2,1,3,2,1
20,https://vlr.gg/player/7716/penny,2024-11-29 19:30:00,1.00,0.84,0.95,197,214,159,35,27,8,41,28,13,12,6,6,-5,-1,-4,70%,75%,61%,129,138,111,15%,18%,9%,6,6,0,11,7,4
21,https://vlr.gg/player/8742/jakee,2024-11-29 19:30:00,0.97,0.87,0.93,179,182,181,33,22,11,41,27,14,21,15,6,0,-1,+1,65%,64%,67%,111,112,108,21%,25%,15%,8,4,4,8,5,3
22,https://vlr.gg/player/69/thief,2024-11-29 19:30:00,0.82,1.11,0.92,168,157,217,35,21,14,40,27,13,15,11,4,0,+1,-1,65%,61%,72%,114,100,141,26%,21%,35%,3,3,0,3,2,1
23,https://vlr.gg/player/739/fiziq,2024-11-29 19:30:00,0.88,0.86,0.87,171,162,211,34,23,11,41,28,13,9,6,3,-3,-5,+2,56%,58%,50%,117,121,109,21%,24%,16%,3,1,2,6,6,0
24,https://vlr.gg/player/733/stellar,2024-11-29 19:30:00,0.87,0.60,0.76,157,180,127,28,21,7,42,28,14,15,10,5,-4,-2,-2,63%,69%,50%,114,128,87,22%,19%,33%,1,0,1,5,2,3
25,https://vlr.gg/player/53/inspire,2024-11-29 19:30:00,1.46,1.28,1.34,219,251,202,42,16,26,27,8,19,20,4,16,+1,-1,+2,81%,72%,86%,138,161,127,31%,38%,27%,4,1,3,3,2,1
26,https://vlr.gg/player/36560/canezerra,2024-11-29 19:30:00,1.23,1.31,1.28,315,291,318,57,17,40,36,11,25,13,4,9,+6,+3,+3,70%,83%,64%,204,191,211,37%,39%,37%,11,4,7,5,1,4
27,https://vlr.gg/player/21778/p0ppin,2024-11-29 19:30:00,1.01,1.08,1.05,191,133,209,37,11,26,31,9,22,15,4,11,-1,-1,0,67%,61%,69%,126,86,146,22%,15%,24%,2,0,2,3,1,2
28,https://vlr.gg/player/35302/eggsterr,2024-11-29 19:30:00,1.08,0.93,0.98,160,174,147,32,12,20,30,10,20,18,10,8,-3,-1,-2,67%,61%,69%,100,95,102,23%,34%,19%,5,2,3,8,3,5
29,https://vlr.gg/player/41798/nightz,2024-11-29 19:30:00,1.04,0.92,0.96,189,180,192,37,11,26,41,13,28,20,12,8,+9,+4,+5,67%,72%,64%,115,97,124,38%,36%,39%,11,4,7,2,0,2
30,https://vlr.gg/player/1023/xxif,2024-11-29 19:30:00,1.24,0.90,1.08,191,227,155,30,18,12,28,15,13,10,6,4,+4,+4,0,74%,73%,76%,120,133,106,33%,39%,26%,5,4,1,1,0,1
31,https://vlr.gg/player/3007/tdawgg,2024-11-29 19:30:00,0.98,0.87,0.93,193,211,173,27,15,12,34,18,16,20,13,7,+1,+1,0,79%,91%,67%,133,145,120,28%,26%,31%,2,1,1,1,0,1
32,https://vlr.gg/player/3702/sym,2024-11-29 19:30:00,0.79,1.06,0.92,229,194,267,33,14,19,37,18,19,10,6,4,+1,-3,+4,74%,73%,76%,147,131,165,26%,26%,26%,14,6,8,13,9,4
33,https://vlr.gg/player/8376/seven,2024-11-29 19:30:00,0.62,1.08,0.85,187,160,215,26,11,15,33,17,16,12,6,6,-1,-1,0,70%,64%,76%,128,107,150,29%,26%,31%,0,0,0,1,1,0
34,https://vlr.gg/player/64/gmd,2024-11-29 19:30:00,0.70,0.71,0.70,126,107,146,20,10,10,33,16,17,9,5,4,+2,-1,+3,67%,77%,57%,81,66,96,35%,33%,37%,4,0,4,2,1,1
35,https://vlr.gg/player/16671/welyy,2024-11-29 19:30:00,1.72,1.25,1.48,255,295,218,39,22,17,21,9,12,12,5,7,+1,0,+1,72%,76%,68%,166,189,145,25%,23%,27%,5,2,3,4,2,2
36,https://vlr.gg/player/26848/zeek,2024-11-29 19:30:00,0.72,1.52,1.13,249,180,315,40,14,26,31,17,14,9,6,3,-2,-1,-1,77%,71%,82%,155,112,195,39%,40%,39%,5,1,4,7,2,5
37,https://vlr.gg/player/873/bob,2024-11-29 19:30:00,1.10,1.04,1.07,224,234,216,35,19,16,30,14,16,14,6,8,-3,-2,-1,72%,76%,68%,158,155,162,27%,19%,37%,3,2,1,6,4,2
38,https://vlr.gg/player/11696/zoestol,2024-11-29 19:30:00,1.19,0.94,1.06,185,210,161,30,16,14,26,13,13,16,10,6,-2,-2,0,72%,76%,68%,118,140,97,26%,28%,24%,3,1,2,5,3,2
39,https://vlr.gg/player/25902/shondex,2024-11-29 19:30:00,0.67,0.77,0.72,141,131,150,21,10,11,28,15,13,15,6,9,-1,-2,+1,70%,57%,82%,92,81,102,32%,32%,32%,2,1,1,3,3,0
40,https://vlr.gg/player/5035/blahst,2024-11-29 19:15:00,1.02,0.96,0.99,188,184,205,51,22,29,47,21,26,6,0,6,-2,+1,-3,67%,60%,74%,115,111,119,34%,32%,36%,4,3,1,6,2,4
41,https://vlr.gg/player/36036/practo,2024-11-29 19:15:00,0.74,1.12,0.94,195,151,239,43,16,27,49,24,25,16,7,9,-4,-1,-3,70%,70%,71%,128,98,154,29%,32%,28%,3,1,2,7,2,5
42,https://vlr.gg/player/20922/zekei,2024-11-29 19:15:00,0.72,0.97,0.85,195,167,229,40,15,25,52,25,27,22,11,11,-2,-3,+1,66%,70%,62%,128,108,147,26%,21%,28%,11,3,8,13,6,7
43,https://vlr.gg/player/28870/k0rupt,2024-11-29 19:15:00,0.80,0.89,0.84,159,142,174,35,15,20,48,23,25,28,10,18,-2,-3,+1,63%,63%,62%,106,94,116,25%,22%,26%,2,1,1,4,4,0
44,https://vlr.gg/player/17751/tim,2024-11-29 19:15:00,0.73,0.54,0.63,168,187,143,35,19,16,55,26,29,13,6,7,-4,-4,0,64%,70%,59%,104,115,94,15%,15%,15%,5,2,3,9,6,3
45,https://vlr.gg/player/8434/nabil,2024-11-29 19:15:00,1.60,1.66,1.63,304,296,305,72,37,35,39,21,18,21,7,14,+6,+3,+3,84%,85%,83%,191,194,188,23%,23%,24%,7,4,3,1,1,0
46,https://vlr.gg/player/8397/dip,2024-11-29 19:15:00,1.19,1.16,1.18,218,218,220,50,27,23,41,23,18,19,8,11,+8,+7,+1,75%,71%,80%,148,146,151,30%,35%,25%,11,7,4,3,0,3
47,https://vlr.gg/player/8758/benjii,2024-11-29 19:15:00,1.03,1.21,1.12,173,161,193,37,18,19,35,20,15,42,22,20,0,0,0,77%,76%,77%,107,102,114,21%,21%,20%,3,1,2,3,1,2
48,https://vlr.gg/player/21886/furbsa,2024-11-29 19:15:00,1.05,1.05,1.05,240,271,201,56,34,22,47,29,18,12,6,6,-2,-6,+4,69%,68%,70%,151,171,127,34%,48%,20%,13,6,7,15,12,3
49,https://vlr.gg/player/6437/dark3st,2024-11-29 19:15:00,0.86,1.03,0.94,171,151,192,36,16,20,42,24,18,39,23,16,+2,0,+2,78%,79%,77%,118,104,133,24%,26%,23%,5,1,4,3,1,2
50,https://vlr.gg/player/10557/darker,2024-11-29 17:00:00,1.06,1.42,1.21,224,222,238,46,26,20,36,23,13,24,16,8,+4,+2,+2,82%,85%,77%,148,137,164,36%,34%,39%,5,3,2,1,1,0
51,https://vlr.gg/player/8056/mited,2024-11-29 17:00:00,1.20,1.19,1.20,219,191,248,41,23,18,34,18,16,22,12,10,0,-3,+3,80%,82%,77%,143,137,152,37%,31%,45%,4,0,4,4,3,1
52,https://vlr.gg/player/3983/virtyy,2024-11-29 17:00:00,1.09,1.23,1.14,258,259,250,49,29,20,37,23,14,11,5,6,+7,+7,0,71%,79%,59%,156,158,154,21%,23%,18%,16,12,4,9,5,4
53,https://vlr.gg/player/7616/feniz,2024-11-29 17:00:00,1.09,1.03,1.06,211,194,221,41,23,18,33,18,15,17,13,4,+3,+1,+2,73%,76%,68%,132,127,140,39%,46%,31%,5,2,3,2,1,1
54,https://vlr.gg/player/24865/acrian,2024-11-29 17:00:00,1.12,0.64,0.91,171,216,101,32,25,7,34,20,14,20,15,5,-3,-2,-1,65%,67%,64%,112,139,72,29%,29%,30%,3,2,1,6,4,2
55,https://vlr.gg/player/6450/korsonix,2024-11-29 17:00:00,0.72,1.57,1.23,250,208,275,45,15,30,41,20,21,14,4,10,-1,-2,+1,67%,68%,67%,172,138,194,32%,29%,33%,8,4,4,9,6,3
56,https://vlr.gg/player/8792/xhowi,2024-11-29 17:00:00,1.16,0.79,0.94,173,239,147,37,19,18,41,16,25,13,4,9,0,-1,+1,69%,73%,67%,125,158,103,34%,33%,35%,3,0,3,3,1,2
57,https://vlr.gg/player/8286/glyph,2024-11-29 17:00:00,0.90,0.85,0.87,165,140,182,31,11,20,40,14,26,15,7,8,-4,0,-4,64%,77%,55%,101,90,108,20%,30%,17%,5,3,2,9,3,6
58,https://vlr.gg/player/586/sickly,2024-11-29 17:00:00,0.94,0.77,0.82,165,179,163,32,14,18,43,16,27,16,9,7,-4,-3,-1,69%,73%,67%,105,102,106,30%,43%,23%,3,1,2,7,4,3
59,https://vlr.gg/player/17694/prask,2024-11-29 17:00:00,0.78,0.62,0.68,138,162,134,29,13,16,44,17,27,16,4,12,-2,0,-2,67%,73%,64%,106,116,99,38%,31%,43%,3,0,3,5,0,5
60,https://vlr.gg/player/9017/moobs,2024-11-29 16:00:00,1.17,1.24,1.20,256,242,273,61,31,30,47,23,24,13,7,6,+9,+5,+4,75%,69%,81%,164,158,171,41%,43%,39%,16,8,8,7,3,4
61,https://vlr.gg/player/9063/infiltrator,2024-11-29 16:00:00,1.14,1.05,1.10,254,284,235,60,34,26,53,29,24,15,13,2,-3,-3,0,73%,75%,71%,169,188,145,29%,28%,32%,13,7,6,16,10,6
62,https://vlr.gg/player/765/jerk,2024-11-29 16:00:00,1.22,0.94,1.09,181,196,163,43,28,15,39,19,20,21,8,13,-2,-2,0,70%,75%,65%,120,126,114,21%,23%,18%,0,0,0,2,2,0
63,https://vlr.gg/player/9837/flare,2024-11-29 16:00:00,1.13,0.88,1.01,193,190,193,44,24,20,46,22,24,24,13,11,-2,-1,-1,72%,69%,74%,128,127,129,22%,21%,24%,2,1,1,4,2,2
64,https://vlr.gg/player/17865/nahsie,2024-11-29 16:00:00,0.76,0.72,0.74,148,139,167,34,17,17,53,27,26,35,21,14,+3,+1,+2,76%,75%,77%,105,89,123,19%,20%,19%,5,2,3,2,1,1
65,https://vlr.gg/player/5035/blahst,2024-11-29 16:00:00,1.12,1.16,1.14,215,202,223,49,22,27,42,18,24,15,7,8,-2,-4,+2,70%,61%,78%,141,139,142,26%,33%,22%,4,2,2,6,6,0
66,https://vlr.gg/player/17751/tim,2024-11-29 16:00:00,1.28,0.98,1.12,198,210,179,50,25,25,44,19,25,18,11,7,-4,+1,-5,63%,68%,58%,120,130,112,25%,24%,25%,3,2,1,7,1,6
67,https://vlr.gg/player/20922/zekei,2024-11-29 16:00:00,0.80,0.98,0.90,215,212,203,46,21,25,53,27,26,15,8,7,-2,-4,+2,69%,68%,69%,137,135,138,22%,28%,15%,11,5,6,13,9,4
68,https://vlr.gg/player/36036/practo,2024-11-29 16:00:00,1.09,0.74,0.90,196,225,176,47,26,21,52,22,30,13,6,7,+6,+3,+3,60%,58%,61%,129,147,114,33%,34%,31%,11,4,7,5,1,4
69,https://vlr.gg/player/28870/k0rupt,2024-11-29 16:00:00,1.01,0.77,0.88,205,232,186,46,24,22,51,22,29,23,12,11,-3,-1,-2,73%,81%,67%,130,140,122,27%,24%,29%,2,0,2,5,1,4
70,https://vlr.gg/player/8434/nabil,2024-11-29 16:00:00,0.63,1.68,1.10,210,143,306,32,11,21,30,18,12,5,1,4,+2,0,+2,73%,64%,83%,133,98,175,26%,38%,20%,3,1,2,1,1,0
71,https://vlr.gg/player/8758/benjii,2024-11-29 16:00:00,1.10,0.85,0.99,201,217,186,26,16,10,28,14,14,16,10,6,0,+1,-1,70%,64%,78%,127,129,126,26%,23%,31%,2,2,0,2,1,1
72,https://vlr.gg/player/6437/dark3st,2024-11-29 16:00:00,0.79,1.13,0.95,204,175,250,26,12,14,31,17,14,13,5,8,+4,+1,+3,65%,64%,67%,141,114,175,20%,12%,33%,6,2,4,2,1,1
73,https://vlr.gg/player/8397/dip,2024-11-29 16:00:00,0.72,0.43,0.59,150,188,100,19,13,6,34,19,15,16,10,6,-5,-1,-4,60%,68%,50%,99,121,71,19%,17%,21%,2,1,1,7,2,5
74,https://vlr.gg/player/21886/furbsa,2024-11-29 16:00:00,0.54,0.56,0.54,137,133,158,19,10,9,35,19,16,6,4,2,-11,-7,-4,60%,55%,67%,101,96,106,40%,38%,43%,2,2,0,13,9,4
75,https://vlr.gg/player/10053/fireballops,2024-11-29 16:00:00,1.48,1.66,1.58,324,315,331,48,20,28,26,12,14,9,5,4,+2,+1,+1,80%,78%,82%,206,212,201,36%,38%,34%,5,2,3,3,1,2
76,https://vlr.gg/player/9094/kess,2024-11-29 16:00:00,1.47,1.45,1.46,278,255,289,39,18,21,24,11,13,19,10,9,+6,+2,+4,75%,78%,73%,165,151,177,18%,15%,20%,6,2,4,0,0,0
77,https://vlr.gg/player/48025/alym,2024-11-29 16:00:00,0.81,1.34,1.10,201,216,186,30,13,17,22,13,9,8,2,6,-4,-1,-3,78%,78%,77%,135,144,127,17%,19%,16%,5,4,1,9,5,4
78,https://vlr.gg/player/6445/sogo,2024-11-29 16:00:00,1.06,0.75,0.89,140,173,123,21,12,9,22,10,12,11,6,5,0,0,0,68%,78%,59%,95,116,78,24%,30%,18%,1,0,1,1,0,1
79,https://vlr.gg/player/62/huynh,2024-11-29 16:00:00,0.80,0.87,0.84,157,138,170,20,8,12,28,14,14,23,15,8,+6,+2,+4,73%,78%,68%,99,82,113,16%,16%,17%,8,3,5,2,1,1
80,https://vlr.gg/player/69/thief,2024-11-29 16:00:00,1.26,1.47,1.36,235,226,254,38,20,18,24,16,8,12,7,5,+3,+3,0,73%,71%,75%,156,160,153,26%,30%,22%,6,3,3,3,0,3
81,https://vlr.gg/player/733/stellar,2024-11-29 16:00:00,1.27,1.04,1.17,214,202,236,34,19,15,27,14,13,21,8,13,+2,+1,+1,80%,71%,90%,135,117,156,22%,24%,21%,3,1,2,1,0,1
82,https://vlr.gg/player/8742/jakee,2024-11-29 16:00:00,0.99,1.18,1.07,210,224,186,32,19,13,30,20,10,18,9,9,+2,+1,+1,84%,79%,90%,134,135,134,31%,37%,24%,5,3,2,3,2,1
83,https://vlr.gg/player/7716/penny,2024-11-29 16:00:00,0.72,1.48,1.06,239,189,291,36,14,22,32,20,12,15,9,6,+1,-1,+2,80%,75%,85%,151,114,196,19%,16%,23%,8,4,4,7,5,2
84,https://vlr.gg/player/739/fiziq,2024-11-29 16:00:00,0.78,1.25,0.99,169,151,181,28,13,15,27,18,9,11,7,4,0,-2,+2,82%,79%,85%,107,100,115,23%,18%,28%,4,2,2,4,4,0
85,https://vlr.gg/player/8376/seven,2024-11-29 16:00:00,1.22,1.28,1.25,254,246,260,39,15,24,34,17,17,15,9,6,+4,+1,+3,80%,75%,83%,166,178,155,34%,32%,36%,5,2,3,1,1,0
86,https://vlr.gg/player/64/gmd,2024-11-29 16:00:00,1.19,0.64,0.89,177,190,153,26,14,12,32,14,18,16,9,7,-1,-1,0,61%,60%,63%,116,121,112,29%,26%,32%,2,0,2,3,1,2
87,https://vlr.gg/player/3007/tdawgg,2024-11-29 16:00:00,0.46,1.11,0.82,178,128,229,26,8,18,34,18,16,15,3,12,-1,+1,-2,66%,50%,79%,121,87,148,16%,21%,14%,5,2,3,6,1,5
88,https://vlr.gg/player/3702/sym,2024-11-29 16:00:00,0.54,0.96,0.77,188,141,226,27,9,18,35,17,18,12,3,9,-7,-4,-3,66%,55%,75%,125,95,150,13%,18%,9%,5,2,3,12,6,6
89,https://vlr.gg/player/1023/xxif,2024-11-29 16:00:00,0.35,0.96,0.68,143,86,186,22,6,16,33,17,16,9,1,8,-3,-3,0,64%,50%,75%,94,67,116,21%,23%,20%,1,1,0,4,4,0
90,https://vlr.gg/player/41798/nightz,2024-11-29 16:00:00,0.98,1.49,1.24,257,215,290,62,26,36,53,32,21,39,17,22,+2,+3,-1,76%,66%,86%,163,134,191,46%,55%,41%,6,4,2,4,1,3
91,https://vlr.gg/player/35302/eggsterr,2024-11-29 16:00:00,0.90,1.36,1.13,201,166,242,54,20,34,44,24,20,19,10,9,-6,-5,-1,77%,71%,83%,131,111,151,28%,30%,27%,4,1,3,10,6,4
92,https://vlr.gg/player/36560/canezerra,2024-11-29 16:00:00,1.05,0.98,1.02,231,228,241,53,27,26,53,26,27,21,9,12,-4,-3,-1,69%,66%,71%,149,151,147,23%,36%,15%,10,5,5,14,8,6
93,https://vlr.gg/player/53/inspire,2024-11-29 16:00:00,0.79,1.00,0.90,169,178,179,40,21,19,47,27,20,25,11,14,+2,+1,+1,67%,57%,77%,116,111,121,25%,28%,22%,7,4,3,5,3,2
94,https://vlr.gg/player/21778/p0ppin,2024-11-29 16:00:00,0.86,0.94,0.90,182,178,185,44,21,23,52,27,25,21,8,13,0,+1,-1,70%,63%,77%,114,112,116,25%,29%,22%,5,2,3,5,1,4
95,https://vlr.gg/player/873/bob,2024-11-29 16:00:00,0.89,1.68,1.28,291,234,353,73,29,44,55,31,24,18,6,12,+7,0,+7,70%,63%,77%,186,140,232,34%,37%,33%,18,9,9,11,9,2
96,https://vlr.gg/player/11696/zoestol,2024-11-29 16:00:00,1.12,1.05,1.08,197,207,194,47,24,23,47,26,21,43,23,20,0,+1,-1,81%,77%,86%,120,129,112,17%,20%,15%,5,3,2,5,2,3
97,https://vlr.gg/player/25902/shondex,2024-11-29 16:00:00,0.61,1.35,0.98,174,135,211,44,16,28,45,26,19,17,6,11,0,0,0,66%,54%,77%,110,83,136,31%,22%,39%,4,2,2,4,2,2
98,https://vlr.gg/player/16671/welyy,2024-11-29 16:00:00,1.18,0.74,0.96,176,199,154,40,25,15,49,24,25,32,14,18,-1,+2,-3,64%,69%,60%,126,135,118,24%,29%,19%,5,3,2,6,1,5
99,https://vlr.gg/player/26848/zeek,2024-11-29 16:00:00,0.67,0.91,0.79,189,172,188,44,19,25,57,31,26,26,14,12,0,0,0,63%,51%,74%,119,114,124,24%,19%,28%,6,2,4,6,2,4
100,https://vlr.gg/player/1457/mistic,2024-11-29 14:20:00,1.64,1.20,1.40,236,293,192,41,23,18,23,13,10,17,6,11,+3,+1,+2,79%,77%,80%,153,187,124,33%,33%,33%,4,2,2,1,1,0
101,https://vlr.gg/player/5292/al0rante,2024-11-29 14:20:00,1.10,1.29,1.20,186,185,186,34,16,18,26,16,10,4,1,3,+2,+1,+1,66%,59%,72%,127,132,122,50%,45%,55%,3,1,2,1,0,1
102,https://vlr.gg/player/2658/xuss,2024-11-29 14:20:00,0.44,1.46,0.98,240,137,324,37,9,28,36,19,17,9,4,5,0,-3,+3,64%,45%,80%,138,88,183,28%,43%,23%,10,2,8,10,5,5
103,https://vlr.gg/player/4244/yaboilewis,2024-11-29 14:20:00,0.62,1.27,0.97,187,165,213,33,12,21,34,20,14,10,5,5,-1,-2,+1,62%,50%,72%,130,105,152,39%,44%,36%,5,2,3,6,4,2
104,https://vlr.gg/player/2690/hoody,2024-11-29 14:20:00,0.50,0.97,0.75,149,131,161,21,9,12,33,19,14,17,6,11,-3,-1,-2,66%,59%,72%,100,84,113,19%,16%,21%,2,2,0,5,3,2
105,https://vlr.gg/player/4525/stix,2024-11-29 14:20:00,0.87,1.86,1.33,244,150,343,43,14,29,30,18,12,11,5,6,-2,-2,0,79%,64%,95%,159,102,224,30%,16%,43%,1,0,1,3,2,1
106,https://vlr.gg/player/30754/karma,2024-11-29 14:20:00,0.67,1.38,1.00,199,147,255,35,15,20,32,21,11,17,7,10,0,0,0,72%,64%,82%,136,96,181,33%,22%,41%,6,3,3,6,3,3
107,https://vlr.gg/player/45490/ico,2024-11-29 14:20:00,1.02,0.97,1.00,225,227,233,35,18,17,38,20,18,17,9,8,+1,-1,+2,74%,68%,82%,165,161,169,24%,20%,28%,6,3,3,5,4,1
108,https://vlr.gg/player/5477/leon,2024-11-29 14:20:00,0.77,0.93,0.84,161,157,175,26,13,13,32,18,14,6,1,5,+4,+1,+3,64%,52%,77%,106,104,108,34%,28%,43%,8,3,5,4,2,2
109,https://vlr.gg/player/22180/spmak,2024-11-29 14:20:00,0.48,0.64,0.55,101,100,102,13,6,7,35,20,15,29,13,16,-4,-3,-1,62%,56%,68%,62,68,55,7%,7%,9%,2,1,1,6,4,2
110,https://vlr.gg/player/18400/bipo,2024-11-29 12:00:00,1.01,1.57,1.32,246,224,262,40,15,25,25,14,11,9,4,5,+4,0,+4,77%,74%,79%,158,145,168,30%,36%,26%,10,5,5,6,5,1
111,https://vlr.gg/player/3753/obnoks,2024-11-29 12:00:00,1.14,1.42,1.30,239,229,250,39,17,22,24,12,12,17,5,12,-2,0,-2,72%,74%,71%,149,138,158,25%,22%,27%,2,0,2,4,0,4
112,https://vlr.gg/player/7660/fizzy,2024-11-29 12:00:00,1.12,1.24,1.19,235,253,222,36,16,20,27,14,13,12,6,6,+8,+6,+2,79%,79%,79%,146,160,135,34%,33%,34%,9,6,3,1,0,1
113,https://vlr.gg/player/10338/lime,2024-11-29 12:00:00,0.91,1.11,1.02,183,135,219,26,9,17,26,10,16,16,7,9,+3,-2,+5,74%,68%,79%,132,97,160,32%,29%,34%,5,0,5,2,2,0
114,https://vlr.gg/player/3674/iluri,2024-11-29 12:00:00,1.16,0.66,0.89,140,178,110,20,12,8,25,11,14,17,6,11,0,+1,-1,72%,74%,71%,97,127,73,27%,37%,17%,2,1,1,2,0,2
115,https://vlr.gg/player/3649/litshii,2024-11-29 12:00:00,0.74,1.43,1.05,184,115,267,28,10,18,29,17,12,11,5,6,+1,0,+1,63%,63%,63%,119,74,174,28%,26%,29%,2,0,2,1,0,1
116,https://vlr.gg/player/47270/darkwinjett,2024-11-29 12:00:00,1.09,0.79,0.96,236,258,211,32,20,12,36,19,17,6,4,2,-5,-5,0,63%,63%,63%,159,170,145,20%,19%,21%,4,2,2,9,7,2
117,https://vlr.gg/player/2540/happen,2024-11-29 12:00:00,1.02,0.86,0.95,170,170,171,26,14,12,29,16,13,7,3,4,-7,-3,-4,60%,58%,63%,127,124,131,20%,15%,27%,1,1,0,8,4,4
118,https://vlr.gg/player/20032/treelover,2024-11-29 12:00:00,0.64,0.75,0.69,135,143,126,21,12,9,33,20,13,6,4,2,+2,+2,0,63%,67%,58%,88,88,88,35%,36%,33%,6,4,2,4,2,2
119,https://vlr.gg/player/13238/shiio,2024-11-29 12:00:00,0.46,0.75,0.59,123,119,130,20,10,10,34,20,14,7,4,3,-4,-2,-2,63%,54%,74%,74,72,77,34%,41%,27%,2,1,1,6,3,3
120,https://vlr.gg/player/22501/amore,2024-11-29 11:00:00,1.38,1.12,1.27,274,306,225,81,51,30,64,39,25,15,5,10,+5,+5,0,72%,74%,69%,183,203,156,41%,42%,39%,19,13,6,14,8,6
121,https://vlr.gg/player/2893/hastack,2024-11-29 11:00:00,1.13,1.44,1.26,216,209,238,64,32,32,53,34,19,19,10,9,0,0,0,72%,66%,81%,146,134,161,24%,24%,25%,4,2,2,4,2,2
122,https://vlr.gg/player/2996/neiker,2024-11-29 11:00:00,0.69,1.44,1.01,208,142,303,62,23,39,62,36,26,29,12,17,+4,-2,+6,66%,60%,75%,131,94,179,46%,40%,51%,10,3,7,6,5,1
123,https://vlr.gg/player/5487/adm1k,2024-11-29 11:00:00,0.83,0.91,0.86,156,155,169,45,25,20,56,32,24,22,13,9,-2,+1,-3,67%,68%,67%,111,103,121,25%,24%,27%,5,3,2,7,2,5
124,https://vlr.gg/player/22154/pika,2024-11-29 11:00:00,0.79,0.73,0.76,134,135,142,39,21,18,56,31,25,26,14,12,-2,-5,+3,69%,64%,75%,101,106,93,26%,31%,21%,6,2,4,8,7,1
125,https://vlr.gg/player/16139/enrik,2024-11-29 11:00:00,1.21,1.12,1.16,225,261,201,64,32,32,55,27,28,34,14,20,+1,+1,0,70%,72%,68%,141,166,121,32%,32%,33%,4,2,2,3,1,2
126,https://vlr.gg/player/22314/mober,2024-11-29 11:00:00,0.70,1.23,1.00,213,170,250,64,21,43,58,30,28,15,5,10,-6,-3,-3,69%,58%,77%,155,120,181,38%,36%,38%,8,4,4,14,7,7
127,https://vlr.gg/player/32300/varuxx,2024-11-29 11:00:00,0.87,1.05,0.96,177,148,196,53,19,34,54,25,29,18,9,9,+2,+1,+1,72%,61%,81%,118,96,136,28%,28%,29%,6,2,4,4,1,3
128,https://vlr.gg/player/14894/facepalm,2024-11-29 11:00:00,0.80,1.00,0.91,216,205,223,62,26,36,64,31,33,9,5,4,+3,-2,+5,65%,56%,72%,129,122,134,33%,39%,29%,18,7,11,15,9,6
129,https://vlr.gg/player/2853/apex,2024-11-29 11:00:00,0.88,0.83,0.85,173,168,172,48,21,27,60,26,34,48,18,30,-5,-3,-2,71%,69%,72%,117,120,115,29%,27%,31%,3,0,3,8,3,5
130,https://vlr.gg/player/13221/azys,2024-11-29 10:00:00,1.22,1.48,1.36,277,260,296,43,17,26,29,14,15,11,5,6,+2,-2,+4,75%,65%,83%,179,165,191,39%,45%,34%,8,3,5,6,5,1
131,https://vlr.gg/player/12947/rawfiul,2024-11-29 10:00:00,1.39,1.16,1.27,254,289,218,37,21,16,28,14,14,17,9,8,+2,+4,-2,80%,80%,79%,172,186,161,30%,31%,29%,6,4,2,4,0,4
132,https://vlr.gg/player/3628/deathmaker,2024-11-29 10:00:00,0.80,1.25,1.04,202,158,237,35,12,23,29,13,16,9,3,6,-4,-3,-1,82%,85%,79%,136,104,162,35%,31%,37%,3,2,1,7,5,2
133,https://vlr.gg/player/3269/antidote,2024-11-29 10:00:00,0.86,0.92,0.89,160,162,160,27,13,14,27,13,14,10,4,6,-5,-1,-4,75%,85%,67%,107,100,112,22%,17%,26%,0,0,0,5,1,4
134,https://vlr.gg/player/18704/levi,2024-11-29 10:00:00,0.85,0.89,0.87,195,163,214,30,11,19,31,14,17,9,4,5,+3,0,+3,80%,80%,79%,123,108,136,26%,21%,30%,4,0,4,1,0,1
135,https://vlr.gg/player/49570/rinsat,2024-11-29 10:00:00,1.52,0.94,1.26,292,313,271,46,27,19,38,19,19,10,9,1,+5,+4,+1,73%,75%,70%,200,207,191,45%,53%,35%,8,5,3,3,1,2
136,https://vlr.gg/player/43398/river,2024-11-29 10:00:00,0.71,1.18,0.93,182,160,202,26,12,14,34,21,13,16,11,5,+2,0,+2,75%,75%,75%,116,109,124,44%,29%,61%,2,0,2,0,0,0
137,https://vlr.gg/player/22054/wave,2024-11-29 10:00:00,1.02,0.67,0.86,174,226,120,27,19,8,34,18,16,9,5,4,+1,+1,0,68%,71%,65%,126,146,102,30%,33%,26%,5,4,1,4,3,1
138,https://vlr.gg/player/43389/yash,2024-11-29 10:00:00,0.51,1.10,0.78,170,134,214,26,11,15,35,21,14,7,5,2,0,-4,+4,70%,58%,85%,113,85,145,27%,24%,29%,7,2,5,7,6,1
139,https://vlr.gg/player/27755/icarus,2024-11-29 10:00:00,0.54,0.88,0.69,119,92,150,19,8,11,32,19,13,3,2,1,-6,-1,-5,52%,58%,45%,94,68,125,31%,25%,35%,1,1,0,7,2,5
140,https://vlr.gg/player/8504/invy,2024-11-29 08:30:00,1.27,1.68,1.53,300,331,283,20,8,12,12,7,5,10,0,10,0,-1,+1,74%,57%,83%,185,215,167,29%,50%,17%,2,0,2,2,1,1
141,https://vlr.gg/player/2334/jessievash,2024-11-29 08:30:00,1.46,1.31,1.36,189,198,184,12,5,7,8,3,5,6,2,4,+3,+1,+2,84%,71%,92%,133,137,130,35%,24%,47%,3,1,2,0,0,0
142,https://vlr.gg/player/9740/wild0reoo,2024-11-29 08:30:00,0.97,1.38,1.23,242,162,290,17,5,12,13,6,7,5,1,4,+3,0,+3,79%,71%,83%,177,140,198,26%,40%,22%,3,0,3,0,0,0
143,https://vlr.gg/player/7405/jremy,2024-11-29 08:30:00,0.96,1.32,1.19,270,248,283,18,6,12,15,7,8,10,4,6,+1,0,+1,68%,71%,67%,183,152,201,33%,22%,46%,1,0,1,0,0,0
144,https://vlr.gg/player/9735/2ge,2024-11-29 08:30:00,0.38,1.48,1.07,240,142,298,17,3,14,16,7,9,5,1,4,-2,-3,+1,74%,29%,100%,139,81,173,19%,12%,23%,3,1,2,5,4,1
145,https://vlr.gg/player/10739/shiro,2024-11-29 08:30:00,0.74,1.07,0.86,191,170,229,13,7,6,15,10,5,7,5,2,+1,+1,0,68%,58%,86%,114,100,138,16%,23%,8%,1,1,0,0,0,0
146,https://vlr.gg/player/7043/ncslasher,2024-11-29 08:30:00,0.67,1.14,0.84,241,180,346,16,7,9,18,11,7,3,2,1,0,-2,+2,63%,58%,71%,155,131,197,21%,33%,14%,2,0,2,2,2,0
147,https://vlr.gg/player/16215/dos9,2024-11-29 08:30:00,0.58,1.03,0.75,190,161,242,12,6,6,16,11,5,3,3,0,0,-1,+1,63%,67%,57%,123,104,155,16%,8%,28%,1,0,1,1,1,0
148,https://vlr.gg/player/2348/famouz,2024-11-29 08:30:00,0.49,0.91,0.64,195,157,263,14,8,6,19,13,6,3,1,2,0,-1,+1,53%,42%,71%,112,97,138,11%,21%,6%,1,0,1,1,1,0
149,https://vlr.gg/player/4874/berserx,2024-11-29 08:30:00,0.34,0.60,0.43,144,154,126,9,6,3,16,12,4,3,2,1,-6,-5,-1,53%,42%,71%,89,89,89,18%,24%,12%,2,1,1,8,6,2
150,https://vlr.gg/player/12323/rvk,2024-11-29 06:30:00,1.15,1.77,1.44,268,232,309,69,32,37,41,26,15,19,7,12,+4,0,+4,76%,69%,84%,176,154,200,29%,25%,32%,7,1,6,3,1,2
151,https://vlr.gg/player/1770/wat,2024-11-29 06:30:00,1.13,1.03,1.08,226,240,212,55,31,24,52,32,20,26,10,16,+1,+1,0,79%,75%,84%,154,170,136,26%,29%,22%,6,3,3,5,2,3
152,https://vlr.gg/player/46121/marcai,2024-11-29 06:30:00,0.81,1.12,0.96,231,205,256,55,25,30,53,31,22,9,7,2,+3,0,+3,72%,69%,75%,144,132,157,25%,25%,24%,15,9,6,12,9,3
153,https://vlr.gg/player/3502/ri0,2024-11-29 06:30:00,0.51,1.14,0.80,164,120,203,39,15,24,51,32,19,22,11,11,+5,+2,+3,75%,69%,81%,117,90,146,26%,26%,26%,7,3,4,2,1,1
154,https://vlr.gg/player/46048/r0meo,2024-11-29 06:30:00,0.53,0.96,0.72,132,118,154,24,11,13,32,21,11,10,6,4,-1,-1,0,74%,65%,85%,84,80,90,10%,14%,4%,3,2,1,4,3,1
155,https://vlr.gg/player/40057/batman,2024-11-29 06:30:00,0.63,0.74,0.69,183,174,191,16,7,9,19,10,9,2,2,0,0,0,0,64%,60%,67%,105,89,117,32%,25%,38%,2,1,1,2,1,1
156,https://vlr.gg/player/30286/karam1l,2024-11-29 06:30:00,1.12,1.43,1.28,254,265,256,64,29,35,46,26,20,7,2,5,-1,-1,0,71%,66%,75%,165,160,170,45%,42%,48%,7,3,4,8,4,4
157,https://vlr.gg/player/46104/envy2k,2024-11-29 06:30:00,0.86,1.26,1.07,264,232,279,57,23,34,54,29,25,13,6,7,+5,-1,+6,69%,59%,78%,164,148,179,21%,22%,20%,13,5,8,8,6,2
158,https://vlr.gg/player/5009/wstvirginia,2024-11-29 06:30:00,0.58,1.32,0.97,210,147,277,50,15,35,56,29,27,25,9,16,-6,-2,-4,69%,69%,69%,131,90,167,32%,32%,32%,4,2,2,10,4,6
159,https://vlr.gg/player/31355/acestarrrrr,2024-11-29 06:30:00,0.79,0.92,0.86,196,164,222,44,18,26,53,27,26,25,14,11,-3,-3,0,72%,69%,75%,127,107,144,21%,19%,23%,3,0,3,6,3,3
160,https://vlr.gg/player/43390/d1sease,2024-11-29 06:30:00,0.62,0.97,0.80,133,118,153,32,11,21,49,26,23,25,11,14,-7,-3,-4,69%,59%,78%,94,79,107,24%,23%,25%,1,1,0,8,4,4
161,https://vlr.gg/player/37494/kai,2024-11-29 06:20:00,,,,263,,,42,,,21,,,8,,,,,,,,,,,,,,,,,,,,
162,https://vlr.gg/player/4770/fengf,2024-11-29 06:20:00,,,,258,,,39,,,24,,,5,,,,,,,,,,,,,,,,,,,,
163,https://vlr.gg/player/3045/luok1ng,2024-11-29 06:20:00,,,,216,,,31,,,30,,,26,,,,,,,,,,,,,,,,,,,,
164,https://vlr.gg/player/3021/biank,2024-11-29 06:20:00,,,,170,,,25,,,29,,,14,,,,,,,,,,,,,,,,,,,,
165,https://vlr.gg/player/4712/heybay,2024-11-29 06:20:00,,,,161,,,27,,,26,,,12,,,,,,,,,,,,,,,,,,,,
166,https://vlr.gg/player/28400/hyunmin,2024-11-29 06:20:00,,,,260,,,40,,,36,,,5,,,,,,,,,,,,,,,,,,,,
167,https://vlr.gg/player/35013/flashback,2024-11-29 06:20:00,,,,193,,,28,,,34,,,9,,,,,,,,,,,,,,,,,,,,
168,https://vlr.gg/player/4462/mako,2024-11-29 06:20:00,,,,156,,,24,,,31,,,15,,,,,,,,,,,,,,,,,,,,
169,https://vlr.gg/player/34982/athan,2024-11-29 06:20:00,,,,132,,,20,,,35,,,8,,,,,,,,,,,,,,,,,,,,
170,https://vlr.gg/player/1916/free1ng,2024-11-29 06:20:00,,,,126,,,18,,,28,,,11,,,,,,,,,,,,,,,,,,,,
171,https://vlr.gg/player/25089/cabeza,2024-11-29 06:20:00,1.39,1.48,1.43,271,266,281,40,21,19,25,12,13,10,5,5,+4,0,+4,81%,82%,80%,175,182,167,34%,32%,36%,5,1,4,1,1,0
172,https://vlr.gg/player/25082/rico,2024-11-29 06:20:00,1.71,1.05,1.40,250,309,183,36,23,13,24,10,14,24,15,9,+4,+3,+1,90%,95%,85%,174,214,130,30%,34%,24%,7,4,3,3,1,2
173,https://vlr.gg/player/17049/hermes,2024-11-29 06:20:00,1.20,1.30,1.25,242,218,274,38,19,19,28,13,15,15,7,8,+1,+1,0,74%,77%,70%,145,125,167,17%,19%,16%,7,4,3,6,3,3
174,https://vlr.gg/player/4127/felix,2024-11-29 06:20:00,1.20,0.83,1.03,170,168,175,27,13,14,25,10,15,11,7,4,+3,+3,0,81%,82%,80%,107,103,112,29%,29%,28%,4,3,1,1,0,1
175,https://vlr.gg/player/25080/empty,2024-11-29 06:20:00,1.07,0.95,1.01,185,209,155,27,17,10,26,14,12,16,8,8,0,+1,-1,81%,77%,85%,128,144,109,22%,21%,22%,4,3,1,4,2,2
176,https://vlr.gg/player/9192/cloudy,2024-11-29 06:20:00,0.72,1.25,0.99,232,193,269,35,14,21,34,17,17,8,4,4,-2,-1,-1,71%,80%,64%,140,121,158,42%,44%,39%,3,1,2,5,2,3
177,https://vlr.gg/player/9236/manggong,2024-11-29 06:20:00,1.19,0.82,0.99,223,250,195,34,19,15,33,14,19,12,6,6,0,-1,+1,69%,75%,64%,144,167,124,32%,30%,33%,3,1,2,3,2,1
178,https://vlr.gg/player/42254/delas,2024-11-29 06:20:00,0.84,0.93,0.89,176,183,172,26,13,13,32,15,17,11,4,7,-1,0,-1,60%,55%,64%,119,118,120,21%,16%,28%,3,2,1,4,2,2
179,https://vlr.gg/player/42749/godsb,2024-11-29 06:20:00,0.88,0.32,0.59,121,153,92,18,12,6,33,13,20,5,3,2,-2,0,-2,57%,80%,36%,86,112,63,28%,35%,18%,2,2,0,4,2,2
180,https://vlr.gg/player/25053/wolverine,2024-11-29 06:20:00,0.50,0.14,0.28,101,142,66,15,11,4,36,16,20,5,3,2,-7,-2,-5,43%,55%,32%,65,84,48,23%,27%,14%,4,2,2,11,4,7
181,https://vlr.gg/player/1009/sakurai,2024-11-29 05:10:00,1.27,1.29,1.28,224,195,246,60,26,34,47,24,23,37,21,16,+1,0,+1,77%,75%,79%,139,122,155,30%,28%,31%,7,2,5,6,2,4
182,https://vlr.gg/player/45962/ken,2024-11-29 05:10:00,1.28,1.26,1.27,277,287,263,68,34,34,50,27,23,21,9,12,+5,0,+5,68%,67%,68%,183,188,177,21%,23%,19%,19,9,10,14,9,5
183,https://vlr.gg/player/6702/bazz,2024-11-29 05:10:00,0.96,0.99,0.98,190,199,177,49,24,25,50,27,23,22,13,9,0,+1,-1,76%,78%,74%,126,130,123,26%,25%,28%,6,4,2,6,3,3
184,https://vlr.gg/player/40736/kapi,2024-11-29 05:10:00,0.71,1.03,0.88,172,147,191,45,19,26,50,28,22,31,16,15,-4,-1,-3,73%,69%,76%,113,104,122,23%,25%,22%,1,0,1,5,1,4
185,https://vlr.gg/player/2400/brofeld,2024-11-29 05:10:00,0.65,0.82,0.73,138,107,159,33,13,20,51,27,24,21,8,13,0,-2,+2,66%,58%,74%,89,75,103,27%,21%,31%,5,2,3,5,4,1
186,https://vlr.gg/player/47482/flora,2024-11-29 05:10:00,1.08,1.34,1.21,239,189,306,65,26,39,51,26,25,18,10,8,+4,-3,+7,69%,61%,78%,164,132,198,33%,42%,28%,13,4,9,9,7,2
187,https://vlr.gg/player/45852/g4ll,2024-11-29 05:10:00,1.09,1.02,1.05,220,238,195,57,31,26,52,31,21,12,5,7,0,-1,+1,66%,63%,69%,141,150,131,26%,21%,35%,8,5,3,8,6,2
188,https://vlr.gg/player/37393/luca,2024-11-29 05:10:00,0.91,0.97,0.93,177,169,194,50,24,26,53,28,25,16,7,9,-3,0,-3,66%,61%,72%,109,102,117,34%,27%,43%,5,3,2,8,3,5
189,https://vlr.gg/player/31845/chay,2024-11-29 05:10:00,0.78,1.01,0.89,161,142,180,37,17,20,50,27,23,24,13,11,-1,+1,-2,69%,63%,75%,110,97,123,37%,36%,38%,8,4,4,9,3,6
190,https://vlr.gg/player/45853/r1va,2024-11-29 05:10:00,0.85,0.87,0.86,154,152,159,39,17,22,50,28,22,24,18,6,-2,-1,-1,70%,68%,72%,107,108,106,24%,23%,26%,2,1,1,4,2,2
191,https://vlr.gg/player/32823/lafura,2024-11-29 04:35:00,1.17,1.18,1.17,241,225,262,63,25,38,50,21,29,15,6,9,+5,+3,+2,69%,62%,75%,165,154,175,27%,29%,26%,10,4,6,5,1,4
192,https://vlr.gg/player/49681/keisu,2024-11-29 04:35:00,1.24,0.95,1.08,253,245,224,64,32,32,55,23,32,8,3,5,-2,-6,+4,65%,62%,68%,147,158,137,24%,27%,21%,15,4,11,17,10,7
193,https://vlr.gg/player/2508/kenmohororo,2024-11-29 04:35:00,0.83,1.28,1.08,189,131,238,47,15,32,46,23,23,41,13,28,+4,+3,+1,70%,59%,80%,116,76,150,27%,34%,24%,6,4,2,2,1,1
194,https://vlr.gg/player/34705/e9lair,2024-11-29 04:35:00,0.74,1.04,0.90,155,111,186,38,13,25,46,22,24,21,8,13,-1,0,-1,69%,65%,73%,111,81,137,20%,16%,23%,3,3,0,4,3,1
195,https://vlr.gg/player/17091/zan,2024-11-29 04:35:00,0.90,0.89,0.90,174,189,168,43,20,23,53,27,26,42,19,23,+4,+2,+2,81%,79%,83%,113,115,110,18%,18%,18%,8,3,5,4,1,3
196,https://vlr.gg/player/2399/fifty,2024-11-29 04:35:00,1.41,1.10,1.27,233,264,189,60,39,21,44,26,18,25,17,8,+3,+2,+1,80%,83%,76%,151,169,130,30%,33%,26%,6,2,4,3,0,3
197,https://vlr.gg/player/43041/zerurun,2024-11-29 04:35:00,1.08,1.07,1.07,197,206,214,57,31,26,52,30,22,12,5,7,0,-3,+3,70%,65%,76%,135,129,143,21%,25%,17%,7,4,3,7,7,0
198,https://vlr.gg/player/49682/kaily,2024-11-29 04:35:00,1.05,0.91,0.99,177,178,192,45,25,20,51,26,25,34,20,14,-6,-1,-5,69%,75%,62%,141,130,153,24%,34%,18%,2,2,0,8,3,5
199,https://vlr.gg/player/11625/muushock,2024-11-29 04:35:00,0.61,1.13,0.85,147,130,183,40,16,24,50,31,19,28,14,14,-5,-5,0,68%,68%,68%,103,92,116,22%,14%,31%,3,0,3,8,5,3
200,https://vlr.gg/player/43036/whizz,2024-11-29 04:35:00,0.70,0.99,0.83,185,178,205,48,23,25,58,37,21,19,13,6,-2,-1,-1,69%,70%,68%,125,119,131,23%,25%,21%,14,8,6,16,9,7
201,https://vlr.gg/player/1960/eko,2024-11-29 04:10:00,1.15,1.23,1.19,287,268,301,70,32,38,55,26,29,15,3,12,+6,-4,+10,67%,58%,76%,176,169,183,19%,24%,16%,18,6,12,12,10,2
202,https://vlr.gg/player/7888/blackwiz,2024-11-29 04:10:00,1.14,1.18,1.16,177,157,190,45,18,27,40,19,21,28,16,12,+3,+1,+2,81%,85%,78%,117,108,125,19%,13%,23%,5,2,3,2,1,1
203,https://vlr.gg/player/1027/marin,2024-11-29 04:10:00,0.71,1.29,1.02,203,147,244,48,17,31,49,25,24,21,7,14,0,-2,+2,76%,67%,84%,137,101,169,32%,33%,31%,4,0,4,4,2,2
204,https://vlr.gg/player/6676/thiefy,2024-11-29 04:10:00,1.03,0.84,0.93,156,208,120,38,22,16,45,25,20,24,13,11,+1,+4,-3,69%,76%,62%,110,146,79,30%,27%,33%,5,4,1,4,0,4
205,https://vlr.gg/player/1952/esperanza,2024-11-29 04:10:00,0.63,0.93,0.79,189,154,214,47,18,29,53,27,26,13,4,9,-2,-4,+2,64%,52%,76%,124,107,140,30%,30%,30%,7,2,5,9,6,3
206,https://vlr.gg/player/47467/ady,2024-11-29 04:10:00,1.06,1.28,1.16,228,218,248,57,27,30,48,26,22,21,12,9,+3,+1,+2,70%,65%,76%,143,133,154,20%,17%,23%,6,4,2,3,3,0
207,https://vlr.gg/player/23971/ask,2024-11-29 04:10:00,0.89,1.47,1.16,234,203,266,57,25,32,49,31,18,17,9,8,-1,-4,+3,73%,73%,73%,149,128,174,26%,24%,28%,5,0,5,6,4,2
208,https://vlr.gg/player/34785/yowamu,2024-11-29 04:10:00,0.84,1.10,0.96,231,213,258,54,26,28,56,32,24,18,7,11,-8,-8,0,69%,65%,73%,162,151,175,32%,33%,30%,10,5,5,18,13,5
209,https://vlr.gg/player/10658/kurozooted,2024-11-29 04:10:00,0.81,0.83,0.82,141,146,149,38,20,18,49,27,22,22,10,12,-3,-3,0,71%,70%,73%,101,106,96,26%,27%,25%,3,0,3,6,3,3
210,https://vlr.gg/player/47469/scope,2024-11-29 04:10:00,0.90,0.64,0.78,140,168,113,36,22,14,46,25,21,4,2,2,+1,+1,0,67%,62%,73%,95,114,73,24%,28%,19%,7,3,4,6,2,4
211,https://vlr.gg/player/13002/akame,2024-11-29 04:00:00,,,,234,,,39,,,32,,,18,,,,,,,,,,,,,,,,,,,,
212,https://vlr.gg/player/6672/meiy,2024-11-29 04:00:00,,,,227,,,38,,,35,,,6,,,,,,,,,,,,,,,,,,,,
213,https://vlr.gg/player/10627/art,2024-11-29 04:00:00,,,,217,,,33,,,39,,,20,,,,,,,,,,,,,,,,,,,,
214,https://vlr.gg/player/21438/ssees,2024-11-29 04:00:00,,,,185,,,33,,,31,,,31,,,,,,,,,,,,,,,,,,,,
215,https://vlr.gg/player/4052/jinboong,2024-11-29 04:00:00,,,,160,,,31,,,34,,,5,,,,,,,,,,,,,,,,,,,,
216,https://vlr.gg/player/9801/f0rsaken,2024-11-29 04:00:00,,,,230,,,38,,,35,,,15,,,,,,,,,,,,,,,,,,,,
217,https://vlr.gg/player/7378/jinggg,2024-11-29 04:00:00,,,,208,,,35,,,37,,,10,,,,,,,,,,,,,,,,,,,,
218,https://vlr.gg/player/9800/mindfreak,2024-11-29 04:00:00,,,,183,,,35,,,33,,,17,,,,,,,,,,,,,,,,,,,,
219,https://vlr.gg/player/17086/something,2024-11-29 04:00:00,,,,182,,,35,,,33,,,8,,,,,,,,,,,,,,,,,,,,
220,https://vlr.gg/player/9803/d4v41,2024-11-29 04:00:00,,,,165,,,28,,,36,,,9,,,,,,,,,,,,,,,,,,,,
221,https://vlr.gg/player/33417/fukuken,2024-11-29 03:50:00,1.18,1.02,1.11,242,269,212,51,31,20,50,29,21,34,23,11,-1,-1,0,71%,76%,66%,157,179,133,30%,29%,31%,1,0,1,2,1,1
222,https://vlr.gg/player/40734/hands,2024-11-29 03:50:00,0.97,0.94,0.96,216,227,206,46,27,19,49,26,23,14,9,5,+8,+4,+4,83%,88%,76%,147,151,144,25%,29%,20%,10,5,5,2,1,1
223,https://vlr.gg/player/10661/phantom,2024-11-29 03:50:00,0.95,0.93,0.94,189,186,191,43,24,19,47,25,22,21,12,9,-6,-5,-1,67%,68%,66%,123,118,128,27%,29%,25%,4,1,3,10,6,4
224,https://vlr.gg/player/48430/rui,2024-11-29 03:50:00,0.50,1.20,0.82,192,145,256,43,16,27,52,30,22,12,7,5,0,0,0,67%,56%,79%,133,98,174,28%,18%,39%,10,6,4,10,6,4
225,https://vlr.gg/player/49680/airy,2024-11-29 03:50:00,0.50,0.56,0.53,122,129,116,30,16,14,50,27,23,9,5,4,-4,-2,-2,62%,62%,62%,77,79,75,41%,41%,41%,5,3,2,9,5,4
226,https://vlr.gg/player/46355/jerry,2024-11-29 03:50:00,1.20,1.35,1.28,247,219,267,59,25,34,42,19,23,11,3,8,+3,+2,+1,75%,69%,79%,166,141,187,31%,30%,31%,8,4,4,5,2,3
227,https://vlr.gg/player/43072/jinbey,2024-11-29 03:50:00,1.27,1.22,1.24,285,318,260,63,31,32,51,25,26,16,10,6,+4,+1,+3,81%,79%,82%,190,209,174,28%,26%,30%,12,6,6,8,5,3
228,https://vlr.gg/player/10642/jan,2024-11-29 03:50:00,0.93,1.38,1.17,207,158,253,45,19,26,36,16,20,20,5,15,-2,-2,0,78%,72%,82%,144,113,171,30%,28%,31%,4,2,2,6,4,2
229,https://vlr.gg/player/17111/allen,2024-11-29 03:50:00,0.77,1.26,1.04,189,181,195,40,19,21,42,21,21,35,19,16,0,-1,+1,79%,76%,82%,127,114,137,28%,25%,31%,5,2,3,5,3,2
230,https://vlr.gg/player/25279/sakura,2024-11-29 03:50:00,1.05,0.84,0.93,176,194,161,41,21,20,47,19,28,28,14,14,-2,-1,-1,75%,86%,65%,119,137,103,33%,32%,35%,4,0,4,6,1,5
231,https://vlr.gg/player/30575/r1sen,2024-11-29 03:30:00,1.57,1.54,1.56,222,234,200,30,18,12,19,9,10,12,10,2,+3,+3,0,84%,86%,80%,144,157,125,40%,41%,39%,6,5,1,3,2,1
232,https://vlr.gg/player/18702/deadly10,2024-11-29 03:30:00,1.48,1.28,1.40,247,283,215,34,23,11,26,12,14,8,5,3,0,0,0,68%,77%,53%,168,192,134,32%,39%,23%,6,3,3,6,3,3
233,https://vlr.gg/player/40912/123,2024-11-29 03:30:00,1.60,1.09,1.39,285,328,181,35,27,8,26,12,14,15,7,8,+1,+4,-3,73%,82%,60%,190,220,146,41%,39%,46%,6,5,1,5,1,4
234,https://vlr.gg/player/19231/kibojn,2024-11-29 03:30:00,1.41,0.95,1.22,204,202,194,28,18,10,23,10,13,12,9,3,+2,+2,0,70%,77%,60%,119,119,118,44%,45%,42%,3,2,1,1,0,1
235,https://vlr.gg/player/44919/aplycs,2024-11-29 03:30:00,0.98,1.16,1.05,189,155,236,25,12,13,22,12,10,20,12,8,-1,-1,0,76%,73%,80%,138,113,174,29%,28%,29%,0,0,0,1,1,0
236,https://vlr.gg/player/30877/lilboii,2024-11-29 03:30:00,0.92,0.80,0.85,166,161,175,24,10,14,29,10,19,7,3,4,0,0,0,73%,87%,64%,118,130,110,32%,26%,39%,1,0,1,1,0,1
237,https://vlr.gg/player/37375/chanyboi,2024-11-29 03:30:00,1.10,0.67,0.84,188,267,150,25,15,10,31,11,20,11,4,7,-2,-2,0,59%,80%,45%,127,171,98,37%,32%,43%,2,1,1,4,3,1
238,https://vlr.gg/player/46062/hyperfiction,2024-11-29 03:30:00,0.92,0.59,0.62,212,276,176,27,15,12,34,13,21,5,2,3,+2,+4,-2,68%,80%,59%,140,168,121,33%,36%,31%,9,5,4,7,1,6
239,https://vlr.gg/player/48108/mrdeagle,2024-11-29 03:30:00,1.00,0.33,0.59,140,200,111,18,11,7,29,9,20,6,3,3,-3,-1,-2,57%,87%,36%,102,146,72,38%,40%,35%,2,1,1,5,2,3
240,https://vlr.gg/player/10760/smokea,2024-11-29 03:30:00,0.69,0.65,0.56,164,182,167,22,10,12,29,11,18,8,4,4,-2,+2,-4,59%,80%,45%,115,122,111,26%,23%,28%,2,2,0,4,0,4
241,https://vlr.gg/player/48925/raxcal,2024-11-29 03:00:00,0.84,1.66,1.22,271,244,309,55,25,30,45,29,16,17,6,11,+9,+1,+8,73%,69%,79%,185,165,207,25%,34%,19%,17,7,10,8,6,2
242,https://vlr.gg/player/48927/xuka,2024-11-29 03:00:00,1.07,0.93,1.00,204,223,186,40,24,16,43,24,19,22,8,14,-5,-4,-1,75%,69%,82%,141,146,135,22%,30%,16%,2,0,2,7,4,3
243,https://vlr.gg/player/48926/sirius,2024-11-29 03:00:00,0.73,1.20,0.95,191,152,233,42,18,24,43,24,19,12,1,11,+1,0,+1,73%,63%,86%,117,103,133,26%,33%,22%,2,1,1,1,1,0
244,https://vlr.gg/player/48923/vista,2024-11-29 03:00:00,0.51,1.20,0.83,191,156,233,40,15,25,50,30,20,17,8,9,-2,-6,+4,70%,63%,79%,129,114,146,19%,22%,17%,6,2,4,8,8,0
245,https://vlr.gg/player/48924/f0rest,2024-11-29 03:00:00,0.81,0.79,0.80,167,151,186,35,17,18,46,24,22,23,8,15,-3,+1,-4,72%,69%,75%,115,103,128,24%,31%,20%,3,2,1,6,1,5
246,https://vlr.gg/player/42710/froz,2024-11-29 03:00:00,1.36,1.40,1.38,248,257,240,52,26,26,37,19,18,23,17,6,-3,-5,+2,75%,68%,81%,170,182,159,28%,29%,27%,4,0,4,7,5,2
247,https://vlr.gg/player/4060/daegi,2024-11-29 03:00:00,0.97,1.51,1.26,260,198,309,55,19,36,44,22,22,14,6,8,+4,0,+4,83%,71%,94%,167,139,191,23%,20%,26%,8,4,4,4,4,0
248,https://vlr.gg/player/4666/acme,2024-11-29 03:00:00,0.98,0.99,0.98,205,230,185,43,21,22,44,24,20,31,19,12,-1,-1,0,78%,82%,75%,133,140,126,23%,19%,29%,4,1,3,5,2,3
249,https://vlr.gg/player/42769/wezzy,2024-11-29 03:00:00,0.43,1.38,0.94,201,153,240,40,12,28,46,28,18,12,6,6,+2,+1,+1,80%,68%,91%,136,107,162,28%,21%,36%,11,5,6,9,4,5
250,https://vlr.gg/player/42771/nameless,2024-11-29 03:00:00,1.02,0.75,0.87,168,180,159,37,18,19,41,20,21,21,14,7,-2,-3,+1,72%,79%,66%,119,131,108,35%,32%,38%,3,0,3,5,3,2
251,https://vlr.gg/player/5476/minty,2024-11-29 02:00:00,1.77,1.38,1.58,276,322,227,34,20,14,16,8,8,13,9,4,+4,+1,+3,91%,88%,94%,183,226,138,33%,31%,36%,5,1,4,1,0,1
252,https://vlr.gg/player/10584/seoldam,2024-11-29 02:00:00,1.38,1.47,1.42,294,285,302,38,20,18,19,8,11,8,2,6,+6,+4,+2,82%,82%,81%,168,152,185,20%,17%,23%,8,6,2,2,2,0
253,https://vlr.gg/player/29843/yatsuka,2024-11-29 02:00:00,1.38,1.04,1.22,164,189,132,22,13,9,12,5,7,10,5,5,+3,0,+3,73%,76%,69%,105,119,91,38%,32%,45%,4,1,3,1,1,0
254,https://vlr.gg/player/29841/caedye,2024-11-29 02:00:00,1.15,1.19,1.17,242,236,252,29,15,14,21,11,10,11,3,8,-1,-1,0,79%,82%,75%,165,150,181,21%,23%,18%,3,1,2,4,2,2
255,https://vlr.gg/player/4663/joxjo,2024-11-29 02:00:00,0.94,1.32,1.12,196,137,262,19,6,13,20,9,11,29,16,13,+1,-1,+2,91%,88%,94%,126,96,157,16%,20%,13%,3,1,2,2,2,0
256,https://vlr.gg/player/34760/meatpien,2024-11-29 02:00:00,1.28,0.69,0.97,222,284,169,24,16,8,27,13,14,5,2,3,0,-1,+1,48%,56%,41%,139,167,113,30%,41%,21%,2,0,2,2,1,1
257,https://vlr.gg/player/13008/serment,2024-11-29 02:00:00,0.81,0.63,0.71,166,172,164,17,10,7,28,13,15,11,5,6,-2,-2,0,58%,63%,53%,115,107,122,21%,21%,21%,1,0,1,3,2,1
258,https://vlr.gg/player/25544/rheify,2024-11-29 02:00:00,0.42,0.90,0.67,177,93,256,21,6,15,29,14,15,2,1,1,-2,-3,+1,55%,50%,59%,100,61,138,18%,14%,20%,4,0,4,6,3,3
259,https://vlr.gg/player/34779/marble,2024-11-29 02:00:00,1.04,0.38,0.66,145,231,67,16,13,3,26,12,14,3,1,2,-3,-1,-2,55%,56%,53%,99,142,59,36%,38%,31%,2,2,0,5,3,2
260,https://vlr.gg/player/25543/alois,2024-11-29 02:00:00,0.16,0.53,0.31,87,60,109,10,2,8,32,16,16,6,4,2,-6,-3,-3,45%,50%,41%,58,42,73,24%,17%,32%,1,1,0,7,4,3
261,https://vlr.gg/player/17169/muto,2024-11-29 02:00:00,1.47,1.20,1.32,249,259,245,53,24,29,44,18,26,25,14,11,+10,+5,+5,74%,81%,69%,159,162,156,28%,24%,32%,12,5,7,2,0,2
262,https://vlr.gg/player/25915/brian,2024-11-29 02:00:00,1.01,1.23,1.13,228,201,240,53,21,32,47,21,26,18,8,10,+2,+2,0,69%,70%,69%,144,142,147,30%,28%,32%,5,3,2,3,1,2
263,https://vlr.gg/player/25027/icebear,2024-11-29 02:00:00,0.98,0.81,0.89,194,211,183,41,20,21,47,20,27,16,6,10,-2,-3,+1,66%,59%,71%,130,139,123,22%,20%,25%,10,4,6,12,7,5
264,https://vlr.gg/player/37390/bnn,2024-11-29 02:00:00,0.97,0.77,0.86,173,184,165,39,19,20,46,19,27,14,7,7,-3,-3,0,71%,74%,69%,120,132,111,30%,25%,36%,3,0,3,6,3,3
265,https://vlr.gg/player/31841/take,2024-11-29 02:00:00,0.75,0.91,0.84,162,146,170,33,13,20,44,20,24,26,13,13,+1,-2,+3,69%,74%,66%,108,96,117,26%,33%,23%,5,1,4,4,3,1
266,https://vlr.gg/player/1971/oitan,2024-11-29 02:00:00,1.30,1.10,1.22,225,234,222,48,30,18,41,22,19,28,9,19,+6,+4,+2,82%,83%,81%,152,152,154,26%,32%,21%,9,4,5,3,0,3
267,https://vlr.gg/player/2671/popogachi,2024-11-29 02:00:00,1.14,1.21,1.17,251,237,272,57,30,27,45,25,20,11,8,3,-3,-5,+2,76%,74%,78%,166,161,171,26%,28%,23%,7,2,5,10,7,3
268,https://vlr.gg/player/44613/yamada,2024-11-29 02:00:00,1.07,1.05,1.06,205,217,199,44,24,20,44,25,19,34,23,11,-1,-1,0,79%,83%,74%,138,152,120,25%,25%,24%,2,1,1,3,2,1
269,https://vlr.gg/player/1973/ripablo,2024-11-29 02:00:00,1.04,0.84,0.96,159,165,160,37,21,16,40,21,19,32,23,9,-2,-2,0,77%,77%,78%,104,106,101,24%,21%,30%,1,0,1,3,2,1
270,https://vlr.gg/player/47481/frxeez,2024-11-29 02:00:00,0.74,0.81,0.77,199,214,175,42,25,17,49,29,20,10,4,6,-8,-5,-3,68%,60%,78%,123,130,115,15%,16%,14%,8,6,2,16,11,5
271,https://vlr.gg/player/40726/gwangboong,2024-11-29 02:00:00,1.44,1.59,1.51,315,323,302,50,28,22,27,17,10,4,3,1,+11,+6,+5,83%,79%,89%,215,213,217,25%,24%,29%,15,10,5,4,4,0
272,https://vlr.gg/player/10769/nobita,2024-11-29 02:00:00,1.60,1.31,1.47,286,302,267,42,26,16,27,16,11,21,10,11,+3,+1,+2,88%,92%,83%,191,199,181,25%,32%,17%,3,1,2,0,0,0
273,https://vlr.gg/player/29840/yuran,2024-11-29 02:00:00,1.10,0.97,1.04,186,187,189,29,17,12,25,14,11,9,4,5,-2,-1,-1,69%,71%,67%,134,136,132,33%,30%,38%,3,2,1,5,3,2
274,https://vlr.gg/player/10628/misaya,2024-11-29 02:00:00,0.90,1.13,1.00,139,113,171,21,10,11,23,14,9,24,16,8,-2,-3,+1,74%,71%,78%,83,63,110,15%,21%,11%,3,0,3,5,3,2
275,https://vlr.gg/player/48431/kippei,2024-11-29 02:00:00,0.73,1.21,0.94,151,119,197,23,10,13,27,16,11,21,11,10,+2,-1,+3,81%,75%,89%,99,84,118,26%,24%,29%,3,0,3,1,1,0
276,https://vlr.gg/player/2137/skyfull,2024-11-29 02:00:00,0.62,1.44,1.09,241,128,324,35,7,28,35,16,19,13,7,6,+2,-1,+3,71%,72%,71%,153,88,203,21%,21%,21%,6,0,6,4,1,3
277,https://vlr.gg/player/10640/kurolia,2024-11-29 02:00:00,1.16,0.83,0.97,206,243,174,30,16,14,32,14,18,12,5,7,+3,+1,+2,69%,78%,63%,131,153,114,44%,50%,38%,5,1,4,2,0,2
278,https://vlr.gg/player/43019/ming,2024-11-29 02:00:00,0.59,0.79,0.71,153,132,166,23,9,14,31,14,17,4,1,3,-4,-2,-2,67%,56%,75%,106,94,115,33%,39%,30%,0,0,0,4,2,2
279,https://vlr.gg/player/17145/paint,2024-11-29 02:00:00,0.71,0.59,0.64,123,131,117,18,8,10,33,15,18,7,3,4,-4,-1,-3,62%,61%,63%,85,88,83,22%,19%,25%,1,0,1,5,1,4
280,https://vlr.gg/player/40739/xui,2024-11-29 02:00:00,0.68,0.59,0.63,143,174,126,23,12,11,34,15,19,3,1,2,-9,-7,-2,50%,50%,50%,94,105,86,26%,23%,30%,3,3,0,12,10,2
281,https://vlr.gg/player/27458/esco,2024-11-29 02:00:00,1.31,1.94,1.60,359,303,395,60,26,34,33,20,13,9,8,1,+18,+9,+9,76%,74%,78%,209,184,237,21%,17%,31%,20,10,10,2,1,1
282,https://vlr.gg/player/34825/han,2024-11-29 02:00:00,0.69,1.84,1.22,220,159,302,37,13,24,31,20,11,23,16,7,0,0,0,82%,78%,87%,144,95,201,23%,25%,21%,3,2,1,3,2,1
283,https://vlr.gg/player/43066/niki,2024-11-29 02:00:00,1.22,0.86,1.05,183,229,134,33,24,9,31,19,12,15,5,10,-2,-1,-1,70%,67%,74%,132,165,93,20%,22%,18%,2,1,1,4,2,2
284,https://vlr.gg/player/49679/abu,2024-11-29 02:00:00,1.22,0.80,1.03,146,196,102,27,19,8,29,17,12,21,14,7,+1,+2,-1,76%,78%,74%,97,131,58,33%,32%,37%,3,2,1,2,0,2
285,https://vlr.gg/player/29837/caspell,2024-11-29 02:00:00,0.66,0.91,0.78,191,186,188,32,17,15,38,23,15,21,13,8,-5,-1,-4,74%,70%,78%,125,125,124,24%,20%,31%,3,3,0,8,4,4
286,https://vlr.gg/player/25259/masa,2024-11-29 02:00:00,0.98,1.08,1.03,190,166,232,34,13,21,35,16,19,7,2,5,-3,+1,-4,66%,65%,67%,145,123,165,36%,47%,31%,4,2,2,7,1,6
287,https://vlr.gg/player/48346/ikura,2024-11-29 02:00:00,0.88,1.07,0.98,243,233,250,40,18,22,43,19,24,7,2,5,+2,+1,+1,62%,52%,70%,161,149,171,37%,39%,35%,9,5,4,7,4,3
288,https://vlr.gg/player/48347/mrsa,2024-11-29 02:00:00,0.71,0.95,0.84,191,157,222,30,11,19,38,18,20,14,5,9,-2,-1,-1,74%,70%,78%,130,107,149,28%,21%,32%,1,1,0,3,2,1
289,https://vlr.gg/player/40733/raysen,2024-11-29 02:00:00,0.46,1.09,0.80,167,126,203,28,9,19,37,18,19,14,3,11,-6,-4,-2,62%,52%,70%,105,75,131,20%,17%,23%,3,0,3,9,4,5
290,https://vlr.gg/player/48348/yuu,2024-11-29 02:00:00,0.55,0.92,0.75,147,144,153,29,11,18,36,20,16,11,6,5,-3,0,-3,60%,57%,63%,100,93,105,43%,55%,35%,2,2,0,5,2,3
291,https://vlr.gg/player/10718/rowancy,2024-11-28 18:45:00,0.41,1.78,1.01,224,123,374,31,9,22,31,20,11,8,1,7,-1,-2,+1,67%,45%,94%,161,90,254,36%,36%,36%,3,1,2,4,3,1
292,https://vlr.gg/player/20809/p4nd4,2024-11-28 18:45:00,0.95,0.88,0.92,219,227,188,29,16,13,32,20,12,8,7,1,0,+3,-3,69%,73%,65%,133,139,125,39%,39%,38%,4,4,0,4,1,3
293,https://vlr.gg/player/31476/mephisto,2024-11-28 18:45:00,0.72,1.03,0.85,189,167,219,25,12,13,31,20,11,4,1,3,0,+1,-1,51%,50%,53%,126,111,144,31%,31%,30%,6,2,4,6,1,5
294,https://vlr.gg/player/26757/otaq,2024-11-28 18:45:00,0.66,0.60,0.63,138,143,146,19,11,8,34,19,15,11,4,7,0,-2,+2,62%,50%,76%,88,82,95,15%,14%,15%,3,1,2,3,3,0
295,https://vlr.gg/player/15931/peloncito,2024-11-28 18:45:00,0.42,0.78,0.58,144,128,167,19,8,11,32,20,12,8,6,2,-4,-4,0,59%,50%,71%,92,81,107,31%,40%,26%,1,1,0,5,5,0
296,https://vlr.gg/player/6450/korsonix,2024-11-28 18:45:00,2.24,1.80,1.99,366,392,342,53,25,28,21,9,12,11,4,7,+8,+4,+4,82%,88%,77%,247,263,235,25%,29%,21%,10,5,5,2,1,1
297,https://vlr.gg/player/8286/glyph,2024-11-28 18:45:00,0.81,1.78,1.35,267,191,333,40,12,28,22,14,8,8,2,6,-1,-2,+1,69%,53%,82%,173,124,210,29%,19%,37%,5,1,4,6,3,3
298,https://vlr.gg/player/8792/xhowi,2024-11-28 18:45:00,0.77,1.25,1.04,211,155,245,28,10,18,27,14,13,16,6,10,+1,0,+1,77%,71%,82%,136,103,161,39%,33%,43%,5,1,4,4,1,3
299,https://vlr.gg/player/17694/prask,2024-11-28 18:45:00,0.73,1.26,1.03,180,182,185,28,12,16,26,16,10,16,2,14,+1,+2,-1,82%,76%,86%,120,113,125,35%,39%,33%,2,2,0,1,0,1
300,https://vlr.gg/player/586/sickly,2024-11-28 18:45:00,0.33,0.95,0.77,130,85,149,9,1,8,11,4,7,4,1,3,0,0,0,71%,60%,75%,75,72,77,18%,11%,21%,0,0,0,0,0,0
301,https://vlr.gg/player/1323/rainmaker,2024-11-28 18:45:00,0.18,0.56,0.35,79,77,81,2,1,1,16,10,6,10,3,7,-4,-3,-1,55%,50%,60%,69,66,73,4%,0%,10%,0,0,0,4,3,1
302,https://vlr.gg/player/3983/virtyy,2024-11-28 17:00:00,1.71,2.15,2.02,414,358,439,55,14,41,19,7,12,1,0,1,+12,+4,+8,79%,70%,83%,250,231,257,38%,29%,43%,15,5,10,3,1,2
303,https://vlr.gg/player/10557/darker,2024-11-28 17:00:00,0.99,1.74,1.52,265,185,295,34,7,27,18,7,11,22,5,17,0,+1,-1,85%,90%,83%,170,108,196,33%,20%,38%,3,1,2,3,0,3
304,https://vlr.gg/player/24865/acrian,2024-11-28 17:00:00,1.92,0.87,1.17,188,347,124,23,13,10,18,6,12,20,5,15,-2,0,-2,85%,90%,83%,116,232,69,29%,48%,15%,0,0,0,2,0,2
305,https://vlr.gg/player/7616/feniz,2024-11-28 17:00:00,0.90,1.18,1.10,173,192,164,21,7,14,17,7,10,8,4,4,+2,-1,+3,79%,80%,79%,121,139,113,41%,35%,45%,4,1,3,2,2,0
306,https://vlr.gg/player/8056/mited,2024-11-28 17:00:00,0.58,0.81,0.74,140,95,161,16,4,12,21,6,15,12,1,11,-2,0,-2,76%,80%,75%,112,70,129,25%,67%,20%,0,0,0,2,0,2
307,https://vlr.gg/player/7618/theory,2024-11-28 17:00:00,0.71,1.00,0.79,170,141,233,20,12,8,27,19,8,3,2,1,0,0,0,50%,54%,40%,123,105,164,43%,52%,33%,1,1,0,1,1,0
308,https://vlr.gg/player/38921/fotzy,2024-11-28 17:00:00,0.78,0.57,0.72,175,186,152,21,16,5,30,21,9,4,2,2,-2,-1,-1,59%,58%,60%,103,109,88,54%,60%,40%,7,5,2,9,6,3
309,https://vlr.gg/player/35583/edu,2024-11-28 17:00:00,0.77,0.54,0.70,159,165,155,18,13,5,32,22,10,6,5,1,0,+1,-1,53%,54%,50%,107,107,107,42%,46%,36%,1,1,0,1,0,1
310,https://vlr.gg/player/12955/danger,2024-11-28 17:00:00,0.52,1.01,0.66,167,135,249,19,10,9,31,22,9,8,5,3,-5,-2,-3,56%,50%,70%,118,106,147,39%,31%,53%,2,2,0,7,4,3
311,https://vlr.gg/player/8057/josegxbo,2024-11-28 17:00:00,0.52,0.74,0.58,135,121,170,15,9,6,29,20,9,13,8,5,-3,-4,+1,68%,63%,80%,78,71,94,30%,29%,31%,1,0,1,4,4,0
312,https://vlr.gg/player/10627/art,2024-11-28 07:15:00,,,,252,,,57,,,37,,,21,,,,,,,,,,,,,,,,,,,,
313,https://vlr.gg/player/6672/meiy,2024-11-28 07:15:00,,,,202,,,45,,,46,,,12,,,,,,,,,,,,,,,,,,,,
314,https://vlr.gg/player/4052/jinboong,2024-11-28 07:15:00,,,,201,,,46,,,43,,,14,,,,,,,,,,,,,,,,,,,,
315,https://vlr.gg/player/13002/akame,2024-11-28 07:15:00,,,,184,,,44,,,48,,,37,,,,,,,,,,,,,,,,,,,,
316,https://vlr.gg/player/21438/ssees,2024-11-28 07:15:00,,,,148,,,33,,,34,,,31,,,,,,,,,,,,,,,,,,,,
317,https://vlr.gg/player/3021/biank,2024-11-28 07:15:00,,,,207,,,42,,,42,,,23,,,,,,,,,,,,,,,,,,,,
318,https://vlr.gg/player/3045/luok1ng,2024-11-28 07:15:00,,,,188,,,42,,,47,,,19,,,,,,,,,,,,,,,,,,,,
319,https://vlr.gg/player/4712/heybay,2024-11-28 07:15:00,,,,179,,,44,,,41,,,29,,,,,,,,,,,,,,,,,,,,
320,https://vlr.gg/player/4770/fengf,2024-11-28 07:15:00,,,,169,,,40,,,48,,,9,,,,,,,,,,,,,,,,,,,,
321,https://vlr.gg/player/37494/kai,2024-11-28 07:15:00,,,,158,,,40,,,49,,,6,,,,,,,,,,,,,,,,,,,,
322,https://vlr.gg/player/25048/sid,2024-11-28 05:20:00,1.40,1.47,1.45,251,256,251,38,16,22,23,11,12,14,5,9,+10,+1,+9,85%,76%,92%,162,163,161,28%,35%,22%,13,4,9,3,3,0
323,https://vlr.gg/player/27444/banger,2024-11-28 05:20:00,1.35,1.44,1.41,276,246,292,41,17,24,26,10,16,14,4,10,+8,+1,+7,76%,71%,79%,169,146,186,51%,40%,60%,8,1,7,0,0,0
324,https://vlr.gg/player/42772/xross,2024-11-28 05:20:00,1.58,1.05,1.27,262,318,211,35,17,18,24,11,13,19,9,10,+1,+1,0,85%,88%,83%,178,205,158,26%,19%,35%,3,2,1,2,1,1
325,https://vlr.gg/player/24979/cloy,2024-11-28 05:20:00,0.50,1.37,1.00,185,129,221,29,8,21,25,14,11,19,5,14,0,-2,+2,78%,59%,92%,121,79,151,27%,32%,26%,5,2,3,5,4,1
326,https://vlr.gg/player/42793/kally,2024-11-28 05:20:00,0.84,0.76,0.79,122,124,134,19,8,11,25,10,15,11,6,5,0,0,0,76%,71%,79%,92,84,97,22%,17%,25%,1,0,1,1,0,1
327,https://vlr.gg/player/42749/godsb,2024-11-28 05:20:00,1.01,1.09,1.04,172,169,195,28,15,13,24,14,10,9,3,6,-3,-2,-1,78%,79%,76%,111,100,128,50%,54%,46%,2,0,2,5,2,3
328,https://vlr.gg/player/42254/delas,2024-11-28 05:20:00,0.73,1.01,0.84,223,213,230,27,14,13,37,22,15,14,8,6,-7,-7,0,59%,58%,59%,148,144,153,21%,19%,23%,2,1,1,9,8,1
329,https://vlr.gg/player/9236/manggong,2024-11-28 05:20:00,0.83,0.63,0.75,166,168,161,23,14,9,34,19,15,12,7,5,-1,-2,+1,59%,58%,59%,101,106,93,25%,33%,16%,1,0,1,2,2,0
330,https://vlr.gg/player/25053/wolverine,2024-11-28 05:20:00,0.84,0.61,0.74,170,168,164,24,14,10,34,21,13,7,6,1,-5,-5,0,56%,50%,65%,104,110,96,28%,32%,24%,2,1,1,7,6,1
331,https://vlr.gg/player/9192/cloudy,2024-11-28 05:20:00,0.60,0.90,0.73,155,120,205,21,10,11,33,20,13,11,6,5,-3,-2,-1,63%,58%,71%,109,78,152,49%,44%,52%,4,1,3,7,3,4
332,https://vlr.gg/player/28400/hyunmin,2024-11-28 04:00:00,,,,225,,,54,,,50,,,14,,,,,,,,,,,,,,,,,,,,
333,https://vlr.gg/player/35013/flashback,2024-11-28 04:00:00,,,,212,,,50,,,47,,,12,,,,,,,,,,,,,,,,,,,,
334,https://vlr.gg/player/1916/free1ng,2024-11-28 04:00:00,,,,187,,,42,,,46,,,16,,,,,,,,,,,,,,,,,,,,
335,https://vlr.gg/player/34982/athan,2024-11-28 04:00:00,,,,182,,,41,,,54,,,26,,,,,,,,,,,,,,,,,,,,
336,https://vlr.gg/player/4462/mako,2024-11-28 04:00:00,,,,179,,,40,,,40,,,20,,,,,,,,,,,,,,,,,,,,
337,https://vlr.gg/player/7378/jinggg,2024-11-28 04:00:00,,,,244,,,59,,,44,,,16,,,,,,,,,,,,,,,,,,,,
338,https://vlr.gg/player/9800/mindfreak,2024-11-28 04:00:00,,,,228,,,52,,,44,,,20,,,,,,,,,,,,,,,,,,,,
339,https://vlr.gg/player/9801/f0rsaken,2024-11-28 04:00:00,,,,222,,,51,,,48,,,18,,,,,,,,,,,,,,,,,,,,
340,https://vlr.gg/player/17086/something,2024-11-28 04:00:00,,,,186,,,43,,,43,,,12,,,,,,,,,,,,,,,,,,,,
341,https://vlr.gg/player/9803/d4v41,2024-11-28 04:00:00,,,,127,,,32,,,48,,,26,,,,,,,,,,,,,,,,,,,,
342,https://vlr.gg/player/9783/doenmo,2024-11-28 03:00:00,1.67,1.54,1.56,258,259,259,27,6,21,12,2,10,21,4,17,0,0,0,90%,100%,88%,166,148,170,25%,37%,22%,2,0,2,2,0,2
343,https://vlr.gg/player/5283/bunny,2024-11-28 03:00:00,1.84,1.43,1.51,287,309,280,34,7,27,16,3,13,11,2,9,+8,+5,+3,87%,100%,83%,180,170,183,19%,18%,20%,10,5,5,2,0,2
344,https://vlr.gg/player/28401/pkm,2024-11-28 03:00:00,1.70,1.39,1.45,248,180,258,30,5,25,14,1,13,7,1,6,+3,0,+3,90%,100%,88%,149,117,157,22%,14%,23%,4,0,4,1,0,1
345,https://vlr.gg/player/4827/goddead,2024-11-28 03:00:00,1.05,1.42,1.35,196,104,218,24,3,21,12,2,10,10,4,6,+1,0,+1,90%,100%,88%,133,85,146,24%,17%,26%,2,0,2,1,0,1
346,https://vlr.gg/player/985/efina,2024-11-28 03:00:00,0.83,1.39,1.27,207,176,218,23,4,19,14,4,10,15,1,14,0,-1,+1,80%,67%,83%,135,96,145,38%,50%,35%,3,0,3,3,1,2
347,https://vlr.gg/player/4127/felix,2024-11-28 03:00:00,0.91,0.67,0.86,187,182,200,18,14,4,26,21,5,4,2,2,0,+1,-1,50%,46%,67%,129,124,147,23%,20%,36%,2,2,0,2,1,1
348,https://vlr.gg/player/25089/cabeza,2024-11-28 03:00:00,0.65,0.34,0.59,148,156,119,14,12,2,27,22,5,5,4,1,0,0,0,53%,54%,50%,97,100,84,26%,31%,14%,3,2,1,3,2,1
349,https://vlr.gg/player/25080/empty,2024-11-28 03:00:00,0.48,0.46,0.48,162,170,144,15,12,3,29,24,5,4,4,0,-3,-3,0,50%,50%,50%,121,123,112,24%,23%,27%,1,1,0,4,4,0
350,https://vlr.gg/player/25082/rico,2024-11-28 03:00:00,0.57,0.09,0.47,119,135,49,10,9,1,28,23,5,10,9,1,-3,-2,-1,53%,54%,50%,84,97,33,18%,17%,50%,1,1,0,4,3,1
351,https://vlr.gg/player/17049/hermes,2024-11-28 03:00:00,0.40,0.22,0.35,128,127,131,11,9,2,28,23,5,9,7,2,-6,-4,-2,53%,54%,50%,85,82,100,18%,18%,15%,2,2,0,8,6,2
352,https://vlr.gg/player/6659/dragon,2024-11-28 02:30:00,0.97,1.40,1.21,235,207,268,79,30,49,58,28,30,28,16,12,+2,-2,+4,78%,82%,76%,160,139,176,34%,33%,35%,8,1,7,6,3,3
353,https://vlr.gg/player/12968/tixx,2024-11-28 02:30:00,0.99,1.17,1.09,192,182,204,59,23,36,57,28,29,34,17,17,+4,+1,+3,78%,82%,76%,129,120,136,30%,30%,30%,8,3,5,4,2,2
354,https://vlr.gg/player/1062/lew,2024-11-28 02:30:00,0.74,1.23,1.02,210,183,241,66,23,43,61,28,33,17,4,13,+1,-2,+3,64%,50%,74%,146,119,166,22%,30%,18%,14,7,7,13,9,4
355,https://vlr.gg/player/5228/minimise,2024-11-28 02:30:00,0.90,1.07,1.00,221,195,241,66,25,41,67,30,37,40,14,26,+3,0,+3,81%,82%,80%,146,131,157,22%,21%,23%,12,3,9,9,3,6
356,https://vlr.gg/player/26310/ikana,2024-11-28 02:30:00,1.12,0.80,0.94,161,221,135,51,28,23,56,25,31,20,8,12,+2,+3,-1,72%,63%,78%,120,148,98,24%,27%,20%,8,5,3,6,2,4
357,https://vlr.gg/player/17272/dokja,2024-11-28 02:30:00,1.13,1.21,1.17,260,244,268,79,42,37,68,39,29,15,7,8,+5,0,+5,69%,64%,76%,159,161,157,26%,29%,21%,14,7,7,9,7,2
358,https://vlr.gg/player/1771/myth,2024-11-28 02:30:00,0.88,1.35,1.08,197,157,248,60,27,33,57,35,22,41,25,16,-3,-1,-2,68%,68%,68%,123,94,162,24%,30%,21%,5,2,3,8,3,5
359,https://vlr.gg/player/36747/bonobo,2024-11-28 02:30:00,1.01,1.02,1.02,207,217,170,59,38,21,67,40,27,41,15,26,+3,-1,+4,72%,72%,71%,114,133,89,28%,34%,20%,11,6,5,8,7,1
360,https://vlr.gg/player/44437/ace,2024-11-28 02:30:00,0.73,1.18,0.93,182,164,218,56,26,30,67,41,26,26,12,14,-9,-3,-6,66%,66%,66%,128,114,146,40%,36%,44%,2,2,0,11,5,6
361,https://vlr.gg/player/31580/vizsla,2024-11-28 02:30:00,0.74,0.78,0.76,161,164,147,45,28,17,64,38,26,36,19,17,-8,-7,-1,66%,66%,66%,103,107,98,22%,22%,23%,6,2,4,14,9,5
362,https://vlr.gg/player/25683/desire,2024-11-27 17:05:00,1.26,1.42,1.34,295,262,321,65,30,35,42,22,20,19,8,11,+4,+2,+2,78%,68%,90%,194,181,208,30%,27%,33%,9,4,5,5,2,3
363,https://vlr.gg/player/1605/champzera,2024-11-27 17:05:00,1.00,1.57,1.27,210,173,256,47,21,26,33,20,13,27,12,15,+3,0,+3,75%,68%,83%,137,112,163,38%,29%,46%,6,2,4,3,2,1
364,https://vlr.gg/player/1595/myssen,2024-11-27 17:05:00,1.19,1.29,1.24,186,180,179,38,20,18,31,20,11,34,20,14,+3,+1,+2,85%,74%,97%,107,109,106,46%,56%,38%,4,2,2,1,1,0
365,https://vlr.gg/player/20251/vit9ine,2024-11-27 17:05:00,0.90,0.89,0.89,172,185,150,38,20,18,38,22,16,8,3,5,+1,+1,0,75%,74%,76%,113,112,113,20%,20%,20%,6,4,2,5,3,2
366,https://vlr.gg/player/36105/needy,2024-11-27 17:05:00,0.53,1.20,0.85,188,136,237,38,15,23,42,25,17,14,5,9,-5,-7,+2,60%,58%,62%,123,90,158,21%,21%,22%,8,2,6,13,9,4
367,https://vlr.gg/player/32801/turkish,2024-11-27 17:05:00,0.92,1.35,1.14,205,178,234,46,17,29,41,22,19,16,8,8,-1,-2,+1,72%,66%,77%,128,113,141,41%,30%,51%,2,0,2,3,2,1
368,https://vlr.gg/player/22914/hiiik,2024-11-27 17:05:00,0.82,0.97,0.89,183,197,179,37,18,19,46,25,21,16,3,13,-6,-3,-3,62%,52%,71%,128,127,128,33%,39%,29%,3,1,2,9,4,5
369,https://vlr.gg/player/41864/rodd,2024-11-27 17:05:00,0.65,1.05,0.86,203,168,249,41,16,25,48,24,24,9,3,6,+1,-2,+3,62%,62%,61%,142,108,173,23%,17%,27%,11,5,6,10,7,3
370,https://vlr.gg/player/41676/toronto,2024-11-27 17:05:00,0.60,1.00,0.80,138,120,162,29,11,18,44,24,20,11,3,8,-2,-2,0,60%,48%,71%,103,93,112,36%,50%,29%,5,1,4,7,3,4
371,https://vlr.gg/player/23855/str0nda,2024-11-27 17:05:00,0.66,0.85,0.76,174,154,185,32,15,17,47,25,22,16,6,10,+2,0,+2,63%,52%,74%,115,100,129,29%,29%,28%,6,3,3,4,3,1
372,https://vlr.gg/player/7220/saiz,2024-11-27 15:15:00,1.37,1.72,1.54,306,241,377,27,12,15,14,7,7,3,2,1,-1,0,-1,70%,58%,82%,205,179,234,59%,63%,57%,1,1,0,2,1,1
373,https://vlr.gg/player/292/fit1nho,2024-11-27 15:15:00,1.37,1.23,1.30,333,376,286,26,15,11,18,11,7,2,2,0,+3,+1,+2,65%,67%,64%,194,222,163,37%,44%,25%,8,4,4,5,3,2
374,https://vlr.gg/player/20055/toki,2024-11-27 15:15:00,1.07,0.68,0.88,162,190,131,13,8,5,16,8,8,12,8,4,-2,-2,0,70%,75%,64%,112,147,75,26%,38%,11%,1,0,1,3,2,1
375,https://vlr.gg/player/2864/ease,2024-11-27 15:15:00,0.59,0.83,0.70,115,75,159,7,2,5,16,8,8,18,11,7,0,0,0,78%,75%,82%,73,45,103,18%,33%,14%,0,0,0,0,0,0
376,https://vlr.gg/player/20058/devilasxa,2024-11-27 15:15:00,0.60,0.59,0.60,107,110,105,8,5,3,15,8,7,4,0,4,-1,-1,0,57%,50%,64%,71,69,74,26%,36%,19%,1,0,1,2,1,1
377,https://vlr.gg/player/5854/z3ro,2024-11-27 15:15:00,0.82,2.28,1.59,281,164,390,24,6,18,15,8,7,13,9,4,0,-2,+2,61%,64%,58%,179,107,245,28%,14%,35%,2,0,2,2,2,0
378,https://vlr.gg/player/24069/mochi,2024-11-27 15:15:00,1.80,0.54,1.15,186,252,126,17,12,5,15,5,10,4,0,4,+2,0,+2,65%,64%,67%,127,158,99,35%,35%,35%,2,0,2,0,0,0
379,https://vlr.gg/player/49607/ciuffo,2024-11-27 15:15:00,0.90,0.83,0.86,191,207,177,14,7,7,16,8,8,3,1,2,-1,+1,-2,65%,64%,67%,123,144,104,20%,22%,18%,3,2,1,4,1,3
380,https://vlr.gg/player/1944/cayden,2024-11-27 15:15:00,1.04,0.63,0.83,156,182,134,12,7,5,17,8,9,9,4,5,0,0,0,70%,82%,58%,108,135,84,29%,26%,33%,1,0,1,1,0,1
381,https://vlr.gg/player/23347/alannn,2024-11-27 15:15:00,0.46,0.91,0.70,146,133,158,12,5,7,18,10,8,6,2,4,0,0,0,65%,45%,83%,98,94,101,34%,36%,33%,4,3,1,4,3,1
382,https://vlr.gg/player/15297/joojina,2024-11-27 15:00:00,1.07,1.14,1.10,223,227,226,33,20,13,30,19,11,8,4,4,0,+1,-1,64%,58%,73%,139,136,144,39%,33%,52%,4,4,0,4,3,1
383,https://vlr.gg/player/4807/bstrdd,2024-11-27 15:00:00,0.90,0.98,0.93,219,215,220,27,17,10,31,19,12,6,3,3,-1,-2,+1,59%,58%,60%,153,150,157,34%,33%,35%,7,5,2,8,7,1
384,https://vlr.gg/player/12143/bizerra,2024-11-27 15:00:00,1.08,0.53,0.87,151,185,93,21,16,5,29,16,13,11,7,4,+1,0,+1,62%,63%,60%,106,123,79,26%,28%,22%,1,0,1,0,0,0
385,https://vlr.gg/player/11232/daiki,2024-11-27 15:00:00,0.99,0.62,0.84,173,186,147,24,16,8,31,18,13,15,11,4,0,+2,-2,67%,75%,53%,111,118,100,53%,57%,47%,2,2,0,2,0,2
386,https://vlr.gg/player/14386/isaa,2024-11-27 15:00:00,0.61,0.63,0.62,158,145,192,19,11,8,32,20,12,10,5,5,-3,-1,-2,69%,71%,67%,112,107,120,25%,30%,20%,4,1,3,7,2,5
387,https://vlr.gg/player/36433/phc,2024-11-27 15:00:00,1.60,1.40,1.48,256,254,263,40,17,23,23,8,15,16,4,12,+2,0,+2,82%,93%,75%,166,164,167,25%,15%,32%,3,0,3,1,0,1
388,https://vlr.gg/player/6202/guuih,2024-11-27 15:00:00,1.95,0.94,1.33,242,350,175,36,20,16,23,7,16,14,8,6,+1,+2,-1,77%,80%,75%,159,227,116,38%,41%,34%,3,3,0,2,1,1
389,https://vlr.gg/player/1567/bezn1,2024-11-27 15:00:00,1.31,1.07,1.16,220,246,204,29,12,17,26,10,16,20,9,11,+5,+3,+2,74%,80%,71%,142,148,138,18%,26%,13%,8,4,4,3,1,2
390,https://vlr.gg/player/3424/siduzord,2024-11-27 15:00:00,0.58,1.17,0.94,165,47,240,21,1,20,24,8,16,14,8,6,-1,0,-1,85%,80%,88%,113,39,160,26%,15%,29%,3,1,2,4,1,3
391,https://vlr.gg/player/32675/kring,2024-11-27 15:00:00,0.89,0.84,0.86,198,192,190,27,11,16,28,11,17,7,6,1,-4,-2,-2,72%,80%,67%,137,144,133,30%,32%,29%,4,1,3,8,3,5
392,https://vlr.gg/player/4629/azury,2024-11-27 14:00:00,1.66,1.14,1.36,229,318,163,19,11,8,12,6,6,3,1,2,+2,0,+2,81%,78%,83%,161,250,95,24%,26%,22%,2,0,2,0,0,0
393,https://vlr.gg/player/3753/obnoks,2024-11-27 14:00:00,1.24,1.38,1.32,224,180,257,17,7,10,10,4,6,9,3,6,+1,0,+1,81%,78%,83%,138,93,172,36%,40%,35%,2,0,2,1,0,1
394,https://vlr.gg/player/12528/disisjohn,2024-11-27 14:00:00,0.72,1.76,1.31,266,189,325,19,5,14,14,8,6,4,2,2,+4,+2,+2,81%,56%,100%,165,113,204,32%,25%,36%,5,3,2,1,1,0
395,https://vlr.gg/player/4325/musashi,2024-11-27 14:00:00,0.82,1.01,0.93,188,205,175,15,8,7,14,7,7,6,2,4,0,+1,-1,76%,78%,75%,124,130,119,50%,46%,53%,3,2,1,3,1,2
396,https://vlr.gg/player/30042/harmonee,2024-11-27 14:00:00,0.10,1.28,0.78,153,83,207,11,1,10,13,8,5,5,3,2,0,-2,+2,62%,56%,67%,105,70,131,24%,31%,20%,2,0,2,2,2,0
397,https://vlr.gg/player/114/enzo,2024-11-27 14:00:00,0.78,1.53,1.10,232,206,268,14,6,8,16,11,5,6,3,3,0,-1,+1,76%,67%,89%,164,154,177,21%,24%,18%,1,0,1,1,1,0
398,https://vlr.gg/player/1284/mikee,2024-11-27 14:00:00,0.72,1.23,0.94,173,150,205,14,7,7,15,10,5,5,2,3,-2,0,-2,57%,50%,67%,116,89,153,29%,28%,29%,0,0,0,2,0,2
399,https://vlr.gg/player/30186/nami,2024-11-27 14:00:00,0.90,0.77,0.85,180,160,208,16,9,7,17,9,8,3,2,1,-1,-2,+1,57%,67%,44%,111,111,111,44%,44%,44%,2,0,2,3,2,1
400,https://vlr.gg/player/257/bramz,2024-11-27 14:00:00,0.72,0.81,0.75,168,157,183,12,6,6,17,10,7,4,4,0,-3,-2,-1,62%,58%,67%,120,94,153,28%,31%,23%,4,3,1,7,5,2
401,https://vlr.gg/player/13258/cyvoph,2024-11-27 14:00:00,0.32,1.00,0.61,110,73,162,6,1,5,16,10,6,11,6,5,-1,-1,0,67%,50%,89%,69,56,86,9%,6%,13%,0,0,0,1,1,0
402,https://vlr.gg/player/38424/zachkappa,2024-11-27 13:00:00,1.60,1.21,1.40,267,282,254,23,12,11,15,6,9,7,2,5,+4,+3,+1,88%,92%,83%,184,214,155,33%,30%,37%,5,3,2,1,0,1
403,https://vlr.gg/player/11322/sevire,2024-11-27 13:00:00,1.58,1.13,1.35,249,258,241,21,12,9,15,6,9,7,5,2,+4,+1,+3,83%,83%,83%,182,196,169,43%,44%,42%,4,1,3,0,0,0
404,https://vlr.gg/player/40004/globex,2024-11-27 13:00:00,1.38,1.30,1.34,281,305,258,25,13,12,15,7,8,3,3,0,-1,+1,-2,71%,75%,67%,174,196,152,21%,26%,16%,2,2,0,3,1,2
405,https://vlr.gg/player/30107/fluxxy,2024-11-27 13:00:00,0.95,0.85,0.90,138,123,154,13,6,7,13,5,8,5,3,2,-2,0,-2,75%,92%,58%,99,95,104,39%,36%,43%,1,1,0,3,1,2
406,https://vlr.gg/player/20116/jademwah,2024-11-27 13:00:00,0.36,0.34,0.35,95,92,98,8,5,3,18,9,9,3,0,3,-3,-1,-2,58%,58%,58%,70,55,86,15%,14%,15%,1,1,0,4,2,2
407,https://vlr.gg/player/3557/skylen,2024-11-27 13:00:00,1.46,1.06,1.26,206,221,191,19,11,8,16,7,9,8,5,3,+2,+1,+1,67%,75%,58%,128,140,116,53%,55%,50%,2,1,1,0,0,0
408,https://vlr.gg/player/21328/wo0t,2024-11-27 13:00:00,1.33,0.87,1.10,250,263,239,20,11,9,18,7,11,2,1,1,+2,+2,0,67%,75%,58%,174,195,153,34%,32%,36%,4,3,1,2,1,1
409,https://vlr.gg/player/19776/jrayn,2024-11-27 13:00:00,1.36,0.62,0.99,183,253,114,14,10,4,17,8,9,10,7,3,-1,+1,-2,67%,83%,50%,121,160,82,32%,48%,15%,2,1,1,3,0,3
410,https://vlr.gg/player/573/cned,2024-11-27 13:00:00,0.55,1.04,0.79,188,159,218,15,6,9,20,11,9,3,2,1,-5,-1,-4,58%,58%,58%,125,100,150,42%,50%,38%,2,2,0,7,3,4
411,https://vlr.gg/player/22792/jiex,2024-11-27 13:00:00,0.39,0.48,0.44,99,106,93,8,5,3,19,9,10,3,1,2,0,-1,+1,46%,58%,33%,64,57,72,38%,33%,42%,1,0,1,1,1,0
412,https://vlr.gg/player/4426/klaus,2024-11-27 05:30:00,1.60,1.77,1.68,292,296,287,50,26,24,28,15,13,19,7,12,+2,+2,0,82%,78%,86%,198,194,202,40%,41%,39%,5,3,2,3,1,2
413,https://vlr.gg/player/34926/oonzmlp,2024-11-27 05:30:00,1.22,1.09,1.16,214,232,195,34,19,15,27,14,13,11,5,6,+4,0,+4,80%,78%,82%,134,150,118,22%,33%,14%,7,3,4,3,3,0
414,https://vlr.gg/player/2149/c1nder,2024-11-27 05:30:00,0.98,1.15,1.06,178,163,195,30,15,15,27,15,12,20,8,12,-2,-2,0,78%,74%,82%,109,109,109,30%,36%,26%,1,0,1,3,2,1
415,https://vlr.gg/player/42733/xuna,2024-11-27 05:30:00,0.64,1.15,0.89,179,142,216,27,10,17,31,17,14,22,9,13,-1,-1,0,80%,65%,95%,129,99,160,27%,18%,33%,2,0,2,3,1,2
416,https://vlr.gg/player/37532/zexy,2024-11-27 05:30:00,0.55,1.13,0.84,212,175,253,31,12,19,35,20,15,10,4,6,+6,0,+6,69%,65%,73%,134,123,146,27%,17%,39%,12,5,7,6,5,1
417,https://vlr.gg/player/42769/wezzy,2024-11-27 05:30:00,0.91,1.89,1.41,275,210,339,42,16,26,33,19,14,19,7,12,+2,-1,+3,84%,86%,83%,183,139,226,43%,45%,42%,5,1,4,3,2,1
418,https://vlr.gg/player/42710/froz,2024-11-27 05:30:00,1.32,1.03,1.17,241,264,216,39,22,17,33,16,17,5,2,3,+2,0,+2,69%,73%,65%,160,177,144,36%,49%,27%,3,1,2,1,1,0
419,https://vlr.gg/player/42771/nameless,2024-11-27 05:30:00,0.69,1.05,0.87,174,122,224,30,10,20,35,18,17,11,7,4,-1,-1,0,64%,68%,61%,108,88,127,47%,39%,55%,3,1,2,4,2,2
420,https://vlr.gg/player/4666/acme,2024-11-27 05:30:00,0.84,0.49,0.66,145,192,102,21,13,8,36,18,18,21,12,9,-5,-5,0,67%,68%,65%,103,146,62,29%,31%,24%,2,0,2,7,5,2
421,https://vlr.gg/player/4060/daegi,2024-11-27 05:30:00,0.28,0.64,0.47,119,97,141,16,6,10,35,19,16,8,3,5,-7,-3,-4,51%,50%,52%,85,71,99,14%,14%,15%,5,3,2,12,6,6
422,https://vlr.gg/player/40279/ngen,2024-11-27 03:00:00,1.32,1.70,1.42,199,197,210,23,16,7,13,11,2,13,11,2,+4,+4,0,85%,83%,89%,146,138,167,23%,22%,24%,4,4,0,0,0,0
423,https://vlr.gg/player/4038/bangnan,2024-11-27 03:00:00,1.43,1.23,1.38,274,286,231,34,26,8,19,13,6,5,3,2,+1,0,+1,82%,75%,100%,173,186,138,31%,32%,29%,4,3,1,3,3,0
424,https://vlr.gg/player/34727/kayle,2024-11-27 03:00:00,1.35,1.17,1.30,242,221,291,32,22,10,21,13,8,13,10,3,0,-1,+1,88%,83%,100%,145,135,171,23%,26%,17%,1,0,1,1,1,0
425,https://vlr.gg/player/38369/only1,2024-11-27 03:00:00,1.17,1.52,1.26,252,254,268,29,20,9,21,16,5,11,9,2,-2,-3,+1,82%,79%,89%,172,171,178,13%,12%,19%,7,3,4,9,6,3
426,https://vlr.gg/player/13000/redlight,2024-11-27 03:00:00,0.96,2.02,1.25,232,200,304,28,19,9,20,15,5,16,10,6,+1,+1,0,97%,96%,100%,146,123,206,21%,22%,19%,2,2,0,1,1,0
427,https://vlr.gg/player/48923/vista,2024-11-27 03:00:00,0.64,0.94,0.85,232,171,264,26,6,20,31,10,21,7,2,5,-1,-2,+1,70%,78%,67%,149,94,170,20%,10%,24%,7,0,7,8,2,6
428,https://vlr.gg/player/48927/xuka,2024-11-27 03:00:00,0.91,0.74,0.78,193,251,172,20,7,13,30,9,21,9,4,5,-2,-1,-1,67%,89%,58%,140,174,127,22%,21%,22%,2,0,2,4,1,3
429,https://vlr.gg/player/48925/raxcal,2024-11-27 03:00:00,0.26,0.91,0.74,155,112,175,20,3,17,27,9,18,4,3,1,-2,-2,0,61%,56%,63%,107,80,117,22%,13%,26%,2,0,2,4,2,2
430,https://vlr.gg/player/48924/f0rest,2024-11-27 03:00:00,0.21,0.62,0.51,133,92,145,13,3,10,30,9,21,15,5,10,0,0,0,67%,67%,67%,81,49,93,19%,17%,20%,1,0,1,1,0,1
431,https://vlr.gg/player/48926/sirius,2024-11-27 03:00:00,0.51,0.44,0.46,113,151,95,13,5,8,29,9,20,5,1,4,+1,+1,0,64%,67%,63%,72,88,66,29%,42%,23%,3,3,0,2,2,0
432,https://vlr.gg/player/31593/kiss,2024-11-27 02:30:00,1.11,1.37,1.24,230,221,238,66,29,37,56,31,25,29,19,10,+4,+1,+3,78%,74%,82%,150,144,157,32%,33%,32%,5,2,3,1,1,0
433,https://vlr.gg/player/34226/sh0pan,2024-11-27 02:30:00,0.66,1.41,1.02,229,166,287,61,22,39,60,33,27,21,7,14,-2,-3,+1,65%,56%,74%,156,113,199,22%,17%,25%,9,3,6,11,6,5
434,https://vlr.gg/player/31589/murza,2024-11-27 02:30:00,0.88,0.87,0.87,210,208,214,57,28,29,64,32,32,17,8,9,+2,0,+2,67%,67%,67%,129,126,132,19%,20%,19%,12,5,7,10,5,5
435,https://vlr.gg/player/46993/long,2024-11-27 02:30:00,0.92,0.81,0.87,175,187,170,46,24,22,58,29,29,30,15,15,-2,-1,-1,73%,79%,67%,115,122,108,14%,14%,13%,7,5,2,9,6,3
436,https://vlr.gg/player/26316/ramen,2024-11-27 02:30:00,0.65,0.94,0.79,172,148,198,43,20,23,62,33,29,29,9,20,+2,-2,+4,81%,74%,87%,114,98,130,21%,25%,19%,8,2,6,6,4,2
437,https://vlr.gg/player/44437/ace,2024-11-27 02:30:00,1.04,1.27,1.16,229,226,234,61,27,34,55,30,25,17,9,8,+11,+4,+7,76%,69%,82%,149,154,144,30%,28%,32%,14,6,8,3,2,1
438,https://vlr.gg/player/1771/myth,2024-11-27 02:30:00,0.99,1.34,1.16,209,189,228,53,26,27,48,29,19,38,14,24,-3,+1,-4,83%,79%,87%,144,124,164,17%,18%,16%,4,3,1,7,2,5
439,https://vlr.gg/player/36747/bonobo,2024-11-27 02:30:00,0.91,1.36,1.13,240,203,280,69,31,38,55,30,25,18,5,13,0,-4,+4,69%,64%,74%,163,139,187,33%,39%,30%,8,0,8,8,4,4
440,https://vlr.gg/player/17272/dokja,2024-11-27 02:30:00,0.91,1.11,1.01,231,236,224,65,31,34,58,31,27,12,6,6,-8,-7,-1,71%,67%,74%,144,142,147,18%,14%,22%,6,4,2,14,11,3
441,https://vlr.gg/player/31580/vizsla,2024-11-27 02:30:00,0.89,0.96,0.93,192,198,186,52,27,25,57,30,27,38,15,23,-4,-3,-1,74%,72%,77%,123,129,116,20%,24%,16%,5,2,3,9,5,4
442,https://vlr.gg/player/34057/jerrwin,2024-11-26 22:30:00,0.99,0.87,0.93,217,231,203,31,16,15,32,17,15,7,3,4,-3,-5,+2,63%,65%,60%,131,151,111,17%,20%,13%,7,3,4,10,8,2
443,https://vlr.gg/player/34400/bao,2024-11-26 22:30:00,0.56,1.24,0.90,198,131,266,30,10,20,34,20,14,15,9,6,-1,-1,0,73%,70%,75%,123,85,160,38%,32%,42%,2,0,2,3,1,2
444,https://vlr.gg/player/29688/mikee,2024-11-26 22:30:00,0.54,1.17,0.86,165,114,217,22,8,14,32,18,14,11,3,8,-3,-2,-1,63%,45%,80%,107,77,136,22%,19%,23%,3,2,1,6,4,2
445,https://vlr.gg/player/4385/monsi,2024-11-26 22:30:00,0.87,0.72,0.79,143,162,124,21,13,8,32,17,15,13,3,10,+1,+2,-1,70%,65%,75%,88,91,86,37%,38%,36%,3,2,1,2,0,2
446,https://vlr.gg/player/3874/teague,2024-11-26 22:30:00,0.33,0.99,0.66,131,72,189,16,3,13,32,18,14,21,10,11,-4,0,-4,58%,50%,65%,78,52,103,12%,15%,11%,0,0,0,4,0,4
447,https://vlr.gg/player/1023/xxif,2024-11-26 22:30:00,1.44,1.37,1.41,233,261,205,35,19,16,18,11,7,6,3,3,+2,0,+2,88%,80%,95%,160,187,133,27%,25%,29%,4,2,2,2,2,0
448,https://vlr.gg/player/3702/sym,2024-11-26 22:30:00,0.88,1.90,1.39,320,234,406,45,15,30,28,17,11,11,4,7,+8,+5,+3,78%,75%,80%,206,146,265,32%,29%,33%,14,7,7,6,2,4
449,https://vlr.gg/player/64/gmd,2024-11-26 22:30:00,1.29,1.13,1.21,208,241,175,31,19,12,22,13,9,18,5,13,-2,-1,-1,73%,60%,85%,133,144,122,24%,22%,26%,1,1,0,3,2,1
450,https://vlr.gg/player/3007/tdawgg,2024-11-26 22:30:00,0.88,1.22,1.05,183,167,199,27,12,15,25,14,11,23,11,12,0,0,0,83%,75%,90%,117,105,129,23%,26%,22%,2,1,1,2,1,1
451,https://vlr.gg/player/8376/seven,2024-11-26 22:30:00,0.63,1.34,0.99,194,123,267,24,7,17,27,15,12,21,9,12,+2,0,+2,85%,70%,100%,129,81,178,15%,24%,12%,4,1,3,2,1,1
452,https://vlr.gg/player/3702/sym,2024-11-26 19:15:00,1.48,1.90,1.72,332,318,354,78,30,48,43,22,21,16,8,8,+16,+5,+11,80%,75%,83%,215,205,223,27%,24%,30%,22,9,13,6,4,2
453,https://vlr.gg/player/64/gmd,2024-11-26 19:15:00,1.05,1.25,1.17,219,178,250,48,17,31,43,19,24,35,19,16,-4,-1,-3,77%,82%,72%,148,122,168,26%,31%,24%,1,1,0,5,2,3
454,https://vlr.gg/player/8376/seven,2024-11-26 19:15:00,1.21,1.00,1.09,243,269,209,51,27,24,47,21,26,38,19,19,0,+1,-1,86%,93%,81%,147,157,138,23%,30%,19%,6,3,3,6,2,4
455,https://vlr.gg/player/3007/tdawgg,2024-11-26 19:15:00,0.84,1.24,1.07,210,172,229,48,18,30,44,21,23,26,9,17,-2,0,-2,78%,79%,78%,138,118,154,41%,44%,38%,5,2,3,7,2,5
456,https://vlr.gg/player/1023/xxif,2024-11-26 19:15:00,0.60,0.85,0.74,129,127,132,31,13,18,44,22,22,9,5,4,-2,-1,-1,73%,75%,72%,90,87,92,25%,31%,22%,2,1,1,4,2,2
457,https://vlr.gg/player/8375/bones,2024-11-26 19:15:00,1.11,1.23,1.17,251,244,265,56,33,23,50,29,21,29,10,19,+4,+1,+3,75%,75%,75%,152,147,160,26%,28%,24%,8,2,6,4,1,3
458,https://vlr.gg/player/36560/canezerra,2024-11-26 19:15:00,0.69,1.33,0.97,233,201,286,55,24,31,52,31,21,8,4,4,0,-1,+1,69%,64%,75%,146,128,169,31%,39%,26%,12,8,4,12,9,3
459,https://vlr.gg/player/41798/nightz,2024-11-26 19:15:00,0.71,1.18,0.92,198,193,218,50,25,25,54,34,20,15,9,6,-6,-3,-3,67%,67%,68%,138,128,151,54%,49%,60%,4,3,1,10,6,4
460,https://vlr.gg/player/8399/mocking,2024-11-26 19:15:00,0.86,0.63,0.76,132,155,118,30,19,11,48,26,22,26,12,14,-1,+1,-2,70%,69%,71%,93,105,77,15%,25%,6%,1,1,0,2,0,2
461,https://vlr.gg/player/29547/ion2x,2024-11-26 19:15:00,0.48,0.69,0.57,129,118,142,30,15,15,52,31,21,11,7,4,-5,-2,-3,63%,61%,64%,91,81,105,30%,33%,27%,3,2,1,8,4,4
462,https://vlr.gg/player/37105/loss,2024-11-26 17:30:00,1.34,1.20,1.27,306,342,277,75,36,39,57,28,29,11,6,5,+10,+8,+2,69%,77%,62%,189,203,177,31%,28%,35%,19,12,7,9,4,5
463,https://vlr.gg/player/9266/tisora,2024-11-26 17:30:00,0.97,0.93,0.95,189,180,197,43,20,23,48,19,29,31,18,13,-3,-3,0,74%,81%,68%,129,116,139,25%,31%,21%,2,1,1,5,4,1
464,https://vlr.gg/player/2021/axeddy,2024-11-26 17:30:00,1.22,0.73,0.95,176,204,158,41,23,18,47,18,29,25,12,13,-1,0,-1,68%,74%,62%,110,124,99,33%,40%,28%,6,2,4,7,2,5
465,https://vlr.gg/player/23001/zaninzs,2024-11-26 17:30:00,1.00,0.76,0.87,143,156,136,32,16,16,41,16,25,15,7,8,-1,0,-1,68%,74%,62%,102,112,94,24%,27%,22%,3,2,1,4,2,2
466,https://vlr.gg/player/33121/stwz1,2024-11-26 17:30:00,0.48,0.81,0.66,152,125,184,35,13,22,54,25,29,12,4,8,-3,-2,-1,57%,58%,57%,102,80,121,25%,22%,27%,5,0,5,8,2,6
467,https://vlr.gg/player/32718/kenkayyy,2024-11-26 17:30:00,1.45,1.02,1.25,237,250,227,57,34,23,46,20,26,24,12,12,-2,-4,+2,72%,73%,71%,155,161,148,32%,32%,33%,5,0,5,7,4,3
468,https://vlr.gg/player/26214/cidzzz,2024-11-26 17:30:00,0.84,1.41,1.10,217,163,267,54,23,31,46,25,21,17,7,10,0,+1,-1,68%,59%,77%,136,101,178,33%,33%,34%,8,5,3,8,4,4
469,https://vlr.gg/player/1607/ntk,2024-11-26 17:30:00,1.28,0.88,1.10,213,220,194,45,28,17,42,20,22,30,14,16,+2,+2,0,79%,81%,77%,141,146,135,12%,13%,11%,6,3,3,4,1,3
470,https://vlr.gg/player/36106/skz,2024-11-26 17:30:00,1.01,1.04,1.02,161,173,143,43,24,19,40,24,16,25,16,9,+1,+1,0,78%,76%,81%,105,113,95,31%,31%,30%,3,1,2,2,0,2
471,https://vlr.gg/player/22964/forbanz,2024-11-26 17:30:00,1.05,0.70,0.89,211,261,155,48,32,16,52,29,23,16,10,6,-3,+1,-4,62%,62%,61%,138,170,100,29%,32%,21%,11,10,1,14,9,5
472,https://vlr.gg/player/8082/zander,2024-11-26 16:00:00,1.08,1.03,1.05,237,257,220,50,27,23,47,24,23,26,7,19,+1,0,+1,74%,67%,81%,147,147,147,23%,20%,25%,7,4,3,6,4,2
473,https://vlr.gg/player/4147/cryocells,2024-11-26 16:00:00,0.89,1.07,0.99,179,179,180,42,19,23,42,21,21,17,6,11,-5,-4,-1,69%,67%,72%,118,118,118,22%,28%,18%,3,1,2,8,5,3
474,https://vlr.gg/player/796/eeiu,2024-11-26 16:00:00,0.76,1.18,0.98,187,130,242,41,15,26,40,20,20,16,6,10,-1,+1,-2,63%,53%,72%,127,88,163,30%,23%,36%,3,1,2,4,0,4
475,https://vlr.gg/player/601/asuna,2024-11-26 16:00:00,0.87,0.89,0.88,238,237,233,45,21,24,58,28,30,20,10,10,+7,+4,+3,73%,77%,69%,151,157,145,27%,26%,27%,15,8,7,8,4,4
476,https://vlr.gg/player/604/boostio,2024-11-26 16:00:00,0.79,0.95,0.87,175,166,190,40,18,22,46,22,24,25,11,14,0,-3,+3,66%,70%,63%,108,110,105,37%,41%,33%,4,0,4,4,3,1
477,https://vlr.gg/player/34057/jerrwin,2024-11-26 16:00:00,1.08,1.70,1.38,280,279,295,62,30,32,46,30,16,19,9,10,+5,+4,+1,79%,72%,87%,189,169,211,20%,25%,16%,15,9,6,10,5,5
478,https://vlr.gg/player/29688/mikee,2024-11-26 16:00:00,0.82,1.61,1.20,237,167,314,54,20,34,39,23,16,9,6,3,+1,-2,+3,71%,69%,73%,165,119,213,36%,30%,40%,5,1,4,4,3,1
479,https://vlr.gg/player/4385/monsi,2024-11-26 16:00:00,1.31,0.79,1.06,197,235,160,46,29,17,42,19,23,24,6,18,-3,-3,0,74%,78%,70%,126,149,102,35%,41%,27%,6,3,3,9,6,3
480,https://vlr.gg/player/34400/bao,2024-11-26 16:00:00,1.12,0.90,1.01,197,207,183,40,23,17,44,21,23,26,10,16,0,0,0,76%,72%,80%,135,138,130,29%,29%,28%,4,1,3,4,1,3
481,https://vlr.gg/player/3874/teague,2024-11-26 16:00:00,0.74,0.88,0.81,142,142,150,31,16,15,47,25,22,49,23,26,-5,-3,-2,82%,78%,87%,89,87,91,20%,23%,18%,0,0,0,5,3,2
482,https://vlr.gg/player/4629/azury,2024-11-26 15:15:00,1.59,1.12,1.34,274,283,267,23,12,11,17,7,10,5,4,1,0,0,0,87%,91%,83%,165,177,153,51%,40%,67%,1,0,1,1,0,1
483,https://vlr.gg/player/3753/obnoks,2024-11-26 15:15:00,1.42,1.11,1.26,235,225,245,20,9,11,15,6,9,12,9,3,-1,0,-1,83%,91%,75%,138,142,135,29%,24%,35%,0,0,0,1,0,1
484,https://vlr.gg/player/12528/disisjohn,2024-11-26 15:15:00,1.17,0.72,0.94,210,272,153,16,10,6,19,10,9,3,1,2,0,+1,-1,70%,73%,67%,133,164,105,22%,25%,17%,4,3,1,4,2,2
485,https://vlr.gg/player/4325/musashi,2024-11-26 15:15:00,0.08,1.44,0.79,177,104,244,13,2,11,18,11,7,5,3,2,-3,-1,-2,74%,73%,75%,140,84,191,18%,15%,20%,2,2,0,5,3,2
486,https://vlr.gg/player/30042/harmonee,2024-11-26 15:15:00,0.57,0.54,0.55,134,137,132,11,5,6,18,8,10,4,1,3,-1,-1,0,70%,82%,58%,93,110,77,28%,29%,27%,2,0,2,3,1,2
487,https://vlr.gg/player/2864/ease,2024-11-26 15:15:00,2.06,1.66,1.87,307,356,255,27,17,10,11,6,5,10,2,8,+2,+3,-1,74%,75%,73%,197,220,172,44%,37%,55%,3,3,0,1,0,1
488,https://vlr.gg/player/292/fit1nho,2024-11-26 15:15:00,1.44,0.75,1.11,252,289,213,19,12,7,17,8,9,5,3,2,0,-2,+2,78%,83%,73%,176,209,140,23%,29%,15%,2,0,2,2,2,0
489,https://vlr.gg/player/20055/toki,2024-11-26 15:15:00,0.51,1.48,0.97,200,149,257,17,5,12,19,12,7,12,11,1,+1,0,+1,87%,83%,91%,139,96,187,54%,50%,57%,2,1,1,1,1,0
490,https://vlr.gg/player/5199/guardy,2024-11-26 15:15:00,0.73,0.66,0.70,162,143,184,12,6,6,17,8,9,5,2,3,+2,+2,0,78%,83%,73%,111,89,134,31%,60%,20%,5,3,2,3,1,2
491,https://vlr.gg/player/7220/saiz,2024-11-26 15:15:00,0.27,0.75,0.50,150,120,184,12,5,7,19,11,8,5,2,3,0,+1,-1,70%,67%,73%,99,78,121,27%,38%,21%,2,1,1,2,0,2
492,https://vlr.gg/player/46568/above,2024-11-26 15:00:00,1.72,1.21,1.48,270,296,244,46,28,18,29,14,15,12,2,10,+2,-1,+3,74%,75%,73%,181,191,170,47%,50%,43%,4,1,3,2,2,0
493,https://vlr.gg/player/37091/peixeh,2024-11-26 15:00:00,0.63,1.40,1.00,171,132,218,28,11,17,27,16,11,5,5,0,-4,-5,+1,67%,67%,68%,121,96,147,34%,24%,43%,3,0,3,7,5,2
494,https://vlr.gg/player/37098/tiezzi,2024-11-26 15:00:00,0.89,1.09,0.98,211,200,224,33,15,18,32,17,15,11,8,3,-1,-4,+3,72%,71%,73%,145,142,147,20%,24%,17%,9,4,5,10,8,2
495,https://vlr.gg/player/37354/basic,2024-11-26 15:00:00,0.62,1.17,0.88,156,123,196,22,8,14,30,18,12,25,12,13,+2,+2,0,74%,71%,77%,108,93,125,15%,13%,16%,3,2,1,1,0,1
496,https://vlr.gg/player/1673/guiih9,2024-11-26 15:00:00,1.14,0.56,0.86,210,280,131,32,24,8,37,20,17,10,4,6,-1,+2,-3,74%,79%,68%,134,179,84,35%,46%,21%,3,2,1,4,0,4
497,https://vlr.gg/player/41851/jway,2024-11-26 15:00:00,1.36,1.85,1.62,266,230,304,49,21,28,26,13,13,5,3,2,+2,-1,+3,63%,64%,63%,196,181,209,45%,39%,50%,7,1,6,5,2,3
498,https://vlr.gg/player/23010/nicksz,2024-11-26 15:00:00,1.22,0.96,1.08,228,229,224,35,18,17,32,15,17,19,8,11,0,-1,+1,76%,73%,79%,139,141,138,24%,28%,22%,3,0,3,3,1,2
499,https://vlr.gg/player/41445/saalped,2024-11-26 15:00:00,0.76,0.80,0.78,152,155,149,25,12,13,33,15,18,5,1,4,-1,-3,+2,59%,45%,71%,107,101,113,26%,23%,29%,5,3,2,6,6,0
500,https://vlr.gg/player/2006/glym,2024-11-26 15:00:00,0.76,0.70,0.73,140,126,157,22,10,12,33,13,20,12,4,8,+1,+1,0,72%,77%,67%,91,78,102,22%,27%,20%,4,2,2,3,1,2
501,https://vlr.gg/player/37024/czewick,2024-11-26 15:00:00,0.52,0.83,0.68,163,142,190,24,9,15,37,19,18,13,6,7,0,0,0,70%,64%,75%,122,113,130,17%,16%,17%,5,3,2,5,3,2
0,https://vlr.gg/player/11322/sevire,2024-11-26 14:15:00,1.56,2.06,1.90,333,201,400,21,5,16,7,2,5,9,2,7,+2,+1,+1,78%,83%,75%,240,151,284,33%,40%,31%,3,1,2,1,0,1
1,https://vlr.gg/player/30107/fluxxy,2024-11-26 14:15:00,1.01,1.87,1.58,207,159,232,13,3,10,5,3,2,12,5,7,+2,+1,+1,94%,100%,92%,137,104,153,31%,25%,35%,2,1,1,0,0,0
2,https://vlr.gg/player/40004/globex,2024-11-26 14:15:00,2.21,1.19,1.53,312,490,223,23,12,11,10,4,6,2,1,1,+3,+2,+1,83%,83%,83%,195,307,139,18%,34%,6%,4,2,2,1,0,1
3,https://vlr.gg/player/20116/jademwah,2024-11-26 14:15:00,0.81,1.14,1.03,153,103,180,10,2,8,12,4,8,12,3,9,+1,0,+1,83%,83%,83%,107,81,120,32%,29%,33%,2,1,1,1,1,0
4,https://vlr.gg/player/38424/zachkappa,2024-11-26 14:15:00,0.90,0.92,0.91,150,142,155,10,2,8,9,3,6,4,2,2,+2,0,+2,83%,83%,83%,118,103,126,44%,57%,40%,3,0,3,1,0,1
5,https://vlr.gg/player/23347/alannn,2024-11-26 14:15:00,1.18,0.29,0.88,185,234,88,12,10,2,15,10,5,3,3,0,-1,0,-1,67%,83%,33%,105,130,56,44%,43%,50%,1,1,0,2,1,1
6,https://vlr.gg/player/1944/cayden,2024-11-26 14:15:00,0.74,1.11,0.87,159,151,178,10,6,4,14,10,4,0,0,0,-1,-2,+1,61%,58%,67%,104,106,102,20%,27%,10%,1,0,1,2,2,0
7,https://vlr.gg/player/49607/ciuffo,2024-11-26 14:15:00,0.15,1.42,0.57,143,91,248,10,4,6,15,11,4,3,1,2,-5,-4,-1,50%,42%,67%,83,48,153,35%,29%,38%,1,1,0,6,5,1
8,https://vlr.gg/player/5854/z3ro,2024-11-26 14:15:00,0.52,0.31,0.45,117,112,129,6,4,2,17,11,6,6,4,2,-1,+1,-2,50%,58%,33%,77,73,85,32%,20%,57%,1,1,0,2,0,2
9,https://vlr.gg/player/24068/effy,2024-11-26 14:15:00,0.27,0.41,0.32,93,85,109,5,3,2,16,11,5,3,2,1,-2,-1,-1,33%,25%,50%,63,55,79,26%,25%,29%,0,0,0,2,1,1
10,https://vlr.gg/player/16012/akira,2024-11-26 13:00:00,0.78,1.24,0.96,197,172,236,42,20,22,47,31,16,19,6,13,-1,-1,0,66%,58%,76%,137,117,166,34%,32%,36%,1,0,1,2,1,1
11,https://vlr.gg/player/22495/mochi,2024-11-26 13:00:00,0.74,1.19,0.92,150,131,178,34,16,18,45,31,14,22,12,10,0,-2,+2,64%,56%,76%,108,95,127,31%,30%,33%,2,0,2,2,2,0
12,https://vlr.gg/player/22291/razziss,2024-11-26 13:00:00,0.57,1.40,0.91,213,166,296,47,20,27,48,34,14,9,5,4,-6,-10,+4,61%,50%,76%,138,111,177,30%,43%,19%,12,4,8,18,14,4
13,https://vlr.gg/player/15487/aqua,2024-11-26 13:00:00,0.81,0.89,0.84,174,179,177,37,22,15,48,32,16,16,2,14,-2,-1,-1,62%,53%,76%,117,117,117,22%,25%,18%,4,2,2,6,3,3
14,https://vlr.gg/player/8595/skygi,2024-11-26 13:00:00,0.41,1.35,0.80,184,130,263,40,14,26,47,33,14,15,6,9,-9,-9,0,57%,44%,76%,119,86,167,27%,21%,32%,3,1,2,12,10,2
15,https://vlr.gg/player/32300/varuxx,2024-11-26 13:00:00,1.20,1.36,1.29,216,219,216,49,20,29,37,19,18,28,9,19,+2,+2,0,80%,76%,83%,147,138,154,31%,45%,24%,4,3,1,2,1,1
16,https://vlr.gg/player/22314/mober,2024-11-26 13:00:00,0.81,1.61,1.28,242,194,285,57,17,40,39,23,16,11,2,9,+4,-1,+5,77%,56%,92%,167,130,193,34%,44%,31%,8,2,6,4,3,1
17,https://vlr.gg/player/14894/facepalm,2024-11-26 13:00:00,0.78,1.37,1.12,238,168,286,51,13,38,42,21,21,12,7,5,+9,-1,+10,80%,72%,86%,151,120,174,27%,33%,24%,15,2,13,6,3,3
18,https://vlr.gg/player/16139/enrik,2024-11-26 13:00:00,0.80,1.19,1.03,185,181,182,40,14,26,39,22,17,23,11,12,+1,-3,+4,74%,56%,86%,119,119,119,26%,24%,27%,6,2,4,5,5,0
19,https://vlr.gg/player/2853/apex,2024-11-26 13:00:00,0.49,1.22,0.92,184,112,220,37,10,27,43,23,20,38,9,29,+2,-1,+3,72%,52%,86%,107,73,131,40%,43%,39%,6,1,5,4,2,2
20,https://vlr.gg/player/573/cned,2024-11-26 13:00:00,1.52,0.79,1.16,243,276,212,22,13,9,17,6,11,2,1,1,+5,+3,+2,73%,92%,54%,160,193,128,19%,31%,10%,6,3,3,1,0,1
21,https://vlr.gg/player/19362/lyda,2024-11-26 13:00:00,1.53,0.60,1.06,234,326,144,20,15,5,18,8,10,4,2,2,-1,+1,-2,69%,77%,62%,146,196,96,21%,36%,7%,4,3,1,5,2,3
22,https://vlr.gg/player/21328/wo0t,2024-11-26 13:00:00,1.42,0.61,1.01,200,261,141,19,13,6,16,6,10,5,4,1,+1,+1,0,65%,92%,38%,136,175,98,38%,40%,35%,1,1,0,0,0,0
23,https://vlr.gg/player/19776/jrayn,2024-11-26 13:00:00,0.91,0.94,0.92,162,142,184,14,7,7,15,7,8,6,3,3,+1,+2,-1,85%,85%,85%,117,93,141,29%,39%,23%,2,2,0,1,0,1
24,https://vlr.gg/player/3557/skylen,2024-11-26 13:00:00,0.64,1.01,0.83,160,88,233,18,5,13,17,7,10,5,4,1,-4,-2,-2,65%,69%,62%,100,68,132,38%,38%,38%,1,0,1,5,2,3
25,https://vlr.gg/player/114/enzo,2024-11-26 13:00:00,1.52,0.77,1.15,220,235,205,17,10,7,17,6,11,10,6,4,+2,+3,-1,65%,77%,54%,157,148,166,19%,19%,19%,4,3,1,2,0,2
26,https://vlr.gg/player/30186/nami,2024-11-26 13:00:00,1.56,0.69,1.12,196,258,136,20,13,7,18,7,11,8,7,1,-2,+1,-3,65%,77%,54%,127,168,87,56%,60%,50%,1,1,0,3,0,3
27,https://vlr.gg/player/1284/mikee,2024-11-26 13:00:00,0.83,1.26,1.05,182,118,248,17,6,11,19,8,11,7,3,4,+1,-1,+2,77%,77%,77%,117,86,148,26%,21%,29%,2,0,2,1,1,0
28,https://vlr.gg/player/13258/cyvoph,2024-11-26 13:00:00,1.27,0.70,0.99,237,327,147,21,15,6,21,11,10,6,3,3,-1,+1,-2,65%,77%,54%,155,222,89,19%,17%,27%,5,4,1,6,3,3
29,https://vlr.gg/player/257/bramz,2024-11-26 13:00:00,0.70,0.45,0.57,85,89,81,8,5,3,18,8,10,6,3,3,-2,-1,-1,58%,62%,54%,58,55,61,37%,44%,30%,0,0,0,2,1,1
30,https://vlr.gg/player/2996/neiker,2024-11-26 11:00:00,0.98,1.82,1.26,228,184,315,29,15,14,21,16,5,15,11,4,0,0,0,72%,71%,75%,149,120,208,38%,27%,58%,2,2,0,2,2,0
31,https://vlr.gg/player/5487/adm1k,2024-11-26 11:00:00,1.09,1.42,1.20,207,184,269,28,16,12,21,14,7,9,7,2,-3,-1,-2,72%,71%,75%,142,120,187,40%,35%,46%,2,0,2,5,1,4
32,https://vlr.gg/player/22154/pika,2024-11-26 11:00:00,1.28,0.88,1.14,213,226,164,28,21,7,22,15,7,14,12,2,+1,+1,0,75%,79%,67%,133,147,106,24%,20%,37%,4,3,1,3,2,1
33,https://vlr.gg/player/22501/amore,2024-11-26 11:00:00,1.03,1.19,1.09,265,277,236,35,24,11,26,19,7,4,3,1,+7,+5,+2,67%,58%,83%,166,173,152,40%,43%,35%,12,9,3,5,4,1
34,https://vlr.gg/player/2893/hastack,2024-11-26 11:00:00,0.95,1.06,0.99,154,168,126,21,15,6,18,13,5,11,6,5,-1,-1,0,81%,75%,92%,98,108,78,18%,17%,20%,0,0,0,1,1,0
35,https://vlr.gg/player/33833/pepecho,2024-11-26 11:00:00,0.68,1.19,1.02,227,144,267,26,5,21,30,10,20,10,5,5,0,-1,+1,67%,75%,63%,153,98,181,34%,28%,36%,4,0,4,4,1,3
36,https://vlr.gg/player/46233/kz,2024-11-26 11:00:00,1.03,1.00,1.01,210,227,210,28,10,18,29,10,19,6,2,4,+3,+2,+1,72%,67%,75%,133,128,135,15%,21%,13%,9,4,5,6,2,4
37,https://vlr.gg/player/42514/aleexfdz,2024-11-26 11:00:00,0.74,0.90,0.85,172,127,185,21,6,15,26,9,17,8,3,5,-3,-1,-2,67%,67%,67%,115,88,129,30%,35%,29%,1,1,0,4,2,2
38,https://vlr.gg/player/48950/zeni,2024-11-26 11:00:00,0.65,0.86,0.79,171,150,186,20,6,14,29,11,18,17,2,15,-2,0,-2,67%,75%,63%,107,110,105,26%,26%,26%,1,0,1,3,0,3
39,https://vlr.gg/player/48951/hassan,2024-11-26 11:00:00,0.38,0.57,0.50,116,111,120,13,4,9,27,10,17,6,1,5,-2,0,-2,61%,50%,67%,85,81,87,29%,26%,31%,1,1,0,3,1,2
40,https://vlr.gg/player/41185/kaza,2024-11-26 04:15:00,0.71,0.88,0.83,187,180,188,22,6,16,29,9,20,5,1,4,+1,0,+1,62%,70%,58%,130,139,127,25%,29%,24%,2,0,2,1,0,1
41,https://vlr.gg/player/5436/azoh,2024-11-26 04:15:00,1.16,0.65,0.80,168,242,142,18,8,10,29,8,21,14,5,9,0,0,0,56%,90%,42%,114,154,97,24%,24%,24%,2,1,1,2,1,1
42,https://vlr.gg/player/3287/exempt,2024-11-26 04:15:00,1.06,0.64,0.76,184,249,160,20,9,11,32,10,22,9,4,5,0,0,0,68%,100%,54%,120,151,108,18%,21%,17%,5,1,4,5,1,4
43,https://vlr.gg/player/5240/indie,2024-11-26 04:15:00,0.12,0.99,0.73,168,60,216,19,2,17,27,8,19,2,0,2,-2,-3,+1,56%,30%,67%,106,42,133,38%,33%,38%,5,1,4,7,4,3
44,https://vlr.gg/player/31632/zenox,2024-11-26 04:15:00,0.62,0.38,0.45,122,158,106,12,5,7,32,9,23,6,2,4,-3,-1,-2,56%,70%,50%,90,123,77,27%,29%,25%,1,0,1,4,1,3
45,https://vlr.gg/player/17272/dokja,2024-11-26 04:15:00,1.67,1.36,1.58,298,329,227,38,31,7,18,12,6,16,11,5,+1,0,+1,85%,83%,90%,178,182,167,23%,25%,18%,5,4,1,4,4,0
46,https://vlr.gg/player/31580/vizsla,2024-11-26 04:15:00,1.16,2.28,1.49,255,218,340,34,18,16,17,14,3,16,13,3,+1,0,+1,88%,88%,90%,161,141,208,21%,17%,30%,3,2,1,2,2,0
47,https://vlr.gg/player/44437/ace,2024-11-26 04:15:00,1.39,1.21,1.33,253,220,325,34,23,11,20,11,9,12,6,6,+4,+1,+3,85%,83%,90%,157,139,199,41%,30%,61%,7,3,4,3,2,1
48,https://vlr.gg/player/1771/myth,2024-11-26 04:15:00,1.45,0.48,1.16,155,202,38,18,17,1,15,10,5,20,17,3,+1,+1,0,79%,88%,60%,106,136,35,32%,36%,13%,1,1,0,0,0,0
49,https://vlr.gg/player/36747/bonobo,2024-11-26 04:15:00,0.96,1.28,1.05,215,198,261,25,16,9,21,14,7,12,8,4,-3,-2,-1,74%,79%,60%,153,143,178,25%,33%,16%,3,2,1,6,4,2
50,https://vlr.gg/player/26316/ramen,2024-11-26 02:30:00,1.14,1.18,1.16,194,192,196,28,13,15,27,14,13,7,6,1,+2,+3,-1,64%,68%,60%,132,126,137,38%,33%,42%,4,4,0,2,1,1
51,https://vlr.gg/player/31589/murza,2024-11-26 02:30:00,1.04,0.74,0.89,212,256,174,28,17,11,31,15,16,8,5,3,-4,0,-4,64%,63%,65%,140,158,124,30%,27%,34%,3,2,1,7,2,5
52,https://vlr.gg/player/31593/kiss,2024-11-26 02:30:00,0.69,1.09,0.89,194,162,224,25,10,15,33,17,16,12,8,4,-2,-2,0,64%,58%,70%,120,99,141,42%,50%,38%,2,0,2,4,2,2
53,https://vlr.gg/player/46993/long,2024-11-26 02:30:00,0.98,0.66,0.82,167,187,148,19,11,8,29,14,15,19,11,8,-3,-1,-2,67%,68%,65%,114,121,106,25%,30%,22%,1,1,0,4,2,2
54,https://vlr.gg/player/34226/sh0pan,2024-11-26 02:30:00,0.43,0.64,0.52,153,134,170,20,9,11,35,17,18,4,4,0,-6,-1,-5,54%,58%,50%,97,80,112,26%,18%,35%,3,2,1,9,3,6
55,https://vlr.gg/player/6659/dragon,2024-11-26 02:30:00,1.86,1.11,1.49,293,372,212,41,27,14,23,12,11,11,6,5,+6,+3,+3,72%,75%,68%,183,223,142,27%,25%,31%,9,5,4,3,2,1
56,https://vlr.gg/player/12968/tixx,2024-11-26 02:30:00,1.02,1.80,1.40,226,149,309,34,11,23,19,10,9,20,10,10,+3,+2,+1,85%,75%,95%,146,108,186,26%,25%,26%,4,2,2,1,0,1
57,https://vlr.gg/player/26310/ikana,2024-11-26 02:30:00,1.22,1.15,1.19,212,200,223,28,15,13,23,10,13,16,7,9,0,+2,-2,79%,80%,79%,138,123,153,23%,17%,33%,2,2,0,2,0,2
58,https://vlr.gg/player/5228/minimise,2024-11-26 02:30:00,0.99,1.36,1.17,211,146,281,30,10,20,22,10,12,18,12,6,+1,0,+1,77%,75%,79%,126,86,168,23%,21%,24%,4,1,3,3,1,2
59,https://vlr.gg/player/1062/lew,2024-11-26 02:30:00,0.72,0.50,0.61,170,215,122,22,15,7,33,18,15,13,6,7,+3,+5,-2,77%,80%,74%,121,141,101,25%,31%,16%,7,6,1,4,1,3
60,https://vlr.gg/player/2864/ease,2024-11-25 15:10:00,1.67,1.27,1.49,256,305,198,20,13,7,13,7,6,12,8,4,0,+1,-1,77%,92%,60%,169,191,142,24%,13%,56%,2,1,1,2,0,2
61,https://vlr.gg/player/292/fit1nho,2024-11-25 15:10:00,1.04,1.80,1.38,314,228,418,24,9,15,16,9,7,3,2,1,+2,-1,+3,82%,83%,80%,216,171,269,32%,42%,24%,5,2,3,3,3,0
62,https://vlr.gg/player/7220/saiz,2024-11-25 15:10:00,1.74,0.63,1.24,223,317,111,17,14,3,14,7,7,7,3,4,-1,-2,+1,86%,100%,70%,147,204,79,35%,41%,21%,1,0,1,2,2,0
63,https://vlr.gg/player/20058/devilasxa,2024-11-25 15:10:00,0.92,0.94,0.93,157,153,163,11,6,5,14,8,6,10,5,5,-2,0,-2,82%,83%,80%,109,98,121,41%,46%,38%,0,0,0,2,0,2
64,https://vlr.gg/player/5199/guardy,2024-11-25 15:10:00,0.61,1.10,0.83,203,157,258,15,6,9,18,10,8,7,5,2,-1,-2,+1,73%,75%,70%,142,110,182,33%,39%,29%,2,1,1,3,3,0
65,https://vlr.gg/player/38424/zachkappa,2024-11-25 15:10:00,2.17,1.44,1.77,375,440,322,30,18,12,15,5,10,4,1,3,+2,0,+2,73%,70%,75%,253,278,232,23%,24%,22%,3,1,2,1,1,0
66,https://vlr.gg/player/30107/fluxxy,2024-11-25 15:10:00,1.23,0.70,0.94,155,211,109,12,7,5,16,7,9,7,4,3,-1,0,-1,64%,60%,67%,105,146,71,28%,27%,29%,0,0,0,1,0,1
67,https://vlr.gg/player/11322/sevire,2024-11-25 15:10:00,0.96,0.65,0.79,246,262,234,17,8,9,21,9,12,5,1,4,+3,0,+3,86%,90%,83%,148,147,149,34%,57%,23%,8,3,5,5,3,2
68,https://vlr.gg/player/20116/jademwah,2024-11-25 15:10:00,0.05,1.07,0.61,118,30,191,9,0,9,17,9,8,11,6,5,0,0,0,59%,40%,75%,72,18,117,15%,0%,18%,0,0,0,0,0,0
69,https://vlr.gg/player/30096/bobbiexo,2024-11-25 15:10:00,0.02,0.56,0.27,85,42,122,7,2,5,19,9,10,3,0,3,-2,-2,0,50%,30%,67%,72,30,107,33%,25%,38%,1,0,1,3,2,1
70,https://vlr.gg/player/114/enzo,2024-11-25 14:15:00,2.33,0.78,1.94,331,408,102,20,18,2,7,4,3,10,9,1,+2,+2,0,88%,100%,50%,202,254,45,18%,17%,20%,2,2,0,0,0,0
71,https://vlr.gg/player/13258/cyvoph,2024-11-25 14:15:00,1.12,2.04,1.35,331,265,529,18,11,7,13,9,4,5,3,2,+4,+2,+2,88%,92%,75%,201,161,322,27%,26%,31%,6,3,3,2,1,1
72,https://vlr.gg/player/1284/mikee,2024-11-25 14:15:00,1.51,0.89,1.35,233,284,81,14,13,1,8,6,2,2,2,0,0,0,0,69%,75%,50%,156,177,91,24%,19%,40%,2,2,0,2,2,0
73,https://vlr.gg/player/16321/nelo,2024-11-25 14:15:00,1.20,1.10,1.18,180,163,235,10,7,3,9,5,4,9,7,2,0,0,0,94%,100%,75%,102,83,158,23%,18%,29%,0,0,0,0,0,0
74,https://vlr.gg/player/30186/nami,2024-11-25 14:15:00,0.83,0.46,0.74,97,99,95,5,4,1,9,6,3,11,9,2,-2,-2,0,88%,100%,50%,66,57,92,21%,30%,11%,0,0,0,2,2,0
75,https://vlr.gg/player/49607/ciuffo,2024-11-25 14:15:00,2.57,0.75,1.21,298,541,217,16,8,8,14,2,12,4,2,2,+3,+1,+2,81%,100%,75%,206,354,157,41%,44%,38%,3,1,2,0,0,0
76,https://vlr.gg/player/23347/alannn,2024-11-25 14:15:00,1.20,0.59,0.74,159,189,149,11,4,7,14,3,11,0,0,0,+1,0,+1,75%,75%,75%,96,132,84,38%,67%,27%,1,0,1,0,0,0
77,https://vlr.gg/player/5854/z3ro,2024-11-25 14:15:00,0.68,0.76,0.74,154,155,154,9,2,7,12,3,9,6,2,4,-2,-1,-1,81%,100%,75%,104,115,101,38%,75%,29%,0,0,0,2,1,1
78,https://vlr.gg/player/24068/effy,2024-11-25 14:15:00,0.38,0.51,0.48,126,135,124,7,2,5,12,3,9,2,0,2,-5,-1,-4,56%,75%,50%,78,80,77,32%,50%,28%,0,0,0,5,1,4
79,https://vlr.gg/player/1944/cayden,2024-11-25 14:15:00,0.09,0.26,0.22,74,13,95,3,0,3,15,3,12,5,2,3,-1,-1,0,38%,50%,33%,47,,63,33%,,33%,2,0,2,3,1,2
80,https://vlr.gg/player/573/cned,2024-11-25 13:00:00,1.44,1.73,1.59,368,339,396,30,13,17,18,9,9,5,2,3,+5,+1,+4,87%,82%,92%,244,235,252,28%,28%,28%,7,3,4,2,2,0
81,https://vlr.gg/player/21328/wo0t,2024-11-25 13:00:00,0.92,1.08,1.00,213,235,193,16,8,8,16,9,7,11,6,5,-2,0,-2,83%,82%,83%,143,157,130,36%,26%,53%,2,1,1,4,1,3
82,https://vlr.gg/player/19362/lyda,2024-11-25 13:00:00,1.03,0.74,0.88,217,242,195,16,9,7,19,9,10,3,1,2,0,0,0,52%,64%,42%,161,170,152,21%,27%,16%,1,0,1,1,0,1
83,https://vlr.gg/player/19776/jrayn,2024-11-25 13:00:00,1.01,0.62,0.81,156,162,152,13,8,5,19,8,11,4,1,3,-1,-1,0,70%,64%,75%,116,117,116,35%,20%,53%,0,0,0,1,1,0
84,https://vlr.gg/player/3557/skylen,2024-11-25 13:00:00,0.06,1.14,0.63,170,91,244,14,3,11,20,11,9,8,4,4,-3,-3,0,61%,55%,67%,103,57,146,48%,38%,53%,1,0,1,4,3,1
85,https://vlr.gg/player/4629/azury,2024-11-25 13:00:00,1.45,1.85,1.64,309,325,292,28,13,15,16,9,7,3,3,0,0,0,0,74%,67%,82%,210,220,200,34%,30%,38%,1,1,0,1,1,0
86,https://vlr.gg/player/12528/disisjohn,2024-11-25 13:00:00,0.91,2.02,1.44,325,247,412,27,11,16,19,11,8,5,2,3,+5,+1,+4,78%,67%,91%,196,151,244,23%,25%,20%,6,1,5,1,0,1
87,https://vlr.gg/player/3753/obnoks,2024-11-25 13:00:00,1.23,0.57,0.92,147,218,71,12,10,2,16,9,7,15,6,9,-1,-1,0,70%,75%,64%,102,145,56,18%,18%,20%,1,1,0,2,2,0
88,https://vlr.gg/player/37969/ellie,2024-11-25 13:00:00,0.75,1.08,0.91,218,195,244,17,8,9,20,11,9,8,3,5,0,-1,+1,78%,67%,91%,152,136,169,37%,35%,40%,2,1,1,2,2,0
89,https://vlr.gg/player/4325/musashi,2024-11-25 13:00:00,0.72,0.36,0.55,123,112,136,8,4,4,18,8,10,13,7,6,-3,-1,-2,70%,83%,55%,98,93,103,21%,25%,17%,2,1,1,5,2,3
90,https://vlr.gg/player/12947/rawfiul,2024-11-25 07:55:00,0.96,1.61,1.30,274,214,333,67,25,42,46,25,21,22,12,10,+2,-3,+5,77%,74%,81%,174,134,212,30%,27%,32%,7,2,5,5,5,0
91,https://vlr.gg/player/13221/azys,2024-11-25 07:55:00,1.21,1.34,1.28,270,276,267,69,33,36,47,25,22,11,7,4,-1,0,-1,74%,74%,75%,173,173,174,27%,33%,20%,10,6,4,11,6,5
92,https://vlr.gg/player/3628/deathmaker,2024-11-25 07:55:00,1.24,0.77,1.00,212,225,202,53,28,25,48,20,28,17,7,10,+2,+1,+1,73%,74%,72%,137,145,128,26%,29%,23%,9,3,6,7,2,5
93,https://vlr.gg/player/18704/levi,2024-11-25 07:55:00,0.73,1.07,0.91,164,137,191,42,16,26,47,25,22,22,15,7,-5,-3,-2,69%,71%,67%,107,82,130,28%,28%,28%,1,0,1,6,3,3
94,https://vlr.gg/player/3269/antidote,2024-11-25 07:55:00,1.05,0.75,0.90,186,218,154,43,26,17,48,25,23,27,13,14,-2,-1,-1,71%,76%,67%,121,143,100,33%,34%,30%,6,3,3,8,4,4
95,https://vlr.gg/player/40912/123,2024-11-25 07:55:00,1.00,1.10,1.05,223,225,222,55,27,28,57,31,26,21,15,6,+5,+3,+2,70%,72%,68%,153,152,155,26%,25%,26%,11,6,5,6,3,3
96,https://vlr.gg/player/18702/deadly10,2024-11-25 07:55:00,1.20,0.87,1.04,241,259,221,60,32,28,58,29,29,12,8,4,+5,+2,+3,71%,83%,59%,142,156,128,25%,22%,31%,15,6,9,10,4,6
97,https://vlr.gg/player/19231/kibojn,2024-11-25 07:55:00,0.88,1.15,1.01,214,180,247,52,23,29,55,28,27,24,12,12,+3,+2,+1,74%,69%,79%,124,103,146,32%,38%,28%,6,4,2,3,2,1
98,https://vlr.gg/player/48426/ghostxd,2024-11-25 07:55:00,0.50,0.97,0.73,140,108,177,37,16,21,50,29,21,10,2,8,-4,-3,-1,60%,50%,71%,102,79,127,36%,43%,32%,2,0,2,6,3,3
99,https://vlr.gg/player/8156/mojo,2024-11-25 07:55:00,0.74,0.67,0.71,145,154,136,32,18,14,54,29,25,33,16,17,-5,-6,+1,67%,69%,65%,92,98,85,15%,22%,10%,3,1,2,8,7,1
100,https://vlr.gg/player/4866/kushy,2024-11-25 06:30:00,,,,249,,,64,,,51,,,18,,,,,,,,,,,,,,,,,,,,
101,https://vlr.gg/player/24895/jemkin,2024-11-25 06:30:00,,,,242,,,65,,,51,,,14,,,,,,,,,,,,,,,,,,,,
102,https://vlr.gg/player/8497/monyet,2024-11-25 06:30:00,,,,169,,,44,,,59,,,15,,,,,,,,,,,,,,,,,,,,
103,https://vlr.gg/player/4871/xffero,2024-11-25 06:30:00,,,,156,,,40,,,49,,,20,,,,,,,,,,,,,,,,,,,,
104,https://vlr.gg/player/25025/estrella,2024-11-25 06:30:00,,,,140,,,37,,,46,,,37,,,,,,,,,,,,,,,,,,,,
105,https://vlr.gg/player/17086/something,2024-11-25 06:30:00,,,,216,,,58,,,45,,,11,,,,,,,,,,,,,,,,,,,,
106,https://vlr.gg/player/9800/mindfreak,2024-11-25 06:30:00,,,,201,,,54,,,46,,,21,,,,,,,,,,,,,,,,,,,,
107,https://vlr.gg/player/9803/d4v41,2024-11-25 06:30:00,,,,195,,,51,,,48,,,9,,,,,,,,,,,,,,,,,,,,
108,https://vlr.gg/player/7378/jinggg,2024-11-25 06:30:00,,,,191,,,47,,,55,,,10,,,,,,,,,,,,,,,,,,,,
109,https://vlr.gg/player/9801/f0rsaken,2024-11-25 06:30:00,,,,174,,,46,,,56,,,26,,,,,,,,,,,,,,,,,,,,
110,https://vlr.gg/player/31580/vizsla,2024-11-25 04:30:00,1.39,1.44,1.41,247,265,231,56,35,21,34,21,13,20,10,10,+1,+3,-2,78%,81%,75%,156,164,145,24%,23%,26%,7,6,1,6,3,3
111,https://vlr.gg/player/44437/ace,2024-11-25 04:30:00,1.50,1.00,1.30,324,313,274,65,42,23,41,22,19,13,11,2,+4,+4,0,77%,81%,71%,198,199,196,37%,38%,36%,12,7,5,8,3,5
112,https://vlr.gg/player/1771/myth,2024-11-25 04:30:00,1.49,0.95,1.27,202,227,160,43,30,13,32,16,16,34,20,14,+2,+3,-1,80%,89%,67%,126,143,99,23%,21%,32%,3,3,0,1,0,1
113,https://vlr.gg/player/17272/dokja,2024-11-25 04:30:00,0.79,1.26,0.98,190,179,234,42,21,21,38,24,14,13,9,4,-3,-2,-1,68%,67%,71%,126,121,133,30%,24%,38%,5,3,2,8,5,3
114,https://vlr.gg/player/36747/bonobo,2024-11-25 04:30:00,0.77,0.75,0.76,160,147,196,35,20,15,43,24,19,16,9,7,-2,-2,0,68%,72%,63%,112,101,128,36%,36%,35%,4,2,2,6,4,2
115,https://vlr.gg/player/34257/strame,2024-11-25 04:30:00,1.40,0.77,1.02,205,255,186,46,23,23,48,16,32,7,3,4,+1,+1,0,58%,71%,50%,145,174,126,28%,38%,22%,6,2,4,5,1,4
116,https://vlr.gg/player/28843/abbas,2024-11-25 04:30:00,0.96,0.84,0.88,193,192,203,40,18,22,48,19,29,17,6,11,-4,+1,-5,63%,71%,58%,132,124,138,25%,28%,23%,5,4,1,9,3,6
117,https://vlr.gg/player/48913/zek,2024-11-25 04:30:00,0.72,0.97,0.85,169,158,198,38,13,25,49,20,29,13,7,6,-1,0,-1,57%,63%,53%,131,121,138,23%,26%,21%,6,2,4,7,2,5
118,https://vlr.gg/player/10089/andy,2024-11-25 04:30:00,0.64,0.94,0.82,184,172,198,37,13,24,49,20,29,9,4,5,+2,-1,+3,60%,54%,64%,129,122,134,27%,23%,30%,8,3,5,6,4,2
119,https://vlr.gg/player/31629/muzz,2024-11-25 04:30:00,0.98,0.59,0.74,130,165,120,27,14,13,47,18,29,16,9,7,0,+3,-3,60%,67%,56%,100,104,97,31%,31%,30%,4,3,1,4,0,4
120,https://vlr.gg/player/3045/luok1ng,2024-11-25 04:00:00,,,,264,,,42,,,26,,,31,,,,,,,,,,,,,,,,,,,,
121,https://vlr.gg/player/37494/kai,2024-11-25 04:00:00,,,,242,,,38,,,29,,,16,,,,,,,,,,,,,,,,,,,,
122,https://vlr.gg/player/3021/biank,2024-11-25 04:00:00,,,,238,,,37,,,30,,,16,,,,,,,,,,,,,,,,,,,,
123,https://vlr.gg/player/4712/heybay,2024-11-25 04:00:00,,,,188,,,33,,,31,,,26,,,,,,,,,,,,,,,,,,,,
124,https://vlr.gg/player/4770/fengf,2024-11-25 04:00:00,,,,180,,,30,,,34,,,10,,,,,,,,,,,,,,,,,,,,
125,https://vlr.gg/player/11600/foxy9,2024-11-25 04:00:00,,,,253,,,36,,,37,,,15,,,,,,,,,,,,,,,,,,,,
126,https://vlr.gg/player/25081/yoman,2024-11-25 04:00:00,,,,216,,,35,,,32,,,15,,,,,,,,,,,,,,,,,,,,
127,https://vlr.gg/player/2489/munchkin,2024-11-25 04:00:00,,,,182,,,28,,,36,,,15,,,,,,,,,,,,,,,,,,,,
128,https://vlr.gg/player/9196/t3xture,2024-11-25 04:00:00,,,,171,,,28,,,37,,,7,,,,,,,,,,,,,,,,,,,,
129,https://vlr.gg/player/34974/karon,2024-11-25 04:00:00,,,,137,,,23,,,38,,,15,,,,,,,,,,,,,,,,,,,,
130,https://vlr.gg/player/31255/biggiecheese,2024-11-25 02:30:00,1.14,0.77,0.97,200,233,168,27,18,9,30,15,15,11,7,4,0,-2,+2,74%,81%,67%,133,151,112,29%,32%,24%,4,1,3,4,3,1
131,https://vlr.gg/player/43125/kadiri,2024-11-25 02:30:00,1.20,0.64,0.94,165,201,126,25,17,8,27,12,15,7,3,4,+1,+2,-1,69%,81%,56%,115,137,90,34%,37%,30%,2,2,0,1,0,1
132,https://vlr.gg/player/31254/feta,2024-11-25 02:30:00,0.83,0.72,0.78,194,198,182,21,11,10,32,17,15,14,10,4,0,0,0,69%,76%,61%,135,146,122,19%,28%,9%,6,4,2,6,4,2
133,https://vlr.gg/player/29821/sinaway,2024-11-25 02:30:00,0.65,0.77,0.71,169,167,166,22,12,10,32,17,15,8,5,3,-3,-1,-2,59%,57%,61%,103,106,99,38%,41%,35%,4,3,1,7,4,3
134,https://vlr.gg/player/29790/zauqk,2024-11-25 02:30:00,0.80,0.54,0.68,138,139,137,18,10,8,33,17,16,15,10,5,-1,0,-1,72%,81%,61%,97,103,90,20%,28%,12%,2,0,2,3,0,3
135,https://vlr.gg/player/31632/zenox,2024-11-25 02:30:00,1.79,1.72,1.75,303,281,311,47,22,25,17,6,11,10,3,7,+4,0,+4,85%,89%,81%,197,198,197,27%,31%,24%,5,1,4,1,1,0
136,https://vlr.gg/player/5436/azoh,2024-11-25 02:30:00,1.67,1.39,1.52,244,238,247,33,15,18,19,7,12,29,14,15,+2,+2,0,87%,89%,86%,157,157,156,23%,20%,25%,4,3,1,2,1,1
137,https://vlr.gg/player/41185/kaza,2024-11-25 02:30:00,1.18,0.91,1.04,168,180,156,25,12,13,22,9,13,14,9,5,-2,-1,-1,77%,72%,81%,114,124,105,29%,31%,27%,2,1,1,4,2,2
138,https://vlr.gg/player/5240/indie,2024-11-25 02:30:00,0.98,0.89,0.93,210,233,192,27,15,12,30,14,16,20,10,10,0,+2,-2,77%,72%,81%,147,158,137,33%,44%,24%,6,4,2,6,2,4
139,https://vlr.gg/player/3287/exempt,2024-11-25 02:30:00,1.25,0.61,0.91,164,196,146,22,12,10,25,9,16,19,10,9,-1,-1,0,79%,83%,76%,110,133,89,21%,21%,22%,4,1,3,5,2,3
140,https://vlr.gg/player/873/bob,2024-11-24 22:30:00,1.23,1.33,1.29,291,281,289,51,24,27,41,20,21,9,2,7,+4,0,+4,72%,63%,81%,169,160,178,26%,30%,22%,13,6,7,9,6,3
141,https://vlr.gg/player/26848/zeek,2024-11-24 22:30:00,1.05,1.29,1.18,191,167,213,36,16,20,29,15,14,21,9,12,-1,0,-1,74%,71%,77%,126,103,148,27%,21%,31%,2,1,1,3,1,2
142,https://vlr.gg/player/25902/shondex,2024-11-24 22:30:00,1.08,1.23,1.16,217,221,212,41,19,22,32,18,14,8,5,3,-2,0,-2,72%,63%,81%,156,138,173,44%,40%,48%,4,4,0,6,4,2
143,https://vlr.gg/player/16671/welyy,2024-11-24 22:30:00,0.81,1.13,0.98,170,133,209,23,8,15,31,16,15,28,13,15,-2,-1,-1,68%,63%,73%,136,116,154,19%,20%,19%,2,0,2,4,1,3
144,https://vlr.gg/player/11696/zoestol,2024-11-24 22:30:00,0.74,1.05,0.90,147,135,165,24,9,15,31,17,14,31,16,15,+3,-1,+4,76%,71%,81%,105,92,116,29%,28%,30%,5,0,5,2,1,1
145,https://vlr.gg/player/34400/bao,2024-11-24 22:30:00,1.15,0.98,1.07,204,244,167,37,23,14,35,21,14,18,8,10,+2,-2,+4,72%,65%,79%,133,155,110,34%,32%,36%,5,1,4,3,3,0
146,https://vlr.gg/player/29688/mikee,2024-11-24 22:30:00,0.73,1.44,1.07,215,144,286,39,15,24,35,20,15,3,0,3,+6,+3,+3,66%,50%,83%,138,90,190,33%,32%,33%,10,5,5,4,2,2
147,https://vlr.gg/player/34057/jerrwin,2024-11-24 22:30:00,0.79,1.30,1.04,257,222,297,46,20,26,39,22,17,11,6,5,-3,-1,-2,68%,62%,75%,169,138,204,27%,27%,26%,6,4,2,9,5,4
148,https://vlr.gg/player/3874/teague,2024-11-24 22:30:00,0.88,1.10,0.98,164,145,196,29,12,17,32,18,14,23,10,13,-1,-2,+1,72%,69%,75%,100,87,113,28%,32%,24%,1,0,1,2,2,0
149,https://vlr.gg/player/4385/monsi,2024-11-24 22:30:00,0.54,0.57,0.55,112,115,102,13,8,5,35,19,16,21,6,15,-6,-2,-4,70%,62%,79%,78,81,74,14%,12%,18%,2,1,1,8,3,5
150,https://vlr.gg/player/45918/clutchz,2024-11-24 19:50:00,1.15,1.64,1.40,294,237,351,50,21,29,33,18,15,6,3,3,+5,+1,+4,75%,67%,83%,191,151,231,24%,25%,23%,10,4,6,5,3,2
151,https://vlr.gg/player/24021/snapss,2024-11-24 19:50:00,0.95,1.54,1.24,224,183,265,40,15,25,29,17,12,11,5,6,+5,+2,+3,73%,75%,71%,137,122,152,29%,27%,31%,7,3,4,2,1,1
152,https://vlr.gg/player/2491/nolan,2024-11-24 19:50:00,1.47,0.96,1.22,207,224,191,37,22,15,28,11,17,13,3,10,0,+3,-3,81%,83%,79%,139,144,134,28%,43%,17%,5,4,1,5,1,4
153,https://vlr.gg/player/7639/ezznap,2024-11-24 19:50:00,0.85,1.02,0.94,160,174,148,25,14,11,28,16,12,24,12,12,0,-3,+3,71%,58%,83%,112,126,98,22%,27%,17%,3,0,3,3,3,0
154,https://vlr.gg/player/49571/paganus,2024-11-24 19:50:00,0.73,0.77,0.75,143,148,138,21,10,11,34,18,16,18,11,7,+2,+1,+1,73%,75%,71%,93,101,84,35%,30%,43%,5,3,2,3,2,1
155,https://vlr.gg/player/6450/korsonix,2024-11-24 19:50:00,1.14,1.19,1.17,228,229,227,37,18,19,32,17,15,13,5,8,+1,0,+1,73%,71%,75%,150,160,140,28%,32%,24%,5,2,3,4,2,2
156,https://vlr.gg/player/8286/glyph,2024-11-24 19:50:00,1.28,1.03,1.15,229,246,211,36,20,16,33,16,17,19,7,12,-1,-1,0,77%,71%,83%,148,171,125,26%,29%,23%,3,0,3,4,1,3
157,https://vlr.gg/player/17694/prask,2024-11-24 19:50:00,0.64,1.09,0.86,162,123,201,29,11,18,34,19,15,10,5,5,+1,+1,0,67%,67%,67%,110,82,138,32%,31%,33%,4,3,1,3,2,1
158,https://vlr.gg/player/8792/xhowi,2024-11-24 19:50:00,0.74,0.74,0.74,154,157,151,25,13,12,35,17,18,11,5,6,-7,-3,-4,58%,50%,67%,104,100,108,39%,48%,33%,1,0,1,8,3,5
159,https://vlr.gg/player/593/fresht,2024-11-24 19:50:00,0.34,0.83,0.59,154,134,175,25,10,15,39,22,17,8,5,3,-6,-5,-1,56%,46%,67%,96,88,105,26%,19%,31%,5,3,2,11,8,3
160,https://vlr.gg/player/25902/shondex,2024-11-24 19:00:00,1.53,1.17,1.35,270,304,233,73,41,32,53,26,27,21,14,7,+2,+3,-1,82%,84%,79%,177,208,147,29%,35%,22%,7,3,4,5,0,5
161,https://vlr.gg/player/26848/zeek,2024-11-24 19:00:00,1.19,0.87,1.03,198,233,178,55,33,22,60,30,30,34,16,18,0,0,0,70%,82%,59%,136,154,118,16%,19%,11%,3,1,2,3,1,2
162,https://vlr.gg/player/873/bob,2024-11-24 19:00:00,0.78,1.03,0.91,238,218,246,60,27,33,65,33,32,13,7,6,-5,-3,-2,61%,63%,59%,148,140,155,29%,26%,31%,15,11,4,20,14,6
163,https://vlr.gg/player/16671/welyy,2024-11-24 19:00:00,0.86,0.95,0.90,179,160,197,45,21,24,53,25,28,22,14,8,+4,0,+4,68%,74%,62%,126,110,142,23%,21%,25%,9,2,7,5,2,3
164,https://vlr.gg/player/11696/zoestol,2024-11-24 19:00:00,0.87,0.82,0.85,149,138,172,41,20,21,56,26,30,31,11,20,-4,-2,-2,70%,68%,72%,105,96,114,22%,25%,20%,3,1,2,7,3,4
165,https://vlr.gg/player/8758/benjii,2024-11-24 19:00:00,1.39,0.98,1.19,211,228,182,57,33,24,48,24,24,37,24,13,+3,0,+3,78%,77%,79%,135,148,122,27%,26%,29%,4,1,3,1,1,0
166,https://vlr.gg/player/6437/dark3st,2024-11-24 19:00:00,1.05,1.00,1.03,209,180,244,54,24,30,54,24,30,26,17,9,-3,-1,-2,69%,64%,74%,146,130,162,26%,25%,26%,6,3,3,9,4,5
167,https://vlr.gg/player/21886/furbsa,2024-11-24 19:00:00,0.97,0.98,0.98,225,244,218,63,33,30,59,30,29,13,9,4,+2,-1,+3,68%,67%,68%,146,158,133,28%,28%,30%,15,6,9,13,7,6
168,https://vlr.gg/player/8397/dip,2024-11-24 19:00:00,1.04,0.91,0.97,187,186,196,52,25,27,53,25,28,28,16,12,+2,+3,-1,82%,85%,79%,122,115,130,29%,40%,21%,5,4,1,3,1,2
169,https://vlr.gg/player/8434/nabil,2024-11-24 19:00:00,1.02,0.89,0.96,235,239,227,61,32,29,60,29,31,21,12,9,-1,0,-1,77%,82%,71%,151,157,146,29%,29%,28%,10,6,4,11,6,5
170,https://vlr.gg/player/34400/bao,2024-11-24 19:00:00,1.09,1.33,1.21,247,232,261,43,20,23,32,17,15,22,12,10,-2,0,-2,80%,84%,75%,149,146,153,42%,44%,40%,2,1,1,4,1,3
171,https://vlr.gg/player/34057/jerrwin,2024-11-24 19:00:00,1.00,1.30,1.15,251,235,271,41,20,21,39,20,19,12,5,7,+5,0,+5,78%,84%,71%,166,158,175,24%,25%,23%,9,3,6,4,3,1
172,https://vlr.gg/player/3874/teague,2024-11-24 19:00:00,1.17,1.04,1.10,179,213,140,30,18,12,32,17,15,29,15,14,+2,-1,+3,71%,72%,71%,109,127,90,23%,19%,29%,5,1,4,3,2,1
173,https://vlr.gg/player/29688/mikee,2024-11-24 19:00:00,0.90,1.21,1.05,214,205,222,36,18,18,33,18,15,9,3,6,-4,-3,-1,57%,44%,71%,152,147,156,36%,31%,42%,5,3,2,9,6,3
174,https://vlr.gg/player/4385/monsi,2024-11-24 19:00:00,1.03,1.06,1.04,170,161,184,28,13,15,29,16,13,18,10,8,0,-1,+1,76%,80%,71%,113,106,120,26%,28%,24%,4,2,2,4,3,1
175,https://vlr.gg/player/823/rebo,2024-11-24 19:00:00,1.35,1.05,1.20,248,295,199,41,25,16,33,17,16,18,9,9,-1,0,-1,73%,67%,80%,162,186,139,30%,33%,27%,2,1,1,3,1,2
176,https://vlr.gg/player/3986/truth,2024-11-24 19:00:00,1.03,1.25,1.14,212,214,215,40,19,21,33,18,15,9,3,6,-1,-1,0,65%,67%,64%,138,141,134,35%,42%,29%,4,2,2,5,3,2
177,https://vlr.gg/player/16028/klamran,2024-11-24 19:00:00,0.74,1.06,0.90,161,134,188,28,11,17,31,16,15,9,4,5,-2,-2,0,65%,63%,68%,108,87,128,38%,35%,40%,1,0,1,3,2,1
178,https://vlr.gg/player/28316/eyan,2024-11-24 19:00:00,0.57,0.84,0.70,152,146,158,25,10,15,37,19,18,13,10,3,-2,0,-2,71%,75%,68%,108,110,107,49%,48%,50%,1,1,0,3,1,2
179,https://vlr.gg/player/8410/cuz,2024-11-24 19:00:00,0.51,0.74,0.62,199,145,251,31,12,19,44,19,25,5,1,4,+5,-3,+8,61%,54%,68%,122,91,152,28%,41%,21%,16,5,11,11,8,3
180,https://vlr.gg/player/41466/mixyce,2024-11-24 17:45:00,1.22,0.90,1.09,227,243,214,49,32,17,46,26,20,20,13,7,+4,+3,+1,79%,83%,72%,147,151,140,18%,23%,12%,8,5,3,4,2,2
181,https://vlr.gg/player/47551/sanoj,2024-11-24 17:45:00,1.00,1.13,1.05,265,266,261,54,31,23,51,30,21,14,9,5,+2,+3,-1,67%,72%,60%,166,167,164,32%,35%,29%,10,6,4,8,3,5
182,https://vlr.gg/player/25691/astroboy,2024-11-24 17:45:00,0.76,1.08,0.89,187,172,211,39,21,18,48,29,19,20,12,8,+1,+1,0,75%,75%,76%,125,112,144,31%,31%,31%,8,5,3,7,4,3
183,https://vlr.gg/player/45658/tonix,2024-11-24 17:45:00,1.01,0.58,0.83,155,176,129,34,23,11,40,21,19,10,6,4,-2,-2,0,66%,67%,64%,105,118,86,28%,31%,22%,3,2,1,5,4,1
184,https://vlr.gg/player/43538/borgesz,2024-11-24 17:45:00,0.98,0.51,0.79,140,156,121,32,22,10,42,22,20,11,8,3,-4,-1,-3,69%,78%,56%,98,110,82,31%,34%,28%,2,2,0,6,3,3
185,https://vlr.gg/player/32801/turkish,2024-11-24 17:45:00,1.57,0.87,1.16,182,235,155,42,24,18,37,11,26,10,2,8,+3,+1,+2,75%,76%,75%,120,145,103,40%,31%,51%,6,3,3,3,2,1
186,https://vlr.gg/player/41864/rodd,2024-11-24 17:45:00,1.19,1.10,1.14,259,227,282,52,19,33,45,16,29,24,9,15,-1,0,-1,72%,68%,75%,171,153,183,23%,28%,21%,10,3,7,11,3,8
187,https://vlr.gg/player/23855/str0nda,2024-11-24 17:45:00,1.10,1.17,1.14,193,206,185,46,21,25,40,16,24,24,9,15,-4,-2,-2,79%,80%,78%,129,135,125,31%,33%,29%,3,1,2,7,3,4
188,https://vlr.gg/player/41676/toronto,2024-11-24 17:45:00,0.98,0.99,0.98,184,195,169,43,19,24,40,16,24,13,4,9,+1,0,+1,77%,80%,75%,120,129,114,39%,49%,32%,3,1,2,2,1,1
189,https://vlr.gg/player/22914/hiiik,2024-11-24 17:45:00,0.88,1.05,0.98,230,203,237,44,16,28,46,20,26,30,11,19,0,+4,-4,69%,72%,67%,150,136,160,28%,33%,26%,8,6,2,8,2,6
190,https://vlr.gg/player/7618/theory,2024-11-24 17:00:00,1.83,0.91,1.40,255,318,193,41,28,13,26,11,15,9,5,4,+1,0,+1,69%,79%,57%,170,210,124,40%,42%,37%,5,3,2,4,3,1
191,https://vlr.gg/player/35583/edu,2024-11-24 17:00:00,1.22,1.19,1.21,218,202,236,33,16,17,31,14,17,16,11,5,+2,+2,0,71%,75%,67%,155,149,161,34%,34%,33%,3,2,1,1,0,1
192,https://vlr.gg/player/38921/fotzy,2024-11-24 17:00:00,1.06,0.69,0.89,211,258,158,36,24,12,34,16,18,7,2,5,+3,+7,-4,64%,75%,52%,134,159,106,42%,43%,39%,11,8,3,8,1,7
193,https://vlr.gg/player/12955/danger,2024-11-24 17:00:00,0.96,0.76,0.87,160,171,149,28,17,11,31,15,16,18,11,7,0,0,0,73%,88%,57%,109,121,96,38%,41%,35%,3,1,2,3,1,2
194,https://vlr.gg/player/8057/josegxbo,2024-11-24 17:00:00,0.90,0.72,0.82,156,150,162,24,13,11,33,16,17,17,11,6,-3,-3,0,76%,83%,67%,104,105,103,37%,47%,28%,2,1,1,5,4,1
195,https://vlr.gg/player/41409/vandals,2024-11-24 17:00:00,0.96,1.02,0.99,210,188,235,32,14,18,36,15,21,12,7,5,-2,-2,0,62%,67%,58%,150,147,152,36%,34%,38%,3,1,2,5,3,2
196,https://vlr.gg/player/24026/generalsteak,2024-11-24 17:00:00,1.07,0.90,0.98,187,167,203,29,13,16,27,10,17,13,9,4,-1,0,-1,76%,86%,67%,118,114,121,38%,53%,33%,4,2,2,5,2,3
197,https://vlr.gg/player/2490/jfoen,2024-11-24 17:00:00,1.11,0.85,0.97,208,227,196,33,17,16,32,13,19,6,2,4,+1,+3,-2,71%,71%,71%,139,154,126,38%,39%,36%,6,4,2,5,1,4
198,https://vlr.gg/player/10556/drakk,2024-11-24 17:00:00,1.05,0.76,0.90,206,205,205,33,18,15,35,13,22,7,0,7,-1,-1,0,73%,81%,67%,130,135,125,32%,37%,26%,4,1,3,5,2,3
199,https://vlr.gg/player/8902/vapes,2024-11-24 17:00:00,1.28,0.34,0.78,163,267,72,28,21,7,32,13,19,3,1,2,0,+3,-3,64%,76%,54%,100,157,50,44%,47%,35%,4,4,0,4,1,3
200,https://vlr.gg/player/1605/champzera,2024-11-24 16:55:00,1.02,1.18,1.11,215,195,228,28,9,19,23,10,13,14,7,7,+4,-1,+5,85%,80%,88%,137,129,143,33%,38%,30%,5,0,5,1,1,0
201,https://vlr.gg/player/20251/vit9ine,2024-11-24 16:55:00,1.28,0.65,0.89,196,260,156,26,14,12,28,10,18,9,1,8,-5,-1,-4,69%,87%,58%,144,179,122,31%,41%,23%,0,0,0,5,1,4
202,https://vlr.gg/player/36105/needy,2024-11-24 16:55:00,0.59,0.93,0.80,195,153,222,24,7,17,29,12,17,7,2,5,0,+1,-1,67%,60%,71%,150,115,171,23%,38%,19%,4,3,1,4,2,2
203,https://vlr.gg/player/25683/desire,2024-11-24 16:55:00,0.55,0.91,0.77,164,99,206,23,5,18,29,11,18,7,5,2,+2,-2,+4,67%,67%,67%,97,64,117,40%,50%,38%,6,0,6,4,2,2
204,https://vlr.gg/player/1595/myssen,2024-11-24 16:55:00,0.86,0.58,0.69,139,171,119,18,9,9,31,11,20,8,0,8,-4,-2,-2,64%,60%,67%,103,125,89,45%,41%,50%,3,2,1,7,4,3
205,https://vlr.gg/player/8896/loweed,2024-11-24 16:55:00,1.64,1.24,1.49,250,281,201,36,25,11,20,12,8,16,9,7,+3,+2,+1,87%,88%,87%,159,171,140,24%,27%,18%,3,2,1,0,0,0
206,https://vlr.gg/player/6222/ginilson,2024-11-24 16:55:00,1.36,1.42,1.39,257,247,273,35,21,14,24,15,9,10,7,3,+6,+2,+4,79%,83%,73%,182,175,193,30%,27%,36%,7,3,4,1,1,0
207,https://vlr.gg/player/16620/bruninej,2024-11-24 16:55:00,0.85,1.25,1.00,170,141,218,27,12,15,23,15,8,13,12,1,-1,-3,+2,77%,71%,87%,112,83,159,37%,35%,39%,3,1,2,4,4,0
208,https://vlr.gg/player/5342/duht,2024-11-24 16:55:00,1.14,0.58,0.92,153,179,113,20,15,5,25,15,10,26,19,7,0,+1,-1,74%,83%,60%,101,115,79,25%,24%,26%,1,1,0,1,0,1
209,https://vlr.gg/player/1999/rnd,2024-11-24 16:55:00,0.73,0.81,0.76,182,169,202,22,13,9,27,18,9,10,8,2,-5,-4,-1,74%,71%,80%,121,118,127,20%,19%,22%,7,4,3,12,8,4
210,https://vlr.gg/player/34057/jerrwin,2024-11-24 16:00:00,0.77,1.60,1.23,283,199,340,58,17,41,45,23,22,15,7,8,+9,-1,+10,70%,70%,70%,173,121,215,25%,24%,26%,17,5,12,8,6,2
211,https://vlr.gg/player/29688/mikee,2024-11-24 16:00:00,1.12,1.18,1.16,224,234,217,51,23,28,39,19,20,11,2,9,+2,+2,0,62%,52%,70%,143,147,140,27%,33%,23%,7,4,3,5,2,3
212,https://vlr.gg/player/34400/bao,2024-11-24 16:00:00,1.13,1.14,1.13,226,216,230,46,20,26,41,20,21,26,14,12,+3,-1,+4,82%,85%,79%,138,137,140,22%,30%,17%,8,2,6,5,3,2
213,https://vlr.gg/player/4385/monsi,2024-11-24 16:00:00,0.55,0.99,0.80,135,116,152,28,9,19,38,21,17,15,7,8,0,-1,+1,67%,56%,76%,90,79,99,24%,27%,23%,2,1,1,2,2,0
214,https://vlr.gg/player/3874/teague,2024-11-24 16:00:00,0.53,0.74,0.65,113,91,134,20,7,13,44,20,24,27,9,18,0,0,0,67%,52%,79%,73,57,86,16%,27%,12%,3,1,2,3,1,2
215,https://vlr.gg/player/16671/welyy,2024-11-24 16:00:00,1.13,1.49,1.29,218,225,212,45,25,20,33,24,9,15,10,5,-3,-3,0,67%,58%,78%,153,152,154,25%,22%,30%,1,0,1,4,3,1
216,https://vlr.gg/player/25902/shondex,2024-11-24 16:00:00,1.18,1.13,1.15,219,232,209,48,28,20,41,23,18,10,2,8,+3,+1,+2,75%,67%,85%,139,146,131,33%,39%,27%,4,2,2,1,1,0
217,https://vlr.gg/player/11696/zoestol,2024-11-24 16:00:00,0.79,1.09,0.93,165,166,175,36,18,18,41,26,15,24,15,9,+2,0,+2,72%,73%,70%,105,105,106,22%,28%,18%,6,2,4,4,2,2
218,https://vlr.gg/player/26848/zeek,2024-11-24 16:00:00,0.81,1.03,0.91,189,167,217,40,18,22,42,25,17,21,11,10,-11,-7,-4,70%,67%,74%,126,111,145,30%,24%,37%,1,1,0,12,8,4
219,https://vlr.gg/player/873/bob,2024-11-24 16:00:00,0.51,1.21,0.83,197,158,249,38,15,23,46,29,17,15,6,9,-5,-6,+1,67%,55%,81%,129,103,160,23%,26%,20%,11,4,7,16,10,6
220,https://vlr.gg/player/8434/nabil,2024-11-24 16:00:00,1.33,1.44,1.37,280,248,311,57,33,24,37,18,19,14,6,8,+10,+4,+6,76%,72%,83%,179,172,190,22%,19%,25%,13,6,7,3,2,1
221,https://vlr.gg/player/8397/dip,2024-11-24 16:00:00,1.74,0.79,1.37,259,305,142,49,39,10,34,16,18,23,16,7,+4,+2,+2,75%,83%,61%,153,191,93,29%,29%,31%,5,3,2,1,1,0
222,https://vlr.gg/player/6437/dark3st,2024-11-24 16:00:00,1.29,1.20,1.26,219,236,203,48,31,17,35,19,16,21,13,8,+5,+7,-2,78%,83%,70%,128,129,126,29%,25%,33%,9,8,1,4,1,3
223,https://vlr.gg/player/8758/benjii,2024-11-24 16:00:00,0.88,1.03,0.94,163,149,176,31,18,13,36,19,17,31,17,14,-1,0,-1,76%,78%,74%,100,94,109,29%,34%,23%,4,3,1,5,3,2
224,https://vlr.gg/player/21886/furbsa,2024-11-24 16:00:00,0.85,0.59,0.74,166,183,142,40,26,14,46,26,20,6,5,1,-5,-1,-4,63%,75%,43%,112,130,84,31%,34%,26%,5,4,1,10,5,5
225,https://vlr.gg/player/28316/eyan,2024-11-24 16:00:00,1.29,0.94,1.07,184,251,159,44,23,21,39,15,24,14,7,7,-3,-1,-2,68%,74%,64%,137,158,124,51%,58%,45%,2,2,0,5,3,2
226,https://vlr.gg/player/3986/truth,2024-11-24 16:00:00,1.04,0.90,0.96,209,245,213,44,19,25,46,16,30,13,7,6,-1,+2,-3,73%,87%,64%,144,158,135,27%,23%,31%,6,4,2,7,2,5
227,https://vlr.gg/player/16028/klamran,2024-11-24 16:00:00,1.05,0.89,0.95,206,195,219,43,18,25,46,14,32,8,3,5,+1,-1,+2,66%,78%,58%,135,117,147,25%,20%,27%,9,2,7,8,3,5
228,https://vlr.gg/player/823/rebo,2024-11-24 16:00:00,0.79,0.58,0.66,132,155,120,24,12,12,45,15,30,18,10,8,-6,-2,-4,58%,65%,53%,92,102,85,15%,15%,14%,1,1,0,7,3,4
229,https://vlr.gg/player/8410/cuz,2024-11-24 16:00:00,0.79,0.50,0.61,157,216,127,33,18,15,49,18,31,13,4,9,-4,+1,-5,66%,83%,56%,106,143,82,31%,33%,30%,5,2,3,9,1,8
230,https://vlr.gg/player/11232/daiki,2024-11-24 15:00:00,0.78,0.74,0.77,159,161,155,18,14,4,25,20,5,8,4,4,0,0,0,58%,50%,86%,118,116,126,32%,41%,13%,2,2,0,2,2,0
231,https://vlr.gg/player/15297/joojina,2024-11-24 15:00:00,0.79,0.60,0.75,157,167,130,16,13,3,26,20,6,8,6,2,-1,-2,+1,45%,42%,57%,93,94,90,28%,27%,30%,3,2,1,4,4,0
232,https://vlr.gg/player/4807/bstrdd,2024-11-24 15:00:00,0.43,1.04,0.57,175,139,300,17,9,8,29,23,6,5,5,0,-4,-5,+1,52%,42%,86%,113,99,162,25%,19%,36%,4,1,3,8,6,2
233,https://vlr.gg/player/12143/bizerra,2024-11-24 15:00:00,0.61,0.10,0.49,113,125,71,10,9,1,27,21,6,3,2,1,+1,+1,0,55%,58%,43%,81,90,50,27%,28%,22%,3,3,0,2,2,0
234,https://vlr.gg/player/14386/isaa,2024-11-24 15:00:00,0.25,0.98,0.39,96,66,207,7,3,4,28,22,6,7,4,3,-1,-2,+1,45%,38%,71%,72,54,133,12%,7%,19%,1,0,1,2,2,0
235,https://vlr.gg/player/1581/guhrvn,2024-11-24 15:00:00,1.19,2.02,1.83,282,183,311,32,5,27,8,4,4,14,4,10,+6,+1,+5,90%,71%,96%,187,104,212,28%,45%,25%,6,1,5,0,0,0
236,https://vlr.gg/player/13093/jzz,2024-11-24 15:00:00,1.61,1.27,1.35,244,311,222,29,8,21,15,4,11,8,0,8,+1,0,+1,81%,86%,79%,152,186,142,30%,30%,30%,3,1,2,2,1,1
237,https://vlr.gg/player/8881/leozin,2024-11-24 15:00:00,0.93,1.45,1.33,205,109,235,26,3,23,14,4,10,12,3,9,0,0,0,84%,86%,83%,128,85,141,27%,43%,25%,2,0,2,2,0,2
238,https://vlr.gg/player/3455/zanatsu,2024-11-24 15:00:00,1.63,1.25,1.33,250,318,228,29,9,20,17,4,13,6,0,6,+1,-2,+3,77%,86%,75%,170,215,157,29%,35%,27%,6,0,6,5,2,3
239,https://vlr.gg/player/15361/swag,2024-11-24 15:00:00,1.06,1.17,1.15,171,153,180,19,4,15,14,4,10,9,2,7,-3,-2,-1,68%,57%,71%,130,114,135,23%,36%,21%,1,0,1,4,2,2
240,https://vlr.gg/player/36433/phc,2024-11-24 15:00:00,1.52,1.45,1.49,228,223,258,41,24,17,27,13,14,30,20,10,+1,0,+1,81%,79%,84%,156,146,170,25%,25%,26%,4,2,2,3,2,1
241,https://vlr.gg/player/3424/siduzord,2024-11-24 15:00:00,1.44,1.08,1.30,257,237,210,37,24,13,27,15,12,18,11,7,+1,+1,0,74%,86%,58%,148,152,142,29%,29%,29%,4,2,2,3,1,2
242,https://vlr.gg/player/6202/guuih,2024-11-24 15:00:00,1.10,1.21,1.14,172,187,185,34,20,14,28,18,10,10,8,2,-3,-1,-2,87%,89%,84%,116,118,114,24%,21%,29%,0,0,0,3,1,2
243,https://vlr.gg/player/32675/kring,2024-11-24 15:00:00,1.11,0.88,1.02,241,276,192,38,27,11,36,22,14,14,6,8,+3,+4,-1,74%,82%,63%,152,160,140,24%,24%,23%,11,9,2,8,5,3
244,https://vlr.gg/player/1567/bezn1,2024-11-24 15:00:00,0.75,1.00,0.85,195,173,194,28,15,13,33,20,13,22,17,5,+1,-2,+3,68%,71%,63%,123,128,114,22%,26%,17%,6,2,4,5,4,1
245,https://vlr.gg/player/28715/hunterx,2024-11-24 15:00:00,1.27,1.43,1.37,260,235,279,43,16,27,30,11,19,11,4,7,+4,+1,+3,79%,74%,82%,164,151,172,17%,20%,16%,5,2,3,1,1,0
246,https://vlr.gg/player/22912/pkx,2024-11-24 15:00:00,1.41,0.78,1.03,162,278,130,31,18,13,31,12,19,6,3,3,+2,+4,-2,70%,79%,64%,135,193,95,29%,24%,41%,4,4,0,2,0,2
247,https://vlr.gg/player/41222/hide,2024-11-24 15:00:00,0.64,1.04,0.88,189,124,218,29,9,20,34,14,20,18,8,10,0,-1,+1,74%,74%,75%,116,83,139,35%,47%,31%,3,0,3,3,1,2
248,https://vlr.gg/player/44448/insano,2024-11-24 15:00:00,0.96,0.77,0.83,189,197,207,32,13,19,40,15,25,11,5,6,-3,-4,+1,60%,58%,61%,151,144,155,34%,38%,32%,5,2,3,8,6,2
249,https://vlr.gg/player/32732/yeah,2024-11-24 15:00:00,0.25,0.18,0.18,90,95,97,15,7,8,44,17,27,7,4,3,-6,-1,-5,45%,58%,36%,64,60,66,17%,16%,18%,5,1,4,11,2,9
250,https://vlr.gg/player/3628/deathmaker,2024-11-24 10:30:00,1.09,1.39,1.22,256,237,274,44,23,21,37,22,15,12,5,7,+2,+1,+1,64%,57%,73%,179,157,207,29%,34%,24%,6,3,3,4,2,2
251,https://vlr.gg/player/12947/rawfiul,2024-11-24 10:30:00,0.66,1.75,1.14,203,162,321,43,15,28,37,23,14,10,7,3,+1,-2,+3,68%,64%,73%,143,103,195,32%,26%,37%,5,1,4,4,3,1
252,https://vlr.gg/player/13221/azys,2024-11-24 10:30:00,0.94,0.66,0.82,206,241,138,33,23,10,39,22,17,8,4,4,-1,+2,-3,68%,71%,64%,129,145,108,27%,33%,18%,11,8,3,12,6,6
253,https://vlr.gg/player/18704/levi,2024-11-24 10:30:00,1.01,0.54,0.80,143,169,135,24,16,8,37,19,18,25,12,13,-4,-4,0,70%,75%,64%,109,122,92,35%,43%,26%,1,0,1,5,4,1
254,https://vlr.gg/player/3269/antidote,2024-11-24 10:30:00,0.76,0.71,0.74,129,128,132,20,12,8,34,19,15,14,6,8,0,+1,-1,64%,64%,64%,92,90,94,19%,31%,12%,1,1,0,1,0,1
255,https://vlr.gg/player/27336/venka,2024-11-24 10:30:00,0.97,1.36,1.19,274,225,286,46,18,28,36,17,19,6,2,4,+4,+2,+2,70%,68%,71%,172,150,190,29%,36%,25%,10,5,5,6,3,3
256,https://vlr.gg/player/3627/hellff,2024-11-24 10:30:00,1.04,1.29,1.18,231,229,239,39,16,23,34,17,17,17,9,8,-6,-4,-2,72%,77%,68%,156,160,153,30%,35%,26%,3,2,1,9,6,3
257,https://vlr.gg/player/3639/hoax,2024-11-24 10:30:00,1.11,1.01,1.05,184,184,178,33,15,18,30,13,17,11,4,7,-1,-1,0,72%,68%,75%,113,117,110,20%,23%,17%,2,0,2,3,1,2
258,https://vlr.gg/player/27775/techno,2024-11-24 10:30:00,1.21,0.87,1.02,183,209,148,32,19,13,29,13,16,14,3,11,+1,+2,-1,68%,77%,61%,126,152,105,32%,34%,30%,5,3,2,4,1,3
259,https://vlr.gg/player/26376/deecee,2024-11-24 10:30:00,0.90,1.08,1.00,213,175,236,34,11,23,35,15,20,23,15,8,+4,+1,+3,70%,68%,71%,135,113,152,24%,13%,38%,6,1,5,2,0,2
260,https://vlr.gg/player/40912/123,2024-11-24 07:55:00,1.52,2.28,1.76,377,334,468,47,29,18,23,18,5,10,8,2,+8,+4,+4,86%,88%,82%,233,210,282,28%,31%,21%,10,6,4,2,2,0
261,https://vlr.gg/player/19231/kibojn,2024-11-24 07:55:00,1.56,0.92,1.36,235,280,142,32,26,6,18,13,5,11,11,0,+1,0,+1,86%,88%,82%,163,192,97,30%,32%,22%,1,0,1,0,0,0
262,https://vlr.gg/player/8156/mojo,2024-11-24 07:55:00,1.41,1.02,1.29,190,203,166,22,16,6,16,10,6,25,16,9,+2,0,+2,91%,92%,91%,119,127,104,22%,22%,22%,3,1,2,1,1,0
263,https://vlr.gg/player/18702/deadly10,2024-11-24 07:55:00,1.13,1.30,1.18,223,214,253,31,20,11,20,14,6,9,5,4,+1,+1,0,77%,71%,91%,141,136,152,24%,29%,14%,6,5,1,5,4,1
264,https://vlr.gg/player/48426/ghostxd,2024-11-24 07:55:00,0.73,1.36,0.92,179,152,195,20,13,7,19,16,3,8,4,4,+5,+3,+2,74%,71%,82%,109,98,132,26%,21%,35%,6,4,2,1,1,0
265,https://vlr.gg/player/40060/rage,2024-11-24 07:55:00,1.05,1.04,1.05,206,201,214,25,7,18,30,9,21,14,5,9,+4,+1,+3,66%,55%,71%,133,115,141,40%,53%,36%,4,1,3,0,0,0
266,https://vlr.gg/player/43398/river,2024-11-24 07:55:00,1.00,0.71,0.80,156,218,133,20,8,12,29,9,20,9,1,8,-3,-1,-2,51%,45%,54%,105,141,88,49%,60%,42%,0,0,0,3,1,2
267,https://vlr.gg/player/49570/rinsat,2024-11-24 07:55:00,0.61,0.73,0.67,181,127,219,22,5,17,33,11,22,8,2,6,-5,-3,-2,57%,36%,67%,123,91,137,54%,42%,58%,3,0,3,8,3,5
268,https://vlr.gg/player/43389/yash,2024-11-24 07:55:00,0.31,0.81,0.65,170,113,195,19,4,15,31,10,21,5,1,4,-7,-5,-2,57%,36%,67%,116,78,134,28%,40%,25%,1,0,1,8,5,3
269,https://vlr.gg/player/27755/icarus,2024-11-24 07:55:00,0.21,0.47,0.38,99,45,124,10,1,9,30,10,20,5,1,4,-6,-1,-5,37%,27%,42%,73,47,85,17%,13%,18%,1,0,1,7,1,6
270,https://vlr.gg/player/3017/nobody,2024-11-24 07:00:00,,,,247,,,51,,,45,,,17,,,,,,,,,,,,,,,,,,,,
271,https://vlr.gg/player/3520/zmjjkk,2024-11-24 07:00:00,,,,224,,,43,,,52,,,9,,,,,,,,,,,,,,,,,,,,
272,https://vlr.gg/player/4742/smoggy,2024-11-24 07:00:00,,,,207,,,43,,,46,,,27,,,,,,,,,,,,,,,,,,,,
273,https://vlr.gg/player/13768/s1mon,2024-11-24 07:00:00,,,,178,,,35,,,45,,,29,,,,,,,,,,,,,,,,,,,,
274,https://vlr.gg/player/15559/chichoo,2024-11-24 07:00:00,,,,153,,,33,,,42,,,11,,,,,,,,,,,,,,,,,,,,
275,https://vlr.gg/player/7378/jinggg,2024-11-24 07:00:00,,,,275,,,62,,,43,,,11,,,,,,,,,,,,,,,,,,,,
276,https://vlr.gg/player/17086/something,2024-11-24 07:00:00,,,,226,,,48,,,38,,,14,,,,,,,,,,,,,,,,,,,,
277,https://vlr.gg/player/9801/f0rsaken,2024-11-24 07:00:00,,,,218,,,41,,,47,,,21,,,,,,,,,,,,,,,,,,,,
278,https://vlr.gg/player/9803/d4v41,2024-11-24 07:00:00,,,,200,,,43,,,36,,,20,,,,,,,,,,,,,,,,,,,,
279,https://vlr.gg/player/9800/mindfreak,2024-11-24 07:00:00,,,,170,,,36,,,41,,,31,,,,,,,,,,,,,,,,,,,,
280,https://vlr.gg/player/8582/laz,2024-11-24 06:00:00,0.90,1.16,1.00,194,176,233,66,36,30,70,43,27,23,14,9,+1,+1,0,60%,60%,61%,132,121,150,23%,24%,21%,6,3,3,5,2,3
281,https://vlr.gg/player/13784/killua,2024-11-24 06:00:00,0.93,0.97,0.95,184,189,184,66,41,25,71,46,25,14,6,8,-9,-7,-2,65%,65%,66%,122,123,121,44%,49%,38%,2,2,0,11,9,2
282,https://vlr.gg/player/24679/cgrs,2024-11-24 06:00:00,0.89,0.97,0.91,175,155,212,59,33,26,72,43,29,22,14,8,-1,-2,+1,67%,65%,71%,118,104,140,24%,34%,16%,5,1,4,6,3,3
283,https://vlr.gg/player/27244/seph1roth,2024-11-24 06:00:00,0.84,0.97,0.89,161,151,175,58,34,24,68,45,23,22,15,7,-3,-1,-2,59%,58%,61%,104,95,117,35%,27%,49%,4,1,3,7,2,5
284,https://vlr.gg/player/12098/kadoom,2024-11-24 06:00:00,0.67,0.80,0.72,184,194,180,55,33,22,84,54,30,25,16,9,-10,-5,-5,58%,58%,58%,131,134,126,24%,26%,22%,21,16,5,31,21,10
285,https://vlr.gg/player/24653/vera,2024-11-24 06:00:00,1.13,1.35,1.27,276,266,276,99,37,62,65,29,36,16,6,10,+12,+6,+6,79%,84%,75%,172,172,173,25%,29%,23%,20,9,11,8,3,5
286,https://vlr.gg/player/24628/wayne,2024-11-24 06:00:00,1.37,0.95,1.11,192,229,175,67,32,35,59,22,37,40,16,24,+2,+3,-1,74%,76%,73%,130,148,119,25%,30%,22%,7,5,2,5,2,3
287,https://vlr.gg/player/1430/crazyguy,2024-11-24 06:00:00,0.70,1.33,1.08,226,143,273,74,18,56,64,28,36,23,9,14,+2,-1,+3,65%,63%,67%,149,97,181,27%,24%,29%,11,1,10,9,2,7
288,https://vlr.gg/player/9152/deryeon,2024-11-24 06:00:00,1.04,1.07,1.06,182,181,186,66,25,41,58,23,35,19,9,10,+1,+1,0,72%,71%,73%,122,116,125,30%,35%,27%,9,5,4,8,4,4
289,https://vlr.gg/player/11704/styron,2024-11-24 06:00:00,0.91,1.03,0.98,172,168,166,58,22,36,58,25,33,45,22,23,+5,-1,+6,76%,76%,75%,110,110,109,28%,24%,30%,13,3,10,8,4,4
290,https://vlr.gg/player/37494/kai,2024-11-24 04:00:00,,,,299,,,63,,,40,,,8,,,,,,,,,,,,,,,,,,,,
291,https://vlr.gg/player/3021/biank,2024-11-24 04:00:00,,,,204,,,35,,,41,,,27,,,,,,,,,,,,,,,,,,,,
292,https://vlr.gg/player/4770/fengf,2024-11-24 04:00:00,,,,186,,,43,,,37,,,7,,,,,,,,,,,,,,,,,,,,
293,https://vlr.gg/player/3045/luok1ng,2024-11-24 04:00:00,,,,153,,,31,,,32,,,26,,,,,,,,,,,,,,,,,,,,
294,https://vlr.gg/player/4712/heybay,2024-11-24 04:00:00,,,,134,,,24,,,38,,,35,,,,,,,,,,,,,,,,,,,,
295,https://vlr.gg/player/4885/whzy,2024-11-24 04:00:00,,,,300,,,63,,,38,,,12,,,,,,,,,,,,,,,,,,,,
296,https://vlr.gg/player/10698/nephh,2024-11-24 04:00:00,,,,199,,,38,,,39,,,34,,,,,,,,,,,,,,,,,,,,
297,https://vlr.gg/player/40845/levius,2024-11-24 04:00:00,,,,168,,,32,,,40,,,9,,,,,,,,,,,,,,,,,,,,
298,https://vlr.gg/player/4774/knight,2024-11-24 04:00:00,,,,155,,,30,,,41,,,16,,,,,,,,,,,,,,,,,,,,
299,https://vlr.gg/player/48878/rushia,2024-11-24 04:00:00,,,,129,,,25,,,38,,,23,,,,,,,,,,,,,,,,,,,,
300,https://vlr.gg/player/3520/zmjjkk,2024-11-24 02:30:00,,,,,,,,,,,,,,,,,,,,,,,,,,,,,,,,,
301,https://vlr.gg/player/9801/f0rsaken,2024-11-24 02:30:00,,,,,,,,,,,,,,,,,,,,,,,,,,,,,,,,,
302,https://vlr.gg/player/15559/chichoo,2024-11-24 02:30:00,,,,,,,,,,,,,,,,,,,,,,,,,,,,,,,,,
303,https://vlr.gg/player/9800/mindfreak,2024-11-24 02:30:00,,,,,,,,,,,,,,,,,,,,,,,,,,,,,,,,,
304,https://vlr.gg/player/4770/fengf,2024-11-24 02:30:00,,,,,,,,,,,,,,,,,,,,,,,,,,,,,,,,,
305,https://vlr.gg/player/9196/t3xture,2024-11-24 02:30:00,,,,,,,,,,,,,,,,,,,,,,,,,,,,,,,,,
306,https://vlr.gg/player/35013/flashback,2024-11-24 02:30:00,,,,,,,,,,,,,,,,,,,,,,,,,,,,,,,,,
307,https://vlr.gg/player/4885/whzy,2024-11-24 02:30:00,,,,,,,,,,,,,,,,,,,,,,,,,,,,,,,,,
308,https://vlr.gg/player/6672/meiy,2024-11-24 02:30:00,,,,,,,,,,,,,,,,,,,,,,,,,,,,,,,,,
309,https://vlr.gg/player/19530/aaaay,2024-11-24 02:30:00,,,,,,,,,,,,,,,,,,,,,,,,,,,,,,,,,
310,https://vlr.gg/player/9094/kess,2024-11-23 23:15:00,1.25,1.22,1.24,234,242,231,56,28,28,45,24,21,30,19,11,0,0,0,81%,78%,85%,146,152,140,14%,15%,13%,4,2,2,4,2,2
311,https://vlr.gg/player/48025/alym,2024-11-23 23:15:00,1.00,1.22,1.10,233,212,249,56,28,28,48,26,22,12,6,6,+7,+2,+5,64%,69%,58%,154,142,168,24%,27%,21%,17,7,10,10,5,5
312,https://vlr.gg/player/6445/sogo,2024-11-23 23:15:00,1.01,1.12,1.06,205,207,203,52,28,24,48,25,23,27,9,18,-1,-1,0,74%,67%,82%,137,139,136,28%,30%,25%,3,1,2,4,2,2
313,https://vlr.gg/player/10053/fireballops,2024-11-23 23:15:00,1.01,1.12,1.06,226,203,248,59,28,31,52,26,26,13,5,8,+3,+2,+1,68%,58%,79%,141,123,161,37%,37%,37%,8,5,3,5,3,2
314,https://vlr.gg/player/62/huynh,2024-11-23 23:15:00,0.63,1.02,0.81,171,156,189,39,18,21,47,27,20,23,9,14,-4,-5,+1,71%,67%,76%,107,105,109,13%,16%,10%,5,2,3,9,7,2
315,https://vlr.gg/player/5093/logan,2024-11-23 23:15:00,0.78,1.68,1.25,250,181,309,59,21,38,48,27,21,21,8,13,+7,0,+7,75%,76%,75%,161,116,202,22%,19%,24%,11,4,7,4,4,0
316,https://vlr.gg/player/754/nerve,2024-11-23 23:15:00,0.87,0.96,0.92,184,170,200,41,18,23,52,25,27,41,23,18,+1,-1,+2,78%,76%,81%,122,106,137,20%,17%,23%,3,1,2,2,2,0
317,https://vlr.gg/player/21878/snarly,2024-11-23 23:15:00,0.98,0.85,0.91,202,225,186,48,26,22,57,28,29,20,10,10,-3,-2,-1,65%,70%,61%,137,152,123,29%,38%,22%,5,1,4,8,3,5
318,https://vlr.gg/player/24553/boni,2024-11-23 23:15:00,0.71,1.04,0.88,199,174,232,49,21,28,56,27,29,15,6,9,-7,-4,-3,68%,61%,75%,132,110,151,22%,29%,16%,9,4,5,16,8,8
319,https://vlr.gg/player/1120/aleksandar,2024-11-23 23:15:00,1.01,0.71,0.85,166,217,121,43,26,17,49,25,24,16,8,8,-3,0,-3,70%,70%,69%,106,129,85,45%,58%,31%,4,3,1,7,3,4
320,https://vlr.gg/player/21778/p0ppin,2024-11-23 20:00:00,1.46,1.36,1.42,260,245,255,57,32,25,40,22,18,36,23,13,-1,-2,+1,76%,74%,78%,150,157,140,22%,26%,15%,8,3,5,9,5,4
321,https://vlr.gg/player/41798/nightz,2024-11-23 20:00:00,1.25,1.44,1.33,295,267,310,68,38,30,51,31,20,26,17,9,+3,+2,+1,82%,85%,78%,181,165,203,56%,57%,56%,6,4,2,3,2,1
322,https://vlr.gg/player/53/inspire,2024-11-23 20:00:00,1.29,0.75,1.07,193,221,147,45,33,12,40,20,20,18,8,10,+1,+1,0,76%,77%,74%,129,147,103,31%,33%,27%,4,2,2,3,1,2
323,https://vlr.gg/player/35302/eggsterr,2024-11-23 20:00:00,0.80,1.17,0.95,191,184,227,45,24,21,47,29,18,25,15,10,0,-1,+1,76%,77%,74%,123,115,136,21%,21%,20%,6,4,2,6,5,1
324,https://vlr.gg/player/36560/canezerra,2024-11-23 20:00:00,0.73,0.63,0.69,187,209,139,42,29,13,52,31,21,16,7,9,-1,+5,-6,62%,62%,63%,115,121,105,24%,25%,22%,10,9,1,11,4,7
325,https://vlr.gg/player/48025/alym,2024-11-23 20:00:00,1.06,1.16,1.12,263,265,282,58,23,35,56,23,33,17,7,10,+5,+6,-1,76%,74%,77%,177,166,184,29%,33%,26%,17,11,6,12,5,7
326,https://vlr.gg/player/9094/kess,2024-11-23 20:00:00,1.30,0.82,1.02,194,236,174,45,23,22,50,18,32,31,14,17,-1,+1,-2,70%,78%,64%,128,166,102,24%,31%,18%,4,2,2,5,1,4
327,https://vlr.gg/player/62/huynh,2024-11-23 20:00:00,0.90,0.99,0.96,190,178,213,42,15,27,50,19,31,34,16,18,+1,+1,0,67%,67%,67%,126,107,139,14%,14%,13%,5,1,4,4,0,4
328,https://vlr.gg/player/10053/fireballops,2024-11-23 20:00:00,1.16,0.79,0.95,195,231,164,45,23,22,47,19,28,16,7,9,-4,-1,-3,68%,70%,67%,122,145,107,33%,42%,27%,3,1,2,7,2,5
329,https://vlr.gg/player/6445/sogo,2024-11-23 20:00:00,0.50,0.92,0.75,192,138,220,38,12,26,54,23,31,20,8,12,-3,-4,+1,71%,67%,74%,126,90,150,24%,21%,25%,3,0,3,6,4,2
330,https://vlr.gg/player/1856/wedid,2024-11-23 20:00:00,1.33,1.06,1.21,204,241,154,49,31,18,41,22,19,32,15,17,-1,+3,-4,77%,83%,70%,130,158,97,26%,24%,30%,3,3,0,4,0,4
331,https://vlr.gg/player/4931/add3r,2024-11-23 20:00:00,1.10,1.05,1.08,242,227,238,53,30,23,47,25,22,10,6,4,0,-1,+1,76%,75%,77%,149,140,160,35%,37%,33%,7,2,5,7,3,4
332,https://vlr.gg/player/844/bdog,2024-11-23 20:00:00,1.11,0.94,1.04,190,213,168,47,29,18,44,24,20,23,14,9,-4,-1,-3,77%,78%,77%,135,158,107,29%,36%,21%,4,2,2,8,3,5
333,https://vlr.gg/player/19292/jowa,2024-11-23 20:00:00,0.91,1.03,0.96,185,179,198,44,25,19,41,21,20,18,8,10,-1,0,-1,80%,78%,83%,131,124,140,32%,31%,33%,4,2,2,5,2,3
334,https://vlr.gg/player/4917/kaoticcc,2024-11-23 20:00:00,0.94,0.92,0.93,211,210,211,48,27,21,49,25,24,15,7,8,+2,-1,+3,64%,61%,67%,140,140,141,26%,31%,20%,13,9,4,11,10,1
335,https://vlr.gg/player/1120/aleksandar,2024-11-23 20:00:00,1.03,1.15,1.10,225,202,243,54,22,32,46,19,27,7,5,2,+2,-1,+3,77%,87%,69%,140,129,148,46%,43%,48%,6,2,4,4,3,1
336,https://vlr.gg/player/754/nerve,2024-11-23 20:00:00,1.10,0.92,1.00,174,168,190,39,18,21,42,15,27,31,15,16,+2,+2,0,79%,83%,75%,118,110,124,27%,40%,22%,5,3,2,3,1,2
337,https://vlr.gg/player/24553/boni,2024-11-23 20:00:00,0.92,1.01,0.97,236,240,227,55,25,30,52,23,29,12,7,5,-3,+1,-4,64%,70%,58%,132,128,135,21%,18%,24%,11,7,4,14,6,8
338,https://vlr.gg/player/5093/logan,2024-11-23 20:00:00,0.97,0.90,0.93,178,203,165,39,20,19,46,20,26,24,13,11,+2,+1,+1,77%,80%,75%,120,132,110,21%,19%,22%,7,2,5,5,1,4
339,https://vlr.gg/player/21878/snarly,2024-11-23 20:00:00,0.94,0.49,0.68,163,189,148,35,20,15,55,22,33,15,9,6,+1,+1,0,67%,83%,53%,107,122,95,31%,33%,27%,6,3,3,5,2,3
340,https://vlr.gg/player/8781/charlslol,2024-11-23 19:30:00,1.26,1.09,1.19,216,234,200,32,22,10,29,17,12,12,6,6,+1,+1,0,71%,67%,79%,146,163,116,34%,31%,40%,1,1,0,0,0,0
341,https://vlr.gg/player/35559/pandejalea,2024-11-23 19:30:00,1.22,0.69,1.02,263,288,214,33,24,9,33,20,13,5,4,1,+1,+1,0,66%,71%,57%,168,188,135,34%,43%,20%,6,5,1,5,4,1
342,https://vlr.gg/player/17676/dexuz,2024-11-23 19:30:00,1.06,0.42,0.83,204,231,135,24,18,6,33,20,13,18,14,4,-2,-1,-1,82%,92%,64%,116,137,78,16%,14%,24%,1,0,1,3,1,2
343,https://vlr.gg/player/10582/panaek,2024-11-23 19:30:00,0.68,0.85,0.75,173,154,219,23,12,11,33,20,13,14,12,2,-2,0,-2,66%,71%,57%,114,104,130,38%,32%,48%,2,1,1,4,1,3
344,https://vlr.gg/player/17696/gera,2024-11-23 19:30:00,0.49,0.53,0.47,123,110,172,15,8,7,33,20,13,14,5,9,-12,-7,-5,61%,58%,64%,92,73,125,9%,8%,11%,2,2,0,14,9,5
345,https://vlr.gg/player/7618/theory,2024-11-23 19:30:00,1.34,1.31,1.33,258,285,229,36,16,20,21,7,14,9,1,8,+3,+1,+2,82%,86%,79%,163,161,165,51%,48%,53%,5,2,3,2,1,1
346,https://vlr.gg/player/35583/edu,2024-11-23 19:30:00,1.75,0.90,1.21,243,288,217,33,16,17,28,8,20,16,8,8,+3,+2,+1,84%,93%,79%,156,197,131,39%,60%,29%,5,2,3,2,0,2
347,https://vlr.gg/player/8057/josegxbo,2024-11-23 19:30:00,1.33,1.12,1.20,190,188,205,29,10,19,23,7,16,14,7,7,0,-1,+1,84%,93%,79%,141,148,137,27%,22%,30%,2,0,2,2,1,1
348,https://vlr.gg/player/12955/danger,2024-11-23 19:30:00,1.11,1.16,1.14,217,191,229,30,10,20,24,9,15,15,11,4,+1,0,+1,89%,93%,88%,148,119,165,33%,28%,35%,2,0,2,1,0,1
349,https://vlr.gg/player/38921/fotzy,2024-11-23 19:30:00,0.96,1.10,1.05,271,247,279,33,12,21,32,13,19,16,3,13,+7,+6,+1,79%,86%,75%,176,141,196,28%,24%,30%,12,7,5,5,1,4
350,https://vlr.gg/player/25858/sw,2024-11-23 17:30:00,0.99,1.16,1.08,209,219,199,45,21,24,40,22,18,15,9,6,-3,0,-3,72%,66%,77%,128,129,126,35%,32%,39%,4,3,1,7,3,4
351,https://vlr.gg/player/1578/shion,2024-11-23 17:30:00,0.88,1.22,1.06,214,181,246,43,19,24,45,23,22,19,6,13,+5,+1,+4,70%,62%,77%,145,118,169,31%,34%,29%,8,3,5,3,2,1
352,https://vlr.gg/player/41224/tkzin,2024-11-23 17:30:00,0.92,1.18,1.05,259,247,273,52,22,30,51,27,24,14,8,6,-4,-1,-3,68%,66%,71%,166,161,172,33%,31%,35%,11,5,6,15,6,9
353,https://vlr.gg/player/5722/prince,2024-11-23 17:30:00,1.04,0.78,0.91,147,181,118,33,19,14,40,21,19,11,6,5,+2,+1,+1,70%,66%,74%,96,118,75,26%,41%,13%,2,1,1,0,0,0
354,https://vlr.gg/player/2486/pollo,2024-11-23 17:30:00,0.44,0.93,0.69,152,110,190,34,13,21,44,24,20,7,0,7,-6,-6,0,50%,31%,68%,107,85,127,28%,32%,26%,2,0,2,8,6,2
355,https://vlr.gg/player/9266/tisora,2024-11-23 17:30:00,1.03,1.18,1.10,233,235,232,52,26,26,43,25,18,18,11,7,+3,+1,+2,75%,71%,79%,144,140,149,22%,24%,21%,7,4,3,4,3,1
356,https://vlr.gg/player/2021/axeddy,2024-11-23 17:30:00,1.00,1.20,1.10,190,175,207,40,18,22,38,21,17,23,13,10,+2,+1,+1,75%,68%,83%,123,109,139,37%,29%,46%,5,3,2,3,2,1
357,https://vlr.gg/player/23001/zaninzs,2024-11-23 17:30:00,0.91,1.19,1.04,194,169,225,42,19,23,37,21,16,9,2,7,-3,+1,-4,70%,74%,66%,129,114,145,32%,34%,31%,2,1,1,5,0,5
358,https://vlr.gg/player/37105/loss,2024-11-23 17:30:00,0.74,1.17,0.95,231,178,283,47,18,29,48,26,22,14,9,5,+2,-1,+3,67%,65%,69%,142,117,169,34%,43%,29%,14,6,8,12,7,5
359,https://vlr.gg/player/33121/stwz1,2024-11-23 17:30:00,0.95,0.80,0.88,178,189,169,38,22,16,41,20,21,16,8,8,+2,-1,+3,77%,74%,79%,126,135,116,29%,31%,28%,5,2,3,3,3,0
360,https://vlr.gg/player/22997/waved,2024-11-23 17:30:00,1.28,0.89,1.06,247,291,222,31,16,15,31,13,18,10,7,3,+5,+3,+2,74%,82%,67%,172,191,157,30%,30%,30%,8,4,4,3,1,2
361,https://vlr.gg/player/11236/antg,2024-11-23 17:30:00,1.09,0.92,1.00,209,243,182,29,16,13,30,13,17,7,4,3,+2,+1,+1,61%,76%,48%,139,154,127,35%,37%,33%,5,3,2,3,2,1
362,https://vlr.gg/player/9821/m4ndzin,2024-11-23 17:30:00,0.79,0.64,0.71,154,157,154,18,8,10,30,12,18,12,7,5,+1,-1,+2,68%,76%,62%,104,100,107,21%,17%,24%,3,0,3,2,1,1
363,https://vlr.gg/player/27724/natasha,2024-11-23 17:30:00,0.51,0.75,0.64,120,93,142,16,6,10,27,12,15,8,1,7,0,0,0,61%,59%,62%,79,61,93,23%,27%,21%,1,1,0,1,1,0
364,https://vlr.gg/player/11242/blu,2024-11-23 17:30:00,0.33,0.48,0.42,100,55,137,13,3,10,35,15,20,12,7,5,+2,+2,0,58%,65%,52%,59,29,83,35%,67%,28%,7,3,4,5,1,4
365,https://vlr.gg/player/26214/cidzzz,2024-11-23 17:30:00,1.15,1.75,1.42,248,205,298,34,16,18,20,11,9,11,6,5,-3,-2,-1,76%,67%,88%,157,128,192,35%,34%,36%,4,2,2,7,4,3
366,https://vlr.gg/player/22964/forbanz,2024-11-23 17:30:00,1.84,0.75,1.35,326,418,203,42,31,11,27,14,13,11,8,3,-1,+2,-3,71%,86%,53%,203,255,138,24%,27%,20%,4,3,1,5,1,4
367,https://vlr.gg/player/32718/kenkayyy,2024-11-23 17:30:00,1.18,1.33,1.25,201,190,216,28,15,13,22,13,9,21,13,8,-2,-1,-1,79%,81%,76%,135,132,139,25%,18%,37%,2,1,1,4,2,2
368,https://vlr.gg/player/36106/skz,2024-11-23 17:30:00,0.81,1.55,1.14,162,107,238,24,8,16,19,11,8,12,7,5,0,-1,+1,84%,76%,94%,122,84,169,31%,18%,42%,2,1,1,2,2,0
369,https://vlr.gg/player/1607/ntk,2024-11-23 17:30:00,1.44,0.70,1.11,205,263,128,25,18,7,19,9,10,14,11,3,-4,-3,-1,76%,86%,65%,133,169,89,13%,16%,9%,2,1,1,6,4,2
370,https://vlr.gg/player/2995/maka,2024-11-23 17:00:00,0.98,1.06,1.03,204,205,199,35,17,18,37,18,19,17,5,12,+4,+1,+3,71%,68%,73%,132,139,126,21%,31%,14%,5,2,3,1,1,0
371,https://vlr.gg/player/17669/pompz,2024-11-23 17:00:00,0.89,1.13,1.02,226,199,249,35,13,22,39,18,21,15,6,9,-2,-2,0,58%,50%,65%,161,145,175,28%,30%,26%,4,2,2,6,4,2
372,https://vlr.gg/player/1328/javiierh,2024-11-23 17:00:00,0.93,1.03,0.98,212,206,221,35,15,20,35,18,17,10,4,6,+1,0,+1,73%,68%,77%,131,129,133,23%,30%,17%,5,1,4,4,1,3
373,https://vlr.gg/player/35567/toro,2024-11-23 17:00:00,0.79,0.68,0.73,132,168,106,22,13,9,35,19,16,11,3,8,0,0,0,63%,50%,73%,89,114,68,21%,28%,14%,3,1,2,3,1,2
374,https://vlr.gg/player/21993/gonchz,2024-11-23 17:00:00,0.31,0.90,0.63,163,135,195,28,10,18,41,21,20,7,2,5,-7,-5,-2,48%,41%,54%,111,97,123,26%,32%,22%,5,2,3,12,7,5
375,https://vlr.gg/player/24026/generalsteak,2024-11-23 17:00:00,1.30,1.59,1.44,230,215,270,39,19,20,26,15,11,24,15,9,+3,+1,+2,90%,85%,95%,168,156,183,50%,46%,56%,4,1,3,1,0,1
376,https://vlr.gg/player/41409/vandals,2024-11-23 17:00:00,1.48,1.07,1.29,244,266,192,44,26,18,32,18,14,12,7,5,+4,+2,+2,85%,88%,82%,156,174,135,38%,36%,42%,4,2,2,0,0,0
377,https://vlr.gg/player/8902/vapes,2024-11-23 17:00:00,0.79,1.48,1.11,209,161,266,36,14,22,29,17,12,12,7,5,+4,0,+4,75%,62%,91%,138,112,169,27%,22%,30%,7,3,4,3,3,0
378,https://vlr.gg/player/10556/drakk,2024-11-23 17:00:00,0.75,1.21,0.96,217,184,254,39,18,21,36,20,16,13,5,8,-3,-5,+2,75%,65%,86%,140,121,163,34%,30%,38%,9,4,5,12,9,3
379,https://vlr.gg/player/2490/jfoen,2024-11-23 17:00:00,1.01,0.79,0.91,166,179,164,29,16,13,32,17,15,19,12,7,-4,0,-4,71%,77%,64%,112,114,111,25%,22%,29%,2,2,0,6,2,4
380,https://vlr.gg/player/19292/jowa,2024-11-23 16:00:00,1.07,0.63,0.82,171,214,154,19,10,9,28,11,17,5,3,2,-3,0,-3,69%,87%,55%,122,147,103,32%,38%,27%,1,1,0,4,1,3
381,https://vlr.gg/player/844/bdog,2024-11-23 16:00:00,0.98,0.63,0.78,191,192,188,23,10,13,31,13,18,14,8,6,-5,-1,-4,66%,67%,65%,120,125,115,27%,40%,20%,1,1,0,6,2,4
382,https://vlr.gg/player/4931/add3r,2024-11-23 16:00:00,0.83,0.70,0.76,172,224,137,21,12,9,29,14,15,6,2,4,0,0,0,66%,67%,65%,108,139,85,24%,23%,25%,3,1,2,3,1,2
383,https://vlr.gg/player/1856/wedid,2024-11-23 16:00:00,0.73,0.76,0.73,147,153,145,17,8,9,27,12,15,5,1,4,-1,-1,0,54%,47%,60%,105,103,106,32%,30%,33%,3,2,1,4,3,1
384,https://vlr.gg/player/4917/kaoticcc,2024-11-23 16:00:00,0.47,0.82,0.67,163,162,173,18,7,11,28,14,14,5,1,4,+2,-1,+3,60%,47%,70%,119,124,116,39%,33%,46%,6,1,5,4,2,2
385,https://vlr.gg/player/35302/eggsterr,2024-11-23 16:00:00,1.38,2.35,1.80,303,234,421,41,16,25,18,10,8,7,6,1,+6,+2,+4,86%,80%,93%,200,152,263,27%,18%,37%,7,3,4,1,1,0
386,https://vlr.gg/player/53/inspire,2024-11-23 16:00:00,1.53,0.72,1.18,207,253,118,24,19,5,16,8,8,8,3,5,0,-1,+1,77%,85%,67%,124,158,78,24%,35%,11%,1,0,1,1,1,0
387,https://vlr.gg/player/36560/canezerra,2024-11-23 16:00:00,1.30,0.98,1.16,215,225,204,27,17,10,20,10,10,9,3,6,0,+1,-1,86%,80%,93%,149,156,140,25%,32%,20%,6,4,2,6,3,3
388,https://vlr.gg/player/41798/nightz,2024-11-23 16:00:00,1.14,1.13,1.13,232,222,230,31,18,13,24,13,11,18,8,10,0,0,0,74%,65%,87%,146,156,131,38%,56%,24%,5,3,2,5,3,2
389,https://vlr.gg/player/21778/p0ppin,2024-11-23 16:00:00,0.86,0.85,0.85,149,119,193,20,9,11,20,10,10,8,3,5,+1,+2,-1,80%,80%,80%,96,73,126,9%,18%,2%,2,2,0,1,0,1
390,https://vlr.gg/player/1120/aleksandar,2024-11-23 16:00:00,1.00,1.22,1.10,205,212,202,55,28,27,45,28,17,8,5,3,+1,-1,+2,74%,67%,82%,139,140,138,49%,56%,43%,8,3,5,7,4,3
391,https://vlr.gg/player/5093/logan,2024-11-23 16:00:00,0.94,1.11,1.02,203,198,208,47,24,23,49,31,18,26,11,15,-1,0,-1,80%,72%,88%,133,123,144,24%,31%,20%,2,1,1,3,1,2
392,https://vlr.gg/player/754/nerve,2024-11-23 16:00:00,0.63,1.37,0.98,187,131,249,43,14,29,51,32,19,32,16,16,+3,-3,+6,72%,69%,76%,107,86,130,24%,22%,26%,9,1,8,6,4,2
393,https://vlr.gg/player/24553/boni,2024-11-23 16:00:00,0.68,1.18,0.92,219,178,262,51,21,30,56,32,24,18,9,9,-2,-3,+1,58%,50%,67%,133,103,165,16%,16%,16%,10,4,6,12,7,5
394,https://vlr.gg/player/21878/snarly,2024-11-23 16:00:00,0.56,1.03,0.79,162,154,174,41,19,22,52,33,19,23,9,14,0,-1,+1,77%,69%,85%,101,92,110,37%,36%,38%,6,5,1,6,6,0
395,https://vlr.gg/player/48025/alym,2024-11-23 16:00:00,0.73,1.65,1.21,280,191,361,66,20,46,51,29,22,19,9,10,-1,-4,+3,71%,64%,78%,172,114,225,24%,17%,28%,17,8,9,18,12,6
396,https://vlr.gg/player/10053/fireballops,2024-11-23 16:00:00,1.17,1.22,1.19,234,257,211,61,31,30,45,26,19,6,1,5,+3,+1,+2,72%,67%,78%,147,161,134,33%,34%,32%,6,2,4,3,1,2
397,https://vlr.gg/player/9094/kess,2024-11-23 16:00:00,0.64,1.45,1.07,230,147,312,54,15,39,48,25,23,33,11,22,+2,0,+2,71%,61%,81%,147,90,199,16%,11%,19%,5,1,4,3,1,2
398,https://vlr.gg/player/6445/sogo,2024-11-23 16:00:00,0.87,1.20,1.04,181,156,203,41,16,25,45,25,20,38,15,23,-1,-3,+2,68%,55%,81%,122,109,134,23%,20%,26%,3,0,3,4,3,1
399,https://vlr.gg/player/62/huynh,2024-11-23 16:00:00,0.69,0.85,0.77,142,144,140,31,15,16,48,26,22,36,14,22,-4,-3,-1,78%,79%,78%,86,89,82,16%,26%,9%,3,1,2,7,4,3
400,https://vlr.gg/player/21659/sato,2024-11-23 15:00:00,1.27,1.61,1.45,310,291,318,44,18,26,29,15,14,10,7,3,+7,+6,+1,76%,84%,70%,200,193,205,44%,48%,40%,12,8,4,5,2,3
401,https://vlr.gg/player/28716/lukxo,2024-11-23 15:00:00,1.24,1.22,1.23,255,273,241,40,20,20,28,14,14,10,5,5,+1,-1,+2,79%,74%,83%,154,169,141,31%,34%,29%,5,2,3,4,3,1
402,https://vlr.gg/player/6238/urango,2024-11-23 15:00:00,0.89,1.11,1.01,208,183,223,32,14,18,30,15,15,11,4,7,0,-1,+1,76%,74%,78%,147,117,171,29%,29%,29%,5,0,5,5,1,4
403,https://vlr.gg/player/1566/prozin,2024-11-23 15:00:00,1.02,0.97,0.99,156,147,165,23,10,13,25,11,14,14,8,6,-3,-2,-1,74%,79%,70%,112,109,114,26%,30%,24%,0,0,0,3,2,1
404,https://vlr.gg/player/5351/rglmeister,2024-11-23 15:00:00,0.90,0.84,0.87,139,163,124,21,11,10,26,13,13,17,8,9,+1,+1,0,71%,68%,74%,98,111,87,20%,20%,20%,2,1,1,1,0,1
405,https://vlr.gg/player/37354/basic,2024-11-23 15:00:00,1.25,1.11,1.19,247,253,244,35,20,15,30,16,14,13,5,8,+2,+1,+1,81%,83%,79%,167,170,162,29%,30%,27%,2,1,1,0,0,0
406,https://vlr.gg/player/46568/above,2024-11-23 15:00:00,0.91,1.14,1.01,167,146,193,27,13,14,28,16,12,8,4,4,-2,0,-2,71%,70%,74%,112,102,123,42%,59%,30%,2,1,1,4,1,3
407,https://vlr.gg/player/37091/peixeh,2024-11-23 15:00:00,0.90,0.98,0.94,202,191,218,29,15,14,34,18,16,10,2,8,+2,+1,+1,69%,61%,79%,141,124,162,38%,38%,37%,6,3,3,4,2,2
408,https://vlr.gg/player/37098/tiezzi,2024-11-23 15:00:00,0.50,0.94,0.70,187,148,240,28,12,16,34,19,15,6,2,4,-4,-4,0,57%,48%,68%,118,94,148,34%,39%,31%,6,4,2,10,8,2
409,https://vlr.gg/player/1673/guiih9,2024-11-23 15:00:00,0.66,0.55,0.61,140,143,147,19,10,9,34,18,16,13,7,6,-4,-1,-3,57%,57%,58%,107,107,106,24%,33%,16%,2,1,1,6,2,4
410,https://vlr.gg/player/5244/sutecas,2024-11-23 15:00:00,1.05,1.21,1.14,191,201,205,34,16,18,34,18,16,29,9,20,-2,-2,0,83%,82%,85%,135,136,134,33%,36%,31%,1,0,1,3,2,1
411,https://vlr.gg/player/7605/closer,2024-11-23 15:00:00,0.68,1.25,0.99,196,134,254,33,10,23,35,18,17,12,6,6,+2,0,+2,65%,59%,69%,132,93,165,17%,13%,20%,5,0,5,3,0,3
412,https://vlr.gg/player/1650/bladez,2024-11-23 15:00:00,0.71,1.18,0.97,198,174,212,34,14,20,35,19,16,6,2,4,-1,-5,+4,73%,64%,81%,139,119,156,28%,37%,23%,11,4,7,12,9,3
413,https://vlr.gg/player/2416/francez,2024-11-23 15:00:00,0.83,1.07,0.96,180,186,197,32,14,18,37,21,16,23,9,14,+2,0,+2,73%,73%,73%,126,127,125,36%,36%,36%,3,1,2,1,1,0
414,https://vlr.gg/player/28383/crocs,2024-11-23 15:00:00,0.62,0.95,0.80,199,181,206,31,12,19,37,19,18,17,6,11,+3,+3,0,77%,64%,88%,128,119,136,32%,31%,33%,6,4,2,3,1,2
415,https://vlr.gg/player/23010/nicksz,2024-11-23 15:00:00,1.08,1.46,1.25,206,176,264,38,16,22,29,18,11,13,8,5,+3,-1,+4,79%,73%,86%,156,134,183,34%,26%,46%,5,0,5,2,1,1
416,https://vlr.gg/player/41445/saalped,2024-11-23 15:00:00,1.16,1.28,1.22,219,232,204,38,21,17,31,19,12,7,3,4,0,-1,+1,67%,58%,77%,150,150,151,33%,34%,33%,2,1,1,2,2,0
417,https://vlr.gg/player/2006/glym,2024-11-23 15:00:00,0.99,1.27,1.12,168,169,178,33,17,16,27,17,10,12,5,7,-3,-2,-1,77%,65%,91%,107,102,114,32%,46%,23%,2,1,1,5,3,2
418,https://vlr.gg/player/41851/jway,2024-11-23 15:00:00,0.81,1.06,0.93,210,188,236,33,16,17,38,22,16,19,10,9,+1,0,+1,81%,77%,86%,138,115,165,34%,47%,25%,5,2,3,4,2,2
419,https://vlr.gg/player/37024/czewick,2024-11-23 15:00:00,0.56,1.17,0.84,233,159,288,36,13,23,39,22,17,11,6,5,-5,-4,-1,67%,62%,73%,148,121,181,24%,25%,24%,8,5,3,13,9,4
420,https://vlr.gg/player/804/buzz,2024-11-23 12:25:00,1.50,1.26,1.39,275,325,219,81,50,31,54,32,22,12,6,6,+14,+8,+6,75%,73%,77%,170,203,133,20%,21%,19%,20,13,7,6,5,1
421,https://vlr.gg/player/4056/sylvan,2024-11-23 12:25:00,0.96,1.46,1.19,221,164,290,63,24,39,55,27,28,52,30,22,-1,-3,+2,80%,78%,82%,137,99,182,30%,20%,37%,8,2,6,9,5,4
422,https://vlr.gg/player/485/stax,2024-11-23 12:25:00,1.04,1.08,1.06,186,164,209,56,27,29,55,28,27,37,18,19,+5,+2,+3,83%,80%,87%,122,110,135,25%,24%,26%,6,3,3,1,1,0
423,https://vlr.gg/player/29833/izu,2024-11-23 12:25:00,0.86,0.85,0.85,166,172,160,51,28,23,56,30,26,20,8,12,-8,-3,-5,67%,71%,62%,112,116,107,21%,30%,12%,4,2,2,12,5,7
424,https://vlr.gg/player/13039/meteor,2024-11-23 12:25:00,0.72,0.90,0.80,165,131,206,50,22,28,56,27,29,13,5,8,-4,-7,+3,65%,60%,72%,109,86,135,33%,31%,33%,7,1,6,11,8,3
425,https://vlr.gg/player/1129/rossy,2024-11-23 12:25:00,1.32,1.06,1.18,230,248,212,70,35,35,60,29,31,24,12,12,+2,0,+2,70%,64%,76%,151,160,143,26%,38%,18%,8,4,4,6,4,2
426,https://vlr.gg/player/7871/xeppaa,2024-11-23 12:25:00,1.03,0.91,0.96,209,244,182,62,35,27,66,33,33,37,22,15,-5,0,-5,75%,87%,64%,130,145,118,27%,27%,26%,4,3,1,9,3,6
427,https://vlr.gg/player/18796/oxy,2024-11-23 12:25:00,0.69,1.18,0.95,223,198,244,59,23,36,68,35,33,24,14,10,-2,-5,+3,68%,72%,64%,140,123,154,20%,17%,22%,18,8,10,20,13,7
428,https://vlr.gg/player/17433/v1c,2024-11-23 12:25:00,0.91,0.93,0.92,160,156,163,46,21,25,57,29,28,48,24,24,+3,-1,+4,79%,74%,82%,97,92,101,29%,27%,30%,6,0,6,3,1,2
429,https://vlr.gg/player/7458/moose,2024-11-23 12:25:00,0.64,0.90,0.78,130,123,137,39,19,20,53,26,27,21,8,13,-4,-3,-1,68%,59%,76%,88,86,89,24%,19%,28%,3,0,3,7,3,4
430,https://vlr.gg/player/1770/wat,2024-11-23 11:00:00,1.57,1.19,1.41,281,311,240,66,44,22,44,25,19,18,5,13,-2,0,-2,76%,72%,81%,176,192,155,38%,44%,32%,5,3,2,7,3,4
431,https://vlr.gg/player/46048/r0meo,2024-11-23 11:00:00,0.74,1.16,0.92,193,162,241,40,18,22,46,26,20,20,11,9,+3,-1,+4,68%,61%,78%,127,109,150,26%,22%,31%,11,5,6,8,6,2
432,https://vlr.gg/player/12323/rvk,2024-11-23 11:00:00,1.16,0.58,0.91,170,185,153,37,25,12,41,21,20,9,6,3,-2,0,-2,59%,64%,52%,113,119,105,27%,33%,20%,2,1,1,4,1,3
433,https://vlr.gg/player/3502/ri0,2024-11-23 11:00:00,0.77,0.93,0.84,153,146,166,34,18,16,46,27,19,19,12,7,-2,-2,0,60%,61%,59%,102,92,116,25%,29%,21%,5,3,2,7,5,2
434,https://vlr.gg/player/46121/marcai,2024-11-23 11:00:00,0.73,0.80,0.76,177,176,180,36,20,16,52,29,23,13,8,5,0,-1,+1,70%,72%,67%,120,119,121,24%,24%,26%,7,4,3,7,5,2
435,https://vlr.gg/player/40060/rage,2024-11-23 11:00:00,1.37,1.10,1.20,205,232,190,13,6,7,10,3,7,8,3,5,+1,0,+1,74%,71%,75%,144,169,130,37%,19%,57%,1,0,1,0,0,0
436,https://vlr.gg/player/49570/rinsat,2024-11-23 11:00:00,1.43,0.84,1.10,238,297,201,51,27,24,47,18,29,29,15,14,+2,+2,0,70%,74%,67%,159,193,134,43%,46%,39%,7,4,3,5,2,3
437,https://vlr.gg/player/27755/icarus,2024-11-23 11:00:00,1.18,1.00,1.08,186,175,190,42,18,24,36,14,22,10,2,8,-1,+1,-2,70%,67%,72%,122,120,124,29%,40%,23%,2,1,1,3,0,3
438,https://vlr.gg/player/43403/silon,2024-11-23 11:00:00,0.92,1.09,1.02,213,203,232,50,21,29,44,19,25,10,3,7,-1,-2,+1,76%,78%,75%,133,120,144,18%,22%,15%,10,3,7,11,5,6
439,https://vlr.gg/player/43398/river,2024-11-23 11:00:00,0.83,1.03,0.94,163,153,174,26,11,15,28,13,15,14,8,6,+1,+1,0,70%,75%,67%,108,96,118,46%,50%,43%,3,2,1,2,1,1
440,https://vlr.gg/player/43389/yash,2024-11-23 11:00:00,0.85,0.91,0.88,214,187,230,47,18,29,48,21,27,7,3,4,+1,-3,+4,67%,70%,64%,133,114,146,20%,15%,24%,10,3,7,9,6,3
441,https://vlr.gg/player/4056/sylvan,2024-11-23 08:00:00,1.35,0.85,1.11,179,207,152,36,21,15,36,16,20,35,22,13,0,+1,-1,75%,79%,71%,117,133,100,34%,37%,31%,2,1,1,2,0,2
442,https://vlr.gg/player/804/buzz,2024-11-23 08:00:00,1.08,1.18,1.11,216,219,228,44,23,21,38,21,17,6,3,3,+4,+1,+3,67%,69%,64%,138,130,146,22%,23%,20%,12,6,6,8,5,3
443,https://vlr.gg/player/29833/izu,2024-11-23 08:00:00,1.09,1.04,1.06,203,197,222,42,22,20,38,18,20,14,8,6,-3,-2,-1,72%,66%,79%,141,134,147,27%,26%,28%,7,3,4,10,5,5
444,https://vlr.gg/player/485/stax,2024-11-23 08:00:00,0.81,1.09,0.95,198,161,234,34,15,19,41,19,22,33,14,19,+3,+1,+2,72%,69%,75%,129,106,152,14%,19%,11%,5,3,2,2,2,0
445,https://vlr.gg/player/13039/meteor,2024-11-23 08:00:00,0.91,0.84,0.87,182,199,168,37,20,17,40,22,18,10,5,5,-3,-2,-1,63%,69%,57%,127,135,118,38%,44%,34%,3,1,2,6,3,3
446,https://vlr.gg/player/12793/xeus,2024-11-23 08:00:00,1.34,1.06,1.20,273,312,217,52,30,22,43,22,21,12,6,6,+4,+4,0,67%,71%,62%,166,189,145,33%,33%,32%,13,7,6,9,3,6
447,https://vlr.gg/player/8369/yetujey,2024-11-23 08:00:00,1.14,1.08,1.11,207,172,221,41,18,23,35,15,20,8,4,4,+3,0,+3,70%,68%,72%,131,117,144,24%,27%,23%,5,1,4,2,1,1
448,https://vlr.gg/player/8044/mrfalin,2024-11-23 08:00:00,1.09,0.86,0.96,178,196,155,35,21,14,36,18,18,19,9,10,-2,0,-2,67%,68%,66%,118,127,109,22%,22%,22%,3,1,2,5,1,4
449,https://vlr.gg/player/6510/atakaptan,2024-11-23 08:00:00,0.65,1.13,0.89,177,131,227,34,11,23,42,20,22,25,14,11,-2,-3,+1,61%,61%,62%,121,84,157,38%,34%,40%,6,4,2,8,7,1
450,https://vlr.gg/player/1139/qraxs,2024-11-23 08:00:00,0.97,0.79,0.88,144,157,131,31,17,14,37,17,20,19,10,9,-4,-3,-1,70%,68%,72%,86,96,77,32%,43%,19%,1,0,1,5,3,2
451,https://vlr.gg/player/40912/123,2024-11-23 07:45:00,1.35,1.37,1.36,283,278,281,64,32,32,45,23,22,21,6,15,+4,+3,+1,80%,83%,77%,200,188,210,36%,38%,35%,8,4,4,4,1,3
452,https://vlr.gg/player/18702/deadly10,2024-11-23 07:45:00,0.92,1.46,1.21,233,245,216,54,24,30,42,27,15,10,6,4,+10,+6,+4,82%,80%,83%,141,152,131,32%,33%,32%,14,9,5,4,3,1
453,https://vlr.gg/player/19231/kibojn,2024-11-23 07:45:00,0.89,1.39,1.16,179,153,198,43,17,26,34,19,15,41,16,25,-6,-4,-2,85%,80%,89%,104,86,119,36%,42%,33%,3,1,2,9,5,4
454,https://vlr.gg/player/48426/ghostxd,2024-11-23 07:45:00,0.88,1.00,0.94,190,162,221,45,17,28,46,23,23,11,3,8,+2,+1,+1,63%,60%,66%,126,108,141,33%,38%,29%,6,2,4,4,1,3
455,https://vlr.gg/player/8156/mojo,2024-11-23 07:45:00,0.64,1.01,0.84,173,142,201,40,15,25,47,23,24,28,11,17,-1,-2,+1,66%,57%,74%,113,91,131,25%,23%,26%,6,1,5,7,3,4
456,https://vlr.gg/player/30286/karam1l,2024-11-23 07:45:00,1.06,1.54,1.28,292,235,360,63,27,36,51,29,22,12,5,7,+2,-2,+4,68%,60%,77%,195,159,237,34%,37%,32%,10,3,7,8,5,3
457,https://vlr.gg/player/46104/envy2k,2024-11-23 07:45:00,1.12,0.87,1.00,238,281,195,53,32,21,48,27,21,12,6,6,-5,-1,-4,68%,66%,70%,143,165,118,19%,19%,18%,11,9,2,16,10,6
458,https://vlr.gg/player/5009/wstvirginia,2024-11-23 07:45:00,0.30,1.38,0.79,141,86,214,33,8,25,47,31,16,21,12,9,-2,0,-2,55%,40%,73%,103,62,151,35%,23%,43%,0,0,0,2,0,2
459,https://vlr.gg/player/31355/acestarrrrr,2024-11-23 07:45:00,0.71,0.83,0.76,162,142,189,35,16,19,51,28,23,20,10,10,0,-1,+1,65%,57%,73%,105,93,119,22%,21%,24%,7,3,4,7,4,3
460,https://vlr.gg/player/43390/d1sease,2024-11-23 07:45:00,0.73,0.55,0.65,124,119,124,30,16,14,49,26,23,15,8,7,-4,-1,-3,63%,63%,63%,82,81,83,18%,15%,20%,0,0,0,4,1,3
461,https://vlr.gg/player/4866/kushy,2024-11-23 07:15:00,,,,222,,,53,,,43,,,14,,,,,,,,,,,,,,,,,,,,
462,https://vlr.gg/player/24895/jemkin,2024-11-23 07:15:00,,,,218,,,52,,,39,,,9,,,,,,,,,,,,,,,,,,,,
463,https://vlr.gg/player/8497/monyet,2024-11-23 07:15:00,,,,206,,,44,,,51,,,15,,,,,,,,,,,,,,,,,,,,
464,https://vlr.gg/player/25025/estrella,2024-11-23 07:15:00,,,,170,,,38,,,38,,,34,,,,,,,,,,,,,,,,,,,,
465,https://vlr.gg/player/4871/xffero,2024-11-23 07:15:00,,,,134,,,30,,,34,,,17,,,,,,,,,,,,,,,,,,,,
466,https://vlr.gg/player/6672/meiy,2024-11-23 07:15:00,,,,235,,,55,,,43,,,13,,,,,,,,,,,,,,,,,,,,
467,https://vlr.gg/player/4052/jinboong,2024-11-23 07:15:00,,,,205,,,48,,,43,,,8,,,,,,,,,,,,,,,,,,,,
468,https://vlr.gg/player/21438/ssees,2024-11-23 07:15:00,,,,163,,,36,,,41,,,25,,,,,,,,,,,,,,,,,,,,
469,https://vlr.gg/player/10627/art,2024-11-23 07:15:00,,,,156,,,31,,,47,,,18,,,,,,,,,,,,,,,,,,,,
470,https://vlr.gg/player/13002/akame,2024-11-23 07:15:00,,,,149,,,35,,,43,,,21,,,,,,,,,,,,,,,,,,,,
471,https://vlr.gg/player/24628/wayne,2024-11-23 06:00:00,1.36,1.52,1.46,284,232,309,56,18,38,35,14,21,57,21,36,0,0,0,90%,83%,94%,184,151,206,29%,26%,31%,4,1,3,4,1,3
472,https://vlr.gg/player/11704/styron,2024-11-23 06:00:00,1.43,1.33,1.37,219,214,219,48,19,29,27,11,16,16,5,11,+4,+2,+2,85%,83%,86%,136,126,143,31%,38%,28%,6,2,4,2,0,2
473,https://vlr.gg/player/9152/deryeon,2024-11-23 06:00:00,0.90,1.44,1.23,206,170,232,47,14,33,32,15,17,15,5,10,+5,+1,+4,80%,70%,86%,133,111,147,26%,19%,31%,10,5,5,5,4,1
474,https://vlr.gg/player/24653/vera,2024-11-23 06:00:00,0.90,1.39,1.20,239,210,252,51,16,35,36,17,19,21,7,14,+4,+2,+2,83%,74%,89%,150,134,160,20%,15%,25%,12,5,7,8,3,5
475,https://vlr.gg/player/1430/crazyguy,2024-11-23 06:00:00,1.17,0.98,1.05,188,192,181,37,16,21,36,15,21,21,6,15,+2,0,+2,83%,74%,89%,139,149,132,26%,26%,26%,5,1,4,3,1,2
476,https://vlr.gg/player/2346/cud,2024-11-23 06:00:00,1.16,1.12,1.14,199,216,183,45,29,16,45,30,15,8,5,3,0,-2,+2,58%,61%,52%,144,158,122,49%,52%,45%,5,1,4,5,3,2
477,https://vlr.gg/player/23710/gotten,2024-11-23 06:00:00,0.96,0.82,0.90,180,204,156,39,26,13,48,31,17,12,7,5,+2,+2,0,66%,64%,70%,113,124,96,34%,34%,34%,3,3,0,1,1,0
478,https://vlr.gg/player/7807/valdyn,2024-11-23 06:00:00,0.69,0.88,0.76,172,145,216,34,17,17,46,30,16,10,8,2,-3,0,-3,59%,56%,65%,119,99,149,36%,33%,39%,2,1,1,5,1,4
479,https://vlr.gg/player/11666/ray4c,2024-11-23 06:00:00,0.42,0.82,0.57,145,126,191,27,13,14,49,32,17,12,8,4,-7,-6,-1,58%,44%,78%,101,81,132,19%,18%,21%,10,7,3,17,13,4
480,https://vlr.gg/player/16852/nakya,2024-11-23 06:00:00,0.30,0.71,0.46,125,95,172,21,9,12,51,33,18,10,6,4,-7,-4,-3,63%,58%,70%,94,71,129,29%,29%,28%,2,1,1,9,5,4
481,https://vlr.gg/player/9196/t3xture,2024-11-23 04:00:00,,,,241,,,60,,,50,,,10,,,,,,,,,,,,,,,,,,,,
482,https://vlr.gg/player/34974/karon,2024-11-23 04:00:00,,,,199,,,48,,,42,,,22,,,,,,,,,,,,,,,,,,,,
483,https://vlr.gg/player/2489/munchkin,2024-11-23 04:00:00,,,,194,,,41,,,39,,,44,,,,,,,,,,,,,,,,,,,,
484,https://vlr.gg/player/11600/foxy9,2024-11-23 04:00:00,,,,160,,,36,,,48,,,16,,,,,,,,,,,,,,,,,,,,
485,https://vlr.gg/player/25081/yoman,2024-11-23 04:00:00,,,,119,,,25,,,45,,,21,,,,,,,,,,,,,,,,,,,,
486,https://vlr.gg/player/28400/hyunmin,2024-11-23 04:00:00,,,,241,,,56,,,46,,,10,,,,,,,,,,,,,,,,,,,,
487,https://vlr.gg/player/4462/mako,2024-11-23 04:00:00,,,,232,,,55,,,36,,,29,,,,,,,,,,,,,,,,,,,,
488,https://vlr.gg/player/35013/flashback,2024-11-23 04:00:00,,,,181,,,45,,,40,,,15,,,,,,,,,,,,,,,,,,,,
489,https://vlr.gg/player/34982/athan,2024-11-23 04:00:00,,,,170,,,36,,,42,,,39,,,,,,,,,,,,,,,,,,,,
490,https://vlr.gg/player/1916/free1ng,2024-11-23 04:00:00,,,,138,,,32,,,46,,,12,,,,,,,,,,,,,,,,,,,,
491,https://vlr.gg/player/5796/kr1stal,2024-11-23 04:00:00,1.42,1.49,1.46,214,192,233,30,10,20,17,6,11,19,11,8,-1,0,-1,79%,80%,79%,163,143,176,30%,25%,33%,1,0,1,2,0,2
492,https://vlr.gg/player/7437/kellys,2024-11-23 04:00:00,1.16,1.45,1.34,234,183,265,35,10,25,23,8,15,19,8,11,-1,-1,0,90%,87%,92%,153,117,176,37%,37%,36%,0,0,0,1,1,0
493,https://vlr.gg/player/4428/udotan,2024-11-23 04:00:00,1.26,1.28,1.27,234,218,239,32,12,20,25,10,15,12,4,8,0,-2,+2,67%,53%,75%,155,144,162,31%,25%,35%,3,0,3,3,2,1
494,https://vlr.gg/player/13219/papi,2024-11-23 04:00:00,1.21,0.98,1.07,193,188,192,26,10,16,24,8,16,23,10,13,+2,-1,+3,74%,80%,71%,127,119,132,20%,26%,17%,4,1,3,2,2,0
495,https://vlr.gg/player/44259/patrickwho,2024-11-23 04:00:00,1.00,1.01,1.01,261,287,244,35,15,20,32,13,19,8,2,6,+3,-1,+4,79%,80%,79%,162,168,158,24%,21%,27%,13,4,9,10,5,5
496,https://vlr.gg/player/49587/bugattiveyron,2024-11-23 04:00:00,1.00,1.09,1.04,237,226,246,31,19,12,32,20,12,7,4,3,0,-3,+3,74%,71%,80%,144,135,159,15%,17%,12%,5,2,3,5,5,0
497,https://vlr.gg/player/49590/tln,2024-11-23 04:00:00,0.97,1.05,1.00,227,217,243,17,9,8,15,9,6,2,2,0,+2,+2,0,62%,67%,56%,148,151,145,38%,33%,47%,3,2,1,1,0,1
498,https://vlr.gg/player/49589/ca1m,2024-11-23 04:00:00,1.12,0.41,0.85,192,235,118,25,19,6,33,19,14,13,9,4,-2,-2,0,64%,71%,53%,127,162,72,28%,35%,12%,3,2,1,5,4,1
499,https://vlr.gg/player/49588/rgynb,2024-11-23 04:00:00,0.59,0.84,0.69,131,124,146,18,11,7,29,19,10,8,5,3,-2,-4,+2,67%,63%,73%,83,72,102,22%,20%,24%,4,0,4,6,4,2
500,https://vlr.gg/player/25949/bunt,2024-11-23 04:00:00,0.60,0.75,0.66,168,164,172,23,13,10,33,23,10,10,7,3,0,0,0,79%,79%,80%,104,106,102,20%,18%,25%,3,2,1,3,2,1
501,https://vlr.gg/player/49586/wdknahnw,2024-11-23 04:00:00,0.38,0.41,0.39,96,104,82,7,5,2,16,11,5,6,3,3,-1,-1,0,61%,50%,83%,57,70,33,13%,19%,0%,0,0,0,1,1,0
0,https://vlr.gg/player/8422/spaz,2024-11-22 22:30:00,1.19,1.15,1.17,213,212,216,51,27,24,40,24,16,25,13,12,+4,+2,+2,74%,65%,84%,138,137,140,29%,29%,28%,7,2,5,3,0,3
1,https://vlr.gg/player/2164/paincakes,2024-11-22 22:30:00,0.97,1.24,1.10,211,206,214,49,26,23,41,27,14,16,7,9,+9,+5,+4,77%,73%,81%,139,133,146,29%,27%,31%,11,5,6,2,0,2
2,https://vlr.gg/player/2172/brawk,2024-11-22 22:30:00,0.97,1.08,1.02,195,183,203,49,25,24,44,26,18,18,7,11,+5,+2,+3,81%,70%,94%,126,112,143,35%,41%,30%,5,2,3,0,0,0
3,https://vlr.gg/player/864/bcj,2024-11-22 22:30:00,0.71,1.38,1.02,201,147,259,49,18,31,48,29,19,20,11,9,-4,-5,+1,71%,65%,78%,130,96,169,31%,28%,33%,7,5,2,11,10,1
4,https://vlr.gg/player/23407/pa1nt,2024-11-22 22:30:00,0.28,0.90,0.57,155,118,207,36,13,23,56,34,22,11,6,5,-9,-9,0,57%,46%,69%,109,90,130,18%,15%,21%,7,2,5,16,11,5
5,https://vlr.gg/player/28870/k0rupt,2024-11-22 22:30:00,0.71,1.44,1.10,181,128,228,47,13,34,43,23,20,28,14,14,0,-2,+2,70%,69%,70%,122,77,161,32%,39%,29%,6,1,5,6,3,3
6,https://vlr.gg/player/36036/practo,2024-11-22 22:30:00,0.93,1.24,1.10,201,195,204,51,22,29,44,25,19,14,3,11,0,-1,+1,71%,69%,73%,131,137,125,32%,34%,31%,9,4,5,9,5,4
7,https://vlr.gg/player/5035/blahst,2024-11-22 22:30:00,1.03,1.07,1.05,205,206,204,49,24,25,49,25,24,19,5,14,+5,+3,+2,70%,59%,78%,133,138,129,23%,34%,16%,8,4,4,3,1,2
8,https://vlr.gg/player/17751/tim,2024-11-22 22:30:00,0.84,1.10,0.98,174,150,197,40,16,24,46,24,22,33,9,24,-3,-2,-1,78%,72%,84%,124,114,133,24%,26%,23%,2,0,2,5,2,3
9,https://vlr.gg/player/20922/zekei,2024-11-22 22:30:00,0.55,1.16,0.87,193,151,239,42,14,28,52,28,24,17,9,8,-7,-8,+1,65%,63%,68%,131,104,154,16%,17%,14%,7,2,5,14,10,4
10,https://vlr.gg/player/6450/korsonix,2024-11-22 20:00:00,0.84,1.07,0.96,187,206,168,31,16,15,33,18,15,16,6,10,0,0,0,67%,64%,71%,118,123,114,23%,23%,23%,4,1,3,4,1,3
11,https://vlr.gg/player/8792/xhowi,2024-11-22 20:00:00,0.97,0.85,0.91,211,222,199,33,17,16,36,18,18,11,4,7,-3,-1,-2,72%,68%,75%,140,149,131,38%,41%,34%,2,0,2,5,1,4
12,https://vlr.gg/player/8286/glyph,2024-11-22 20:00:00,1.02,0.78,0.89,185,226,148,26,17,9,35,18,17,15,3,12,-1,+1,-2,67%,64%,71%,120,142,99,32%,47%,22%,3,2,1,4,1,3
13,https://vlr.gg/player/593/fresht,2024-11-22 20:00:00,0.30,1.09,0.71,191,156,223,30,10,20,38,21,17,11,8,3,-5,-7,+2,65%,59%,71%,128,105,149,20%,23%,17%,6,2,4,11,9,2
14,https://vlr.gg/player/17694/prask,2024-11-22 20:00:00,0.34,0.75,0.55,125,93,153,19,6,13,38,19,19,7,3,4,-3,-1,-2,63%,68%,58%,85,63,105,17%,14%,19%,2,2,0,5,3,2
15,https://vlr.gg/player/10557/darker,2024-11-22 20:00:00,1.06,1.37,1.21,199,155,246,33,14,19,27,14,13,22,8,14,+1,+1,0,83%,75%,91%,131,110,154,29%,33%,26%,1,1,0,0,0,0
16,https://vlr.gg/player/3983/virtyy,2024-11-22 20:00:00,1.08,1.30,1.19,265,239,294,45,22,23,29,16,13,6,2,4,+5,0,+5,76%,67%,86%,171,149,196,21%,18%,25%,14,7,7,9,7,2
17,https://vlr.gg/player/8056/mited,2024-11-22 20:00:00,1.18,1.16,1.17,202,217,187,33,17,16,27,15,12,18,10,8,0,+2,-2,80%,83%,77%,144,161,126,23%,23%,23%,5,3,2,5,1,4
18,https://vlr.gg/player/7616/feniz,2024-11-22 20:00:00,1.08,1.25,1.16,222,189,255,36,16,20,28,14,14,13,4,9,+4,+2,+2,78%,71%,86%,145,125,167,34%,34%,34%,5,3,2,1,1,0
19,https://vlr.gg/player/17690/jow,2024-11-22 20:00:00,1.03,1.09,1.06,192,192,197,33,17,16,28,14,14,16,10,6,+2,-1,+3,91%,92%,91%,111,114,107,31%,26%,37%,4,0,4,2,1,1
20,https://vlr.gg/player/8422/spaz,2024-11-22 18:25:00,1.19,1.31,1.25,215,215,223,57,27,30,49,26,23,40,19,21,+3,+1,+2,78%,79%,78%,143,143,142,24%,26%,22%,6,3,3,3,2,1
21,https://vlr.gg/player/23407/pa1nt,2024-11-22 18:25:00,1.12,0.98,1.05,228,237,219,65,33,32,57,27,30,14,6,8,0,-4,+4,62%,59%,65%,145,151,138,25%,29%,21%,13,3,10,13,7,6
22,https://vlr.gg/player/2172/brawk,2024-11-22 18:25:00,0.97,1.08,1.03,198,169,222,52,23,29,53,26,27,27,12,15,0,-1,+1,76%,77%,75%,134,116,151,19%,20%,19%,5,2,3,5,3,2
23,https://vlr.gg/player/2164/paincakes,2024-11-22 18:25:00,0.74,1.22,0.98,198,173,227,57,24,33,58,31,27,14,5,9,-3,-5,+2,62%,56%,68%,135,114,155,28%,26%,30%,6,2,4,9,7,2
24,https://vlr.gg/player/864/bcj,2024-11-22 18:25:00,0.72,0.97,0.85,186,176,192,48,23,25,62,33,29,37,15,22,-7,-6,-1,76%,72%,80%,116,107,125,24%,28%,22%,6,2,4,13,8,5
25,https://vlr.gg/player/733/stellar,2024-11-22 18:25:00,1.11,1.25,1.18,218,194,247,64,28,36,51,26,25,21,13,8,+7,0,+7,73%,68%,79%,141,129,153,23%,28%,19%,9,2,7,2,2,0
26,https://vlr.gg/player/69/thief,2024-11-22 18:25:00,1.10,1.20,1.15,224,226,233,65,32,33,54,29,25,21,11,10,+5,-1,+6,78%,73%,85%,149,150,148,27%,29%,26%,11,4,7,6,5,1
27,https://vlr.gg/player/7716/penny,2024-11-22 18:25:00,0.66,1.27,0.96,225,185,254,56,23,33,59,35,24,21,10,11,-1,-3,+2,72%,70%,74%,148,121,175,18%,22%,16%,12,5,7,13,8,5
28,https://vlr.gg/player/739/fiziq,2024-11-22 18:25:00,0.84,0.91,0.87,170,172,175,45,23,22,58,30,28,32,13,19,+3,+2,+1,62%,60%,64%,113,113,113,16%,23%,10%,8,3,5,5,1,4
29,https://vlr.gg/player/8742/jakee,2024-11-22 18:25:00,0.94,0.75,0.83,172,198,156,48,29,19,57,30,27,26,11,15,-7,-6,-1,75%,73%,77%,118,127,109,21%,29%,14%,3,2,1,10,8,2
30,https://vlr.gg/player/36036/practo,2024-11-22 18:25:00,1.53,1.32,1.43,228,259,197,28,16,12,16,9,7,12,7,5,0,+1,-1,85%,94%,76%,166,183,149,24%,17%,31%,2,2,0,2,1,1
31,https://vlr.gg/player/5035/blahst,2024-11-22 18:25:00,1.47,1.28,1.38,222,252,191,29,16,13,17,9,8,12,7,5,+1,+1,0,88%,88%,88%,145,158,133,19%,25%,15%,4,3,1,3,2,1
32,https://vlr.gg/player/20922/zekei,2024-11-22 18:25:00,1.35,1.29,1.32,258,278,239,35,18,17,21,11,10,7,4,3,+2,0,+2,76%,71%,82%,160,185,136,26%,25%,26%,6,3,3,4,3,1
33,https://vlr.gg/player/17751/tim,2024-11-22 18:25:00,1.07,1.49,1.28,256,217,297,31,12,19,22,11,11,17,11,6,+6,-1,+7,82%,82%,82%,165,150,180,33%,26%,41%,9,1,8,3,2,1
34,https://vlr.gg/player/28870/k0rupt,2024-11-22 18:25:00,1.63,0.71,1.17,198,227,169,25,16,9,20,7,13,21,11,10,-1,0,-1,85%,88%,82%,123,130,115,33%,44%,24%,0,0,0,1,0,1
35,https://vlr.gg/player/6642/wildfire,2024-11-22 18:25:00,1.15,0.81,0.98,206,207,205,27,15,12,28,13,15,8,2,6,-1,-1,0,68%,65%,71%,129,135,123,32%,31%,32%,4,2,2,5,3,2
36,https://vlr.gg/player/2119/renz,2024-11-22 18:25:00,0.74,0.63,0.69,183,211,156,21,12,9,29,14,15,4,2,2,-3,-4,+1,59%,59%,59%,109,123,95,18%,17%,19%,3,1,2,6,5,1
37,https://vlr.gg/player/766/ange,2024-11-22 18:25:00,0.96,0.32,0.64,141,187,95,15,12,3,29,13,16,11,4,7,-1,0,-1,74%,76%,71%,92,110,75,19%,19%,19%,2,1,1,3,1,2
38,https://vlr.gg/player/12932/geeza,2024-11-22 18:25:00,0.32,0.97,0.63,168,74,261,18,3,15,31,15,16,7,4,3,-2,-2,0,53%,59%,47%,108,59,157,34%,19%,41%,4,1,3,6,3,3
39,https://vlr.gg/player/15639/chloric,2024-11-22 18:25:00,0.73,0.49,0.61,163,166,161,15,7,8,31,15,16,13,10,3,-1,0,-1,59%,65%,53%,124,128,119,18%,17%,19%,0,0,0,1,0,1
40,https://vlr.gg/player/1595/myssen,2024-11-22 17:20:00,1.30,1.55,1.46,267,212,282,34,11,23,20,8,12,18,6,12,+2,0,+2,89%,79%,96%,181,152,197,47%,55%,44%,3,0,3,1,0,1
41,https://vlr.gg/player/1605/champzera,2024-11-22 17:20:00,1.41,1.41,1.41,257,268,257,38,13,25,25,9,16,27,11,16,+3,0,+3,95%,93%,96%,173,168,176,30%,25%,33%,4,0,4,1,0,1
42,https://vlr.gg/player/36105/needy,2024-11-22 17:20:00,1.34,1.25,1.28,263,260,260,36,13,23,24,8,16,7,3,4,+4,+2,+2,82%,79%,83%,165,172,161,25%,22%,27%,9,5,4,5,3,2
43,https://vlr.gg/player/20251/vit9ine,2024-11-22 17:20:00,1.06,1.16,1.12,187,180,208,28,10,18,21,8,13,13,3,10,-1,-1,0,84%,86%,83%,136,138,135,36%,46%,30%,4,1,3,5,2,3
44,https://vlr.gg/player/25683/desire,2024-11-22 17:20:00,1.31,0.84,1.01,174,208,144,22,12,10,21,7,14,16,5,11,-6,-3,-3,71%,79%,67%,116,127,110,35%,53%,24%,0,0,0,6,3,3
45,https://vlr.gg/player/47551/sanoj,2024-11-22 17:20:00,0.92,0.93,0.92,208,207,205,25,16,9,31,20,11,9,4,5,-3,-1,-2,71%,67%,79%,135,127,147,47%,50%,43%,2,2,0,5,3,2
46,https://vlr.gg/player/45658/tonix,2024-11-22 17:20:00,0.79,1.05,0.88,161,153,186,23,13,10,29,19,10,4,3,1,+1,0,+1,66%,67%,64%,121,114,134,17%,16%,18%,3,0,3,2,0,2
47,https://vlr.gg/player/43538/borgesz,2024-11-22 17:20:00,1.18,0.34,0.87,133,178,59,19,16,3,27,15,12,14,10,4,-1,0,-1,74%,75%,71%,90,122,34,31%,39%,8%,0,0,0,1,0,1
48,https://vlr.gg/player/25691/astroboy,2024-11-22 17:20:00,0.95,0.57,0.81,203,224,169,25,19,6,35,22,13,9,7,2,+4,+2,+2,63%,75%,43%,144,156,125,28%,30%,25%,4,2,2,0,0,0
49,https://vlr.gg/player/41855/sotired,2024-11-22 17:20:00,0.19,0.85,0.43,147,109,220,18,7,11,36,23,13,10,7,3,-3,-5,+2,68%,67%,71%,95,72,134,23%,17%,33%,9,6,3,12,11,1
50,https://vlr.gg/player/16620/bruninej,2024-11-22 17:20:00,1.56,1.26,1.40,264,310,224,39,22,17,27,13,14,16,8,8,+3,+2,+1,83%,95%,73%,161,181,143,25%,20%,31%,7,3,4,4,1,3
51,https://vlr.gg/player/5342/duht,2024-11-22 17:20:00,1.29,1.30,1.30,234,252,215,35,20,15,26,13,13,22,10,12,-1,-1,0,76%,75%,77%,146,152,140,35%,39%,31%,4,2,2,5,3,2
52,https://vlr.gg/player/1999/rnd,2024-11-22 17:20:00,0.78,1.14,0.97,224,239,209,32,17,15,32,20,12,9,3,6,+2,-1,+3,71%,65%,77%,152,159,145,20%,33%,7%,6,2,4,4,3,1
53,https://vlr.gg/player/8896/loweed,2024-11-22 17:20:00,0.35,1.41,0.90,168,83,245,25,4,21,29,17,12,16,9,7,-1,-1,0,83%,80%,86%,113,66,155,26%,11%,36%,1,0,1,2,1,1
54,https://vlr.gg/player/6222/ginilson,2024-11-22 17:20:00,0.74,0.99,0.87,213,191,235,33,14,19,32,15,17,9,3,6,-5,-5,0,69%,65%,73%,137,128,146,20%,20%,20%,2,0,2,7,5,2
55,https://vlr.gg/player/41676/toronto,2024-11-22 17:20:00,1.11,1.10,1.10,224,211,233,33,17,16,32,16,16,8,1,7,-2,-1,-1,69%,64%,75%,154,155,154,40%,50%,32%,3,2,1,5,3,2
56,https://vlr.gg/player/32801/turkish,2024-11-22 17:20:00,0.73,1.27,0.99,223,170,286,34,14,20,32,17,15,9,1,8,+1,0,+1,71%,55%,90%,150,118,186,33%,39%,29%,5,3,2,4,3,1
57,https://vlr.gg/player/23855/str0nda,2024-11-22 17:20:00,1.00,0.86,0.93,184,177,192,26,13,13,34,17,17,18,13,5,+4,-1,+5,74%,77%,70%,121,120,122,44%,47%,40%,5,0,5,1,1,0
58,https://vlr.gg/player/22914/hiiik,2024-11-22 17:20:00,0.58,1.27,0.91,195,178,211,28,12,16,32,19,13,16,8,8,-1,-3,+2,71%,64%,80%,125,116,134,29%,32%,27%,5,2,3,6,5,1
59,https://vlr.gg/player/41864/rodd,2024-11-22 17:20:00,0.55,0.80,0.67,150,155,150,23,11,12,34,19,15,4,0,4,0,+1,-1,62%,50%,75%,108,105,111,29%,26%,31%,4,2,2,4,1,3
60,https://vlr.gg/player/26757/otaq,2024-11-22 17:00:00,1.63,1.45,1.53,266,284,246,59,30,29,31,14,17,23,18,5,+7,+1,+6,85%,83%,88%,161,180,145,24%,25%,23%,8,2,6,1,1,0
61,https://vlr.gg/player/31476/mephisto,2024-11-22 17:00:00,1.49,1.40,1.44,309,315,305,67,32,35,42,20,22,22,10,12,0,-1,+1,69%,72%,66%,196,206,187,23%,24%,23%,9,5,4,9,6,3
62,https://vlr.gg/player/15931/peloncito,2024-11-22 17:00:00,1.02,1.10,1.06,181,181,183,40,19,21,41,20,21,32,11,21,-4,-2,-2,80%,76%,84%,116,109,122,35%,32%,39%,5,1,4,9,3,6
63,https://vlr.gg/player/49572/killy,2024-11-22 17:00:00,0.70,1.34,1.03,165,111,210,37,13,24,35,19,16,36,16,20,-8,-6,-2,77%,76%,78%,108,73,140,41%,31%,47%,1,0,1,9,6,3
64,https://vlr.gg/player/10718/rowancy,2024-11-22 17:00:00,0.96,0.89,0.92,172,187,145,34,18,16,33,17,16,10,2,8,+2,+3,-1,69%,69%,69%,112,130,96,25%,25%,24%,6,4,2,4,1,3
65,https://vlr.gg/player/24021/snapss,2024-11-22 17:00:00,0.86,1.15,1.00,183,162,214,39,18,21,45,24,21,31,15,16,+2,0,+2,70%,66%,76%,121,108,136,31%,30%,33%,6,2,4,4,2,2
66,https://vlr.gg/player/45918/clutchz,2024-11-22 17:00:00,1.08,0.80,0.95,219,260,191,49,29,20,51,27,24,5,2,3,+5,+4,+1,66%,59%,72%,140,157,122,25%,25%,25%,12,7,5,7,3,4
67,https://vlr.gg/player/2491/nolan,2024-11-22 17:00:00,0.75,0.92,0.83,171,164,176,36,19,17,45,25,20,10,3,7,-2,-2,0,59%,63%,55%,115,115,116,26%,23%,30%,4,2,2,6,4,2
68,https://vlr.gg/player/7639/ezznap,2024-11-22 17:00:00,0.65,0.82,0.73,150,121,191,28,12,16,47,22,25,20,6,14,+1,-2,+3,57%,59%,55%,106,91,122,21%,21%,21%,6,1,5,5,3,2
69,https://vlr.gg/player/49571/paganus,2024-11-22 17:00:00,0.60,0.75,0.67,143,134,152,30,14,16,49,27,22,20,11,9,-3,-2,-1,66%,66%,66%,97,98,97,26%,30%,21%,4,3,1,7,5,2
70,https://vlr.gg/player/2164/paincakes,2024-11-22 16:00:00,1.35,1.51,1.42,311,324,286,45,26,19,25,15,10,10,3,7,+5,+2,+3,85%,87%,83%,198,216,174,27%,28%,25%,10,5,5,5,3,2
71,https://vlr.gg/player/864/bcj,2024-11-22 16:00:00,1.17,1.69,1.40,241,195,303,36,16,20,23,14,9,24,13,11,+1,-2,+3,78%,74%,83%,150,126,180,25%,24%,27%,4,1,3,3,3,0
72,https://vlr.gg/player/23407/pa1nt,2024-11-22 16:00:00,1.00,1.35,1.15,236,213,258,35,17,18,28,18,10,10,7,3,+3,+1,+2,76%,70%,83%,135,130,142,30%,38%,20%,6,3,3,3,2,1
73,https://vlr.gg/player/8422/spaz,2024-11-22 16:00:00,0.93,1.33,1.11,197,190,199,28,15,13,25,17,8,31,18,13,0,-1,+1,90%,91%,89%,129,122,138,21%,23%,20%,3,1,2,3,2,1
74,https://vlr.gg/player/2172/brawk,2024-11-22 16:00:00,1.05,0.96,1.01,159,175,145,23,14,9,24,14,10,15,5,10,-1,0,-1,76%,74%,78%,114,120,106,21%,18%,26%,1,1,0,2,1,1
75,https://vlr.gg/player/36036/practo,2024-11-22 16:00:00,0.59,1.45,1.07,231,135,300,32,7,25,30,14,16,9,4,5,+1,-2,+3,63%,50%,74%,148,106,180,47%,36%,57%,4,0,4,3,2,1
76,https://vlr.gg/player/20922/zekei,2024-11-22 16:00:00,0.50,1.25,0.92,200,146,244,27,9,18,35,18,17,7,0,7,-7,-6,-1,61%,44%,74%,127,89,158,11%,15%,9%,3,1,2,10,7,3
77,https://vlr.gg/player/5035/blahst,2024-11-22 16:00:00,0.93,0.74,0.83,178,210,157,24,14,10,33,15,18,11,3,8,+2,+1,+1,61%,67%,57%,122,132,115,27%,32%,24%,5,3,2,3,2,1
78,https://vlr.gg/player/28870/k0rupt,2024-11-22 16:00:00,0.45,0.90,0.70,147,123,174,22,7,15,33,16,17,16,4,12,-2,-2,0,66%,67%,65%,99,83,111,33%,27%,37%,3,0,3,5,2,3
79,https://vlr.gg/player/17751/tim,2024-11-22 16:00:00,0.72,0.41,0.55,153,175,131,20,10,10,37,17,20,17,6,11,-2,0,-2,61%,56%,65%,99,115,87,18%,22%,15%,2,1,1,4,1,3
80,https://vlr.gg/player/739/fiziq,2024-11-22 16:00:00,2.03,0.80,1.53,290,334,175,38,28,10,23,8,15,26,20,6,+2,+3,-1,84%,92%,72%,175,216,117,26%,26%,29%,5,4,1,3,1,2
81,https://vlr.gg/player/7716/penny,2024-11-22 16:00:00,1.41,1.12,1.29,246,257,236,37,24,13,27,13,14,11,5,6,+4,-2,+6,75%,73%,78%,156,167,141,23%,27%,19%,9,3,6,5,5,0
82,https://vlr.gg/player/8742/jakee,2024-11-22 16:00:00,1.21,1.21,1.21,273,258,259,38,25,13,31,16,15,18,5,13,-1,0,-1,75%,85%,61%,175,170,182,37%,41%,31%,6,5,1,7,5,2
83,https://vlr.gg/player/69/thief,2024-11-22 16:00:00,1.08,1.30,1.17,189,191,227,37,20,17,25,14,11,5,3,2,-3,-1,-2,80%,85%,72%,131,117,151,27%,25%,29%,2,1,1,5,2,3
84,https://vlr.gg/player/733/stellar,2024-11-22 16:00:00,0.98,0.72,0.87,138,136,145,23,15,8,24,11,13,15,7,8,0,0,0,75%,81%,67%,93,93,93,19%,18%,21%,1,0,1,1,0,1
85,https://vlr.gg/player/2119/renz,2024-11-22 16:00:00,1.47,0.65,0.99,206,316,165,32,20,12,35,11,24,12,4,8,+3,+2,+1,59%,61%,58%,149,195,118,27%,29%,24%,7,4,3,4,2,2
86,https://vlr.gg/player/766/ange,2024-11-22 16:00:00,0.65,1.08,0.91,197,150,237,27,9,18,36,14,22,21,7,14,0,-3,+3,82%,78%,85%,135,102,159,21%,20%,21%,4,1,3,4,4,0
87,https://vlr.gg/player/6642/wildfire,2024-11-22 16:00:00,1.14,0.60,0.82,153,215,118,24,14,10,31,11,20,15,8,7,-2,-1,-1,66%,72%,62%,102,144,73,33%,47%,20%,0,0,0,2,1,1
88,https://vlr.gg/player/15639/chloric,2024-11-22 16:00:00,0.71,0.61,0.65,143,167,143,23,11,12,34,12,22,10,5,5,0,-1,+1,64%,67%,62%,104,113,98,24%,24%,24%,6,1,5,6,2,4
89,https://vlr.gg/player/12932/geeza,2024-11-22 16:00:00,0.99,0.35,0.61,170,211,140,24,14,10,37,13,24,8,4,4,-3,+1,-4,57%,83%,38%,106,138,85,29%,36%,24%,4,2,2,7,1,6
90,https://vlr.gg/player/6202/guuih,2024-11-22 15:00:00,1.15,1.20,1.17,195,205,184,29,17,12,26,16,10,11,6,5,+1,0,+1,79%,83%,72%,133,135,131,29%,37%,22%,1,0,1,0,0,0
91,https://vlr.gg/player/3424/siduzord,2024-11-22 15:00:00,1.00,0.94,0.97,175,174,191,25,14,11,29,16,13,13,6,7,+1,+1,0,69%,75%,61%,125,112,143,34%,48%,24%,2,2,0,1,1,0
92,https://vlr.gg/player/36433/phc,2024-11-22 15:00:00,0.72,1.04,0.86,159,112,226,24,9,15,31,18,13,19,12,7,+3,+1,+2,81%,75%,89%,114,83,154,25%,23%,27%,3,1,2,0,0,0
93,https://vlr.gg/player/1567/bezn1,2024-11-22 15:00:00,0.78,0.83,0.80,167,158,172,21,12,9,32,18,14,14,6,8,-1,-4,+3,60%,50%,72%,112,111,113,24%,24%,23%,4,1,3,5,5,0
94,https://vlr.gg/player/32675/kring,2024-11-22 15:00:00,0.62,0.85,0.72,192,182,195,25,13,12,33,21,12,10,5,5,-4,-6,+2,64%,63%,67%,115,114,117,17%,17%,15%,11,4,7,15,10,5
95,https://vlr.gg/player/11232/daiki,2024-11-22 15:00:00,0.99,1.61,1.34,261,191,308,37,12,25,24,12,12,18,6,12,+2,-1,+3,76%,61%,88%,166,128,195,33%,27%,37%,7,2,5,5,3,2
96,https://vlr.gg/player/12143/bizerra,2024-11-22 15:00:00,1.15,1.23,1.20,191,190,187,30,12,18,21,11,10,12,6,6,0,0,0,79%,72%,83%,136,133,139,33%,24%,42%,3,1,2,3,1,2
97,https://vlr.gg/player/14386/isaa,2024-11-22 15:00:00,1.40,0.87,1.10,202,250,160,30,16,14,21,9,12,10,3,7,-2,-2,0,71%,72%,71%,129,153,111,23%,22%,25%,3,1,2,5,3,2
98,https://vlr.gg/player/4807/bstrdd,2024-11-22 15:00:00,0.61,1.30,1.00,224,160,271,34,11,23,32,15,17,13,3,10,0,-5,+5,71%,56%,83%,140,96,173,25%,23%,26%,7,1,6,7,6,1
99,https://vlr.gg/player/15297/joojina,2024-11-22 15:00:00,0.94,0.81,0.86,136,155,119,20,11,9,26,12,14,19,4,15,0,0,0,74%,67%,79%,100,128,79,27%,41%,15%,1,0,1,1,0,1
100,https://vlr.gg/player/1581/guhrvn,2024-11-22 15:00:00,1.11,1.40,1.28,213,206,201,35,15,20,25,12,13,15,4,11,-4,-3,-1,72%,58%,81%,137,135,137,37%,32%,42%,1,0,1,5,3,2
101,https://vlr.gg/player/15361/swag,2024-11-22 15:00:00,0.80,1.48,1.20,243,180,252,34,10,24,28,14,14,14,6,8,+5,+1,+4,78%,79%,78%,159,130,179,22%,20%,24%,7,1,6,2,0,2
102,https://vlr.gg/player/13093/jzz,2024-11-22 15:00:00,1.28,1.15,1.20,214,259,191,38,18,20,29,14,15,9,6,3,+7,+5,+2,78%,79%,78%,149,176,131,47%,50%,44%,7,5,2,0,0,0
103,https://vlr.gg/player/8881/leozin,2024-11-22 15:00:00,1.32,0.96,1.11,203,230,196,32,15,17,31,13,18,30,16,14,-1,+1,-2,83%,89%,78%,133,139,129,28%,48%,18%,2,1,1,3,0,3
104,https://vlr.gg/player/3455/zanatsu,2024-11-22 15:00:00,1.03,1.06,1.05,249,235,248,38,16,22,36,14,22,17,6,11,+7,+1,+6,83%,89%,78%,159,154,163,31%,33%,30%,13,5,8,6,4,2
105,https://vlr.gg/player/32732/yeah,2024-11-22 15:00:00,1.01,1.33,1.14,244,267,281,45,26,19,36,23,13,7,3,4,-2,-3,+1,70%,63%,79%,166,175,153,33%,33%,33%,9,4,5,11,7,4
106,https://vlr.gg/player/41222/hide,2024-11-22 15:00:00,0.57,1.31,0.87,171,117,238,26,9,17,33,21,12,12,9,3,-4,-2,-2,65%,59%,74%,113,95,139,37%,37%,38%,1,1,0,5,3,2
107,https://vlr.gg/player/22912/pkx,2024-11-22 15:00:00,0.96,0.82,0.87,160,163,184,29,17,12,34,19,15,5,2,3,-2,+1,-3,59%,56%,63%,110,107,114,38%,35%,42%,2,2,0,4,1,3
108,https://vlr.gg/player/44448/insano,2024-11-22 15:00:00,0.67,0.76,0.71,199,167,215,31,17,14,41,23,18,11,7,4,-8,-7,-1,70%,67%,74%,120,101,147,45%,41%,50%,0,0,0,8,7,1
109,https://vlr.gg/player/28715/hunterx,2024-11-22 15:00:00,0.90,0.40,0.69,131,166,94,18,13,5,33,17,16,15,10,5,+2,+2,0,67%,74%,58%,94,111,70,18%,17%,21%,4,2,2,2,0,2
110,https://vlr.gg/player/7873/leaf,2024-11-22 12:10:00,1.00,1.14,1.07,230,223,238,26,12,14,28,14,14,9,3,6,-1,-3,+2,60%,53%,67%,157,161,155,19%,26%,15%,2,0,2,3,3,0
111,https://vlr.gg/player/3885/valyn,2024-11-22 12:10:00,1.37,0.34,0.84,194,296,102,24,19,5,29,14,15,5,1,4,-4,0,-4,60%,71%,50%,124,186,66,32%,38%,18%,1,0,1,5,0,5
112,https://vlr.gg/player/3993/jawgemo,2024-11-22 12:10:00,0.79,0.87,0.83,221,225,216,24,11,13,32,16,16,10,7,3,-2,-3,+1,57%,59%,56%,136,145,128,20%,20%,19%,5,3,2,7,6,1
113,https://vlr.gg/player/15500/trent,2024-11-22 12:10:00,0.74,0.86,0.80,173,168,180,19,9,10,28,13,15,10,4,6,+1,0,+1,54%,47%,61%,112,109,114,32%,21%,46%,2,0,2,1,0,1
114,https://vlr.gg/player/4581/jonahp,2024-11-22 12:10:00,0.39,0.65,0.51,126,94,155,12,4,8,30,15,15,19,12,7,-7,-5,-2,54%,53%,56%,84,69,98,19%,22%,17%,1,0,1,8,5,3
115,https://vlr.gg/player/1129/rossy,2024-11-22 12:10:00,1.65,1.82,1.73,280,242,325,38,16,22,16,8,8,12,9,3,+3,0,+3,89%,89%,88%,184,161,209,35%,32%,38%,3,0,3,0,0,0
116,https://vlr.gg/player/18796/oxy,2024-11-22 12:10:00,1.78,1.12,1.46,341,372,309,43,25,18,27,11,16,11,4,7,+9,+5,+4,83%,72%,94%,222,240,203,30%,30%,31%,13,7,6,4,2,2
117,https://vlr.gg/player/17433/v1c,2024-11-22 12:10:00,1.04,1.19,1.11,167,174,159,20,10,10,19,10,9,20,9,11,0,0,0,80%,83%,76%,108,117,99,21%,25%,17%,2,1,1,2,1,1
118,https://vlr.gg/player/7871/xeppaa,2024-11-22 12:10:00,1.10,0.99,1.05,198,222,175,27,15,12,22,11,11,18,13,5,+1,-1,+2,86%,89%,82%,122,126,118,28%,26%,30%,2,0,2,1,1,0
119,https://vlr.gg/player/7458/moose,2024-11-22 12:10:00,0.87,0.85,0.86,155,141,168,19,9,10,21,10,11,12,5,7,0,-2,+2,74%,67%,82%,105,105,105,21%,26%,16%,4,2,2,4,4,0
120,https://vlr.gg/player/27336/venka,2024-11-22 11:10:00,1.84,1.20,1.43,317,380,284,44,19,25,26,11,15,6,5,1,+9,+5,+4,76%,71%,79%,196,240,171,33%,42%,24%,12,7,5,3,2,1
121,https://vlr.gg/player/3627/hellff,2024-11-22 11:10:00,1.16,1.42,1.33,210,188,223,30,9,21,18,9,9,18,10,8,+1,-1,+2,79%,79%,79%,134,115,146,25%,22%,26%,3,0,3,2,1,1
122,https://vlr.gg/player/3639/hoax,2024-11-22 11:10:00,0.88,1.42,1.22,196,143,219,25,6,19,19,10,9,18,6,12,+1,0,+1,79%,71%,83%,130,107,144,27%,13%,36%,2,0,2,1,0,1
123,https://vlr.gg/player/27775/techno,2024-11-22 11:10:00,1.12,1.27,1.21,216,133,265,31,7,24,22,7,15,12,7,5,+5,0,+5,82%,79%,83%,136,80,169,30%,25%,31%,9,2,7,4,2,2
124,https://vlr.gg/player/26376/deecee,2024-11-22 11:10:00,0.97,1.24,1.14,181,156,193,24,8,16,19,8,11,14,4,10,0,0,0,76%,71%,79%,129,112,140,30%,42%,25%,1,0,1,1,0,1
125,https://vlr.gg/player/40912/123,2024-11-22 11:10:00,0.79,1.30,0.98,229,189,296,29,14,15,32,22,10,5,2,3,-4,-2,-2,66%,58%,79%,163,131,218,39%,47%,31%,0,0,0,4,2,2
126,https://vlr.gg/player/8156/mojo,2024-11-22 11:10:00,0.70,1.12,0.85,150,141,181,21,12,9,28,20,8,11,4,7,-2,-2,0,55%,50%,64%,99,96,106,26%,35%,17%,2,1,1,4,3,1
127,https://vlr.gg/player/19231/kibojn,2024-11-22 11:10:00,0.92,0.70,0.84,171,190,137,19,14,5,30,20,10,16,8,8,-1,+1,-2,61%,54%,71%,105,113,93,38%,38%,37%,2,2,0,3,1,2
128,https://vlr.gg/player/18702/deadly10,2024-11-22 11:10:00,0.83,0.62,0.75,187,204,156,24,16,8,31,21,10,3,2,1,-9,-8,-1,58%,54%,64%,112,119,100,28%,27%,29%,4,2,2,13,10,3
129,https://vlr.gg/player/48426/ghostxd,2024-11-22 11:10:00,0.11,0.58,0.28,96,53,173,11,3,8,33,22,11,4,4,0,0,-1,+1,34%,29%,43%,64,39,108,31%,25%,35%,3,1,2,3,2,1
130,https://vlr.gg/player/10137/ip0tt,2024-11-22 09:30:00,1.41,1.51,1.46,263,235,281,94,42,52,58,28,30,26,12,14,+2,-1,+3,70%,69%,70%,170,151,186,44%,43%,45%,8,3,5,6,4,2
131,https://vlr.gg/player/31855/celasun,2024-11-22 09:30:00,1.09,0.81,0.94,162,197,134,64,38,26,65,29,36,13,4,9,+1,-2,+3,70%,82%,59%,117,141,95,30%,35%,24%,4,0,4,3,2,1
132,https://vlr.gg/player/3557/skylen,2024-11-22 09:30:00,0.93,0.88,0.91,153,164,168,60,28,32,70,32,38,37,21,16,+3,+1,+2,65%,65%,65%,107,97,116,33%,34%,32%,9,4,5,6,3,3
133,https://vlr.gg/player/40935/umu7,2024-11-22 09:30:00,0.71,0.91,0.81,173,162,198,61,25,36,75,35,40,22,13,9,-2,-6,+4,62%,63%,61%,116,108,124,19%,18%,19%,20,8,12,22,14,8
134,https://vlr.gg/player/22676/ventt,2024-11-22 09:30:00,0.93,0.60,0.76,162,193,148,58,32,26,78,35,43,35,22,13,-11,-1,-10,66%,76%,57%,111,122,101,33%,29%,38%,7,5,2,18,6,12
135,https://vlr.gg/player/24344/loita,2024-11-22 09:30:00,1.44,1.08,1.27,239,269,201,89,52,37,62,31,31,42,27,15,+2,-2,+4,73%,76%,69%,155,171,138,36%,38%,34%,15,7,8,13,9,4
136,https://vlr.gg/player/40591/comeback,2024-11-22 09:30:00,1.02,0.95,0.98,250,234,230,81,44,37,77,39,38,14,6,8,+7,+2,+5,67%,67%,67%,149,147,150,24%,21%,28%,19,7,12,12,5,7
137,https://vlr.gg/player/31305/lar0k,2024-11-22 09:30:00,0.86,1.04,0.94,143,124,170,47,23,24,63,32,31,53,17,36,-4,-3,-1,74%,76%,71%,97,82,114,29%,29%,29%,3,0,3,7,3,4
138,https://vlr.gg/player/12795/crewen,2024-11-22 09:30:00,0.90,0.97,0.93,171,174,182,70,37,33,67,35,32,13,5,8,+2,+4,-2,71%,74%,67%,112,106,118,30%,36%,25%,9,8,1,7,4,3
139,https://vlr.gg/player/5565/ros,2024-11-22 09:30:00,0.93,0.90,0.92,182,188,177,59,31,28,68,35,33,25,12,13,0,-3,+3,73%,72%,73%,124,133,114,22%,22%,23%,9,4,5,9,7,2
140,https://vlr.gg/player/9554/kaajak,2024-11-22 09:20:00,0.84,1.54,1.08,212,177,277,28,14,14,28,20,8,7,4,3,-1,-3,+2,70%,63%,85%,137,109,188,56%,56%,57%,2,0,2,3,3,0
141,https://vlr.gg/player/9810/alfajer,2024-11-22 09:20:00,1.09,1.08,1.06,246,262,255,32,21,11,30,20,10,4,1,3,+5,+5,0,73%,63%,92%,172,167,181,31%,28%,36%,13,10,3,8,5,3
142,https://vlr.gg/player/458/chronicle,2024-11-22 09:20:00,0.82,0.71,0.78,181,192,153,22,17,5,31,21,10,4,0,4,-2,0,-2,62%,67%,54%,127,128,125,21%,27%,14%,1,1,0,3,1,2
143,https://vlr.gg/player/438/boaster,2024-11-22 09:20:00,0.69,0.42,0.59,120,141,106,16,10,6,32,20,12,15,10,5,-1,+2,-3,57%,54%,62%,96,100,89,24%,20%,29%,2,2,0,3,0,3
144,https://vlr.gg/player/33902/sayonara,2024-11-22 09:20:00,0.52,0.68,0.57,119,99,123,11,7,4,29,19,10,9,5,4,-2,-2,0,65%,63%,69%,78,74,87,29%,31%,26%,0,0,0,2,2,0
145,https://vlr.gg/player/7873/leaf,2024-11-22 09:20:00,1.26,1.80,1.61,306,212,325,42,10,32,19,8,11,8,4,4,+2,+1,+1,84%,85%,83%,167,143,180,17%,26%,15%,5,2,3,3,1,2
146,https://vlr.gg/player/3885/valyn,2024-11-22 09:20:00,1.38,1.30,1.32,243,282,225,32,12,20,22,9,13,17,9,8,-2,+2,-4,84%,85%,83%,159,155,161,31%,29%,33%,3,3,0,5,1,4
147,https://vlr.gg/player/3993/jawgemo,2024-11-22 09:20:00,1.03,1.01,1.02,238,179,272,33,10,23,26,8,18,5,1,4,-1,-1,0,68%,69%,67%,145,110,163,18%,13%,21%,7,1,6,8,2,6
148,https://vlr.gg/player/15500/trent,2024-11-22 09:20:00,0.97,1.05,1.02,144,178,142,21,8,13,18,7,11,6,2,4,0,-1,+1,76%,77%,75%,96,108,89,20%,15%,23%,1,0,1,1,1,0
149,https://vlr.gg/player/4581/jonahp,2024-11-22 09:20:00,1.23,0.66,0.86,180,215,152,22,10,12,24,8,16,20,8,12,+2,+2,0,84%,92%,79%,117,139,105,33%,27%,38%,3,2,1,1,0,1
150,https://vlr.gg/player/27244/seph1roth,2024-11-22 09:15:00,1.79,1.01,1.38,214,258,176,38,21,17,20,6,14,15,13,2,-1,+1,-2,80%,100%,63%,132,162,105,24%,28%,19%,3,2,1,4,1,3
151,https://vlr.gg/player/8582/laz,2024-11-22 09:15:00,1.29,1.02,1.14,210,226,196,34,18,16,29,12,17,14,6,8,-1,+1,-2,71%,90%,54%,135,150,122,38%,33%,46%,3,2,1,4,1,3
152,https://vlr.gg/player/24679/cgrs,2024-11-22 09:15:00,0.91,1.18,1.06,185,132,231,25,9,16,27,10,17,21,9,12,-1,-1,0,80%,86%,75%,126,94,154,22%,21%,23%,0,0,0,1,1,0
153,https://vlr.gg/player/13784/killua,2024-11-22 09:15:00,1.21,0.84,1.01,205,244,170,34,19,15,31,14,17,9,5,4,+2,+3,-1,69%,81%,58%,122,144,102,37%,42%,31%,6,4,2,4,1,3
154,https://vlr.gg/player/12098/kadoom,2024-11-22 09:15:00,0.96,0.65,0.79,195,249,151,29,18,11,36,17,19,5,3,2,-2,+3,-5,56%,71%,42%,126,156,100,25%,25%,25%,9,6,3,11,3,8
155,https://vlr.gg/player/9152/deryeon,2024-11-22 09:15:00,1.24,0.94,1.10,212,199,228,34,19,15,29,12,17,10,7,3,+2,0,+2,71%,71%,71%,147,156,136,29%,33%,26%,4,0,4,2,0,2
156,https://vlr.gg/player/1430/crazyguy,2024-11-22 09:15:00,1.07,1.09,1.08,222,173,281,35,15,20,31,15,16,6,4,2,+2,+2,0,71%,79%,62%,151,124,181,35%,38%,33%,3,2,1,1,0,1
157,https://vlr.gg/player/24653/vera,2024-11-22 09:15:00,1.00,0.56,0.79,185,228,135,28,19,9,36,19,17,7,4,3,-1,+3,-4,60%,67%,52%,128,163,88,21%,23%,18%,9,7,2,10,4,6
158,https://vlr.gg/player/24628/wayne,2024-11-22 09:15:00,1.00,0.53,0.78,156,202,103,23,16,7,33,15,18,14,5,9,-1,+2,-3,67%,67%,67%,100,133,63,27%,27%,25%,3,3,0,4,1,3
159,https://vlr.gg/player/11704/styron,2024-11-22 09:15:00,1.00,0.46,0.75,151,182,113,23,15,8,33,16,17,23,14,9,+1,+3,-2,73%,71%,76%,94,105,82,23%,17%,35%,5,5,0,4,2,2
160,https://vlr.gg/player/12947/rawfiul,2024-11-22 08:00:00,1.18,1.51,1.35,287,283,296,57,27,30,39,20,19,13,8,5,+3,0,+3,82%,78%,86%,191,194,189,38%,40%,36%,7,2,5,4,2,2
161,https://vlr.gg/player/3628/deathmaker,2024-11-22 08:00:00,1.23,1.06,1.14,224,243,202,44,23,21,34,16,18,14,7,7,-2,0,-2,73%,67%,79%,146,157,136,25%,23%,28%,5,3,2,7,3,4
162,https://vlr.gg/player/13221/azys,2024-11-22 08:00:00,1.22,0.81,1.01,249,294,210,50,29,21,44,19,25,9,5,4,-2,0,-2,71%,78%,66%,163,177,151,27%,33%,21%,11,7,4,13,7,6
163,https://vlr.gg/player/18704/levi,2024-11-22 08:00:00,1.10,0.88,0.99,168,192,143,34,19,15,34,15,19,28,11,17,-3,-1,-2,75%,78%,72%,108,120,96,29%,27%,31%,0,0,0,3,1,2
164,https://vlr.gg/player/3269/antidote,2024-11-22 08:00:00,0.75,0.82,0.79,160,122,194,32,13,19,37,17,20,11,6,5,-2,-2,0,73%,70%,76%,106,87,124,22%,20%,23%,2,0,2,4,2,2
165,https://vlr.gg/player/3502/ri0,2024-11-22 08:00:00,1.11,0.90,1.01,175,192,164,37,22,15,38,19,19,12,5,7,+4,+2,+2,61%,62%,59%,109,117,102,30%,40%,20%,9,5,4,5,3,2
166,https://vlr.gg/player/46121/marcai,2024-11-22 08:00:00,1.10,0.82,0.94,238,291,189,44,28,16,51,26,25,12,6,6,-1,0,-1,64%,72%,56%,155,179,129,35%,43%,25%,12,7,5,13,7,6
167,https://vlr.gg/player/1770/wat,2024-11-22 08:00:00,0.95,0.90,0.93,202,200,201,41,22,19,42,20,22,20,8,12,+1,+1,0,71%,76%,67%,131,126,136,43%,45%,41%,1,1,0,0,0,0
168,https://vlr.gg/player/46048/r0meo,2024-11-22 08:00:00,0.77,0.98,0.87,170,143,199,34,14,20,41,19,22,15,12,3,+2,+1,+1,71%,79%,63%,100,83,119,22%,25%,20%,7,3,4,5,2,3
169,https://vlr.gg/player/12323/rvk,2024-11-22 08:00:00,0.72,0.76,0.74,168,152,186,32,15,17,45,22,23,14,7,7,0,-1,+1,68%,69%,67%,119,120,118,30%,29%,31%,2,0,2,2,1,1
170,https://vlr.gg/player/16852/nakya,2024-11-22 06:00:00,0.91,1.67,1.28,259,199,329,63,26,37,40,23,17,5,3,2,-5,-4,-1,74%,72%,77%,168,136,202,35%,40%,32%,4,2,2,9,6,3
171,https://vlr.gg/player/7807/valdyn,2024-11-22 06:00:00,1.19,1.01,1.10,208,201,214,46,24,22,40,18,22,24,13,11,+1,0,+1,77%,75%,80%,132,128,136,22%,24%,20%,4,2,2,3,2,1
172,https://vlr.gg/player/11666/ray4c,2024-11-22 06:00:00,0.88,1.14,1.01,224,212,247,48,22,26,46,24,22,14,10,4,+3,0,+3,73%,66%,80%,140,129,152,15%,12%,18%,14,6,8,11,6,5
173,https://vlr.gg/player/2346/cud,2024-11-22 06:00:00,1.17,0.70,0.95,200,246,142,42,28,14,40,20,20,14,8,6,+2,+5,-3,74%,78%,70%,137,163,109,30%,33%,26%,7,6,1,5,1,4
174,https://vlr.gg/player/23710/gotten,2024-11-22 06:00:00,0.74,0.71,0.73,159,159,158,35,19,16,46,24,22,23,8,15,-3,+1,-4,73%,75%,70%,103,101,106,29%,31%,27%,1,1,0,4,0,4
175,https://vlr.gg/player/16842/mojer,2024-11-22 06:00:00,0.99,1.03,1.01,230,232,228,50,25,25,49,24,25,15,6,9,+2,+4,-2,74%,67%,81%,146,146,147,20%,23%,18%,10,8,2,8,4,4
176,https://vlr.gg/player/7754/xavi8k,2024-11-22 06:00:00,0.63,1.36,1.01,233,170,288,45,16,29,50,25,25,20,5,15,+4,0,+4,69%,63%,75%,157,116,195,21%,20%,22%,10,3,7,6,3,3
177,https://vlr.gg/player/7749/nexi,2024-11-22 06:00:00,0.98,1.03,1.01,208,199,217,43,20,23,47,22,25,18,4,14,-1,-1,0,71%,70%,72%,142,136,148,25%,23%,27%,5,2,3,6,3,3
178,https://vlr.gg/player/13220/ja,2024-11-22 06:00:00,1.18,0.83,1.00,167,212,138,37,22,15,43,21,22,14,6,8,+3,+3,0,65%,67%,63%,116,141,93,25%,27%,24%,5,3,2,2,0,2
179,https://vlr.gg/player/9747/emman,2024-11-22 06:00:00,0.87,0.92,0.90,155,171,139,37,20,17,45,23,22,20,8,12,-6,-2,-4,69%,60%,78%,101,110,92,34%,42%,27%,2,1,1,8,3,5
180,https://vlr.gg/player/4742/smoggy,2024-11-22 06:00:00,,,,309,,,69,,,45,,,25,,,,,,,,,,,,,,,,,,,,
181,https://vlr.gg/player/3520/zmjjkk,2024-11-22 06:00:00,,,,189,,,40,,,51,,,9,,,,,,,,,,,,,,,,,,,,
182,https://vlr.gg/player/15559/chichoo,2024-11-22 06:00:00,,,,182,,,40,,,44,,,13,,,,,,,,,,,,,,,,,,,,
183,https://vlr.gg/player/3017/nobody,2024-11-22 06:00:00,,,,164,,,36,,,44,,,13,,,,,,,,,,,,,,,,,,,,
184,https://vlr.gg/player/13768/s1mon,2024-11-22 06:00:00,,,,162,,,35,,,43,,,23,,,,,,,,,,,,,,,,,,,,
185,https://vlr.gg/player/13002/akame,2024-11-22 06:00:00,,,,256,,,56,,,44,,,22,,,,,,,,,,,,,,,,,,,,
186,https://vlr.gg/player/6672/meiy,2024-11-22 06:00:00,,,,243,,,54,,,43,,,6,,,,,,,,,,,,,,,,,,,,
187,https://vlr.gg/player/4052/jinboong,2024-11-22 06:00:00,,,,201,,,41,,,45,,,14,,,,,,,,,,,,,,,,,,,,
188,https://vlr.gg/player/21438/ssees,2024-11-22 06:00:00,,,,187,,,41,,,42,,,22,,,,,,,,,,,,,,,,,,,,
189,https://vlr.gg/player/10627/art,2024-11-22 06:00:00,,,,172,,,35,,,46,,,22,,,,,,,,,,,,,,,,,,,,
190,https://vlr.gg/player/1916/free1ng,2024-11-22 04:00:00,,,,267,,,38,,,24,,,6,,,,,,,,,,,,,,,,,,,,
191,https://vlr.gg/player/28400/hyunmin,2024-11-22 04:00:00,,,,236,,,31,,,25,,,11,,,,,,,,,,,,,,,,,,,,
192,https://vlr.gg/player/35013/flashback,2024-11-22 04:00:00,,,,208,,,30,,,18,,,11,,,,,,,,,,,,,,,,,,,,
193,https://vlr.gg/player/4462/mako,2024-11-22 04:00:00,,,,200,,,29,,,21,,,15,,,,,,,,,,,,,,,,,,,,
194,https://vlr.gg/player/34982/athan,2024-11-22 04:00:00,,,,199,,,27,,,23,,,20,,,,,,,,,,,,,,,,,,,,
195,https://vlr.gg/player/10698/nephh,2024-11-22 04:00:00,,,,204,,,24,,,33,,,18,,,,,,,,,,,,,,,,,,,,
196,https://vlr.gg/player/40845/levius,2024-11-22 04:00:00,,,,174,,,25,,,27,,,8,,,,,,,,,,,,,,,,,,,,
197,https://vlr.gg/player/4885/whzy,2024-11-22 04:00:00,,,,166,,,23,,,37,,,8,,,,,,,,,,,,,,,,,,,,
198,https://vlr.gg/player/48878/rushia,2024-11-22 04:00:00,,,,162,,,25,,,30,,,12,,,,,,,,,,,,,,,,,,,,
199,https://vlr.gg/player/4774/knight,2024-11-22 04:00:00,,,,110,,,14,,,28,,,6,,,,,,,,,,,,,,,,,,,,
200,https://vlr.gg/player/30470/kyu,2024-11-21 22:00:00,1.22,0.82,1.05,236,257,183,36,24,12,38,21,17,22,12,10,+3,+2,+1,71%,74%,67%,156,175,132,24%,24%,26%,7,5,2,4,3,1
201,https://vlr.gg/player/13084/smiley,2024-11-21 22:00:00,1.05,0.86,0.97,163,170,176,27,16,11,31,16,15,14,9,5,0,0,0,73%,78%,67%,112,110,114,37%,50%,27%,4,1,3,4,1,3
202,https://vlr.gg/player/24865/acrian,2024-11-21 22:00:00,1.06,0.70,0.90,161,198,137,29,19,10,32,18,14,7,6,1,-2,0,-2,69%,78%,57%,112,131,88,34%,29%,48%,1,1,0,3,1,2
203,https://vlr.gg/player/3227/screwface,2024-11-21 22:00:00,0.86,0.81,0.84,147,165,131,24,15,9,31,18,13,6,5,1,+5,+1,+4,56%,56%,57%,96,106,84,22%,27%,16%,7,3,4,2,2,0
204,https://vlr.gg/player/29076/satellite,2024-11-21 22:00:00,0.61,0.45,0.54,121,152,114,22,15,7,36,21,15,3,1,2,-6,-4,-2,60%,59%,62%,87,99,71,16%,18%,12%,5,3,2,11,7,4
205,https://vlr.gg/player/8376/seven,2024-11-21 22:00:00,1.48,1.01,1.21,184,211,194,34,16,18,25,7,18,16,5,11,+3,+2,+1,81%,90%,74%,133,130,134,26%,33%,22%,4,3,1,1,1,0
206,https://vlr.gg/player/1023/xxif,2024-11-21 22:00:00,0.97,1.29,1.15,181,130,215,32,10,22,22,9,13,5,1,4,0,-1,+1,69%,71%,67%,124,94,147,39%,47%,34%,2,1,1,2,2,0
207,https://vlr.gg/player/3007/tdawgg,2024-11-21 22:00:00,1.14,1.14,1.14,212,203,235,36,15,21,30,11,19,13,5,8,+1,+1,0,67%,71%,63%,141,130,149,20%,22%,19%,4,2,2,3,1,2
208,https://vlr.gg/player/3702/sym,2024-11-21 22:00:00,1.07,0.96,1.01,265,240,231,36,17,19,34,13,21,16,7,9,-2,-5,+3,65%,62%,67%,152,154,151,33%,36%,30%,8,1,7,10,6,4
209,https://vlr.gg/player/64/gmd,2024-11-21 22:00:00,1.38,0.68,0.99,169,223,150,30,16,14,27,9,18,11,5,6,-2,+2,-4,75%,81%,70%,115,139,96,25%,24%,27%,6,3,3,8,1,7
210,https://vlr.gg/player/8286/glyph,2024-11-21 19:30:00,1.47,1.60,1.53,288,286,292,49,23,26,31,17,14,20,11,9,-5,-4,-1,79%,71%,88%,189,201,176,25%,34%,17%,1,1,0,6,5,1
211,https://vlr.gg/player/6450/korsonix,2024-11-21 19:30:00,1.15,1.32,1.24,228,216,241,39,19,20,34,18,16,16,6,10,-1,0,-1,77%,75%,79%,145,138,153,42%,33%,53%,1,0,1,2,0,2
212,https://vlr.gg/player/8792/xhowi,2024-11-21 19:30:00,1.03,0.83,0.93,200,200,200,34,19,15,39,19,20,17,9,8,+5,+3,+2,73%,71%,75%,130,121,140,35%,41%,31%,8,3,5,3,0,3
213,https://vlr.gg/player/593/fresht,2024-11-21 19:30:00,0.61,0.86,0.74,204,203,206,33,15,18,41,23,18,12,7,5,0,+2,-2,75%,71%,79%,127,129,124,32%,32%,32%,11,7,4,11,5,6
214,https://vlr.gg/player/17694/prask,2024-11-21 19:30:00,0.35,1.00,0.67,147,107,187,24,8,16,35,22,13,13,11,2,-5,-3,-2,65%,58%,71%,103,75,131,14%,21%,11%,0,0,0,5,3,2
215,https://vlr.gg/player/10556/drakk,2024-11-21 19:30:00,0.93,1.61,1.27,281,219,345,49,18,31,37,20,17,13,6,7,+5,+5,0,77%,75%,79%,186,148,224,30%,21%,40%,14,9,5,9,4,5
216,https://vlr.gg/player/24026/generalsteak,2024-11-21 19:30:00,1.05,1.29,1.17,201,185,217,34,16,18,32,17,15,29,10,19,+2,0,+2,75%,71%,79%,131,132,129,36%,33%,38%,2,0,2,0,0,0
217,https://vlr.gg/player/2490/jfoen,2024-11-21 19:30:00,0.86,1.29,1.08,215,165,266,35,13,22,34,17,17,23,6,17,0,-2,+2,71%,58%,83%,145,119,171,22%,30%,16%,4,1,3,4,3,1
218,https://vlr.gg/player/41409/vandals,2024-11-21 19:30:00,1.05,0.81,0.93,205,234,177,36,22,14,39,20,19,13,5,8,+2,+1,+1,73%,67%,79%,137,147,127,38%,36%,39%,5,2,3,3,1,2
219,https://vlr.gg/player/8902/vapes,2024-11-21 19:30:00,0.42,0.84,0.63,148,141,156,26,12,14,37,21,16,7,3,4,-3,0,-3,63%,58%,67%,103,100,107,28%,24%,32%,2,2,0,5,2,3
220,https://vlr.gg/player/9017/moobs,2024-11-21 18:25:00,1.44,1.16,1.28,272,280,262,68,31,37,51,18,33,15,6,9,-2,-2,0,72%,73%,72%,173,190,160,44%,46%,42%,6,2,4,8,4,4
221,https://vlr.gg/player/765/jerk,2024-11-21 18:25:00,1.35,0.93,1.11,188,232,141,48,27,21,37,16,21,24,12,12,-1,0,-1,77%,83%,72%,116,134,102,30%,30%,30%,4,2,2,5,2,3
222,https://vlr.gg/player/17865/nahsie,2024-11-21 18:25:00,0.85,1.20,1.05,210,185,232,47,18,29,50,21,29,34,14,20,-2,-1,-1,71%,77%,67%,143,128,155,21%,23%,20%,4,1,3,6,2,4
223,https://vlr.gg/player/9837/flare,2024-11-21 18:25:00,1.14,0.94,1.03,208,209,194,50,22,28,50,21,29,30,17,13,+1,0,+1,72%,77%,69%,137,138,137,22%,21%,24%,5,3,2,4,3,1
224,https://vlr.gg/player/9063/infiltrator,2024-11-21 18:25:00,0.69,1.13,0.94,218,173,250,55,20,35,54,23,31,12,6,6,+2,0,+2,72%,70%,74%,138,109,161,28%,21%,32%,15,6,9,13,6,7
225,https://vlr.gg/player/30470/kyu,2024-11-21 18:25:00,1.26,0.86,1.09,206,227,181,51,33,18,50,26,24,27,17,10,+5,+3,+2,78%,85%,70%,134,146,118,23%,22%,24%,6,3,3,1,0,1
226,https://vlr.gg/player/29076/satellite,2024-11-21 18:25:00,1.08,0.82,0.97,237,266,190,53,35,18,57,33,24,20,15,5,+3,0,+3,71%,74%,67%,144,160,125,18%,18%,19%,16,7,9,13,7,6
227,https://vlr.gg/player/24865/acrian,2024-11-21 18:25:00,0.82,1.11,0.95,185,180,206,46,24,22,50,28,22,18,12,6,-1,0,-1,68%,72%,63%,127,121,135,23%,23%,24%,4,3,1,5,3,2
228,https://vlr.gg/player/3227/screwface,2024-11-21 18:25:00,0.86,0.80,0.83,186,210,185,45,28,17,56,31,25,21,12,9,-2,-2,0,72%,67%,80%,129,134,123,33%,29%,38%,5,4,1,7,6,1
229,https://vlr.gg/player/13084/smiley,2024-11-21 18:25:00,0.71,0.98,0.83,187,168,209,46,23,23,56,33,23,23,18,5,-3,-1,-2,70%,72%,67%,117,101,138,30%,36%,25%,4,2,2,7,3,4
230,https://vlr.gg/player/64/gmd,2024-11-21 18:25:00,1.29,1.74,1.50,282,236,330,61,27,34,34,17,17,23,13,10,+6,0,+6,84%,81%,89%,184,160,212,34%,36%,33%,7,1,6,1,1,0
231,https://vlr.gg/player/3702/sym,2024-11-21 18:25:00,1.09,1.32,1.20,305,284,330,64,33,31,48,26,22,9,4,5,+7,+3,+4,83%,84%,81%,189,170,212,28%,30%,26%,16,10,6,9,7,2
232,https://vlr.gg/player/1023/xxif,2024-11-21 18:25:00,0.95,1.24,1.09,162,135,200,35,15,20,29,15,14,20,8,12,0,-2,+2,76%,71%,81%,116,100,134,37%,47%,30%,3,1,2,3,3,0
233,https://vlr.gg/player/8376/seven,2024-11-21 18:25:00,1.33,0.77,1.07,222,242,179,43,26,17,40,17,23,29,13,16,+1,-1,+2,88%,90%,85%,133,151,113,17%,16%,18%,6,3,3,5,4,1
234,https://vlr.gg/player/3007/tdawgg,2024-11-21 18:25:00,0.93,0.71,0.83,150,155,147,32,19,13,36,17,19,17,8,9,-2,-1,-1,71%,71%,70%,109,100,118,28%,21%,37%,3,0,3,5,1,4
235,https://vlr.gg/player/39021/notexxd,2024-11-21 18:25:00,1.43,1.03,1.21,243,295,207,52,30,22,45,22,23,20,8,12,0,0,0,74%,81%,68%,156,186,130,32%,36%,27%,4,1,3,4,1,3
236,https://vlr.gg/player/27879/clewy,2024-11-21 18:25:00,0.89,0.91,0.91,191,214,184,42,21,21,48,23,25,10,6,4,0,-3,+3,62%,63%,61%,127,147,110,29%,37%,23%,6,1,5,6,4,2
237,https://vlr.gg/player/29074/sonofcar,2024-11-21 18:25:00,1.04,0.67,0.84,192,252,156,38,23,15,48,24,24,14,6,8,-4,-4,0,67%,70%,65%,127,151,107,20%,20%,21%,9,3,6,13,7,6
238,https://vlr.gg/player/5128/polkan,2024-11-21 18:25:00,0.47,0.96,0.73,152,119,188,31,10,21,48,24,24,17,9,8,-6,-4,-2,62%,59%,65%,106,88,121,42%,35%,46%,1,1,0,7,5,2
239,https://vlr.gg/player/2171/cavern,2024-11-21 18:25:00,0.57,0.64,0.61,137,135,142,24,11,13,46,22,24,14,5,9,-2,-2,0,57%,56%,58%,103,97,108,21%,17%,26%,3,1,2,5,3,2
240,https://vlr.gg/player/1607/ntk,2024-11-21 17:15:00,1.42,0.95,1.20,276,309,248,56,34,22,51,26,25,31,15,16,+1,-1,+2,78%,76%,80%,187,205,165,25%,26%,23%,9,2,7,8,3,5
241,https://vlr.gg/player/36106/skz,2024-11-21 17:15:00,1.21,1.13,1.17,229,259,194,56,32,24,46,28,18,16,13,3,0,+1,-1,72%,85%,57%,152,163,141,34%,40%,28%,4,2,2,4,1,3
242,https://vlr.gg/player/26214/cidzzz,2024-11-21 17:15:00,0.74,1.40,1.05,207,165,246,48,19,29,39,25,14,10,6,4,-6,-6,0,69%,50%,90%,125,104,148,24%,27%,21%,2,0,2,8,6,2
243,https://vlr.gg/player/32718/kenkayyy,2024-11-21 17:15:00,0.74,0.82,0.78,184,174,185,41,23,18,49,27,22,25,10,15,-4,-2,-2,72%,65%,80%,121,118,125,29%,37%,22%,1,1,0,5,3,2
244,https://vlr.gg/player/14944/ind1n,2024-11-21 17:15:00,0.47,1.02,0.72,160,126,192,36,15,21,49,28,21,18,8,10,-9,-10,+1,64%,65%,63%,103,83,125,19%,21%,18%,7,3,4,16,13,3
245,https://vlr.gg/player/37105/loss,2024-11-21 17:15:00,1.52,1.63,1.58,319,327,323,74,34,40,49,23,26,14,6,8,+15,+4,+11,77%,73%,79%,204,206,202,31%,28%,34%,22,9,13,7,5,2
246,https://vlr.gg/player/9266/tisora,2024-11-21 17:15:00,1.05,1.42,1.25,226,188,269,56,22,34,42,22,20,24,9,15,+1,0,+1,80%,80%,79%,150,120,177,26%,27%,26%,3,1,2,2,1,1
247,https://vlr.gg/player/2021/axeddy,2024-11-21 17:15:00,0.72,1.24,1.00,198,145,234,44,15,29,47,23,24,23,11,12,+2,-3,+5,69%,67%,71%,127,100,150,27%,18%,37%,7,1,6,5,4,1
248,https://vlr.gg/player/33121/stwz1,2024-11-21 17:15:00,0.81,0.64,0.72,138,173,121,31,17,14,47,22,25,19,11,8,+1,0,+1,66%,73%,59%,100,121,82,33%,30%,37%,3,2,1,2,2,0
249,https://vlr.gg/player/23001/zaninzs,2024-11-21 17:15:00,0.50,0.54,0.52,141,133,141,28,12,16,52,24,28,13,7,6,-1,-1,0,67%,67%,68%,96,93,99,30%,26%,35%,6,2,4,7,3,4
250,https://vlr.gg/player/7618/theory,2024-11-21 17:00:00,0.76,1.04,0.93,198,167,122,30,9,21,30,13,17,7,1,6,-1,0,-1,77%,53%,92%,94,108,85,54%,57%,52%,1,0,1,2,0,2
251,https://vlr.gg/player/35583/edu,2024-11-21 17:00:00,0.40,1.24,0.92,258,91,166,23,4,19,33,12,21,9,2,7,0,0,0,79%,53%,96%,104,77,120,49%,50%,48%,0,0,0,0,0,0
252,https://vlr.gg/player/8057/josegxbo,2024-11-21 17:00:00,0.87,0.89,0.88,136,165,87,24,9,15,30,11,19,12,3,9,0,-1,+1,74%,60%,83%,75,103,58,41%,43%,39%,2,0,2,2,1,1
253,https://vlr.gg/player/12955/danger,2024-11-21 17:00:00,0.75,0.73,0.73,112,155,75,26,9,17,32,11,21,7,1,6,-1,-1,0,72%,47%,88%,69,99,50,34%,39%,29%,1,0,1,2,1,1
254,https://vlr.gg/player/38921/fotzy,2024-11-21 17:00:00,0.57,0.65,0.62,147,143,89,19,7,12,35,12,23,5,2,3,-5,-3,-2,77%,60%,88%,80,100,67,30%,36%,24%,2,1,1,7,4,3
255,https://vlr.gg/player/7616/feniz,2024-11-21 17:00:00,1.13,1.36,1.21,284,129,262,43,12,31,22,8,14,15,3,12,0,0,0,90%,88%,93%,112,78,167,34%,50%,26%,1,1,0,1,1,0
256,https://vlr.gg/player/3983/virtyy,2024-11-21 17:00:00,0.84,1.64,1.15,232,120,289,32,10,22,28,12,16,9,3,6,+3,+2,+1,87%,88%,87%,125,90,181,22%,32%,18%,6,4,2,3,2,1
257,https://vlr.gg/player/17690/jow,2024-11-21 17:00:00,0.93,1.43,1.12,187,188,186,13,8,5,11,9,2,6,5,1,0,0,0,84%,75%,100%,123,114,137,31%,32%,31%,1,1,0,1,1,0
258,https://vlr.gg/player/8056/mited,2024-11-21 17:00:00,0.92,1.22,1.03,221,79,235,29,6,23,23,7,16,21,5,16,+1,0,+1,79%,83%,73%,95,68,137,16%,20%,13%,2,1,1,1,1,0
259,https://vlr.gg/player/10557/darker,2024-11-21 17:00:00,0.87,0.94,0.90,192,81,179,29,7,22,24,9,15,17,7,10,+2,0,+2,85%,83%,87%,85,50,142,29%,29%,29%,3,0,3,1,0,1
260,https://vlr.gg/player/29380/fadeout,2024-11-21 17:00:00,0.86,0.17,0.59,,,65,14,0,14,14,0,14,9,0,9,,,,80%,100%,50%,14,,34,0%,,0%,,,,,,
261,https://vlr.gg/player/1578/shion,2024-11-21 16:55:00,1.17,1.59,1.40,223,215,226,30,13,17,19,11,8,20,11,9,+1,0,+1,85%,89%,82%,140,130,149,31%,24%,38%,2,1,1,1,1,0
262,https://vlr.gg/player/2486/pollo,2024-11-21 16:55:00,1.16,1.29,1.23,200,226,180,28,14,14,19,12,7,7,3,4,-2,-2,0,73%,56%,86%,134,152,120,30%,26%,34%,1,0,1,3,2,1
263,https://vlr.gg/player/25858/sw,2024-11-21 16:55:00,1.04,1.36,1.22,213,186,238,33,12,21,22,11,11,9,5,4,+3,0,+3,68%,61%,73%,138,129,145,31%,46%,25%,5,2,3,2,2,0
264,https://vlr.gg/player/41224/tkzin,2024-11-21 16:55:00,1.16,1.03,1.09,231,212,253,32,14,18,28,12,16,8,5,3,-1,-2,+1,63%,72%,55%,155,146,162,29%,34%,25%,9,2,7,10,4,6
265,https://vlr.gg/player/5722/prince,2024-11-21 16:55:00,1.04,0.82,0.92,196,233,160,25,15,10,29,14,15,16,7,9,+3,+2,+1,73%,72%,73%,137,158,119,25%,31%,20%,5,3,2,2,1,1
266,https://vlr.gg/player/11236/antg,2024-11-21 16:55:00,0.84,1.52,1.15,250,186,328,37,16,21,30,15,15,13,3,10,0,-1,+1,73%,59%,89%,155,108,212,34%,32%,37%,3,1,2,3,2,1
267,https://vlr.gg/player/22997/waved,2024-11-21 16:55:00,0.83,1.30,1.04,226,191,277,33,15,18,30,18,12,2,1,1,-2,-3,+1,68%,64%,72%,143,112,182,34%,35%,32%,9,3,6,11,6,5
268,https://vlr.gg/player/9821/m4ndzin,2024-11-21 16:55:00,0.82,0.86,0.83,160,147,192,20,10,10,29,15,14,12,5,7,+2,+1,+1,75%,86%,61%,118,91,150,18%,14%,21%,2,1,1,0,0,0
269,https://vlr.gg/player/11242/blu,2024-11-21 16:55:00,0.61,0.55,0.58,120,132,100,16,10,6,31,17,14,8,6,2,-1,-2,+1,60%,68%,50%,79,77,81,31%,30%,32%,2,1,1,3,3,0
270,https://vlr.gg/player/27724/natasha,2024-11-21 16:55:00,0.52,0.49,0.51,88,89,86,11,6,5,28,15,13,9,4,5,-3,-1,-2,48%,45%,50%,58,56,61,27%,23%,35%,2,2,0,5,3,2
271,https://vlr.gg/player/458/chronicle,2024-11-21 16:15:00,2.05,0.81,1.68,334,389,205,22,18,4,11,7,4,2,1,1,0,0,0,82%,92%,60%,219,266,107,35%,38%,27%,3,2,1,3,2,1
272,https://vlr.gg/player/9810/alfajer,2024-11-21 16:15:00,1.42,2.26,1.67,331,292,425,20,12,8,10,7,3,6,5,1,+2,+2,0,76%,83%,60%,219,196,274,31%,28%,40%,3,3,0,1,1,0
273,https://vlr.gg/player/33902/sayonara,2024-11-21 16:15:00,1.81,1.07,1.60,247,289,146,16,14,2,6,4,2,4,3,1,+1,0,+1,76%,83%,60%,166,198,91,20%,18%,40%,1,0,1,0,0,0
274,https://vlr.gg/player/9554/kaajak,2024-11-21 16:15:00,1.26,1.34,1.28,222,211,251,14,10,4,9,6,3,3,2,1,+2,0,+2,71%,67%,80%,154,143,180,43%,40%,50%,2,0,2,0,0,0
275,https://vlr.gg/player/438/boaster,2024-11-21 16:15:00,0.55,0.41,0.51,54,74,10,4,4,0,9,6,3,3,1,2,-2,-2,0,59%,67%,40%,37,53,,57%,57%,,1,1,0,3,3,0
276,https://vlr.gg/player/2690/hoody,2024-11-21 16:15:00,1.81,0.59,0.95,243,438,162,14,8,6,16,4,12,6,2,4,+1,0,+1,59%,80%,50%,163,270,118,24%,29%,21%,1,0,1,0,0,0
277,https://vlr.gg/player/1457/mistic,2024-11-21 16:15:00,1.69,0.62,0.94,199,262,174,10,4,6,14,2,12,9,4,5,-2,0,-2,65%,60%,67%,132,180,112,34%,36%,33%,0,0,0,2,0,2
278,https://vlr.gg/player/2658/xuss,2024-11-21 16:15:00,0.54,0.89,0.79,205,158,225,12,3,9,16,4,12,0,0,0,+1,-1,+2,53%,60%,50%,127,76,148,21%,6%,33%,4,1,3,3,2,1
279,https://vlr.gg/player/5292/al0rante,2024-11-21 16:15:00,0.03,0.48,0.33,116,,166,6,0,6,15,4,11,2,0,2,+1,0,+1,47%,20%,58%,81,,114,42%,,42%,2,0,2,1,0,1
280,https://vlr.gg/player/4244/yaboilewis,2024-11-21 16:15:00,0.03,0.30,0.21,62,32,75,3,0,3,15,4,11,3,1,2,-4,-2,-2,47%,40%,50%,48,32,55,50%,33%,57%,0,0,0,4,2,2
281,https://vlr.gg/player/3702/sym,2024-11-21 16:00:00,0.94,1.45,1.17,290,259,342,45,21,24,39,22,17,9,5,4,+4,+1,+3,80%,75%,85%,189,172,209,33%,46%,24%,13,8,5,9,7,2
282,https://vlr.gg/player/1023/xxif,2024-11-21 16:00:00,1.30,0.68,1.02,208,262,144,30,22,8,32,16,16,11,3,8,+4,+2,+2,77%,83%,70%,150,181,114,31%,30%,35%,4,2,2,0,0,0
283,https://vlr.gg/player/64/gmd,2024-11-21 16:00:00,0.81,1.12,0.95,205,213,191,30,16,14,36,21,15,16,6,10,+1,+1,0,68%,63%,75%,137,142,132,29%,30%,29%,3,2,1,2,1,1
284,https://vlr.gg/player/3007/tdawgg,2024-11-21 16:00:00,0.72,0.99,0.85,166,118,216,26,11,15,31,16,15,11,3,8,-5,-1,-4,61%,50%,75%,109,87,136,36%,48%,30%,1,1,0,6,2,4
285,https://vlr.gg/player/8376/seven,2024-11-21 16:00:00,0.89,0.58,0.75,164,152,180,25,14,11,36,16,20,17,8,9,0,-1,+1,75%,83%,65%,109,94,128,28%,33%,23%,3,0,3,3,1,2
286,https://vlr.gg/player/765/jerk,2024-11-21 16:00:00,1.44,1.14,1.28,212,235,201,36,19,17,25,11,14,7,3,4,-2,-2,0,77%,80%,75%,144,156,135,29%,26%,32%,1,0,1,3,2,1
287,https://vlr.gg/player/9063/infiltrator,2024-11-21 16:00:00,1.13,1.09,1.11,254,267,232,39,19,20,33,16,17,12,5,7,-1,+1,-2,75%,85%,67%,151,177,129,21%,28%,16%,6,3,3,7,2,5
288,https://vlr.gg/player/17865/nahsie,2024-11-21 16:00:00,0.98,1.16,1.08,201,173,220,30,12,18,30,14,16,28,11,17,+3,-1,+4,73%,75%,71%,130,123,136,22%,20%,25%,5,1,4,2,2,0
289,https://vlr.gg/player/9017/moobs,2024-11-21 16:00:00,0.87,1.14,1.02,230,218,242,37,16,21,34,16,18,8,2,6,-2,+1,-3,64%,65%,63%,151,145,156,41%,43%,40%,4,3,1,6,2,4
290,https://vlr.gg/player/9837/flare,2024-11-21 16:00:00,1.06,0.86,0.95,194,210,187,32,17,15,34,15,19,13,6,7,-2,-1,-1,75%,90%,63%,139,153,126,39%,38%,39%,4,2,2,6,3,3
291,https://vlr.gg/player/30470/kyu,2024-11-21 16:00:00,1.33,1.75,1.50,235,219,278,37,20,17,19,12,7,20,9,11,+2,0,+2,80%,75%,88%,163,144,189,41%,49%,33%,2,0,2,0,0,0
292,https://vlr.gg/player/24865/acrian,2024-11-21 16:00:00,1.28,1.17,1.23,197,200,206,30,17,13,21,11,10,14,7,7,0,+1,-1,90%,96%,82%,133,134,131,21%,21%,21%,1,1,0,1,0,1
293,https://vlr.gg/player/29076/satellite,2024-11-21 16:00:00,1.02,1.52,1.22,288,260,318,41,22,19,29,18,11,10,3,7,+1,-2,+3,71%,67%,76%,185,172,204,19%,17%,21%,11,7,4,10,9,1
294,https://vlr.gg/player/13084/smiley,2024-11-21 16:00:00,0.97,1.53,1.20,203,156,257,30,13,17,22,14,8,20,13,7,+3,0,+3,83%,79%,88%,119,90,159,38%,44%,35%,6,2,4,3,2,1
295,https://vlr.gg/player/3227/screwface,2024-11-21 16:00:00,0.92,0.52,0.76,164,211,93,24,19,5,28,17,11,14,6,8,-3,-1,-2,68%,71%,65%,111,141,69,22%,22%,20%,2,1,1,5,2,3
296,https://vlr.gg/player/39021/notexxd,2024-11-21 16:00:00,1.28,1.00,1.12,220,262,216,34,16,18,33,13,20,17,7,10,+3,0,+3,71%,76%,67%,149,175,130,26%,33%,20%,5,1,4,2,1,1
297,https://vlr.gg/player/2171/cavern,2024-11-21 16:00:00,0.89,0.97,0.93,183,203,186,24,10,14,34,15,19,16,3,13,-2,-2,0,71%,71%,71%,139,145,134,21%,21%,21%,3,1,2,5,3,2
298,https://vlr.gg/player/29074/sonofcar,2024-11-21 16:00:00,0.66,0.82,0.75,168,179,161,22,10,12,34,17,17,13,4,9,-3,0,-3,59%,53%,63%,107,103,111,23%,22%,24%,6,4,2,9,4,5
299,https://vlr.gg/player/27879/clewy,2024-11-21 16:00:00,0.61,0.82,0.74,114,119,131,21,7,14,30,14,16,9,4,5,-2,-1,-1,59%,59%,58%,81,71,88,39%,43%,37%,2,0,2,4,1,3
300,https://vlr.gg/player/5128/polkan,2024-11-21 16:00:00,0.31,0.84,0.61,139,55,190,18,4,14,32,13,19,11,3,8,+1,-2,+3,66%,59%,71%,97,41,137,29%,27%,30%,3,0,3,2,2,0
301,https://vlr.gg/player/1139/qraxs,2024-11-21 15:15:00,1.78,1.21,1.59,274,318,186,20,16,4,10,7,3,6,2,4,+1,+1,0,78%,83%,67%,176,205,117,50%,50%,50%,2,2,0,1,1,0
302,https://vlr.gg/player/6510/atakaptan,2024-11-21 15:15:00,1.14,2.12,1.46,235,201,305,16,8,8,8,6,2,9,6,3,+2,0,+2,83%,83%,83%,167,156,190,30%,25%,45%,2,0,2,0,0,0
303,https://vlr.gg/player/12793/xeus,2024-11-21 15:15:00,1.06,1.78,1.30,297,258,376,19,11,8,13,9,4,2,2,0,-2,-3,+1,72%,67%,83%,179,164,209,43%,33%,62%,3,1,2,5,4,1
304,https://vlr.gg/player/8044/mrfalin,2024-11-21 15:15:00,1.02,0.50,0.85,121,149,69,5,4,1,10,6,4,11,7,4,+2,+2,0,72%,67%,83%,79,96,46,19%,25%,10%,2,2,0,0,0,0
305,https://vlr.gg/player/8369/yetujey,2024-11-21 15:15:00,0.99,0.52,0.84,149,143,162,11,7,4,11,6,5,3,3,0,+1,+2,-1,72%,75%,67%,93,83,114,35%,25%,57%,2,2,0,1,0,1
306,https://vlr.gg/player/16459/elite,2024-11-21 15:15:00,1.96,0.98,1.30,273,422,200,17,9,8,13,5,8,4,2,2,0,+2,-2,56%,83%,42%,187,253,155,59%,69%,53%,2,2,0,2,0,2
307,https://vlr.gg/player/10307/marteen,2024-11-21 15:15:00,0.03,1.49,0.98,207,46,288,14,0,14,15,6,9,3,2,1,0,-1,+1,72%,33%,92%,134,38,182,29%,0%,33%,2,0,2,2,1,1
308,https://vlr.gg/player/5654/avez,2024-11-21 15:15:00,0.76,0.67,0.70,155,192,137,8,4,4,15,5,10,10,2,8,+1,0,+1,67%,50%,75%,105,113,102,23%,21%,25%,1,0,1,0,0,0
309,https://vlr.gg/player/2858/suygetsu,2024-11-21 15:15:00,1.08,0.36,0.60,119,205,76,7,4,3,14,4,10,5,1,4,-2,0,-2,50%,67%,42%,70,117,46,32%,57%,17%,1,0,1,3,0,3
310,https://vlr.gg/player/727/saadhak,2024-11-21 15:15:00,0.03,0.84,0.56,129,55,166,6,1,5,14,5,9,6,0,6,-3,-3,0,50%,33%,58%,97,33,129,17%,14%,18%,1,0,1,4,3,1
311,https://vlr.gg/player/28716/lukxo,2024-11-21 15:00:00,1.51,2.52,1.65,311,277,518,30,23,7,14,12,2,10,8,2,+6,+4,+2,89%,88%,100%,186,167,297,33%,31%,36%,9,7,2,3,3,0
312,https://vlr.gg/player/5351/rglmeister,2024-11-21 15:00:00,1.76,0.29,1.55,184,215,,20,20,0,6,4,2,15,15,0,0,+1,-1,96%,100%,75%,125,146,,32%,32%,,1,1,0,1,0,1
313,https://vlr.gg/player/21659/sato,2024-11-21 15:00:00,1.57,1.21,1.52,274,302,109,31,28,3,13,12,1,3,2,1,+4,+4,0,89%,88%,100%,183,202,71,33%,35%,17%,6,6,0,2,2,0
314,https://vlr.gg/player/1566/prozin,2024-11-21 15:00:00,1.31,2.36,1.46,189,174,280,21,16,5,8,8,0,24,17,7,-1,-1,0,93%,92%,100%,120,114,155,33%,34%,27%,0,0,0,1,1,0
315,https://vlr.gg/player/6238/urango,2024-11-21 15:00:00,1.25,2.15,1.38,274,262,348,27,22,5,14,13,1,8,6,2,+1,0,+1,86%,83%,100%,184,173,248,38%,37%,40%,3,2,1,2,2,0
316,https://vlr.gg/player/2416/francez,2024-11-21 15:00:00,0.39,0.83,0.77,173,84,188,16,1,15,25,4,21,4,1,3,-2,0,-2,50%,50%,50%,125,77,133,35%,40%,35%,2,0,2,4,0,4
317,https://vlr.gg/player/28383/crocs,2024-11-21 15:00:00,0.83,0.54,0.58,174,264,159,16,4,12,27,4,23,4,0,4,+2,0,+2,57%,50%,58%,106,144,100,36%,33%,37%,6,1,5,4,1,3
318,https://vlr.gg/player/5244/sutecas,2024-11-21 15:00:00,0.48,0.56,0.55,129,87,136,10,1,9,26,4,22,9,1,8,-3,0,-3,68%,75%,67%,97,58,104,20%,0%,23%,0,0,0,3,0,3
319,https://vlr.gg/player/7605/closer,2024-11-21 15:00:00,0.08,0.56,0.48,96,14,110,7,0,7,25,4,21,3,0,3,-1,-1,0,39%,,46%,80,14,91,17%,0%,18%,1,0,1,2,1,1
320,https://vlr.gg/player/1650/bladez,2024-11-21 15:00:00,0.02,0.23,0.17,76,40,82,6,0,6,26,4,22,1,1,0,-6,-1,-5,32%,25%,33%,55,40,58,25%,0%,32%,0,0,0,6,1,5
321,https://vlr.gg/player/41445/saalped,2024-11-21 15:00:00,0.94,1.10,1.03,216,186,239,29,12,17,28,12,16,6,2,4,0,-1,+1,76%,72%,80%,135,114,154,35%,35%,34%,2,0,2,2,1,1
322,https://vlr.gg/player/23010/nicksz,2024-11-21 15:00:00,1.18,0.86,1.01,183,208,164,26,14,12,29,13,16,18,9,9,-1,-2,+1,71%,67%,75%,121,131,112,24%,17%,34%,2,0,2,3,2,1
323,https://vlr.gg/player/41851/jway,2024-11-21 15:00:00,0.73,1.06,0.90,199,159,231,26,11,15,29,14,15,8,2,6,-4,-2,-2,79%,67%,90%,128,112,143,42%,52%,36%,3,1,2,7,3,4
324,https://vlr.gg/player/2006/glym,2024-11-21 15:00:00,0.86,0.71,0.78,191,209,177,22,12,10,31,14,17,14,4,10,-3,-1,-2,68%,72%,65%,133,146,120,27%,30%,21%,0,0,0,3,1,2
325,https://vlr.gg/player/37024/czewick,2024-11-21 15:00:00,0.67,0.63,0.65,194,209,184,23,12,11,35,17,18,10,5,5,-2,0,-2,63%,67%,60%,127,134,121,24%,27%,22%,7,5,2,9,5,4
326,https://vlr.gg/player/37354/basic,2024-11-21 15:00:00,1.62,1.06,1.35,226,251,194,30,18,12,22,9,13,18,8,10,0,+1,-1,82%,80%,83%,137,154,117,21%,20%,21%,2,1,1,2,0,2
327,https://vlr.gg/player/37098/tiezzi,2024-11-21 15:00:00,1.01,1.60,1.29,283,224,357,41,19,22,28,15,13,9,3,6,+3,-2,+5,74%,70%,78%,191,140,249,38%,31%,43%,9,3,6,6,5,1
328,https://vlr.gg/player/46568/above,2024-11-21 15:00:00,1.49,0.71,1.12,227,296,147,31,21,10,27,14,13,23,12,11,+2,+3,-1,76%,80%,72%,142,190,88,30%,43%,14%,3,3,0,1,0,1
329,https://vlr.gg/player/1673/guiih9,2024-11-21 15:00:00,0.88,1.25,1.05,198,193,202,26,12,14,26,15,11,16,8,8,+3,+2,+1,74%,70%,78%,132,139,124,23%,26%,20%,7,4,3,4,2,2
330,https://vlr.gg/player/37091/peixeh,2024-11-21 15:00:00,0.75,1.07,0.90,175,152,200,24,12,12,24,13,11,5,1,4,+2,0,+2,76%,80%,72%,113,110,117,25%,34%,19%,3,1,2,1,1,0
331,https://vlr.gg/player/3993/jawgemo,2024-11-21 15:00:00,1.13,1.51,1.32,251,247,257,22,10,12,16,10,6,3,1,2,+2,+2,0,79%,58%,100%,161,150,173,11%,12%,11%,5,4,1,3,2,1
332,https://vlr.gg/player/4581/jonahp,2024-11-21 15:00:00,0.99,1.19,1.09,205,180,231,20,9,11,17,9,8,5,0,5,-2,-1,-1,79%,58%,100%,145,136,155,31%,38%,27%,1,0,1,3,1,2
333,https://vlr.gg/player/7873/leaf,2024-11-21 15:00:00,0.74,1.13,0.94,209,185,234,17,7,10,20,11,9,5,2,3,+1,0,+1,63%,58%,67%,141,144,138,29%,28%,31%,3,1,2,2,1,1
334,https://vlr.gg/player/15500/trent,2024-11-21 15:00:00,0.41,1.38,0.90,177,80,275,11,1,10,19,10,9,12,6,6,0,0,0,63%,50%,75%,121,66,177,30%,15%,43%,2,1,1,2,1,1
335,https://vlr.gg/player/3885/valyn,2024-11-21 15:00:00,0.80,0.92,0.86,123,123,123,11,6,5,15,9,6,11,6,5,-1,-1,0,71%,58%,83%,92,96,88,29%,25%,32%,1,0,1,2,1,1
336,https://vlr.gg/player/29833/izu,2024-11-21 15:00:00,1.25,1.55,1.40,280,267,294,25,11,14,16,9,7,7,2,5,+2,+2,0,79%,75%,83%,178,173,183,34%,33%,34%,3,2,1,1,0,1
337,https://vlr.gg/player/13039/meteor,2024-11-21 15:00:00,0.71,1.46,1.08,255,184,327,21,8,13,17,10,7,6,3,3,0,-1,+1,79%,58%,100%,173,141,204,38%,39%,38%,4,2,2,4,3,1
338,https://vlr.gg/player/485/stax,2024-11-21 15:00:00,0.81,1.36,1.08,185,164,208,15,6,9,15,9,6,17,6,11,0,0,0,88%,83%,92%,124,116,131,26%,17%,38%,2,1,1,2,1,1
339,https://vlr.gg/player/4056/sylvan,2024-11-21 15:00:00,1.03,1.11,1.07,191,215,168,15,9,6,16,10,6,16,7,9,+1,0,+1,79%,83%,75%,120,125,116,33%,37%,30%,1,0,1,0,0,0
340,https://vlr.gg/player/804/buzz,2024-11-21 15:00:00,0.25,0.87,0.56,139,110,169,11,4,7,17,10,7,3,2,1,-3,-1,-2,63%,50%,75%,95,69,121,21%,24%,18%,2,1,1,5,2,3
341,https://vlr.gg/player/10971/riens,2024-11-21 13:10:00,0.66,1.21,0.94,169,53,287,18,2,16,17,5,12,3,1,2,0,-1,+1,79%,75%,83%,102,33,171,24%,0%,33%,2,1,1,2,2,0
342,https://vlr.gg/player/18350/miniboo,2024-11-21 13:10:00,1.14,0.53,0.83,179,181,177,22,9,13,21,4,17,6,0,6,-3,0,-3,79%,92%,67%,111,95,128,37%,45%,29%,2,1,1,5,1,4
343,https://vlr.gg/player/29873/benjyfishy,2024-11-21 13:10:00,0.96,0.66,0.81,110,72,149,12,3,9,19,4,15,12,4,8,0,0,0,79%,92%,67%,62,43,81,47%,75%,38%,1,0,1,1,0,1
344,https://vlr.gg/player/2038/weber,2024-11-21 13:10:00,0.69,0.64,0.67,75,68,83,7,3,4,16,4,12,9,0,9,-2,-1,-1,79%,92%,67%,52,45,58,22%,11%,33%,0,0,0,2,1,1
345,https://vlr.gg/player/1144/boo,2024-11-21 13:10:00,1.00,0.24,0.62,98,132,66,11,5,6,18,5,13,5,2,3,0,+1,-1,71%,92%,50%,73,100,46,31%,35%,22%,2,1,1,2,0,2
346,https://vlr.gg/player/17433/v1c,2024-11-21 13:10:00,1.91,0.72,1.32,173,269,78,18,12,6,11,3,8,13,7,6,+1,+1,0,92%,100%,83%,110,160,60,32%,30%,38%,1,1,0,0,0,0
347,https://vlr.gg/player/1129/rossy,2024-11-21 13:10:00,1.33,0.93,1.13,181,238,126,20,9,11,13,6,7,5,3,2,+3,+2,+1,83%,83%,83%,124,163,84,35%,47%,24%,4,3,1,1,1,0
348,https://vlr.gg/player/7871/xeppaa,2024-11-21 13:10:00,1.07,0.94,1.01,135,178,93,18,7,11,15,8,7,15,8,7,0,+1,-1,79%,75%,83%,91,126,57,32%,37%,22%,1,1,0,1,0,1
349,https://vlr.gg/player/18796/oxy,2024-11-21 13:10:00,0.70,1.17,0.94,167,185,151,17,8,9,18,9,9,5,3,2,+3,+1,+2,83%,83%,83%,109,115,103,24%,35%,16%,5,3,2,2,2,0
350,https://vlr.gg/player/7458/moose,2024-11-21 13:10:00,1.33,0.46,0.90,91,175,8,14,10,4,13,4,9,10,6,4,-2,0,-2,75%,83%,67%,61,113,8,32%,29%,50%,0,0,0,2,0,2
351,https://vlr.gg/player/46051/yuvi,2024-11-21 11:45:00,1.23,1.39,1.34,291,288,292,37,12,25,28,10,18,6,3,3,+3,-2,+5,71%,82%,67%,180,166,187,26%,32%,23%,7,0,7,4,2,2
352,https://vlr.gg/player/3271/excali,2024-11-21 11:45:00,0.91,0.77,0.81,184,175,188,21,6,15,30,9,21,16,8,8,-1,-2,+1,71%,91%,63%,120,110,124,37%,29%,40%,3,1,2,4,3,1
353,https://vlr.gg/player/3268/vibhorr,2024-11-21 11:45:00,1.27,0.60,0.81,211,304,171,22,11,11,30,9,21,10,5,5,+1,0,+1,63%,73%,58%,139,182,119,17%,14%,20%,1,0,1,0,0,0
354,https://vlr.gg/player/7485/ezzy,2024-11-21 11:45:00,0.74,0.70,0.72,161,173,155,19,7,12,28,9,19,8,4,4,-1,+1,-2,57%,64%,54%,104,109,101,29%,44%,23%,2,2,0,3,1,2
355,https://vlr.gg/player/5536/whimp,2024-11-21 11:45:00,0.19,0.96,0.69,142,40,189,16,0,16,30,9,21,16,5,11,-3,-2,-1,71%,64%,75%,93,31,122,29%,0%,37%,4,0,4,7,2,5
356,https://vlr.gg/player/27755/icarus,2024-11-21 11:45:00,1.76,1.30,1.62,290,323,216,38,29,9,18,13,5,3,3,0,+2,+1,+1,86%,88%,82%,199,223,145,34%,38%,25%,3,1,2,1,0,1
357,https://vlr.gg/player/40060/rage,2024-11-21 11:45:00,1.03,1.28,1.11,165,155,188,25,16,9,18,12,6,4,2,2,-2,-3,+1,77%,75%,82%,116,111,128,25%,31%,20%,1,0,1,3,3,0
358,https://vlr.gg/player/43403/silon,2024-11-21 11:45:00,1.30,0.66,1.10,230,276,130,29,25,4,25,16,9,15,5,10,+1,0,+1,77%,75%,82%,147,179,78,31%,33%,26%,6,5,1,5,5,0
359,https://vlr.gg/player/43389/yash,2024-11-21 11:45:00,0.73,1.49,0.97,229,199,300,29,17,12,28,20,8,7,4,3,+1,+1,0,80%,75%,91%,152,138,184,24%,21%,28%,5,3,2,4,2,2
360,https://vlr.gg/player/49570/rinsat,2024-11-21 11:45:00,0.72,1.30,0.90,209,159,314,25,13,12,26,18,8,13,10,3,-1,-3,+2,74%,71%,82%,140,108,208,46%,59%,34%,3,1,2,4,4,0
361,https://vlr.gg/player/6510/atakaptan,2024-11-21 11:40:00,0.98,1.75,1.44,265,177,324,19,5,14,13,7,6,14,3,11,0,-1,+1,85%,75%,92%,162,108,199,54%,29%,71%,2,0,2,2,1,1
362,https://vlr.gg/player/1139/qraxs,2024-11-21 11:40:00,0.82,1.13,1.01,213,203,220,14,5,9,16,8,8,6,1,5,+1,+1,0,75%,63%,83%,120,123,119,16%,16%,15%,1,1,0,0,0,0
363,https://vlr.gg/player/8044/mrfalin,2024-11-21 11:40:00,0.12,1.13,0.72,184,88,248,12,1,11,15,8,7,3,1,2,-1,-1,0,70%,38%,92%,126,90,150,18%,10%,25%,1,0,1,2,1,1
364,https://vlr.gg/player/8369/yetujey,2024-11-21 11:40:00,0.31,0.92,0.67,123,100,139,9,3,6,13,8,5,3,0,3,0,0,0,60%,38%,75%,80,49,100,29%,67%,24%,2,1,1,2,1,1
365,https://vlr.gg/player/12793/xeus,2024-11-21 11:40:00,0.04,0.94,0.57,170,71,236,11,1,10,16,8,8,3,1,2,-4,-3,-1,65%,38%,83%,122,56,166,34%,38%,33%,2,0,2,6,3,3
366,https://vlr.gg/player/13039/meteor,2024-11-21 11:40:00,1.66,1.94,1.77,311,322,296,24,14,10,11,9,2,5,3,2,+1,+1,0,85%,75%,100%,204,200,210,32%,35%,29%,2,2,0,1,1,0
367,https://vlr.gg/player/485/stax,2024-11-21 11:40:00,0.63,1.75,1.08,185,130,269,13,5,8,12,10,2,10,4,6,+1,+1,0,75%,67%,88%,126,95,172,25%,29%,22%,1,1,0,0,0,0
368,https://vlr.gg/player/29833/izu,2024-11-21 11:40:00,0.64,1.33,0.91,164,111,246,11,5,6,15,10,5,7,3,4,+2,0,+2,80%,67%,100%,115,87,157,15%,45%,7%,3,1,2,1,1,0
369,https://vlr.gg/player/804/buzz,2024-11-21 11:40:00,0.20,1.91,0.88,185,96,320,14,4,10,13,11,2,2,1,1,+2,-1,+3,65%,50%,88%,110,56,192,8%,0%,14%,6,2,4,4,3,1
370,https://vlr.gg/player/4056/sylvan,2024-11-21 11:40:00,0.73,0.81,0.76,146,166,118,11,6,5,14,10,4,7,3,4,-2,-1,-1,70%,58%,88%,108,122,86,32%,22%,80%,0,0,0,2,1,1
371,https://vlr.gg/player/3993/jawgemo,2024-11-21 10:40:00,2.37,1.81,2.03,347,436,289,27,12,15,7,3,4,3,2,1,+3,+3,0,85%,75%,92%,240,282,213,34%,29%,38%,3,3,0,0,0,0
372,https://vlr.gg/player/15500/trent,2024-11-21 10:40:00,1.43,2.02,1.79,308,233,359,24,7,17,11,4,7,4,2,2,+4,0,+4,90%,88%,92%,197,151,228,33%,26%,38%,5,1,4,1,1,0
373,https://vlr.gg/player/3885/valyn,2024-11-21 10:40:00,1.21,0.62,0.86,152,191,126,11,6,5,12,4,8,9,5,4,-3,-1,-2,80%,88%,75%,105,139,83,23%,22%,25%,1,0,1,4,1,3
374,https://vlr.gg/player/4581/jonahp,2024-11-21 10:40:00,1.12,0.64,0.84,96,123,79,7,4,3,10,3,7,13,5,8,0,0,0,90%,88%,92%,67,92,51,14%,25%,6%,0,0,0,0,0,0
375,https://vlr.gg/player/7873/leaf,2024-11-21 10:40:00,0.91,0.70,0.78,208,249,181,14,8,6,15,6,9,8,1,7,-2,0,-2,65%,63%,67%,123,124,123,11%,14%,8%,2,1,1,4,1,3
376,https://vlr.gg/player/2858/suygetsu,2024-11-21 10:40:00,1.00,0.84,0.94,178,157,211,12,7,5,16,8,8,3,2,1,+1,0,+1,65%,75%,50%,112,103,125,35%,25%,55%,1,0,1,0,0,0
377,https://vlr.gg/player/16459/elite,2024-11-21 10:40:00,1.09,0.65,0.91,198,223,160,13,9,4,16,9,7,2,1,1,0,0,0,55%,67%,38%,123,133,108,43%,64%,25%,2,1,1,2,1,1
378,https://vlr.gg/player/10307/marteen,2024-11-21 10:40:00,0.71,1.03,0.84,205,198,216,14,8,6,16,10,6,2,1,1,-1,+1,-2,45%,50%,38%,139,140,136,30%,30%,31%,5,4,1,6,3,3
379,https://vlr.gg/player/5654/avez,2024-11-21 10:40:00,0.91,0.38,0.70,168,190,137,11,8,3,18,10,8,5,1,4,0,+1,-1,80%,83%,75%,113,125,95,31%,33%,27%,1,1,0,1,0,1
380,https://vlr.gg/player/727/saadhak,2024-11-21 10:40:00,0.44,0.18,0.34,93,89,101,5,3,2,17,9,8,3,1,2,-2,-2,0,50%,50%,50%,84,85,81,27%,55%,7%,0,0,0,2,2,0
381,https://vlr.gg/player/31305/lar0k,2024-11-21 09:30:00,1.51,0.99,1.28,224,266,159,48,32,16,35,18,17,23,15,8,0,+4,-4,74%,82%,63%,148,181,107,39%,39%,38%,7,5,2,7,1,6
382,https://vlr.gg/player/12795/crewen,2024-11-21 09:30:00,1.43,1.05,1.26,194,210,179,46,28,18,31,14,17,14,8,6,+2,+1,+1,70%,74%,67%,131,139,122,31%,29%,33%,4,2,2,2,1,1
383,https://vlr.gg/player/40591/comeback,2024-11-21 09:30:00,1.10,1.14,1.12,262,255,262,57,31,26,45,24,21,10,6,4,+8,+4,+4,77%,71%,85%,167,165,169,22%,23%,20%,16,8,8,8,4,4
384,https://vlr.gg/player/5565/ros,2024-11-21 09:30:00,1.00,1.05,1.02,187,159,220,41,20,21,39,20,19,10,6,4,-2,0,-2,69%,71%,67%,125,112,140,22%,26%,19%,1,1,0,3,1,2
385,https://vlr.gg/player/24344/loita,2024-11-21 09:30:00,0.81,1.29,1.02,190,151,229,40,18,22,38,21,17,26,13,13,-5,-7,+2,75%,74%,78%,124,100,155,41%,38%,44%,4,2,2,9,9,0
386,https://vlr.gg/player/12774/anima,2024-11-21 09:30:00,1.16,0.83,0.97,192,230,173,37,20,17,44,19,25,29,12,17,-1,-1,0,66%,67%,65%,128,149,111,16%,15%,18%,5,1,4,6,2,4
387,https://vlr.gg/player/10160/izzy,2024-11-21 09:30:00,0.84,0.92,0.89,187,204,186,42,21,21,47,22,25,5,2,3,0,0,0,56%,59%,53%,127,127,126,24%,21%,26%,10,5,5,10,5,5
388,https://vlr.gg/player/10161/qutionerx,2024-11-21 09:30:00,0.75,0.90,0.84,185,195,187,39,18,21,49,23,26,9,5,4,-6,-2,-4,64%,74%,56%,129,127,130,25%,25%,24%,5,4,1,11,6,5
389,https://vlr.gg/player/8041/brave,2024-11-21 09:30:00,0.79,0.81,0.80,181,162,185,37,16,21,48,20,28,14,7,7,+3,+1,+2,74%,74%,74%,107,96,115,33%,39%,30%,6,2,4,3,1,2
390,https://vlr.gg/player/10163/cyderx,2024-11-21 09:30:00,0.77,0.70,0.73,135,146,134,33,16,17,44,19,25,12,5,7,+1,+1,0,61%,74%,50%,90,90,90,26%,28%,25%,3,1,2,2,0,2
391,https://vlr.gg/player/33902/sayonara,2024-11-21 09:20:00,1.11,1.36,1.24,241,190,293,21,9,12,17,6,11,8,4,4,+2,+1,+1,88%,92%,83%,162,119,206,31%,39%,27%,3,1,2,1,0,1
392,https://vlr.gg/player/9810/alfajer,2024-11-21 09:20:00,1.47,0.85,1.16,251,324,178,21,14,7,19,9,10,5,2,3,+8,+6,+2,79%,92%,67%,169,229,109,38%,34%,44%,9,6,3,1,0,1
393,https://vlr.gg/player/458/chronicle,2024-11-21 09:20:00,1.20,0.55,0.88,194,218,171,17,10,7,19,8,11,3,2,1,0,+1,-1,71%,83%,58%,148,167,129,21%,23%,19%,1,1,0,1,0,1
394,https://vlr.gg/player/438/boaster,2024-11-21 09:20:00,1.02,0.53,0.78,126,124,130,11,6,5,15,5,10,6,4,2,-1,0,-1,75%,92%,58%,76,72,81,32%,33%,31%,1,1,0,2,1,1
395,https://vlr.gg/player/9554/kaajak,2024-11-21 09:20:00,0.84,0.35,0.60,168,221,116,14,10,4,20,9,11,3,1,2,+1,+2,-1,67%,83%,50%,111,152,71,41%,40%,44%,3,2,1,2,0,2
396,https://vlr.gg/player/1129/rossy,2024-11-21 09:20:00,1.15,1.93,1.54,256,158,354,22,7,15,12,5,7,5,3,2,-1,-1,0,88%,75%,100%,163,112,214,43%,29%,57%,0,0,0,1,1,0
397,https://vlr.gg/player/17433/v1c,2024-11-21 09:20:00,1.87,0.86,1.36,254,338,171,22,15,7,15,5,10,8,4,4,+1,+2,-1,75%,83%,67%,174,211,136,24%,22%,29%,3,2,1,2,0,2
398,https://vlr.gg/player/18796/oxy,2024-11-21 09:20:00,1.38,0.52,0.95,249,348,152,22,16,6,20,9,11,3,1,2,-4,0,-4,71%,75%,67%,165,221,109,44%,46%,41%,3,3,0,7,3,4
399,https://vlr.gg/player/7458/moose,2024-11-21 09:20:00,1.29,0.38,0.83,144,215,73,13,10,3,16,6,10,8,4,4,-2,-1,-1,63%,75%,50%,83,128,39,34%,32%,40%,0,0,0,2,1,1
400,https://vlr.gg/player/7871/xeppaa,2024-11-21 09:20:00,0.46,0.47,0.46,149,130,169,11,5,6,22,11,11,11,7,4,-4,0,-4,58%,58%,58%,106,91,121,31%,32%,30%,1,1,0,5,1,4
401,https://vlr.gg/player/7754/xavi8k,2024-11-21 08:15:00,0.97,2.15,1.71,325,226,350,44,11,33,22,13,9,18,5,13,+4,0,+4,83%,67%,92%,213,155,248,16%,18%,15%,6,1,5,2,1,1
402,https://vlr.gg/player/9747/emman,2024-11-21 08:15:00,1.04,1.36,1.24,186,180,220,29,10,19,22,10,12,21,4,17,+2,-1,+3,83%,60%,96%,133,119,142,42%,43%,41%,3,0,3,1,1,0
403,https://vlr.gg/player/13220/ja,2024-11-21 08:15:00,1.76,0.77,1.14,218,332,159,31,18,13,26,10,16,12,3,9,+6,+1,+5,85%,87%,84%,156,224,115,34%,39%,29%,7,1,6,1,0,1
404,https://vlr.gg/player/7749/nexi,2024-11-21 08:15:00,0.58,1.31,1.04,216,138,248,29,8,21,27,13,14,14,2,12,+3,0,+3,78%,60%,88%,141,88,173,29%,42%,25%,6,2,4,3,2,1
405,https://vlr.gg/player/16842/mojer,2024-11-21 08:15:00,0.23,1.40,0.96,241,109,279,35,5,30,29,15,14,6,4,2,+1,-1,+2,73%,60%,80%,124,71,156,21%,17%,22%,6,3,3,5,4,1
406,https://vlr.gg/player/7746/kevzii,2024-11-21 08:15:00,0.79,1.46,1.04,227,195,312,31,15,16,34,22,12,6,2,4,+2,-1,+3,75%,64%,93%,162,127,221,26%,24%,28%,3,0,3,1,1,0
407,https://vlr.gg/player/9737/kakarot,2024-11-21 08:15:00,0.58,1.37,0.88,176,144,250,24,10,14,33,24,9,16,9,7,-2,-1,-1,73%,64%,87%,128,103,169,20%,19%,21%,0,0,0,2,1,1
408,https://vlr.gg/player/13744/patmen,2024-11-21 08:15:00,0.70,0.99,0.81,163,182,175,25,15,10,32,23,9,5,3,2,-12,-10,-2,65%,64%,67%,119,117,122,26%,28%,23%,5,3,2,17,13,4
409,https://vlr.gg/player/21677/jeee,2024-11-21 08:15:00,0.85,0.66,0.78,184,185,147,24,16,8,33,23,10,14,9,5,0,0,0,65%,64%,67%,100,103,94,29%,27%,32%,1,1,0,1,1,0
410,https://vlr.gg/player/16953/zynd,2024-11-21 08:15:00,0.24,1.06,0.54,136,98,254,22,9,13,36,24,12,5,0,5,-4,-5,+1,60%,40%,93%,104,67,166,33%,42%,29%,3,0,3,7,5,2
411,https://vlr.gg/player/18350/miniboo,2024-11-21 08:15:00,1.00,1.42,1.21,239,230,250,20,10,10,16,10,6,3,0,3,0,-1,+1,63%,50%,75%,155,146,164,35%,41%,30%,4,2,2,4,3,1
412,https://vlr.gg/player/29873/benjyfishy,2024-11-21 08:15:00,0.93,1.32,1.13,198,181,215,16,7,9,15,10,5,10,7,3,+3,+2,+1,71%,58%,83%,120,97,144,24%,19%,28%,4,2,2,1,0,1
413,https://vlr.gg/player/10971/riens,2024-11-21 08:15:00,0.39,1.62,1.01,190,84,297,17,3,14,16,10,6,5,3,2,-3,-4,+1,67%,58%,75%,122,60,184,30%,14%,38%,2,0,2,5,4,1
414,https://vlr.gg/player/21328/wo0t,2024-11-21 08:15:00,0.89,1.13,1.01,177,174,181,15,7,8,17,9,8,8,2,6,+2,0,+2,71%,67%,75%,123,121,125,34%,29%,41%,2,0,2,0,0,0
415,https://vlr.gg/player/1144/boo,2024-11-21 08:15:00,0.40,1.11,0.76,168,96,240,13,3,10,18,10,8,12,4,8,0,-1,+1,71%,58%,83%,120,74,166,26%,21%,28%,1,0,1,1,1,0
416,https://vlr.gg/player/1457/mistic,2024-11-21 08:15:00,0.57,1.63,1.10,221,169,275,20,7,13,17,12,5,8,1,7,0,-1,+1,79%,58%,100%,136,97,176,41%,41%,41%,2,1,1,2,2,0
417,https://vlr.gg/player/4244/yaboilewis,2024-11-21 08:15:00,1.01,1.18,1.10,225,254,198,18,10,8,17,10,7,3,0,3,+1,-2,+3,58%,33%,83%,146,152,139,29%,47%,17%,4,1,3,3,3,0
418,https://vlr.gg/player/2690/hoody,2024-11-21 08:15:00,1.00,0.92,0.96,195,242,149,15,9,6,15,9,6,4,1,3,-1,-1,0,83%,75%,92%,129,151,108,28%,33%,22%,1,1,0,2,2,0
419,https://vlr.gg/player/2658/xuss,2024-11-21 08:15:00,0.27,1.59,0.93,172,64,281,15,2,13,13,9,4,0,0,0,0,-2,+2,50%,25%,75%,103,45,160,13%,22%,9%,4,0,4,4,2,2
420,https://vlr.gg/player/5292/al0rante,2024-11-21 08:15:00,0.41,0.80,0.61,158,120,196,14,5,9,19,11,8,2,0,2,-2,0,-2,54%,42%,67%,119,86,151,50%,45%,53%,0,0,0,2,0,2
421,https://vlr.gg/player/3626/lightningfast,2024-11-21 07:50:00,0.94,1.42,1.20,191,159,191,50,17,33,44,16,28,40,11,29,+5,-1,+6,88%,83%,92%,112,100,122,40%,42%,38%,8,1,7,3,2,1
422,https://vlr.gg/player/10758/kohliii,2024-11-21 07:50:00,1.19,0.90,1.03,179,187,157,54,18,36,45,16,29,23,13,10,0,-1,+1,90%,90%,89%,115,128,104,23%,21%,26%,2,0,2,2,1,1
423,https://vlr.gg/player/28612/tricky,2024-11-21 07:50:00,0.95,1.03,1.00,192,200,161,63,23,40,52,20,32,10,2,8,+3,+2,+1,81%,80%,81%,111,118,105,22%,19%,27%,11,8,3,8,6,2
424,https://vlr.gg/player/10463/paradox,2024-11-21 07:50:00,1.13,0.77,0.93,165,174,143,49,19,30,48,15,33,19,7,12,-1,-1,0,88%,83%,92%,102,118,88,32%,36%,28%,3,1,2,4,2,2
425,https://vlr.gg/player/1162/russ,2024-11-21 07:50:00,0.69,0.87,0.79,104,63,117,44,7,37,40,14,26,23,7,16,-3,-2,-1,76%,77%,76%,62,40,80,34%,12%,50%,2,0,2,5,2,3
426,https://vlr.gg/player/5009/wstvirginia,2024-11-21 07:50:00,0.97,1.05,1.01,132,111,162,47,15,32,44,18,26,30,14,16,-4,-2,-2,78%,76%,80%,90,73,112,37%,44%,31%,0,0,0,4,2,2
427,https://vlr.gg/player/30286/karam1l,2024-11-21 07:50:00,1.08,0.93,1.01,176,170,154,58,20,38,50,19,31,16,7,9,+3,0,+3,73%,76%,70%,109,113,103,32%,37%,27%,9,4,5,6,4,2
428,https://vlr.gg/player/46104/envy2k,2024-11-21 07:50:00,1.10,0.89,1.00,203,199,197,64,28,36,57,22,35,15,3,12,+2,-1,+3,81%,81%,80%,120,115,125,17%,16%,19%,8,2,6,6,3,3
429,https://vlr.gg/player/43390/d1sease,2024-11-21 07:50:00,0.46,1.12,0.75,113,65,175,32,6,26,56,24,32,34,13,21,-2,-2,0,82%,78%,87%,74,45,111,24%,28%,22%,2,1,1,4,3,1
430,https://vlr.gg/player/31355/acestarrrrr,2024-11-21 07:50:00,0.84,0.61,0.72,103,113,77,28,12,16,53,20,33,23,12,11,-3,-2,-1,76%,84%,67%,72,82,60,23%,30%,14%,3,2,1,6,4,2
431,https://vlr.gg/player/9801/f0rsaken,2024-11-21 06:15:00,,,,248,,,74,,,62,,,37,,,,,,,,,,,,,,,,,,,,
432,https://vlr.gg/player/9800/mindfreak,2024-11-21 06:15:00,,,,227,,,74,,,57,,,46,,,,,,,,,,,,,,,,,,,,
433,https://vlr.gg/player/9803/d4v41,2024-11-21 06:15:00,,,,194,,,63,,,54,,,17,,,,,,,,,,,,,,,,,,,,
434,https://vlr.gg/player/7378/jinggg,2024-11-21 06:15:00,,,,189,,,54,,,72,,,24,,,,,,,,,,,,,,,,,,,,
435,https://vlr.gg/player/17086/something,2024-11-21 06:15:00,,,,167,,,53,,,60,,,16,,,,,,,,,,,,,,,,,,,,
436,https://vlr.gg/player/34974/karon,2024-11-21 06:15:00,,,,231,,,75,,,57,,,31,,,,,,,,,,,,,,,,,,,,
437,https://vlr.gg/player/9196/t3xture,2024-11-21 06:15:00,,,,220,,,65,,,71,,,17,,,,,,,,,,,,,,,,,,,,
438,https://vlr.gg/player/11600/foxy9,2024-11-21 06:15:00,,,,192,,,56,,,64,,,20,,,,,,,,,,,,,,,,,,,,
439,https://vlr.gg/player/25081/yoman,2024-11-21 06:15:00,,,,189,,,58,,,61,,,22,,,,,,,,,,,,,,,,,,,,
440,https://vlr.gg/player/2489/munchkin,2024-11-21 06:15:00,,,,174,,,52,,,65,,,29,,,,,,,,,,,,,,,,,,,,
441,https://vlr.gg/player/23710/gotten,2024-11-21 06:00:00,1.22,1.40,1.31,236,228,244,41,21,20,28,13,15,19,7,12,+2,+2,0,72%,75%,70%,148,141,155,29%,29%,28%,4,3,1,2,1,1
442,https://vlr.gg/player/2346/cud,2024-11-21 06:00:00,1.29,1.18,1.23,182,172,194,33,17,16,22,9,13,7,1,6,+1,0,+1,85%,88%,83%,121,124,119,33%,29%,38%,5,0,5,4,0,4
443,https://vlr.gg/player/16852/nakya,2024-11-21 06:00:00,1.37,1.04,1.21,248,257,238,37,20,17,31,15,16,20,12,8,+3,+3,0,70%,75%,65%,163,181,145,29%,42%,19%,7,5,2,4,2,2
444,https://vlr.gg/player/11666/ray4c,2024-11-21 06:00:00,0.91,0.96,0.93,223,234,212,36,20,16,34,16,18,11,5,6,0,-3,+3,70%,79%,61%,138,150,126,12%,15%,8%,7,2,5,7,5,2
445,https://vlr.gg/player/7807/valdyn,2024-11-21 06:00:00,0.71,0.76,0.73,148,154,141,22,12,10,32,16,16,25,12,13,-1,-2,+1,60%,67%,52%,98,88,108,28%,29%,26%,3,2,1,4,4,0
446,https://vlr.gg/player/23930/potter,2024-11-21 06:00:00,1.25,1.24,1.24,277,283,270,41,22,19,36,17,19,10,6,4,+4,-1,+5,64%,61%,67%,181,188,175,27%,28%,25%,9,3,6,5,4,1
447,https://vlr.gg/player/3342/sushiboys,2024-11-21 06:00:00,1.07,0.93,1.00,192,198,190,32,17,15,33,15,18,16,10,6,0,0,0,68%,78%,58%,123,122,125,32%,41%,24%,5,2,3,5,2,3
448,https://vlr.gg/player/27254/leviathan,2024-11-21 06:00:00,1.00,0.85,0.93,206,230,183,33,17,16,35,17,18,12,6,6,0,0,0,72%,74%,71%,134,159,110,36%,33%,43%,2,1,1,2,1,1
449,https://vlr.gg/player/2366/alert,2024-11-21 06:00:00,0.86,0.67,0.76,152,156,148,23,12,11,33,15,18,13,9,4,-6,-3,-3,77%,78%,75%,108,113,103,16%,17%,15%,2,1,1,8,4,4
450,https://vlr.gg/player/4377/johnolsen,2024-11-21 06:00:00,0.76,0.59,0.68,116,122,112,18,10,8,32,15,17,11,4,7,-3,-1,-2,62%,61%,63%,81,82,80,29%,30%,29%,3,2,1,6,3,3
451,https://vlr.gg/player/43125/kadiri,2024-11-21 04:30:00,1.04,1.36,1.21,242,207,274,37,15,22,32,17,15,12,5,7,+3,+1,+2,69%,70%,68%,155,138,170,32%,34%,31%,6,2,4,3,1,2
452,https://vlr.gg/player/29821/sinaway,2024-11-21 04:30:00,1.07,0.79,0.93,190,237,150,27,16,11,32,17,15,12,7,5,+1,+1,0,64%,70%,59%,126,160,95,32%,40%,23%,3,2,1,2,1,1
453,https://vlr.gg/player/31255/biggiecheese,2024-11-21 04:30:00,0.95,0.87,0.91,181,198,164,26,14,12,33,16,17,17,9,8,+1,0,+1,74%,70%,77%,117,131,105,26%,25%,28%,3,0,3,2,0,2
454,https://vlr.gg/player/31254/feta,2024-11-21 04:30:00,0.62,1.14,0.89,208,158,252,31,12,19,33,17,16,5,3,2,-1,-2,+1,69%,65%,73%,139,107,168,33%,29%,35%,9,4,5,10,6,4
455,https://vlr.gg/player/29790/zauqk,2024-11-21 04:30:00,0.47,0.66,0.57,148,136,160,20,9,11,36,18,18,9,4,5,-1,0,-1,62%,65%,59%,98,85,110,27%,27%,28%,2,2,0,3,2,1
456,https://vlr.gg/player/12968/tixx,2024-11-21 04:30:00,1.17,1.32,1.24,253,237,269,40,19,21,28,15,13,12,9,3,+3,+1,+2,74%,68%,80%,163,150,177,30%,27%,33%,5,2,3,2,1,1
457,https://vlr.gg/player/6659/dragon,2024-11-21 04:30:00,1.22,1.20,1.21,265,270,258,38,20,18,28,15,13,12,3,9,+2,0,+2,67%,64%,70%,164,167,161,31%,36%,27%,3,1,2,1,1,0
458,https://vlr.gg/player/5228/minimise,2024-11-21 04:30:00,0.86,1.24,1.04,177,176,175,27,13,14,26,15,11,15,5,10,0,0,0,76%,77%,75%,111,105,118,19%,15%,24%,5,4,1,5,4,1
459,https://vlr.gg/player/26310/ikana,2024-11-21 04:30:00,1.13,0.86,1.00,187,196,185,27,16,11,28,14,14,13,6,7,-5,-2,-3,69%,73%,65%,135,126,145,18%,15%,21%,2,0,2,7,2,5
460,https://vlr.gg/player/1062/lew,2024-11-21 04:30:00,0.64,1.26,0.94,222,169,281,33,12,21,31,17,14,10,6,4,-3,-3,0,69%,68%,70%,153,111,199,23%,20%,26%,4,2,2,7,5,2
461,https://vlr.gg/player/37494/kai,2024-11-21 04:00:00,,,,216,,,28,,,32,,,6,,,,,,,,,,,,,,,,,,,,
462,https://vlr.gg/player/4770/fengf,2024-11-21 04:00:00,,,,179,,,24,,,28,,,6,,,,,,,,,,,,,,,,,,,,
463,https://vlr.gg/player/4712/heybay,2024-11-21 04:00:00,,,,179,,,22,,,30,,,12,,,,,,,,,,,,,,,,,,,,
464,https://vlr.gg/player/3045/luok1ng,2024-11-21 04:00:00,,,,141,,,19,,,29,,,14,,,,,,,,,,,,,,,,,,,,
465,https://vlr.gg/player/3021/biank,2024-11-21 04:00:00,,,,128,,,17,,,29,,,6,,,,,,,,,,,,,,,,,,,,
466,https://vlr.gg/player/8497/monyet,2024-11-21 04:00:00,,,,285,,,37,,,26,,,16,,,,,,,,,,,,,,,,,,,,
467,https://vlr.gg/player/4871/xffero,2024-11-21 04:00:00,,,,262,,,36,,,18,,,4,,,,,,,,,,,,,,,,,,,,
468,https://vlr.gg/player/24895/jemkin,2024-11-21 04:00:00,,,,238,,,33,,,22,,,5,,,,,,,,,,,,,,,,,,,,
469,https://vlr.gg/player/25025/estrella,2024-11-21 04:00:00,,,,213,,,27,,,20,,,29,,,,,,,,,,,,,,,,,,,,
470,https://vlr.gg/player/4866/kushy,2024-11-21 04:00:00,,,,112,,,15,,,24,,,7,,,,,,,,,,,,,,,,,,,,
471,https://vlr.gg/player/5796/kr1stal,2024-11-21 04:00:00,1.08,1.51,1.32,225,184,266,53,19,34,39,19,20,22,11,11,-1,-2,+1,77%,72%,80%,150,124,172,28%,25%,29%,4,1,3,5,3,2
472,https://vlr.gg/player/44259/patrickwho,2024-11-21 04:00:00,0.92,1.23,1.08,247,228,256,54,23,31,47,23,24,19,6,13,-3,-6,+3,70%,62%,77%,159,147,168,33%,37%,31%,7,0,7,10,6,4
473,https://vlr.gg/player/13219/papi,2024-11-21 04:00:00,1.21,0.79,0.98,159,205,115,35,22,13,39,18,21,23,6,17,+2,+1,+1,78%,72%,83%,101,129,78,25%,30%,20%,4,2,2,2,1,1
474,https://vlr.gg/player/7437/kellys,2024-11-21 04:00:00,0.84,0.92,0.88,191,187,187,41,19,22,48,23,25,21,7,14,-2,-1,-1,77%,72%,80%,126,121,131,19%,18%,19%,7,3,4,9,4,5
475,https://vlr.gg/player/4428/udotan,2024-11-21 04:00:00,0.66,0.98,0.83,182,147,212,41,15,26,48,22,26,10,2,8,+2,-3,+5,63%,55%,69%,125,100,145,34%,31%,36%,9,3,6,7,6,1
476,https://vlr.gg/player/7043/ncslasher,2024-11-21 04:00:00,1.16,1.05,1.11,195,192,204,47,25,22,40,21,19,32,22,10,+1,+1,0,81%,83%,79%,121,108,138,31%,35%,27%,3,1,2,2,0,2
477,https://vlr.gg/player/2348/famouz,2024-11-21 04:00:00,0.86,1.38,1.10,238,223,259,50,24,26,45,28,17,14,7,7,+3,-3,+6,73%,71%,76%,162,151,174,17%,25%,8%,13,5,8,10,8,2
478,https://vlr.gg/player/10739/shiro,2024-11-21 04:00:00,1.02,0.90,0.96,170,192,151,35,22,13,42,24,18,26,11,15,+1,-1,+2,64%,60%,69%,110,116,101,16%,21%,10%,7,3,4,6,4,2
479,https://vlr.gg/player/4874/berserx,2024-11-21 04:00:00,0.72,1.19,0.93,203,180,235,50,23,27,47,27,20,14,5,9,-2,-5,+3,77%,66%,90%,136,120,155,34%,42%,29%,7,3,4,9,8,1
480,https://vlr.gg/player/16215/dos9,2024-11-21 04:00:00,0.96,0.81,0.89,171,181,173,39,22,17,50,26,24,39,20,19,-1,-1,0,73%,71%,76%,111,109,113,19%,19%,18%,3,1,2,4,2,2
481,https://vlr.gg/player/31589/murza,2024-11-21 02:30:00,1.36,1.13,1.26,252,284,217,40,26,14,27,14,13,8,2,6,-5,-5,0,77%,75%,79%,158,184,124,19%,24%,12%,4,1,3,9,6,3
482,https://vlr.gg/player/46993/long,2024-11-21 02:30:00,1.11,1.17,1.14,167,165,159,27,15,12,25,14,11,30,16,14,-2,0,-2,79%,88%,68%,95,96,94,24%,26%,23%,1,1,0,3,1,2
483,https://vlr.gg/player/34226/sh0pan,2024-11-21 02:30:00,0.87,1.32,1.07,223,196,253,34,17,17,31,18,13,8,5,3,-1,-1,0,79%,83%,74%,137,120,159,17%,18%,16%,5,4,1,6,5,1
484,https://vlr.gg/player/31593/kiss,2024-11-21 02:30:00,1.12,0.90,1.03,211,241,172,31,20,11,30,16,14,19,10,9,-1,0,-1,77%,79%,74%,145,173,108,42%,44%,39%,2,2,0,3,2,1
485,https://vlr.gg/player/26316/ramen,2024-11-21 02:30:00,0.80,1.27,1.01,201,148,272,28,11,17,29,15,14,7,2,5,+2,0,+2,65%,71%,58%,137,109,172,24%,24%,25%,6,1,5,4,1,3
486,https://vlr.gg/player/31580/vizsla,2024-11-21 02:30:00,0.92,1.37,1.17,238,176,284,33,10,23,31,14,17,25,14,11,+3,0,+3,79%,79%,79%,146,110,174,28%,26%,29%,4,0,4,1,0,1
487,https://vlr.gg/player/22816/blessed,2024-11-21 02:30:00,1.07,1.09,1.08,211,239,186,29,16,13,30,13,17,20,8,12,0,+2,-2,70%,68%,71%,146,158,137,22%,28%,18%,6,4,2,6,2,4
488,https://vlr.gg/player/36747/bonobo,2024-11-21 02:30:00,0.85,0.81,0.83,195,213,177,30,15,15,35,16,19,6,2,4,+5,+1,+4,58%,63%,54%,121,134,110,31%,54%,20%,6,2,4,1,1,0
489,https://vlr.gg/player/17272/dokja,2024-11-21 02:30:00,0.70,0.91,0.82,188,185,201,31,14,17,33,15,18,6,0,6,-2,-3,+1,60%,63%,58%,129,126,131,28%,52%,19%,5,2,3,7,5,2
490,https://vlr.gg/player/1771/myth,2024-11-21 02:30:00,0.91,0.71,0.80,145,190,122,19,10,9,31,13,18,15,10,5,+1,+1,0,72%,89%,58%,104,126,87,13%,11%,16%,4,2,2,3,1,2
0,https://vlr.gg/player/49572/killy,2024-11-20 18:50:00,1.61,1.55,1.58,281,319,261,44,21,23,23,12,11,15,3,12,+3,+1,+2,95%,88%,100%,193,201,188,47%,74%,33%,5,2,3,2,1,1
1,https://vlr.gg/player/26757/otaq,2024-11-20 18:50:00,0.94,2.03,1.57,248,175,283,37,10,27,19,12,7,17,6,11,+1,0,+1,83%,59%,100%,169,129,198,24%,17%,30%,2,0,2,1,0,1
2,https://vlr.gg/player/31476/mephisto,2024-11-20 18:50:00,0.81,1.35,1.12,272,214,315,39,13,26,30,14,16,5,1,4,+2,-3,+5,75%,65%,83%,177,147,199,25%,20%,29%,11,3,8,9,6,3
3,https://vlr.gg/player/10718/rowancy,2024-11-20 18:50:00,0.99,0.92,0.95,186,195,181,26,12,14,25,11,14,13,3,10,-3,-2,-1,78%,76%,78%,125,129,122,18%,16%,20%,1,0,1,4,2,2
4,https://vlr.gg/player/15931/peloncito,2024-11-20 18:50:00,0.76,0.91,0.85,167,130,196,23,6,17,26,12,14,13,8,5,-3,-1,-2,85%,88%,83%,115,96,129,28%,21%,33%,1,1,0,4,2,2
5,https://vlr.gg/player/10582/panaek,2024-11-20 18:50:00,0.82,1.25,1.00,213,195,232,28,14,14,32,21,11,8,5,3,+3,+2,+1,75%,74%,76%,132,124,143,25%,30%,20%,6,4,2,3,2,1
6,https://vlr.gg/player/17676/dexuz,2024-11-20 18:50:00,0.71,1.02,0.84,185,142,231,26,12,14,33,20,13,16,10,6,-3,-3,0,68%,65%,71%,110,94,132,26%,46%,18%,1,0,1,4,3,1
7,https://vlr.gg/player/35559/pandejalea,2024-11-20 18:50:00,0.74,0.95,0.83,202,210,208,27,15,12,37,24,13,10,6,4,+3,-1,+4,60%,52%,71%,132,142,118,25%,21%,32%,8,3,5,5,4,1
8,https://vlr.gg/player/8781/charlslol,2024-11-20 18:50:00,0.93,0.52,0.76,160,179,139,23,15,8,34,21,13,15,11,4,0,0,0,68%,70%,65%,106,100,114,19%,17%,20%,1,0,1,1,0,1
9,https://vlr.gg/player/17696/gera,2024-11-20 18:50:00,0.31,1.00,0.60,136,96,199,19,6,13,34,22,12,9,7,2,-3,-3,0,70%,61%,82%,91,67,123,15%,13%,18%,4,2,2,7,5,2
10,https://vlr.gg/player/2995/maka,2024-11-20 17:00:00,1.02,0.26,0.78,167,218,47,19,18,1,30,21,9,8,7,1,-1,0,-1,56%,63%,40%,108,134,46,23%,26%,10%,1,1,0,2,1,1
11,https://vlr.gg/player/35567/toro,2024-11-20 17:00:00,0.75,0.81,0.77,161,142,209,18,11,7,28,20,8,3,2,1,+1,0,+1,50%,54%,40%,114,110,124,31%,65%,16%,4,2,2,3,2,1
12,https://vlr.gg/player/17669/pompz,2024-11-20 17:00:00,0.86,0.51,0.76,156,174,113,19,15,4,29,21,8,14,11,3,-2,-1,-1,56%,50%,70%,95,107,68,35%,41%,21%,0,0,0,2,1,1
13,https://vlr.gg/player/1328/javiierh,2024-11-20 17:00:00,0.75,0.71,0.74,193,186,211,20,14,6,30,21,9,9,6,3,-2,-3,+1,59%,63%,50%,131,124,148,21%,20%,23%,3,2,1,5,5,0
14,https://vlr.gg/player/21993/gonchz,2024-11-20 17:00:00,0.14,0.95,0.38,127,89,221,13,6,7,33,24,9,9,6,3,-6,-6,0,47%,42%,60%,89,63,151,26%,30%,22%,4,2,2,10,8,2
15,https://vlr.gg/player/7639/ezznap,2024-11-20 17:00:00,2.16,1.53,1.71,262,311,242,34,12,22,14,3,11,20,6,14,+2,+1,+1,94%,90%,96%,164,179,158,30%,24%,33%,3,1,2,1,0,1
16,https://vlr.gg/player/2491/nolan,2024-11-20 17:00:00,1.89,1.46,1.58,250,294,232,35,12,23,13,3,10,7,2,5,+3,0,+3,88%,100%,83%,156,185,144,43%,52%,38%,4,0,4,1,0,1
17,https://vlr.gg/player/24021/snapss,2024-11-20 17:00:00,1.16,1.29,1.25,209,178,222,26,7,19,17,5,12,14,5,9,-1,0,-1,94%,90%,96%,145,121,155,32%,15%,39%,0,0,0,1,0,1
18,https://vlr.gg/player/45918/clutchz,2024-11-20 17:00:00,1.13,1.25,1.21,258,263,255,31,9,22,23,7,16,11,2,9,+5,-1,+6,82%,80%,83%,165,179,160,20%,30%,17%,12,4,8,7,5,2
19,https://vlr.gg/player/49571/paganus,2024-11-20 17:00:00,0.60,1.05,0.92,196,94,238,24,3,21,22,7,15,11,3,8,+1,0,+1,76%,70%,79%,129,85,147,36%,19%,44%,3,0,3,2,0,2
20,https://vlr.gg/player/3993/jawgemo,2024-11-20 15:40:00,1.58,1.78,1.73,292,198,323,16,2,14,7,1,6,12,4,8,+2,0,+2,81%,100%,75%,175,141,187,11%,8%,13%,2,0,2,0,0,0
21,https://vlr.gg/player/7873/leaf,2024-11-20 15:40:00,2.00,1.25,1.44,266,396,223,16,6,10,8,2,6,3,0,3,+4,+2,+2,88%,100%,83%,181,209,172,17%,0%,24%,5,2,3,1,0,1
22,https://vlr.gg/player/4581/jonahp,2024-11-20 15:40:00,1.04,1.47,1.36,206,90,245,12,2,10,7,1,6,7,1,6,-1,-1,0,81%,75%,83%,134,34,167,20%,50%,18%,1,0,1,2,1,1
23,https://vlr.gg/player/3885/valyn,2024-11-20 15:40:00,2.11,1.03,1.30,197,209,194,13,4,9,7,0,7,7,2,5,+1,0,+1,81%,100%,75%,122,124,122,28%,33%,26%,1,0,1,0,0,0
24,https://vlr.gg/player/15500/trent,2024-11-20 15:40:00,0.94,0.84,0.86,203,163,217,11,3,8,12,3,9,6,0,6,0,+1,-1,81%,75%,83%,143,102,157,31%,33%,30%,2,1,1,2,0,2
25,https://vlr.gg/player/13238/shiio,2024-11-20 15:40:00,1.34,0.01,0.93,180,232,29,10,10,0,13,9,4,2,2,0,-1,0,-1,50%,67%,,120,150,29,28%,29%,25%,0,0,0,1,0,1
26,https://vlr.gg/player/47270/darkwinjett,2024-11-20 15:40:00,0.73,0.51,0.67,201,200,208,11,8,3,15,11,4,2,2,0,-5,-3,-2,44%,50%,25%,133,129,144,19%,19%,20%,3,3,0,8,6,2
27,https://vlr.gg/player/20032/treelover,2024-11-20 15:40:00,0.84,0.06,0.65,147,191,20,8,8,0,14,11,3,4,3,1,0,0,0,50%,50%,50%,91,117,14,24%,26%,0%,1,1,0,1,1,0
28,https://vlr.gg/player/2540/happen,2024-11-20 15:40:00,0.70,0.05,0.54,108,143,6,6,6,0,13,10,3,4,3,1,0,0,0,56%,58%,50%,78,103,,13%,13%,,0,0,0,0,0,0
29,https://vlr.gg/player/3649/litshii,2024-11-20 15:40:00,0.39,1.00,0.54,140,79,325,6,2,4,13,10,3,7,6,1,0,-1,+1,75%,67%,100%,91,51,212,32%,8%,67%,1,0,1,1,1,0
30,https://vlr.gg/player/2540/happen,2024-11-20 14:00:00,1.28,1.23,1.25,257,282,233,21,11,10,19,11,8,14,6,8,+1,-1,+2,82%,71%,93%,177,186,169,23%,19%,30%,3,0,3,2,1,1
31,https://vlr.gg/player/47270/darkwinjett,2024-11-20 14:00:00,0.78,1.36,1.07,261,146,377,25,8,17,24,14,10,8,7,1,0,-1,+1,75%,71%,79%,167,124,211,16%,9%,22%,5,2,3,5,3,2
32,https://vlr.gg/player/20032/treelover,2024-11-20 14:00:00,0.71,1.37,1.04,170,167,175,18,7,11,17,12,5,8,5,3,-4,-3,-1,68%,57%,79%,117,123,112,19%,15%,25%,1,1,0,5,4,1
33,https://vlr.gg/player/13238/shiio,2024-11-20 14:00:00,0.72,1.34,1.03,186,144,228,20,7,13,18,12,6,5,2,3,0,-2,+2,61%,43%,79%,135,106,164,35%,23%,46%,2,0,2,2,2,0
34,https://vlr.gg/player/3649/litshii,2024-11-20 14:00:00,0.51,1.47,0.99,158,67,251,14,3,11,19,12,7,23,7,16,+1,-1,+2,75%,57%,93%,93,42,145,10%,14%,9%,2,0,2,1,1,0
35,https://vlr.gg/player/5554/profek,2024-11-20 14:00:00,0.95,1.42,1.18,246,202,291,25,10,15,21,13,8,10,3,7,+3,0,+3,71%,57%,86%,148,129,167,35%,39%,31%,4,1,3,1,1,0
36,https://vlr.gg/player/5568/sociablee,2024-11-20 14:00:00,1.13,1.09,1.11,230,237,224,22,10,12,20,12,8,9,3,6,-1,-1,0,75%,64%,86%,159,164,154,25%,21%,31%,2,0,2,3,1,2
37,https://vlr.gg/player/9780/jamppi,2024-11-20 14:00:00,0.53,1.40,0.97,167,105,230,17,5,12,18,12,6,10,2,8,-2,-1,-1,68%,43%,93%,122,78,165,20%,18%,20%,0,0,0,2,1,1
38,https://vlr.gg/player/321/chiwa,2024-11-20 14:00:00,0.52,1.33,0.93,170,136,206,18,7,11,17,12,5,4,0,4,-1,-1,0,68%,50%,86%,115,95,136,35%,33%,35%,2,2,0,3,3,0
39,https://vlr.gg/player/20144/lewn,2024-11-20 14:00:00,0.18,1.19,0.68,167,109,226,15,4,11,22,13,9,7,2,5,+3,-3,+6,64%,29%,100%,114,69,160,25%,45%,19%,7,1,6,4,4,0
40,https://vlr.gg/player/3993/jawgemo,2024-11-20 12:45:00,1.03,1.76,1.40,267,247,288,22,9,13,17,10,7,8,2,6,+4,+2,+2,71%,58%,83%,163,154,171,25%,19%,35%,8,4,4,4,2,2
41,https://vlr.gg/player/3885/valyn,2024-11-20 12:45:00,1.43,1.17,1.30,239,252,227,21,12,9,17,9,8,8,2,6,+1,-1,+2,67%,58%,75%,151,164,138,21%,21%,21%,3,0,3,2,1,1
42,https://vlr.gg/player/15500/trent,2024-11-20 12:45:00,0.19,1.19,0.69,189,81,298,13,2,11,21,12,9,10,3,7,-2,-2,0,63%,42%,83%,130,62,198,29%,27%,30%,0,0,0,2,2,0
43,https://vlr.gg/player/4581/jonahp,2024-11-20 12:45:00,0.50,0.65,0.58,119,115,123,9,4,5,18,10,8,7,5,2,+1,0,+1,71%,67%,75%,79,81,77,26%,36%,18%,1,0,1,0,0,0
44,https://vlr.gg/player/7873/leaf,2024-11-20 12:45:00,0.46,0.51,0.48,117,96,139,9,3,6,18,9,9,4,2,2,-2,-1,-1,46%,50%,42%,83,67,99,14%,25%,8%,1,1,0,3,2,1
45,https://vlr.gg/player/8369/yetujey,2024-11-20 12:45:00,1.71,1.03,1.37,254,329,180,22,14,8,13,7,6,4,2,2,0,-1,+1,83%,83%,83%,157,198,116,33%,34%,30%,2,1,1,2,2,0
46,https://vlr.gg/player/8044/mrfalin,2024-11-20 12:45:00,0.71,1.88,1.30,215,139,291,18,5,13,12,9,3,13,8,5,-2,-2,0,88%,75%,100%,136,86,187,33%,40%,30%,1,0,1,3,2,1
47,https://vlr.gg/player/12793/xeus,2024-11-20 12:45:00,1.40,1.20,1.30,299,339,259,26,14,12,18,10,8,1,1,0,-1,0,-1,63%,67%,58%,189,209,170,44%,39%,55%,6,3,3,7,3,4
48,https://vlr.gg/player/6510/atakaptan,2024-11-20 12:45:00,0.39,1.27,0.83,158,106,211,11,3,8,16,10,6,10,6,4,+1,-1,+2,67%,58%,75%,115,64,165,32%,13%,43%,2,0,2,1,1,0
49,https://vlr.gg/player/1139/qraxs,2024-11-20 12:45:00,0.73,0.93,0.83,158,106,212,14,5,9,15,8,7,7,3,4,0,0,0,75%,67%,83%,96,63,128,36%,44%,33%,0,0,0,0,0,0
50,https://vlr.gg/player/40935/umu7,2024-11-20 12:30:00,1.10,1.62,1.36,285,259,310,67,30,37,44,26,18,11,2,9,+17,+6,+11,77%,79%,76%,171,158,184,19%,24%,14%,20,9,11,3,3,0
51,https://vlr.gg/player/10137/ip0tt,2024-11-20 12:30:00,1.09,1.19,1.14,193,183,209,45,22,23,36,19,17,18,9,9,-7,-2,-5,70%,67%,73%,133,125,142,27%,38%,19%,3,1,2,10,3,7
52,https://vlr.gg/player/3557/skylen,2024-11-20 12:30:00,1.11,1.08,1.09,186,198,171,46,24,22,43,24,19,25,10,15,+1,0,+1,73%,79%,67%,122,125,118,42%,49%,35%,5,2,3,4,2,2
53,https://vlr.gg/player/22676/ventt,2024-11-20 12:30:00,0.72,1.13,0.93,190,165,215,41,17,24,44,26,18,25,13,12,+3,-3,+6,83%,85%,82%,130,121,138,29%,32%,26%,8,2,6,5,5,0
54,https://vlr.gg/player/31855/celasun,2024-11-20 12:30:00,0.89,0.71,0.80,162,167,153,36,19,17,44,22,22,16,10,6,-2,-2,0,67%,67%,67%,115,125,106,27%,33%,21%,3,2,1,5,4,1
55,https://vlr.gg/player/31305/lar0k,2024-11-20 12:30:00,1.00,1.07,1.04,187,176,201,44,22,22,45,23,22,30,13,17,+1,+1,0,77%,79%,76%,118,105,131,42%,47%,39%,5,2,3,4,1,3
56,https://vlr.gg/player/40591/comeback,2024-11-20 12:30:00,0.85,1.11,0.98,233,213,252,50,21,29,52,28,24,14,9,5,+2,+1,+1,70%,61%,79%,152,146,157,23%,24%,21%,10,5,5,8,4,4
57,https://vlr.gg/player/12795/crewen,2024-11-20 12:30:00,0.83,1.08,0.96,187,156,218,47,19,28,46,25,21,10,7,3,-3,-3,0,70%,70%,70%,121,102,139,35%,36%,35%,4,1,3,7,4,3
58,https://vlr.gg/player/24344/loita,2024-11-20 12:30:00,0.76,1.08,0.92,156,143,174,33,15,18,45,24,21,33,9,24,-6,-7,+1,68%,67%,70%,114,98,131,39%,34%,43%,5,1,4,11,8,3
59,https://vlr.gg/player/5565/ros,2024-11-20 12:30:00,0.86,0.87,0.85,167,161,175,37,17,20,47,23,24,19,9,10,-6,-5,-1,62%,58%,67%,116,110,123,32%,32%,32%,3,1,2,9,6,3
60,https://vlr.gg/player/3649/litshii,2024-11-20 11:35:00,1.37,1.43,1.40,281,301,261,23,12,11,16,9,7,11,4,7,-2,-1,-1,92%,83%,100%,181,194,169,29%,34%,24%,0,0,0,2,1,1
61,https://vlr.gg/player/47270/darkwinjett,2024-11-20 11:35:00,0.85,1.48,1.17,251,242,260,23,10,13,16,11,5,4,3,1,+4,-1,+5,71%,58%,83%,139,138,140,17%,18%,16%,8,3,5,4,4,0
62,https://vlr.gg/player/2540/happen,2024-11-20 11:35:00,1.08,0.98,1.03,189,209,171,15,9,6,14,8,6,10,6,4,0,0,0,71%,58%,83%,132,146,118,13%,10%,16%,1,0,1,1,0,1
63,https://vlr.gg/player/20032/treelover,2024-11-20 11:35:00,0.72,1.03,0.88,180,145,216,16,6,10,18,9,9,12,5,7,-1,-2,+1,63%,50%,75%,118,122,115,39%,24%,55%,2,0,2,3,2,1
64,https://vlr.gg/player/13238/shiio,2024-11-20 11:35:00,0.91,0.55,0.73,149,173,126,14,8,6,16,7,9,2,1,1,-3,-2,-1,63%,58%,67%,112,119,106,18%,21%,16%,0,0,0,3,2,1
65,https://vlr.gg/player/26837/poegii,2024-11-20 11:35:00,1.41,0.96,1.18,218,242,194,18,11,7,19,8,11,14,4,10,0,-1,+1,83%,83%,83%,146,161,130,21%,17%,25%,2,0,2,2,1,1
66,https://vlr.gg/player/4613/johnieboy,2024-11-20 11:35:00,1.01,1.13,1.07,192,177,209,17,8,9,16,8,8,5,1,4,-1,-1,0,54%,50%,58%,122,115,129,33%,39%,29%,3,2,1,4,3,1
67,https://vlr.gg/player/90/idex,2024-11-20 11:35:00,0.83,1.29,1.06,219,226,213,18,9,9,19,11,8,9,4,5,+1,0,+1,71%,67%,75%,163,144,182,28%,21%,33%,3,1,2,2,1,1
68,https://vlr.gg/player/5498/kipperman,2024-11-20 11:35:00,0.67,1.10,0.89,214,161,269,17,5,12,21,11,10,3,3,0,+3,-1,+4,63%,42%,83%,134,118,150,24%,21%,27%,5,1,4,2,2,0
69,https://vlr.gg/player/36385/6clarity,2024-11-20 11:35:00,0.60,0.99,0.80,138,90,187,10,3,7,16,8,8,4,2,2,-1,-1,0,71%,75%,67%,116,65,166,28%,33%,26%,0,0,0,1,1,0
70,https://vlr.gg/player/5568/sociablee,2024-11-20 11:35:00,2.44,1.30,1.68,343,410,310,24,10,14,12,1,11,5,3,2,+3,+1,+2,89%,100%,83%,216,255,197,23%,47%,16%,5,1,4,2,0,2
71,https://vlr.gg/player/321/chiwa,2024-11-20 11:35:00,1.87,1.46,1.60,239,236,241,16,5,11,8,1,7,8,3,5,0,+1,-1,83%,100%,75%,167,155,173,34%,36%,33%,1,1,0,1,0,1
72,https://vlr.gg/player/20144/lewn,2024-11-20 11:35:00,1.70,1.06,1.27,240,338,192,16,8,8,13,4,9,3,1,2,+2,+3,-1,72%,83%,67%,155,208,128,39%,55%,29%,4,3,1,2,0,2
73,https://vlr.gg/player/5554/profek,2024-11-20 11:35:00,1.51,0.58,0.89,153,142,159,9,3,6,12,1,11,9,7,2,-1,0,-1,56%,100%,33%,110,94,119,28%,33%,25%,0,0,0,1,0,1
74,https://vlr.gg/player/9780/jamppi,2024-11-20 11:35:00,0.82,0.68,0.73,122,116,126,8,2,6,12,3,9,7,5,2,-2,-1,-1,61%,83%,50%,84,91,80,37%,60%,32%,0,0,0,2,1,1
75,https://vlr.gg/player/2818/neto,2024-11-20 11:35:00,1.56,0.85,1.32,312,375,188,19,16,3,16,11,5,1,1,0,+5,+6,-1,67%,75%,50%,196,226,135,47%,50%,38%,6,6,0,1,0,1
76,https://vlr.gg/player/1291/bnj,2024-11-20 11:35:00,1.27,0.64,1.06,242,280,168,15,12,3,14,8,6,5,4,1,0,-1,+1,78%,83%,67%,149,167,115,26%,26%,23%,2,1,1,2,2,0
77,https://vlr.gg/player/2586/hanling,2024-11-20 11:35:00,0.81,0.43,0.68,172,205,108,8,6,2,14,9,5,9,7,2,-2,-1,-1,83%,83%,83%,122,150,65,24%,21%,50%,0,0,0,2,1,1
78,https://vlr.gg/player/15916/jotinha,2024-11-20 11:35:00,0.91,0.03,0.60,127,155,73,9,8,1,14,8,6,2,2,0,-2,-1,-1,61%,75%,33%,105,120,74,60%,55%,75%,0,0,0,2,1,1
79,https://vlr.gg/player/2403/mizu,2024-11-20 11:35:00,0.41,0.11,0.31,100,114,75,6,5,1,15,9,6,2,2,0,-3,-1,-2,39%,42%,33%,78,88,58,41%,38%,50%,0,0,0,3,1,2
80,https://vlr.gg/player/15500/trent,2024-11-20 10:15:00,2.54,1.47,1.83,295,314,287,19,7,12,7,1,6,11,4,7,+3,0,+3,100%,100%,100%,196,228,180,28%,26%,29%,3,0,3,0,0,0
81,https://vlr.gg/player/3885/valyn,2024-11-20 10:15:00,0.88,1.82,1.51,280,181,330,20,4,16,11,4,7,12,6,6,0,-1,+1,94%,83%,100%,186,113,223,33%,27%,35%,1,0,1,1,1,0
82,https://vlr.gg/player/3993/jawgemo,2024-11-20 10:15:00,1.46,1.47,1.47,316,353,299,22,9,13,11,4,7,4,1,3,0,+2,-2,78%,67%,83%,193,167,206,21%,12%,27%,4,3,1,4,1,3
83,https://vlr.gg/player/4581/jonahp,2024-11-20 10:15:00,1.05,0.97,1.00,127,153,114,8,3,5,8,3,5,7,4,3,-1,-1,0,72%,83%,67%,89,107,80,36%,40%,33%,1,0,1,2,1,1
84,https://vlr.gg/player/7873/leaf,2024-11-20 10:15:00,0.93,0.73,0.80,143,158,137,10,4,6,12,4,8,6,1,5,0,0,0,89%,83%,92%,84,101,76,21%,0%,30%,1,0,1,1,0,1
85,https://vlr.gg/player/9780/jamppi,2024-11-20 10:15:00,0.93,1.05,0.97,235,230,247,17,11,6,18,12,6,2,2,0,0,0,0,83%,92%,67%,143,142,145,24%,23%,27%,0,0,0,0,0,0
86,https://vlr.gg/player/321/chiwa,2024-11-20 10:15:00,0.89,0.86,0.88,203,173,264,10,6,4,15,9,6,2,1,1,0,-2,+2,39%,42%,33%,136,119,170,20%,16%,24%,2,0,2,2,2,0
87,https://vlr.gg/player/5568/sociablee,2024-11-20 10:15:00,0.69,0.43,0.60,122,138,93,8,6,2,15,10,5,7,5,2,-1,+1,-2,50%,50%,50%,85,96,64,25%,31%,14%,1,1,0,2,0,2
88,https://vlr.gg/player/5554/profek,2024-11-20 10:15:00,0.58,0.35,0.50,110,127,76,7,5,2,14,9,5,5,4,1,-1,-1,0,61%,67%,50%,62,76,34,21%,29%,0%,2,2,0,3,3,0
89,https://vlr.gg/player/20144/lewn,2024-11-20 10:15:00,0.40,0.64,0.48,146,133,173,7,5,2,17,12,5,4,1,3,0,0,0,61%,58%,67%,106,90,137,36%,64%,14%,3,2,1,3,2,1
90,https://vlr.gg/player/3649/litshii,2024-11-20 10:15:00,1.35,0.74,1.15,238,293,130,14,12,2,12,10,2,2,1,1,0,+1,-1,83%,83%,83%,147,180,82,21%,30%,0%,1,1,0,1,0,1
91,https://vlr.gg/player/13238/shiio,2024-11-20 10:15:00,0.70,0.63,0.68,114,128,87,8,6,2,14,10,4,4,3,1,-1,-1,0,61%,67%,50%,80,82,78,19%,17%,25%,0,0,0,1,1,0
92,https://vlr.gg/player/20032/treelover,2024-11-20 10:15:00,0.46,0.86,0.59,125,117,141,7,4,3,15,11,4,5,3,2,+4,+3,+1,67%,67%,67%,85,72,112,13%,17%,7%,4,3,1,0,0,0
93,https://vlr.gg/player/2540/happen,2024-11-20 10:15:00,0.54,0.57,0.55,148,147,152,11,7,4,16,11,5,1,0,1,-4,-2,-2,50%,58%,33%,96,88,113,21%,15%,36%,0,0,0,4,2,2
94,https://vlr.gg/player/47270/darkwinjett,2024-11-20 10:15:00,0.02,1.20,0.35,128,57,272,7,1,6,17,12,5,3,3,0,-5,-5,0,56%,50%,67%,83,46,158,18%,7%,31%,1,0,1,6,5,1
95,https://vlr.gg/player/1139/qraxs,2024-11-20 10:15:00,1.89,1.35,1.53,246,321,209,16,7,9,11,4,7,14,3,11,+2,+3,-1,83%,67%,92%,171,181,167,44%,54%,38%,3,3,0,1,0,1
96,https://vlr.gg/player/6510/atakaptan,2024-11-20 10:15:00,1.42,1.39,1.40,275,247,290,19,6,13,9,3,6,5,2,3,+2,+1,+1,78%,83%,75%,155,137,164,29%,20%,35%,3,1,2,1,0,1
97,https://vlr.gg/player/8369/yetujey,2024-11-20 10:15:00,0.91,1.42,1.25,182,118,214,12,2,10,8,3,5,5,1,4,+2,0,+2,83%,83%,83%,118,87,133,27%,38%,24%,2,0,2,0,0,0
98,https://vlr.gg/player/8044/mrfalin,2024-11-20 10:15:00,0.70,1.46,1.21,185,80,239,10,1,9,8,3,5,11,4,7,+1,0,+1,89%,67%,100%,121,55,154,26%,33%,24%,1,0,1,0,0,0
99,https://vlr.gg/player/12793/xeus,2024-11-20 10:15:00,0.99,1.29,1.19,242,190,268,17,4,13,11,4,7,4,3,1,-1,-2,+1,78%,83%,75%,170,146,181,42%,55%,36%,3,0,3,4,2,2
100,https://vlr.gg/player/40912/123,2024-11-20 09:50:00,1.38,1.71,1.52,319,353,282,48,30,18,27,19,8,14,8,6,+1,0,+1,83%,83%,83%,213,226,195,28%,28%,27%,6,3,3,5,3,2
101,https://vlr.gg/player/19231/kibojn,2024-11-20 09:50:00,1.12,1.73,1.38,244,197,310,40,18,22,22,13,9,27,17,10,+3,+1,+2,81%,79%,83%,151,115,200,40%,35%,45%,3,1,2,0,0,0
102,https://vlr.gg/player/18702/deadly10,2024-11-20 09:50:00,0.91,1.48,1.15,270,215,343,39,16,23,34,19,15,12,7,5,-1,-4,+3,76%,67%,89%,195,162,239,23%,19%,27%,9,5,4,10,9,1
103,https://vlr.gg/player/8156/mojo,2024-11-20 09:50:00,0.98,0.97,0.98,200,199,199,27,16,11,30,19,11,24,13,11,-3,+1,-4,81%,75%,89%,124,117,134,13%,14%,13%,2,2,0,5,1,4
104,https://vlr.gg/player/48426/ghostxd,2024-11-20 09:50:00,0.71,0.74,0.72,116,123,110,17,10,7,26,15,11,12,8,4,0,0,0,67%,67%,67%,77,80,74,34%,24%,48%,1,0,1,1,0,1
105,https://vlr.gg/player/49570/rinsat,2024-11-20 09:50:00,1.03,1.19,1.12,259,251,266,38,17,21,38,18,20,10,2,8,-1,0,-1,69%,78%,63%,171,166,175,45%,50%,41%,4,2,2,5,2,3
106,https://vlr.gg/player/27755/icarus,2024-11-20 09:50:00,0.76,1.13,0.97,193,183,202,30,12,18,32,15,17,7,3,4,+1,0,+1,69%,61%,75%,126,114,136,31%,41%,25%,2,0,2,1,0,1
107,https://vlr.gg/player/40060/rage,2024-11-20 09:50:00,0.43,1.09,0.80,143,97,177,21,5,16,29,15,14,8,5,3,-1,-1,0,64%,56%,71%,99,69,122,25%,20%,29%,2,1,1,3,2,1
108,https://vlr.gg/player/43389/yash,2024-11-20 09:50:00,0.22,1.19,0.77,192,85,268,26,5,21,35,16,19,10,4,6,-1,-4,+3,79%,61%,92%,124,60,172,37%,25%,41%,7,1,6,8,5,3
109,https://vlr.gg/player/43403/silon,2024-11-20 09:50:00,1.05,0.52,0.75,179,252,126,24,15,9,37,17,20,12,4,8,+2,+3,-1,74%,67%,79%,131,174,99,25%,24%,27%,6,4,2,4,1,3
110,https://vlr.gg/player/24628/wayne,2024-11-20 09:40:00,1.46,1.68,1.56,281,264,302,68,34,34,41,23,18,39,24,15,+5,+3,+2,82%,84%,79%,166,165,167,28%,30%,25%,6,3,3,1,0,1
111,https://vlr.gg/player/1430/crazyguy,2024-11-20 09:40:00,1.49,0.90,1.23,241,296,161,54,39,15,38,23,15,17,11,6,+1,0,+1,71%,73%,69%,158,190,118,23%,25%,20%,7,4,3,6,4,2
112,https://vlr.gg/player/11704/styron,2024-11-20 09:40:00,1.05,1.00,1.03,165,169,156,38,22,16,39,22,17,28,16,12,+1,0,+1,79%,76%,83%,117,118,115,25%,30%,22%,7,4,3,6,4,2
113,https://vlr.gg/player/24653/vera,2024-11-20 09:40:00,0.79,1.03,0.90,226,227,222,47,26,21,55,33,22,25,13,12,-2,-2,0,77%,76%,79%,150,149,151,23%,29%,17%,8,5,3,10,7,3
114,https://vlr.gg/player/9152/deryeon,2024-11-20 09:40:00,0.68,0.93,0.79,157,146,178,37,20,17,43,26,17,12,5,7,-7,-6,-1,68%,65%,72%,109,101,119,22%,25%,18%,4,0,4,11,6,5
115,https://vlr.gg/player/23710/gotten,2024-11-20 09:40:00,1.32,1.11,1.20,203,239,192,50,24,26,44,19,25,25,10,15,+1,+1,0,67%,69%,65%,145,165,130,38%,29%,48%,5,2,3,4,1,3
116,https://vlr.gg/player/2346/cud,2024-11-20 09:40:00,0.96,1.07,1.02,187,147,211,41,16,25,45,17,28,12,2,10,+4,+2,+2,68%,62%,73%,126,102,145,32%,29%,35%,4,2,2,0,0,0
117,https://vlr.gg/player/16852/nakya,2024-11-20 09:40:00,0.95,0.94,0.94,223,208,229,50,21,29,53,23,30,18,9,9,0,0,0,64%,62%,65%,144,136,150,33%,30%,36%,9,5,4,9,5,4
118,https://vlr.gg/player/7807/valdyn,2024-11-20 09:40:00,0.80,1.01,0.92,191,176,207,43,16,27,49,22,27,17,8,9,0,-3,+3,71%,69%,73%,137,128,143,27%,24%,30%,5,0,5,5,3,2
119,https://vlr.gg/player/11666/ray4c,2024-11-20 09:40:00,0.61,0.61,0.61,155,153,168,32,12,20,53,22,31,24,13,11,-3,-3,0,62%,69%,57%,98,98,97,12%,16%,9%,11,4,7,14,7,7
120,https://vlr.gg/player/5510/oxmann,2024-11-20 09:30:00,1.30,0.78,1.00,195,241,157,43,23,20,48,17,31,12,2,10,-1,-2,+1,66%,77%,58%,121,150,100,45%,57%,34%,3,0,3,4,2,2
121,https://vlr.gg/player/558/toronto,2024-11-20 09:30:00,1.24,0.76,0.96,204,252,161,40,22,18,47,17,30,15,2,13,-2,+1,-3,65%,65%,64%,135,162,116,19%,19%,18%,3,2,1,5,1,4
122,https://vlr.gg/player/13571/musz3kk,2024-11-20 09:30:00,0.83,0.87,0.84,180,167,196,39,15,24,47,18,29,6,3,3,-7,-3,-4,58%,65%,53%,114,105,120,29%,32%,26%,10,5,5,17,8,9
123,https://vlr.gg/player/22716/antsy,2024-11-20 09:30:00,0.73,0.88,0.82,165,150,175,36,15,21,46,18,28,13,6,7,-3,-2,-1,63%,73%,56%,103,92,112,29%,32%,28%,4,2,2,7,4,3
124,https://vlr.gg/player/4894/jn3v1ce,2024-11-20 09:30:00,0.83,0.76,0.79,136,121,155,26,10,16,44,16,28,26,13,13,-1,+2,-3,69%,81%,61%,94,72,110,25%,28%,23%,4,2,2,5,0,5
125,https://vlr.gg/player/12774/anima,2024-11-20 09:30:00,1.32,1.08,1.22,192,189,183,45,26,19,32,16,16,25,19,6,+1,0,+1,77%,81%,73%,132,129,136,37%,43%,30%,2,1,1,1,1,0
126,https://vlr.gg/player/10160/izzy,2024-11-20 09:30:00,1.34,0.93,1.17,220,245,195,52,33,19,37,19,18,10,7,3,+5,+6,-1,74%,78%,69%,143,158,122,20%,17%,29%,13,8,5,8,2,6
127,https://vlr.gg/player/10161/qutionerx,2024-11-20 09:30:00,1.33,0.87,1.14,249,271,221,56,37,19,40,21,19,15,10,5,+5,+4,+1,73%,72%,73%,164,182,139,34%,28%,50%,11,7,4,6,3,3
128,https://vlr.gg/player/10163/cyderx,2024-11-20 09:30:00,1.07,0.92,1.01,190,189,188,45,29,16,37,19,18,9,7,2,-1,-3,+2,68%,78%,54%,125,130,119,40%,37%,45%,4,1,3,5,4,1
129,https://vlr.gg/player/8041/brave,2024-11-20 09:30:00,0.89,0.90,0.89,172,174,155,34,22,12,39,24,15,28,17,11,+4,+3,+1,81%,83%,77%,109,111,108,38%,38%,39%,8,6,2,4,3,1
130,https://vlr.gg/player/9447/apyr,2024-11-20 09:25:00,0.73,1.17,1.06,295,234,317,15,3,12,15,4,11,3,1,2,+2,0,+2,63%,75%,58%,186,136,203,33%,45%,30%,7,2,5,5,2,3
131,https://vlr.gg/player/7170/q,2024-11-20 09:25:00,1.33,0.59,0.78,149,284,104,8,4,4,13,3,10,2,1,1,0,0,0,50%,75%,42%,109,156,94,32%,43%,25%,0,0,0,0,0,0
132,https://vlr.gg/player/18478/vali,2024-11-20 09:25:00,0.38,0.74,0.65,123,31,154,5,0,5,12,3,9,13,4,9,-1,0,-1,69%,50%,75%,94,22,118,22%,0%,25%,0,0,0,1,0,1
133,https://vlr.gg/player/7231/kya,2024-11-20 09:25:00,0.66,0.63,0.63,158,124,171,7,2,5,12,3,9,2,1,1,-1,0,-1,56%,75%,50%,119,91,128,18%,17%,19%,0,0,0,1,0,1
134,https://vlr.gg/player/7193/yourii,2024-11-20 09:25:00,0.83,0.31,0.44,148,243,117,9,4,5,13,3,10,4,2,2,-1,0,-1,69%,75%,67%,88,132,74,38%,50%,31%,0,0,0,1,0,1
135,https://vlr.gg/player/2818/neto,2024-11-20 09:25:00,2.38,0.90,2.01,399,491,125,23,21,2,8,5,3,5,3,2,+4,+3,+1,88%,83%,100%,237,293,70,32%,32%,33%,4,3,1,0,0,0
136,https://vlr.gg/player/2403/mizu,2024-11-20 09:25:00,0.97,1.95,1.21,274,245,364,16,11,5,10,7,3,1,1,0,+3,+3,0,81%,75%,100%,174,160,217,55%,53%,58%,4,4,0,1,1,0
137,https://vlr.gg/player/2586/hanling,2024-11-20 09:25:00,0.89,1.54,1.06,202,189,245,12,8,4,11,9,2,5,4,1,-1,-1,0,75%,75%,75%,125,119,141,31%,40%,18%,1,0,1,2,1,1
138,https://vlr.gg/player/1291/bnj,2024-11-20 09:25:00,1.01,1.09,1.03,109,67,238,6,3,3,8,4,4,11,9,2,-2,-1,-1,81%,83%,75%,73,45,156,16%,25%,9%,0,0,0,2,1,1
139,https://vlr.gg/player/15916/jotinha,2024-11-20 09:25:00,0.91,0.79,0.88,127,141,87,8,7,1,8,6,2,9,6,3,-3,-2,-1,69%,67%,75%,82,85,76,17%,15%,25%,0,0,0,3,2,1
140,https://vlr.gg/player/5498/kipperman,2024-11-20 09:20:00,1.94,1.21,1.50,264,307,235,22,10,12,9,3,6,2,0,2,0,+2,-2,80%,100%,67%,163,185,149,23%,30%,19%,4,3,1,4,1,3
141,https://vlr.gg/player/26837/poegii,2024-11-20 09:20:00,1.60,1.41,1.49,268,265,271,18,6,12,10,4,6,9,5,4,+1,0,+1,80%,88%,75%,162,168,159,20%,11%,27%,2,0,2,1,0,1
142,https://vlr.gg/player/36385/6clarity,2024-11-20 09:20:00,1.14,1.25,1.21,240,238,242,18,7,11,13,6,7,9,4,5,+1,+1,0,85%,75%,92%,162,167,158,31%,32%,30%,1,1,0,0,0,0
143,https://vlr.gg/player/90/idex,2024-11-20 09:20:00,0.41,1.25,0.91,187,103,244,13,3,10,14,6,8,4,0,4,+2,+1,+1,65%,38%,83%,105,59,137,35%,50%,32%,4,2,2,2,1,1
144,https://vlr.gg/player/4613/johnieboy,2024-11-20 09:20:00,0.11,1.20,0.76,163,61,232,10,1,9,16,8,8,11,4,7,0,0,0,70%,50%,83%,101,37,144,30%,17%,32%,1,0,1,1,0,1
145,https://vlr.gg/player/36175/rezq,2024-11-20 09:20:00,1.09,1.32,1.18,273,297,238,19,12,7,16,12,4,3,2,1,0,+1,-1,85%,92%,75%,160,166,150,22%,26%,19%,3,3,0,3,2,1
146,https://vlr.gg/player/17323/mimi,2024-11-20 09:20:00,1.04,0.93,1.00,213,239,175,15,10,5,15,10,5,6,3,3,-1,0,-1,80%,75%,88%,140,165,103,20%,20%,19%,0,0,0,1,0,1
147,https://vlr.gg/player/24149/amy,2024-11-20 09:20:00,0.60,1.20,0.84,172,109,268,12,4,8,16,10,6,4,3,1,+1,+1,0,70%,67%,75%,106,74,153,30%,40%,25%,4,3,1,3,2,1
148,https://vlr.gg/player/20064/vania,2024-11-20 09:20:00,0.42,1.20,0.73,164,111,243,11,4,7,17,11,6,9,4,5,+1,0,+1,75%,75%,75%,109,67,173,23%,21%,23%,1,0,1,0,0,0
149,https://vlr.gg/player/17320/petra,2024-11-20 09:20:00,0.40,0.20,0.32,81,119,27,5,5,0,17,11,6,6,3,3,-5,-2,-3,70%,67%,75%,57,80,24,14%,19%,0%,0,0,0,5,2,3
150,https://vlr.gg/player/15500/trent,2024-11-20 08:00:00,1.29,1.30,1.30,231,203,262,20,10,10,13,7,6,9,5,4,+2,+1,+1,78%,67%,91%,143,135,153,25%,30%,21%,3,1,2,1,0,1
151,https://vlr.gg/player/3993/jawgemo,2024-11-20 08:00:00,0.75,1.78,1.24,255,205,310,21,8,13,16,10,6,6,5,1,-2,-4,+2,83%,83%,82%,161,147,176,16%,23%,11%,2,0,2,4,4,0
152,https://vlr.gg/player/4581/jonahp,2024-11-20 08:00:00,1.03,1.12,1.07,170,141,203,11,4,7,12,6,6,16,12,4,+1,-1,+2,91%,92%,91%,124,110,139,24%,29%,21%,2,0,2,1,1,0
153,https://vlr.gg/player/7873/leaf,2024-11-20 08:00:00,1.28,0.55,0.93,165,211,117,13,9,4,14,6,8,10,6,4,+1,+1,0,74%,83%,64%,98,129,64,16%,21%,8%,3,2,1,2,1,1
154,https://vlr.gg/player/3885/valyn,2024-11-20 08:00:00,1.12,0.36,0.75,136,228,37,11,11,0,16,9,7,8,3,5,0,+1,-1,70%,75%,64%,82,126,35,24%,28%,17%,2,2,0,2,1,1
155,https://vlr.gg/player/5498/kipperman,2024-11-20 08:00:00,1.18,1.23,1.21,211,221,202,16,9,7,13,5,8,5,2,3,-1,0,-1,87%,82%,92%,151,176,129,15%,18%,13%,2,1,1,3,1,2
156,https://vlr.gg/player/36385/6clarity,2024-11-20 08:00:00,0.81,1.13,0.98,196,141,247,16,6,10,15,7,8,3,1,2,+1,0,+1,74%,73%,75%,126,88,160,30%,20%,43%,1,0,1,0,0,0
157,https://vlr.gg/player/26837/poegii,2024-11-20 08:00:00,0.90,0.87,0.88,207,186,228,15,7,8,17,7,10,3,1,2,+1,-1,+2,70%,73%,67%,133,102,162,25%,30%,22%,3,0,3,2,1,1
158,https://vlr.gg/player/4613/johnieboy,2024-11-20 08:00:00,0.70,0.96,0.84,168,150,185,14,5,9,17,8,9,7,5,2,0,0,0,74%,82%,67%,108,86,127,48%,42%,53%,3,2,1,3,2,1
159,https://vlr.gg/player/90/idex,2024-11-20 08:00:00,1.06,0.36,0.70,147,220,81,10,7,3,15,7,8,3,0,3,-3,-2,-1,61%,64%,58%,108,151,69,20%,28%,11%,2,1,1,5,3,2
160,https://vlr.gg/player/5568/sociablee,2024-11-20 08:00:00,2.24,1.26,1.59,288,364,251,21,10,11,9,2,7,0,0,0,+2,0,+2,83%,100%,75%,157,199,137,22%,35%,10%,4,0,4,2,0,2
161,https://vlr.gg/player/20144/lewn,2024-11-20 08:00:00,1.15,1.21,1.19,293,281,300,18,5,13,14,5,9,5,3,2,0,0,0,78%,83%,75%,188,179,193,38%,36%,38%,3,2,1,3,2,1
162,https://vlr.gg/player/9780/jamppi,2024-11-20 08:00:00,1.83,0.85,1.18,171,244,135,11,6,5,8,1,7,9,2,7,0,0,0,89%,100%,83%,130,174,108,41%,70%,24%,0,0,0,0,0,0
163,https://vlr.gg/player/5554/profek,2024-11-20 08:00:00,1.16,1.06,1.09,182,219,164,13,5,8,9,3,6,5,3,2,-1,0,-1,78%,100%,67%,127,146,117,33%,33%,33%,0,0,0,1,0,1
164,https://vlr.gg/player/321/chiwa,2024-11-20 08:00:00,1.18,1.05,1.09,190,180,195,12,4,8,10,3,7,4,2,2,+1,0,+1,89%,100%,83%,124,123,125,24%,44%,17%,3,1,2,2,1,1
165,https://vlr.gg/player/17323/mimi,2024-11-20 08:00:00,1.14,0.38,0.89,198,217,162,12,9,3,15,9,6,4,2,2,0,0,0,72%,75%,67%,130,139,112,47%,48%,44%,1,0,1,1,0,1
166,https://vlr.gg/player/24149/amy,2024-11-20 08:00:00,0.66,0.95,0.76,182,147,253,12,7,5,16,10,6,2,0,2,-1,-2,+1,67%,58%,83%,122,97,174,48%,43%,54%,1,0,1,2,2,0
167,https://vlr.gg/player/20064/vania,2024-11-20 08:00:00,0.88,0.43,0.73,97,93,105,6,4,2,13,7,6,8,5,3,+1,+1,0,78%,75%,83%,54,47,69,20%,44%,0%,1,1,0,0,0,0
168,https://vlr.gg/player/17320/petra,2024-11-20 08:00:00,0.92,0.07,0.64,157,207,60,10,9,1,15,9,6,2,1,1,0,0,0,44%,50%,33%,88,116,32,32%,27%,67%,2,1,1,2,1,1
169,https://vlr.gg/player/36175/rezq,2024-11-20 08:00:00,0.56,0.56,0.56,143,157,115,10,7,3,16,10,6,1,1,0,-2,-1,-1,50%,58%,33%,90,100,70,28%,28%,29%,3,3,0,5,4,1
170,https://vlr.gg/player/7193/yourii,2024-11-20 08:00:00,1.08,1.51,1.31,262,172,337,19,5,14,16,6,10,5,4,1,+3,0,+3,55%,70%,42%,162,105,209,32%,22%,37%,3,0,3,0,0,0
171,https://vlr.gg/player/7231/kya,2024-11-20 08:00:00,0.99,1.13,1.06,227,247,211,18,8,10,16,8,8,2,0,2,+2,0,+2,55%,50%,58%,138,144,133,37%,67%,24%,3,1,2,1,1,0
172,https://vlr.gg/player/9447/apyr,2024-11-20 08:00:00,0.75,0.51,0.61,133,183,93,9,6,3,16,8,8,3,1,2,-3,-2,-1,41%,30%,50%,79,100,61,24%,29%,18%,2,1,1,5,3,2
173,https://vlr.gg/player/18478/vali,2024-11-20 08:00:00,0.30,0.62,0.47,66,53,77,3,1,2,16,8,8,10,5,5,-3,-2,-1,50%,50%,50%,46,35,55,9%,20%,6%,0,0,0,3,2,1
174,https://vlr.gg/player/7170/q,2024-11-20 08:00:00,0.55,0.27,0.40,60,71,52,4,2,2,16,7,9,5,3,2,-3,-2,-1,50%,50%,50%,47,63,33,13%,29%,0%,1,0,1,4,2,2
175,https://vlr.gg/player/2540/happen,2024-11-20 08:00:00,1.65,1.76,1.70,314,311,320,24,14,10,10,6,4,10,4,6,+2,+1,+1,91%,92%,90%,198,186,212,25%,27%,23%,4,2,2,2,1,1
176,https://vlr.gg/player/47270/darkwinjett,2024-11-20 08:00:00,1.16,1.57,1.35,269,243,302,22,10,12,12,7,5,9,6,3,+1,-2,+3,73%,75%,70%,152,142,163,16%,11%,24%,5,2,3,4,4,0
177,https://vlr.gg/player/20032/treelover,2024-11-20 08:00:00,1.33,1.37,1.34,222,197,253,18,9,9,12,6,6,12,7,5,+2,-1,+3,73%,75%,70%,134,125,145,24%,30%,19%,4,1,3,2,2,0
178,https://vlr.gg/player/13238/shiio,2024-11-20 08:00:00,0.93,0.98,0.95,103,121,82,8,5,3,8,6,2,6,3,3,0,0,0,73%,67%,80%,75,82,65,20%,16%,27%,0,0,0,0,0,0
179,https://vlr.gg/player/3649/litshii,2024-11-20 08:00:00,0.93,0.60,0.78,116,135,94,8,5,3,11,6,5,11,7,4,-1,0,-1,82%,83%,80%,73,90,53,5%,4%,7%,0,0,0,1,0,1
180,https://vlr.gg/player/2818/neto,2024-11-20 08:00:00,1.09,0.25,0.92,245,270,146,11,10,1,15,12,3,2,2,0,-4,-3,-1,60%,67%,33%,175,191,112,56%,55%,60%,0,0,0,4,3,1
181,https://vlr.gg/player/1291/bnj,2024-11-20 08:00:00,1.03,0.29,0.88,206,246,50,10,10,0,14,11,3,5,4,1,0,+1,-1,47%,50%,33%,136,158,50,33%,33%,33%,2,2,0,2,1,1
182,https://vlr.gg/player/2403/mizu,2024-11-20 08:00:00,0.45,0.48,0.46,107,96,155,6,4,2,13,10,3,2,2,0,-1,0,-1,47%,50%,33%,64,68,48,31%,44%,0%,0,0,0,1,0,1
183,https://vlr.gg/player/15916/jotinha,2024-11-20 08:00:00,0.52,0.09,0.43,111,135,15,5,5,0,13,10,3,2,2,0,-5,-5,0,47%,58%,,71,85,15,17%,19%,0%,0,0,0,5,5,0
184,https://vlr.gg/player/2586/hanling,2024-11-20 08:00:00,0.18,0.13,0.17,47,53,26,2,2,0,14,11,3,2,1,1,-1,-1,0,40%,42%,33%,35,37,26,20%,11%,100%,0,0,0,1,1,0
185,https://vlr.gg/player/8369/yetujey,2024-11-20 08:00:00,2.69,2.21,2.30,368,352,373,22,4,18,4,0,4,3,1,2,+3,+1,+2,93%,100%,92%,216,198,220,25%,60%,22%,4,1,3,1,0,1
186,https://vlr.gg/player/1139/qraxs,2024-11-20 08:00:00,1.40,1.51,1.49,232,240,230,13,3,10,6,1,5,7,1,6,+2,+1,+1,80%,100%,75%,168,147,174,42%,50%,40%,2,1,1,0,0,0
187,https://vlr.gg/player/6510/atakaptan,2024-11-20 08:00:00,1.34,1.40,1.39,241,206,251,15,2,13,8,1,7,7,1,6,+2,+1,+1,80%,100%,75%,164,141,170,41%,60%,37%,2,1,1,0,0,0
188,https://vlr.gg/player/12793/xeus,2024-11-20 08:00:00,1.93,1.05,1.23,221,282,206,13,4,9,7,0,7,2,0,2,+3,0,+3,87%,100%,83%,141,172,133,39%,44%,37%,4,0,4,1,0,1
189,https://vlr.gg/player/8044/mrfalin,2024-11-20 08:00:00,0.98,0.60,0.67,122,153,114,6,2,4,9,1,8,8,2,6,+1,0,+1,80%,100%,75%,82,86,81,21%,40%,16%,1,0,1,0,0,0
190,https://vlr.gg/player/27775/techno,2024-11-20 08:00:00,1.38,1.32,1.36,260,266,254,36,23,13,20,13,7,11,5,6,0,+1,-1,79%,79%,79%,167,170,161,32%,35%,29%,4,2,2,4,1,3
191,https://vlr.gg/player/3627/hellff,2024-11-20 08:00:00,1.33,1.32,1.33,232,253,176,31,22,9,18,14,4,8,4,4,+3,+1,+2,84%,79%,93%,139,159,106,43%,54%,25%,5,3,2,2,2,0
192,https://vlr.gg/player/3639/hoax,2024-11-20 08:00:00,1.05,1.71,1.29,209,179,254,30,16,14,16,12,4,11,6,5,+1,0,+1,76%,71%,86%,141,116,183,29%,26%,32%,3,1,2,2,1,1
193,https://vlr.gg/player/27336/venka,2024-11-20 08:00:00,0.92,1.62,1.18,245,209,307,34,17,17,24,17,7,6,4,2,+4,+2,+2,76%,79%,71%,164,145,196,36%,38%,35%,9,6,3,5,4,1
194,https://vlr.gg/player/26376/deecee,2024-11-20 08:00:00,0.86,1.50,1.10,158,143,208,21,11,10,17,13,4,17,9,8,0,0,0,84%,75%,100%,122,105,152,25%,30%,20%,2,2,0,2,2,0
195,https://vlr.gg/player/46051/yuvi,2024-11-20 08:00:00,0.62,1.15,0.95,215,165,247,26,8,18,32,14,18,5,1,4,-1,0,-1,55%,57%,54%,147,111,168,24%,29%,22%,6,3,3,7,3,4
196,https://vlr.gg/player/3268/vibhorr,2024-11-20 08:00:00,0.58,1.03,0.86,164,125,197,20,5,15,30,12,18,13,5,8,0,0,0,61%,50%,67%,108,79,125,33%,28%,35%,3,1,2,3,1,2
197,https://vlr.gg/player/7485/ezzy,2024-11-20 08:00:00,0.26,0.93,0.68,131,59,172,18,3,15,30,13,17,8,0,8,-3,-1,-2,58%,43%,67%,84,41,109,31%,13%,39%,1,0,1,4,1,3
198,https://vlr.gg/player/3271/excali,2024-11-20 08:00:00,0.46,0.72,0.62,125,104,136,14,4,10,29,12,17,9,3,6,-3,-2,-1,55%,57%,54%,80,70,86,23%,14%,28%,3,1,2,6,3,3
199,https://vlr.gg/player/5536/whimp,2024-11-20 08:00:00,0.63,0.58,0.60,123,143,117,17,6,11,31,12,19,6,5,1,-1,-1,0,58%,57%,58%,86,98,80,20%,22%,19%,2,0,2,3,1,2
200,https://vlr.gg/player/13220/ja,2024-11-20 06:00:00,1.18,1.17,1.18,223,214,229,63,30,33,55,26,29,20,8,12,-4,-1,-3,69%,69%,69%,139,128,151,26%,23%,29%,3,1,2,7,2,5
201,https://vlr.gg/player/16842/mojer,2024-11-20 06:00:00,1.23,0.91,1.07,246,278,221,66,38,28,64,29,35,18,7,11,+6,+3,+3,74%,77%,72%,152,169,136,22%,28%,15%,20,11,9,14,8,6
202,https://vlr.gg/player/9747/emman,2024-11-20 06:00:00,0.92,1.02,0.97,184,190,179,49,24,25,59,29,30,35,25,10,-4,-3,-1,67%,69%,64%,122,126,118,33%,28%,38%,3,1,2,7,4,3
203,https://vlr.gg/player/7754/xavi8k,2024-11-20 06:00:00,0.89,0.71,0.80,141,142,141,35,19,16,54,25,29,30,17,13,-6,-3,-3,63%,69%,56%,102,100,104,28%,25%,30%,2,0,2,8,3,5
204,https://vlr.gg/player/7749/nexi,2024-11-20 06:00:00,0.59,0.84,0.72,175,159,190,48,22,26,65,32,33,16,4,12,-4,-5,+1,60%,51%,69%,116,113,119,26%,31%,23%,5,2,3,9,7,2
205,https://vlr.gg/player/27244/seph1roth,2024-11-20 06:00:00,0.99,1.33,1.16,242,217,268,68,31,37,53,27,26,22,11,11,+4,+1,+3,81%,79%,82%,150,137,164,31%,24%,38%,9,2,7,5,1,4
206,https://vlr.gg/player/12098/kadoom,2024-11-20 06:00:00,1.16,1.05,1.10,242,284,199,64,38,26,56,29,27,18,9,9,+8,+2,+6,73%,72%,74%,150,173,126,21%,24%,18%,20,12,8,12,10,2
207,https://vlr.gg/player/24679/cgrs,2024-11-20 06:00:00,1.07,1.12,1.09,206,197,218,57,28,29,48,23,25,25,11,14,-2,-3,+1,76%,79%,72%,137,133,141,27%,30%,24%,4,1,3,6,4,2
208,https://vlr.gg/player/13784/killua,2024-11-20 06:00:00,1.15,1.01,1.08,210,222,199,58,30,28,52,25,27,23,15,8,+5,+2,+3,73%,74%,72%,146,149,143,39%,38%,40%,9,4,5,4,2,2
209,https://vlr.gg/player/8582/laz,2024-11-20 06:00:00,1.00,0.86,0.93,177,180,172,50,29,21,52,24,28,35,11,24,-3,+1,-4,72%,77%,67%,118,121,115,31%,29%,33%,3,2,1,6,1,5
210,https://vlr.gg/player/47212/ecco,2024-11-20 05:20:00,1.08,1.15,1.11,224,239,193,49,31,18,45,29,16,14,11,3,0,-2,+2,72%,76%,67%,157,169,141,42%,49%,31%,4,0,4,4,2,2
211,https://vlr.gg/player/31628/dark,2024-11-20 05:20:00,1.04,1.01,1.03,184,192,174,38,23,15,43,26,17,26,14,12,+1,0,+1,67%,65%,70%,118,126,107,20%,20%,21%,4,1,3,3,1,2
212,https://vlr.gg/player/46768/indraa,2024-11-20 05:20:00,0.89,1.19,1.02,232,233,246,52,28,24,50,32,18,17,11,6,-5,-6,+1,66%,70%,59%,156,153,160,29%,30%,27%,9,4,5,14,10,4
213,https://vlr.gg/player/46994/tisoyy,2024-11-20 05:20:00,0.72,1.09,0.87,198,182,221,48,26,22,47,30,17,8,2,6,-4,-3,-1,66%,62%,70%,127,109,152,39%,50%,30%,4,2,2,8,5,3
214,https://vlr.gg/player/36676/novae,2024-11-20 05:20:00,0.73,0.78,0.75,154,183,110,34,21,13,47,29,18,10,7,3,-12,-10,-2,59%,54%,67%,105,129,72,27%,27%,28%,1,1,0,13,11,2
215,https://vlr.gg/player/10089/andy,2024-11-20 05:20:00,1.32,1.61,1.49,294,275,311,66,25,41,40,18,22,11,2,9,+9,+4,+5,73%,67%,78%,187,168,201,29%,38%,24%,12,7,5,3,3,0
216,https://vlr.gg/player/48913/zek,2024-11-20 05:20:00,0.85,1.47,1.21,260,189,305,58,17,41,48,21,27,14,5,9,+10,-1,+11,77%,63%,86%,169,125,201,25%,30%,22%,13,1,12,3,2,1
217,https://vlr.gg/player/31629/muzz,2024-11-20 05:20:00,1.15,1.05,1.09,198,206,201,45,20,25,42,16,26,24,11,13,0,-2,+2,69%,67%,70%,139,145,135,33%,30%,35%,5,2,3,5,4,1
218,https://vlr.gg/player/28843/abbas,2024-11-20 05:20:00,0.81,0.91,0.86,176,148,196,40,16,24,48,18,30,20,3,17,-1,-1,0,64%,59%,68%,119,102,131,24%,27%,21%,5,0,5,6,1,5
219,https://vlr.gg/player/33714/vina,2024-11-20 05:20:00,0.38,1.04,0.77,152,127,170,9,3,6,15,7,8,4,0,4,+3,+1,+2,55%,38%,67%,102,80,117,17%,6%,25%,3,1,2,0,0,0
220,https://vlr.gg/player/34257/strame,2024-11-20 05:20:00,0.53,0.51,0.51,94,91,96,14,5,9,28,12,16,12,6,6,-1,-2,+1,64%,58%,68%,72,68,75,25%,26%,24%,4,2,2,5,4,1
221,https://vlr.gg/player/4428/udotan,2024-11-20 04:00:00,1.55,1.44,1.51,252,273,227,32,20,12,13,7,6,5,2,3,+3,+3,0,94%,94%,93%,161,171,148,39%,47%,31%,3,3,0,0,0,0
222,https://vlr.gg/player/5796/kr1stal,2024-11-20 04:00:00,1.61,1.35,1.49,221,206,252,27,15,12,13,4,9,9,5,4,+5,+3,+2,84%,89%,79%,157,149,168,32%,39%,25%,5,3,2,0,0,0
223,https://vlr.gg/player/7437/kellys,2024-11-20 04:00:00,1.86,0.82,1.41,278,318,217,32,22,10,17,7,10,7,7,0,+3,+3,0,78%,89%,64%,175,205,137,24%,30%,16%,5,3,2,2,0,2
224,https://vlr.gg/player/13219/papi,2024-11-20 04:00:00,1.60,0.87,1.28,228,247,187,29,19,10,15,7,8,9,6,3,+1,0,+1,88%,89%,86%,145,169,114,40%,36%,48%,3,0,3,2,0,2
225,https://vlr.gg/player/44259/patrickwho,2024-11-20 04:00:00,0.56,1.19,0.84,177,159,199,23,11,12,22,14,8,4,2,2,-2,-1,-1,72%,72%,71%,123,103,150,47%,56%,41%,5,4,1,7,5,2
226,https://vlr.gg/player/46532/satoshi,2024-11-20 04:00:00,1.13,0.88,0.99,231,204,243,24,10,14,28,10,18,8,4,4,-4,-2,-2,56%,57%,56%,158,141,172,42%,57%,34%,2,0,2,6,2,4
227,https://vlr.gg/player/49476/zhe,2024-11-20 04:00:00,0.66,0.78,0.73,171,146,186,18,7,11,28,11,17,8,5,3,-2,0,-2,56%,64%,50%,107,91,120,24%,20%,28%,1,1,0,3,1,2
228,https://vlr.gg/player/15885/minato,2024-11-20 04:00:00,1.15,0.17,0.59,158,287,77,17,13,4,30,12,18,4,3,1,-3,+2,-5,44%,64%,28%,108,181,51,19%,23%,12%,6,5,1,9,3,6
229,https://vlr.gg/player/39494/yueluo,2024-11-20 04:00:00,0.51,0.60,0.56,104,82,119,10,4,6,27,11,16,6,4,2,+2,0,+2,47%,57%,39%,68,57,76,24%,19%,27%,2,0,2,0,0,0
230,https://vlr.gg/player/3531/midnight,2024-11-20 04:00:00,0.65,0.16,0.37,99,137,76,11,7,4,30,12,18,10,4,6,-3,-2,-1,59%,64%,56%,72,108,45,26%,28%,21%,0,0,0,3,2,1
231,https://vlr.gg/player/22831/art,2024-11-20 02:30:00,1.22,1.29,1.25,190,180,201,46,20,26,32,14,18,25,8,17,-2,-2,0,80%,79%,82%,128,130,127,29%,29%,29%,2,1,1,4,3,1
232,https://vlr.gg/player/15078/noir,2024-11-20 02:30:00,1.27,1.19,1.23,262,275,250,56,29,27,42,20,22,18,3,15,+3,+3,0,75%,71%,79%,174,176,172,26%,26%,26%,7,4,3,4,1,3
233,https://vlr.gg/player/43129/dasani,2024-11-20 02:30:00,1.02,1.05,1.04,253,235,254,55,24,31,46,20,26,7,4,3,0,0,0,70%,64%,76%,151,138,162,33%,34%,31%,13,6,7,13,6,7
234,https://vlr.gg/player/22829/ibrocky,2024-11-20 02:30:00,1.05,1.02,1.03,187,158,211,39,17,22,36,16,20,36,14,22,-1,-2,+1,80%,75%,85%,123,101,142,25%,22%,26%,3,1,2,4,3,1
235,https://vlr.gg/player/33061/brock,2024-11-20 02:30:00,0.67,1.01,0.86,188,162,215,35,13,22,47,22,25,29,14,15,+1,-3,+4,72%,68%,76%,134,119,147,19%,21%,18%,6,0,6,5,3,2
236,https://vlr.gg/player/3287/exempt,2024-11-20 02:30:00,1.26,1.01,1.15,193,213,174,42,27,15,41,21,20,29,13,16,+2,-1,+3,74%,73%,75%,126,142,107,31%,32%,30%,6,1,5,4,2,2
237,https://vlr.gg/player/31632/zenox,2024-11-20 02:30:00,0.92,1.29,1.09,205,182,234,44,20,24,41,24,17,14,6,8,-1,-1,0,69%,70%,68%,144,131,159,22%,16%,29%,5,3,2,6,4,2
238,https://vlr.gg/player/5436/azoh,2024-11-20 02:30:00,0.74,1.02,0.87,177,161,200,37,18,19,47,26,21,23,12,11,-1,-3,+2,70%,76%,64%,119,108,131,24%,30%,20%,5,2,3,6,5,1
239,https://vlr.gg/player/41185/kaza,2024-11-20 02:30:00,1.00,0.64,0.84,167,199,137,34,24,10,49,26,23,25,12,13,0,+2,-2,70%,73%,68%,118,133,100,22%,29%,14%,4,3,1,4,1,3
240,https://vlr.gg/player/5240/indie,2024-11-20 02:30:00,0.65,0.92,0.76,204,203,217,46,22,24,53,31,22,10,8,2,-1,-2,+1,66%,70%,61%,140,139,141,26%,26%,27%,10,5,5,11,7,4
241,https://vlr.gg/player/29688/mikee,2024-11-19 21:40:00,1.59,1.33,1.48,289,325,224,39,25,14,25,15,10,13,8,5,+5,+5,0,79%,86%,71%,181,214,138,36%,42%,27%,9,6,3,4,1,3
242,https://vlr.gg/player/4385/monsi,2024-11-19 21:40:00,1.00,1.55,1.24,196,137,269,27,11,16,20,10,10,14,7,7,0,-2,+2,77%,73%,82%,126,87,177,38%,48%,35%,2,0,2,2,2,0
243,https://vlr.gg/player/34400/bao,2024-11-19 21:40:00,0.91,1.49,1.17,173,106,266,26,9,17,21,11,10,20,11,9,0,-2,+2,74%,68%,82%,110,63,170,35%,19%,45%,2,0,2,2,2,0
244,https://vlr.gg/player/34057/jerrwin,2024-11-19 21:40:00,1.25,0.72,1.02,221,275,152,31,21,10,29,15,14,11,4,7,0,+3,-3,74%,73%,76%,137,162,106,27%,26%,27%,7,6,1,7,3,4
245,https://vlr.gg/player/3874/teague,2024-11-19 21:40:00,0.96,0.75,0.87,130,135,128,18,11,7,24,12,12,20,9,11,-2,-2,0,64%,68%,59%,87,93,80,20%,15%,25%,1,0,1,3,2,1
246,https://vlr.gg/player/30470/kyu,2024-11-19 21:40:00,1.24,1.14,1.18,226,225,232,32,13,19,27,12,15,9,7,2,-1,0,-1,74%,82%,68%,157,157,157,30%,27%,33%,3,2,1,4,2,2
247,https://vlr.gg/player/3227/screwface,2024-11-19 21:40:00,1.09,0.99,1.04,188,192,191,25,12,13,24,11,13,14,5,9,+1,+1,0,74%,71%,77%,138,129,144,30%,27%,33%,3,2,1,2,1,1
248,https://vlr.gg/player/24865/acrian,2024-11-19 21:40:00,0.89,0.66,0.76,159,203,129,21,13,8,28,13,15,14,6,8,+2,+1,+1,67%,71%,64%,108,136,86,27%,46%,11%,4,1,3,2,0,2
249,https://vlr.gg/player/13084/smiley,2024-11-19 21:40:00,0.85,0.63,0.73,153,200,127,21,11,10,30,14,16,10,6,4,-2,0,-2,69%,71%,68%,108,134,88,38%,45%,31%,1,1,0,3,1,2
250,https://vlr.gg/player/29076/satellite,2024-11-19 21:40:00,0.44,0.78,0.62,154,126,172,20,7,13,32,14,18,8,4,4,-3,-3,0,56%,59%,55%,100,78,118,19%,17%,20%,7,2,5,10,5,5
251,https://vlr.gg/player/3874/teague,2024-11-19 19:30:00,1.34,1.13,1.22,204,241,172,32,15,17,24,12,12,16,5,11,+2,+1,+1,76%,72%,79%,119,158,91,29%,30%,28%,4,1,3,2,0,2
252,https://vlr.gg/player/34057/jerrwin,2024-11-19 19:30:00,0.80,1.37,1.12,256,188,312,36,12,24,31,13,18,14,4,10,+2,0,+2,71%,61%,79%,162,112,200,24%,15%,27%,8,3,5,6,3,3
253,https://vlr.gg/player/29688/mikee,2024-11-19 19:30:00,0.86,1.19,1.05,224,186,251,34,12,22,30,13,17,10,2,8,+4,0,+4,76%,72%,79%,147,118,169,37%,52%,30%,9,4,5,5,4,1
254,https://vlr.gg/player/34400/bao,2024-11-19 19:30:00,1.01,0.98,1.00,195,206,189,28,12,16,27,11,16,19,9,10,+2,+1,+1,81%,83%,79%,116,128,108,25%,30%,22%,2,1,1,0,0,0
255,https://vlr.gg/player/4385/monsi,2024-11-19 19:30:00,0.98,0.98,0.98,178,184,171,26,13,13,23,8,15,13,2,11,-4,-2,-2,69%,61%,75%,116,114,117,36%,30%,40%,1,0,1,5,2,3
256,https://vlr.gg/player/27879/clewy,2024-11-19 19:30:00,0.95,1.21,1.06,215,186,252,33,17,16,31,18,13,8,2,6,0,0,0,74%,67%,83%,137,124,154,53%,57%,50%,4,2,2,4,2,2
257,https://vlr.gg/player/39021/notexxd,2024-11-19 19:30:00,1.20,0.83,1.04,184,196,166,26,16,10,31,17,14,23,14,9,-1,0,-1,71%,75%,67%,118,123,111,33%,26%,45%,3,2,1,4,2,2
258,https://vlr.gg/player/29074/sonofcar,2024-11-19 19:30:00,0.88,1.09,0.97,197,213,180,28,16,12,32,20,12,12,10,2,-2,-5,+3,71%,71%,72%,139,146,130,17%,14%,27%,7,3,4,9,8,1
259,https://vlr.gg/player/2171/cavern,2024-11-19 19:30:00,0.67,1.13,0.87,180,160,207,27,14,13,31,19,12,15,9,6,-2,0,-2,67%,67%,67%,115,103,131,36%,38%,33%,4,2,2,6,2,4
260,https://vlr.gg/player/5128/polkan,2024-11-19 19:30:00,0.83,0.51,0.69,137,166,98,21,16,5,32,18,14,10,4,6,-1,-1,0,64%,63%,67%,90,110,62,23%,26%,17%,0,0,0,1,1,0
261,https://vlr.gg/player/29076/satellite,2024-11-19 18:40:00,1.06,1.47,1.25,262,228,302,54,26,28,40,23,17,13,6,7,+7,0,+7,79%,79%,79%,175,159,194,28%,31%,26%,14,5,9,7,5,2
262,https://vlr.gg/player/30470/kyu,2024-11-19 18:40:00,1.26,1.06,1.17,187,204,167,45,28,17,36,20,16,18,7,11,0,-1,+1,75%,79%,71%,135,152,115,30%,29%,32%,2,1,1,2,2,0
263,https://vlr.gg/player/24865/acrian,2024-11-19 18:40:00,1.11,1.19,1.15,190,185,197,41,21,20,35,19,16,20,10,10,-1,+2,-3,79%,88%,68%,130,127,134,19%,18%,20%,3,2,1,4,0,4
264,https://vlr.gg/player/13084/smiley,2024-11-19 18:40:00,1.13,0.90,1.02,173,221,117,42,28,14,38,22,16,19,11,8,+1,+2,-1,74%,79%,68%,114,145,77,41%,46%,32%,6,5,1,5,3,2
265,https://vlr.gg/player/3227/screwface,2024-11-19 18:40:00,0.79,0.84,0.81,171,168,176,33,19,14,46,24,22,20,8,12,-4,-4,0,66%,61%,71%,123,122,124,28%,31%,26%,7,3,4,11,7,4
266,https://vlr.gg/player/8419/reduxx,2024-11-19 18:40:00,0.87,1.16,1.03,223,211,234,50,20,30,46,22,24,10,4,6,0,-3,+3,74%,71%,76%,147,139,154,23%,19%,27%,9,3,6,9,6,3
267,https://vlr.gg/player/3980/governor,2024-11-19 18:40:00,0.64,1.19,0.94,190,142,232,36,11,25,45,21,24,17,6,11,+7,+3,+4,64%,57%,70%,135,105,160,35%,31%,37%,11,4,7,4,1,3
268,https://vlr.gg/player/11118/skuba,2024-11-19 18:40:00,1.06,0.85,0.94,165,161,170,35,16,19,42,17,25,23,13,10,-5,0,-5,64%,64%,64%,119,111,126,25%,31%,22%,1,1,0,6,1,5
269,https://vlr.gg/player/261/victor,2024-11-19 18:40:00,0.95,0.92,0.93,181,201,164,41,21,20,41,18,23,11,4,7,-5,-4,-1,75%,79%,73%,126,134,118,32%,33%,30%,4,3,1,9,7,2
270,https://vlr.gg/player/612/mitch,2024-11-19 18:40:00,1.17,0.64,0.88,158,176,146,33,19,14,41,15,26,19,6,13,0,0,0,61%,64%,58%,113,132,96,23%,34%,15%,4,1,3,4,1,3
271,https://vlr.gg/player/3227/screwface,2024-11-19 16:00:00,0.86,1.44,1.15,226,171,280,37,13,24,34,17,17,20,8,12,+4,0,+4,79%,69%,88%,154,125,184,33%,37%,30%,7,3,4,3,3,0
272,https://vlr.gg/player/24865/acrian,2024-11-19 16:00:00,1.17,1.12,1.14,191,187,190,38,19,19,27,13,14,12,5,7,-4,-1,-3,73%,65%,81%,128,123,133,23%,28%,19%,2,1,1,6,2,4
273,https://vlr.gg/player/30470/kyu,2024-11-19 16:00:00,0.81,1.45,1.13,192,157,229,34,13,21,31,18,13,22,10,12,+1,-2,+3,85%,77%,92%,131,101,161,20%,28%,16%,3,0,3,2,2,0
274,https://vlr.gg/player/29076/satellite,2024-11-19 16:00:00,1.00,1.26,1.13,269,276,270,48,24,24,39,21,18,11,4,7,+6,-2,+8,75%,62%,88%,176,175,177,22%,32%,15%,14,5,9,8,7,1
275,https://vlr.gg/player/13084/smiley,2024-11-19 16:00:00,1.43,0.74,1.08,184,200,162,36,20,16,30,12,18,11,6,5,-3,+1,-4,67%,81%,54%,121,137,106,40%,38%,42%,2,2,0,5,1,4
276,https://vlr.gg/player/765/jerk,2024-11-19 16:00:00,0.96,1.03,1.00,145,131,162,27,12,15,32,17,15,17,9,8,0,-2,+2,65%,58%,73%,106,102,111,21%,21%,21%,2,0,2,2,2,0
277,https://vlr.gg/player/17865/nahsie,2024-11-19 16:00:00,0.98,0.96,0.97,177,188,172,32,16,16,37,20,17,21,14,7,0,-1,+1,65%,62%,69%,118,120,116,30%,33%,27%,4,1,3,4,2,2
278,https://vlr.gg/player/9017/moobs,2024-11-19 16:00:00,0.78,1.01,0.90,189,181,201,35,17,18,38,20,18,9,3,6,+1,-1,+2,71%,69%,73%,117,111,122,42%,42%,42%,7,2,5,6,3,3
279,https://vlr.gg/player/9837/flare,2024-11-19 16:00:00,0.81,0.91,0.86,211,216,198,38,19,19,43,24,19,10,5,5,-1,0,-1,65%,69%,62%,143,145,141,32%,25%,41%,4,3,1,5,3,2
280,https://vlr.gg/player/9063/infiltrator,2024-11-19 16:00:00,0.72,0.77,0.74,188,205,168,29,16,13,43,23,20,14,7,7,-4,-4,0,54%,50%,58%,124,135,114,28%,33%,22%,7,3,4,11,7,4
281,https://vlr.gg/player/261/victor,2024-11-19 16:00:00,1.23,1.21,1.22,242,231,250,38,21,17,31,16,15,17,11,6,+3,+1,+2,82%,88%,76%,161,149,174,34%,46%,24%,6,3,3,3,2,1
282,https://vlr.gg/player/8419/reduxx,2024-11-19 16:00:00,1.05,1.40,1.22,261,277,246,43,24,19,33,21,12,8,4,4,+2,0,+2,69%,63%,76%,161,166,156,17%,15%,21%,8,5,3,6,5,1
283,https://vlr.gg/player/3980/governor,2024-11-19 16:00:00,1.07,1.38,1.21,240,213,268,37,17,20,31,18,13,15,9,6,+2,+1,+1,82%,83%,81%,168,162,175,38%,41%,36%,6,3,3,4,2,2
284,https://vlr.gg/player/11118/skuba,2024-11-19 16:00:00,1.30,0.79,1.06,181,230,128,29,19,10,27,13,14,17,10,7,0,0,0,84%,88%,81%,129,159,95,18%,16%,23%,1,0,1,1,0,1
285,https://vlr.gg/player/612/mitch,2024-11-19 16:00:00,0.38,1.36,0.82,154,98,218,24,8,16,31,19,12,22,9,13,-2,-4,+2,67%,58%,76%,104,64,149,35%,35%,35%,4,0,4,6,4,2
286,https://vlr.gg/player/48025/alym,2024-11-19 16:00:00,1.08,1.29,1.19,273,292,255,42,20,22,35,19,16,12,4,8,0,-1,+1,73%,71%,75%,171,190,155,31%,32%,30%,10,5,5,10,6,4
287,https://vlr.gg/player/62/huynh,2024-11-19 16:00:00,0.87,1.42,1.17,225,179,270,34,13,21,31,16,15,18,8,10,-5,-5,0,69%,67%,71%,145,116,170,27%,34%,22%,4,1,3,9,6,3
288,https://vlr.gg/player/6445/sogo,2024-11-19 16:00:00,0.78,1.11,0.96,212,170,246,34,13,21,35,16,19,10,4,6,-1,-1,0,64%,62%,67%,140,113,163,24%,29%,22%,2,0,2,3,1,2
289,https://vlr.gg/player/9094/kess,2024-11-19 16:00:00,0.76,0.84,0.80,150,141,156,23,10,13,35,16,19,27,10,17,+2,+1,+1,76%,71%,79%,96,109,84,23%,28%,19%,3,1,2,1,0,1
290,https://vlr.gg/player/10053/fireballops,2024-11-19 16:00:00,0.63,0.48,0.55,117,129,110,20,10,10,35,15,20,10,4,6,-1,-1,0,73%,67%,79%,80,94,69,45%,50%,40%,1,0,1,2,1,1
291,https://vlr.gg/player/8838/chanformer,2024-11-19 15:00:00,1.32,1.30,1.31,262,257,263,41,18,23,28,11,17,13,8,5,0,+2,-2,71%,76%,67%,172,171,173,27%,36%,20%,4,2,2,4,0,4
292,https://vlr.gg/player/1848/incredible,2024-11-19 15:00:00,1.33,1.15,1.23,209,211,211,35,17,18,27,11,16,24,10,14,+3,+2,+1,84%,90%,79%,139,137,141,22%,35%,15%,6,4,2,3,2,1
293,https://vlr.gg/player/11330/mcd,2024-11-19 15:00:00,1.29,0.85,1.06,164,180,150,28,16,12,26,9,17,13,2,11,0,-1,+1,78%,76%,79%,118,118,119,24%,25%,23%,3,1,2,3,2,1
294,https://vlr.gg/player/2617/leare,2024-11-19 15:00:00,0.94,1.07,1.01,216,201,226,33,14,19,32,15,17,14,7,7,-3,-1,-2,80%,81%,79%,145,135,153,30%,36%,25%,5,4,1,8,5,3
295,https://vlr.gg/player/10270/dev0,2024-11-19 15:00:00,1.09,0.81,0.94,182,181,188,29,13,16,29,12,17,19,14,5,-1,+1,-2,76%,81%,71%,131,127,134,36%,28%,45%,4,1,3,5,0,5
296,https://vlr.gg/player/12372/szoren,2024-11-19 15:00:00,1.69,0.69,1.22,236,320,145,39,29,10,32,15,17,17,10,7,0,+1,-1,71%,92%,48%,144,190,91,21%,21%,23%,5,3,2,5,2,3
297,https://vlr.gg/player/31350/deqadz,2024-11-19 15:00:00,0.92,1.03,0.98,203,204,200,30,16,14,32,17,15,13,5,8,-1,0,-1,60%,63%,57%,132,133,131,23%,25%,20%,5,3,2,6,3,3
298,https://vlr.gg/player/42371/t0ba,2024-11-19 15:00:00,0.82,0.83,0.83,179,195,162,28,17,11,33,19,14,7,4,3,-1,0,-1,64%,67%,62%,112,121,103,26%,26%,26%,4,2,2,5,2,3
299,https://vlr.gg/player/29630/porkychop,2024-11-19 15:00:00,0.38,1.16,0.75,172,131,221,28,10,18,37,21,16,8,5,3,0,0,0,58%,54%,62%,120,92,153,22%,20%,24%,5,3,2,5,3,2
300,https://vlr.gg/player/6364/mishu,2024-11-19 15:00:00,0.86,0.48,0.69,122,155,84,17,12,5,32,16,16,14,7,7,+3,+3,0,71%,88%,52%,93,115,68,30%,32%,26%,4,3,1,1,0,1
301,https://vlr.gg/player/5854/z3ro,2024-11-19 15:00:00,0.79,1.65,1.16,233,164,325,18,7,11,15,9,6,9,3,6,0,-1,+1,76%,75%,78%,154,106,218,50%,39%,61%,2,1,1,2,2,0
302,https://vlr.gg/player/1944/cayden,2024-11-19 15:00:00,0.76,1.60,1.12,195,145,263,15,5,10,14,10,4,8,6,2,0,0,0,71%,58%,89%,134,99,179,26%,23%,29%,0,0,0,0,0,0
303,https://vlr.gg/player/23347/alannn,2024-11-19 15:00:00,0.87,1.08,0.96,225,213,241,16,9,7,16,10,6,3,1,2,+4,+1,+3,62%,58%,67%,147,140,156,39%,42%,35%,6,3,3,2,2,0
304,https://vlr.gg/player/24069/mochi,2024-11-19 15:00:00,0.71,0.75,0.73,152,162,140,9,6,3,15,9,6,8,2,6,-2,0,-2,67%,58%,78%,117,118,116,38%,47%,29%,1,1,0,3,1,2
305,https://vlr.gg/player/18400/bipo,2024-11-19 15:00:00,0.28,0.49,0.37,132,119,151,8,4,4,18,11,7,3,1,2,+1,-2,+3,62%,42%,89%,89,81,100,10%,13%,6%,3,0,3,2,2,0
306,https://vlr.gg/player/12528/disisjohn,2024-11-19 15:00:00,1.99,1.70,1.82,359,394,333,25,12,13,14,7,7,8,3,5,+2,+2,0,86%,89%,83%,238,248,231,24%,38%,14%,4,2,2,2,0,2
307,https://vlr.gg/player/4629/azury,2024-11-19 15:00:00,0.61,1.50,1.12,158,90,209,13,3,10,11,6,5,5,1,4,+1,0,+1,76%,67%,83%,106,59,142,29%,20%,32%,1,0,1,0,0,0
308,https://vlr.gg/player/4325/musashi,2024-11-19 15:00:00,0.98,1.14,1.07,211,180,235,16,6,10,14,7,7,6,2,4,-6,-5,-1,76%,67%,83%,152,135,165,22%,26%,19%,1,0,1,7,5,2
309,https://vlr.gg/player/3753/obnoks,2024-11-19 15:00:00,1.06,0.88,0.95,156,209,118,12,7,5,15,8,7,10,4,6,0,-1,+1,81%,78%,83%,98,134,72,37%,28%,50%,1,0,1,1,1,0
310,https://vlr.gg/player/37969/ellie,2024-11-19 15:00:00,0.13,1.42,0.87,160,65,231,12,1,11,13,8,5,5,3,2,0,-1,+1,71%,56%,83%,103,45,146,34%,11%,45%,2,0,2,2,1,1
311,https://vlr.gg/player/22291/razziss,2024-11-19 14:15:00,1.40,0.62,0.88,161,220,132,11,6,5,11,3,8,2,1,1,-3,-1,-2,61%,67%,58%,118,151,101,40%,67%,25%,1,0,1,4,1,3
312,https://vlr.gg/player/8595/skygi,2024-11-19 14:15:00,1.62,0.49,0.86,169,315,97,11,7,4,14,4,10,4,2,2,+3,+2,+1,56%,67%,50%,104,194,59,26%,20%,43%,4,2,2,1,0,1
313,https://vlr.gg/player/15487/aqua,2024-11-19 14:15:00,0.96,0.56,0.69,165,258,119,9,5,4,14,5,9,6,1,5,+1,+2,-1,67%,83%,58%,115,188,78,29%,26%,33%,3,2,1,2,0,2
314,https://vlr.gg/player/22495/mochi,2024-11-19 14:15:00,0.52,0.51,0.51,111,88,123,5,1,4,14,5,9,8,3,5,-1,0,-1,50%,50%,50%,74,67,77,16%,14%,17%,0,0,0,1,0,1
315,https://vlr.gg/player/16012/akira,2024-11-19 14:15:00,0.03,0.67,0.44,132,61,168,7,1,6,14,6,8,1,1,0,-2,-1,-1,44%,33%,50%,91,38,117,60%,25%,73%,0,0,0,2,1,1
316,https://vlr.gg/player/2996/neiker,2024-11-19 14:15:00,2.00,0.93,1.65,290,311,250,19,14,5,8,3,5,6,1,5,+3,+3,0,83%,83%,83%,177,194,141,51%,60%,33%,3,3,0,0,0,0
317,https://vlr.gg/player/2893/hastack,2024-11-19 14:15:00,1.12,1.62,1.29,177,145,243,12,6,6,8,5,3,5,3,2,-1,-1,0,89%,83%,100%,120,93,174,19%,17%,21%,0,0,0,1,1,0
318,https://vlr.gg/player/5487/adm1k,2024-11-19 14:15:00,1.14,1.53,1.27,166,129,242,11,5,6,5,2,3,0,0,0,+2,+1,+1,83%,83%,83%,122,95,177,35%,33%,38%,3,2,1,1,1,0
319,https://vlr.gg/player/22154/pika,2024-11-19 14:15:00,1.17,1.37,1.24,189,168,232,11,7,4,11,7,4,9,6,3,+2,+2,0,67%,67%,67%,130,111,169,38%,42%,31%,2,2,0,0,0,0
320,https://vlr.gg/player/22501/amore,2024-11-19 14:15:00,1.36,0.40,1.04,219,269,122,14,12,2,11,6,5,3,1,2,-4,-1,-3,83%,83%,83%,159,191,96,34%,31%,44%,2,1,1,6,2,4
321,https://vlr.gg/player/19362/lyda,2024-11-19 14:15:00,1.53,1.05,1.32,307,369,225,23,16,7,14,9,5,1,0,1,+7,+6,+1,81%,75%,89%,202,243,148,28%,27%,32%,9,6,3,2,0,2
322,https://vlr.gg/player/19776/jrayn,2024-11-19 14:15:00,0.79,1.82,1.23,220,116,360,17,5,12,11,6,5,5,2,3,+3,+1,+2,76%,67%,89%,135,74,216,44%,33%,48%,3,1,2,0,0,0
323,https://vlr.gg/player/3557/skylen,2024-11-19 14:15:00,1.23,0.74,1.02,189,200,174,15,10,5,12,6,6,8,4,4,-1,-1,0,81%,83%,78%,121,127,113,29%,24%,40%,0,0,0,1,1,0
324,https://vlr.gg/player/22792/jiex,2024-11-19 14:15:00,1.08,0.87,0.99,131,133,129,10,6,4,12,6,6,10,6,4,0,0,0,67%,67%,67%,107,119,92,29%,32%,25%,0,0,0,0,0,0
325,https://vlr.gg/player/573/cned,2024-11-19 14:15:00,0.87,0.86,0.86,227,254,192,16,10,6,16,10,6,3,2,1,+2,0,+2,76%,75%,78%,155,182,120,48%,44%,55%,4,2,2,2,2,0
326,https://vlr.gg/player/292/fit1nho,2024-11-19 14:15:00,0.81,1.60,1.26,236,160,293,19,6,13,15,7,8,1,0,1,-2,-2,0,62%,56%,67%,149,104,182,68%,88%,61%,2,0,2,4,2,2
327,https://vlr.gg/player/7220/saiz,2024-11-19 14:15:00,1.05,0.97,1.00,200,208,194,15,7,8,16,7,9,3,0,3,0,+1,-1,67%,67%,67%,136,132,139,42%,47%,38%,2,2,0,2,1,1
328,https://vlr.gg/player/20058/devilasxa,2024-11-19 14:15:00,1.07,0.65,0.83,179,196,167,12,6,6,17,7,10,7,5,2,-2,-1,-1,57%,78%,42%,114,113,116,22%,17%,26%,1,0,1,3,1,2
329,https://vlr.gg/player/2864/ease,2024-11-19 14:15:00,0.87,0.76,0.81,141,141,142,10,4,6,15,6,9,6,3,3,-4,-2,-2,71%,78%,67%,97,122,79,18%,24%,14%,0,0,0,4,2,2
330,https://vlr.gg/player/5199/guardy,2024-11-19 14:15:00,0.90,0.47,0.65,152,192,122,9,5,4,18,7,11,8,3,5,-3,-1,-2,62%,56%,67%,111,142,87,25%,35%,16%,0,0,0,3,1,2
331,https://vlr.gg/player/23082/cobra,2024-11-19 13:00:00,1.37,1.20,1.29,271,265,277,23,12,11,17,8,9,4,2,2,+1,+1,0,83%,83%,82%,177,189,163,38%,42%,33%,3,1,2,2,0,2
332,https://vlr.gg/player/48956/bujaxd,2024-11-19 13:00:00,0.93,1.03,0.98,219,232,205,18,9,9,18,9,9,9,4,5,0,+1,-1,70%,67%,73%,140,145,134,14%,8%,25%,3,3,0,3,2,1
333,https://vlr.gg/player/48953/t1tan,2024-11-19 13:00:00,0.84,0.96,0.90,218,233,202,18,10,8,19,11,8,4,3,1,+4,+2,+2,78%,75%,82%,131,148,113,44%,45%,42%,6,3,3,2,1,1
334,https://vlr.gg/player/48952/xpiryy,2024-11-19 13:00:00,1.15,0.47,0.82,214,219,211,18,11,7,20,9,11,7,4,3,-2,-1,-1,70%,83%,55%,145,147,144,27%,26%,29%,0,0,0,2,1,1
335,https://vlr.gg/player/48955/dubstep,2024-11-19 13:00:00,0.81,0.54,0.68,184,190,178,13,7,6,19,9,10,15,12,3,0,+1,-1,61%,75%,45%,133,136,129,21%,16%,27%,1,1,0,1,0,1
336,https://vlr.gg/player/48951/hassan,2024-11-19 13:00:00,1.99,2.07,2.03,356,368,346,32,16,16,13,6,7,6,3,3,-1,0,-1,100%,100%,100%,246,262,231,37%,42%,33%,0,0,0,1,0,1
337,https://vlr.gg/player/46233/kz,2024-11-19 13:00:00,0.96,1.25,1.12,265,220,307,21,8,13,21,10,11,6,4,2,+2,+2,0,70%,73%,67%,162,135,188,20%,38%,12%,7,4,3,5,2,3
338,https://vlr.gg/player/33833/pepecho,2024-11-19 13:00:00,1.12,0.79,0.94,170,190,152,13,7,6,18,8,10,10,6,4,-2,-1,-1,52%,64%,42%,118,136,101,31%,47%,16%,2,1,1,4,2,2
339,https://vlr.gg/player/48950/zeni,2024-11-19 13:00:00,0.85,0.84,0.85,230,266,198,18,12,6,21,9,12,13,5,8,-1,0,-1,65%,82%,50%,151,159,143,13%,18%,8%,1,1,0,2,1,1
340,https://vlr.gg/player/42514/aleexfdz,2024-11-19 13:00:00,0.69,0.43,0.56,110,109,111,9,5,4,18,8,10,8,4,4,-1,0,-1,74%,73%,75%,81,90,74,24%,18%,33%,0,0,0,1,0,1
341,https://vlr.gg/player/1284/mikee,2024-11-19 13:00:00,1.46,1.08,1.27,242,325,160,26,17,9,21,12,9,7,2,5,-1,+1,-2,77%,73%,80%,142,193,91,32%,39%,22%,2,1,1,3,0,3
342,https://vlr.gg/player/114/enzo,2024-11-19 13:00:00,0.83,1.71,1.27,217,173,262,20,8,12,18,12,6,12,3,9,+1,0,+1,70%,60%,80%,165,132,197,24%,25%,24%,2,1,1,1,1,0
343,https://vlr.gg/player/13258/cyvoph,2024-11-19 13:00:00,0.32,1.87,1.09,259,133,386,28,6,22,23,14,9,5,4,1,-2,-4,+2,63%,47%,80%,159,86,233,22%,23%,21%,7,3,4,9,7,2
344,https://vlr.gg/player/16321/nelo,2024-11-19 13:00:00,0.63,0.83,0.73,141,133,150,14,6,8,21,12,9,17,10,7,0,-1,+1,67%,67%,67%,92,86,99,30%,22%,37%,1,0,1,1,1,0
345,https://vlr.gg/player/257/bramz,2024-11-19 13:00:00,0.60,0.84,0.72,172,115,231,18,6,12,25,12,13,9,7,2,+2,+1,+1,63%,60%,67%,107,80,134,29%,43%,23%,3,1,2,1,0,1
346,https://vlr.gg/player/11322/sevire,2024-11-19 13:00:00,0.67,2.12,1.39,292,187,397,29,8,21,19,13,6,11,7,4,-1,-3,+2,77%,67%,87%,180,118,241,37%,29%,43%,4,0,4,5,3,2
347,https://vlr.gg/player/40004/globex,2024-11-19 13:00:00,1.10,1.31,1.21,289,315,265,27,13,14,23,14,9,13,6,7,+4,+1,+3,77%,73%,80%,196,227,166,26%,26%,25%,7,4,3,3,3,0
348,https://vlr.gg/player/30096/bobbiexo,2024-11-19 13:00:00,0.56,1.21,0.89,142,135,151,16,7,9,18,12,6,3,0,3,-1,-1,0,67%,53%,80%,98,92,104,37%,37%,36%,2,2,0,3,3,0
349,https://vlr.gg/player/30107/fluxxy,2024-11-19 13:00:00,0.75,0.86,0.81,197,182,213,21,10,11,24,12,12,7,1,6,-2,0,-2,67%,60%,73%,130,115,146,24%,53%,12%,1,0,1,3,0,3
350,https://vlr.gg/player/20116/jademwah,2024-11-19 13:00:00,0.70,0.80,0.75,122,108,137,15,8,7,22,12,10,14,4,10,0,0,0,77%,73%,80%,79,66,92,30%,18%,40%,1,0,1,1,0,1
351,https://vlr.gg/player/10163/cyderx,2024-11-19 12:25:00,1.38,1.07,1.20,201,238,195,35,18,17,29,12,17,9,3,6,-3,-3,0,67%,70%,65%,149,154,146,38%,32%,43%,3,1,2,6,4,2
352,https://vlr.gg/player/12774/anima,2024-11-19 12:25:00,1.02,1.17,1.10,187,185,204,30,14,16,30,14,16,18,8,10,0,0,0,70%,75%,65%,133,115,147,21%,18%,24%,1,0,1,1,0,1
353,https://vlr.gg/player/10160/izzy,2024-11-19 12:25:00,0.66,0.92,0.81,197,137,232,29,9,20,38,16,22,7,3,4,0,-2,+2,52%,55%,50%,123,98,142,21%,25%,17%,8,1,7,8,3,5
354,https://vlr.gg/player/8041/brave,2024-11-19 12:25:00,0.65,0.66,0.65,162,139,168,23,8,15,38,16,22,11,9,2,0,0,0,70%,65%,73%,102,84,115,37%,38%,37%,1,1,0,1,1,0
355,https://vlr.gg/player/10161/qutionerx,2024-11-19 12:25:00,0.60,0.46,0.51,139,202,114,25,14,11,38,18,20,7,4,3,-7,-1,-6,61%,65%,58%,102,136,76,29%,39%,21%,5,4,1,12,5,7
356,https://vlr.gg/player/31305/lar0k,2024-11-19 12:25:00,1.38,1.27,1.33,242,245,209,38,24,14,27,16,11,20,10,10,+1,-1,+2,80%,77%,85%,147,158,132,38%,42%,34%,3,1,2,2,2,0
357,https://vlr.gg/player/24344/loita,2024-11-19 12:25:00,1.09,1.63,1.32,256,175,339,39,15,24,28,15,13,14,10,4,+3,+1,+2,78%,77%,80%,156,116,208,40%,47%,35%,7,2,5,4,1,3
358,https://vlr.gg/player/40591/comeback,2024-11-19 12:25:00,1.05,1.56,1.27,275,222,297,44,21,23,28,18,10,8,5,3,+9,+6,+3,78%,77%,80%,151,133,174,30%,32%,28%,13,8,5,4,2,2
359,https://vlr.gg/player/12795/crewen,2024-11-19 12:25:00,1.25,0.57,0.95,163,225,117,31,23,8,29,14,15,10,4,6,-1,-2,+1,78%,77%,80%,111,132,83,24%,30%,13%,2,1,1,3,3,0
360,https://vlr.gg/player/5565/ros,2024-11-19 12:25:00,0.77,0.60,0.69,122,156,109,21,14,7,30,16,14,8,3,5,-2,0,-2,65%,62%,70%,87,95,77,13%,13%,11%,3,3,0,5,3,2
361,https://vlr.gg/player/42521/jahbu,2024-11-19 12:00:00,1.57,1.40,1.50,321,308,343,23,14,9,12,7,5,5,2,3,+4,+2,+2,85%,92%,75%,205,194,223,25%,32%,18%,5,2,3,1,0,1
362,https://vlr.gg/player/4951/hardy,2024-11-19 12:00:00,1.50,1.25,1.40,252,247,261,18,10,8,12,6,6,12,9,3,+1,0,+1,85%,83%,88%,161,170,149,20%,19%,20%,2,1,1,1,1,0
363,https://vlr.gg/player/29974/erizillo,2024-11-19 12:00:00,1.40,0.84,1.18,172,245,64,13,10,3,10,7,3,13,13,0,-2,-1,-1,70%,75%,63%,97,141,31,36%,38%,25%,1,0,1,3,1,2
364,https://vlr.gg/player/23090/krystal,2024-11-19 12:00:00,0.92,0.74,0.85,211,250,153,15,11,4,14,9,5,3,2,1,-1,-1,0,65%,58%,75%,156,193,101,27%,37%,17%,1,1,0,2,2,0
365,https://vlr.gg/player/2886/drk,2024-11-19 12:00:00,0.56,1.14,0.79,147,117,193,12,6,6,12,8,4,3,2,1,-2,-2,0,75%,75%,75%,85,48,141,36%,57%,28%,1,1,0,3,3,0
366,https://vlr.gg/player/31553/pukytoo,2024-11-19 12:00:00,0.73,1.20,1.02,186,154,208,14,4,10,16,7,9,6,5,1,0,0,0,80%,75%,83%,111,89,126,30%,19%,38%,1,0,1,1,0,1
367,https://vlr.gg/player/41764/meow,2024-11-19 12:00:00,1.36,0.70,0.96,179,254,130,12,7,5,14,5,9,2,1,1,-2,-1,-1,65%,75%,58%,109,144,86,33%,39%,24%,2,1,1,4,2,2
368,https://vlr.gg/player/44137/levi,2024-11-19 12:00:00,0.67,0.92,0.82,202,166,228,13,5,8,17,6,11,5,1,4,-2,-2,0,70%,50%,83%,144,125,158,32%,50%,25%,2,1,1,4,3,1
369,https://vlr.gg/player/42519/lolito,2024-11-19 12:00:00,1.12,0.60,0.81,167,174,164,11,5,6,16,5,11,3,0,3,+2,+1,+1,60%,50%,67%,114,122,109,33%,36%,32%,2,1,1,0,0,0
370,https://vlr.gg/player/2862/chechuu,2024-11-19 12:00:00,0.62,0.81,0.73,157,106,192,10,2,8,18,7,11,8,5,3,+2,0,+2,60%,63%,58%,108,80,127,30%,8%,47%,3,0,3,1,0,1
371,https://vlr.gg/player/22617/vitie,2024-11-19 11:00:00,1.49,1.55,1.52,288,253,325,77,34,43,45,20,25,29,14,15,+2,+1,+1,78%,81%,76%,190,160,219,24%,26%,23%,8,4,4,6,3,3
372,https://vlr.gg/player/34002/lukey,2024-11-19 11:00:00,0.80,1.24,1.03,252,237,263,64,29,35,59,32,27,8,6,2,-1,-7,+6,65%,56%,74%,158,153,162,22%,22%,22%,14,4,10,15,11,4
373,https://vlr.gg/player/9943/mezoky,2024-11-19 11:00:00,1.04,0.76,0.90,176,202,143,43,25,18,51,25,26,26,10,16,0,0,0,69%,64%,74%,120,133,107,29%,31%,25%,6,3,3,6,3,3
374,https://vlr.gg/player/5203/bati,2024-11-19 11:00:00,0.70,1.04,0.87,152,126,170,38,12,26,47,26,21,34,20,14,+1,+1,0,66%,64%,68%,101,94,107,18%,18%,18%,4,3,1,3,2,1
375,https://vlr.gg/player/24426/w1ll,2024-11-19 11:00:00,0.47,0.92,0.70,145,96,190,35,12,23,54,27,27,17,4,13,-4,-3,-1,68%,56%,79%,95,65,123,25%,34%,20%,4,0,4,8,3,5
376,https://vlr.gg/player/33358/shinnok,2024-11-19 11:00:00,1.35,1.32,1.33,237,280,193,61,35,26,49,29,20,29,14,15,+5,+2,+3,70%,74%,67%,154,176,132,25%,19%,33%,7,3,4,2,1,1
377,https://vlr.gg/player/42458/bravo,2024-11-19 11:00:00,1.04,1.41,1.22,218,195,237,55,26,29,49,28,21,46,19,27,-4,-2,-2,80%,74%,86%,145,132,159,35%,44%,29%,2,1,1,6,3,3
378,https://vlr.gg/player/44922/golack,2024-11-19 11:00:00,0.64,1.34,0.98,195,161,232,52,22,30,49,31,18,9,4,5,+3,-4,+7,73%,66%,81%,127,103,152,27%,22%,33%,16,8,8,13,12,1
379,https://vlr.gg/player/36402/kubfu,2024-11-19 11:00:00,0.79,0.80,0.80,160,156,169,43,22,21,53,28,25,9,5,4,-1,-2,+1,66%,63%,69%,112,110,113,26%,28%,24%,5,0,5,6,2,4
380,https://vlr.gg/player/39103/waken,2024-11-19 11:00:00,0.75,0.81,0.78,168,155,180,45,21,24,57,29,28,20,9,11,-1,0,-1,64%,58%,69%,106,97,116,27%,26%,27%,8,4,4,9,4,5
381,https://vlr.gg/player/30286/karam1l,2024-11-19 10:30:00,1.06,1.22,1.13,238,235,233,52,31,21,44,28,16,10,6,4,+4,0,+4,62%,61%,63%,147,147,147,36%,34%,39%,9,4,5,5,4,1
382,https://vlr.gg/player/31355/acestarrrrr,2024-11-19 10:30:00,1.05,1.24,1.13,234,241,224,50,29,21,45,30,15,12,8,4,+1,+1,0,70%,69%,71%,165,168,161,37%,37%,38%,5,3,2,4,2,2
383,https://vlr.gg/player/46104/envy2k,2024-11-19 10:30:00,0.93,1.36,1.10,267,239,298,53,30,23,46,29,17,12,5,7,+6,+2,+4,68%,61%,79%,161,143,188,22%,20%,27%,14,8,6,8,6,2
384,https://vlr.gg/player/43390/d1sease,2024-11-19 10:30:00,0.86,0.71,0.80,132,147,118,28,19,9,42,26,16,26,17,9,-3,-3,0,67%,64%,71%,91,102,76,22%,19%,32%,3,1,2,6,4,2
385,https://vlr.gg/player/17294/hybr1d,2024-11-19 10:30:00,0.89,0.52,0.72,135,157,102,26,18,8,45,26,19,22,14,8,-4,-2,-2,65%,69%,58%,93,107,72,22%,25%,16%,1,1,0,5,3,2
386,https://vlr.gg/player/12323/rvk,2024-11-19 10:30:00,1.61,1.07,1.29,259,316,228,54,27,27,40,15,25,18,7,11,-1,+1,-2,72%,75%,69%,165,183,154,35%,40%,32%,3,1,2,4,0,4
387,https://vlr.gg/player/46048/r0meo,2024-11-19 10:30:00,0.56,1.49,1.05,204,114,286,17,4,13,14,8,6,2,1,1,+1,-1,+2,74%,55%,92%,134,86,177,19%,10%,23%,4,1,3,3,2,1
388,https://vlr.gg/player/1770/wat,2024-11-19 10:30:00,0.90,1.10,1.02,227,167,260,46,15,31,42,16,26,17,6,11,+2,-2,+4,72%,71%,72%,132,100,154,33%,28%,35%,9,1,8,7,3,4
389,https://vlr.gg/player/46121/marcai,2024-11-19 10:30:00,0.66,1.16,0.96,220,193,243,46,15,31,47,20,27,12,4,8,0,+1,-1,73%,58%,83%,140,113,158,31%,31%,31%,10,6,4,10,5,5
390,https://vlr.gg/player/40057/batman,2024-11-19 10:30:00,1.18,0.80,0.94,204,243,180,28,13,15,28,10,18,5,1,4,-3,-2,-1,70%,77%,67%,129,153,117,17%,18%,16%,1,0,1,4,2,2
391,https://vlr.gg/player/3502/ri0,2024-11-19 10:30:00,0.71,0.91,0.83,138,107,160,31,9,22,38,13,25,13,2,11,-3,-3,0,73%,67%,78%,99,71,118,31%,36%,29%,1,0,1,4,3,1
392,https://vlr.gg/player/10137/ip0tt,2024-11-19 09:30:00,1.31,1.78,1.49,289,246,342,61,34,27,31,20,11,14,7,7,+5,+2,+3,72%,72%,73%,194,174,228,39%,45%,30%,9,4,5,4,2,2
393,https://vlr.gg/player/40935/umu7,2024-11-19 09:30:00,1.33,1.25,1.30,268,283,240,54,36,18,36,23,13,16,7,9,+8,+4,+4,74%,75%,73%,170,173,164,15%,15%,15%,18,12,6,10,8,2
394,https://vlr.gg/player/22676/ventt,2024-11-19 09:30:00,0.88,1.47,1.10,196,178,232,43,24,19,36,27,9,26,11,15,-1,-3,+2,84%,83%,86%,119,106,140,34%,40%,27%,3,1,2,4,4,0
395,https://vlr.gg/player/3557/skylen,2024-11-19 09:30:00,0.87,1.28,1.02,174,153,214,36,18,18,35,24,11,35,22,13,+4,+1,+3,86%,86%,86%,112,100,131,47%,37%,65%,6,2,4,2,1,1
396,https://vlr.gg/player/31855/celasun,2024-11-19 09:30:00,1.15,0.69,0.98,178,220,106,39,32,7,35,23,12,12,4,8,-2,-2,0,79%,83%,73%,122,150,77,32%,42%,15%,0,0,0,2,2,0
397,https://vlr.gg/player/558/toronto,2024-11-19 09:30:00,0.61,1.18,0.96,209,148,251,36,10,26,46,19,27,19,2,17,+3,-1,+4,66%,50%,75%,142,92,172,21%,14%,23%,9,3,6,6,4,2
398,https://vlr.gg/player/22716/antsy,2024-11-19 09:30:00,0.95,0.95,0.95,205,188,214,40,15,25,47,17,30,16,2,14,-1,-3,+2,69%,59%,75%,131,118,138,27%,29%,26%,3,0,3,4,3,1
399,https://vlr.gg/player/4894/jn3v1ce,2024-11-19 09:30:00,0.82,0.93,0.89,158,140,174,34,11,23,44,17,27,17,6,11,-2,-2,0,60%,55%,64%,101,81,113,29%,29%,29%,2,0,2,4,2,2
400,https://vlr.gg/player/5510/oxmann,2024-11-19 09:30:00,0.52,0.96,0.80,146,102,171,33,8,25,46,18,28,9,4,5,-2,-1,-1,57%,45%,64%,99,64,120,46%,37%,49%,2,1,1,4,2,2
401,https://vlr.gg/player/13571/musz3kk,2024-11-19 09:30:00,0.57,0.47,0.50,134,152,131,28,12,16,51,19,32,8,3,5,-12,-5,-7,48%,50%,47%,91,99,86,34%,52%,21%,6,1,5,18,6,12
402,https://vlr.gg/player/37421/riyabtw,2024-11-19 09:10:00,0.94,1.19,1.07,221,206,258,63,26,37,55,24,31,12,3,9,-5,-4,-1,68%,64%,72%,155,136,171,34%,33%,34%,4,2,2,9,6,3
403,https://vlr.gg/player/24304/kiuuuu,2024-11-19 09:10:00,0.73,1.14,0.95,199,159,222,47,17,30,58,27,31,31,14,17,-2,-1,-1,69%,61%,77%,127,106,145,32%,24%,37%,4,0,4,6,1,5
404,https://vlr.gg/player/7851/uta,2024-11-19 09:10:00,0.82,0.88,0.85,210,227,196,50,25,25,60,29,31,19,7,12,+1,-1,+2,68%,64%,72%,142,145,139,21%,25%,18%,10,4,6,9,5,4
405,https://vlr.gg/player/24302/chimei,2024-11-19 09:10:00,0.76,0.86,0.81,176,172,195,44,17,27,58,25,33,31,12,19,-6,-5,-1,65%,58%,72%,121,113,127,17%,18%,17%,4,2,2,10,7,3
406,https://vlr.gg/player/47977/chak,2024-11-19 09:10:00,0.77,0.76,0.75,149,150,171,43,18,25,58,26,32,9,3,6,-11,-6,-5,64%,61%,67%,108,102,114,39%,33%,45%,2,0,2,13,6,7
407,https://vlr.gg/player/7746/kevzii,2024-11-19 09:10:00,1.50,1.54,1.52,284,283,266,74,43,31,44,26,18,16,10,6,+4,+2,+2,85%,85%,85%,193,210,173,33%,32%,34%,9,4,5,5,2,3
408,https://vlr.gg/player/13744/patmen,2024-11-19 09:10:00,1.26,1.62,1.43,314,294,342,81,39,42,54,32,22,22,12,10,+9,+4,+5,82%,79%,85%,201,186,219,40%,40%,40%,17,9,8,8,5,3
409,https://vlr.gg/player/16953/zynd,2024-11-19 09:10:00,1.01,1.22,1.11,226,219,226,58,31,27,49,28,21,16,9,7,+10,+4,+6,75%,74%,76%,140,145,136,27%,30%,23%,15,8,7,5,4,1
410,https://vlr.gg/player/21677/jeee,2024-11-19 09:10:00,0.97,0.81,0.90,161,182,140,40,26,14,50,28,22,36,18,18,+3,0,+3,88%,85%,91%,115,128,98,28%,29%,27%,5,1,4,2,1,1
411,https://vlr.gg/player/42331/jcl,2024-11-19 09:10:00,0.76,0.92,0.83,154,149,152,36,20,16,51,30,21,51,30,21,-3,-3,0,78%,72%,85%,96,92,100,14%,13%,15%,2,1,1,5,4,1
412,https://vlr.gg/player/13221/azys,2024-11-19 08:30:00,1.90,1.56,1.69,379,391,369,54,21,33,26,8,18,9,4,5,+12,+8,+4,82%,87%,79%,221,225,219,37%,33%,40%,18,9,9,6,1,5
413,https://vlr.gg/player/12947/rawfiul,2024-11-19 08:30:00,1.83,0.86,1.23,223,340,153,32,20,12,18,4,14,13,5,8,+2,+1,+1,82%,100%,71%,158,230,114,38%,36%,41%,2,1,1,0,0,0
414,https://vlr.gg/player/3269/antidote,2024-11-19 08:30:00,1.45,1.05,1.20,194,218,163,30,13,17,17,6,11,8,5,3,+1,+1,0,82%,87%,79%,111,136,95,31%,30%,32%,3,1,2,2,0,2
415,https://vlr.gg/player/18704/levi,2024-11-19 08:30:00,1.22,0.92,1.04,170,155,179,25,11,14,21,6,15,10,1,9,0,0,0,82%,93%,75%,118,105,125,29%,32%,28%,1,0,1,1,0,1
416,https://vlr.gg/player/3628/deathmaker,2024-11-19 08:30:00,0.95,0.91,0.93,160,150,168,21,8,13,23,8,15,13,8,5,-4,-1,-3,82%,93%,75%,111,110,111,29%,24%,33%,1,1,0,5,2,3
417,https://vlr.gg/player/28612/tricky,2024-11-19 08:30:00,0.98,0.66,0.85,193,237,141,25,19,6,33,19,14,8,2,6,+1,+1,0,54%,63%,40%,131,152,97,35%,36%,33%,7,6,1,6,5,1
418,https://vlr.gg/player/10463/paradox,2024-11-19 08:30:00,0.92,0.73,0.85,181,186,171,25,17,8,33,19,14,3,0,3,-1,-1,0,56%,50%,67%,123,122,125,28%,33%,21%,3,2,1,4,3,1
419,https://vlr.gg/player/1162/russ,2024-11-19 08:30:00,0.90,0.61,0.79,151,143,164,19,11,8,31,16,15,16,12,4,-3,-1,-2,54%,58%,47%,100,93,111,44%,38%,53%,2,2,0,5,3,2
420,https://vlr.gg/player/3626/lightningfast,2024-11-19 08:30:00,0.88,0.38,0.69,151,163,144,21,14,7,31,16,15,4,1,3,-5,-1,-4,59%,67%,47%,91,103,72,25%,41%,9%,2,1,1,7,2,5
421,https://vlr.gg/player/10758/kohliii,2024-11-19 08:30:00,0.74,0.18,0.52,128,154,93,15,12,3,34,19,15,7,4,3,-3,0,-3,54%,58%,47%,93,108,69,25%,28%,20%,0,0,0,3,0,3
422,https://vlr.gg/player/44149/pr0digy,2024-11-19 06:00:00,1.09,0.82,0.94,223,297,178,48,29,19,57,27,30,25,13,12,+5,+6,-1,62%,72%,53%,153,195,120,34%,34%,35%,9,8,1,4,2,2
423,https://vlr.gg/player/23042/tripciew,2024-11-19 06:00:00,0.90,0.89,0.90,156,117,196,14,7,7,14,5,9,4,0,4,-1,0,-1,79%,83%,75%,97,70,124,14%,6%,19%,1,0,1,2,0,2
424,https://vlr.gg/player/14254/gin,2024-11-19 06:00:00,0.83,0.94,0.89,227,197,250,53,20,33,54,21,33,9,3,6,-4,-4,0,71%,66%,75%,140,127,150,34%,40%,32%,11,5,6,15,9,6
425,https://vlr.gg/player/14209/suka,2024-11-19 06:00:00,0.67,1.02,0.86,185,148,213,39,15,24,49,21,28,18,6,12,-2,-1,-1,69%,69%,69%,129,102,151,32%,33%,31%,2,0,2,4,1,3
426,https://vlr.gg/player/19154/albus,2024-11-19 06:00:00,0.73,0.92,0.84,169,169,170,24,9,15,31,14,17,6,2,4,0,-1,+1,63%,65%,63%,108,114,104,30%,21%,41%,4,0,4,4,1,3
427,https://vlr.gg/player/14587/daft,2024-11-19 06:00:00,1.06,0.65,0.83,137,194,96,31,20,11,41,18,23,22,9,13,+1,+1,0,75%,83%,69%,90,130,58,22%,25%,17%,5,2,3,4,1,3
428,https://vlr.gg/player/4377/johnolsen,2024-11-19 06:00:00,1.46,1.22,1.36,226,218,241,56,31,25,36,16,20,24,13,11,-1,0,-1,75%,75%,76%,141,140,142,31%,34%,28%,5,3,2,6,3,3
429,https://vlr.gg/player/27254/leviathan,2024-11-19 06:00:00,1.33,1.25,1.30,243,252,239,56,34,22,42,23,19,23,11,12,+6,+5,+1,82%,81%,83%,167,171,162,39%,40%,37%,6,5,1,0,0,0
430,https://vlr.gg/player/23930/potter,2024-11-19 06:00:00,1.43,1.13,1.29,299,335,234,66,42,24,47,25,22,17,11,6,+4,+2,+2,72%,78%,66%,185,209,154,33%,31%,38%,13,6,7,9,4,5
431,https://vlr.gg/player/2366/alert,2024-11-19 06:00:00,0.88,1.32,1.07,172,162,204,39,18,21,38,21,17,23,14,9,0,-1,+1,71%,75%,66%,126,113,143,24%,20%,29%,6,2,4,6,3,3
432,https://vlr.gg/player/3342/sushiboys,2024-11-19 06:00:00,0.72,0.82,0.76,141,126,155,28,14,14,46,25,21,45,23,22,-8,-4,-4,75%,78%,72%,91,84,99,19%,23%,16%,3,3,0,11,7,4
433,https://vlr.gg/player/38369/only1,2024-11-19 05:35:00,1.34,0.99,1.16,245,296,203,58,34,24,49,25,24,11,4,7,+1,-4,+5,67%,56%,78%,153,181,127,17%,22%,13%,15,6,9,14,10,4
434,https://vlr.gg/player/40279/ngen,2024-11-19 05:35:00,0.93,1.32,1.13,201,143,268,55,20,35,46,22,24,15,4,11,+2,+2,0,66%,68%,64%,139,95,180,35%,34%,35%,5,3,2,3,1,2
435,https://vlr.gg/player/34727/kayle,2024-11-19 05:35:00,0.71,1.18,0.95,178,148,212,41,15,26,48,26,22,33,16,17,+3,0,+3,74%,65%,83%,116,93,137,24%,22%,25%,9,3,6,6,3,3
436,https://vlr.gg/player/4038/bangnan,2024-11-19 05:35:00,0.66,0.97,0.82,180,138,210,46,16,30,49,24,25,6,3,3,-1,-3,+2,67%,62%,72%,110,89,130,32%,22%,39%,6,1,5,7,4,3
437,https://vlr.gg/player/13000/redlight,2024-11-19 05:35:00,0.78,0.81,0.80,171,182,156,40,21,19,51,26,25,25,10,15,-1,-1,0,76%,74%,78%,110,123,97,26%,27%,25%,2,1,1,3,2,1
438,https://vlr.gg/player/9236/manggong,2024-11-19 05:35:00,0.97,1.34,1.15,213,175,244,53,23,30,46,26,20,24,11,13,+2,+2,0,71%,67%,76%,127,113,141,40%,33%,47%,10,4,6,8,2,6
439,https://vlr.gg/player/42254/delas,2024-11-19 05:35:00,1.04,1.07,1.05,206,221,189,52,30,22,46,26,20,19,7,12,-5,-5,0,69%,64%,74%,132,139,125,26%,21%,33%,6,3,3,11,8,3
440,https://vlr.gg/player/25053/wolverine,2024-11-19 05:35:00,0.82,1.21,1.01,211,177,252,50,20,30,53,28,25,27,15,12,0,-4,+4,71%,64%,79%,139,115,165,36%,31%,40%,8,2,6,8,6,2
441,https://vlr.gg/player/9192/cloudy,2024-11-19 05:35:00,0.91,1.10,1.00,192,195,199,46,22,24,49,28,21,24,12,12,-3,-2,-1,69%,67%,71%,125,123,126,35%,41%,31%,4,3,1,7,5,2
442,https://vlr.gg/player/42749/godsb,2024-11-19 05:35:00,0.91,0.85,0.88,166,185,150,42,25,17,46,26,20,12,1,11,+2,-1,+3,69%,67%,71%,104,117,91,31%,28%,35%,5,1,4,3,2,1
443,https://vlr.gg/player/12968/tixx,2024-11-19 04:30:00,2.06,1.37,1.74,329,386,260,43,27,16,19,9,10,17,9,8,+6,+2,+4,79%,83%,75%,205,241,165,40%,45%,33%,6,2,4,0,0,0
444,https://vlr.gg/player/26310/ikana,2024-11-19 04:30:00,1.35,1.14,1.25,204,183,236,26,13,13,15,6,9,14,8,6,0,0,0,82%,83%,81%,130,122,138,25%,28%,22%,0,0,0,0,0,0
445,https://vlr.gg/player/6659/dragon,2024-11-19 04:30:00,1.25,0.92,1.10,169,209,117,22,14,8,17,9,8,7,5,2,0,+2,-2,79%,83%,75%,106,124,86,36%,34%,39%,3,3,0,3,1,2
446,https://vlr.gg/player/5228/minimise,2024-11-19 04:30:00,0.89,1.30,1.09,233,175,307,29,11,18,22,11,11,21,11,10,+1,-2,+3,74%,72%,75%,156,118,199,31%,26%,34%,6,2,4,5,4,1
447,https://vlr.gg/player/1062/lew,2024-11-19 04:30:00,0.82,1.39,1.09,236,213,261,27,13,14,21,14,7,5,3,2,+7,+2,+5,85%,78%,94%,152,140,166,31%,26%,38%,9,4,5,2,2,0
448,https://vlr.gg/player/10089/andy,2024-11-19 04:30:00,1.39,1.01,1.26,276,280,270,16,11,5,15,10,5,2,1,1,+1,0,+1,56%,50%,67%,185,184,189,30%,23%,43%,3,0,3,2,0,2
449,https://vlr.gg/player/34257/strame,2024-11-19 04:30:00,1.05,0.67,0.85,190,225,155,22,12,10,28,13,15,4,2,2,-2,-2,0,50%,50%,50%,117,145,92,48%,50%,45%,1,0,1,3,2,1
450,https://vlr.gg/player/28843/abbas,2024-11-19 04:30:00,0.50,0.82,0.67,173,177,172,20,9,11,30,15,15,4,1,3,-7,-4,-3,56%,50%,61%,119,113,124,31%,27%,35%,4,2,2,11,6,5
451,https://vlr.gg/player/33714/vina,2024-11-19 04:30:00,0.45,0.74,0.60,115,84,139,13,4,9,29,14,15,9,4,5,-1,-1,0,62%,38%,83%,75,52,95,37%,23%,47%,1,1,0,2,2,0
452,https://vlr.gg/player/31629/muzz,2024-11-19 04:30:00,0.56,0.58,0.57,134,116,150,15,6,9,29,13,16,3,2,1,-3,-3,0,56%,63%,50%,90,83,97,21%,14%,27%,1,0,1,4,3,1
453,https://vlr.gg/player/48913/zek,2024-11-19 04:30:00,0.48,0.49,0.49,148,202,131,8,3,5,16,4,12,0,0,0,-2,0,-2,44%,50%,42%,98,139,84,47%,57%,42%,0,0,0,2,0,2
454,https://vlr.gg/player/44259/patrickwho,2024-11-19 04:00:00,0.75,1.40,1.12,263,182,339,57,17,40,51,22,29,15,6,9,0,-6,+6,71%,56%,83%,173,115,219,23%,21%,24%,10,3,7,10,9,1
455,https://vlr.gg/player/7437/kellys,2024-11-19 04:00:00,1.30,0.82,1.03,207,231,184,46,23,23,51,21,30,24,16,8,-1,-1,0,85%,85%,86%,129,147,115,30%,33%,27%,4,1,3,5,2,3
456,https://vlr.gg/player/5796/kr1stal,2024-11-19 04:00:00,1.03,0.77,0.88,176,203,161,37,19,18,45,21,24,22,13,9,+3,+3,0,79%,74%,83%,122,125,120,29%,25%,31%,5,3,2,2,0,2
457,https://vlr.gg/player/4428/udotan,2024-11-19 04:00:00,0.75,0.94,0.85,197,204,192,39,17,22,49,23,26,16,5,11,-1,-1,0,61%,74%,51%,129,130,128,32%,32%,31%,10,4,6,11,5,6
458,https://vlr.gg/player/13219/papi,2024-11-19 04:00:00,0.81,0.83,0.82,146,141,156,33,12,21,47,21,26,25,17,8,-3,0,-3,68%,74%,63%,96,90,101,21%,17%,24%,1,0,1,4,0,4
459,https://vlr.gg/player/13220/ja,2024-11-19 04:00:00,1.19,1.80,1.46,302,260,369,68,32,36,43,26,17,17,10,7,+8,0,+8,85%,83%,89%,204,176,240,33%,27%,42%,17,7,10,9,7,2
460,https://vlr.gg/player/7754/xavi8k,2024-11-19 04:00:00,1.10,1.02,1.07,224,231,216,48,30,18,42,24,18,21,7,14,-1,-2,+1,84%,80%,89%,151,159,140,37%,40%,33%,4,3,1,5,5,0
461,https://vlr.gg/player/16842/mojer,2024-11-19 04:00:00,1.04,1.08,1.06,239,222,244,49,26,23,46,26,20,18,9,9,0,+1,-1,69%,74%,63%,165,149,186,18%,20%,15%,8,5,3,8,4,4
462,https://vlr.gg/player/7749/nexi,2024-11-19 04:00:00,0.85,1.19,1.00,190,182,195,44,24,20,41,26,15,19,10,9,-2,-2,0,76%,71%,81%,132,133,130,34%,21%,56%,3,1,2,5,3,2
463,https://vlr.gg/player/9747/emman,2024-11-19 04:00:00,1.05,0.68,0.89,152,174,129,34,23,11,40,22,18,23,13,10,-3,0,-3,69%,77%,59%,105,117,89,23%,20%,30%,0,0,0,3,0,3
464,https://vlr.gg/player/42793/kally,2024-11-19 03:10:00,1.65,0.90,1.24,203,257,161,35,21,14,26,9,17,20,10,10,+2,+2,0,84%,90%,79%,128,152,108,30%,31%,29%,3,2,1,1,0,1
465,https://vlr.gg/player/42772/xross,2024-11-19 03:10:00,1.24,1.15,1.19,238,228,249,36,16,20,31,13,18,17,9,8,+1,0,+1,93%,100%,88%,154,141,166,25%,27%,23%,5,2,3,4,2,2
466,https://vlr.gg/player/24979/cloy,2024-11-19 03:10:00,0.90,1.39,1.17,216,198,233,35,15,20,28,14,14,15,7,8,+1,-2,+3,77%,70%,83%,144,141,147,25%,27%,25%,6,2,4,5,4,1
467,https://vlr.gg/player/27444/banger,2024-11-19 03:10:00,1.28,0.94,1.09,171,209,134,28,15,13,26,12,14,20,14,6,-4,-3,-1,70%,80%,63%,113,140,90,42%,35%,52%,1,0,1,5,3,2
468,https://vlr.gg/player/25048/sid,2024-11-19 03:10:00,1.05,1.12,1.09,244,250,238,37,17,20,32,14,18,11,5,6,+4,+3,+1,80%,80%,79%,170,182,161,28%,32%,23%,9,4,5,5,1,4
469,https://vlr.gg/player/37535/jaebin,2024-11-19 03:10:00,1.05,1.18,1.11,276,284,268,39,21,18,37,21,16,16,10,6,+3,+3,0,75%,67%,85%,181,193,166,26%,28%,23%,8,6,2,5,3,2
470,https://vlr.gg/player/4054/secret,2024-11-19 03:10:00,1.17,0.81,1.01,178,197,155,27,17,10,35,17,18,25,13,12,+1,-1,+2,73%,75%,70%,119,139,94,35%,43%,25%,3,1,2,2,2,0
471,https://vlr.gg/player/25017/ash,2024-11-19 03:10:00,0.82,0.88,0.85,165,159,173,24,13,11,32,16,16,13,7,6,+1,0,+1,70%,71%,70%,124,122,126,36%,37%,36%,3,1,2,2,1,1
472,https://vlr.gg/player/4488/wix,2024-11-19 03:10:00,0.99,0.65,0.83,191,198,189,33,19,14,34,16,18,7,3,4,-3,-2,-1,57%,54%,60%,124,127,120,35%,36%,34%,3,1,2,6,3,3
473,https://vlr.gg/player/7483/nakji,2024-11-19 03:10:00,0.60,0.72,0.66,134,123,148,20,11,9,33,17,16,18,10,8,-6,-4,-2,61%,67%,55%,92,84,101,23%,24%,22%,3,1,2,9,5,4
474,https://vlr.gg/player/31254/feta,2024-11-19 02:30:00,1.84,1.39,1.67,293,303,249,42,28,14,19,9,10,11,6,5,+2,+1,+1,79%,75%,87%,174,180,165,25%,27%,23%,5,3,2,3,2,1
475,https://vlr.gg/player/29790/zauqk,2024-11-19 02:30:00,1.11,1.59,1.29,225,192,260,30,15,15,22,13,9,16,9,7,-3,-1,-2,74%,67%,87%,165,158,176,34%,38%,31%,2,2,0,5,3,2
476,https://vlr.gg/player/29821/sinaway,2024-11-19 02:30:00,1.45,0.98,1.27,250,286,185,32,24,8,22,13,9,15,8,7,+2,0,+2,79%,79%,80%,175,208,123,29%,30%,26%,6,4,2,4,4,0
477,https://vlr.gg/player/43125/kadiri,2024-11-19 02:30:00,1.26,1.24,1.26,175,167,188,26,15,11,17,9,8,13,9,4,+1,+1,0,85%,92%,73%,116,119,110,46%,47%,44%,2,1,1,1,0,1
478,https://vlr.gg/player/31255/biggiecheese,2024-11-19 02:30:00,1.15,0.93,1.07,204,215,190,28,18,10,25,13,12,20,13,7,-1,+1,-2,72%,79%,60%,127,139,108,32%,31%,33%,5,3,2,6,2,4
479,https://vlr.gg/player/47212/ecco,2024-11-19 02:30:00,1.62,0.62,1.01,222,360,139,31,21,10,31,11,20,9,2,7,-1,+1,-2,59%,80%,46%,144,223,95,34%,35%,32%,4,3,1,5,2,3
480,https://vlr.gg/player/36676/novae,2024-11-19 02:30:00,0.57,0.84,0.73,164,134,188,21,6,15,30,11,19,4,3,1,-2,-2,0,56%,53%,58%,122,100,136,26%,16%,34%,3,0,3,5,2,3
481,https://vlr.gg/player/49003/cybxr,2024-11-19 02:30:00,0.66,0.63,0.64,109,132,117,17,8,9,32,12,20,3,2,1,+3,+1,+2,51%,67%,42%,87,82,90,36%,35%,36%,3,1,2,0,0,0
482,https://vlr.gg/player/46994/tisoyy,2024-11-19 02:30:00,0.68,0.50,0.57,122,138,116,16,7,9,32,11,21,7,4,3,-2,0,-2,56%,67%,50%,81,93,73,34%,29%,39%,0,0,0,2,0,2
483,https://vlr.gg/player/46768/indraa,2024-11-19 02:30:00,0.35,0.70,0.55,160,134,176,20,6,14,33,13,20,2,1,1,+1,+1,0,54%,73%,42%,104,86,116,27%,17%,35%,9,4,5,8,3,5
484,https://vlr.gg/player/1120/aleksandar,2024-11-18 22:30:00,1.49,0.92,1.18,206,257,187,49,28,21,38,14,24,4,2,2,+1,0,+1,73%,81%,67%,145,174,122,49%,67%,36%,2,1,1,1,1,0
485,https://vlr.gg/player/5093/logan,2024-11-18 22:30:00,1.19,1.07,1.12,225,232,227,46,21,25,44,18,26,22,14,8,+2,+2,0,78%,85%,73%,150,142,156,26%,31%,24%,6,3,3,4,1,3
486,https://vlr.gg/player/24553/boni,2024-11-18 22:30:00,1.08,0.64,0.84,200,260,166,42,25,17,49,21,28,12,6,6,+1,-1,+2,67%,78%,58%,139,176,108,24%,29%,17%,13,7,6,12,8,4
487,https://vlr.gg/player/21878/snarly,2024-11-18 22:30:00,1.01,0.68,0.83,172,174,167,33,15,18,46,19,27,30,16,14,-1,0,-1,77%,85%,70%,104,116,95,38%,35%,42%,6,1,5,7,1,6
488,https://vlr.gg/player/754/nerve,2024-11-18 22:30:00,0.97,0.64,0.79,144,149,149,28,12,16,44,17,27,25,19,6,-3,-2,-1,58%,63%,55%,98,99,98,32%,32%,33%,3,1,2,6,3,3
489,https://vlr.gg/player/36560/canezerra,2024-11-18 22:30:00,1.48,1.23,1.37,278,309,247,65,39,26,42,21,21,8,3,5,+7,+3,+4,72%,76%,67%,163,190,131,29%,31%,25%,13,8,5,6,5,1
490,https://vlr.gg/player/1850/shot-up,2024-11-18 22:30:00,1.19,0.94,1.08,206,195,198,42,24,18,36,16,20,24,13,11,-1,-1,0,75%,76%,74%,126,125,126,22%,24%,19%,3,1,2,4,2,2
491,https://vlr.gg/player/29547/ion2x,2024-11-18 22:30:00,1.19,0.67,0.95,172,217,122,38,26,12,37,18,19,11,8,3,-3,-1,-2,73%,82%,63%,132,161,96,36%,47%,19%,4,2,2,7,3,4
492,https://vlr.gg/player/41798/nightz,2024-11-18 22:30:00,0.89,0.93,0.91,204,202,220,44,24,20,47,25,22,20,12,8,+2,+1,+1,70%,73%,67%,135,125,148,48%,51%,45%,8,5,3,6,4,2
493,https://vlr.gg/player/8399/mocking,2024-11-18 22:30:00,1.01,0.70,0.87,169,168,151,32,20,12,37,17,20,22,9,13,-5,-3,-2,72%,76%,67%,103,109,96,16%,12%,22%,2,0,2,7,3,4
494,https://vlr.gg/player/19292/jowa,2024-11-18 19:20:00,1.11,1.08,1.09,192,170,217,50,21,29,53,24,29,27,16,11,+2,+3,-1,74%,70%,77%,133,113,152,29%,24%,35%,6,3,3,4,0,4
495,https://vlr.gg/player/4917/kaoticcc,2024-11-18 19:20:00,0.88,1.24,1.07,253,229,282,67,29,38,60,29,31,13,4,9,+12,-1,+13,71%,62%,79%,171,149,191,28%,26%,30%,23,8,15,11,9,2
496,https://vlr.gg/player/844/bdog,2024-11-18 19:20:00,1.07,1.08,1.07,203,193,219,53,24,29,54,27,27,32,14,18,-1,-2,+1,75%,70%,79%,138,125,151,19%,22%,17%,4,2,2,5,4,1
497,https://vlr.gg/player/1856/wedid,2024-11-18 19:20:00,0.98,1.00,0.99,189,189,197,47,21,26,55,28,27,39,22,17,+2,-1,+3,74%,73%,74%,133,126,140,26%,21%,31%,7,2,5,5,3,2
498,https://vlr.gg/player/4931/add3r,2024-11-18 19:20:00,0.65,0.99,0.82,164,137,189,45,18,27,54,27,27,13,2,11,-1,-4,+3,68%,54%,82%,106,93,118,30%,33%,28%,5,1,4,6,5,1
499,https://vlr.gg/player/24553/boni,2024-11-18 19:20:00,1.09,1.27,1.17,262,253,265,73,36,37,54,29,25,16,8,8,0,-4,+4,72%,72%,73%,160,152,168,18%,16%,20%,13,4,9,13,8,5
500,https://vlr.gg/player/5093/logan,2024-11-18 19:20:00,1.06,1.17,1.11,240,232,242,57,30,27,56,31,25,32,15,17,-1,+1,-2,71%,64%,78%,161,154,168,36%,43%,30%,4,1,3,5,0,5
501,https://vlr.gg/player/754/nerve,2024-11-18 19:20:00,1.06,1.13,1.10,210,213,208,51,27,24,50,29,21,44,21,23,-9,-7,-2,80%,79%,81%,142,131,153,24%,26%,22%,3,1,2,12,8,4
502,https://vlr.gg/player/21878/snarly,2024-11-18 19:20:00,0.90,1.02,0.96,183,176,195,50,26,24,54,30,24,32,14,18,-4,-7,+3,79%,85%,73%,123,118,128,37%,46%,30%,4,0,4,8,7,1
503,https://vlr.gg/player/1120/aleksandar,2024-11-18 19:20:00,0.76,1.11,0.93,165,172,165,45,22,23,48,30,18,19,12,7,0,-2,+2,74%,72%,76%,113,114,111,50%,43%,60%,7,4,3,7,6,1
0,https://vlr.gg/player/3986/truth,2024-11-18 18:40:00,1.32,1.02,1.14,231,290,196,35,17,18,29,12,17,5,2,3,0,-1,+1,65%,75%,58%,148,173,130,45%,47%,44%,4,1,3,4,2,2
1,https://vlr.gg/player/16028/klamran,2024-11-18 18:40:00,1.10,0.95,1.01,208,216,199,28,14,14,30,9,21,15,4,11,+1,+1,0,75%,75%,75%,137,142,134,40%,39%,41%,2,1,1,1,0,1
2,https://vlr.gg/player/28316/eyan,2024-11-18 18:40:00,0.78,1.14,0.99,225,162,260,31,9,22,32,12,20,14,8,6,0,-1,+1,73%,81%,67%,136,110,152,32%,19%,41%,3,0,3,3,1,2
3,https://vlr.gg/player/823/rebo,2024-11-18 18:40:00,1.18,0.73,0.91,196,245,167,25,13,12,31,11,20,21,10,11,-1,0,-1,78%,88%,71%,131,159,113,13%,10%,16%,3,1,2,4,1,3
4,https://vlr.gg/player/8410/cuz,2024-11-18 18:40:00,0.69,0.75,0.72,186,210,179,23,11,12,35,13,22,10,2,8,-2,-3,+1,58%,56%,58%,131,132,130,21%,27%,16%,7,3,4,9,6,3
5,https://vlr.gg/player/36560/canezerra,2024-11-18 18:40:00,1.22,1.71,1.42,299,276,339,45,24,21,29,17,12,9,7,2,+4,+1,+3,78%,75%,81%,173,153,203,23%,19%,28%,8,5,3,4,4,0
6,https://vlr.gg/player/41798/nightz,2024-11-18 18:40:00,1.77,0.72,1.35,285,327,210,39,29,10,29,14,15,15,9,6,-2,-1,-1,88%,96%,75%,181,212,134,49%,48%,53%,2,0,2,4,1,3
7,https://vlr.gg/player/1850/shot-up,2024-11-18 18:40:00,1.33,0.74,1.09,200,250,144,30,23,7,27,15,12,22,16,6,+4,+3,+1,80%,88%,69%,125,150,86,23%,26%,18%,6,3,3,2,0,2
8,https://vlr.gg/player/8399/mocking,2024-11-18 18:40:00,0.79,1.50,1.07,164,125,223,23,10,13,24,15,9,18,12,6,0,-1,+1,73%,71%,75%,115,89,155,29%,29%,30%,1,0,1,1,1,0
9,https://vlr.gg/player/29547/ion2x,2024-11-18 18:40:00,0.65,0.35,0.53,151,169,119,18,13,5,33,18,15,17,12,5,-4,-4,0,68%,75%,56%,110,114,105,18%,20%,14%,4,3,1,8,7,1
10,https://vlr.gg/player/4931/add3r,2024-11-18 16:00:00,1.36,1.45,1.40,225,229,221,39,17,22,24,12,12,15,6,9,+2,+3,-1,76%,86%,67%,142,151,134,31%,33%,29%,6,4,2,4,1,3
11,https://vlr.gg/player/19292/jowa,2024-11-18 16:00:00,1.31,1.33,1.32,258,253,261,40,19,21,26,11,15,13,3,10,+2,0,+2,82%,81%,83%,177,168,186,35%,35%,35%,3,1,2,1,1,0
12,https://vlr.gg/player/844/bdog,2024-11-18 16:00:00,1.58,1.06,1.30,216,241,190,32,18,14,25,9,16,23,9,14,+3,+1,+2,76%,76%,75%,149,163,137,34%,39%,30%,5,2,3,2,1,1
13,https://vlr.gg/player/4917/kaoticcc,2024-11-18 16:00:00,0.95,0.98,0.97,221,205,234,36,16,20,34,15,19,6,4,2,-2,-3,+1,64%,62%,67%,144,143,145,38%,50%,30%,7,3,4,9,6,3
14,https://vlr.gg/player/1856/wedid,2024-11-18 16:00:00,0.83,0.64,0.73,128,149,114,17,9,8,32,13,19,20,11,9,-4,-2,-2,71%,67%,75%,84,91,78,21%,16%,29%,2,0,2,6,2,4
15,https://vlr.gg/player/12932/geeza,2024-11-18 16:00:00,0.94,1.33,1.12,252,220,292,41,19,22,34,18,16,11,4,7,-2,-3,+1,67%,71%,62%,158,142,177,28%,24%,31%,4,1,3,6,4,2
16,https://vlr.gg/player/15639/chloric,2024-11-18 16:00:00,1.11,0.71,0.92,164,199,126,25,16,9,28,14,14,10,5,5,+1,0,+1,71%,79%,62%,108,132,82,26%,39%,11%,2,1,1,1,1,0
17,https://vlr.gg/player/2119/renz,2024-11-18 16:00:00,0.87,0.84,0.85,206,228,178,34,20,14,36,20,16,5,3,2,+2,+1,+1,60%,63%,57%,128,147,106,32%,30%,34%,9,5,4,7,4,3
18,https://vlr.gg/player/6642/wildfire,2024-11-18 16:00:00,0.85,0.65,0.75,144,163,123,22,14,8,31,15,16,14,6,8,-2,-1,-1,60%,58%,62%,100,107,93,22%,23%,21%,3,1,2,5,2,3
19,https://vlr.gg/player/766/ange,2024-11-18 16:00:00,0.93,0.55,0.75,150,172,123,19,12,7,35,18,17,21,14,7,0,+1,-1,64%,71%,57%,105,120,87,28%,29%,28%,4,3,1,4,2,2
20,https://vlr.gg/player/3986/truth,2024-11-18 16:00:00,1.87,1.26,1.56,312,384,241,57,36,21,32,15,17,9,4,5,-1,+3,-4,75%,88%,63%,184,220,147,34%,35%,33%,4,4,0,5,1,4
21,https://vlr.gg/player/823/rebo,2024-11-18 16:00:00,1.31,1.06,1.18,212,222,203,37,20,17,28,11,17,11,5,6,0,+1,-1,77%,79%,75%,131,136,127,22%,19%,24%,5,3,2,5,2,3
22,https://vlr.gg/player/16028/klamran,2024-11-18 16:00:00,0.83,1.22,1.02,225,196,255,36,15,21,36,17,19,19,10,9,+4,+1,+3,71%,83%,58%,138,125,152,33%,37%,31%,7,4,3,3,3,0
23,https://vlr.gg/player/28316/eyan,2024-11-18 16:00:00,0.87,0.82,0.84,157,138,176,28,13,15,34,15,19,15,8,7,0,0,0,69%,79%,58%,103,95,111,33%,29%,38%,1,0,1,1,0,1
24,https://vlr.gg/player/8410/cuz,2024-11-18 16:00:00,1.20,0.28,0.71,170,236,104,26,20,6,36,14,22,14,6,8,-10,-3,-7,71%,83%,58%,111,150,71,23%,22%,26%,3,2,1,13,5,8
25,https://vlr.gg/player/29893/timotino,2024-11-18 16:00:00,1.53,1.05,1.29,286,303,269,47,25,22,36,15,21,8,6,2,+2,+3,-1,71%,71%,71%,191,209,174,27%,28%,26%,10,5,5,8,2,6
26,https://vlr.gg/player/2125/nanners,2024-11-18 16:00:00,1.55,0.43,0.99,202,292,113,32,27,5,31,12,19,17,9,8,0,+4,-4,67%,79%,54%,129,177,82,27%,30%,21%,5,5,0,5,1,4
27,https://vlr.gg/player/3719/matt,2024-11-18 16:00:00,1.00,0.92,0.96,185,190,180,32,17,15,37,16,21,15,8,7,+2,+1,+1,73%,75%,71%,121,121,122,26%,26%,26%,4,3,1,2,2,0
28,https://vlr.gg/player/39602/recoil,2024-11-18 16:00:00,0.87,0.73,0.80,203,203,204,34,18,16,43,19,24,13,6,7,+6,+3,+3,73%,71%,75%,127,123,132,29%,35%,23%,8,4,4,2,1,1
29,https://vlr.gg/player/893/retrq,2024-11-18 16:00:00,0.52,0.69,0.61,132,114,151,21,8,13,38,18,20,25,17,8,-3,-1,-2,60%,67%,54%,92,79,106,25%,14%,38%,1,0,1,4,1,3
30,https://vlr.gg/player/257/bramz,2024-11-18 15:00:00,1.50,1.63,1.55,320,319,324,25,14,11,13,8,5,2,1,1,+1,+1,0,75%,75%,75%,198,204,188,40%,41%,39%,3,2,1,2,1,1
31,https://vlr.gg/player/114/enzo,2024-11-18 15:00:00,1.00,1.72,1.28,213,181,263,15,7,8,11,8,3,9,7,2,+3,+2,+1,80%,83%,75%,144,103,206,23%,14%,35%,3,2,1,0,0,0
32,https://vlr.gg/player/16321/nelo,2024-11-18 15:00:00,1.24,1.05,1.17,219,200,249,14,8,6,12,6,6,11,6,5,+5,+3,+2,90%,92%,88%,142,124,169,26%,20%,33%,5,3,2,0,0,0
33,https://vlr.gg/player/1284/mikee,2024-11-18 15:00:00,0.89,1.24,1.03,170,158,189,13,7,6,12,8,4,6,3,3,0,0,0,80%,83%,75%,117,101,142,23%,24%,21%,2,1,1,2,1,1
34,https://vlr.gg/player/13258/cyvoph,2024-11-18 15:00:00,1.17,0.74,1.00,149,200,76,12,10,2,12,8,4,5,4,1,+1,0,+1,70%,67%,75%,102,136,51,30%,38%,0%,2,1,1,1,1,0
35,https://vlr.gg/player/5199/guardy,2024-11-18 15:00:00,1.34,1.27,1.30,268,257,276,20,8,12,15,6,9,0,0,0,+1,+1,0,60%,75%,50%,170,168,172,27%,23%,30%,3,1,2,2,0,2
36,https://vlr.gg/player/2864/ease,2024-11-18 15:00:00,0.56,1.09,0.88,157,141,169,9,3,6,14,7,7,6,2,4,0,0,0,65%,50%,75%,126,121,129,27%,21%,30%,1,1,0,1,1,0
37,https://vlr.gg/player/7220/saiz,2024-11-18 15:00:00,0.83,0.69,0.75,154,159,152,11,5,6,15,6,9,3,2,1,-2,0,-2,60%,63%,58%,125,121,127,45%,50%,42%,0,0,0,2,0,2
38,https://vlr.gg/player/292/fit1nho,2024-11-18 15:00:00,0.41,0.77,0.63,179,149,199,12,4,8,18,7,11,4,2,2,-6,-5,-1,65%,63%,67%,123,107,135,26%,29%,24%,1,0,1,7,5,2
39,https://vlr.gg/player/20055/toki,2024-11-18 15:00:00,0.60,0.46,0.52,133,97,157,8,2,6,17,7,10,7,4,3,-3,0,-3,60%,63%,58%,94,59,118,36%,22%,44%,0,0,0,3,0,3
40,https://vlr.gg/player/42514/aleexfdz,2024-11-18 14:15:00,1.19,1.31,1.24,222,190,257,19,9,10,14,7,7,6,4,2,-1,-1,0,78%,67%,91%,144,128,161,28%,32%,25%,0,0,0,1,1,0
41,https://vlr.gg/player/48950/zeni,2024-11-18 14:15:00,1.63,0.60,1.14,241,305,171,20,14,6,18,8,10,7,3,4,-2,-1,-1,83%,83%,82%,164,199,126,31%,42%,17%,1,0,1,3,1,2
42,https://vlr.gg/player/46233/kz,2024-11-18 14:15:00,0.53,1.76,1.12,269,178,370,22,7,15,18,10,8,4,2,2,-2,-6,+4,83%,67%,100%,162,107,223,15%,10%,18%,5,1,4,7,7,0
43,https://vlr.gg/player/48951/hassan,2024-11-18 14:15:00,1.41,0.73,1.09,193,242,140,17,11,6,15,7,8,7,4,3,+3,+2,+1,70%,75%,64%,140,193,82,35%,33%,38%,3,2,1,0,0,0
44,https://vlr.gg/player/33833/pepecho,2024-11-18 14:15:00,0.90,1.03,0.96,177,152,206,15,7,8,15,8,7,8,5,3,+3,0,+3,87%,92%,82%,129,120,140,34%,44%,27%,3,0,3,0,0,0
45,https://vlr.gg/player/42519/lolito,2024-11-18 14:15:00,1.34,0.94,1.13,249,240,258,22,10,12,19,8,11,3,2,1,+1,+1,0,61%,55%,67%,166,157,175,32%,22%,43%,2,1,1,1,0,1
46,https://vlr.gg/player/31553/pukytoo,2024-11-18 14:15:00,0.86,1.14,1.01,188,182,195,15,7,8,16,8,8,4,1,3,+2,-1,+3,74%,91%,58%,126,113,139,43%,40%,47%,3,0,3,1,1,0
47,https://vlr.gg/player/2862/chechuu,2024-11-18 14:15:00,1.12,0.57,0.83,191,242,145,15,10,5,20,9,11,10,3,7,-2,-2,0,65%,73%,58%,125,151,101,37%,33%,41%,0,0,0,2,2,0
48,https://vlr.gg/player/44137/levi,2024-11-18 14:15:00,0.26,1.22,0.76,214,151,272,15,5,10,20,11,9,2,0,2,+1,-4,+5,78%,64%,92%,158,111,201,26%,35%,22%,5,0,5,4,4,0
49,https://vlr.gg/player/41764/meow,2024-11-18 14:15:00,0.83,0.64,0.73,158,207,115,13,8,5,18,9,9,1,1,0,-3,-1,-2,57%,64%,50%,113,148,80,32%,41%,20%,1,1,0,4,2,2
50,https://vlr.gg/player/4325/musashi,2024-11-18 14:00:00,3.10,2.10,2.47,418,518,361,29,14,15,7,2,5,11,4,7,+2,+1,+1,84%,86%,83%,251,301,222,46%,50%,44%,2,1,1,0,0,0
51,https://vlr.gg/player/12528/disisjohn,2024-11-18 14:00:00,0.72,1.38,1.14,296,159,377,17,3,14,14,5,9,5,2,3,+5,+1,+4,79%,71%,83%,204,137,243,31%,38%,29%,7,2,5,2,1,1
52,https://vlr.gg/player/3753/obnoks,2024-11-18 14:00:00,0.55,1.39,1.08,208,146,245,16,4,12,12,6,6,3,2,1,-1,0,-1,74%,71%,75%,137,101,158,41%,57%,36%,1,0,1,2,0,2
53,https://vlr.gg/player/30042/harmonee,2024-11-18 14:00:00,1.50,0.57,0.91,147,218,106,12,7,5,11,2,9,2,1,1,-2,0,-2,74%,86%,67%,100,153,69,39%,55%,25%,1,1,0,3,1,2
54,https://vlr.gg/player/37969/ellie,2024-11-18 14:00:00,0.93,0.56,0.70,79,111,60,4,2,2,9,3,6,8,4,4,+1,+1,0,68%,71%,67%,57,73,48,28%,38%,20%,1,1,0,0,0,0
55,https://vlr.gg/player/40004/globex,2024-11-18 14:00:00,1.36,0.92,1.20,298,330,246,18,12,6,15,9,6,4,3,1,0,+2,-2,58%,67%,43%,181,200,147,25%,25%,25%,4,3,1,4,1,3
56,https://vlr.gg/player/38424/zachkappa,2024-11-18 14:00:00,1.02,1.11,1.05,249,229,285,15,9,6,16,10,6,4,2,2,0,-1,+1,68%,67%,71%,179,168,197,28%,27%,30%,2,1,1,2,2,0
57,https://vlr.gg/player/30096/bobbiexo,2024-11-18 14:00:00,1.41,0.18,0.95,154,220,42,11,11,0,13,7,6,3,1,2,-1,0,-1,63%,75%,43%,121,157,58,25%,25%,25%,0,0,0,1,0,1
58,https://vlr.gg/player/20116/jademwah,2024-11-18 14:00:00,0.22,0.58,0.35,89,80,104,6,3,3,16,10,6,3,1,2,-4,-3,-1,53%,50%,57%,60,61,58,29%,30%,25%,1,1,0,5,4,1
59,https://vlr.gg/player/30107/fluxxy,2024-11-18 14:00:00,0.02,0.51,0.14,58,36,95,3,0,3,18,12,6,7,6,1,0,0,0,47%,42%,57%,41,30,59,25%,0%,60%,0,0,0,0,0,0
60,https://vlr.gg/player/23082/cobra,2024-11-18 13:10:00,1.50,1.12,1.33,245,275,210,17,11,6,15,8,7,12,4,8,-2,-1,-1,82%,75%,90%,152,161,142,33%,29%,40%,0,0,0,2,1,1
61,https://vlr.gg/player/48956/bujaxd,2024-11-18 13:10:00,1.28,1.00,1.15,245,244,248,19,10,9,18,9,9,9,6,3,+2,+2,0,73%,75%,70%,155,136,178,38%,36%,39%,3,2,1,1,0,1
62,https://vlr.gg/player/48952/xpiryy,2024-11-18 13:10:00,0.88,1.06,0.96,205,192,223,17,8,9,17,10,7,4,2,2,0,0,0,73%,67%,80%,133,127,139,31%,50%,19%,3,2,1,3,2,1
63,https://vlr.gg/player/48953/t1tan,2024-11-18 13:10:00,0.67,1.21,0.91,188,137,250,14,5,9,17,9,8,5,2,3,+3,+2,+1,68%,67%,70%,126,89,171,28%,21%,33%,4,2,2,1,0,1
64,https://vlr.gg/player/48955/dubstep,2024-11-18 13:10:00,0.19,0.49,0.32,71,65,80,5,2,3,18,11,7,7,3,4,-1,-1,0,59%,58%,60%,59,51,67,33%,20%,50%,2,1,1,3,2,1
65,https://vlr.gg/player/22314/mober,2024-11-18 13:10:00,1.11,2.12,1.66,312,279,340,27,11,16,13,8,5,3,1,2,-1,0,-1,77%,80%,75%,203,168,232,53%,47%,57%,1,1,0,2,1,1
66,https://vlr.gg/player/32300/varuxx,2024-11-18 13:10:00,1.57,0.89,1.20,212,232,195,16,9,7,13,5,8,7,1,6,0,+1,-1,64%,70%,58%,150,152,147,31%,33%,29%,2,2,0,2,1,1
67,https://vlr.gg/player/14894/facepalm,2024-11-18 13:10:00,1.02,0.91,0.96,215,231,203,17,9,8,16,8,8,4,1,3,-2,0,-2,64%,60%,67%,141,138,145,28%,27%,29%,4,2,2,6,2,4
68,https://vlr.gg/player/2853/apex,2024-11-18 13:10:00,0.81,0.86,0.84,179,206,157,13,6,7,16,9,7,15,7,8,0,0,0,68%,50%,83%,122,144,104,19%,19%,18%,0,0,0,0,0,0
69,https://vlr.gg/player/16139/enrik,2024-11-18 13:10:00,0.58,0.86,0.74,142,90,187,12,3,9,14,6,8,8,6,2,+1,-1,+2,73%,70%,75%,94,72,113,28%,33%,26%,3,0,3,2,1,1
70,https://vlr.gg/player/18400/bipo,2024-11-18 13:00:00,1.20,1.27,1.23,231,221,245,17,9,8,15,10,5,2,0,2,+5,+4,+1,67%,58%,78%,148,144,153,24%,27%,21%,7,4,3,2,0,2
71,https://vlr.gg/player/1944/cayden,2024-11-18 13:00:00,1.19,1.21,1.20,214,244,175,16,10,6,14,10,4,4,3,1,0,+1,-1,62%,67%,56%,151,174,119,28%,26%,31%,1,1,0,1,0,1
72,https://vlr.gg/player/5854/z3ro,2024-11-18 13:00:00,0.74,0.84,0.78,205,193,221,14,8,6,18,10,8,7,4,3,0,0,0,76%,67%,89%,121,112,133,33%,24%,47%,1,1,0,1,1,0
73,https://vlr.gg/player/24069/mochi,2024-11-18 13:00:00,0.78,0.58,0.69,124,154,86,10,7,3,16,10,6,4,3,1,0,-1,+1,62%,58%,67%,89,108,65,53%,67%,29%,1,0,1,1,1,0
74,https://vlr.gg/player/24068/effy,2024-11-18 13:00:00,0.04,0.49,0.22,70,35,118,4,1,3,16,10,6,6,2,4,-6,-4,-2,48%,42%,56%,48,26,78,36%,67%,27%,0,0,0,6,4,2
75,https://vlr.gg/player/19776/jrayn,2024-11-18 13:00:00,1.43,2.36,1.96,348,252,421,26,8,18,9,5,4,5,1,4,+3,+1,+2,90%,89%,92%,220,142,278,37%,28%,40%,3,1,2,0,0,0
76,https://vlr.gg/player/19362/lyda,2024-11-18 13:00:00,1.21,1.07,1.13,186,193,183,14,6,8,12,5,7,10,6,4,0,0,0,90%,89%,92%,116,117,116,54%,50%,57%,1,0,1,1,0,1
77,https://vlr.gg/player/573/cned,2024-11-18 13:00:00,1.30,0.87,1.06,233,292,189,18,9,9,14,6,8,4,1,3,-1,0,-1,71%,78%,67%,148,182,122,20%,33%,8%,3,2,1,4,2,2
78,https://vlr.gg/player/3557/skylen,2024-11-18 13:00:00,0.73,1.19,0.99,201,124,260,17,4,13,14,6,8,3,2,1,0,+1,-1,81%,67%,92%,129,80,165,58%,100%,48%,3,2,1,3,1,2
79,https://vlr.gg/player/22792/jiex,2024-11-18 13:00:00,0.82,0.36,0.56,71,70,73,4,2,2,12,4,8,6,2,4,-1,-1,0,67%,67%,67%,59,61,58,29%,43%,21%,1,0,1,2,1,1
80,https://vlr.gg/player/23090/krystal,2024-11-18 12:00:00,1.83,0.60,1.13,251,413,131,19,14,5,17,6,11,0,0,0,-1,+2,-3,67%,89%,50%,182,277,111,30%,29%,31%,3,2,1,4,0,4
81,https://vlr.gg/player/42521/jahbu,2024-11-18 12:00:00,1.03,0.95,0.98,241,280,212,16,8,8,18,8,10,6,2,4,0,+2,-2,67%,78%,58%,163,183,147,43%,47%,39%,2,2,0,2,0,2
82,https://vlr.gg/player/29974/erizillo,2024-11-18 12:00:00,0.91,0.93,0.92,183,151,208,14,6,8,17,7,10,4,2,2,0,-1,+1,71%,67%,75%,107,81,127,14%,18%,12%,1,0,1,1,1,0
83,https://vlr.gg/player/2886/drk,2024-11-18 12:00:00,0.16,0.93,0.60,119,53,169,8,1,7,16,7,9,5,2,3,-3,-2,-1,52%,44%,58%,70,43,90,23%,25%,22%,0,0,0,3,2,1
84,https://vlr.gg/player/4951/hardy,2024-11-18 12:00:00,0.59,0.35,0.45,154,176,139,8,5,3,20,8,12,7,3,4,-5,-2,-3,57%,67%,50%,120,126,116,8%,14%,3%,0,0,0,5,2,3
85,https://vlr.gg/player/22291/razziss,2024-11-18 12:00:00,1.88,1.40,1.67,396,472,294,30,20,10,15,8,7,7,3,4,+6,+6,0,95%,100%,89%,254,298,196,29%,27%,35%,7,6,1,1,0,1
86,https://vlr.gg/player/8595/skygi,2024-11-18 12:00:00,1.63,1.65,1.64,298,280,324,21,12,9,10,5,5,14,9,5,+3,+2,+1,95%,92%,100%,183,165,207,26%,30%,21%,3,2,1,0,0,0
87,https://vlr.gg/player/15487/aqua,2024-11-18 12:00:00,1.42,1.29,1.36,231,201,273,18,10,8,12,5,7,9,5,4,+1,0,+1,90%,92%,89%,152,142,164,28%,32%,24%,3,1,2,2,1,1
88,https://vlr.gg/player/22495/mochi,2024-11-18 12:00:00,1.01,0.95,0.99,175,172,181,14,8,6,12,6,6,9,3,6,+1,+1,0,71%,83%,56%,105,103,108,38%,43%,33%,1,1,0,0,0,0
89,https://vlr.gg/player/16012/akira,2024-11-18 12:00:00,0.55,0.13,0.37,82,79,87,5,2,3,16,7,9,14,10,4,-2,-1,-1,67%,83%,44%,46,51,41,14%,15%,11%,1,0,1,3,1,2
90,https://vlr.gg/player/5283/bunny,2024-11-18 05:40:00,1.80,1.21,1.45,321,365,290,42,21,21,30,11,19,21,9,12,+7,+3,+4,85%,82%,88%,208,260,171,24%,35%,16%,11,5,6,4,2,2
91,https://vlr.gg/player/9783/doenmo,2024-11-18 05:40:00,1.14,1.15,1.14,214,172,248,33,12,21,27,9,18,24,11,13,+2,0,+2,93%,94%,92%,125,106,139,29%,28%,29%,4,1,3,2,1,1
92,https://vlr.gg/player/985/efina,2024-11-18 05:40:00,1.21,1.06,1.13,186,200,173,24,11,13,21,8,13,10,5,5,+1,+1,0,78%,82%,75%,124,138,114,18%,21%,15%,3,2,1,2,1,1
93,https://vlr.gg/player/28401/pkm,2024-11-18 05:40:00,1.12,1.10,1.11,198,207,189,32,15,17,25,10,15,8,1,7,-1,+2,-3,83%,82%,83%,141,142,141,22%,41%,15%,2,2,0,3,0,3
94,https://vlr.gg/player/4827/goddead,2024-11-18 05:40:00,1.00,1.16,1.09,206,198,210,29,11,18,29,13,16,26,15,11,+4,+3,+1,80%,82%,79%,133,137,130,24%,26%,23%,7,3,4,3,0,3
95,https://vlr.gg/player/20928/seolho,2024-11-18 05:40:00,1.65,0.88,1.33,267,342,167,39,30,9,29,15,14,15,6,9,-1,0,-1,73%,75%,71%,160,201,101,32%,34%,27%,2,2,0,3,2,1
96,https://vlr.gg/player/4040/nezz,2024-11-18 05:40:00,1.30,1.19,1.25,254,272,236,39,24,15,30,17,13,5,3,2,+2,0,+2,78%,83%,71%,168,178,155,41%,47%,32%,5,2,3,3,2,1
97,https://vlr.gg/player/1986/idg,2024-11-18 05:40:00,0.97,0.82,0.91,154,160,149,19,11,8,28,15,13,20,10,10,-2,+2,-4,80%,83%,76%,104,105,103,12%,9%,16%,3,3,0,5,1,4
98,https://vlr.gg/player/9194/blueming,2024-11-18 05:40:00,0.46,0.58,0.51,153,135,177,21,11,10,36,20,16,5,3,2,-6,-4,-2,61%,67%,53%,108,98,123,28%,31%,24%,2,1,1,8,5,3
99,https://vlr.gg/player/42721/awayk,2024-11-18 05:40:00,0.10,0.63,0.31,103,75,146,14,5,9,37,23,14,10,5,5,-6,-2,-4,61%,63%,59%,69,61,80,18%,18%,18%,2,2,0,8,4,4
100,https://vlr.gg/player/17272/dokja,2024-11-18 04:45:00,1.66,1.96,1.77,358,318,405,52,29,23,23,13,10,6,5,1,+6,+3,+3,82%,79%,87%,209,196,230,32%,33%,31%,7,4,3,1,1,0
101,https://vlr.gg/player/36747/bonobo,2024-11-18 04:45:00,1.15,1.14,1.15,204,212,193,26,18,8,24,15,9,16,4,12,+5,+5,0,82%,83%,80%,134,138,128,39%,46%,29%,8,6,2,3,1,2
102,https://vlr.gg/player/1771/myth,2024-11-18 04:45:00,0.93,1.46,1.13,200,133,323,28,11,17,22,12,10,12,8,4,+1,+1,0,72%,71%,73%,119,74,190,10%,13%,8%,3,2,1,2,1,1
103,https://vlr.gg/player/31580/vizsla,2024-11-18 04:45:00,1.11,0.65,0.94,154,171,121,22,16,6,22,11,11,11,6,5,+2,+2,0,77%,79%,73%,105,127,70,23%,39%,9%,5,3,2,3,1,2
104,https://vlr.gg/player/44437/ace,2024-11-18 04:45:00,1.24,0.43,0.93,184,246,85,25,20,5,23,12,11,10,7,3,+1,+1,0,69%,67%,73%,123,175,40,35%,40%,10%,4,3,1,3,2,1
105,https://vlr.gg/player/41185/kaza,2024-11-18 04:45:00,1.51,0.99,1.19,261,335,205,34,18,16,29,11,18,8,3,5,-3,+1,-4,72%,80%,67%,158,208,128,28%,37%,20%,2,2,0,5,1,4
106,https://vlr.gg/player/31632/zenox,2024-11-18 04:45:00,1.18,0.56,0.79,163,225,131,22,13,9,31,10,21,4,1,3,-3,-2,-1,49%,53%,46%,119,146,103,28%,29%,28%,3,2,1,6,4,2
107,https://vlr.gg/player/5240/indie,2024-11-18 04:45:00,0.57,0.84,0.73,176,169,187,25,9,16,32,13,19,8,5,3,-6,-2,-4,54%,67%,46%,114,103,120,33%,33%,32%,4,1,3,10,3,7
108,https://vlr.gg/player/3287/exempt,2024-11-18 04:45:00,0.63,0.75,0.71,143,139,143,18,7,11,29,12,17,8,4,4,-3,0,-3,64%,67%,63%,91,81,97,32%,23%,40%,1,1,0,4,1,3
109,https://vlr.gg/player/5436/azoh,2024-11-18 04:45:00,0.33,0.73,0.57,125,84,156,15,4,11,32,13,19,19,10,9,0,0,0,59%,60%,58%,77,39,101,18%,18%,18%,2,0,2,2,0,2
110,https://vlr.gg/player/5796/kr1stal,2024-11-18 04:00:00,1.28,1.51,1.38,273,221,320,38,19,19,22,12,10,13,6,7,+4,+1,+3,88%,83%,94%,176,162,196,28%,28%,28%,4,1,3,0,0,0
111,https://vlr.gg/player/4428/udotan,2024-11-18 04:00:00,1.37,1.38,1.37,245,241,249,39,22,17,23,14,9,9,5,4,+4,+4,0,78%,79%,76%,157,159,153,34%,32%,36%,7,5,2,3,1,2
112,https://vlr.gg/player/13219/papi,2024-11-18 04:00:00,1.24,1.02,1.15,192,241,134,27,19,8,23,15,8,18,12,6,-1,-1,0,83%,79%,88%,128,156,90,32%,34%,24%,3,1,2,4,2,2
113,https://vlr.gg/player/7437/kellys,2024-11-18 04:00:00,0.83,1.23,0.99,171,148,197,27,14,13,25,16,9,11,5,6,0,0,0,80%,79%,82%,113,93,141,27%,34%,21%,2,2,0,2,2,0
114,https://vlr.gg/player/44259/patrickwho,2024-11-18 04:00:00,0.92,0.96,0.94,207,225,181,30,19,11,30,20,10,9,7,2,+4,+2,+2,76%,75%,76%,138,157,111,26%,29%,21%,10,6,4,6,4,2
115,https://vlr.gg/player/27336/venka,2024-11-18 04:00:00,1.08,0.99,1.03,242,262,244,36,15,21,34,14,20,2,0,2,-3,0,-3,59%,59%,58%,168,163,171,40%,45%,37%,4,2,2,7,2,5
116,https://vlr.gg/player/3639/hoax,2024-11-18 04:00:00,0.82,1.13,1.00,204,168,226,27,9,18,31,14,17,10,3,7,-1,0,-1,71%,59%,79%,142,125,154,27%,22%,31%,1,0,1,2,0,2
117,https://vlr.gg/player/27775/techno,2024-11-18 04:00:00,0.88,0.84,0.85,159,160,166,24,10,14,30,12,18,10,6,4,-2,-1,-1,63%,71%,58%,104,99,107,36%,58%,27%,6,2,4,8,3,5
118,https://vlr.gg/player/3627/hellff,2024-11-18 04:00:00,0.32,0.97,0.70,125,79,161,18,4,14,32,14,18,18,4,14,-5,-3,-2,61%,65%,58%,83,55,102,23%,27%,22%,0,0,0,5,3,2
119,https://vlr.gg/player/26376/deecee,2024-11-18 04:00:00,0.70,0.59,0.63,141,153,147,18,8,10,34,14,20,10,3,7,0,-1,+1,71%,59%,79%,104,108,100,27%,25%,29%,4,2,2,4,3,1
120,https://vlr.gg/player/4426/klaus,2024-11-18 03:10:00,1.55,1.19,1.40,285,329,216,51,34,17,32,18,14,12,8,4,+1,+1,0,87%,93%,80%,189,220,148,63%,67%,55%,4,2,2,3,1,2
121,https://vlr.gg/player/37532/zexy,2024-11-18 03:10:00,1.65,0.88,1.33,298,348,230,46,31,15,33,16,17,14,9,5,+8,+7,+1,79%,85%,70%,182,217,135,39%,39%,38%,13,8,5,5,1,4
122,https://vlr.gg/player/2149/c1nder,2024-11-18 03:10:00,1.18,0.99,1.10,184,189,208,33,19,14,29,14,15,27,18,9,+3,+3,0,81%,89%,70%,122,115,130,42%,33%,51%,5,4,1,2,1,1
123,https://vlr.gg/player/34926/oonzmlp,2024-11-18 03:10:00,0.75,1.33,1.00,194,133,254,31,13,18,30,16,14,22,13,9,-1,-1,0,74%,74%,75%,114,87,150,31%,29%,34%,4,3,1,5,4,1
124,https://vlr.gg/player/42733/xuna,2024-11-18 03:10:00,1.05,0.51,0.82,156,158,127,25,17,8,28,12,16,8,5,3,-2,-1,-1,70%,81%,55%,96,107,82,37%,53%,19%,2,1,1,4,2,2
125,https://vlr.gg/player/17049/hermes,2024-11-18 03:10:00,1.30,1.00,1.13,229,265,223,39,20,19,35,14,21,10,5,5,-2,+2,-4,70%,80%,63%,146,154,139,32%,27%,36%,8,5,3,10,3,7
126,https://vlr.gg/player/4127/felix,2024-11-18 03:10:00,0.66,1.23,0.99,187,171,208,31,10,21,37,18,19,17,11,6,-3,-1,-2,62%,65%,59%,130,125,134,27%,24%,30%,1,0,1,4,1,3
127,https://vlr.gg/player/25089/cabeza,2024-11-18 03:10:00,1.55,0.36,0.87,203,315,133,34,23,11,40,14,26,13,8,5,+2,+3,-1,70%,85%,59%,139,194,98,26%,25%,27%,5,4,1,3,1,2
128,https://vlr.gg/player/25082/rico,2024-11-18 03:10:00,0.93,0.69,0.79,168,188,179,24,11,13,39,15,24,26,10,16,-1,-1,0,79%,80%,78%,128,140,119,30%,38%,24%,3,1,2,4,2,2
129,https://vlr.gg/player/25080/empty,2024-11-18 03:10:00,0.98,0.61,0.77,174,182,152,24,12,12,39,15,24,20,12,8,-5,-3,-2,66%,90%,48%,108,111,106,28%,35%,23%,2,0,2,7,3,4
130,https://vlr.gg/player/31589/murza,2024-11-18 02:30:00,0.81,1.91,1.30,259,172,365,36,14,22,24,15,9,9,1,8,+4,+1,+3,68%,57%,82%,164,115,225,19%,26%,13%,5,2,3,1,1,0
131,https://vlr.gg/player/46993/long,2024-11-18 02:30:00,1.40,0.99,1.22,245,297,179,30,20,10,27,15,12,22,12,10,-2,+1,-3,82%,90%,71%,174,218,119,15%,15%,15%,3,3,0,5,2,3
132,https://vlr.gg/player/34226/sh0pan,2024-11-18 02:30:00,0.84,1.67,1.21,214,184,268,33,14,19,23,16,7,8,5,3,+4,+1,+3,76%,67%,88%,147,120,181,22%,24%,20%,7,4,3,3,3,0
133,https://vlr.gg/player/26316/ramen,2024-11-18 02:30:00,1.09,1.08,1.08,181,180,181,23,13,10,23,13,10,26,14,12,0,+1,-1,79%,81%,76%,119,124,112,22%,31%,16%,3,2,1,3,1,2
134,https://vlr.gg/player/31593/kiss,2024-11-18 02:30:00,1.08,0.97,1.03,193,208,161,27,16,11,28,16,12,16,11,5,+2,+1,+1,79%,81%,76%,127,135,116,38%,42%,32%,5,2,3,3,1,2
135,https://vlr.gg/player/22829/ibrocky,2024-11-18 02:30:00,0.70,1.57,1.18,219,176,260,29,10,19,27,14,13,15,4,11,+1,0,+1,76%,65%,86%,158,122,188,25%,26%,24%,2,0,2,1,0,1
136,https://vlr.gg/player/15078/noir,2024-11-18 02:30:00,0.53,1.27,0.94,219,163,264,28,9,19,31,15,16,13,3,10,+1,-1,+2,71%,65%,76%,153,115,184,25%,35%,22%,5,2,3,4,3,1
137,https://vlr.gg/player/22831/art,2024-11-18 02:30:00,1.07,0.63,0.83,170,213,135,24,13,11,29,14,15,14,9,5,-5,-1,-4,74%,82%,67%,106,130,86,26%,39%,17%,1,0,1,6,1,5
138,https://vlr.gg/player/33061/brock,2024-11-18 02:30:00,0.68,0.92,0.82,175,154,198,21,8,13,32,15,17,19,7,12,-1,-1,0,74%,59%,86%,118,99,133,18%,15%,20%,4,2,2,5,3,2
139,https://vlr.gg/player/43129/dasani,2024-11-18 02:30:00,0.76,0.79,0.78,204,203,199,23,10,13,30,14,16,11,4,7,-4,0,-4,68%,71%,67%,145,131,156,28%,29%,28%,3,3,0,7,3,4
140,https://vlr.gg/player/17976/florescent,2024-11-17 10:00:00,1.51,1.59,1.55,317,341,300,74,37,37,37,21,16,8,3,5,+17,+14,+3,80%,84%,75%,198,214,183,26%,24%,32%,23,16,7,6,2,4
141,https://vlr.gg/player/21486/sarahcat,2024-11-17 10:00:00,1.19,1.26,1.22,226,199,251,49,22,27,35,17,18,18,10,8,+1,-1,+2,83%,84%,81%,151,131,170,20%,21%,19%,5,1,4,4,2,2
142,https://vlr.gg/player/17397/noia,2024-11-17 10:00:00,1.12,1.19,1.16,210,204,216,51,26,25,37,19,18,12,3,9,+4,+3,+1,72%,69%,75%,145,134,156,33%,30%,35%,6,3,3,2,0,2
143,https://vlr.gg/player/3079/alexis,2024-11-17 10:00:00,1.02,0.87,0.95,145,144,141,28,14,14,35,17,18,37,20,17,-3,-2,-1,81%,78%,84%,94,94,94,15%,6%,28%,1,0,1,4,2,2
144,https://vlr.gg/player/3063/mel,2024-11-17 10:00:00,0.86,0.95,0.91,167,164,167,36,17,19,38,19,19,34,22,12,-3,-4,+1,73%,72%,75%,102,98,106,18%,14%,22%,5,1,4,8,5,3
145,https://vlr.gg/player/31574/srn,2024-11-17 10:00:00,0.79,1.12,0.95,217,210,227,44,20,24,51,28,23,10,7,3,-4,-2,-2,69%,66%,72%,148,140,155,27%,27%,26%,13,7,6,17,9,8
146,https://vlr.gg/player/21435/jelly,2024-11-17 10:00:00,0.95,0.94,0.95,185,196,178,41,23,18,49,25,24,22,8,14,-2,-1,-1,64%,66%,63%,116,119,112,31%,31%,30%,3,1,2,5,2,3
147,https://vlr.gg/player/19791/mel,2024-11-17 10:00:00,0.98,0.74,0.86,174,179,165,36,20,16,47,22,25,21,7,14,-3,0,-3,66%,63%,69%,112,121,102,19%,22%,16%,4,3,1,7,3,4
148,https://vlr.gg/player/11239/sayuri,2024-11-17 10:00:00,0.61,1.07,0.84,162,119,201,36,13,23,46,24,22,24,10,14,-5,-3,-2,64%,56%,72%,100,80,121,14%,22%,11%,2,1,1,7,4,3
149,https://vlr.gg/player/14685/jubs,2024-11-17 10:00:00,0.72,0.61,0.67,119,120,116,25,13,12,45,23,22,9,6,3,-2,0,-2,63%,56%,69%,82,83,81,22%,26%,20%,2,1,1,4,1,3
150,https://vlr.gg/player/2377/aduka,2024-11-17 01:45:00,1.19,1.15,1.17,249,251,254,73,32,41,63,27,36,30,16,14,-2,-1,-1,73%,73%,73%,167,163,169,28%,26%,29%,9,3,6,11,4,7
151,https://vlr.gg/player/17814/toggle,2024-11-17 01:45:00,1.04,1.04,1.04,227,248,211,67,32,35,67,30,37,20,8,12,+5,+3,+2,73%,68%,77%,152,165,142,24%,24%,24%,16,10,6,11,7,4
152,https://vlr.gg/player/7371/fishball,2024-11-17 01:45:00,1.04,0.91,0.97,201,209,195,58,25,33,64,26,38,39,21,18,-1,0,-1,74%,78%,71%,140,147,135,22%,21%,23%,8,3,5,9,3,6
153,https://vlr.gg/player/9179/kael,2024-11-17 01:45:00,0.80,0.83,0.82,182,165,197,56,22,34,68,27,41,11,5,6,0,0,0,64%,59%,67%,117,108,124,29%,26%,32%,8,3,5,8,3,5
154,https://vlr.gg/player/31189/kye,2024-11-17 01:45:00,0.79,0.69,0.73,137,127,143,40,19,21,63,24,39,32,14,18,+1,+1,0,66%,62%,69%,87,78,94,43%,35%,48%,3,1,2,2,0,2
155,https://vlr.gg/player/5886/flaring,2024-11-17 01:45:00,1.34,1.16,1.26,225,239,208,70,40,30,53,29,24,36,23,13,-1,-1,0,76%,81%,70%,151,162,135,28%,29%,28%,3,1,2,4,2,2
156,https://vlr.gg/player/7443/riza,2024-11-17 01:45:00,1.13,1.20,1.16,225,221,227,70,39,31,59,33,26,24,13,11,-1,-1,0,78%,79%,76%,144,147,140,30%,29%,32%,8,4,4,9,5,4
157,https://vlr.gg/player/7513/markl,2024-11-17 01:45:00,0.94,1.26,1.08,221,182,272,69,33,36,58,31,27,21,11,10,+3,-1,+4,71%,71%,70%,144,122,173,26%,20%,32%,10,4,6,7,5,2
158,https://vlr.gg/player/3480/thedoctorr,2024-11-17 01:45:00,1.04,1.11,1.07,160,155,171,52,30,22,51,27,24,33,15,18,0,-1,+1,72%,75%,68%,112,110,115,36%,41%,29%,4,2,2,4,3,1
159,https://vlr.gg/player/45876/fixy,2024-11-17 01:45:00,1.01,0.55,0.81,221,289,129,64,49,15,73,44,29,13,7,6,-4,+4,-8,67%,71%,62%,145,185,94,30%,33%,23%,16,13,3,20,9,11
160,https://vlr.gg/player/17272/dokja,2024-11-16 23:40:00,1.34,1.07,1.21,242,272,210,62,36,26,44,23,21,7,5,2,-1,0,-1,75%,75%,75%,160,179,138,27%,27%,28%,6,4,2,7,4,3
161,https://vlr.gg/player/36747/bonobo,2024-11-16 23:40:00,0.94,1.24,1.08,223,188,260,53,24,29,46,24,22,19,11,8,-1,-2,+1,69%,69%,69%,153,136,172,37%,40%,34%,3,2,1,4,4,0
162,https://vlr.gg/player/31580/vizsla,2024-11-16 23:40:00,0.97,0.80,0.89,184,222,151,42,25,17,49,27,22,28,20,8,-2,+1,-3,72%,81%,63%,115,131,98,32%,36%,27%,6,5,1,8,4,4
163,https://vlr.gg/player/1771/myth,2024-11-16 23:40:00,0.80,0.98,0.88,191,182,193,42,22,20,49,27,22,19,7,12,-2,-1,-1,68%,69%,66%,121,118,124,24%,22%,26%,6,3,3,8,4,4
164,https://vlr.gg/player/44437/ace,2024-11-16 23:40:00,0.64,0.84,0.74,162,148,182,33,19,14,49,26,23,17,5,12,-2,0,-2,69%,72%,66%,124,118,132,27%,30%,24%,9,3,6,11,3,8
165,https://vlr.gg/player/43125/kadiri,2024-11-16 23:40:00,1.01,1.48,1.26,216,154,267,50,17,33,43,19,24,24,11,13,+5,+2,+3,76%,66%,86%,138,96,176,41%,47%,37%,7,4,3,2,2,0
166,https://vlr.gg/player/29821/sinaway,2024-11-16 23:40:00,1.34,1.09,1.21,234,257,212,59,32,27,45,21,24,17,11,6,-2,-1,-1,78%,81%,75%,154,171,139,25%,26%,25%,6,2,4,8,3,5
167,https://vlr.gg/player/31254/feta,2024-11-16 23:40:00,1.19,1.21,1.20,236,248,230,57,26,31,45,22,23,15,13,2,+4,+3,+1,72%,78%,67%,156,161,152,25%,26%,24%,13,6,7,9,3,6
168,https://vlr.gg/player/31255/biggiecheese,2024-11-16 23:40:00,0.54,1.15,0.86,167,111,213,35,12,23,51,24,27,28,6,22,+4,+1,+3,71%,66%,75%,114,73,151,33%,23%,39%,7,3,4,3,2,1
169,https://vlr.gg/player/29790/zauqk,2024-11-16 23:40:00,1.08,0.61,0.83,152,192,120,35,22,13,48,21,27,28,12,16,-3,+1,-4,71%,75%,67%,107,123,92,21%,25%,17%,5,4,1,8,3,5
170,https://vlr.gg/player/45876/fixy,2024-11-16 21:00:00,1.49,1.22,1.37,299,324,259,44,26,18,31,16,15,10,5,5,+5,+3,+2,80%,82%,79%,190,212,165,25%,23%,30%,9,5,4,4,2,2
171,https://vlr.gg/player/3480/thedoctorr,2024-11-16 21:00:00,1.43,1.07,1.27,223,244,201,34,20,14,25,12,13,24,14,10,+3,+3,0,83%,91%,74%,147,160,132,34%,37%,31%,7,5,2,4,2,2
172,https://vlr.gg/player/7443/riza,2024-11-16 21:00:00,1.14,1.15,1.14,226,228,222,35,20,15,25,14,11,10,6,4,-1,0,-1,76%,77%,74%,148,148,148,34%,29%,43%,3,2,1,4,2,2
173,https://vlr.gg/player/7513/markl,2024-11-16 21:00:00,1.20,0.83,1.02,189,215,157,26,18,8,26,12,14,15,4,11,+1,-2,+3,76%,86%,63%,127,149,102,34%,37%,29%,4,0,4,3,2,1
174,https://vlr.gg/player/5886/flaring,2024-11-16 21:00:00,1.02,1.00,1.01,166,175,156,24,14,10,25,14,11,20,8,12,-1,0,-1,83%,91%,74%,113,131,92,31%,29%,35%,1,1,0,2,1,1
175,https://vlr.gg/player/27053/ender,2024-11-16 21:00:00,1.22,1.32,1.27,268,229,294,38,16,22,31,13,18,8,6,2,-3,-1,-2,61%,58%,64%,177,159,191,41%,36%,46%,2,1,1,5,2,3
176,https://vlr.gg/player/36707/bullet,2024-11-16 21:00:00,0.49,1.18,0.86,187,93,267,26,5,21,31,12,19,16,8,8,-6,-4,-2,71%,58%,82%,115,56,165,13%,15%,13%,1,0,1,7,4,3
177,https://vlr.gg/player/26965/haeart,2024-11-16 21:00:00,0.85,0.77,0.81,181,162,201,25,12,13,35,15,20,15,6,9,+2,0,+2,66%,68%,64%,107,93,120,33%,23%,45%,4,1,3,2,1,1
178,https://vlr.gg/player/27102/asphyxia,2024-11-16 21:00:00,1.20,0.32,0.73,154,189,119,21,14,7,32,11,21,5,1,4,+1,+1,0,61%,68%,55%,110,128,94,32%,41%,26%,4,2,2,3,1,2
179,https://vlr.gg/player/36687/miz,2024-11-16 21:00:00,1.09,0.16,0.59,161,265,76,22,17,5,35,15,20,7,4,3,-1,+1,-2,59%,63%,55%,92,146,44,10%,13%,4%,6,4,2,7,3,4
180,https://vlr.gg/player/1062/lew,2024-11-16 21:00:00,1.31,1.06,1.18,278,314,228,50,30,20,41,21,20,11,5,6,+13,+7,+6,70%,85%,56%,168,197,139,30%,31%,28%,16,9,7,3,2,1
181,https://vlr.gg/player/12968/tixx,2024-11-16 21:00:00,0.86,1.16,1.01,202,167,244,36,14,22,37,18,19,32,21,11,-4,-3,-1,78%,74%,81%,148,123,172,36%,36%,36%,2,0,2,6,3,3
182,https://vlr.gg/player/26310/ikana,2024-11-16 21:00:00,1.00,0.83,0.92,181,201,161,35,19,16,37,18,19,12,6,6,-1,-1,0,65%,67%,63%,115,133,97,22%,18%,28%,2,0,2,3,1,2
183,https://vlr.gg/player/5228/minimise,2024-11-16 21:00:00,1.24,0.50,0.87,172,222,128,35,23,12,40,18,22,15,11,4,+1,+1,0,72%,85%,59%,118,138,98,22%,22%,22%,6,4,2,5,3,2
184,https://vlr.gg/player/6659/dragon,2024-11-16 21:00:00,1.13,0.59,0.84,193,224,171,38,23,15,41,19,22,23,14,9,-3,-3,0,65%,78%,52%,127,135,119,31%,30%,33%,4,1,3,7,4,3
185,https://vlr.gg/player/29821/sinaway,2024-11-16 21:00:00,1.19,1.50,1.34,229,188,273,47,19,28,34,14,20,14,9,5,0,-1,+1,67%,67%,67%,160,140,181,31%,24%,36%,4,1,3,4,2,2
186,https://vlr.gg/player/31255/biggiecheese,2024-11-16 21:00:00,1.45,1.11,1.28,255,260,241,45,24,21,40,16,24,25,10,15,+2,0,+2,81%,85%,78%,165,167,163,32%,30%,34%,3,1,2,1,1,0
187,https://vlr.gg/player/31254/feta,2024-11-16 21:00:00,1.58,0.67,1.13,228,302,162,42,27,15,40,18,22,11,6,5,+4,+5,-1,70%,70%,70%,152,191,114,23%,28%,17%,12,8,4,8,3,5
188,https://vlr.gg/player/43125/kadiri,2024-11-16 21:00:00,1.08,0.94,1.01,201,190,201,38,19,19,39,17,22,16,4,12,-4,-4,0,67%,59%,74%,132,136,128,39%,38%,39%,4,1,3,8,5,3
189,https://vlr.gg/player/29790/zauqk,2024-11-16 21:00:00,0.62,0.60,0.61,128,120,141,24,13,11,41,20,21,12,4,8,-8,-5,-3,56%,59%,52%,92,85,99,18%,21%,16%,1,0,1,9,5,4
190,https://vlr.gg/player/24428/harambe,2024-11-16 13:00:00,1.35,1.52,1.44,264,278,252,64,32,32,42,27,15,15,6,9,+7,+2,+5,82%,76%,88%,174,177,171,35%,33%,37%,10,5,5,3,3,0
191,https://vlr.gg/player/30901/ianto,2024-11-16 13:00:00,0.73,1.46,1.09,195,159,232,49,17,32,44,29,15,29,17,12,+2,+3,-1,79%,79%,79%,116,93,139,26%,22%,29%,7,5,2,5,2,3
192,https://vlr.gg/player/12519/ticey,2024-11-16 13:00:00,0.75,1.19,0.97,205,188,222,51,24,27,48,30,18,13,5,8,-3,-6,+3,76%,76%,76%,132,121,142,16%,15%,16%,8,1,7,11,7,4
193,https://vlr.gg/player/31298/luca,2024-11-16 13:00:00,0.85,1.06,0.95,198,169,228,48,19,29,49,28,21,13,6,7,+5,-1,+6,66%,59%,74%,136,127,145,29%,26%,31%,7,1,6,2,2,0
194,https://vlr.gg/player/33994/creamydreamy,2024-11-16 13:00:00,0.46,0.89,0.67,143,112,177,30,11,19,51,30,21,28,12,16,-1,-2,+1,72%,56%,88%,97,74,120,19%,22%,18%,7,3,4,8,5,3
195,https://vlr.gg/player/11330/mcd,2024-11-16 13:00:00,1.14,1.36,1.25,226,208,245,55,24,31,44,26,18,17,9,8,+5,+1,+4,76%,65%,88%,147,131,163,29%,34%,26%,10,4,6,5,3,2
196,https://vlr.gg/player/8838/chanformer,2024-11-16 13:00:00,0.87,1.14,1.01,200,171,230,47,21,26,49,27,22,25,5,20,-1,-2,+1,72%,56%,88%,126,106,146,29%,25%,32%,2,0,2,3,2,1
197,https://vlr.gg/player/1848/incredible,2024-11-16 13:00:00,0.74,1.24,0.99,206,172,243,46,17,29,49,28,21,32,13,19,-1,0,-1,74%,62%,85%,129,109,149,16%,13%,17%,5,2,3,6,2,4
198,https://vlr.gg/player/10270/dev0,2024-11-16 13:00:00,0.47,1.25,0.86,148,94,203,37,11,26,47,29,18,30,9,21,-4,-5,+1,69%,59%,79%,89,52,127,36%,33%,37%,4,1,3,8,6,2
199,https://vlr.gg/player/2617/leare,2024-11-16 13:00:00,0.55,1.15,0.85,202,151,256,49,17,32,53,29,24,14,5,9,-9,-8,-1,62%,53%,71%,134,98,169,30%,33%,28%,8,3,5,17,11,6
200,https://vlr.gg/player/33292/martux,2024-11-16 13:00:00,1.33,0.76,1.08,245,280,206,36,23,13,37,18,19,13,11,2,-3,+1,-4,67%,67%,68%,160,182,133,30%,28%,32%,7,5,2,10,4,6
201,https://vlr.gg/player/32345/snaptor,2024-11-16 13:00:00,1.07,0.64,0.88,176,213,130,28,19,9,34,18,16,10,7,3,+2,+2,0,67%,83%,47%,116,134,93,26%,24%,30%,2,2,0,0,0,0
202,https://vlr.gg/player/29634/cintyx,2024-11-16 13:00:00,1.00,0.63,0.84,187,217,151,29,19,10,33,17,16,6,2,4,-4,0,-4,63%,75%,47%,120,133,102,15%,15%,16%,1,1,0,5,1,4
203,https://vlr.gg/player/38840/lamelly,2024-11-16 13:00:00,0.73,0.88,0.80,155,108,212,21,9,12,32,15,17,15,11,4,-1,-2,+1,70%,71%,68%,101,74,135,23%,35%,18%,3,0,3,4,2,2
204,https://vlr.gg/player/11332/ara,2024-11-16 13:00:00,0.89,0.59,0.75,175,202,139,26,16,10,34,18,16,6,5,1,-1,+1,-2,58%,63%,53%,121,135,102,25%,21%,40%,5,5,0,6,4,2
205,https://vlr.gg/player/42371/t0ba,2024-11-16 13:00:00,1.62,1.39,1.49,310,295,323,51,23,28,29,11,18,13,6,7,+5,+4,+1,81%,100%,67%,187,183,191,20%,21%,20%,8,4,4,3,0,3
206,https://vlr.gg/player/29630/porkychop,2024-11-16 13:00:00,1.26,1.03,1.14,212,247,184,31,18,13,26,10,16,10,3,7,+1,+1,0,79%,84%,75%,147,154,141,9%,9%,10%,5,2,3,4,1,3
207,https://vlr.gg/player/31350/deqadz,2024-11-16 13:00:00,1.13,1.04,1.08,220,260,190,33,17,16,31,14,17,15,6,9,+2,+3,-1,81%,95%,71%,138,171,112,21%,25%,17%,5,4,1,3,1,2
208,https://vlr.gg/player/12372/szoren,2024-11-16 13:00:00,1.07,1.04,1.06,193,188,198,33,15,18,27,10,17,15,2,13,0,0,0,67%,74%,63%,129,133,127,25%,31%,22%,4,3,1,4,3,1
209,https://vlr.gg/player/29628/famzzam,2024-11-16 13:00:00,1.13,0.61,0.84,142,154,132,22,11,11,27,9,18,13,7,6,-1,+1,-2,81%,89%,75%,97,110,87,20%,28%,14%,3,1,2,4,0,4
210,https://vlr.gg/player/17323/mimi,2024-11-16 10:00:00,0.78,0.98,0.89,187,182,197,39,15,24,46,22,24,23,10,13,-2,-2,0,63%,50%,73%,127,131,123,35%,35%,36%,1,0,1,3,2,1
211,https://vlr.gg/player/36175/rezq,2024-11-16 10:00:00,0.68,1.01,0.87,228,215,257,47,17,30,51,25,26,10,5,5,-8,-5,-3,66%,62%,70%,147,133,158,28%,23%,33%,12,4,8,20,9,11
212,https://vlr.gg/player/20064/vania,2024-11-16 10:00:00,0.69,1.00,0.86,156,132,171,30,11,19,42,20,22,24,13,11,-3,-3,0,76%,69%,82%,101,89,111,32%,33%,31%,3,1,2,6,4,2
213,https://vlr.gg/player/17320/petra,2024-11-16 10:00:00,0.76,0.76,0.76,169,164,162,31,13,18,49,22,27,18,10,8,-1,0,-1,66%,54%,76%,110,116,105,30%,36%,26%,4,2,2,5,2,3
214,https://vlr.gg/player/24149/amy,2024-11-16 10:00:00,0.61,0.81,0.71,156,119,202,34,12,22,47,21,26,10,2,8,+1,0,+1,69%,54%,82%,114,98,126,33%,34%,32%,3,1,2,2,1,1
215,https://vlr.gg/player/11239/sayuri,2024-11-16 10:00:00,1.31,1.76,1.51,247,209,295,54,26,28,32,21,11,39,22,17,+3,0,+3,92%,91%,92%,154,130,186,19%,24%,16%,4,1,3,1,1,0
216,https://vlr.gg/player/31574/srn,2024-11-16 10:00:00,1.29,1.63,1.44,330,302,358,70,35,35,43,26,17,10,6,4,+13,+9,+4,83%,79%,88%,204,187,225,28%,25%,31%,22,14,8,9,5,4
217,https://vlr.gg/player/19791/mel,2024-11-16 10:00:00,1.06,1.05,1.06,195,182,188,39,22,17,36,21,15,21,11,10,-3,-2,-1,68%,67%,69%,118,120,116,20%,20%,20%,3,1,2,6,3,3
218,https://vlr.gg/player/21435/jelly,2024-11-16 10:00:00,1.02,0.97,0.98,182,197,145,36,23,13,37,23,14,22,17,5,0,-4,+4,85%,82%,88%,117,131,100,37%,36%,40%,4,0,4,4,4,0
219,https://vlr.gg/player/14685/jubs,2024-11-16 10:00:00,0.84,1.13,0.97,158,151,176,36,19,17,33,22,11,8,4,4,0,0,0,71%,64%,81%,109,108,110,33%,37%,29%,3,2,1,3,2,1
220,https://vlr.gg/player/34002/lukey,2024-11-16 10:00:00,1.14,1.78,1.41,306,293,345,42,22,20,26,17,9,9,6,3,0,-1,+1,79%,77%,81%,195,195,196,20%,33%,11%,7,4,3,7,5,2
221,https://vlr.gg/player/22617/vitie,2024-11-16 10:00:00,1.43,1.25,1.35,284,299,261,37,22,15,24,12,12,22,12,10,0,+1,-1,89%,86%,94%,171,186,150,21%,26%,14%,2,1,1,2,0,2
222,https://vlr.gg/player/5203/bati,2024-11-16 10:00:00,1.27,1.41,1.33,201,195,208,29,16,13,17,10,7,16,7,9,+1,+2,-1,79%,73%,88%,136,123,156,30%,26%,35%,4,3,1,3,1,2
223,https://vlr.gg/player/9943/mezoky,2024-11-16 10:00:00,0.90,1.20,1.03,220,191,240,28,15,13,25,14,11,14,5,9,+4,+4,0,66%,59%,75%,136,125,150,30%,28%,32%,7,5,2,3,1,2
224,https://vlr.gg/player/24426/w1ll,2024-11-16 10:00:00,1.20,0.73,1.00,164,189,106,23,18,5,20,11,9,6,1,5,+1,0,+1,76%,82%,69%,98,117,71,17%,15%,23%,2,1,1,1,1,0
225,https://vlr.gg/player/23190/chevin11,2024-11-16 10:00:00,1.12,0.83,0.95,196,213,179,26,13,13,31,11,20,16,2,14,-4,-1,-3,61%,56%,64%,118,139,103,15%,18%,13%,2,1,1,6,2,4
226,https://vlr.gg/player/47910/sudu1,2024-11-16 10:00:00,0.95,0.74,0.83,168,183,147,22,11,11,29,12,17,4,1,3,+1,+1,0,63%,63%,64%,114,118,110,31%,38%,25%,4,3,1,3,2,1
227,https://vlr.gg/player/47909/tripic,2024-11-16 10:00:00,0.46,1.07,0.82,175,127,220,25,6,19,31,13,18,7,3,4,-1,-2,+1,53%,56%,50%,115,91,133,24%,28%,22%,3,1,2,4,3,1
228,https://vlr.gg/player/47907/jennerbenner,2024-11-16 10:00:00,0.60,0.73,0.67,176,189,177,19,9,10,33,14,19,14,3,11,-2,0,-2,58%,56%,59%,119,121,117,23%,33%,17%,2,0,2,4,0,4
229,https://vlr.gg/player/47908/zwet,2024-11-16 10:00:00,0.40,0.86,0.67,176,179,172,20,10,10,36,16,20,8,2,6,0,+2,-2,71%,75%,68%,110,98,119,29%,38%,24%,5,3,2,5,1,4
230,https://vlr.gg/player/22310/stike,2024-11-16 10:00:00,0.76,1.36,1.02,189,179,205,25,13,12,28,19,9,15,4,11,+2,+1,+1,62%,55%,71%,121,106,141,23%,16%,34%,3,1,2,1,0,1
231,https://vlr.gg/player/12308/mista,2024-11-16 10:00:00,0.80,0.80,0.80,180,166,205,24,12,12,33,18,15,8,4,4,-2,-1,-1,62%,59%,65%,113,102,128,29%,30%,27%,2,1,1,4,2,2
232,https://vlr.gg/player/30456/nass,2024-11-16 10:00:00,0.66,0.87,0.75,180,166,204,24,12,12,34,20,14,9,4,5,0,-2,+2,64%,59%,71%,111,104,121,30%,37%,24%,5,1,4,5,3,2
233,https://vlr.gg/player/28480/marky,2024-11-16 10:00:00,0.32,1.02,0.62,138,108,180,20,8,12,31,20,11,3,2,1,-6,-6,0,46%,36%,59%,90,63,125,31%,30%,32%,5,3,2,11,9,2
234,https://vlr.gg/player/6271/haxzorus,2024-11-16 10:00:00,0.30,1.01,0.61,107,60,186,12,3,9,30,20,10,13,4,9,-3,-2,-1,56%,36%,82%,88,47,142,22%,19%,24%,0,0,0,3,2,1
235,https://vlr.gg/player/33358/shinnok,2024-11-16 10:00:00,1.50,1.63,1.57,265,268,268,36,16,20,18,9,9,16,3,13,+3,+1,+2,92%,88%,95%,181,196,170,34%,43%,29%,4,1,3,1,0,1
236,https://vlr.gg/player/44922/golack,2024-11-16 10:00:00,1.25,1.50,1.39,273,254,272,39,15,24,22,12,10,5,2,3,+2,0,+2,74%,59%,86%,167,163,170,21%,25%,17%,11,5,6,9,5,4
237,https://vlr.gg/player/39103/waken,2024-11-16 10:00:00,1.00,1.34,1.19,205,178,227,28,9,19,20,11,9,18,8,10,+5,+2,+3,79%,65%,91%,131,126,135,30%,19%,38%,6,2,4,1,0,1
238,https://vlr.gg/player/36402/kubfu,2024-11-16 10:00:00,0.69,1.41,1.10,232,160,284,31,10,21,24,13,11,11,2,9,-1,-3,+2,77%,65%,86%,164,134,187,29%,28%,30%,2,0,2,3,3,0
239,https://vlr.gg/player/42458/bravo,2024-11-16 10:00:00,0.72,1.24,1.01,155,144,170,22,9,13,21,12,9,18,6,12,0,-1,+1,77%,71%,82%,102,98,104,29%,25%,33%,1,0,1,1,1,0
240,https://vlr.gg/player/16621/alexy,2024-11-15 12:50:00,1.31,1.04,1.15,240,283,212,44,24,20,43,17,26,15,3,12,+4,+5,-1,74%,78%,71%,163,194,140,25%,23%,27%,12,8,4,8,3,5
241,https://vlr.gg/player/18093/kamiyu,2024-11-15 12:50:00,1.24,0.74,0.95,196,255,152,37,21,16,44,18,26,23,13,10,+1,+1,0,78%,91%,68%,113,147,88,17%,25%,10%,4,1,3,3,0,3
242,https://vlr.gg/player/8176/enerii,2024-11-15 12:50:00,1.02,0.87,0.94,217,246,201,38,18,20,41,17,24,17,11,6,+2,+2,0,63%,70%,58%,146,172,127,16%,18%,13%,10,4,6,8,2,6
243,https://vlr.gg/player/18091/shirazi,2024-11-15 12:50:00,0.98,0.79,0.87,157,168,151,32,16,16,36,13,23,10,4,6,-3,-1,-2,70%,78%,65%,112,112,112,20%,31%,14%,2,2,0,5,3,2
244,https://vlr.gg/player/8492/tara,2024-11-15 12:50:00,0.97,0.61,0.77,141,128,151,27,11,16,39,13,26,19,12,7,-2,0,-2,63%,78%,52%,93,78,104,19%,23%,17%,0,0,0,2,0,2
245,https://vlr.gg/player/19791/mel,2024-11-15 12:50:00,1.47,1.05,1.29,224,249,194,44,28,16,31,15,16,22,15,7,-3,+1,-4,78%,84%,70%,146,155,134,18%,17%,20%,2,2,0,5,1,4
246,https://vlr.gg/player/31574/srn,2024-11-15 12:50:00,1.43,1.03,1.26,279,309,235,53,34,19,38,19,19,12,7,5,-1,0,-1,65%,65%,65%,181,194,163,27%,24%,33%,13,9,4,14,9,5
247,https://vlr.gg/player/11239/sayuri,2024-11-15 12:50:00,1.24,0.89,1.09,182,183,177,35,20,15,35,17,18,30,23,7,+1,+3,-2,83%,87%,78%,118,115,122,27%,22%,34%,4,4,0,3,1,2
248,https://vlr.gg/player/14685/jubs,2024-11-15 12:50:00,0.97,1.11,1.03,192,185,202,37,22,15,33,18,15,16,5,11,+3,+2,+1,78%,77%,78%,133,132,134,25%,23%,27%,5,3,2,2,1,1
249,https://vlr.gg/player/21435/jelly,2024-11-15 12:50:00,0.96,0.63,0.82,172,180,162,33,20,13,42,21,21,18,12,6,-2,-1,-1,74%,81%,65%,125,129,120,32%,30%,35%,2,0,2,4,1,3
250,https://vlr.gg/player/24149/amy,2024-11-15 10:00:00,1.35,0.81,1.08,226,274,163,46,30,16,41,21,20,10,4,6,-1,+1,-2,71%,76%,66%,139,169,109,41%,45%,35%,3,3,0,4,2,2
251,https://vlr.gg/player/20064/vania,2024-11-15 10:00:00,1.18,0.92,1.05,176,174,171,32,16,16,38,18,20,34,18,16,-1,-2,+1,74%,76%,72%,101,103,99,19%,18%,21%,3,1,2,4,3,1
252,https://vlr.gg/player/17320/petra,2024-11-15 10:00:00,0.81,1.05,0.93,203,176,232,39,17,22,44,23,21,12,8,4,-8,-3,-5,67%,69%,66%,134,122,147,26%,21%,31%,5,3,2,13,6,7
253,https://vlr.gg/player/36175/rezq,2024-11-15 10:00:00,0.95,0.70,0.83,195,231,160,40,25,15,45,22,23,5,3,2,-4,-1,-3,59%,62%,55%,124,152,97,22%,23%,22%,9,5,4,13,6,7
254,https://vlr.gg/player/17323/mimi,2024-11-15 10:00:00,0.85,0.71,0.78,157,176,138,29,19,10,43,22,21,20,11,9,-5,-1,-4,62%,69%,55%,106,113,99,27%,27%,28%,0,0,0,5,1,4
255,https://vlr.gg/player/17976/florescent,2024-11-15 10:00:00,1.10,1.31,1.21,255,268,250,53,27,26,40,22,18,7,4,3,+15,+9,+6,78%,86%,69%,165,166,163,42%,40%,46%,19,10,9,4,1,3
256,https://vlr.gg/player/17397/noia,2024-11-15 10:00:00,1.39,0.94,1.16,224,248,195,46,26,20,37,15,22,6,3,3,+4,+5,-1,60%,72%,48%,145,162,128,35%,31%,42%,8,5,3,4,0,4
257,https://vlr.gg/player/21486/sarahcat,2024-11-15 10:00:00,1.32,0.78,1.05,201,201,194,38,22,16,37,13,24,17,10,7,+3,+3,0,74%,79%,69%,136,126,146,27%,20%,34%,6,4,2,3,1,2
258,https://vlr.gg/player/3063/mel,2024-11-15 10:00:00,1.07,0.92,1.00,195,182,212,42,18,24,37,16,21,16,14,2,+3,0,+3,78%,76%,79%,134,124,143,26%,25%,27%,5,2,3,2,2,0
259,https://vlr.gg/player/3079/alexis,2024-11-15 10:00:00,0.83,0.75,0.79,134,116,142,24,10,14,36,16,20,37,23,14,-6,-3,-3,66%,69%,62%,83,78,87,40%,37%,42%,0,0,0,6,3,3
260,https://vlr.gg/player/18093/kamiyu,2024-11-14 11:40:00,1.49,1.27,1.38,258,261,258,59,30,29,43,20,23,30,16,14,-1,-1,0,75%,79%,71%,182,190,175,32%,28%,37%,2,0,2,3,1,2
261,https://vlr.gg/player/18091/shirazi,2024-11-14 11:40:00,0.90,1.12,1.01,193,166,222,40,17,23,46,22,24,30,15,15,+1,0,+1,83%,85%,81%,125,104,146,20%,11%,29%,5,3,2,4,3,1
262,https://vlr.gg/player/16621/alexy,2024-11-14 11:40:00,1.28,0.62,0.96,169,217,124,41,28,13,46,21,25,12,8,4,-5,-3,-2,67%,82%,52%,121,148,93,27%,29%,24%,7,3,4,12,6,6
263,https://vlr.gg/player/8176/enerii,2024-11-14 11:40:00,0.86,1.04,0.95,228,224,238,48,24,24,56,28,28,22,9,13,-9,-5,-4,73%,73%,74%,156,150,161,28%,26%,30%,9,5,4,18,10,8
264,https://vlr.gg/player/8492/tara,2024-11-14 11:40:00,0.94,0.70,0.82,141,152,124,33,19,14,45,22,23,18,10,8,0,0,0,63%,70%,55%,85,82,87,20%,17%,24%,2,1,1,2,1,1
265,https://vlr.gg/player/11235/biazik,2024-11-14 11:40:00,1.27,1.08,1.17,223,245,197,48,25,23,40,19,21,23,13,10,+6,+4,+2,81%,87%,76%,148,159,138,27%,28%,27%,8,5,3,2,1,1
266,https://vlr.gg/player/18982/romily,2024-11-14 11:40:00,1.28,1.06,1.16,226,261,191,57,31,26,41,20,21,12,2,10,0,+1,-1,70%,74%,67%,146,176,119,42%,54%,32%,5,3,2,5,2,3
267,https://vlr.gg/player/21558/micaela,2024-11-14 11:40:00,1.09,1.08,1.08,202,189,217,48,22,26,44,19,25,25,16,9,+3,-1,+4,77%,74%,79%,131,123,138,35%,33%,37%,6,1,5,3,2,1
268,https://vlr.gg/player/11259/conir,2024-11-14 11:40:00,1.15,0.57,0.85,172,210,141,38,25,13,44,18,26,22,8,14,+6,+1,+5,77%,81%,73%,117,140,94,28%,42%,18%,7,2,5,1,1,0
269,https://vlr.gg/player/25663/dods,2024-11-14 11:40:00,0.69,0.91,0.80,209,189,223,45,20,25,52,27,25,13,5,8,-1,0,-1,80%,81%,79%,139,126,152,32%,28%,35%,13,7,6,14,7,7
270,https://vlr.gg/player/31574/srn,2024-11-14 10:00:00,2.29,1.58,1.89,394,566,277,43,25,18,14,8,6,4,3,1,+9,+5,+4,83%,85%,81%,277,383,191,29%,29%,30%,11,6,5,2,1,1
271,https://vlr.gg/player/21435/jelly,2024-11-14 10:00:00,1.33,1.75,1.56,303,253,339,31,12,19,15,8,7,14,6,8,+5,+3,+2,100%,100%,100%,178,158,194,33%,45%,26%,5,3,2,0,0,0
272,https://vlr.gg/player/11239/sayuri,2024-11-14 10:00:00,0.96,1.83,1.44,214,120,276,22,5,17,10,6,4,20,11,9,+3,+1,+2,90%,85%,94%,121,65,166,24%,27%,23%,3,1,2,0,0,0
273,https://vlr.gg/player/19791/mel,2024-11-14 10:00:00,1.07,1.67,1.40,196,158,225,22,8,14,9,6,3,12,4,8,+3,+1,+2,90%,85%,94%,126,107,142,30%,32%,28%,4,1,3,1,0,1
274,https://vlr.gg/player/14685/jubs,2024-11-14 10:00:00,0.83,1.03,0.93,117,80,141,12,4,8,10,5,5,5,3,2,+1,-1,+2,86%,69%,100%,76,60,89,26%,25%,26%,2,0,2,1,1,0
275,https://vlr.gg/player/29314/moco,2024-11-14 10:00:00,0.80,1.01,0.90,180,177,178,20,12,8,25,15,10,7,1,6,-2,-1,-1,55%,44%,69%,102,98,107,23%,21%,26%,1,1,0,3,2,1
276,https://vlr.gg/player/39902/ur,2024-11-14 10:00:00,0.24,0.94,0.55,109,61,179,10,2,8,25,15,10,6,3,3,-2,-2,0,45%,31%,62%,78,45,118,27%,20%,30%,1,0,1,3,2,1
277,https://vlr.gg/player/29316/aco,2024-11-14 10:00:00,0.22,0.87,0.49,98,49,173,9,1,8,27,16,11,11,6,5,-1,-1,0,38%,25%,54%,64,38,96,28%,7%,44%,0,0,0,1,1,0
278,https://vlr.gg/player/39904/serena,2024-11-14 10:00:00,0.59,0.33,0.47,121,142,86,11,7,4,26,14,12,2,0,2,-5,-2,-3,41%,44%,38%,78,85,68,26%,21%,36%,1,1,0,6,3,3
279,https://vlr.gg/player/10653/suzu,2024-11-14 10:00:00,0.09,0.45,0.23,104,85,130,8,3,5,27,16,11,5,3,2,-11,-6,-5,28%,25%,31%,74,65,84,11%,7%,15%,1,0,1,12,6,6
280,https://vlr.gg/player/17976/florescent,2024-11-13 13:10:00,1.58,1.33,1.46,311,326,290,48,27,21,28,16,12,13,4,9,+11,+7,+4,89%,92%,86%,199,215,181,37%,40%,33%,16,9,7,5,2,3
281,https://vlr.gg/player/21486/sarahcat,2024-11-13 13:10:00,1.20,1.26,1.23,231,234,234,37,19,18,24,14,10,14,8,6,+3,+3,0,87%,83%,90%,160,166,154,28%,29%,27%,4,3,1,1,0,1
282,https://vlr.gg/player/3079/alexis,2024-11-13 13:10:00,1.26,1.00,1.14,180,204,153,28,17,11,24,12,12,28,16,12,-1,-1,0,87%,92%,81%,117,141,91,30%,33%,27%,3,1,2,4,2,2
283,https://vlr.gg/player/17397/noia,2024-11-13 13:10:00,1.04,0.99,1.01,198,196,207,34,19,15,28,14,14,12,4,8,-4,-1,-3,76%,71%,81%,135,123,148,28%,36%,23%,1,1,0,5,2,3
284,https://vlr.gg/player/3063/mel,2024-11-13 13:10:00,0.52,1.43,0.94,157,102,222,25,8,17,25,17,8,24,9,15,-4,-4,0,80%,75%,86%,102,65,145,13%,9%,16%,1,0,1,5,4,1
285,https://vlr.gg/player/16621/alexy,2024-11-13 13:10:00,0.92,1.42,1.19,211,179,246,33,14,19,30,17,13,8,2,6,-4,-3,-1,80%,71%,88%,144,117,167,26%,40%,19%,3,1,2,7,4,3
286,https://vlr.gg/player/8176/enerii,2024-11-13 13:10:00,0.52,1.34,0.95,212,152,264,36,11,25,37,19,18,6,2,4,+2,+2,0,62%,67%,58%,130,103,154,21%,16%,24%,7,4,3,5,2,3
287,https://vlr.gg/player/18091/shirazi,2024-11-13 13:10:00,0.74,1.03,0.90,163,134,186,26,10,16,32,15,17,7,2,5,+1,+1,0,73%,67%,79%,106,86,123,27%,30%,26%,6,3,3,5,2,3
288,https://vlr.gg/player/8492/tara,2024-11-13 13:10:00,0.87,0.35,0.59,110,140,89,15,9,6,35,15,20,17,10,7,-2,0,-2,60%,62%,58%,75,92,60,20%,18%,22%,1,1,0,3,1,2
289,https://vlr.gg/player/18093/kamiyu,2024-11-13 13:10:00,0.81,0.24,0.51,131,168,105,19,12,7,38,16,22,13,6,7,-2,-1,-1,51%,62%,42%,85,112,61,19%,29%,9%,3,1,2,5,2,3
290,https://vlr.gg/player/17320/petra,2024-11-13 10:00:00,0.97,1.97,1.53,279,207,331,59,18,41,36,18,18,24,12,12,+6,0,+6,86%,81%,91%,170,129,201,31%,22%,37%,12,4,8,6,4,2
291,https://vlr.gg/player/20064/vania,2024-11-13 10:00:00,1.28,1.40,1.35,240,196,259,47,17,30,33,15,18,37,20,17,+4,+3,+1,80%,81%,79%,151,126,170,35%,36%,35%,6,3,3,2,0,2
292,https://vlr.gg/player/17323/mimi,2024-11-13 10:00:00,1.19,0.80,0.97,169,206,141,35,20,15,36,16,20,24,15,9,-4,-3,-1,81%,73%,88%,108,127,94,27%,31%,22%,2,0,2,6,3,3
293,https://vlr.gg/player/24149/amy,2024-11-13 10:00:00,1.03,0.92,0.97,177,181,182,41,19,22,37,17,20,6,3,3,-1,-1,0,73%,69%,76%,124,119,128,32%,39%,28%,1,0,1,2,1,1
294,https://vlr.gg/player/36175/rezq,2024-11-13 10:00:00,0.86,0.52,0.66,168,214,140,32,18,14,49,22,27,16,8,8,-2,-1,-1,64%,77%,55%,120,155,92,21%,19%,25%,10,5,5,12,6,6
295,https://vlr.gg/player/21435/jelly,2024-11-13 10:00:00,1.16,1.77,1.43,261,207,338,56,22,34,40,23,17,24,19,5,+2,-1,+3,75%,67%,85%,168,132,214,45%,35%,55%,5,0,5,3,1,2
296,https://vlr.gg/player/31574/srn,2024-11-13 10:00:00,1.04,0.97,1.01,252,281,233,51,32,19,49,28,21,12,7,5,+3,-1,+4,69%,76%,62%,170,167,174,24%,21%,30%,16,10,6,13,11,2
297,https://vlr.gg/player/11239/sayuri,2024-11-13 10:00:00,0.78,0.92,0.85,156,144,168,31,16,15,43,25,18,26,18,8,-2,0,-2,71%,73%,69%,93,85,103,14%,14%,14%,2,1,1,4,1,3
298,https://vlr.gg/player/19791/mel,2024-11-13 10:00:00,0.95,0.60,0.80,153,165,128,30,20,10,41,22,19,15,6,9,-2,-1,-1,71%,70%,73%,101,115,84,23%,24%,20%,2,1,1,4,2,2
299,https://vlr.gg/player/14685/jubs,2024-11-13 10:00:00,0.53,0.64,0.58,119,117,117,23,13,10,41,24,17,13,5,8,-4,-2,-2,63%,61%,65%,87,87,87,28%,33%,24%,3,2,1,7,4,3
300,https://vlr.gg/player/48950/zeni,2024-11-12 14:15:00,1.46,0.63,0.84,194,390,130,10,5,5,13,4,9,7,1,6,-1,0,-1,81%,75%,83%,120,234,83,24%,19%,31%,0,0,0,1,0,1
301,https://vlr.gg/player/33833/pepecho,2024-11-12 14:15:00,0.23,0.96,0.78,173,76,207,9,1,8,12,4,8,7,3,4,+1,0,+1,69%,75%,67%,129,45,157,35%,50%,33%,1,0,1,0,0,0
302,https://vlr.gg/player/46233/kz,2024-11-12 14:15:00,0.89,0.72,0.76,206,288,180,11,4,7,13,4,9,3,1,2,-3,-1,-2,81%,75%,83%,132,165,121,21%,36%,13%,2,1,1,5,2,3
303,https://vlr.gg/player/42514/aleexfdz,2024-11-12 14:15:00,0.37,0.66,0.59,119,178,100,8,2,6,13,4,9,1,1,0,0,0,0,63%,50%,67%,75,126,58,36%,33%,40%,0,0,0,0,0,0
304,https://vlr.gg/player/48951/hassan,2024-11-12 14:15:00,0.12,0.47,0.38,121,58,143,6,1,5,13,4,9,1,0,1,0,-1,+1,56%,50%,58%,78,21,98,30%,0%,33%,3,0,3,3,1,2
305,https://vlr.gg/player/2996/neiker,2024-11-12 14:15:00,1.28,1.73,1.40,239,205,345,15,9,6,9,6,3,3,2,1,0,0,0,81%,83%,75%,152,145,172,29%,29%,29%,3,2,1,3,2,1
306,https://vlr.gg/player/22154/pika,2024-11-12 14:15:00,1.21,1.95,1.39,173,133,294,11,6,5,6,4,2,14,11,3,0,0,0,81%,83%,75%,120,82,234,28%,19%,45%,0,0,0,0,0,0
307,https://vlr.gg/player/2893/hastack,2024-11-12 14:15:00,1.21,1.39,1.26,202,197,222,12,9,3,8,6,2,6,3,3,0,0,0,88%,83%,100%,149,140,173,20%,16%,29%,0,0,0,0,0,0
308,https://vlr.gg/player/22501/amore,2024-11-12 14:15:00,1.34,0.82,1.21,241,250,219,15,12,3,11,7,4,1,0,1,+2,0,+2,94%,92%,100%,152,150,160,32%,43%,10%,4,2,2,2,2,0
309,https://vlr.gg/player/5487/adm1k,2024-11-12 14:15:00,0.95,1.49,1.08,220,213,243,11,8,3,10,8,2,7,4,3,+1,+1,0,94%,92%,100%,156,153,168,17%,25%,6%,2,2,0,1,1,0
310,https://vlr.gg/player/2886/drk,2024-11-12 13:15:00,0.86,1.13,1.04,249,230,259,16,5,11,17,6,11,7,3,4,0,0,0,56%,67%,50%,152,121,168,30%,44%,26%,0,0,0,0,0,0
311,https://vlr.gg/player/42521/jahbu,2024-11-12 13:15:00,0.75,1.03,0.94,189,167,201,12,4,8,16,6,10,1,0,1,-2,0,-2,56%,50%,58%,150,129,161,50%,36%,57%,0,0,0,2,0,2
312,https://vlr.gg/player/23090/krystal,2024-11-12 13:15:00,0.03,1.08,0.71,158,71,202,11,1,10,16,6,10,1,1,0,-4,-2,-2,50%,50%,50%,100,54,123,19%,17%,20%,2,0,2,6,2,4
313,https://vlr.gg/player/29974/erizillo,2024-11-12 13:15:00,0.87,0.58,0.68,161,228,128,9,4,5,15,6,9,7,3,4,+1,0,+1,72%,83%,67%,97,121,86,26%,23%,28%,2,0,2,1,0,1
314,https://vlr.gg/player/4951/hardy,2024-11-12 13:15:00,0.01,0.52,0.22,101,5,149,5,0,5,17,6,11,4,0,4,-5,-4,-1,39%,,58%,75,5,109,18%,0%,19%,0,0,0,5,4,1
315,https://vlr.gg/player/22314/mober,2024-11-12 13:15:00,1.44,2.89,1.92,339,313,394,26,16,10,9,9,0,3,1,2,+3,+2,+1,89%,83%,100%,219,193,272,59%,64%,53%,3,2,1,0,0,0
316,https://vlr.gg/player/14894/facepalm,2024-11-12 13:15:00,1.24,1.90,1.46,334,281,441,21,11,10,12,8,4,4,2,2,+3,+1,+2,83%,75%,100%,228,196,293,28%,28%,29%,6,4,2,3,3,0
317,https://vlr.gg/player/16139/enrik,2024-11-12 13:15:00,1.37,1.02,1.25,217,243,166,15,11,4,10,6,4,9,5,4,+1,0,+1,94%,92%,100%,138,161,93,47%,55%,30%,2,1,1,1,1,0
318,https://vlr.gg/player/32300/varuxx,2024-11-12 13:15:00,0.96,1.66,1.19,163,153,184,11,7,4,9,7,2,9,4,5,+1,0,+1,83%,75%,100%,113,112,117,24%,26%,21%,1,0,1,0,0,0
319,https://vlr.gg/player/2853/apex,2024-11-12 13:15:00,0.73,0.55,0.67,145,165,105,8,6,2,13,9,4,12,10,2,+2,+1,+1,83%,92%,67%,94,114,53,18%,22%,10%,2,1,1,0,0,0
320,https://vlr.gg/player/22291/razziss,2024-11-12 12:00:00,2.23,1.63,1.94,418,485,346,35,21,14,16,7,9,5,3,2,+8,+7,+1,87%,92%,82%,240,283,192,31%,32%,28%,9,7,2,1,0,1
321,https://vlr.gg/player/22495/mochi,2024-11-12 12:00:00,1.01,0.80,0.91,176,176,177,14,8,6,17,7,10,6,2,4,0,0,0,74%,75%,73%,111,110,112,24%,24%,23%,1,0,1,1,0,1
322,https://vlr.gg/player/8595/skygi,2024-11-12 12:00:00,1.12,0.56,0.85,168,218,114,14,9,5,16,8,8,6,5,1,+4,+3,+1,74%,92%,55%,104,138,67,28%,21%,50%,4,3,1,0,0,0
323,https://vlr.gg/player/16012/akira,2024-11-12 12:00:00,0.69,0.70,0.70,149,129,172,11,6,5,17,8,9,4,2,2,+3,+1,+2,65%,58%,73%,104,89,120,40%,42%,38%,4,1,3,1,0,1
324,https://vlr.gg/player/15487/aqua,2024-11-12 12:00:00,0.39,0.47,0.43,105,93,120,7,3,4,19,9,10,7,2,5,0,-1,+1,65%,67%,64%,76,77,76,24%,20%,29%,1,0,1,1,1,0
325,https://vlr.gg/player/42519/lolito,2024-11-12 12:00:00,1.70,1.78,1.74,349,346,352,29,14,15,14,6,8,7,3,4,-1,-1,0,83%,91%,75%,218,210,226,26%,18%,35%,1,0,1,2,1,1
326,https://vlr.gg/player/31553/pukytoo,2024-11-12 12:00:00,1.80,0.74,1.25,216,286,152,19,12,7,15,5,10,10,6,4,-2,+1,-3,78%,91%,67%,143,179,109,46%,50%,40%,1,1,0,3,0,3
327,https://vlr.gg/player/41764/meow,2024-11-12 12:00:00,0.98,0.93,0.96,199,221,180,17,9,8,16,7,9,5,3,2,-2,-1,-1,78%,91%,67%,121,119,123,19%,12%,29%,0,0,0,2,1,1
328,https://vlr.gg/player/2862/chechuu,2024-11-12 12:00:00,0.63,1.05,0.85,148,119,175,13,5,8,15,7,8,4,2,2,-2,0,-2,74%,91%,58%,94,69,116,31%,23%,36%,0,0,0,2,0,2
329,https://vlr.gg/player/44137/levi,2024-11-12 12:00:00,0.37,0.04,0.19,106,163,55,7,6,1,21,9,12,6,1,5,-8,-4,-4,39%,36%,42%,76,104,50,20%,29%,8%,2,2,0,10,6,4
330,https://vlr.gg/player/44137/levi,2024-11-11 14:15:00,1.08,1.23,1.16,297,300,295,26,13,13,21,11,10,7,6,1,0,-2,+2,73%,69%,77%,199,210,188,29%,35%,24%,6,3,3,6,5,1
331,https://vlr.gg/player/41764/meow,2024-11-11 14:15:00,0.96,1.10,1.03,203,190,217,20,9,11,17,9,8,6,4,2,+2,+1,+1,62%,69%,54%,131,124,138,43%,33%,57%,3,1,2,1,0,1
332,https://vlr.gg/player/31553/pukytoo,2024-11-11 14:15:00,0.99,0.67,0.83,160,199,122,16,10,6,19,10,9,12,8,4,+1,+1,0,73%,85%,62%,109,132,85,54%,65%,36%,3,2,1,2,1,1
333,https://vlr.gg/player/42519/lolito,2024-11-11 14:15:00,0.74,0.88,0.81,159,139,179,15,6,9,19,10,9,10,6,4,-2,0,-2,65%,77%,54%,117,102,132,28%,25%,30%,0,0,0,2,0,2
334,https://vlr.gg/player/2862/chechuu,2024-11-11 14:15:00,0.90,0.70,0.80,217,216,219,18,10,8,23,10,13,10,3,7,+1,+1,0,81%,77%,85%,140,135,145,24%,20%,29%,2,1,1,1,0,1
335,https://vlr.gg/player/22314/mober,2024-11-11 14:15:00,1.88,1.50,1.69,339,368,311,29,16,13,18,8,10,8,3,5,+5,+3,+2,81%,85%,77%,230,242,219,42%,42%,42%,6,3,3,1,0,1
336,https://vlr.gg/player/32300/varuxx,2024-11-11 14:15:00,1.43,1.45,1.44,228,223,235,22,11,11,15,7,8,6,3,3,+2,0,+2,69%,77%,62%,158,140,176,28%,19%,36%,4,1,3,2,1,1
337,https://vlr.gg/player/2853/apex,2024-11-11 14:15:00,0.94,1.10,1.02,206,174,239,18,7,11,19,10,9,13,9,4,-4,-3,-1,77%,69%,85%,141,120,161,43%,37%,48%,0,0,0,4,3,1
338,https://vlr.gg/player/14894/facepalm,2024-11-11 14:15:00,1.02,0.64,0.83,179,215,144,17,10,7,21,10,11,3,2,1,-1,+1,-2,58%,54%,62%,102,121,84,32%,32%,31%,2,2,0,3,1,2
339,https://vlr.gg/player/16139/enrik,2024-11-11 14:15:00,0.40,0.98,0.69,137,115,159,13,5,8,22,12,10,16,8,8,-4,-2,-2,69%,54%,85%,96,77,115,18%,24%,16%,0,0,0,4,2,2
340,https://vlr.gg/player/2893/hastack,2024-11-11 13:15:00,2.33,1.45,2.07,347,347,348,20,15,5,6,2,4,7,7,0,+2,+2,0,94%,100%,80%,233,229,244,29%,30%,27%,2,2,0,0,0,0
341,https://vlr.gg/player/5487/adm1k,2024-11-11 13:15:00,1.32,1.64,1.41,239,227,270,15,10,5,8,5,3,2,1,1,0,+1,-1,94%,100%,80%,173,162,200,32%,24%,54%,1,1,0,1,0,1
342,https://vlr.gg/player/2996/neiker,2024-11-11 13:15:00,1.22,1.00,1.16,185,184,190,13,10,3,8,4,4,3,1,2,-1,-1,0,82%,83%,80%,124,126,119,57%,60%,50%,2,1,1,3,2,1
343,https://vlr.gg/player/22501/amore,2024-11-11 13:15:00,1.31,0.37,1.03,275,344,112,18,16,2,15,10,5,2,1,1,0,+1,-1,76%,83%,60%,171,212,73,40%,39%,67%,3,3,0,3,2,1
344,https://vlr.gg/player/22154/pika,2024-11-11 13:15:00,0.61,1.07,0.75,128,108,178,8,4,4,11,8,3,6,5,1,0,+1,-1,88%,92%,80%,85,69,125,47%,36%,67%,1,1,0,1,0,1
345,https://vlr.gg/player/48956/bujaxd,2024-11-11 13:15:00,1.37,0.94,1.07,243,270,233,13,4,9,15,4,11,7,5,2,+3,+2,+1,59%,80%,50%,144,149,141,40%,23%,50%,3,2,1,0,0,0
346,https://vlr.gg/player/48955/dubstep,2024-11-11 13:15:00,0.68,0.69,0.68,183,209,173,11,4,7,16,4,12,1,0,1,+2,+1,+1,71%,100%,58%,111,110,111,44%,67%,38%,2,1,1,0,0,0
347,https://vlr.gg/player/48953/t1tan,2024-11-11 13:15:00,1.10,0.44,0.63,124,202,92,8,4,4,13,3,10,0,0,0,-2,0,-2,47%,80%,33%,81,135,59,38%,29%,50%,0,0,0,2,0,2
348,https://vlr.gg/player/23082/cobra,2024-11-11 13:15:00,0.60,0.43,0.48,108,106,109,7,3,4,14,3,11,3,0,3,-2,-1,-1,53%,80%,42%,77,81,76,30%,40%,27%,0,0,0,2,1,1
349,https://vlr.gg/player/48952/xpiryy,2024-11-11 13:15:00,0.61,0.38,0.45,158,207,138,9,4,5,16,5,11,3,1,2,-2,+1,-3,53%,80%,42%,105,144,88,29%,33%,25%,3,1,2,5,0,5
350,https://vlr.gg/player/23190/chevin11,2024-11-11 13:00:00,1.25,0.93,1.10,226,210,218,45,25,20,39,18,21,21,11,10,+2,0,+2,69%,72%,67%,136,132,140,15%,15%,16%,6,2,4,4,2,2
351,https://vlr.gg/player/47910/sudu1,2024-11-11 13:00:00,1.08,0.99,1.04,231,232,243,47,27,20,44,23,21,15,7,8,+5,+2,+3,85%,84%,85%,163,162,164,22%,19%,25%,9,4,5,4,2,2
352,https://vlr.gg/player/47907/jennerbenner,2024-11-11 13:00:00,1.10,0.89,1.00,187,207,168,40,23,17,40,22,18,13,9,4,-3,-2,-1,75%,81%,67%,127,136,116,35%,42%,27%,5,3,2,8,5,3
353,https://vlr.gg/player/47909/tripic,2024-11-11 13:00:00,1.27,0.61,0.97,190,235,129,42,30,12,41,21,20,9,6,3,-6,-5,-1,73%,72%,74%,112,136,84,15%,15%,14%,3,1,2,9,6,3
354,https://vlr.gg/player/47908/zwet,2024-11-11 13:00:00,0.74,1.13,0.92,193,144,230,39,16,23,44,25,19,24,18,6,-1,-1,0,76%,81%,70%,109,91,131,25%,30%,22%,5,3,2,6,4,2
355,https://vlr.gg/player/8816/inst1nct,2024-11-11 13:00:00,1.36,1.30,1.33,235,243,247,49,23,26,38,16,22,19,7,12,+3,-1,+4,76%,70%,81%,163,165,162,16%,24%,11%,6,1,5,3,2,1
356,https://vlr.gg/player/42256/zentox,2024-11-11 13:00:00,1.25,0.79,1.00,205,227,181,38,20,18,43,18,25,27,16,11,0,0,0,69%,78%,63%,140,167,118,28%,29%,28%,6,3,3,6,3,3
357,https://vlr.gg/player/20591/eagle,2024-11-11 13:00:00,1.36,0.68,0.99,201,249,156,42,25,17,41,16,25,11,2,9,0,+2,-2,71%,67%,75%,129,156,107,20%,22%,17%,3,3,0,3,1,2
358,https://vlr.gg/player/33980/howl9,2024-11-11 13:00:00,0.82,0.97,0.90,221,222,228,43,19,24,47,23,24,11,5,6,0,-4,+4,66%,63%,69%,144,139,149,17%,29%,10%,14,5,9,14,9,5
359,https://vlr.gg/player/20453/ross,2024-11-11 13:00:00,0.76,0.94,0.86,172,136,198,36,12,24,44,19,25,21,12,9,0,0,0,66%,70%,63%,114,92,132,34%,34%,34%,2,0,2,2,0,2
360,https://vlr.gg/player/10270/dev0,2024-11-11 13:00:00,1.54,1.17,1.34,235,242,230,39,19,20,27,9,18,20,6,14,+2,+2,0,84%,80%,88%,152,158,147,41%,33%,50%,3,3,0,1,1,0
361,https://vlr.gg/player/2617/leare,2024-11-11 13:00:00,0.64,1.68,1.21,290,194,368,41,13,28,33,15,18,14,6,8,+3,0,+3,70%,75%,67%,193,146,232,29%,29%,29%,12,4,8,9,4,5
362,https://vlr.gg/player/11330/mcd,2024-11-11 13:00:00,1.44,0.80,1.09,203,260,159,32,18,14,25,9,16,12,7,5,+1,0,+1,86%,90%,83%,129,154,108,52%,58%,47%,4,2,2,3,2,1
363,https://vlr.gg/player/1848/incredible,2024-11-11 13:00:00,1.29,0.68,0.96,162,185,137,26,15,11,27,10,17,11,8,3,-2,+1,-3,77%,85%,71%,110,131,93,23%,29%,18%,1,1,0,3,0,3
364,https://vlr.gg/player/8838/chanformer,2024-11-11 13:00:00,0.94,0.95,0.95,166,181,159,27,13,14,28,13,15,13,6,7,-2,-1,-1,66%,65%,67%,111,117,107,20%,14%,26%,3,1,2,5,2,3
365,https://vlr.gg/player/31300/drog,2024-11-11 13:00:00,1.20,1.09,1.15,227,228,224,36,19,17,31,16,15,14,9,5,+1,0,+1,73%,71%,75%,158,173,140,30%,27%,37%,7,4,3,6,4,2
366,https://vlr.gg/player/20443/br-di,2024-11-11 13:00:00,0.82,0.89,0.85,193,200,181,32,19,13,34,20,14,5,2,3,-4,-3,-1,64%,63%,65%,129,130,128,37%,38%,36%,1,1,0,5,4,1
367,https://vlr.gg/player/10931/xenp1o,2024-11-11 13:00:00,1.00,0.54,0.79,142,178,102,21,14,7,30,16,14,15,10,5,+1,+2,-1,66%,75%,55%,98,121,70,50%,48%,53%,2,2,0,1,0,1
368,https://vlr.gg/player/11293/chukl9,2024-11-11 13:00:00,0.83,0.75,0.79,153,151,158,24,14,10,33,17,16,9,4,5,+3,+2,+1,64%,75%,50%,112,96,130,31%,30%,31%,5,2,3,2,0,2
369,https://vlr.gg/player/4973/otom,2024-11-11 13:00:00,0.88,0.64,0.77,179,206,150,26,17,9,37,19,18,10,5,5,-3,-1,-2,64%,58%,70%,125,131,118,18%,16%,21%,6,3,3,9,4,5
370,https://vlr.gg/player/38840/lamelly,2024-11-11 13:00:00,1.46,1.35,1.40,245,247,247,39,18,21,22,10,12,27,16,11,+4,+3,+1,95%,95%,96%,158,142,171,20%,28%,15%,4,3,1,0,0,0
371,https://vlr.gg/player/33292/martux,2024-11-11 13:00:00,1.40,1.23,1.31,251,288,222,40,21,19,26,13,13,14,5,9,+4,+2,+2,83%,89%,78%,149,167,135,23%,26%,21%,9,4,5,5,2,3
372,https://vlr.gg/player/29634/cintyx,2024-11-11 13:00:00,1.38,1.12,1.24,220,267,177,33,18,15,24,12,12,13,6,7,+4,+1,+3,76%,74%,78%,153,199,115,25%,20%,31%,7,3,4,3,2,1
373,https://vlr.gg/player/11332/ara,2024-11-11 13:00:00,0.76,1.51,1.17,235,182,277,36,12,24,26,15,11,14,7,7,+5,+2,+3,71%,63%,78%,149,117,176,18%,18%,18%,9,3,6,4,1,3
374,https://vlr.gg/player/32345/snaptor,2024-11-11 13:00:00,0.96,0.75,0.85,171,168,169,25,12,13,27,12,15,13,6,7,+1,+1,0,74%,68%,78%,115,124,108,23%,36%,17%,1,1,0,0,0,0
375,https://vlr.gg/player/42650/mally,2024-11-11 13:00:00,1.07,1.15,1.11,213,205,228,33,16,17,32,16,16,8,5,3,+1,+1,0,67%,74%,58%,134,123,147,33%,35%,30%,4,3,1,3,2,1
376,https://vlr.gg/player/42651/avey,2024-11-11 13:00:00,0.94,0.79,0.88,195,204,187,28,16,12,34,18,16,6,3,3,-6,-4,-2,71%,74%,68%,130,130,130,38%,37%,39%,1,0,1,7,4,3
377,https://vlr.gg/player/28479/jkg,2024-11-11 13:00:00,0.73,0.83,0.77,170,150,202,25,13,12,35,19,16,18,8,10,-2,0,-2,79%,74%,84%,118,97,144,34%,32%,36%,3,3,0,5,3,2
378,https://vlr.gg/player/45836/corsa,2024-11-11 13:00:00,0.47,0.95,0.69,175,137,218,23,8,15,38,21,17,6,4,2,0,0,0,62%,57%,68%,121,98,149,27%,23%,31%,4,1,3,4,1,3
379,https://vlr.gg/player/1472/falltw,2024-11-11 13:00:00,0.58,0.49,0.54,123,130,113,16,10,6,34,18,16,11,6,5,-11,-6,-5,55%,48%,63%,88,84,93,18%,18%,18%,0,0,0,11,6,5
380,https://vlr.gg/player/11259/conir,2024-11-11 12:05:00,1.30,1.30,1.30,231,204,250,39,16,23,27,14,13,17,11,6,+2,+2,0,75%,78%,72%,150,141,158,23%,20%,26%,4,2,2,2,0,2
381,https://vlr.gg/player/25663/dods,2024-11-11 12:05:00,1.36,1.20,1.28,272,302,231,44,24,20,33,18,15,11,7,4,+2,-1,+3,65%,61%,68%,176,204,150,33%,33%,33%,13,8,5,11,9,2
382,https://vlr.gg/player/18982/romily,2024-11-11 12:05:00,0.68,1.46,1.09,221,153,289,36,12,24,31,16,15,19,5,14,+3,+1,+2,71%,65%,76%,147,97,193,29%,43%,23%,4,1,3,1,0,1
383,https://vlr.gg/player/21558/micaela,2024-11-11 12:05:00,1.07,1.03,1.05,172,154,198,31,13,18,29,13,16,24,12,12,-1,-1,0,77%,74%,80%,108,107,109,38%,33%,41%,1,0,1,2,1,1
384,https://vlr.gg/player/11235/biazik,2024-11-11 12:05:00,0.93,1.06,1.00,175,145,208,28,11,17,29,14,15,19,11,8,+6,+2,+4,77%,83%,72%,122,101,141,22%,20%,24%,8,2,6,2,0,2
385,https://vlr.gg/player/16418/smurfette,2024-11-11 12:05:00,1.16,1.16,1.16,235,230,241,41,21,20,34,19,15,5,1,4,0,0,0,65%,60%,70%,159,165,152,36%,43%,28%,9,4,5,9,4,5
386,https://vlr.gg/player/26632/joliinaa,2024-11-11 12:05:00,0.75,1.13,0.93,196,171,231,31,14,17,35,22,13,11,6,5,+3,+2,+1,71%,60%,83%,140,122,160,23%,25%,22%,3,2,1,0,0,0
387,https://vlr.gg/player/17343/ness,2024-11-11 12:05:00,1.08,0.74,0.92,202,214,184,33,20,13,38,19,19,13,4,9,-2,0,-2,65%,64%,65%,129,134,124,28%,33%,25%,1,1,0,3,1,2
388,https://vlr.gg/player/24107/sarah,2024-11-11 12:05:00,0.49,0.98,0.72,129,100,159,19,7,12,33,20,13,13,4,9,-3,-5,+2,60%,56%,65%,93,74,114,32%,28%,35%,3,0,3,6,5,1
389,https://vlr.gg/player/24101/miyori,2024-11-11 12:05:00,0.58,0.83,0.70,157,167,145,25,12,13,38,22,16,8,6,2,-10,-6,-4,60%,56%,65%,117,126,108,23%,16%,38%,2,1,1,12,7,5
390,https://vlr.gg/player/23090/krystal,2024-11-11 12:00:00,1.12,1.44,1.28,253,178,329,21,8,13,18,7,11,3,1,2,+3,+1,+2,69%,77%,62%,161,121,202,22%,22%,23%,5,2,3,2,1,1
391,https://vlr.gg/player/4951/hardy,2024-11-11 12:00:00,1.51,0.89,1.20,239,303,175,22,15,7,16,7,9,2,1,1,+4,+3,+1,77%,77%,77%,158,193,122,16%,15%,17%,4,3,1,0,0,0
392,https://vlr.gg/player/42521/jahbu,2024-11-11 12:00:00,0.76,1.12,0.94,199,148,251,18,7,11,17,7,10,3,2,1,0,-2,+2,65%,62%,69%,124,87,161,40%,55%,34%,3,1,2,3,3,0
393,https://vlr.gg/player/29974/erizillo,2024-11-11 12:00:00,0.94,0.53,0.73,117,133,102,10,6,4,17,7,10,7,6,1,-1,+1,-2,58%,69%,46%,91,102,79,40%,47%,31%,1,1,0,2,0,2
394,https://vlr.gg/player/2886/drk,2024-11-11 12:00:00,0.97,0.34,0.66,128,161,96,11,7,4,18,7,11,7,4,3,0,+2,-2,77%,77%,77%,93,114,72,40%,35%,50%,3,2,1,3,0,3
395,https://vlr.gg/player/48951/hassan,2024-11-11 12:00:00,1.26,1.21,1.24,235,233,239,22,12,10,14,7,7,3,1,2,-1,0,-1,73%,69%,77%,154,167,140,32%,41%,24%,2,2,0,3,2,1
396,https://vlr.gg/player/44130/bern1,2024-11-11 12:00:00,1.18,0.78,0.98,133,128,139,11,5,6,13,4,9,9,9,0,-1,0,-1,69%,85%,54%,97,87,107,45%,43%,47%,0,0,0,1,0,1
397,https://vlr.gg/player/46233/kz,2024-11-11 12:00:00,1.23,0.72,0.97,223,301,145,19,14,5,19,9,10,2,2,0,-1,0,-1,62%,77%,46%,144,193,94,17%,14%,27%,5,2,3,6,2,4
398,https://vlr.gg/player/48950/zeni,2024-11-11 12:00:00,0.69,1.03,0.86,211,201,221,21,11,10,19,11,8,6,3,3,-2,-1,-1,73%,77%,69%,129,116,143,33%,26%,41%,3,2,1,5,3,2
399,https://vlr.gg/player/42514/aleexfdz,2024-11-11 12:00:00,1.09,0.31,0.70,142,208,77,13,10,3,18,8,10,6,4,2,-1,0,-1,65%,77%,54%,96,139,52,28%,29%,25%,0,0,0,1,0,1
400,https://vlr.gg/player/29903/madv,2024-11-11 10:00:00,0.71,1.22,0.96,205,172,244,31,13,18,33,19,14,2,1,1,-2,-1,-1,63%,57%,70%,144,101,190,38%,34%,40%,5,3,2,7,4,3
401,https://vlr.gg/player/17333/mary,2024-11-11 10:00:00,0.64,1.17,0.90,206,191,222,29,13,16,34,20,14,10,3,7,-6,-2,-4,61%,62%,60%,119,112,126,33%,57%,21%,5,3,2,11,5,6
402,https://vlr.gg/player/19366/lexa,2024-11-11 10:00:00,0.69,1.08,0.88,191,152,233,26,11,15,30,17,13,4,0,4,-2,-4,+2,66%,57%,75%,132,106,159,30%,31%,29%,3,0,3,5,4,1
403,https://vlr.gg/player/20055/toki,2024-11-11 10:00:00,0.89,0.80,0.84,169,201,132,23,14,9,31,18,13,11,4,7,0,-1,+1,66%,71%,60%,112,132,92,28%,32%,22%,2,0,2,2,1,1
404,https://vlr.gg/player/19371/eva,2024-11-11 10:00:00,0.23,1.16,0.68,119,72,169,16,4,12,29,19,10,5,3,2,-1,-1,0,66%,52%,80%,86,56,117,24%,18%,28%,0,0,0,1,1,0
405,https://vlr.gg/player/29314/moco,2024-11-11 10:00:00,1.45,1.17,1.30,206,239,177,31,18,13,21,11,10,25,9,16,+2,+3,-1,80%,80%,81%,134,162,106,40%,32%,52%,3,3,0,1,0,1
406,https://vlr.gg/player/39904/serena,2024-11-11 10:00:00,0.75,1.73,1.26,243,155,327,38,11,27,24,15,9,5,2,3,+2,-2,+4,68%,55%,81%,150,102,196,21%,17%,23%,4,0,4,2,2,0
407,https://vlr.gg/player/29316/aco,2024-11-11 10:00:00,0.88,1.52,1.20,200,179,220,29,12,17,24,15,9,22,9,13,+4,+3,+1,85%,75%,95%,138,112,163,25%,21%,29%,4,3,1,0,0,0
408,https://vlr.gg/player/39902/ur,2024-11-11 10:00:00,0.93,1.23,1.08,209,195,221,32,15,17,24,13,11,12,1,11,-1,0,-1,73%,65%,81%,132,122,141,20%,27%,16%,3,1,2,4,1,3
409,https://vlr.gg/player/10653/suzu,2024-11-11 10:00:00,0.55,1.21,0.89,203,138,266,27,8,19,32,16,16,16,7,9,+4,-2,+6,73%,70%,76%,133,96,168,21%,24%,19%,12,4,8,8,6,2
410,https://vlr.gg/player/1457/mistic,2024-11-10 13:30:00,1.01,1.60,1.30,243,188,300,61,23,38,50,27,23,30,12,18,-1,-3,+2,68%,60%,76%,154,121,189,36%,34%,38%,3,0,3,4,3,1
411,https://vlr.gg/player/2658/xuss,2024-11-10 13:30:00,0.80,1.21,1.00,223,185,264,52,22,30,58,32,26,11,4,7,-2,-7,+5,67%,66%,68%,152,122,182,33%,41%,28%,10,2,8,12,9,3
412,https://vlr.gg/player/2690/hoody,2024-11-10 13:30:00,0.95,0.93,0.94,183,205,164,39,20,19,52,29,23,36,22,14,-3,-2,-1,77%,80%,74%,124,139,109,24%,24%,25%,3,1,2,6,3,3
413,https://vlr.gg/player/5292/al0rante,2024-11-10 13:30:00,0.74,0.93,0.84,166,152,178,39,19,20,53,29,24,15,4,11,-7,-5,-2,65%,60%,71%,114,105,123,32%,40%,26%,3,1,2,10,6,4
414,https://vlr.gg/player/4244/yaboilewis,2024-11-10 13:30:00,0.73,0.90,0.81,154,159,157,39,20,19,53,31,22,15,6,9,-10,-8,-2,59%,54%,65%,113,101,125,32%,29%,36%,4,1,3,14,9,5
415,https://vlr.gg/player/7987/kovaq,2024-11-10 13:30:00,1.41,1.31,1.36,289,295,284,72,36,36,47,24,23,22,7,15,+4,+1,+3,78%,76%,80%,195,193,196,32%,39%,26%,6,2,4,2,1,1
416,https://vlr.gg/player/12593/felix,2024-11-10 13:30:00,0.87,1.54,1.21,233,190,266,58,22,36,41,24,17,17,8,9,+9,+1,+8,80%,74%,86%,153,132,174,39%,36%,42%,11,3,8,2,2,0
417,https://vlr.gg/player/7968/stavinci,2024-11-10 13:30:00,0.77,1.04,0.90,181,168,192,45,19,26,48,27,21,37,15,22,-1,-2,+1,78%,74%,83%,119,103,134,38%,40%,37%,6,4,2,7,6,1
418,https://vlr.gg/player/20302/jini,2024-11-10 13:30:00,0.88,0.90,0.89,163,158,174,41,19,22,44,22,22,29,14,15,+2,-1,+3,78%,71%,86%,105,103,107,20%,28%,15%,6,1,5,4,2,2
419,https://vlr.gg/player/122/luckerrr,2024-11-10 13:30:00,0.69,1.09,0.89,205,173,232,50,22,28,50,29,21,15,11,4,+9,-1,+10,75%,71%,80%,122,108,135,20%,23%,18%,17,6,11,8,7,1
420,https://vlr.gg/player/26632/joliinaa,2024-11-10 13:05:00,1.68,1.67,1.67,317,312,313,40,14,26,20,7,13,20,5,15,+2,0,+2,92%,92%,92%,198,185,206,25%,17%,31%,4,1,3,2,1,1
421,https://vlr.gg/player/17343/ness,2024-11-10 13:05:00,1.39,1.12,1.22,175,205,160,23,10,13,17,6,11,19,9,10,+1,+1,0,89%,92%,88%,108,119,102,14%,15%,14%,1,1,0,0,0,0
422,https://vlr.gg/player/24107/sarah,2024-11-10 13:05:00,1.08,1.30,1.22,200,146,218,26,6,20,18,6,12,16,5,11,+3,0,+3,73%,85%,67%,125,109,133,33%,22%,39%,4,0,4,1,0,1
423,https://vlr.gg/player/24101/miyori,2024-11-10 13:05:00,1.08,1.28,1.21,282,240,278,36,13,23,25,9,16,6,0,6,+1,-1,+2,78%,85%,75%,176,165,182,32%,44%,28%,7,1,6,6,2,4
424,https://vlr.gg/player/16418/smurfette,2024-11-10 13:05:00,1.02,1.12,1.08,193,205,194,28,10,18,21,9,12,7,3,4,-6,-5,-1,68%,54%,75%,127,130,125,19%,17%,22%,3,1,2,9,6,3
425,https://vlr.gg/player/25415/yusin,2024-11-10 13:05:00,1.07,1.25,1.13,234,224,291,31,18,13,32,20,12,15,10,5,+4,+2,+2,76%,75%,77%,157,143,183,28%,28%,27%,5,2,3,1,0,1
426,https://vlr.gg/player/17524/ximilu,2024-11-10 13:05:00,0.67,0.87,0.74,152,153,165,18,11,7,29,20,9,9,5,4,0,0,0,68%,67%,69%,110,105,119,32%,23%,58%,2,1,1,2,1,1
427,https://vlr.gg/player/1909/jinny,2024-11-10 13:05:00,0.70,0.58,0.65,140,144,102,15,10,5,29,19,10,11,8,3,-2,-2,0,57%,58%,54%,82,92,65,26%,21%,42%,1,0,1,3,2,1
428,https://vlr.gg/player/13232/muffyn,2024-11-10 13:05:00,0.56,0.75,0.62,161,170,150,21,14,7,31,21,10,3,1,2,-3,-5,+2,54%,42%,77%,107,100,119,26%,22%,33%,6,4,2,9,9,0
429,https://vlr.gg/player/48160/laiyin,2024-11-10 13:05:00,0.65,0.40,0.56,126,136,131,16,11,5,32,20,12,7,4,3,0,-1,+1,54%,58%,46%,98,101,92,27%,26%,31%,4,2,2,4,3,1
430,https://vlr.gg/player/42651/avey,2024-11-10 12:00:00,0.69,1.43,1.05,224,184,267,46,18,28,45,26,19,14,7,7,-2,-5,+3,68%,61%,76%,145,115,177,23%,22%,24%,11,5,6,13,10,3
431,https://vlr.gg/player/1472/falltw,2024-11-10 12:00:00,1.35,0.65,1.01,215,265,145,43,30,13,43,20,23,18,8,10,-5,-1,-4,63%,65%,62%,130,156,102,28%,31%,25%,4,2,2,9,3,6
432,https://vlr.gg/player/45836/corsa,2024-11-10 12:00:00,0.88,1.00,0.94,190,154,235,44,20,24,46,23,23,13,7,6,+2,0,+2,73%,71%,76%,134,114,155,32%,33%,32%,5,1,4,3,1,2
433,https://vlr.gg/player/42650/mally,2024-11-10 12:00:00,1.10,0.73,0.92,197,221,152,36,24,12,45,22,23,27,8,19,+6,+3,+3,68%,71%,66%,125,145,103,22%,30%,14%,7,4,3,1,1,0
434,https://vlr.gg/player/28479/jkg,2024-11-10 12:00:00,0.67,1.20,0.91,144,85,211,31,6,25,41,21,20,25,19,6,+1,-2,+3,73%,65%,83%,93,58,132,24%,17%,29%,4,1,3,3,3,0
435,https://vlr.gg/player/28480/marky,2024-11-10 12:00:00,1.58,1.38,1.48,270,310,251,57,30,27,36,19,17,20,11,9,+3,+1,+2,78%,86%,71%,190,210,172,20%,25%,15%,10,5,5,7,4,3
436,https://vlr.gg/player/12308/mista,2024-11-10 12:00:00,0.92,1.35,1.14,219,159,271,47,18,29,41,19,22,28,12,16,+4,-1,+5,82%,76%,87%,147,105,186,35%,36%,34%,6,0,6,2,1,1
437,https://vlr.gg/player/40003/wintxrr,2024-11-10 12:00:00,1.00,1.15,1.07,212,244,193,47,24,23,40,23,17,8,5,3,-3,-3,0,73%,69%,77%,146,163,130,35%,42%,29%,4,3,1,7,6,1
438,https://vlr.gg/player/22310/stike,2024-11-10 12:00:00,1.16,0.80,0.97,188,250,154,44,26,18,44,21,23,24,10,14,-1,+1,-2,75%,83%,68%,121,147,96,30%,38%,24%,7,3,4,8,2,6
439,https://vlr.gg/player/6271/haxzorus,2024-11-10 12:00:00,0.45,0.84,0.65,115,82,139,25,10,15,39,20,19,18,4,14,-5,-5,0,65%,59%,71%,68,44,90,25%,27%,23%,2,0,2,7,5,2
440,https://vlr.gg/player/29630/porkychop,2024-11-10 12:00:00,1.61,2.24,1.88,354,282,465,50,22,28,18,11,7,5,4,1,+5,+1,+4,89%,86%,94%,239,193,299,21%,26%,17%,7,2,5,2,1,1
441,https://vlr.gg/player/31350/deqadz,2024-11-10 12:00:00,1.33,1.37,1.35,234,211,265,32,17,15,21,12,9,21,16,5,+1,0,+1,84%,86%,81%,147,129,171,24%,20%,26%,5,3,2,4,3,1
442,https://vlr.gg/player/12372/szoren,2024-11-10 12:00:00,1.51,0.97,1.28,281,345,183,36,26,10,23,14,9,18,7,11,+2,+3,-1,92%,95%,88%,174,220,114,21%,23%,16%,4,3,1,2,0,2
443,https://vlr.gg/player/29628/famzzam,2024-11-10 12:00:00,0.98,1.35,1.14,185,166,208,24,12,12,18,11,7,10,5,5,0,0,0,86%,86%,88%,124,119,130,32%,28%,38%,3,1,2,3,1,2
444,https://vlr.gg/player/42371/t0ba,2024-11-10 12:00:00,0.73,1.11,0.89,155,163,159,23,12,11,23,16,7,9,7,2,-1,-1,0,68%,62%,75%,115,110,121,37%,48%,26%,3,3,0,4,4,0
445,https://vlr.gg/player/47910/sudu1,2024-11-10 12:00:00,0.87,1.28,1.09,220,159,281,30,9,21,31,13,18,4,2,2,-4,-2,-2,62%,50%,71%,151,117,176,24%,42%,17%,2,1,1,6,3,3
446,https://vlr.gg/player/47909/tripic,2024-11-10 12:00:00,0.39,1.14,0.79,171,110,228,23,6,17,31,15,16,10,1,9,0,-2,+2,62%,38%,81%,114,69,148,21%,14%,25%,6,2,4,6,4,2
447,https://vlr.gg/player/47907/jennerbenner,2024-11-10 12:00:00,0.58,0.74,0.67,140,150,129,16,7,9,32,16,16,12,5,7,-2,0,-2,62%,56%,67%,102,109,97,29%,33%,25%,1,1,0,3,1,2
448,https://vlr.gg/player/23190/chevin11,2024-11-10 12:00:00,0.85,0.49,0.64,145,170,133,16,8,8,34,14,20,19,8,11,+1,+1,0,59%,56%,62%,95,116,79,9%,8%,11%,2,1,1,1,0,1
449,https://vlr.gg/player/47908/zwet,2024-11-10 12:00:00,0.50,0.51,0.50,156,174,151,18,9,9,37,18,19,12,4,8,-2,-1,-1,65%,63%,67%,108,118,101,28%,33%,24%,4,1,3,6,2,4
450,https://vlr.gg/player/42256/zentox,2024-11-10 12:00:00,1.14,1.93,1.38,218,197,265,28,18,10,13,12,1,4,3,1,+3,+1,+2,82%,75%,100%,141,126,177,31%,26%,41%,4,2,2,1,1,0
451,https://vlr.gg/player/20591/eagle,2024-11-10 12:00:00,1.14,1.93,1.37,238,211,301,31,18,13,18,15,3,9,8,1,+7,+4,+3,79%,75%,90%,160,135,219,21%,14%,43%,7,4,3,0,0,0
452,https://vlr.gg/player/8816/inst1nct,2024-11-10 12:00:00,1.14,1.68,1.30,209,165,306,24,12,12,14,10,4,15,11,4,+2,-1,+3,85%,88%,80%,134,118,173,14%,14%,15%,3,0,3,1,1,0
453,https://vlr.gg/player/33980/howl9,2024-11-10 12:00:00,1.06,1.65,1.23,249,227,304,31,19,12,20,16,4,5,5,0,+2,0,+2,76%,71%,90%,164,150,197,27%,24%,33%,7,5,2,5,5,0
454,https://vlr.gg/player/20453/ross,2024-11-10 12:00:00,1.41,0.64,1.18,220,273,110,27,24,3,21,14,7,12,7,5,+2,+2,0,82%,83%,80%,136,165,66,31%,44%,14%,4,4,0,2,2,0
455,https://vlr.gg/player/38345/ts-g,2024-11-10 12:00:00,0.36,1.20,0.95,202,109,243,22,3,19,28,10,18,8,1,7,+1,0,+1,65%,30%,79%,131,78,153,28%,13%,32%,2,0,2,1,0,1
456,https://vlr.gg/player/48705/chaza,2024-11-10 12:00:00,0.84,0.91,0.86,211,246,196,22,8,14,28,10,18,7,1,6,-1,-1,0,53%,50%,54%,137,151,131,34%,32%,36%,2,0,2,3,1,2
457,https://vlr.gg/player/6922/lcdfff,2024-11-10 12:00:00,0.47,0.87,0.71,162,117,178,19,3,16,27,10,17,4,1,3,-6,-3,-3,44%,30%,50%,103,89,109,10%,30%,6%,3,0,3,9,3,6
458,https://vlr.gg/player/42655/y0dish,2024-11-10 12:00:00,0.50,0.64,0.60,125,149,119,13,4,9,28,10,18,6,1,5,-3,-2,-1,53%,60%,50%,90,113,81,25%,24%,25%,1,0,1,4,2,2
459,https://vlr.gg/player/38347/keks-u,2024-11-10 12:00:00,0.03,0.42,0.28,87,35,110,10,1,9,30,10,20,3,1,2,-7,-4,-3,50%,30%,58%,58,21,73,16%,33%,15%,1,0,1,8,4,4
460,https://vlr.gg/player/10728/xray,2024-11-10 12:00:00,1.30,1.00,1.15,189,207,174,35,20,15,29,15,14,16,11,5,+1,0,+1,74%,71%,78%,129,136,121,20%,17%,24%,2,0,2,1,0,1
461,https://vlr.gg/player/16948/boogie,2024-11-10 12:00:00,0.90,1.21,1.05,227,184,274,37,16,21,36,18,18,11,4,7,+4,+2,+2,74%,79%,70%,147,120,176,27%,26%,29%,7,4,3,3,2,1
462,https://vlr.gg/player/42570/necro,2024-11-10 12:00:00,0.90,0.98,0.94,183,172,195,31,15,16,33,17,16,18,12,6,+1,-1,+2,66%,67%,65%,121,123,120,24%,22%,27%,4,1,3,3,2,1
463,https://vlr.gg/player/33986/kendo,2024-11-10 12:00:00,0.72,0.88,0.80,197,209,185,32,17,15,38,21,17,8,5,3,+6,+3,+3,81%,83%,78%,123,125,122,27%,38%,18%,14,8,6,8,5,3
464,https://vlr.gg/player/37697/dro9,2024-11-10 12:00:00,0.92,0.64,0.78,165,178,152,24,14,10,33,16,17,16,9,7,-5,-2,-3,68%,75%,61%,118,130,106,16%,22%,11%,0,0,0,5,2,3
465,https://vlr.gg/player/2617/leare,2024-11-10 12:00:00,1.05,1.35,1.20,260,248,274,40,18,22,36,18,18,9,5,4,0,-1,+1,60%,61%,58%,170,165,174,22%,20%,24%,8,4,4,8,5,3
466,https://vlr.gg/player/10270/dev0,2024-11-10 12:00:00,1.48,0.94,1.20,253,288,220,45,26,19,35,16,19,21,11,10,0,-2,+2,70%,74%,67%,153,179,129,49%,40%,68%,3,0,3,3,2,1
467,https://vlr.gg/player/11330/mcd,2024-11-10 12:00:00,0.92,1.42,1.18,202,168,233,33,13,20,27,15,12,9,2,7,+2,+2,0,79%,78%,79%,142,122,162,36%,37%,36%,5,3,2,3,1,2
468,https://vlr.gg/player/1848/incredible,2024-11-10 12:00:00,1.06,0.80,0.92,170,173,168,25,13,12,32,13,19,31,13,18,-7,-2,-5,68%,74%,63%,111,107,114,26%,27%,24%,2,1,1,9,3,6
469,https://vlr.gg/player/8838/chanformer,2024-11-10 12:00:00,0.81,0.93,0.87,148,132,164,26,12,14,29,15,14,12,7,5,-2,-2,0,74%,70%,79%,95,78,111,32%,30%,34%,2,1,1,4,3,1
470,https://vlr.gg/player/12528/disisjohn,2024-11-10 11:00:00,0.08,2.53,1.36,298,79,499,23,2,21,17,11,6,4,2,2,+4,-3,+7,61%,36%,83%,185,59,300,30%,36%,29%,8,1,7,4,4,0
471,https://vlr.gg/player/4969/shazeon,2024-11-10 11:00:00,1.16,1.27,1.22,255,292,220,40,22,18,35,20,15,29,9,20,-1,-1,0,78%,72%,85%,180,199,161,30%,30%,29%,4,1,3,5,2,3
472,https://vlr.gg/player/4629/azury,2024-11-10 11:00:00,0.76,1.57,1.17,244,219,270,24,12,12,20,13,7,3,0,3,-4,-4,0,64%,43%,86%,154,119,189,33%,36%,32%,1,0,1,5,4,1
473,https://vlr.gg/player/7865/xanarchy,2024-11-10 11:00:00,0.71,1.15,0.93,168,122,208,32,10,22,34,19,15,19,8,11,-3,-1,-2,67%,56%,77%,106,79,131,29%,25%,31%,0,0,0,3,1,2
474,https://vlr.gg/player/9508/leosen,2024-11-10 11:00:00,0.43,1.13,0.79,190,137,247,34,11,23,45,24,21,21,6,15,-6,-7,+1,65%,44%,85%,121,88,152,30%,45%,25%,3,0,3,9,7,2
475,https://vlr.gg/player/30750/enes,2024-11-10 11:00:00,0.58,0.67,0.63,111,118,105,20,9,11,37,21,16,16,8,8,-7,-5,-2,57%,44%,69%,76,84,69,26%,19%,35%,1,0,1,8,5,3
476,https://vlr.gg/player/22180/spmak,2024-11-10 11:00:00,1.02,1.77,1.39,257,210,307,45,20,25,30,19,11,19,4,15,+3,-1,+4,78%,65%,92%,171,139,204,16%,18%,15%,5,1,4,2,2,0
477,https://vlr.gg/player/5477/leon,2024-11-10 11:00:00,0.81,1.69,1.24,244,190,301,45,18,27,33,22,11,18,4,14,+7,+1,+6,76%,65%,88%,150,125,177,18%,24%,15%,9,3,6,2,2,0
478,https://vlr.gg/player/30754/karma,2024-11-10 11:00:00,0.92,1.16,1.04,218,226,214,41,21,20,38,21,17,16,6,10,+4,0,+4,78%,69%,88%,139,145,132,25%,22%,29%,9,3,6,5,3,2
479,https://vlr.gg/player/4525/stix,2024-11-10 11:00:00,0.86,1.17,1.01,183,162,211,33,13,20,35,21,14,24,17,7,+1,-2,+3,76%,65%,88%,126,120,134,25%,24%,26%,3,0,3,2,2,0
480,https://vlr.gg/player/45490/ico,2024-11-10 11:00:00,0.31,1.08,0.69,139,109,172,24,8,16,37,24,13,16,8,8,+2,-2,+4,65%,46%,84%,91,70,113,23%,22%,23%,8,4,4,6,6,0
481,https://vlr.gg/player/8329/starbound,2024-11-10 10:00:00,1.03,1.18,1.09,230,227,231,50,27,23,45,28,17,11,7,4,+2,0,+2,75%,66%,88%,153,149,158,23%,22%,23%,5,2,3,3,2,1
482,https://vlr.gg/player/33694/evv,2024-11-10 10:00:00,0.97,1.21,1.07,223,209,244,49,27,22,43,27,16,17,8,9,-2,-1,-1,74%,71%,77%,147,130,169,39%,39%,39%,6,3,3,8,4,4
483,https://vlr.gg/player/9185/dodonut,2024-11-10 10:00:00,0.97,1.13,1.04,224,232,216,45,26,19,49,31,18,15,8,7,+6,-1,+7,80%,80%,81%,151,155,145,23%,21%,25%,15,7,8,9,8,1
484,https://vlr.gg/player/11968/l4ce,2024-11-10 10:00:00,0.91,1.16,1.02,191,182,201,41,22,19,45,27,18,36,21,15,+2,0,+2,74%,69%,81%,120,111,132,23%,16%,36%,4,2,2,2,2,0
485,https://vlr.gg/player/17/theia,2024-11-10 10:00:00,0.63,1.08,0.82,162,141,189,33,16,17,43,27,16,39,18,21,+1,-1,+2,64%,57%,73%,98,87,113,25%,22%,29%,5,2,3,4,3,1
486,https://vlr.gg/player/10653/suzu,2024-11-10 10:00:00,0.76,1.84,1.38,300,224,364,67,19,48,47,23,24,8,2,6,+1,-2,+3,74%,62%,83%,194,146,229,30%,28%,31%,11,5,6,10,7,3
487,https://vlr.gg/player/29316/aco,2024-11-10 10:00:00,0.97,1.08,1.03,190,201,186,38,17,21,42,21,21,39,13,26,+1,+1,0,80%,81%,80%,124,125,123,26%,28%,24%,3,2,1,2,1,1
488,https://vlr.gg/player/29314/moco,2024-11-10 10:00:00,1.16,0.83,0.97,190,207,171,42,20,22,41,17,24,20,6,14,-4,-2,-2,70%,73%,69%,119,132,110,34%,41%,28%,3,0,3,7,2,5
489,https://vlr.gg/player/39902/ur,2024-11-10 10:00:00,0.77,1.08,0.95,191,163,216,38,12,26,43,20,23,24,9,15,-5,-4,-1,70%,77%,66%,124,112,134,19%,19%,18%,4,0,4,9,4,5
490,https://vlr.gg/player/39904/serena,2024-11-10 10:00:00,0.81,0.96,0.88,192,161,221,40,17,23,45,19,26,18,4,14,-2,-5,+3,75%,65%,83%,125,100,144,20%,20%,20%,5,0,5,7,5,2
491,https://vlr.gg/player/42651/avey,2024-11-10 09:00:00,0.65,1.25,0.91,211,179,282,27,11,16,31,19,12,8,5,3,-2,-3,+1,69%,60%,81%,135,121,152,18%,26%,13%,8,4,4,10,7,3
492,https://vlr.gg/player/45836/corsa,2024-11-10 09:00:00,0.47,1.22,0.80,180,157,216,22,10,12,30,19,11,10,5,5,-3,-2,-1,69%,65%,75%,121,107,138,28%,28%,28%,1,0,1,4,2,2
493,https://vlr.gg/player/28479/jkg,2024-11-10 09:00:00,0.57,0.98,0.75,138,136,145,17,9,8,28,19,9,13,5,8,-5,-3,-2,67%,65%,69%,99,95,104,31%,35%,27%,0,0,0,5,3,2
494,https://vlr.gg/player/42650/mally,2024-11-10 09:00:00,0.80,0.57,0.69,151,191,96,18,12,6,32,19,13,7,6,1,0,0,0,64%,65%,63%,103,135,64,23%,22%,26%,1,0,1,1,0,1
495,https://vlr.gg/player/1472/falltw,2024-11-10 09:00:00,0.34,0.78,0.53,139,124,161,18,9,9,31,19,12,4,1,3,-2,-2,0,47%,50%,44%,91,84,99,21%,29%,16%,2,1,1,4,3,1
496,https://vlr.gg/player/22617/vitie,2024-11-10 09:00:00,0.83,1.86,1.40,256,161,321,32,9,23,20,11,9,21,6,15,+3,0,+3,78%,63%,90%,162,112,202,30%,39%,27%,5,1,4,2,1,1
497,https://vlr.gg/player/5203/bati,2024-11-10 09:00:00,0.72,1.85,1.34,227,126,300,31,7,24,17,9,8,17,5,12,+2,-2,+4,78%,69%,85%,142,84,188,33%,30%,33%,4,0,4,2,2,0
498,https://vlr.gg/player/9943/mezoky,2024-11-10 09:00:00,1.53,1.02,1.25,172,264,100,25,17,8,16,9,7,12,4,8,0,+1,-1,81%,75%,85%,118,170,77,25%,37%,8%,2,2,0,2,1,1
499,https://vlr.gg/player/24426/w1ll,2024-11-10 09:00:00,0.75,1.50,1.17,244,158,316,29,8,21,24,11,13,14,4,10,+4,+2,+2,86%,75%,95%,152,103,191,30%,20%,34%,5,2,3,1,0,1
500,https://vlr.gg/player/34002/lukey,2024-11-10 09:00:00,1.18,1.10,1.13,272,291,261,35,16,19,25,11,14,7,2,5,+3,+1,+2,72%,63%,80%,173,190,160,30%,36%,25%,8,4,4,5,3,2
0,https://vlr.gg/player/12519/ticey,2024-11-10 09:00:00,1.26,1.13,1.19,257,275,232,38,18,20,30,14,16,15,8,7,+1,+1,0,79%,84%,75%,157,184,135,19%,25%,13%,9,5,4,8,4,4
1,https://vlr.gg/player/33994/creamydreamy,2024-11-10 09:00:00,1.07,1.24,1.17,216,152,276,31,9,22,29,10,19,28,16,12,-4,-4,0,81%,84%,79%,142,100,176,29%,32%,28%,2,0,2,6,4,2
2,https://vlr.gg/player/24428/harambe,2024-11-10 09:00:00,1.04,1.23,1.14,228,224,237,34,14,20,29,13,16,11,3,8,+2,+3,-1,74%,63%,83%,152,145,158,26%,32%,23%,5,3,2,3,0,3
3,https://vlr.gg/player/31298/luca,2024-11-10 09:00:00,1.24,1.06,1.14,174,173,161,28,14,14,23,9,14,17,6,11,0,0,0,74%,79%,71%,112,99,122,19%,19%,20%,1,1,0,1,1,0
4,https://vlr.gg/player/30901/ianto,2024-11-10 09:00:00,1.20,0.50,0.81,149,198,108,22,14,8,28,10,18,13,3,10,0,+1,-1,74%,74%,75%,99,138,69,22%,17%,29%,4,1,3,4,0,4
5,https://vlr.gg/player/11293/chukl9,2024-11-10 09:00:00,1.22,1.09,1.16,220,226,227,32,18,14,28,15,13,14,8,6,+1,+1,0,77%,79%,74%,155,161,147,32%,34%,29%,5,2,3,4,1,3
6,https://vlr.gg/player/42550/merix,2024-11-10 09:00:00,1.02,0.86,0.95,220,243,202,35,22,13,32,19,13,4,2,2,+5,+3,+2,65%,71%,58%,144,157,128,21%,27%,14%,8,5,3,3,2,1
7,https://vlr.gg/player/31300/drog,2024-11-10 09:00:00,0.82,0.95,0.88,185,166,202,27,14,13,31,17,14,10,5,5,-4,-1,-3,58%,63%,53%,121,110,134,24%,27%,22%,3,3,0,7,4,3
8,https://vlr.gg/player/10931/xenp1o,2024-11-10 09:00:00,1.07,0.65,0.88,153,177,108,24,16,8,28,14,14,4,2,2,-1,-2,+1,67%,63%,74%,92,111,68,27%,30%,23%,1,0,1,2,2,0
9,https://vlr.gg/player/20443/br-di,2024-11-10 09:00:00,0.91,0.62,0.78,174,181,159,21,13,8,34,19,15,24,12,12,0,+1,-1,77%,79%,74%,117,124,108,23%,28%,18%,5,3,2,5,2,3
10,https://vlr.gg/player/33358/shinnok,2024-11-10 09:00:00,1.84,1.96,1.91,341,369,322,27,12,15,9,4,5,5,2,3,+1,+3,-2,76%,89%,67%,215,244,193,39%,53%,31%,3,3,0,2,0,2
11,https://vlr.gg/player/36402/kubfu,2024-11-10 09:00:00,1.40,1.56,1.50,269,291,253,22,10,12,12,6,6,10,4,6,-1,-1,0,81%,67%,92%,164,169,159,40%,63%,29%,0,0,0,1,1,0
12,https://vlr.gg/player/44922/golack,2024-11-10 09:00:00,1.51,0.75,1.08,268,342,213,20,11,9,17,7,10,0,0,0,+5,+3,+2,76%,67%,83%,153,186,129,39%,40%,38%,9,3,6,4,0,4
13,https://vlr.gg/player/42458/bravo,2024-11-10 09:00:00,0.47,0.82,0.67,131,93,160,8,2,6,15,7,8,15,7,8,-1,-1,0,90%,100%,83%,84,66,99,18%,8%,25%,0,0,0,1,1,0
14,https://vlr.gg/player/39103/waken,2024-11-10 09:00:00,0.51,0.77,0.66,127,115,137,8,3,5,14,6,8,13,6,7,-1,-1,0,76%,89%,67%,86,85,86,14%,20%,9%,0,0,0,1,1,0
15,https://vlr.gg/player/15237/lolb0om,2024-11-10 09:00:00,0.89,1.38,1.10,216,237,191,16,9,7,17,12,5,3,2,1,0,+1,-1,62%,58%,67%,147,152,140,24%,21%,29%,1,1,0,1,0,1
16,https://vlr.gg/player/29043/spartah,2024-11-10 09:00:00,0.92,0.98,0.95,194,203,184,14,8,6,16,10,6,8,5,3,0,+1,-1,57%,67%,44%,125,132,115,39%,33%,50%,2,2,0,2,1,1
17,https://vlr.gg/player/15167/mcnuggets,2024-11-10 09:00:00,0.85,1.06,0.94,188,164,222,14,6,8,16,7,9,4,2,2,+2,0,+2,57%,58%,56%,111,110,113,33%,15%,55%,5,2,3,3,2,1
18,https://vlr.gg/player/15183/doobs,2024-11-10 09:00:00,0.93,0.29,0.65,169,179,155,13,9,4,17,8,9,7,4,3,-4,-1,-3,67%,75%,56%,112,109,116,21%,14%,33%,1,1,0,5,2,3
19,https://vlr.gg/player/11358/karokis,2024-11-10 09:00:00,0.45,0.36,0.41,149,127,180,10,5,5,19,10,9,6,3,3,-1,-1,0,57%,58%,56%,103,101,105,23%,31%,18%,0,0,0,1,1,0
20,https://vlr.gg/player/47926/chapix,2024-11-10 09:00:00,1.13,1.67,1.40,288,254,323,48,19,29,32,19,13,15,7,8,+1,-1,+2,73%,71%,75%,178,169,187,19%,21%,17%,9,4,5,8,5,3
21,https://vlr.gg/player/23198/wak1e,2024-11-10 09:00:00,0.95,1.29,1.12,206,187,226,36,16,20,33,18,15,23,8,15,+1,0,+1,83%,75%,92%,126,109,143,24%,20%,28%,6,3,3,5,3,2
22,https://vlr.gg/player/15080/f1co,2024-11-10 09:00:00,0.44,1.26,0.85,147,81,214,23,5,18,34,19,15,18,9,9,+2,0,+2,71%,63%,79%,115,61,168,23%,10%,29%,3,1,2,1,1,0
23,https://vlr.gg/player/23197/knowbii,2024-11-10 09:00:00,0.78,0.84,0.81,165,149,181,25,11,14,35,17,18,26,16,10,0,-1,+1,79%,79%,79%,107,92,122,24%,22%,25%,3,0,3,3,1,2
24,https://vlr.gg/player/19058/folke,2024-11-10 09:00:00,0.71,0.84,0.78,149,135,164,25,11,14,34,18,16,9,3,6,-4,-2,-2,65%,58%,71%,105,97,112,33%,40%,29%,3,2,1,7,4,3
25,https://vlr.gg/player/10270/dev0,2024-11-10 09:00:00,1.42,1.36,1.39,239,263,216,40,22,18,31,19,12,29,9,20,+3,+1,+2,85%,83%,88%,156,166,146,40%,39%,42%,5,2,3,2,1,1
26,https://vlr.gg/player/11330/mcd,2024-11-10 09:00:00,0.77,1.56,1.16,228,174,281,39,14,25,30,18,12,4,2,2,+2,+1,+1,71%,67%,75%,158,120,195,35%,33%,36%,6,3,3,4,2,2
27,https://vlr.gg/player/2617/leare,2024-11-10 09:00:00,0.94,1.01,0.97,228,251,205,39,20,19,36,21,15,8,6,2,-1,-1,0,67%,63%,71%,144,160,128,34%,33%,35%,6,2,4,7,3,4
28,https://vlr.gg/player/8838/chanformer,2024-11-10 09:00:00,0.73,0.96,0.85,170,159,181,26,13,13,32,19,13,11,6,5,0,-1,+1,73%,63%,83%,126,120,132,26%,31%,23%,4,2,2,4,3,1
29,https://vlr.gg/player/1848/incredible,2024-11-10 09:00:00,0.39,1.17,0.78,143,97,189,24,8,16,29,19,10,16,3,13,-4,-4,0,69%,54%,83%,92,66,118,28%,24%,30%,3,1,2,7,5,2
30,https://vlr.gg/player/10501/furiouzmeow,2024-11-10 09:00:00,1.35,0.89,1.13,230,257,200,38,23,15,35,18,17,17,12,5,+4,+1,+3,70%,83%,55%,137,152,120,17%,19%,15%,6,3,3,2,2,0
31,https://vlr.gg/player/42634/rawn3n,2024-11-10 09:00:00,1.06,1.08,1.07,221,246,198,38,22,16,34,18,16,6,4,2,-1,-1,0,70%,67%,73%,150,166,132,20%,22%,17%,3,0,3,4,1,3
32,https://vlr.gg/player/32616/fe11xx,2024-11-10 09:00:00,1.00,1.01,1.01,181,161,205,26,12,14,32,15,17,22,13,9,-2,-1,-1,74%,75%,73%,134,120,149,19%,17%,21%,2,0,2,4,1,3
33,https://vlr.gg/player/42632/darksy,2024-11-10 09:00:00,0.90,0.90,0.90,207,211,200,33,18,15,36,17,19,16,4,12,-2,+1,-3,74%,71%,77%,141,134,148,39%,31%,49%,2,2,0,4,1,3
34,https://vlr.gg/player/22469/sm1le,2024-11-10 09:00:00,0.48,0.68,0.57,156,153,159,25,13,12,37,19,18,4,2,2,-7,-6,-1,52%,50%,55%,101,93,110,28%,21%,37%,6,4,2,13,10,3
35,https://vlr.gg/player/11332/ara,2024-11-10 09:00:00,0.88,1.59,1.25,251,213,294,42,16,26,32,17,15,11,5,6,+5,-1,+6,80%,82%,79%,151,126,175,29%,31%,27%,10,3,7,5,4,1
36,https://vlr.gg/player/33292/martux,2024-11-10 09:00:00,1.49,1.03,1.25,256,298,213,40,23,17,31,14,17,14,8,6,+3,+5,-2,72%,77%,67%,164,187,142,23%,20%,27%,8,6,2,5,1,4
37,https://vlr.gg/player/32345/snaptor,2024-11-10 09:00:00,1.26,1.20,1.23,218,215,220,36,18,18,28,12,16,11,4,7,+1,0,+1,74%,77%,71%,167,178,158,33%,33%,33%,2,0,2,1,0,1
38,https://vlr.gg/player/38840/lamelly,2024-11-10 09:00:00,1.32,1.11,1.21,212,211,215,33,17,16,31,13,18,30,17,13,0,0,0,76%,73%,79%,150,144,156,23%,20%,26%,2,1,1,2,1,1
39,https://vlr.gg/player/29634/cintyx,2024-11-10 09:00:00,0.71,0.43,0.56,139,158,119,23,13,10,38,16,22,8,2,6,-1,-2,+1,57%,59%,54%,85,103,69,21%,32%,13%,5,2,3,6,4,2
40,https://vlr.gg/player/16215/dos9,2024-11-10 06:40:00,1.55,0.85,1.26,200,268,136,31,23,8,22,12,10,22,17,5,+3,+3,0,88%,100%,71%,142,179,89,26%,23%,44%,3,3,0,0,0,0
41,https://vlr.gg/player/7043/ncslasher,2024-11-10 06:40:00,1.25,1.13,1.20,223,230,201,30,19,11,26,15,11,20,16,4,+5,+1,+4,78%,83%,71%,147,166,120,28%,31%,22%,6,2,4,1,1,0
42,https://vlr.gg/player/10739/shiro,2024-11-10 06:40:00,0.91,1.61,1.20,251,190,329,32,15,17,27,17,10,24,17,7,+2,-1,+3,80%,83%,76%,170,134,221,20%,23%,18%,8,2,6,6,3,3
43,https://vlr.gg/player/4874/berserx,2024-11-10 06:40:00,1.10,1.33,1.19,194,180,209,29,15,14,22,12,10,9,5,4,0,0,0,80%,79%,82%,133,118,154,39%,40%,38%,1,1,0,1,1,0
44,https://vlr.gg/player/9717/lilo,2024-11-10 06:40:00,1.52,0.54,1.11,253,327,122,34,29,5,28,15,13,10,5,5,-1,+1,-2,78%,88%,65%,152,194,92,18%,19%,11%,7,6,1,8,5,3
45,https://vlr.gg/player/7807/valdyn,2024-11-10 06:40:00,1.63,0.64,1.05,188,256,128,27,15,12,30,9,21,19,15,4,0,+1,-1,73%,88%,63%,119,166,85,34%,38%,27%,2,2,0,2,1,1
46,https://vlr.gg/player/16852/nakya,2024-11-10 06:40:00,0.83,1.08,0.97,226,206,243,33,13,20,33,13,20,11,3,8,-2,0,-2,73%,71%,75%,140,142,138,28%,34%,24%,4,2,2,6,2,4
47,https://vlr.gg/player/23710/gotten,2024-11-10 06:40:00,1.13,0.77,0.92,159,191,141,23,12,11,28,10,18,19,9,10,-5,-2,-3,73%,82%,67%,115,131,104,28%,34%,23%,1,0,1,6,2,4
48,https://vlr.gg/player/2346/cud,2024-11-10 06:40:00,0.80,0.66,0.72,122,139,124,21,9,12,28,10,18,3,0,3,-1,-1,0,66%,71%,63%,81,82,80,32%,32%,32%,3,1,2,4,2,2
49,https://vlr.gg/player/11666/ray4c,2024-11-10 06:40:00,0.37,0.80,0.62,180,88,248,21,5,16,37,13,24,10,1,9,-1,-3,+2,63%,47%,75%,123,68,162,11%,13%,11%,6,1,5,7,4,3
50,https://vlr.gg/player/4885/whzy,2024-11-10 04:05:00,,,,269,,,89,,,73,,,14,,,,,,,,,,,,,,,,,,,,
51,https://vlr.gg/player/10698/nephh,2024-11-10 04:05:00,,,,235,,,71,,,64,,,51,,,,,,,,,,,,,,,,,,,,
52,https://vlr.gg/player/4774/knight,2024-11-10 04:05:00,,,,185,,,61,,,55,,,26,,,,,,,,,,,,,,,,,,,,
53,https://vlr.gg/player/48878/rushia,2024-11-10 04:05:00,,,,183,,,64,,,65,,,30,,,,,,,,,,,,,,,,,,,,
54,https://vlr.gg/player/40845/levius,2024-11-10 04:05:00,,,,162,,,56,,,59,,,18,,,,,,,,,,,,,,,,,,,,
55,https://vlr.gg/player/14125/spring,2024-11-10 04:05:00,,,,216,,,73,,,68,,,11,,,,,,,,,,,,,,,,,,,,
56,https://vlr.gg/player/7849/siufatbb,2024-11-10 04:05:00,,,,210,,,70,,,66,,,17,,,,,,,,,,,,,,,,,,,,
57,https://vlr.gg/player/37489/lysoar,2024-11-10 04:05:00,,,,205,,,69,,,72,,,18,,,,,,,,,,,,,,,,,,,,
58,https://vlr.gg/player/11218/yuicaw,2024-11-10 04:05:00,,,,173,,,57,,,75,,,34,,,,,,,,,,,,,,,,,,,,
59,https://vlr.gg/player/45104/v1ya,2024-11-10 04:05:00,,,,152,,,47,,,64,,,45,,,,,,,,,,,,,,,,,,,,
60,https://vlr.gg/player/44298/banunu,2024-11-10 02:40:00,0.93,1.02,0.99,187,154,205,26,8,18,28,9,19,7,3,4,0,+1,-1,78%,83%,75%,113,86,126,24%,19%,27%,2,1,1,2,0,2
61,https://vlr.gg/player/7436/fission,2024-11-10 02:40:00,0.56,0.95,0.82,208,199,214,24,8,16,33,12,21,9,3,6,-6,-1,-5,61%,58%,63%,146,129,154,22%,32%,18%,3,1,2,9,2,7
62,https://vlr.gg/player/7754/xavi8k,2024-11-10 02:40:00,0.46,0.97,0.76,178,103,218,20,4,16,31,10,21,12,3,9,-11,-6,-5,61%,50%,67%,115,61,142,15%,30%,13%,2,1,1,13,7,6
63,https://vlr.gg/player/49001/secre,2024-11-10 02:40:00,0.77,0.76,0.76,173,183,170,19,7,12,32,10,22,8,2,6,-1,0,-1,56%,58%,54%,112,113,112,36%,25%,43%,0,0,0,1,0,1
64,https://vlr.gg/player/49002/dy,2024-11-10 02:40:00,0.67,0.68,0.68,142,161,132,16,6,10,30,11,19,12,5,7,-2,0,-2,58%,67%,54%,103,125,92,30%,35%,27%,1,0,1,3,0,3
65,https://vlr.gg/player/21677/jeee,2024-11-10 02:40:00,1.50,1.26,1.42,238,274,167,33,25,8,16,11,5,11,10,1,+3,+3,0,92%,96%,83%,151,168,117,26%,25%,29%,4,3,1,1,0,1
66,https://vlr.gg/player/16953/zynd,2024-11-10 02:40:00,1.45,1.25,1.38,259,271,239,35,23,12,20,13,7,9,6,3,+2,+2,0,72%,71%,75%,166,168,162,39%,36%,46%,4,4,0,2,2,0
67,https://vlr.gg/player/13744/patmen,2024-11-10 02:40:00,1.17,1.53,1.29,269,260,288,37,24,13,26,18,8,19,12,7,+6,+5,+1,86%,83%,92%,183,179,191,35%,32%,41%,9,6,3,3,1,2
68,https://vlr.gg/player/7746/kevzii,2024-11-10 02:40:00,0.92,1.22,1.02,196,209,175,24,17,7,22,16,6,13,9,4,+3,+2,+1,81%,83%,75%,125,133,110,31%,35%,25%,5,4,1,2,2,0
69,https://vlr.gg/player/9737/kakarot,2024-11-10 02:40:00,0.79,1.46,1.01,194,142,287,25,13,12,21,14,7,13,8,5,+6,+2,+4,81%,79%,83%,116,93,160,17%,15%,18%,6,2,4,0,0,0
70,https://vlr.gg/player/2858/suygetsu,2024-11-09 16:55:00,1.41,1.20,1.31,262,281,243,22,12,10,16,8,8,7,1,6,0,+1,-1,74%,75%,73%,175,185,163,37%,42%,32%,1,1,0,1,0,1
71,https://vlr.gg/player/727/saadhak,2024-11-09 16:55:00,1.07,1.29,1.17,235,204,270,18,8,10,15,8,7,5,3,2,+6,+2,+4,83%,83%,82%,155,140,171,44%,42%,45%,7,2,5,1,0,1
72,https://vlr.gg/player/5654/avez,2024-11-09 16:55:00,0.95,1.40,1.17,239,207,275,20,10,10,17,10,7,10,3,7,+2,+1,+1,83%,75%,91%,147,128,168,52%,41%,67%,2,1,1,0,0,0
73,https://vlr.gg/player/16459/elite,2024-11-09 16:55:00,0.94,1.02,0.98,213,230,195,19,10,9,16,9,7,3,2,1,-2,-2,0,70%,67%,73%,136,141,130,46%,45%,47%,2,1,1,4,3,1
74,https://vlr.gg/player/10307/marteen,2024-11-09 16:55:00,0.33,1.14,0.72,144,86,208,11,3,8,18,10,8,8,3,5,-3,-2,-1,78%,67%,91%,94,65,126,23%,36%,20%,1,1,0,4,3,1
75,https://vlr.gg/player/1428/sheydos,2024-11-09 16:55:00,1.76,0.96,1.34,255,315,201,22,14,8,15,8,7,5,2,3,0,+1,-1,83%,91%,75%,158,181,136,22%,28%,15%,1,1,0,1,0,1
76,https://vlr.gg/player/5550/grubinho,2024-11-09 16:55:00,1.07,1.16,1.12,214,205,223,19,9,10,17,8,9,5,3,2,+2,0,+2,57%,45%,67%,140,124,155,56%,47%,67%,4,1,3,2,1,1
77,https://vlr.gg/player/101/soulcas,2024-11-09 16:55:00,0.37,1.46,0.94,159,78,233,13,2,11,18,11,7,15,7,8,-1,0,-1,70%,64%,75%,114,52,170,26%,17%,29%,0,0,0,1,0,1
78,https://vlr.gg/player/4544/filu,2024-11-09 16:55:00,0.53,1.00,0.78,239,218,259,18,8,10,20,11,9,2,0,2,-3,-3,0,74%,73%,75%,148,145,151,23%,28%,20%,2,1,1,5,4,1
79,https://vlr.gg/player/3685/flyuh,2024-11-09 16:55:00,0.31,0.53,0.42,145,137,152,10,4,6,21,10,11,6,3,3,-1,-1,0,52%,45%,58%,100,98,101,23%,31%,17%,3,1,2,4,2,2
80,https://vlr.gg/player/11183/glance,2024-11-09 15:45:00,1.33,1.04,1.22,274,296,242,19,13,6,17,10,7,8,4,4,+1,0,+1,80%,67%,100%,173,198,135,49%,45%,63%,1,0,1,0,0,0
81,https://vlr.gg/player/16419/roxi,2024-11-09 15:45:00,1.23,0.89,1.10,221,264,158,16,11,5,17,11,6,2,1,1,-1,0,-1,75%,75%,75%,161,199,103,23%,26%,18%,0,0,0,1,0,1
82,https://vlr.gg/player/19356/kuripuuya,2024-11-09 15:45:00,0.53,0.83,0.65,136,112,173,9,4,5,16,10,6,6,3,3,-3,-2,-1,60%,50%,75%,79,60,108,32%,29%,36%,1,0,1,4,2,2
83,https://vlr.gg/player/21153/matrix,2024-11-09 15:45:00,0.31,0.82,0.51,172,128,238,13,5,8,19,11,8,1,1,0,-3,-3,0,55%,50%,63%,104,81,139,42%,41%,43%,4,3,1,7,6,1
84,https://vlr.gg/player/16321/nelo,2024-11-09 15:45:00,0.31,0.75,0.49,135,106,180,8,4,4,18,11,7,11,3,8,-2,-1,-1,65%,50%,88%,94,77,119,19%,13%,25%,0,0,0,2,1,1
85,https://vlr.gg/player/29960/nidxvilco,2024-11-09 15:45:00,1.50,1.64,1.58,304,371,260,24,11,13,13,7,6,9,7,2,+2,0,+2,90%,100%,83%,178,224,148,29%,37%,22%,3,1,2,1,1,0
86,https://vlr.gg/player/20058/devilasxa,2024-11-09 15:45:00,1.53,1.49,1.51,278,199,331,20,7,13,13,3,10,14,6,8,-2,-2,0,95%,88%,100%,167,122,197,27%,45%,21%,1,0,1,3,2,1
87,https://vlr.gg/player/30105/ikyoo,2024-11-09 15:45:00,0.92,1.49,1.26,279,253,297,18,6,12,15,8,7,7,4,3,+5,+1,+4,95%,88%,100%,185,166,199,25%,35%,21%,6,1,5,1,0,1
88,https://vlr.gg/player/26698/lil-bob,2024-11-09 15:45:00,1.58,0.95,1.21,206,277,159,17,8,9,11,4,7,3,0,3,+3,+3,0,75%,75%,75%,146,181,122,48%,62%,39%,4,3,1,1,0,1
89,https://vlr.gg/player/30060/alessia,2024-11-09 15:45:00,0.43,0.69,0.58,98,53,129,8,2,6,13,6,7,4,2,2,0,0,0,75%,88%,67%,71,35,95,10%,0%,14%,0,0,0,0,0,0
90,https://vlr.gg/player/17976/florescent,2024-11-09 12:40:00,1.68,1.57,1.64,354,381,313,45,31,14,23,16,7,17,15,2,+6,+3,+3,92%,88%,100%,227,245,194,34%,37%,26%,10,6,4,4,3,1
91,https://vlr.gg/player/3079/alexis,2024-11-09 12:40:00,1.34,1.29,1.32,219,231,207,31,20,11,19,13,6,20,16,4,0,-1,+1,78%,79%,77%,137,139,134,30%,29%,30%,2,1,1,2,2,0
92,https://vlr.gg/player/3063/mel,2024-11-09 12:40:00,1.23,1.42,1.30,242,232,256,31,19,12,20,13,7,19,14,5,+4,+2,+2,86%,92%,77%,144,147,139,33%,25%,44%,7,4,3,3,2,1
93,https://vlr.gg/player/17397/noia,2024-11-09 12:40:00,1.52,0.82,1.28,183,223,100,28,23,5,16,10,6,6,3,3,-1,-2,+1,78%,83%,69%,125,162,58,34%,34%,35%,1,0,1,2,2,0
94,https://vlr.gg/player/21486/sarahcat,2024-11-09 12:40:00,1.08,1.10,1.09,202,203,193,25,17,8,21,14,7,17,12,5,0,0,0,81%,79%,85%,135,133,139,27%,30%,23%,3,2,1,3,2,1
95,https://vlr.gg/player/19371/eva,2024-11-09 12:40:00,1.22,0.86,0.98,194,177,212,26,8,18,30,8,22,10,7,3,-2,-1,-1,62%,62%,63%,122,107,131,26%,26%,25%,1,0,1,3,1,2
96,https://vlr.gg/player/17333/mary,2024-11-09 12:40:00,0.24,0.96,0.70,198,122,236,23,5,18,35,13,22,6,3,3,0,-1,+1,65%,69%,63%,127,85,150,39%,40%,38%,7,3,4,7,4,3
97,https://vlr.gg/player/20055/toki,2024-11-09 12:40:00,1.00,0.51,0.69,157,173,145,18,7,11,32,8,24,9,4,5,+1,0,+1,65%,69%,63%,109,123,101,40%,31%,48%,3,0,3,2,0,2
98,https://vlr.gg/player/29903/madv,2024-11-09 12:40:00,0.87,0.62,0.69,173,193,170,22,9,13,33,11,22,6,2,4,-6,-4,-2,65%,77%,58%,117,118,117,30%,33%,29%,3,0,3,9,4,5
99,https://vlr.gg/player/19366/lexa,2024-11-09 12:40:00,0.44,0.36,0.39,87,91,83,10,4,6,30,10,20,5,0,5,-2,-1,-1,59%,54%,63%,62,70,58,20%,18%,22%,0,0,0,2,1,1
100,https://vlr.gg/player/7660/fizzy,2024-11-09 12:10:00,1.22,1.53,1.44,276,194,298,34,7,27,20,6,14,7,4,3,+6,+2,+4,74%,90%,67%,169,132,184,37%,30%,39%,7,3,4,1,1,0
101,https://vlr.gg/player/10338/lime,2024-11-09 12:10:00,1.32,1.48,1.43,245,208,255,28,8,20,15,5,10,9,2,7,+1,+1,0,91%,90%,92%,172,136,187,39%,44%,38%,4,2,2,3,1,2
102,https://vlr.gg/player/3674/iluri,2024-11-09 12:10:00,1.30,1.29,1.30,211,196,193,26,8,18,15,4,11,20,2,18,-3,-1,-2,82%,80%,83%,122,132,118,37%,57%,29%,1,0,1,4,1,3
103,https://vlr.gg/player/3753/obnoks,2024-11-09 12:10:00,1.26,1.26,1.26,223,242,232,28,8,20,19,6,13,11,5,6,+1,0,+1,79%,90%,75%,144,157,139,24%,24%,23%,3,0,3,2,0,2
104,https://vlr.gg/player/18400/bipo,2024-11-09 12:10:00,1.30,1.20,1.23,203,238,192,28,10,18,17,6,11,4,1,3,+5,+2,+3,88%,90%,88%,134,149,128,27%,41%,22%,7,2,5,2,0,2
105,https://vlr.gg/player/45494/proxh,2024-11-09 12:10:00,1.20,0.69,1.05,219,246,174,28,22,6,27,19,8,10,6,4,-2,-2,0,65%,67%,60%,143,159,104,32%,35%,26%,1,0,1,3,2,1
106,https://vlr.gg/player/27789/deyten,2024-11-09 12:10:00,0.69,1.16,0.82,159,148,205,19,12,7,27,20,7,6,3,3,-3,-2,-1,53%,50%,60%,112,101,138,42%,42%,41%,0,0,0,3,2,1
107,https://vlr.gg/player/22518/mimori,2024-11-09 12:10:00,0.73,0.58,0.69,143,154,103,17,13,4,27,19,8,3,2,1,-2,-1,-1,56%,58%,50%,90,97,73,46%,50%,38%,5,4,1,7,5,2
108,https://vlr.gg/player/33974/appa,2024-11-09 12:10:00,0.51,0.59,0.54,175,167,176,16,11,5,31,22,9,5,3,2,0,0,0,56%,58%,50%,121,117,131,33%,33%,32%,5,4,1,5,4,1
109,https://vlr.gg/player/7991/hyperr,2024-11-09 12:10:00,0.09,0.69,0.26,81,50,159,6,1,5,32,23,9,15,9,6,-3,-1,-2,56%,50%,70%,61,43,106,15%,21%,10%,1,1,0,4,2,2
110,https://vlr.gg/player/37697/dro9,2024-11-09 11:00:00,0.40,0.97,0.86,222,141,242,9,1,8,14,3,11,3,1,2,+1,-1,+2,67%,67%,67%,153,100,166,6%,0%,8%,2,0,2,1,1,0
111,https://vlr.gg/player/16948/boogie,2024-11-09 11:00:00,0.30,0.69,0.61,183,150,192,8,1,7,15,3,12,3,1,2,-1,0,-1,33%,67%,25%,121,107,125,18%,0%,22%,1,0,1,2,0,2
112,https://vlr.gg/player/42570/necro,2024-11-09 11:00:00,0.40,0.59,0.55,144,183,135,6,2,4,14,3,11,4,0,4,-1,0,-1,53%,67%,50%,114,120,112,18%,8%,23%,0,0,0,1,0,1
113,https://vlr.gg/player/33986/kendo,2024-11-09 11:00:00,0.40,0.53,0.50,136,134,137,8,2,6,15,3,12,2,0,2,-2,-1,-1,53%,67%,50%,87,81,89,30%,75%,21%,1,0,1,3,1,2
114,https://vlr.gg/player/10728/xray,2024-11-09 11:00:00,0.64,0.34,0.40,116,122,115,6,1,5,15,3,12,5,2,3,-4,-1,-3,47%,67%,42%,76,113,67,32%,17%,38%,0,0,0,4,1,3
115,https://vlr.gg/player/5203/bati,2024-11-09 11:00:00,1.83,1.97,1.85,320,317,337,19,15,4,7,6,1,6,3,3,0,0,0,93%,92%,100%,200,200,202,18%,20%,13%,0,0,0,0,0,0
116,https://vlr.gg/player/9943/mezoky,2024-11-09 11:00:00,1.51,2.32,1.67,312,293,391,16,12,4,7,6,1,4,3,1,+3,+2,+1,93%,92%,100%,193,179,250,47%,54%,33%,3,2,1,0,0,0
117,https://vlr.gg/player/22617/vitie,2024-11-09 11:00:00,1.36,2.24,1.53,229,212,297,14,10,4,6,5,1,10,7,3,0,0,0,93%,92%,100%,120,117,131,48%,47%,50%,1,1,0,1,1,0
118,https://vlr.gg/player/24426/w1ll,2024-11-09 11:00:00,1.22,0.87,1.15,190,215,95,12,11,1,6,5,1,1,1,0,+3,+3,0,80%,83%,67%,115,128,66,23%,30%,0%,3,3,0,0,0,0
119,https://vlr.gg/player/34002/lukey,2024-11-09 11:00:00,0.90,0.68,0.85,227,236,195,12,10,2,11,8,3,5,4,1,+1,-1,+2,87%,83%,100%,140,146,113,25%,29%,0%,4,2,2,3,3,0
120,https://vlr.gg/player/11332/ara,2024-11-09 11:00:00,0.61,1.65,1.13,257,221,294,21,8,13,19,12,7,7,3,4,+2,-1,+3,71%,50%,92%,156,133,178,32%,23%,38%,6,2,4,4,3,1
121,https://vlr.gg/player/29634/cintyx,2024-11-09 11:00:00,0.55,1.39,0.97,188,140,236,14,5,9,18,11,7,13,6,7,-1,-1,0,75%,58%,92%,141,101,181,16%,13%,17%,2,1,1,3,2,1
122,https://vlr.gg/player/32345/snaptor,2024-11-09 11:00:00,0.79,1.08,0.93,203,211,195,18,9,9,17,10,7,5,2,3,+1,+1,0,83%,75%,92%,126,122,130,23%,17%,29%,1,1,0,0,0,0
123,https://vlr.gg/player/38840/lamelly,2024-11-09 11:00:00,0.90,0.92,0.91,160,167,154,12,7,5,18,11,7,15,7,8,-1,0,-1,83%,83%,83%,104,107,102,19%,30%,13%,1,0,1,2,0,2
124,https://vlr.gg/player/33292/martux,2024-11-09 11:00:00,0.80,0.73,0.77,191,219,164,16,9,7,18,10,8,3,0,3,+1,+1,0,63%,58%,67%,113,124,102,19%,25%,10%,3,2,1,2,1,1
125,https://vlr.gg/player/39103/waken,2024-11-09 11:00:00,1.28,1.92,1.60,269,264,276,25,11,14,14,9,5,5,2,3,-3,0,-3,75%,67%,83%,177,173,181,29%,31%,27%,2,2,0,5,2,3
126,https://vlr.gg/player/33358/shinnok,2024-11-09 11:00:00,1.13,1.00,1.07,219,228,210,18,10,8,16,8,8,9,1,8,+3,+1,+2,79%,83%,75%,156,158,154,42%,42%,43%,3,1,2,0,0,0
127,https://vlr.gg/player/42458/bravo,2024-11-09 11:00:00,0.54,1.56,1.05,176,75,278,14,2,12,15,8,7,12,5,7,+1,-1,+2,83%,75%,92%,105,46,163,13%,8%,14%,2,0,2,1,1,0
128,https://vlr.gg/player/36402/kubfu,2024-11-09 11:00:00,0.75,1.13,0.94,190,118,263,17,5,12,16,7,9,5,1,4,-2,-2,0,79%,67%,92%,130,97,162,23%,31%,19%,1,0,1,3,2,1
129,https://vlr.gg/player/44922/golack,2024-11-09 11:00:00,0.73,0.61,0.67,197,201,193,16,8,8,20,11,9,3,1,2,-1,0,-1,83%,75%,92%,133,139,127,17%,12%,24%,3,2,1,4,2,2
130,https://vlr.gg/player/10501/furiouzmeow,2024-11-09 11:00:00,0.75,1.55,1.15,221,165,278,22,8,14,21,11,10,9,7,2,+1,-2,+3,85%,85%,85%,154,112,195,21%,17%,24%,4,1,3,3,3,0
131,https://vlr.gg/player/42632/darksy,2024-11-09 11:00:00,0.91,1.23,1.07,186,144,229,19,7,12,15,8,7,8,5,3,+1,0,+1,81%,69%,92%,135,101,168,32%,27%,34%,1,0,1,0,0,0
132,https://vlr.gg/player/22469/sm1le,2024-11-09 11:00:00,1.26,0.79,1.03,241,287,196,20,12,8,20,10,10,4,3,1,+2,+1,+1,69%,69%,69%,150,180,121,21%,29%,11%,6,4,2,4,3,1
133,https://vlr.gg/player/42634/rawn3n,2024-11-09 11:00:00,1.14,0.67,0.91,203,199,209,17,10,7,22,10,12,7,3,4,-3,-2,-1,73%,85%,62%,145,147,143,25%,41%,16%,1,0,1,4,2,2
134,https://vlr.gg/player/32616/fe11xx,2024-11-09 11:00:00,0.89,0.71,0.80,164,156,174,14,6,8,20,9,11,6,4,2,+1,0,+1,62%,69%,54%,115,114,116,16%,9%,23%,2,0,2,1,0,1
135,https://vlr.gg/player/15237/lolb0om,2024-11-09 11:00:00,1.60,1.38,1.49,297,328,266,28,16,12,17,9,8,3,2,1,0,-2,+2,69%,77%,62%,181,211,152,33%,36%,29%,4,0,4,4,2,2
136,https://vlr.gg/player/29043/spartah,2024-11-09 11:00:00,0.90,1.39,1.15,238,221,257,24,11,13,16,9,7,1,1,0,-1,-2,+1,65%,54%,77%,156,149,162,45%,43%,46%,2,1,1,3,3,0
137,https://vlr.gg/player/15167/mcnuggets,2024-11-09 11:00:00,1.04,0.86,0.95,195,210,180,18,10,8,18,9,9,5,1,4,0,0,0,81%,69%,92%,130,133,126,16%,20%,11%,4,2,2,4,2,2
138,https://vlr.gg/player/11358/karokis,2024-11-09 11:00:00,0.70,0.79,0.74,197,187,208,17,8,9,21,11,10,9,3,6,0,-1,+1,85%,77%,92%,116,104,128,16%,14%,17%,1,0,1,1,1,0
139,https://vlr.gg/player/15183/doobs,2024-11-09 11:00:00,0.39,0.76,0.57,139,137,142,11,5,6,20,11,9,10,5,5,-1,0,-1,65%,54%,77%,100,97,103,24%,23%,25%,1,1,0,2,1,1
140,https://vlr.gg/player/24149/amy,2024-11-09 09:10:00,0.96,1.22,1.10,211,177,241,50,22,28,42,19,23,14,3,11,+4,+1,+3,75%,71%,78%,149,116,177,32%,30%,33%,7,3,4,3,2,1
141,https://vlr.gg/player/20064/vania,2024-11-09 09:10:00,1.07,0.93,1.00,171,189,158,44,22,22,42,21,21,23,14,9,+3,+1,+2,75%,77%,72%,113,118,108,52%,59%,47%,4,2,2,1,1,0
142,https://vlr.gg/player/17320/petra,2024-11-09 09:10:00,1.08,0.85,0.96,216,254,182,50,26,24,51,25,26,15,7,8,+2,0,+2,67%,77%,58%,141,172,114,28%,28%,27%,8,2,6,6,2,4
143,https://vlr.gg/player/36175/rezq,2024-11-09 09:10:00,1.10,0.73,0.90,221,255,199,52,28,24,51,22,29,16,6,10,+2,+1,+1,64%,65%,64%,141,159,125,22%,26%,19%,14,7,7,12,6,6
144,https://vlr.gg/player/17323/mimi,2024-11-09 09:10:00,0.66,0.77,0.72,131,118,145,29,12,17,45,22,23,25,13,12,0,0,0,67%,71%,64%,87,70,101,36%,28%,44%,6,3,3,6,3,3
145,https://vlr.gg/player/21558/micaela,2024-11-09 09:10:00,1.22,1.12,1.18,218,243,194,53,30,23,44,24,20,29,15,14,+1,0,+1,69%,75%,61%,135,150,117,32%,37%,25%,5,3,2,4,3,1
146,https://vlr.gg/player/11235/biazik,2024-11-09 09:10:00,1.03,1.31,1.16,215,160,274,46,19,27,43,21,22,26,13,13,-5,-2,-3,72%,72%,71%,152,115,196,31%,28%,33%,3,2,1,8,4,4
147,https://vlr.gg/player/25663/dods,2024-11-09 09:10:00,1.14,1.09,1.12,240,235,240,58,30,28,47,24,23,12,7,5,-1,0,-1,64%,72%,55%,150,151,150,37%,40%,35%,15,8,7,16,8,8
148,https://vlr.gg/player/11259/conir,2024-11-09 09:10:00,0.96,0.78,0.88,171,183,165,37,22,15,47,24,23,28,16,12,-4,-4,0,73%,69%,77%,116,118,113,32%,36%,27%,3,1,2,7,5,2
149,https://vlr.gg/player/18982/romily,2024-11-09 09:10:00,0.93,0.74,0.84,150,167,135,37,21,16,44,22,22,9,5,4,-2,-2,0,72%,72%,71%,104,113,94,29%,28%,30%,2,0,2,4,2,2
150,https://vlr.gg/player/28480/marky,2024-11-09 09:00:00,0.64,2.21,1.42,290,148,434,25,6,19,17,11,6,10,3,7,+1,-3,+4,73%,62%,85%,187,105,269,10%,17%,7%,6,0,6,5,3,2
151,https://vlr.gg/player/12308/mista,2024-11-09 09:00:00,1.08,1.09,1.08,211,241,183,20,10,10,20,11,9,6,2,4,+2,+1,+1,65%,46%,85%,138,153,122,44%,50%,37%,5,3,2,3,2,1
152,https://vlr.gg/player/6271/haxzorus,2024-11-09 09:00:00,0.84,1.09,0.97,157,171,145,15,7,8,17,11,6,10,6,4,0,0,0,73%,62%,85%,104,104,103,27%,20%,39%,1,1,0,1,1,0
153,https://vlr.gg/player/30456/nass,2024-11-09 09:00:00,0.62,0.94,0.78,145,156,135,15,7,8,17,10,7,5,2,3,-2,-2,0,54%,62%,46%,95,93,97,28%,26%,30%,0,0,0,2,2,0
154,https://vlr.gg/player/22310/stike,2024-11-09 09:00:00,0.22,0.95,0.58,119,71,167,9,3,6,22,13,9,8,1,7,-1,-1,0,50%,31%,69%,86,47,125,27%,18%,32%,1,0,1,2,1,1
155,https://vlr.gg/player/34002/lukey,2024-11-09 09:00:00,0.84,1.80,1.32,299,193,405,29,9,20,19,11,8,3,1,2,+5,+1,+4,69%,62%,77%,190,135,245,25%,30%,22%,7,3,4,2,2,0
156,https://vlr.gg/player/22617/vitie,2024-11-09 09:00:00,0.92,1.73,1.32,279,251,307,24,11,13,16,10,6,8,0,8,+2,0,+2,81%,69%,92%,183,167,200,30%,33%,27%,2,0,2,0,0,0
157,https://vlr.gg/player/9943/mezoky,2024-11-09 09:00:00,0.43,1.38,0.91,161,97,226,15,3,12,15,10,5,9,6,3,-4,-4,0,73%,62%,85%,112,80,144,18%,29%,13%,2,0,2,6,4,2
158,https://vlr.gg/player/5203/bati,2024-11-09 09:00:00,0.83,0.85,0.84,170,191,151,14,8,6,18,11,7,11,4,7,-3,-2,-1,69%,62%,77%,115,125,105,24%,18%,30%,2,1,1,5,3,2
159,https://vlr.gg/player/24426/w1ll,2024-11-09 09:00:00,0.77,0.84,0.81,110,109,113,11,6,5,16,9,7,11,1,10,0,0,0,65%,46%,85%,68,56,80,8%,0%,16%,0,0,0,0,0,0
160,https://vlr.gg/player/42651/avey,2024-11-09 09:00:00,2.08,1.90,2.05,415,412,439,21,18,3,7,6,1,5,3,2,+4,+2,+2,79%,75%,100%,263,260,280,24%,26%,13%,5,3,2,1,1,0
161,https://vlr.gg/player/28479/jkg,2024-11-09 09:00:00,1.45,3.08,1.68,229,194,443,13,10,3,4,4,0,6,3,3,+1,+1,0,93%,92%,100%,157,134,293,38%,38%,40%,1,1,0,0,0,0
162,https://vlr.gg/player/45836/corsa,2024-11-09 09:00:00,1.63,1.93,1.68,292,311,187,14,12,2,7,7,0,5,5,0,-1,-1,0,93%,92%,100%,202,214,133,28%,28%,29%,0,0,0,1,1,0
163,https://vlr.gg/player/42650/mally,2024-11-09 09:00:00,1.28,1.36,1.29,204,196,255,11,9,2,6,5,1,8,5,3,+3,+3,0,100%,100%,100%,115,116,109,27%,31%,14%,3,3,0,0,0,0
164,https://vlr.gg/player/1472/falltw,2024-11-09 09:00:00,0.49,0.23,0.45,90,106,,5,5,0,9,8,1,1,1,0,-3,-3,0,50%,50%,50%,52,61,,10%,10%,,0,0,0,3,3,0
165,https://vlr.gg/player/11358/karokis,2024-11-09 09:00:00,0.29,1.02,0.91,255,40,292,12,0,12,13,2,11,3,1,2,-2,0,-2,57%,50%,58%,135,28,153,55%,0%,58%,1,0,1,3,0,3
166,https://vlr.gg/player/15183/doobs,2024-11-09 09:00:00,0.02,0.78,0.64,135,,158,7,0,7,12,2,10,0,0,0,0,-1,+1,50%,50%,50%,92,,108,41%,,41%,1,0,1,1,1,0
167,https://vlr.gg/player/15237/lolb0om,2024-11-09 09:00:00,1.61,0.38,0.55,138,371,100,6,2,4,12,2,10,0,0,0,0,0,0,57%,50%,58%,90,233,66,38%,40%,38%,1,0,1,1,0,1
168,https://vlr.gg/player/15167/mcnuggets,2024-11-09 09:00:00,0.01,0.50,0.38,162,51,181,5,0,5,14,2,12,5,0,5,0,-1,+1,43%,,50%,121,51,133,26%,0%,27%,2,0,2,2,1,1
169,https://vlr.gg/player/29043/spartah,2024-11-09 09:00:00,0.58,0.30,0.34,98,130,93,3,1,2,13,2,11,1,0,1,-2,0,-2,36%,50%,33%,83,98,80,31%,50%,29%,0,0,0,2,0,2
170,https://vlr.gg/player/12519/ticey,2024-11-09 09:00:00,1.61,2.32,1.84,364,335,422,23,15,8,12,10,2,5,3,2,+5,+2,+3,94%,92%,100%,245,210,315,8%,9%,5%,7,4,3,2,2,0
171,https://vlr.gg/player/24428/harambe,2024-11-09 09:00:00,1.30,1.54,1.38,238,241,234,16,11,5,10,8,2,7,4,3,0,-1,+1,89%,83%,100%,158,172,129,20%,18%,25%,1,0,1,1,1,0
172,https://vlr.gg/player/31298/luca,2024-11-09 09:00:00,1.18,0.98,1.11,134,172,60,11,9,2,8,7,1,1,1,0,0,0,0,67%,58%,83%,104,142,28,30%,33%,20%,1,1,0,1,1,0
173,https://vlr.gg/player/30901/ianto,2024-11-09 09:00:00,0.83,1.43,1.03,225,155,367,15,6,9,13,10,3,10,8,2,-4,-2,-2,78%,83%,67%,146,106,225,21%,16%,25%,0,0,0,4,2,2
174,https://vlr.gg/player/33994/creamydreamy,2024-11-09 09:00:00,0.67,1.14,0.83,182,185,177,10,6,4,13,11,2,9,8,1,-1,-1,0,67%,67%,67%,116,121,107,30%,33%,27%,0,0,0,1,1,0
175,https://vlr.gg/player/29630/porkychop,2024-11-09 09:00:00,0.54,1.38,1.10,276,184,323,15,3,12,15,6,9,8,0,8,+1,0,+1,83%,67%,92%,191,111,231,12%,4%,16%,2,1,1,1,1,0
176,https://vlr.gg/player/42371/t0ba,2024-11-09 09:00:00,0.71,1.23,1.06,243,176,277,16,3,13,16,6,10,4,1,3,0,0,0,72%,50%,83%,145,124,155,17%,17%,17%,2,0,2,2,0,2
177,https://vlr.gg/player/29628/famzzam,2024-11-09 09:00:00,0.44,0.85,0.71,132,102,147,9,2,7,14,6,8,3,1,2,+2,0,+2,61%,67%,58%,80,60,90,36%,50%,33%,3,1,2,1,1,0
178,https://vlr.gg/player/31350/deqadz,2024-11-09 09:00:00,0.62,0.76,0.71,168,130,188,9,1,8,15,5,10,8,3,5,-1,-2,+1,50%,33%,58%,119,118,119,15%,25%,13%,2,0,2,3,2,1
179,https://vlr.gg/player/12372/szoren,2024-11-09 09:00:00,0.04,0.58,0.39,85,35,111,5,1,4,16,6,10,8,0,8,-2,0,-2,67%,33%,83%,61,17,82,9%,0%,12%,0,0,0,2,0,2
180,https://vlr.gg/player/47270/darkwinjett,2024-11-09 09:00:00,1.73,1.41,1.57,298,361,238,61,36,25,33,19,14,13,7,6,+2,0,+2,80%,76%,83%,184,221,149,19%,22%,15%,11,6,5,9,6,3
181,https://vlr.gg/player/2540/happen,2024-11-09 09:00:00,0.87,1.40,1.13,211,166,262,45,16,29,38,21,17,17,7,10,+2,-1,+3,76%,69%,83%,146,125,166,18%,16%,20%,5,1,4,3,2,1
182,https://vlr.gg/player/3649/litshii,2024-11-09 09:00:00,0.98,1.16,1.07,196,166,215,42,18,24,37,19,18,20,8,12,+1,0,+1,75%,79%,70%,120,107,134,21%,24%,19%,3,0,3,2,0,2
183,https://vlr.gg/player/13238/shiio,2024-11-09 09:00:00,0.92,0.94,0.93,130,118,147,29,15,14,32,17,15,15,5,10,+1,-1,+2,68%,62%,73%,86,72,99,19%,17%,21%,4,2,2,3,3,0
184,https://vlr.gg/player/20032/treelover,2024-11-09 09:00:00,0.82,0.90,0.84,192,181,197,38,18,20,44,24,20,27,12,15,+1,-1,+2,73%,72%,73%,121,113,129,32%,44%,25%,10,4,6,9,5,4
185,https://vlr.gg/player/33392/zeikosha,2024-11-09 09:00:00,0.72,1.53,1.12,212,160,257,43,16,27,37,23,14,12,3,9,-2,-5,+3,66%,47%,86%,135,100,171,29%,24%,32%,6,2,4,8,7,1
186,https://vlr.gg/player/45834/aidan,2024-11-09 09:00:00,1.02,0.89,0.96,221,229,225,43,22,21,47,23,24,18,9,9,0,-4,+4,73%,73%,72%,150,157,143,24%,22%,27%,9,2,7,9,6,3
187,https://vlr.gg/player/4361/radenz,2024-11-09 09:00:00,0.90,0.97,0.93,170,148,205,39,18,21,42,21,21,16,7,9,-2,-2,0,66%,67%,66%,111,88,135,35%,52%,28%,3,2,1,5,4,1
188,https://vlr.gg/player/44548/nomiss,2024-11-09 09:00:00,0.93,0.73,0.81,141,144,145,28,14,14,43,21,22,28,15,13,+1,+1,0,64%,67%,62%,94,99,88,25%,31%,20%,4,2,2,3,1,2
189,https://vlr.gg/player/24831/complexit,2024-11-09 09:00:00,0.67,0.71,0.69,157,136,178,31,14,17,46,24,22,10,4,6,-4,0,-4,64%,63%,66%,114,100,129,26%,23%,29%,4,2,2,8,2,6
190,https://vlr.gg/player/26632/joliinaa,2024-11-09 07:00:00,1.37,0.91,1.09,197,213,191,29,13,16,29,9,20,13,8,5,-1,0,-1,65%,69%,63%,129,140,122,21%,24%,18%,3,1,2,4,1,3
191,https://vlr.gg/player/17343/ness,2024-11-09 07:00:00,1.17,0.73,0.91,170,209,149,25,13,12,31,11,20,7,4,3,-1,-1,0,63%,75%,54%,123,142,110,27%,21%,30%,2,0,2,3,1,2
192,https://vlr.gg/player/24101/miyori,2024-11-09 07:00:00,0.71,0.98,0.87,209,174,243,29,9,20,35,13,22,11,5,6,-2,-1,-1,70%,63%,75%,136,113,152,28%,21%,33%,4,2,2,6,3,3
193,https://vlr.gg/player/16418/smurfette,2024-11-09 07:00:00,0.77,0.79,0.77,219,222,210,27,12,15,34,13,21,9,4,5,0,-2,+2,60%,69%,54%,144,148,142,35%,41%,32%,6,2,4,6,4,2
194,https://vlr.gg/player/24107/sarah,2024-11-09 07:00:00,1.05,0.20,0.54,134,197,91,17,11,6,36,13,23,22,13,9,+2,+2,0,55%,88%,33%,75,102,56,25%,38%,14%,4,2,2,2,0,2
195,https://vlr.gg/player/19791/mel,2024-11-09 07:00:00,1.35,1.53,1.42,239,210,260,35,20,15,20,11,9,15,6,9,-6,-5,-1,85%,79%,94%,157,146,174,27%,33%,20%,0,0,0,6,5,1
196,https://vlr.gg/player/11239/sayuri,2024-11-09 07:00:00,1.13,1.29,1.19,184,177,209,30,17,13,24,13,11,20,14,6,+2,+1,+1,83%,88%,75%,120,106,139,28%,21%,39%,2,1,1,0,0,0
197,https://vlr.gg/player/31574/srn,2024-11-09 07:00:00,1.26,1.00,1.16,282,302,230,37,24,13,31,18,13,13,9,4,+7,+4,+3,78%,79%,75%,174,198,137,32%,33%,29%,15,8,7,8,4,4
198,https://vlr.gg/player/14685/jubs,2024-11-09 07:00:00,1.35,0.76,1.12,219,220,209,31,20,11,25,12,13,12,10,2,-1,0,-1,78%,79%,75%,146,153,135,28%,21%,39%,1,1,0,2,1,1
199,https://vlr.gg/player/21435/jelly,2024-11-09 07:00:00,1.46,0.59,1.11,217,276,141,32,25,7,28,16,12,9,5,4,0,0,0,73%,79%,63%,158,188,114,37%,43%,24%,3,2,1,3,2,1
200,https://vlr.gg/player/7783/zhar,2024-11-09 06:30:00,0.95,0.85,0.89,163,160,170,19,8,11,26,9,17,11,8,3,0,-2,+2,71%,80%,63%,104,104,104,26%,38%,19%,3,0,3,3,2,1
201,https://vlr.gg/player/7046/no1syboy,2024-11-09 06:30:00,1.19,0.55,0.84,200,252,165,25,15,10,29,10,19,2,2,0,+2,+3,-1,62%,80%,47%,128,150,110,23%,27%,21%,3,3,0,1,0,1
202,https://vlr.gg/player/7802/flynch,2024-11-09 06:30:00,0.95,0.33,0.58,164,233,104,17,12,5,31,12,19,7,4,3,+2,+3,-1,53%,73%,37%,112,152,80,35%,42%,22%,8,6,2,6,3,3
203,https://vlr.gg/player/7047/vascalizz,2024-11-09 06:30:00,0.80,0.36,0.56,131,114,139,14,6,8,29,10,19,13,8,5,0,0,0,65%,73%,58%,89,94,85,24%,29%,20%,2,0,2,2,0,2
204,https://vlr.gg/player/4867/onigiri,2024-11-09 06:30:00,0.64,0.43,0.52,141,168,126,17,9,8,31,12,19,3,1,2,-4,-1,-3,50%,60%,42%,94,106,85,27%,60%,15%,1,0,1,5,1,4
205,https://vlr.gg/player/4872/frostmind,2024-11-09 06:30:00,1.76,1.39,1.60,275,255,298,33,18,15,14,4,10,18,13,5,+1,+2,-1,85%,100%,67%,182,171,194,42%,47%,36%,3,2,1,2,0,2
206,https://vlr.gg/player/9290/madelyn,2024-11-09 06:30:00,1.87,1.20,1.58,246,303,161,30,20,10,15,8,7,20,15,5,-1,+1,-2,88%,95%,80%,148,194,90,26%,28%,23%,3,3,0,4,2,2
207,https://vlr.gg/player/10749/k1ngkappa,2024-11-09 06:30:00,1.72,1.06,1.43,225,272,157,31,22,9,15,5,10,4,1,3,0,-2,+2,79%,89%,67%,150,188,101,36%,28%,63%,3,0,3,3,2,1
208,https://vlr.gg/player/26829/damaraa,2024-11-09 06:30:00,1.10,1.16,1.13,288,303,278,35,21,14,27,15,12,11,5,6,+2,+3,-1,74%,79%,67%,170,174,164,30%,31%,28%,8,6,2,6,3,3
209,https://vlr.gg/player/9263/sayoo,2024-11-09 06:30:00,1.06,0.72,0.90,145,164,126,17,12,5,21,10,11,16,12,4,-2,-1,-1,76%,89%,60%,94,94,93,30%,36%,23%,0,0,0,2,1,1
210,https://vlr.gg/player/11218/yuicaw,2024-11-09 04:00:00,,,,265,,,63,,,47,,,40,,,,,,,,,,,,,,,,,,,,
211,https://vlr.gg/player/14125/spring,2024-11-09 04:00:00,,,,209,,,50,,,50,,,16,,,,,,,,,,,,,,,,,,,,
212,https://vlr.gg/player/7849/siufatbb,2024-11-09 04:00:00,,,,205,,,54,,,35,,,19,,,,,,,,,,,,,,,,,,,,
213,https://vlr.gg/player/37489/lysoar,2024-11-09 04:00:00,,,,190,,,52,,,48,,,9,,,,,,,,,,,,,,,,,,,,
214,https://vlr.gg/player/45104/v1ya,2024-11-09 04:00:00,,,,174,,,43,,,49,,,33,,,,,,,,,,,,,,,,,,,,
215,https://vlr.gg/player/6022/yosemite,2024-11-09 04:00:00,,,,223,,,53,,,52,,,20,,,,,,,,,,,,,,,,,,,,
216,https://vlr.gg/player/3028/life,2024-11-09 04:00:00,,,,202,,,53,,,58,,,9,,,,,,,,,,,,,,,,,,,,
217,https://vlr.gg/player/19530/aaaay,2024-11-09 04:00:00,,,,176,,,45,,,53,,,22,,,,,,,,,,,,,,,,,,,,
218,https://vlr.gg/player/872/autumn,2024-11-09 04:00:00,,,,156,,,41,,,53,,,19,,,,,,,,,,,,,,,,,,,,
219,https://vlr.gg/player/7857/berlin,2024-11-09 04:00:00,,,,139,,,32,,,46,,,21,,,,,,,,,,,,,,,,,,,,
220,https://vlr.gg/player/13744/patmen,2024-11-09 03:50:00,1.46,1.56,1.51,313,338,293,43,22,21,24,13,11,9,4,5,+1,+3,-2,86%,83%,89%,193,207,181,35%,37%,32%,8,6,2,7,3,4
221,https://vlr.gg/player/21677/jeee,2024-11-09 03:50:00,1.49,1.10,1.29,228,268,188,31,17,14,22,11,11,24,16,8,-2,-1,-1,89%,94%,84%,147,161,134,23%,24%,23%,1,0,1,3,1,2
222,https://vlr.gg/player/9737/kakarot,2024-11-09 03:50:00,1.29,1.16,1.23,232,250,211,31,17,14,22,11,11,13,6,7,+3,+3,0,84%,89%,79%,145,152,137,29%,52%,17%,4,3,1,1,0,1
223,https://vlr.gg/player/7746/kevzii,2024-11-09 03:50:00,1.04,1.33,1.19,217,191,244,27,12,15,20,9,11,12,5,7,+3,0,+3,81%,78%,84%,152,126,177,25%,24%,26%,4,1,3,1,1,0
224,https://vlr.gg/player/16953/zynd,2024-11-09 03:50:00,0.80,1.05,0.93,175,142,204,27,12,15,23,11,12,3,1,2,-4,-3,-1,70%,67%,74%,113,103,124,36%,41%,32%,2,0,2,6,3,3
225,https://vlr.gg/player/11578/hotsauz,2024-11-09 03:50:00,1.01,1.23,1.12,236,201,276,31,13,18,31,15,16,7,5,2,+5,+3,+2,65%,63%,67%,161,131,192,34%,30%,38%,5,3,2,0,0,0
226,https://vlr.gg/player/44251/dignified,2024-11-09 03:50:00,0.86,1.07,0.96,197,206,188,27,15,12,30,17,13,9,3,6,-1,-1,0,73%,79%,67%,127,131,123,23%,30%,18%,2,1,1,3,2,1
227,https://vlr.gg/player/9745/georggyyy,2024-11-09 03:50:00,1.02,0.49,0.76,189,241,133,22,14,8,33,16,17,9,6,3,-4,0,-4,65%,63%,67%,128,166,87,18%,19%,17%,4,3,1,8,3,5
228,https://vlr.gg/player/35965/yukxx,2024-11-09 03:50:00,0.41,0.77,0.59,125,96,155,15,6,9,32,16,16,15,9,6,-4,-3,-1,65%,63%,67%,80,60,101,24%,18%,27%,1,1,0,5,4,1
229,https://vlr.gg/player/10203/tesseract,2024-11-09 03:50:00,0.63,0.35,0.50,138,137,139,16,8,8,33,15,18,11,7,4,+3,+2,+1,59%,68%,50%,84,88,79,24%,37%,14%,6,2,4,3,0,3
230,https://vlr.gg/player/11666/ray4c,2024-11-09 01:50:00,0.96,1.20,1.07,260,270,248,59,33,26,52,31,21,26,13,13,+7,+6,+1,75%,70%,80%,155,160,150,16%,13%,21%,14,10,4,7,4,3
231,https://vlr.gg/player/7807/valdyn,2024-11-09 01:50:00,1.04,1.08,1.06,211,179,253,52,25,27,48,22,26,25,15,10,+2,-1,+3,81%,78%,83%,132,113,155,27%,27%,28%,6,2,4,4,3,1
232,https://vlr.gg/player/16852/nakya,2024-11-09 01:50:00,1.04,1.07,1.05,209,215,212,51,29,22,45,24,21,17,7,10,0,+1,-1,73%,76%,70%,143,147,138,27%,31%,22%,8,5,3,8,4,4
233,https://vlr.gg/player/2346/cud,2024-11-09 01:50:00,1.14,0.94,1.05,187,201,168,46,28,18,41,24,17,16,7,9,+3,+1,+2,76%,78%,73%,132,147,114,38%,34%,43%,6,3,3,3,2,1
234,https://vlr.gg/player/23710/gotten,2024-11-09 01:50:00,1.13,0.84,1.00,202,218,175,44,28,16,50,26,24,46,25,21,-3,+4,-7,82%,84%,80%,130,138,120,33%,33%,34%,4,4,0,7,0,7
235,https://vlr.gg/player/10749/k1ngkappa,2024-11-09 01:50:00,1.25,1.24,1.24,261,239,279,61,27,34,49,20,29,20,10,10,0,+1,-1,69%,67%,70%,179,165,191,32%,27%,36%,7,3,4,7,2,5
236,https://vlr.gg/player/4872/frostmind,2024-11-09 01:50:00,1.27,1.05,1.15,205,259,166,46,27,19,51,24,27,39,13,26,0,+1,-1,75%,77%,73%,132,160,110,41%,40%,43%,5,3,2,5,2,3
237,https://vlr.gg/player/9290/madelyn,2024-11-09 01:50:00,0.95,1.12,1.05,189,164,204,43,16,27,45,19,26,30,14,16,0,+1,-1,72%,83%,62%,118,96,136,21%,21%,20%,4,2,2,4,1,3
238,https://vlr.gg/player/9263/sayoo,2024-11-09 01:50:00,0.90,0.88,0.89,173,170,185,42,19,23,50,21,29,26,12,14,-4,-3,-1,75%,73%,76%,120,117,122,29%,29%,29%,4,2,2,8,5,3
239,https://vlr.gg/player/26829/damaraa,2024-11-09 01:50:00,0.92,0.76,0.83,207,214,200,44,20,24,57,25,32,24,17,7,-5,+2,-7,66%,73%,59%,134,140,130,26%,30%,23%,9,6,3,14,4,10
240,https://vlr.gg/player/4874/berserx,2024-11-08 23:00:00,1.56,1.80,1.70,303,266,313,46,17,29,16,8,8,7,1,6,+1,-1,+2,83%,71%,91%,186,162,205,43%,56%,37%,5,1,4,4,2,2
241,https://vlr.gg/player/16215/dos9,2024-11-08 23:00:00,1.07,1.32,1.22,208,189,222,30,11,19,22,10,12,25,11,14,+1,-1,+2,85%,76%,91%,136,123,146,18%,17%,18%,2,0,2,1,1,0
242,https://vlr.gg/player/9717/lilo,2024-11-08 23:00:00,1.21,1.15,1.18,247,256,249,36,14,22,27,13,14,10,3,7,+5,+2,+3,78%,76%,78%,156,164,151,26%,42%,18%,9,4,5,4,2,2
243,https://vlr.gg/player/10739/shiro,2024-11-08 23:00:00,0.93,1.35,1.17,230,173,261,30,10,20,26,12,14,22,5,17,+1,0,+1,80%,65%,91%,151,128,168,23%,29%,19%,4,2,2,3,2,1
244,https://vlr.gg/player/7043/ncslasher,2024-11-08 23:00:00,0.88,0.98,0.94,147,133,159,22,9,13,25,12,13,20,9,11,-2,-3,+1,78%,76%,78%,97,83,107,18%,26%,13%,3,0,3,5,3,2
245,https://vlr.gg/player/7047/vascalizz,2024-11-08 23:00:00,0.77,1.28,0.98,199,182,234,28,15,13,33,22,11,11,4,7,0,-1,+1,65%,70%,59%,129,107,158,22%,20%,23%,5,1,4,5,2,3
246,https://vlr.gg/player/7802/flynch,2024-11-08 23:00:00,0.80,1.04,0.90,202,194,211,26,14,12,32,20,12,5,3,2,-2,-4,+2,65%,61%,71%,125,125,124,29%,27%,31%,5,3,2,7,7,0
247,https://vlr.gg/player/4867/onigiri,2024-11-08 23:00:00,0.42,1.13,0.72,152,126,196,21,8,13,33,23,10,13,6,7,-2,-3,+1,60%,52%,71%,99,84,120,38%,33%,41%,3,1,2,5,4,1
248,https://vlr.gg/player/7783/zhar,2024-11-08 23:00:00,0.84,0.54,0.70,156,173,129,21,13,8,32,18,14,15,7,8,-1,0,-1,53%,57%,47%,100,105,93,22%,18%,28%,2,1,1,3,1,2
249,https://vlr.gg/player/7046/no1syboy,2024-11-08 23:00:00,0.79,0.54,0.69,154,154,157,20,11,9,34,20,14,20,15,5,-1,-1,0,70%,78%,59%,98,95,101,24%,27%,21%,2,1,1,3,2,1
250,https://vlr.gg/player/35361/lazy,2024-11-08 20:30:00,1.25,1.57,1.42,334,307,367,77,33,44,51,23,28,15,4,11,+12,+6,+6,73%,65%,80%,217,197,234,23%,21%,25%,19,10,9,7,4,3
251,https://vlr.gg/player/19288/core,2024-11-08 20:30:00,1.24,1.21,1.22,248,239,254,56,25,31,45,19,26,22,13,9,+4,+3,+1,80%,81%,80%,167,160,173,20%,23%,19%,8,4,4,4,1,3
252,https://vlr.gg/player/19291/bobovo,2024-11-08 20:30:00,1.18,0.79,0.97,168,205,138,40,24,16,40,18,22,22,10,12,-1,0,-1,73%,77%,69%,105,121,90,25%,29%,21%,6,4,2,7,4,3
253,https://vlr.gg/player/35360/kcep,2024-11-08 20:30:00,0.90,0.65,0.77,144,152,135,33,18,15,47,19,28,22,10,12,-1,-4,+3,68%,77%,60%,95,105,86,27%,30%,24%,5,0,5,6,4,2
254,https://vlr.gg/player/39629/zuk,2024-11-08 20:30:00,0.67,0.66,0.66,145,127,152,30,12,18,47,20,27,15,7,8,-2,0,-2,67%,65%,69%,94,86,101,23%,27%,20%,1,0,1,3,0,3
255,https://vlr.gg/player/9063/infiltrator,2024-11-08 20:30:00,1.48,1.31,1.40,309,324,260,69,40,29,47,24,23,9,6,3,-1,0,-1,70%,74%,65%,185,207,160,31%,34%,23%,13,7,6,14,7,7
256,https://vlr.gg/player/765/jerk,2024-11-08 20:30:00,0.92,1.05,0.98,166,163,175,40,22,18,45,25,20,21,9,12,-2,-3,+1,70%,71%,68%,117,110,124,23%,19%,28%,2,1,1,4,4,0
257,https://vlr.gg/player/9017/moobs,2024-11-08 20:30:00,1.07,0.86,0.97,210,232,192,47,26,21,48,25,23,19,16,3,-1,0,-1,65%,77%,52%,134,146,120,25%,24%,28%,8,5,3,9,5,4
258,https://vlr.gg/player/9837/flare,2024-11-08 20:30:00,1.05,0.70,0.88,174,200,145,39,26,13,47,24,23,25,12,13,-6,-1,-5,70%,77%,61%,114,125,103,23%,19%,26%,2,1,1,8,2,6
259,https://vlr.gg/player/17865/nahsie,2024-11-08 20:30:00,0.84,0.87,0.85,168,157,190,35,17,18,49,26,23,33,21,12,-2,-3,+1,73%,74%,71%,120,116,124,13%,16%,11%,2,0,2,4,3,1
260,https://vlr.gg/player/53/inspire,2024-11-08 18:00:00,1.69,1.01,1.27,220,278,185,32,18,14,18,6,12,9,3,6,+3,+4,-1,85%,100%,75%,139,171,120,31%,39%,24%,5,4,1,2,0,2
261,https://vlr.gg/player/21778/p0ppin,2024-11-08 18:00:00,1.21,1.25,1.23,242,210,265,35,11,24,24,9,15,11,5,6,-1,-1,0,77%,80%,75%,162,122,187,36%,21%,46%,6,2,4,7,3,4
262,https://vlr.gg/player/35302/eggsterr,2024-11-08 18:00:00,1.59,0.97,1.21,237,284,207,34,16,18,26,9,17,17,9,8,+1,0,+1,82%,87%,79%,155,171,144,31%,42%,24%,3,1,2,2,1,1
263,https://vlr.gg/player/41798/nightz,2024-11-08 18:00:00,1.08,1.27,1.20,234,202,255,32,10,22,29,11,18,24,10,14,0,+1,-1,82%,87%,79%,148,130,159,44%,29%,55%,2,2,0,2,1,1
264,https://vlr.gg/player/36560/canezerra,2024-11-08 18:00:00,0.82,1.07,0.98,228,217,235,30,11,19,31,14,17,12,7,5,0,-1,+1,69%,73%,67%,146,132,155,24%,18%,29%,5,0,5,5,1,4
265,https://vlr.gg/player/5035/blahst,2024-11-08 18:00:00,1.69,1.04,1.44,272,335,172,37,28,9,29,17,12,9,2,7,+2,+1,+1,82%,83%,80%,168,203,110,35%,39%,26%,2,1,1,0,0,0
266,https://vlr.gg/player/17751/tim,2024-11-08 18:00:00,1.07,1.25,1.14,245,215,293,31,16,15,32,18,14,18,14,4,-1,-1,0,77%,83%,67%,157,134,193,31%,29%,33%,4,3,1,5,4,1
267,https://vlr.gg/player/20922/zekei,2024-11-08 18:00:00,0.71,0.55,0.65,193,185,204,26,16,10,34,20,14,4,1,3,0,+1,-1,64%,58%,73%,127,125,132,26%,28%,25%,10,6,4,10,5,5
268,https://vlr.gg/player/28870/k0rupt,2024-11-08 18:00:00,0.54,0.58,0.54,129,117,153,14,7,7,34,20,14,21,12,9,-1,-1,0,67%,71%,60%,84,82,87,19%,21%,18%,1,1,0,2,2,0
269,https://vlr.gg/player/36036/practo,2024-11-08 18:00:00,0.51,0.57,0.53,159,148,176,20,13,7,35,22,13,10,5,5,-3,0,-3,69%,71%,67%,107,99,119,24%,23%,28%,1,1,0,4,1,3
270,https://vlr.gg/player/28892/muddy,2024-11-08 18:00:00,1.52,1.11,1.31,261,301,218,45,26,19,33,15,18,12,5,7,+3,+2,+1,76%,80%,72%,171,196,145,35%,35%,35%,5,3,2,2,1,1
271,https://vlr.gg/player/41550/zaj,2024-11-08 18:00:00,1.38,1.03,1.20,275,318,236,49,29,20,39,18,21,13,3,10,+2,-1,+3,68%,72%,64%,181,209,154,34%,34%,33%,10,5,5,8,6,2
272,https://vlr.gg/player/42064/hieu,2024-11-08 18:00:00,0.60,1.09,0.84,215,155,275,37,12,25,40,19,21,12,7,5,-1,-1,0,68%,64%,72%,138,105,171,37%,34%,39%,7,3,4,8,4,4
273,https://vlr.gg/player/29685/sambae,2024-11-08 18:00:00,0.80,0.84,0.82,151,131,172,25,10,15,35,16,19,11,5,6,0,+2,-2,64%,68%,60%,102,85,119,41%,38%,44%,3,2,1,3,0,3
274,https://vlr.gg/player/39240/exile,2024-11-08 18:00:00,0.71,0.82,0.77,144,125,163,23,11,12,37,17,20,28,8,20,0,+1,-1,70%,64%,76%,104,94,113,33%,31%,35%,2,1,1,2,0,2
275,https://vlr.gg/player/765/jerk,2024-11-08 18:00:00,1.53,0.97,1.25,212,256,168,40,25,15,29,14,15,11,7,4,+1,-1,+2,86%,84%,88%,138,163,112,27%,28%,26%,2,0,2,1,1,0
276,https://vlr.gg/player/9017/moobs,2024-11-08 18:00:00,1.34,1.02,1.18,221,246,201,39,24,15,33,16,17,13,2,11,+1,+1,0,70%,68%,72%,140,150,129,35%,36%,34%,7,4,3,6,3,3
277,https://vlr.gg/player/17865/nahsie,2024-11-08 18:00:00,0.75,1.20,0.97,209,202,214,35,16,19,39,21,18,27,13,14,-1,-1,0,78%,76%,80%,135,134,136,16%,11%,22%,4,2,2,5,3,2
278,https://vlr.gg/player/9063/infiltrator,2024-11-08 18:00:00,0.90,1.04,0.97,250,239,258,41,20,21,43,22,21,14,7,7,-2,+1,-3,60%,60%,60%,152,149,156,27%,24%,30%,10,6,4,12,5,7
279,https://vlr.gg/player/9837/flare,2024-11-08 18:00:00,0.74,0.94,0.84,169,154,183,29,14,15,35,18,17,22,11,11,-3,-1,-2,68%,72%,64%,102,98,107,15%,10%,21%,0,0,0,3,1,2
280,https://vlr.gg/player/9185/dodonut,2024-11-08 11:35:00,1.16,1.35,1.24,272,248,289,57,30,27,45,28,17,22,14,8,+8,0,+8,80%,79%,82%,172,169,177,22%,27%,17%,14,5,9,6,5,1
281,https://vlr.gg/player/33694/evv,2024-11-08 11:35:00,1.18,0.88,1.05,219,233,206,56,34,22,44,25,19,24,14,10,+3,+1,+2,80%,82%,79%,143,147,138,30%,32%,28%,7,3,4,4,2,2
282,https://vlr.gg/player/8329/starbound,2024-11-08 11:35:00,0.95,1.04,0.99,191,200,187,44,25,19,43,27,16,15,6,9,0,-2,+2,65%,66%,64%,120,121,118,19%,23%,14%,5,3,2,5,5,0
283,https://vlr.gg/player/17/theia,2024-11-08 11:35:00,0.80,0.99,0.88,168,154,206,42,22,20,46,28,18,19,9,10,+1,0,+1,70%,68%,71%,115,103,131,27%,31%,23%,5,3,2,4,3,1
284,https://vlr.gg/player/8849/sonder,2024-11-08 11:35:00,0.89,0.55,0.74,147,169,122,33,23,10,47,27,20,24,13,11,-2,-1,-1,79%,79%,79%,91,100,80,19%,20%,17%,7,4,3,9,5,4
285,https://vlr.gg/player/16621/alexy,2024-11-08 11:35:00,0.68,1.55,1.18,238,182,273,50,15,35,43,23,20,21,8,13,+2,-4,+6,68%,50%,82%,154,119,179,17%,13%,20%,11,3,8,9,7,2
286,https://vlr.gg/player/8492/tara,2024-11-08 11:35:00,0.66,1.23,0.99,190,115,239,43,10,33,46,19,27,26,13,13,0,-1,+1,67%,64%,68%,124,74,160,30%,21%,33%,4,2,2,4,3,1
287,https://vlr.gg/player/18091/shirazi,2024-11-08 11:35:00,1.22,0.83,0.99,183,239,152,43,24,19,45,19,26,24,6,18,-3,-1,-2,74%,75%,74%,128,162,104,27%,36%,20%,2,1,1,5,2,3
288,https://vlr.gg/player/18093/kamiyu,2024-11-08 11:35:00,1.14,0.87,0.98,190,184,196,41,17,24,46,17,29,18,5,13,-2,0,-2,64%,75%,55%,136,135,136,31%,36%,26%,3,0,3,5,0,5
289,https://vlr.gg/player/8176/enerii,2024-11-08 11:35:00,1.19,0.70,0.91,209,234,187,48,24,24,52,20,32,15,6,9,-7,-6,-1,58%,61%,55%,128,129,127,21%,25%,18%,8,2,6,15,8,7
290,https://vlr.gg/player/1909/jinny,2024-11-08 09:35:00,0.59,1.37,0.93,146,131,180,19,9,10,25,17,8,15,6,9,+2,0,+2,53%,42%,67%,97,82,117,41%,35%,47%,2,0,2,0,0,0
291,https://vlr.gg/player/48160/laiyin,2024-11-08 09:35:00,0.66,1.04,0.83,185,152,231,22,10,12,28,17,11,5,2,3,-3,-2,-1,71%,68%,73%,121,97,151,26%,24%,27%,2,2,0,5,4,1
292,https://vlr.gg/player/13232/muffyn,2024-11-08 09:35:00,0.42,1.35,0.83,226,165,310,28,11,17,30,18,12,2,1,1,-1,-1,0,62%,53%,73%,130,92,178,32%,23%,39%,6,3,3,7,4,3
293,https://vlr.gg/player/25415/yusin,2024-11-08 09:35:00,0.64,0.29,0.48,140,157,109,13,9,4,31,17,14,14,7,7,-3,-2,-1,65%,63%,67%,88,98,74,26%,24%,29%,2,1,1,5,3,2
294,https://vlr.gg/player/48161/1hp,2024-11-08 09:35:00,0.20,0.41,0.29,85,84,91,9,5,4,32,19,13,9,4,5,-3,-2,-1,50%,47%,53%,64,60,69,34%,33%,36%,1,0,1,4,2,2
295,https://vlr.gg/player/29903/madv,2024-11-08 09:35:00,1.56,1.93,1.77,346,291,384,42,16,26,18,8,10,8,5,3,+5,0,+5,91%,80%,100%,223,187,251,49%,50%,48%,8,3,5,3,3,0
296,https://vlr.gg/player/19366/lexa,2024-11-08 09:35:00,1.46,1.35,1.40,213,255,184,27,15,12,14,7,7,9,2,7,+2,0,+2,88%,87%,89%,138,164,118,28%,24%,32%,2,0,2,0,0,0
297,https://vlr.gg/player/19371/eva,2024-11-08 09:35:00,0.96,1.60,1.32,196,142,229,25,7,18,15,8,7,8,4,4,+1,+2,-1,82%,80%,84%,123,87,152,35%,16%,52%,2,2,0,1,0,1
298,https://vlr.gg/player/17333/mary,2024-11-08 09:35:00,0.71,1.46,1.12,241,208,261,30,11,19,22,13,9,9,2,7,+2,+2,0,71%,67%,74%,146,132,157,37%,37%,37%,6,3,3,4,1,3
299,https://vlr.gg/player/20055/toki,2024-11-08 09:35:00,1.03,1.09,1.06,198,195,209,22,9,13,22,11,11,26,13,13,-2,-3,+1,79%,80%,79%,129,120,136,49%,52%,46%,3,0,3,5,3,2
300,https://vlr.gg/player/3028/life,2024-11-08 07:25:00,,,,295,,,46,,,39,,,9,,,,,,,,,,,,,,,,,,,,
301,https://vlr.gg/player/872/autumn,2024-11-08 07:25:00,,,,259,,,44,,,32,,,10,,,,,,,,,,,,,,,,,,,,
302,https://vlr.gg/player/6022/yosemite,2024-11-08 07:25:00,,,,232,,,38,,,30,,,17,,,,,,,,,,,,,,,,,,,,
303,https://vlr.gg/player/19530/aaaay,2024-11-08 07:25:00,,,,200,,,33,,,30,,,18,,,,,,,,,,,,,,,,,,,,
304,https://vlr.gg/player/7857/berlin,2024-11-08 07:25:00,,,,105,,,16,,,29,,,16,,,,,,,,,,,,,,,,,,,,
305,https://vlr.gg/player/22047/rarga,2024-11-08 07:25:00,,,,223,,,37,,,38,,,3,,,,,,,,,,,,,,,,,,,,
306,https://vlr.gg/player/37927/happywei,2024-11-08 07:25:00,,,,218,,,34,,,33,,,17,,,,,,,,,,,,,,,,,,,,
307,https://vlr.gg/player/36668/mart1n,2024-11-08 07:25:00,,,,212,,,38,,,32,,,10,,,,,,,,,,,,,,,,,,,,
308,https://vlr.gg/player/4710/you,2024-11-08 07:25:00,,,,192,,,30,,,38,,,10,,,,,,,,,,,,,,,,,,,,
309,https://vlr.gg/player/37674/mrcani,2024-11-08 07:25:00,,,,101,,,14,,,38,,,15,,,,,,,,,,,,,,,,,,,,
310,https://vlr.gg/player/25663/dods,2024-11-08 07:00:00,0.81,1.61,1.25,301,259,336,46,17,29,35,19,16,13,4,9,+1,-2,+3,70%,55%,83%,191,162,214,36%,33%,38%,10,4,6,9,6,3
311,https://vlr.gg/player/11259/conir,2024-11-08 07:00:00,1.42,1.08,1.24,211,235,192,33,18,15,23,9,14,24,12,12,-1,0,-1,82%,75%,88%,136,158,118,24%,21%,27%,2,0,2,3,0,3
312,https://vlr.gg/player/18982/romily,2024-11-08 07:00:00,1.06,1.26,1.17,192,182,200,30,13,17,23,11,12,12,1,11,+1,0,+1,77%,70%,83%,128,113,142,37%,39%,36%,2,1,1,1,1,0
313,https://vlr.gg/player/21558/micaela,2024-11-08 07:00:00,1.16,1.02,1.08,204,193,213,34,15,19,29,12,17,19,11,8,0,-2,+2,82%,70%,92%,131,126,135,39%,37%,41%,4,1,3,4,3,1
314,https://vlr.gg/player/11235/biazik,2024-11-08 07:00:00,0.81,1.10,0.97,172,141,198,23,8,15,27,14,13,19,8,11,+1,-2,+3,70%,60%,79%,119,110,127,13%,16%,11%,5,1,4,4,3,1
315,https://vlr.gg/player/29314/moco,2024-11-08 07:00:00,1.14,0.92,1.04,190,182,200,30,17,13,31,16,15,13,4,9,0,-1,+1,70%,71%,70%,127,126,128,24%,27%,20%,2,0,2,2,1,1
316,https://vlr.gg/player/39902/ur,2024-11-08 07:00:00,0.88,1.02,0.94,186,202,167,26,15,11,35,20,15,17,8,9,+4,+2,+2,68%,58%,80%,127,131,122,14%,13%,16%,5,3,2,1,1,0
317,https://vlr.gg/player/39904/serena,2024-11-08 07:00:00,0.66,1.22,0.92,178,159,202,27,13,14,34,21,13,11,4,7,-3,-2,-1,66%,63%,70%,139,127,155,36%,30%,42%,2,1,1,5,3,2
318,https://vlr.gg/player/10653/suzu,2024-11-08 07:00:00,0.62,1.12,0.85,204,173,242,32,13,19,34,20,14,6,4,2,+1,-4,+5,70%,71%,70%,123,107,141,19%,9%,36%,8,3,5,7,7,0
319,https://vlr.gg/player/29316/aco,2024-11-08 07:00:00,0.68,0.75,0.71,163,173,153,22,14,8,32,18,14,19,7,12,-4,-3,-1,75%,75%,75%,104,108,100,23%,33%,15%,4,1,3,8,4,4
320,https://vlr.gg/player/44298/banunu,2024-11-08 06:40:00,1.43,0.93,1.18,192,242,143,34,21,13,29,13,16,10,5,5,0,+1,-1,71%,75%,67%,131,164,98,19%,15%,26%,1,1,0,1,0,1
321,https://vlr.gg/player/7436/fission,2024-11-08 06:40:00,1.24,0.96,1.10,252,276,229,44,25,19,35,16,19,14,5,9,-7,-5,-2,69%,71%,67%,164,173,154,20%,23%,16%,7,4,3,14,9,5
322,https://vlr.gg/player/7754/xavi8k,2024-11-08 06:40:00,1.08,0.98,1.03,215,228,202,36,19,17,31,14,17,13,6,7,+1,0,+1,77%,83%,71%,146,155,137,25%,30%,21%,5,2,3,4,2,2
323,https://vlr.gg/player/49002/dy,2024-11-08 06:40:00,0.99,0.89,0.94,193,179,206,29,13,16,35,15,20,28,14,14,+1,0,+1,75%,75%,75%,119,112,126,22%,24%,21%,4,2,2,3,2,1
324,https://vlr.gg/player/49001/secre,2024-11-08 06:40:00,0.74,0.98,0.86,185,174,197,30,14,16,35,18,17,14,6,8,-1,0,-1,65%,63%,67%,127,123,131,20%,16%,25%,4,1,3,5,1,4
325,https://vlr.gg/player/46135/zeus,2024-11-08 06:40:00,1.28,1.18,1.23,246,302,190,39,23,16,35,20,15,14,7,7,+6,+4,+2,73%,75%,71%,167,212,121,23%,24%,21%,13,8,5,7,4,3
326,https://vlr.gg/player/26143/secondlove,2024-11-08 06:40:00,1.49,0.88,1.19,226,264,189,40,25,15,32,13,19,9,3,6,+3,+2,+1,73%,79%,67%,157,177,137,32%,41%,23%,6,3,3,3,1,2
327,https://vlr.gg/player/10251/slathom999,2024-11-08 06:40:00,0.75,1.27,1.01,196,151,241,33,12,21,34,16,18,13,6,7,-1,-2,+1,67%,63%,71%,142,114,171,42%,34%,49%,2,1,1,3,3,0
328,https://vlr.gg/player/10217/marky,2024-11-08 06:40:00,0.95,0.78,0.87,161,158,163,26,14,12,36,16,20,23,8,15,-2,-2,0,73%,71%,75%,102,93,110,30%,32%,28%,4,1,3,6,3,3
329,https://vlr.gg/player/12322/ndg,2024-11-08 06:40:00,1.03,0.69,0.86,166,190,141,27,15,12,36,16,20,24,18,6,0,0,0,73%,79%,67%,109,118,100,24%,18%,32%,2,0,2,2,0,2
330,https://vlr.gg/player/37489/lysoar,2024-11-08 04:00:00,,,,254,,,55,,,46,,,7,,,,,,,,,,,,,,,,,,,,
331,https://vlr.gg/player/14125/spring,2024-11-08 04:00:00,,,,230,,,49,,,45,,,6,,,,,,,,,,,,,,,,,,,,
332,https://vlr.gg/player/11218/yuicaw,2024-11-08 04:00:00,,,,200,,,43,,,48,,,38,,,,,,,,,,,,,,,,,,,,
333,https://vlr.gg/player/45104/v1ya,2024-11-08 04:00:00,,,,157,,,32,,,47,,,28,,,,,,,,,,,,,,,,,,,,
334,https://vlr.gg/player/7849/siufatbb,2024-11-08 04:00:00,,,,146,,,29,,,42,,,24,,,,,,,,,,,,,,,,,,,,
335,https://vlr.gg/player/4774/knight,2024-11-08 04:00:00,,,,258,,,52,,,40,,,25,,,,,,,,,,,,,,,,,,,,
336,https://vlr.gg/player/4885/whzy,2024-11-08 04:00:00,,,,237,,,51,,,48,,,11,,,,,,,,,,,,,,,,,,,,
337,https://vlr.gg/player/40845/levius,2024-11-08 04:00:00,,,,228,,,50,,,40,,,17,,,,,,,,,,,,,,,,,,,,
338,https://vlr.gg/player/10698/nephh,2024-11-08 04:00:00,,,,185,,,38,,,42,,,35,,,,,,,,,,,,,,,,,,,,
339,https://vlr.gg/player/48878/rushia,2024-11-08 04:00:00,,,,160,,,37,,,38,,,32,,,,,,,,,,,,,,,,,,,,
340,https://vlr.gg/player/29243/neon,2024-11-07 14:00:00,1.27,1.43,1.35,291,260,324,101,46,55,68,32,36,25,9,16,+13,+5,+8,78%,80%,76%,188,169,208,35%,36%,34%,29,15,14,16,10,6
341,https://vlr.gg/player/29240/skyppervz,2024-11-07 14:00:00,1.27,1.12,1.19,219,234,210,79,42,37,61,30,31,42,20,22,+1,-2,+3,83%,80%,86%,151,164,137,31%,45%,21%,7,1,6,6,3,3
342,https://vlr.gg/player/29242/erde,2024-11-07 14:00:00,0.99,1.21,1.10,197,188,215,75,35,40,65,34,31,45,19,26,-1,0,-1,72%,67%,76%,131,119,144,30%,37%,25%,6,3,3,7,3,4
343,https://vlr.gg/player/29244/mikey-tap,2024-11-07 14:00:00,1.02,0.92,0.97,178,170,184,62,29,33,65,31,34,32,16,16,+2,+2,0,68%,71%,65%,117,117,117,27%,21%,34%,7,4,3,5,2,3
344,https://vlr.gg/player/29241/miradaninja,2024-11-07 14:00:00,0.63,1.12,0.87,160,135,184,57,21,36,63,35,28,20,12,8,-7,-4,-3,68%,57%,78%,115,101,128,26%,26%,26%,6,3,3,13,7,6
345,https://vlr.gg/player/2464/suther,2024-11-07 14:00:00,1.13,1.25,1.19,195,203,189,69,37,32,61,36,25,49,19,30,0,+1,-1,73%,65%,80%,129,138,121,23%,23%,23%,3,1,2,3,0,3
346,https://vlr.gg/player/13860/rubkkoide,2024-11-07 14:00:00,0.82,1.06,0.94,223,209,236,77,36,41,82,45,37,17,10,7,+1,-3,+4,67%,65%,69%,143,132,154,29%,25%,33%,19,9,10,18,12,6
347,https://vlr.gg/player/12872/david,2024-11-07 14:00:00,0.88,0.90,0.88,180,175,186,63,30,33,77,39,38,43,18,25,-3,-4,+1,59%,51%,67%,117,118,116,22%,23%,22%,9,3,6,12,7,5
348,https://vlr.gg/player/783/murizzz,2024-11-07 14:00:00,1.03,0.72,0.87,187,210,163,63,36,27,80,41,39,25,15,10,-2,-1,-1,61%,63%,59%,122,138,106,27%,29%,25%,10,4,6,12,5,7
349,https://vlr.gg/player/3828/tacolilla,2024-11-07 14:00:00,0.54,0.92,0.72,144,124,166,50,21,29,74,40,34,22,7,15,-4,0,-4,58%,49%,67%,96,81,110,21%,31%,16%,6,5,1,10,5,5
350,https://vlr.gg/player/41207/jade,2024-11-07 12:00:00,1.72,1.23,1.48,267,278,257,62,33,29,38,16,22,35,20,15,+1,0,+1,83%,94%,71%,171,179,162,31%,30%,32%,7,1,6,6,1,5
351,https://vlr.gg/player/17318/blossi,2024-11-07 12:00:00,1.26,1.20,1.23,218,207,219,48,25,23,37,18,19,25,13,12,+4,+4,0,79%,78%,81%,142,129,156,27%,23%,31%,8,6,2,4,2,2
352,https://vlr.gg/player/37969/ellie,2024-11-07 12:00:00,1.31,1.11,1.21,276,305,248,62,35,27,48,24,24,13,7,6,0,+1,-1,78%,75%,81%,179,198,159,34%,32%,35%,10,7,3,10,6,4
353,https://vlr.gg/player/30042/harmonee,2024-11-07 12:00:00,0.91,1.22,1.06,183,150,198,42,17,25,36,18,18,19,10,9,-3,-2,-1,71%,72%,71%,118,106,131,30%,25%,35%,4,1,3,7,3,4
354,https://vlr.gg/player/19373/ginger,2024-11-07 12:00:00,0.81,0.83,0.82,161,172,148,37,20,17,44,22,22,14,9,5,+3,+1,+2,68%,69%,68%,104,112,95,24%,23%,24%,5,3,2,2,2,0
355,https://vlr.gg/player/20112/kxoma,2024-11-07 12:00:00,1.16,0.88,1.02,205,226,199,47,26,21,49,23,26,19,11,8,-3,-1,-2,71%,77%,66%,133,131,136,20%,18%,24%,1,0,1,4,1,3
356,https://vlr.gg/player/40177/leeni,2024-11-07 12:00:00,0.78,1.03,0.91,193,165,252,45,17,28,51,24,27,15,8,7,+1,-1,+2,65%,68%,63%,131,109,153,26%,21%,29%,9,3,6,8,4,4
357,https://vlr.gg/player/20730/karina,2024-11-07 12:00:00,0.83,0.89,0.86,176,166,178,39,20,19,48,23,25,7,3,4,+5,+4,+1,57%,55%,59%,116,107,125,32%,33%,32%,9,6,3,4,2,2
358,https://vlr.gg/player/40524/star,2024-11-07 12:00:00,0.87,0.53,0.70,181,253,115,39,26,13,55,28,27,7,4,3,-2,+1,-3,59%,55%,63%,116,162,72,33%,48%,16%,8,6,2,10,5,5
359,https://vlr.gg/player/46438/taromie,2024-11-07 12:00:00,0.73,0.70,0.70,155,143,166,33,16,17,48,23,25,22,13,9,-6,-4,-2,62%,61%,63%,101,93,108,23%,22%,24%,2,0,2,8,4,4
360,https://vlr.gg/player/13744/patmen,2024-11-07 08:45:00,1.23,1.02,1.14,254,271,228,36,22,14,36,21,15,13,5,8,0,-1,+1,73%,67%,80%,163,175,149,38%,40%,34%,11,5,6,11,6,5
361,https://vlr.gg/player/7746/kevzii,2024-11-07 08:45:00,0.75,1.52,1.10,212,132,309,32,10,22,31,18,13,10,4,6,+4,+2,+2,61%,42%,85%,148,91,216,40%,34%,43%,4,2,2,0,0,0
362,https://vlr.gg/player/9737/kakarot,2024-11-07 08:45:00,0.82,0.98,0.89,167,174,161,25,13,12,34,21,13,20,10,10,-1,-2,+1,59%,54%,65%,114,114,113,22%,19%,29%,1,0,1,2,2,0
363,https://vlr.gg/player/16953/zynd,2024-11-07 08:45:00,0.82,0.75,0.79,152,148,164,25,14,11,33,18,15,7,2,5,-5,-4,-1,57%,54%,60%,102,89,117,24%,23%,26%,1,1,0,6,5,1
364,https://vlr.gg/player/21677/jeee,2024-11-07 08:45:00,0.51,0.87,0.67,143,96,207,22,7,15,34,18,16,17,10,7,-4,-3,-1,75%,75%,75%,89,62,121,20%,33%,15%,2,0,2,6,3,3
365,https://vlr.gg/player/23710/gotten,2024-11-07 08:45:00,1.40,1.29,1.34,256,219,291,39,16,23,29,13,16,18,11,7,+7,+2,+5,84%,80%,88%,165,142,184,32%,32%,32%,8,2,6,1,0,1
366,https://vlr.gg/player/2346/cud,2024-11-07 08:45:00,1.47,1.00,1.21,184,243,132,33,21,12,22,12,10,7,4,3,+1,0,+1,84%,80%,88%,117,155,86,40%,44%,35%,3,1,2,2,1,1
367,https://vlr.gg/player/7807/valdyn,2024-11-07 08:45:00,1.04,1.24,1.15,247,239,254,39,15,24,28,15,13,17,10,7,-2,-2,0,73%,75%,71%,157,155,158,27%,21%,33%,4,2,2,6,4,2
368,https://vlr.gg/player/11666/ray4c,2024-11-07 08:45:00,1.00,1.12,1.06,220,243,197,16,9,7,16,10,6,9,5,4,+4,+3,+1,79%,92%,67%,147,148,145,10%,8%,11%,6,4,2,2,1,1
369,https://vlr.gg/player/16852/nakya,2024-11-07 08:45:00,0.47,1.27,0.91,202,128,256,31,9,22,31,17,14,7,4,3,0,-3,+3,73%,70%,75%,139,84,185,24%,12%,32%,4,0,4,4,3,1
370,https://vlr.gg/player/1742/asteriskk,2024-11-07 08:45:00,0.42,1.02,0.78,142,83,182,10,2,8,14,7,7,10,3,7,-4,-2,-2,70%,38%,92%,94,44,127,30%,20%,32%,0,0,0,4,2,2
371,https://vlr.gg/player/39697/cb,2024-11-07 07:30:00,,,,253,,,48,,,47,,,19,,,,,,,,,,,,,,,,,,,,
372,https://vlr.gg/player/41054/guang,2024-11-07 07:30:00,,,,232,,,55,,,36,,,9,,,,,,,,,,,,,,,,,,,,
373,https://vlr.gg/player/1209/swerl,2024-11-07 07:30:00,,,,208,,,43,,,46,,,7,,,,,,,,,,,,,,,,,,,,
374,https://vlr.gg/player/46460/ezeir,2024-11-07 07:30:00,,,,182,,,36,,,45,,,23,,,,,,,,,,,,,,,,,,,,
375,https://vlr.gg/player/4402/o0o0o,2024-11-07 07:30:00,,,,140,,,25,,,46,,,43,,,,,,,,,,,,,,,,,,,,
376,https://vlr.gg/player/6022/yosemite,2024-11-07 07:30:00,,,,269,,,59,,,44,,,15,,,,,,,,,,,,,,,,,,,,
377,https://vlr.gg/player/3028/life,2024-11-07 07:30:00,,,,241,,,52,,,41,,,12,,,,,,,,,,,,,,,,,,,,
378,https://vlr.gg/player/19530/aaaay,2024-11-07 07:30:00,,,,216,,,41,,,39,,,22,,,,,,,,,,,,,,,,,,,,
379,https://vlr.gg/player/872/autumn,2024-11-07 07:30:00,,,,189,,,42,,,41,,,16,,,,,,,,,,,,,,,,,,,,
380,https://vlr.gg/player/7857/berlin,2024-11-07 07:30:00,,,,146,,,26,,,42,,,27,,,,,,,,,,,,,,,,,,,,
381,https://vlr.gg/player/7851/uta,2024-11-07 06:00:00,0.94,1.21,1.02,217,228,221,44,28,16,43,30,13,7,6,1,-6,-6,0,69%,64%,78%,143,146,136,26%,25%,30%,8,6,2,14,12,2
382,https://vlr.gg/player/47977/chak,2024-11-07 06:00:00,1.08,0.55,0.90,202,236,143,40,31,9,46,30,16,18,12,6,+4,+4,0,74%,78%,67%,123,142,86,28%,31%,19%,5,4,1,1,0,1
383,https://vlr.gg/player/24304/kiuuuu,2024-11-07 06:00:00,0.81,1.04,0.89,210,176,288,29,16,13,31,18,13,4,3,1,-4,-4,0,62%,63%,62%,139,109,195,40%,35%,46%,2,1,1,6,5,1
384,https://vlr.gg/player/37421/riyabtw,2024-11-07 06:00:00,0.76,0.72,0.75,172,161,190,30,19,11,44,28,16,12,11,1,+5,+2,+3,65%,67%,61%,111,112,109,44%,42%,50%,8,3,5,3,1,2
385,https://vlr.gg/player/24302/chimei,2024-11-07 06:00:00,0.57,0.72,0.62,115,95,155,17,9,8,44,28,16,30,21,9,-4,-3,-1,74%,67%,89%,82,70,107,19%,21%,16%,1,0,1,5,3,2
386,https://vlr.gg/player/42541/ckuma,2024-11-07 06:00:00,0.60,0.24,0.49,109,132,55,6,5,1,16,11,5,2,0,2,-1,-1,0,53%,58%,40%,81,96,47,29%,38%,0%,0,0,0,1,1,0
387,https://vlr.gg/player/1430/crazyguy,2024-11-07 06:00:00,1.42,1.53,1.49,270,236,279,53,16,37,30,10,20,18,9,9,+1,-2,+3,83%,89%,81%,188,161,201,36%,47%,32%,4,0,4,3,2,1
388,https://vlr.gg/player/9152/deryeon,2024-11-07 06:00:00,1.04,1.39,1.27,249,255,256,50,19,31,34,14,20,17,2,15,+5,+1,+4,83%,83%,83%,166,165,167,25%,42%,19%,8,3,5,3,2,1
389,https://vlr.gg/player/24628/wayne,2024-11-07 06:00:00,1.26,1.12,1.17,200,233,183,38,15,23,31,11,20,34,13,21,-1,-2,+1,89%,89%,89%,134,148,128,27%,24%,28%,3,0,3,4,2,2
390,https://vlr.gg/player/11704/styron,2024-11-07 06:00:00,0.98,1.13,1.08,197,182,199,38,11,27,31,10,21,15,4,11,+4,+1,+3,78%,83%,75%,117,102,124,19%,10%,24%,5,2,3,1,1,0
391,https://vlr.gg/player/7530/kimmy,2024-11-07 06:00:00,1.19,0.88,0.97,219,249,203,44,17,27,40,14,26,10,2,8,-3,0,-3,70%,72%,69%,134,150,126,22%,19%,24%,10,3,7,13,3,10
392,https://vlr.gg/player/24977/beomjun,2024-11-07 05:15:00,1.04,1.35,1.20,313,315,311,46,23,23,38,16,22,14,9,5,+1,+1,0,85%,84%,86%,195,203,189,37%,37%,38%,4,3,1,3,2,1
393,https://vlr.gg/player/17048/clark,2024-11-07 05:15:00,0.89,0.97,0.94,192,174,209,29,13,16,29,13,16,2,1,1,-1,0,-1,75%,79%,71%,128,119,137,45%,60%,38%,3,2,1,4,2,2
394,https://vlr.gg/player/48906/hachi,2024-11-07 05:15:00,0.89,0.55,0.71,159,160,156,21,10,11,30,12,18,8,4,4,-1,+1,-2,63%,74%,52%,114,111,117,32%,38%,27%,2,1,1,3,0,3
395,https://vlr.gg/player/31831/aru,2024-11-07 05:15:00,0.71,0.55,0.63,191,209,176,24,13,11,35,16,19,8,3,5,+1,-1,+2,68%,68%,67%,120,133,109,22%,23%,21%,10,4,6,9,5,4
396,https://vlr.gg/player/42773/foxar,2024-11-07 05:15:00,0.68,0.47,0.57,111,115,107,14,6,8,30,12,18,15,9,6,-2,0,-2,70%,89%,52%,79,81,77,22%,19%,29%,0,0,0,2,0,2
397,https://vlr.gg/player/9236/manggong,2024-11-07 05:15:00,1.72,1.23,1.49,274,309,238,41,25,16,23,11,12,15,10,5,+3,+1,+2,80%,86%,74%,164,180,146,30%,25%,37%,5,2,3,2,1,1
398,https://vlr.gg/player/42254/delas,2024-11-07 05:15:00,1.04,1.28,1.16,248,238,256,35,18,17,29,17,12,11,3,8,-2,0,-2,80%,81%,79%,155,155,155,31%,26%,39%,8,6,2,10,6,4
399,https://vlr.gg/player/42749/godsb,2024-11-07 05:15:00,1.14,1.09,1.11,183,177,188,26,14,12,23,12,11,12,4,8,-1,0,-1,80%,86%,74%,125,127,123,32%,39%,26%,2,1,1,3,1,2
400,https://vlr.gg/player/9192/cloudy,2024-11-07 05:15:00,0.96,1.09,1.02,212,212,209,30,16,14,30,16,14,11,7,4,+1,0,+1,75%,71%,79%,142,159,122,35%,38%,32%,2,0,2,1,0,1
401,https://vlr.gg/player/25053/wolverine,2024-11-07 05:15:00,1.29,0.62,0.97,193,254,132,28,18,10,30,16,14,14,10,4,+1,+2,-1,78%,86%,68%,123,164,77,25%,21%,37%,4,3,1,3,1,2
402,https://vlr.gg/player/16924/stew,2024-11-07 04:00:00,,,,266,,,66,,,43,,,12,,,,,,,,,,,,,,,,,,,,
403,https://vlr.gg/player/3519/jkuro,2024-11-07 04:00:00,,,,210,,,49,,,52,,,21,,,,,,,,,,,,,,,,,,,,
404,https://vlr.gg/player/36415/viva,2024-11-07 04:00:00,,,,203,,,47,,,51,,,10,,,,,,,,,,,,,,,,,,,,
405,https://vlr.gg/player/41029/z1yan,2024-11-07 04:00:00,,,,174,,,39,,,45,,,19,,,,,,,,,,,,,,,,,,,,
406,https://vlr.gg/player/3049/sword9,2024-11-07 04:00:00,,,,144,,,35,,,43,,,18,,,,,,,,,,,,,,,,,,,,
407,https://vlr.gg/player/37927/happywei,2024-11-07 04:00:00,,,,275,,,63,,,50,,,11,,,,,,,,,,,,,,,,,,,,
408,https://vlr.gg/player/22047/rarga,2024-11-07 04:00:00,,,,246,,,57,,,53,,,8,,,,,,,,,,,,,,,,,,,,
409,https://vlr.gg/player/4710/you,2024-11-07 04:00:00,,,,202,,,48,,,46,,,15,,,,,,,,,,,,,,,,,,,,
410,https://vlr.gg/player/36668/mart1n,2024-11-07 04:00:00,,,,152,,,37,,,42,,,21,,,,,,,,,,,,,,,,,,,,
411,https://vlr.gg/player/37674/mrcani,2024-11-07 04:00:00,,,,130,,,29,,,46,,,23,,,,,,,,,,,,,,,,,,,,
412,https://vlr.gg/player/4563/kobra,2024-11-07 03:00:00,1.31,0.74,1.03,264,315,219,32,22,10,31,17,14,5,1,4,+3,+4,-1,63%,65%,60%,170,203,127,22%,23%,22%,8,6,2,5,2,3
413,https://vlr.gg/player/27465/ktree,2024-11-07 03:00:00,0.69,1.33,0.97,210,188,253,25,12,13,28,17,11,8,4,4,+1,+1,0,66%,65%,67%,151,133,174,28%,29%,28%,2,2,0,1,1,0
414,https://vlr.gg/player/34973/apex,2024-11-07 03:00:00,0.93,0.88,0.91,191,187,198,24,15,9,29,16,13,14,5,9,-1,-1,0,74%,80%,67%,130,130,130,24%,22%,26%,2,1,1,3,2,1
415,https://vlr.gg/player/20881/exia,2024-11-07 03:00:00,0.78,0.25,0.55,142,175,88,14,11,3,31,17,14,17,8,9,-1,+1,-2,71%,75%,67%,84,106,56,24%,19%,44%,2,1,1,3,0,3
416,https://vlr.gg/player/25020/bbiyong,2024-11-07 03:00:00,0.41,0.67,0.52,117,95,158,15,6,9,29,16,13,6,4,2,-1,-1,0,63%,55%,73%,72,58,92,40%,29%,50%,4,2,2,5,3,2
417,https://vlr.gg/player/40279/ngen,2024-11-07 03:00:00,1.57,1.24,1.38,227,239,226,28,13,15,17,6,11,11,8,3,0,0,0,86%,93%,80%,161,163,159,26%,23%,29%,1,0,1,1,0,1
418,https://vlr.gg/player/13000/redlight,2024-11-07 03:00:00,1.47,1.13,1.28,259,240,255,31,12,19,23,9,14,25,18,7,0,-1,+1,74%,87%,65%,148,136,156,23%,14%,32%,4,0,4,4,1,3
419,https://vlr.gg/player/4038/bangnan,2024-11-07 03:00:00,1.42,1.14,1.26,206,231,199,29,14,15,22,8,14,5,2,3,+1,+1,0,71%,67%,75%,148,150,147,44%,50%,40%,2,2,0,1,1,0
420,https://vlr.gg/player/34727/kayle,2024-11-07 03:00:00,0.91,1.41,1.20,263,193,291,28,9,19,25,11,14,32,16,16,+1,0,+1,80%,73%,85%,151,112,180,26%,15%,34%,3,1,2,2,1,1
421,https://vlr.gg/player/38369/only1,2024-11-07 03:00:00,1.34,1.03,1.16,237,300,195,32,17,15,24,11,13,5,0,5,-3,+3,-6,69%,73%,65%,151,177,131,26%,29%,23%,7,6,1,10,3,7
422,https://vlr.gg/player/35031/sevy,2024-11-06 23:10:00,1.15,1.16,1.16,204,211,200,59,29,30,49,23,26,26,11,15,-2,+1,-3,69%,74%,64%,130,131,129,31%,27%,37%,2,1,1,4,0,4
423,https://vlr.gg/player/44584/altg,2024-11-06 23:10:00,0.98,0.91,0.95,224,224,217,57,31,26,59,28,31,14,5,9,-5,-2,-3,65%,56%,74%,139,140,137,27%,30%,25%,5,3,2,10,5,5
424,https://vlr.gg/player/10254/magicss,2024-11-06 23:10:00,0.90,0.99,0.94,190,204,181,52,25,27,58,29,29,38,21,17,-5,-2,-3,68%,64%,72%,128,137,119,27%,24%,31%,4,4,0,9,6,3
425,https://vlr.gg/player/35512/n9sty,2024-11-06 23:10:00,0.95,0.88,0.92,230,248,213,61,34,27,63,31,32,16,4,12,+1,-2,+3,69%,69%,69%,146,152,139,22%,22%,23%,18,7,11,17,9,8
426,https://vlr.gg/player/28291/yawnpeek,2024-11-06 23:10:00,0.82,0.83,0.83,160,147,170,43,21,22,55,27,28,21,11,10,-5,-2,-3,65%,62%,69%,107,99,115,23%,17%,31%,2,1,1,7,3,4
427,https://vlr.gg/player/10203/tesseract,2024-11-06 23:10:00,1.50,1.10,1.30,248,291,213,71,41,30,48,22,26,16,8,8,+2,+3,-1,73%,79%,67%,164,192,135,29%,28%,32%,11,8,3,9,5,4
428,https://vlr.gg/player/9745/georggyyy,2024-11-06 23:10:00,1.17,1.33,1.25,271,262,286,70,33,37,60,30,30,17,11,6,+12,+7,+5,73%,77%,69%,178,175,181,21%,19%,24%,18,9,9,6,2,4
429,https://vlr.gg/player/11578/hotsauz,2024-11-06 23:10:00,0.82,1.20,1.01,207,180,227,57,24,33,53,29,24,19,8,11,+3,+4,-1,68%,64%,72%,130,117,143,26%,19%,35%,9,5,4,6,1,5
430,https://vlr.gg/player/44251/dignified,2024-11-06 23:10:00,0.94,1.03,0.98,158,154,169,41,19,22,55,27,28,47,27,20,-2,-2,0,77%,85%,69%,116,108,123,26%,24%,29%,3,2,1,5,4,1
431,https://vlr.gg/player/35965/yukxx,2024-11-06 23:10:00,1.04,0.65,0.84,173,190,150,45,29,16,56,24,32,46,17,29,+1,-3,+4,69%,72%,67%,111,126,95,33%,39%,29%,6,0,6,5,3,2
432,https://vlr.gg/player/10217/marky,2024-11-06 21:00:00,1.68,1.39,1.60,277,298,214,33,27,6,15,11,4,15,9,6,+7,+5,+2,82%,88%,67%,175,182,156,26%,29%,19%,8,6,2,1,1,0
433,https://vlr.gg/player/46135/zeus,2024-11-06 21:00:00,1.48,1.94,1.60,310,284,364,38,25,13,19,13,6,8,5,3,+6,+5,+1,82%,79%,89%,184,176,205,21%,22%,21%,7,6,1,1,1,0
434,https://vlr.gg/player/10251/slathom999,2024-11-06 21:00:00,1.46,0.83,1.29,183,202,111,21,17,4,13,8,5,13,11,2,-1,0,-1,82%,83%,78%,120,141,66,29%,33%,13%,3,1,2,4,1,3
435,https://vlr.gg/player/12322/ndg,2024-11-06 21:00:00,1.23,1.17,1.21,191,179,231,23,17,6,15,9,6,13,9,4,+2,+1,+1,91%,92%,89%,130,122,151,20%,37%,5%,4,3,1,2,2,0
436,https://vlr.gg/player/26143/secondlove,2024-11-06 21:00:00,0.93,1.76,1.16,202,189,258,25,16,9,18,15,3,14,5,9,-1,-1,0,82%,75%,100%,127,119,146,27%,33%,19%,1,1,0,2,2,0
437,https://vlr.gg/player/52235/kael,2024-11-06 21:00:00,1.13,1.01,1.04,212,185,223,23,7,16,25,6,19,13,0,13,+1,+1,0,73%,67%,75%,122,105,129,19%,15%,20%,1,1,0,0,0,0
438,https://vlr.gg/player/35963/migz,2024-11-06 21:00:00,0.50,0.59,0.56,157,177,156,16,4,12,29,9,20,7,2,5,-3,-2,-1,52%,44%,54%,105,118,100,15%,11%,19%,3,1,2,6,3,3
439,https://vlr.gg/player/27199/jaso,2024-11-06 21:00:00,0.44,0.61,0.55,128,79,149,13,2,11,27,7,20,6,1,5,-4,0,-4,45%,44%,46%,88,63,97,30%,27%,31%,1,0,1,5,0,5
440,https://vlr.gg/player/35967/taphtaph,2024-11-06 21:00:00,0.77,0.37,0.48,119,198,86,12,6,6,29,7,22,7,3,4,-5,-1,-4,42%,67%,33%,77,121,60,19%,25%,13%,0,0,0,5,1,4
441,https://vlr.gg/player/25375/scarymd2,2024-11-06 21:00:00,0.40,0.52,0.47,138,168,129,16,5,11,30,9,21,6,3,3,-2,-1,-1,58%,78%,50%,88,111,80,28%,24%,32%,5,1,4,7,2,5
442,https://vlr.gg/player/13860/rubkkoide,2024-11-06 14:00:00,1.16,1.42,1.28,265,264,262,79,41,38,57,33,24,20,9,11,-2,-2,0,79%,80%,78%,177,175,178,36%,35%,37%,14,7,7,16,9,7
443,https://vlr.gg/player/2464/suther,2024-11-06 14:00:00,1.11,1.31,1.21,193,168,228,59,28,31,48,24,24,50,20,30,+4,+1,+3,77%,70%,85%,130,105,157,23%,25%,21%,6,1,5,2,0,2
444,https://vlr.gg/player/783/murizzz,2024-11-06 14:00:00,1.10,1.12,1.11,223,229,212,67,36,31,55,29,26,23,11,12,+4,+4,0,77%,75%,80%,146,149,143,27%,27%,28%,11,7,4,7,3,4
445,https://vlr.gg/player/3828/tacolilla,2024-11-06 14:00:00,0.99,1.07,1.03,203,205,197,61,32,29,54,31,23,24,10,14,+3,0,+3,71%,68%,75%,131,137,125,26%,29%,22%,11,6,5,8,6,2
446,https://vlr.gg/player/12872/david,2024-11-06 14:00:00,0.88,0.96,0.92,177,176,176,50,28,22,56,30,26,39,12,27,-1,+1,-2,70%,68%,73%,124,127,120,28%,31%,23%,4,3,1,5,2,3
447,https://vlr.gg/player/1309/tio,2024-11-06 14:00:00,1.25,0.93,1.08,198,214,185,59,31,28,58,27,31,32,20,12,-1,0,-1,81%,80%,82%,129,141,117,23%,28%,20%,4,2,2,5,2,3
448,https://vlr.gg/player/8730/1kuzohh,2024-11-06 14:00:00,0.65,1.34,1.01,227,183,270,66,23,43,69,36,33,15,9,6,+1,0,+1,69%,65%,73%,149,121,175,31%,31%,31%,14,8,6,13,8,5
449,https://vlr.gg/player/2909/alca,2024-11-06 14:00:00,0.76,0.99,0.88,170,140,194,44,17,27,60,28,32,29,11,18,-3,0,-3,69%,68%,70%,114,94,131,27%,29%,25%,6,3,3,9,3,6
450,https://vlr.gg/player/8278/knzy,2024-11-06 14:00:00,0.99,0.69,0.83,183,205,169,52,29,23,66,31,35,22,13,9,-3,0,-3,65%,73%,59%,116,126,107,15%,18%,12%,7,4,3,10,4,6
451,https://vlr.gg/player/38857/beng,2024-11-06 14:00:00,0.71,0.68,0.69,161,152,168,48,22,26,63,30,33,19,14,5,-2,-4,+2,65%,70%,61%,94,93,94,26%,28%,25%,7,1,6,9,5,4
452,https://vlr.gg/player/2366/alert,2024-11-06 08:15:00,1.41,1.46,1.43,255,232,285,38,19,19,29,16,13,9,6,3,+2,0,+2,68%,58%,80%,164,161,168,30%,23%,42%,4,1,3,2,1,1
453,https://vlr.gg/player/4377/johnolsen,2024-11-06 08:15:00,0.81,0.92,0.86,176,151,211,28,13,15,34,19,15,7,3,4,-3,-2,-1,57%,50%,65%,123,120,128,33%,31%,35%,1,0,1,4,2,2
454,https://vlr.gg/player/3342/sushiboys,2024-11-06 08:15:00,0.82,0.60,0.72,169,174,158,23,14,9,36,19,17,23,12,11,-7,-2,-5,66%,71%,60%,104,107,102,24%,23%,25%,2,2,0,9,4,5
455,https://vlr.gg/player/23930/potter,2024-11-06 08:15:00,0.68,0.74,0.71,152,158,147,23,12,11,36,20,16,7,4,3,-2,-1,-1,57%,54%,60%,118,120,115,42%,43%,41%,7,5,2,9,6,3
456,https://vlr.gg/player/27254/leviathan,2024-11-06 08:15:00,0.68,0.64,0.66,134,144,121,21,12,9,34,19,15,13,9,4,-2,-1,-1,66%,75%,55%,81,92,68,61%,60%,62%,2,1,1,4,2,2
457,https://vlr.gg/player/27244/seph1roth,2024-11-06 08:15:00,1.13,1.38,1.27,207,155,252,33,12,21,24,10,14,23,9,14,+4,+1,+3,91%,85%,96%,137,96,172,43%,52%,39%,4,1,3,0,0,0
458,https://vlr.gg/player/24679/cgrs,2024-11-06 08:15:00,1.42,1.04,1.21,217,244,193,33,18,15,26,12,14,15,8,7,-1,+2,-3,82%,90%,75%,157,168,148,18%,20%,17%,4,3,1,5,1,4
459,https://vlr.gg/player/8582/laz,2024-11-06 08:15:00,1.10,1.23,1.17,205,195,215,33,14,19,25,12,13,7,4,3,+3,+1,+2,75%,80%,71%,137,120,150,29%,38%,24%,6,1,5,3,0,3
460,https://vlr.gg/player/12098/kadoom,2024-11-06 08:15:00,1.02,1.11,1.07,227,247,210,35,16,19,29,15,14,12,7,5,+4,+3,+1,77%,70%,83%,152,168,139,30%,27%,35%,10,7,3,6,4,2
461,https://vlr.gg/player/13784/killua,2024-11-06 08:15:00,0.96,1.06,1.01,218,216,219,35,16,19,29,14,15,10,5,5,+2,-1,+3,70%,70%,71%,141,137,144,33%,50%,24%,4,1,3,2,2,0
462,https://vlr.gg/player/4774/knight,2024-11-06 07:10:00,,,,286,,,44,,,26,,,19,,,,,,,,,,,,,,,,,,,,
463,https://vlr.gg/player/10698/nephh,2024-11-06 07:10:00,,,,238,,,36,,,31,,,32,,,,,,,,,,,,,,,,,,,,
464,https://vlr.gg/player/40845/levius,2024-11-06 07:10:00,,,,222,,,38,,,25,,,13,,,,,,,,,,,,,,,,,,,,
465,https://vlr.gg/player/4885/whzy,2024-11-06 07:10:00,,,,198,,,29,,,33,,,18,,,,,,,,,,,,,,,,,,,,
466,https://vlr.gg/player/48878/rushia,2024-11-06 07:10:00,,,,187,,,29,,,25,,,21,,,,,,,,,,,,,,,,,,,,
467,https://vlr.gg/player/46460/ezeir,2024-11-06 07:10:00,,,,248,,,40,,,35,,,21,,,,,,,,,,,,,,,,,,,,
468,https://vlr.gg/player/39697/cb,2024-11-06 07:10:00,,,,228,,,34,,,35,,,10,,,,,,,,,,,,,,,,,,,,
469,https://vlr.gg/player/41054/guang,2024-11-06 07:10:00,,,,188,,,29,,,31,,,7,,,,,,,,,,,,,,,,,,,,
470,https://vlr.gg/player/4402/o0o0o,2024-11-06 07:10:00,,,,146,,,20,,,36,,,25,,,,,,,,,,,,,,,,,,,,
471,https://vlr.gg/player/1209/swerl,2024-11-06 07:10:00,,,,133,,,17,,,40,,,10,,,,,,,,,,,,,,,,,,,,
472,https://vlr.gg/player/13220/ja,2024-11-06 06:00:00,1.29,1.71,1.48,262,227,297,48,23,25,28,18,10,16,8,8,-1,0,-1,76%,64%,91%,171,151,194,33%,26%,39%,4,3,1,5,3,2
473,https://vlr.gg/player/9747/emman,2024-11-06 06:00:00,1.18,1.25,1.21,187,179,214,36,21,15,31,18,13,27,13,14,+1,0,+1,76%,68%,87%,134,112,161,36%,47%,29%,2,0,2,1,0,1
474,https://vlr.gg/player/7749/nexi,2024-11-06 06:00:00,0.96,1.26,1.10,216,215,215,37,22,15,35,22,13,15,7,8,-1,-2,+1,78%,71%,87%,145,142,148,28%,37%,20%,4,1,3,5,3,2
475,https://vlr.gg/player/7754/xavi8k,2024-11-06 06:00:00,0.92,1.23,1.06,198,203,202,33,17,16,34,22,12,19,13,6,+3,+1,+2,76%,71%,83%,140,144,135,21%,18%,24%,5,2,3,2,1,1
476,https://vlr.gg/player/16842/mojer,2024-11-06 06:00:00,0.74,1.09,0.90,242,220,249,41,20,21,40,24,16,17,9,8,-5,-5,0,67%,61%,74%,140,131,151,18%,16%,22%,9,5,4,14,10,4
477,https://vlr.gg/player/14209/suka,2024-11-06 06:00:00,1.47,1.21,1.33,242,284,224,42,21,21,36,16,20,29,10,19,+2,0,+2,76%,65%,86%,164,185,148,31%,34%,28%,5,1,4,3,1,2
478,https://vlr.gg/player/14587/daft,2024-11-06 06:00:00,0.47,1.21,0.87,173,128,230,30,8,22,38,19,19,18,5,13,+4,0,+4,67%,52%,79%,120,86,148,33%,25%,38%,7,2,5,3,2,1
479,https://vlr.gg/player/44149/pr0digy,2024-11-06 06:00:00,0.60,0.91,0.77,151,118,187,28,10,18,36,17,19,13,3,10,-1,0,-1,61%,48%,71%,109,84,129,41%,35%,45%,3,1,2,4,1,3
480,https://vlr.gg/player/14254/gin,2024-11-06 06:00:00,0.62,0.87,0.76,203,180,213,35,14,21,45,20,25,11,4,7,+2,0,+2,73%,65%,79%,125,110,137,29%,29%,29%,11,6,5,9,6,3
481,https://vlr.gg/player/19154/albus,2024-11-06 06:00:00,0.41,1.02,0.75,179,120,219,33,12,21,41,20,21,10,2,8,-4,-3,-1,63%,57%,68%,110,70,144,30%,26%,32%,1,0,1,5,3,2
482,https://vlr.gg/player/34883/distinct,2024-11-06 05:55:00,1.66,1.12,1.39,253,267,239,41,23,18,28,12,16,11,8,3,+1,+2,-1,69%,78%,59%,160,175,144,26%,20%,35%,6,3,3,5,1,4
483,https://vlr.gg/player/31830/jiha,2024-11-06 05:55:00,1.21,0.76,0.99,190,206,174,29,17,12,32,14,18,15,9,6,-1,+1,-2,69%,83%,55%,126,126,125,29%,29%,29%,3,3,0,4,2,2
484,https://vlr.gg/player/48908/xizen,2024-11-06 05:55:00,0.70,1.02,0.85,189,149,233,29,11,18,36,17,19,12,5,7,-1,0,-1,73%,74%,73%,131,106,157,37%,26%,50%,4,1,3,5,1,4
485,https://vlr.gg/player/48910/aether,2024-11-06 05:55:00,0.79,0.63,0.71,141,176,106,22,13,9,38,19,19,20,12,8,+1,+1,0,73%,74%,73%,102,132,70,23%,23%,23%,1,1,0,0,0,0
486,https://vlr.gg/player/48909/krazy,2024-11-06 05:55:00,0.59,0.82,0.70,167,170,164,26,14,12,36,19,17,10,6,4,-3,-3,0,60%,57%,64%,101,96,107,20%,17%,25%,7,4,3,10,7,3
487,https://vlr.gg/player/4054/secret,2024-11-06 05:55:00,1.62,1.18,1.39,251,265,237,42,22,20,27,10,17,23,11,12,+2,+1,+1,87%,91%,83%,157,172,144,28%,26%,30%,3,2,1,1,1,0
488,https://vlr.gg/player/7483/nakji,2024-11-06 05:55:00,0.91,1.49,1.21,225,188,259,31,14,17,30,15,15,32,13,19,0,-3,+3,71%,73%,70%,156,145,166,26%,24%,26%,3,0,3,3,3,0
489,https://vlr.gg/player/37535/jaebin,2024-11-06 05:55:00,1.46,0.95,1.20,259,284,239,38,21,17,32,14,18,26,14,12,+1,+1,0,76%,86%,65%,169,185,154,14%,17%,11%,10,5,5,9,4,5
490,https://vlr.gg/player/4488/wix,2024-11-06 05:55:00,0.84,1.15,1.00,188,199,180,30,15,15,28,16,12,11,5,6,+3,+4,-1,64%,64%,65%,122,128,117,17%,17%,16%,5,5,0,2,1,1
491,https://vlr.gg/player/25017/ash,2024-11-06 05:55:00,1.13,0.65,0.88,169,202,138,29,17,12,30,14,16,10,7,3,-3,+1,-4,76%,91%,61%,125,155,97,25%,27%,22%,3,1,2,6,0,6
492,https://vlr.gg/player/14125/spring,2024-11-06 04:00:00,,,,348,,,70,,,37,,,12,,,,,,,,,,,,,,,,,,,,
493,https://vlr.gg/player/37489/lysoar,2024-11-06 04:00:00,,,,252,,,54,,,33,,,16,,,,,,,,,,,,,,,,,,,,
494,https://vlr.gg/player/11218/yuicaw,2024-11-06 04:00:00,,,,183,,,37,,,40,,,28,,,,,,,,,,,,,,,,,,,,
495,https://vlr.gg/player/7849/siufatbb,2024-11-06 04:00:00,,,,149,,,26,,,34,,,34,,,,,,,,,,,,,,,,,,,,
496,https://vlr.gg/player/45104/v1ya,2024-11-06 04:00:00,,,,131,,,24,,,39,,,25,,,,,,,,,,,,,,,,,,,,
497,https://vlr.gg/player/16924/stew,2024-11-06 04:00:00,,,,239,,,49,,,45,,,9,,,,,,,,,,,,,,,,,,,,
498,https://vlr.gg/player/41029/z1yan,2024-11-06 04:00:00,,,,196,,,39,,,39,,,9,,,,,,,,,,,,,,,,,,,,
499,https://vlr.gg/player/36415/viva,2024-11-06 04:00:00,,,,177,,,36,,,44,,,9,,,,,,,,,,,,,,,,,,,,
500,https://vlr.gg/player/3519/jkuro,2024-11-06 04:00:00,,,,172,,,33,,,41,,,16,,,,,,,,,,,,,,,,,,,,
501,https://vlr.gg/player/3049/sword9,2024-11-06 04:00:00,,,,138,,,26,,,42,,,16,,,,,,,,,,,,,,,,,,,,
0,https://vlr.gg/player/48924/f0rest,2024-11-06 03:00:00,1.32,0.79,1.03,202,264,160,34,21,13,32,13,19,19,11,8,0,+1,-1,74%,90%,60%,123,155,97,38%,33%,44%,4,2,2,4,1,3
1,https://vlr.gg/player/48926/sirius,2024-11-06 03:00:00,0.76,1.06,0.92,205,167,242,34,12,22,37,16,21,9,5,4,+1,+1,0,70%,71%,68%,135,113,153,35%,30%,39%,6,3,3,5,2,3
2,https://vlr.gg/player/48923/vista,2024-11-06 03:00:00,1.35,0.55,0.91,199,285,124,29,21,8,35,14,21,15,8,7,+2,+1,+1,72%,86%,60%,137,189,93,29%,37%,18%,6,3,3,4,2,2
3,https://vlr.gg/player/48927/xuka,2024-11-06 03:00:00,0.99,0.82,0.89,162,182,150,29,17,12,31,14,17,12,3,9,+1,+1,0,67%,76%,60%,106,108,104,29%,37%,23%,2,1,1,1,0,1
4,https://vlr.gg/player/48925/raxcal,2024-11-06 03:00:00,0.67,0.45,0.55,167,198,145,24,13,11,39,17,22,10,6,4,-8,-3,-5,63%,67%,60%,113,127,102,17%,14%,20%,3,2,1,11,5,6
5,https://vlr.gg/player/25048/sid,2024-11-06 03:00:00,1.57,1.42,1.50,296,311,300,49,30,19,33,13,20,19,8,11,+2,+4,-2,83%,92%,71%,203,200,207,28%,29%,27%,10,6,4,8,2,6
6,https://vlr.gg/player/42772/xross,2024-11-06 03:00:00,1.44,1.14,1.30,260,270,241,40,24,16,32,15,17,21,13,8,+2,+1,+1,80%,84%,76%,182,196,165,33%,33%,33%,5,2,3,3,1,2
7,https://vlr.gg/player/24979/cloy,2024-11-06 03:00:00,1.08,1.01,1.05,219,194,229,32,16,16,31,14,17,23,16,7,-2,-2,0,80%,92%,67%,135,129,142,25%,33%,20%,4,2,2,6,4,2
8,https://vlr.gg/player/42793/kally,2024-11-06 03:00:00,1.18,0.73,0.97,160,180,130,25,16,9,28,12,16,13,7,6,+1,+2,-1,78%,88%,67%,104,119,87,38%,43%,31%,3,3,0,2,1,1
9,https://vlr.gg/player/27444/banger,2024-11-06 03:00:00,1.03,0.77,0.91,165,171,169,28,16,12,28,12,16,7,4,3,+1,0,+1,76%,84%,67%,108,113,103,32%,29%,35%,3,2,1,2,2,0
10,https://vlr.gg/player/38857/beng,2024-11-05 16:30:00,1.73,1.74,1.73,302,339,262,49,27,22,25,15,10,22,14,8,+5,+2,+3,91%,91%,90%,206,225,185,41%,41%,43%,5,2,3,0,0,0
11,https://vlr.gg/player/2909/alca,2024-11-05 16:30:00,0.91,1.68,1.28,252,179,331,39,15,24,29,15,14,12,6,6,0,-3,+3,70%,57%,86%,174,135,217,34%,39%,31%,7,3,4,7,6,1
12,https://vlr.gg/player/1309/tio,2024-11-05 16:30:00,0.82,1.23,1.02,184,171,200,28,12,16,31,17,14,24,14,10,+3,+2,+1,82%,74%,90%,116,111,122,15%,14%,16%,5,2,3,2,0,2
13,https://vlr.gg/player/8278/knzy,2024-11-05 16:30:00,1.06,0.89,0.98,160,163,154,26,15,11,30,15,15,17,5,12,+4,-1,+5,80%,78%,81%,90,91,90,11%,9%,13%,6,1,5,2,2,0
14,https://vlr.gg/player/8730/1kuzohh,2024-11-05 16:30:00,0.70,0.86,0.78,201,196,205,27,13,14,35,18,17,20,10,10,-4,-3,-1,80%,74%,86%,139,138,141,19%,20%,17%,3,2,1,7,5,2
15,https://vlr.gg/player/43926/crazy-ny,2024-11-05 16:30:00,1.20,1.29,1.25,264,283,253,40,20,20,33,17,16,9,4,5,+2,0,+2,75%,71%,78%,176,190,163,29%,25%,34%,3,0,3,1,0,1
16,https://vlr.gg/player/35739/evoluzionz,2024-11-05 16:30:00,1.08,1.18,1.13,193,199,188,30,14,16,27,15,12,12,7,5,-3,-3,0,70%,67%,74%,123,140,108,24%,23%,26%,1,0,1,4,3,1
17,https://vlr.gg/player/3677/fross,2024-11-05 16:30:00,0.93,0.80,0.86,179,171,184,30,14,16,34,16,18,16,10,6,-2,-1,-1,73%,81%,65%,108,102,112,25%,34%,20%,2,1,1,4,2,2
18,https://vlr.gg/player/46902/21,2024-11-05 16:30:00,0.48,0.95,0.73,182,165,201,26,12,14,37,19,18,14,5,9,-2,-1,-1,73%,67%,78%,119,99,137,10%,10%,10%,3,0,3,5,1,4
19,https://vlr.gg/player/35665/miyeon,2024-11-05 16:30:00,0.25,0.80,0.54,171,159,183,23,9,14,38,21,17,12,5,7,-3,-6,+3,66%,62%,70%,113,111,116,18%,19%,18%,9,4,5,12,10,2
20,https://vlr.gg/player/19365/sia,2024-11-05 15:30:00,1.25,1.00,1.12,212,220,204,38,19,19,33,14,19,12,5,7,-5,-3,-2,62%,68%,57%,144,137,150,40%,36%,45%,1,0,1,6,3,3
21,https://vlr.gg/player/45174/purity,2024-11-05 15:30:00,0.95,1.26,1.11,196,161,230,30,12,18,30,14,16,13,4,9,+2,0,+2,76%,73%,78%,128,114,141,17%,16%,17%,4,2,2,2,2,0
22,https://vlr.gg/player/9434/samsi,2024-11-05 15:30:00,1.03,0.93,0.98,202,235,171,33,20,13,32,16,16,5,2,3,+2,+2,0,82%,86%,78%,142,165,119,27%,30%,24%,5,3,2,3,1,2
23,https://vlr.gg/player/30241/majusia,2024-11-05 15:30:00,1.10,0.56,0.82,219,269,174,34,21,13,38,17,21,4,1,3,-5,-2,-3,49%,50%,48%,138,166,112,33%,33%,33%,7,3,4,12,5,7
24,https://vlr.gg/player/29793/moshieroo,2024-11-05 15:30:00,0.67,0.69,0.68,140,112,167,23,9,14,33,14,19,14,7,7,-5,-3,-2,64%,68%,61%,91,78,103,26%,21%,31%,0,0,0,5,3,2
25,https://vlr.gg/player/20730/karina,2024-11-05 15:30:00,1.43,1.18,1.31,223,237,210,38,21,17,28,13,15,9,6,3,+3,+3,0,71%,78%,64%,150,164,137,32%,30%,34%,4,3,1,1,0,1
26,https://vlr.gg/player/20112/kxoma,2024-11-05 15:30:00,1.23,0.84,1.04,177,209,144,31,20,11,28,12,16,12,5,7,+1,0,+1,73%,74%,73%,115,132,97,23%,22%,23%,3,1,2,2,1,1
27,https://vlr.gg/player/40524/star,2024-11-05 15:30:00,0.76,1.26,1.01,206,179,233,30,12,18,31,18,13,15,8,7,+2,+2,0,62%,65%,59%,137,122,153,26%,23%,31%,7,3,4,5,1,4
28,https://vlr.gg/player/40177/leeni,2024-11-05 15:30:00,1.01,0.91,0.96,240,257,222,38,22,16,37,19,18,6,2,4,+5,+2,+3,58%,61%,55%,155,173,136,36%,45%,26%,12,7,5,7,5,2
29,https://vlr.gg/player/46438/taromie,2024-11-05 15:30:00,1.12,0.65,0.89,186,194,175,29,16,13,34,15,19,26,19,7,0,-2,+2,76%,83%,68%,122,126,118,19%,16%,24%,2,0,2,2,2,0
30,https://vlr.gg/player/22501/amore,2024-11-05 14:25:00,1.10,0.53,0.91,228,261,163,14,11,3,14,9,5,0,0,0,-3,-3,0,61%,50%,83%,137,149,112,22%,21%,29%,1,1,0,4,4,0
31,https://vlr.gg/player/22154/pika,2024-11-05 14:25:00,1.07,0.16,0.77,135,155,97,6,5,1,12,7,5,8,5,3,0,+1,-1,72%,83%,50%,94,102,78,32%,35%,25%,2,2,0,2,1,1
32,https://vlr.gg/player/5487/adm1k,2024-11-05 14:25:00,0.97,0.33,0.75,199,226,144,11,9,2,14,9,5,1,1,0,0,-1,+1,61%,67%,50%,135,152,100,28%,40%,11%,1,0,1,1,1,0
33,https://vlr.gg/player/2893/hastack,2024-11-05 14:25:00,0.58,0.76,0.64,120,74,212,6,2,4,14,8,6,6,5,1,-2,-1,-1,72%,67%,83%,84,61,130,22%,13%,36%,1,0,1,3,1,2
34,https://vlr.gg/player/2996/neiker,2024-11-05 14:25:00,0.80,0.06,0.56,132,182,34,9,8,1,14,9,5,4,3,1,-1,0,-1,50%,50%,50%,86,122,15,37%,44%,0%,1,1,0,2,1,1
35,https://vlr.gg/player/14894/facepalm,2024-11-05 14:25:00,1.91,1.62,1.72,236,264,224,18,7,11,6,2,4,1,0,1,+5,+2,+3,83%,100%,75%,153,179,139,32%,29%,35%,5,2,3,0,0,0
36,https://vlr.gg/player/16139/enrik,2024-11-05 14:25:00,1.76,1.11,1.32,206,241,189,13,5,8,8,2,6,11,6,5,-1,-1,0,83%,100%,75%,135,180,113,21%,14%,27%,2,0,2,3,1,2
37,https://vlr.gg/player/22314/mober,2024-11-05 14:25:00,1.36,1.10,1.18,216,230,210,14,5,9,11,3,8,9,3,6,-1,-1,0,72%,83%,67%,156,180,145,41%,50%,35%,0,0,0,1,1,0
38,https://vlr.gg/player/2853/apex,2024-11-05 14:25:00,1.09,0.98,1.01,206,201,210,13,4,9,12,3,9,9,5,4,+4,+2,+2,72%,83%,67%,135,136,135,29%,40%,24%,5,2,3,1,0,1
39,https://vlr.gg/player/32300/varuxx,2024-11-05 14:25:00,1.45,0.74,0.98,160,176,152,10,5,5,9,1,8,6,1,5,-1,0,-1,83%,100%,75%,101,97,103,8%,17%,4%,0,0,0,1,0,1
40,https://vlr.gg/player/29243/neon,2024-11-05 14:00:00,0.96,1.36,1.17,238,196,276,37,15,22,32,16,16,9,3,6,+1,-3,+4,72%,68%,75%,157,127,185,30%,33%,27%,7,1,6,6,4,2
41,https://vlr.gg/player/29242/erde,2024-11-05 14:00:00,1.00,1.14,1.07,198,207,195,31,16,15,32,18,14,14,6,8,-2,0,-2,76%,73%,79%,143,147,139,26%,26%,25%,4,3,1,6,3,3
42,https://vlr.gg/player/29244/mikey-tap,2024-11-05 14:00:00,0.91,1.14,1.03,233,205,253,38,16,22,35,18,17,15,9,6,+2,0,+2,72%,68%,75%,153,143,163,37%,35%,38%,4,2,2,2,2,0
43,https://vlr.gg/player/29241/miradaninja,2024-11-05 14:00:00,1.01,0.97,0.99,203,218,187,34,18,16,32,17,15,12,6,6,0,-1,+1,65%,64%,67%,130,145,117,30%,30%,31%,6,2,4,6,3,3
44,https://vlr.gg/player/29240/skyppervz,2024-11-05 14:00:00,0.70,1.23,0.98,189,171,206,31,12,19,33,20,13,16,8,8,-1,0,-1,72%,68%,75%,125,103,145,31%,39%,27%,2,1,1,3,1,2
45,https://vlr.gg/player/783/murizzz,2024-11-05 14:00:00,1.06,1.46,1.25,247,222,278,37,16,21,33,19,14,17,7,10,+1,+1,0,72%,54%,91%,171,154,189,27%,27%,27%,4,2,2,3,1,2
46,https://vlr.gg/player/3828/tacolilla,2024-11-05 14:00:00,0.91,1.32,1.10,240,184,303,39,17,22,34,18,16,15,6,9,-1,-3,+2,74%,67%,82%,159,131,188,25%,22%,28%,5,1,4,6,4,2
47,https://vlr.gg/player/2464/suther,2024-11-05 14:00:00,0.94,1.15,1.04,203,159,253,34,15,19,34,18,16,17,9,8,+5,+3,+2,78%,83%,73%,131,120,143,24%,27%,22%,6,3,3,1,0,1
48,https://vlr.gg/player/12872/david,2024-11-05 14:00:00,0.93,0.87,0.90,173,175,167,29,16,13,33,18,15,19,6,13,-1,0,-1,63%,54%,73%,103,121,84,20%,36%,9%,2,1,1,3,1,2
49,https://vlr.gg/player/13860/rubkkoide,2024-11-05 14:00:00,0.45,0.82,0.63,163,135,194,25,11,14,37,21,16,5,3,2,-4,-5,+1,54%,50%,59%,112,91,136,21%,23%,19%,6,3,3,10,8,2
50,https://vlr.gg/player/2886/drk,2024-11-05 13:10:00,1.09,1.07,1.08,184,169,201,17,7,10,15,8,7,8,7,1,0,0,0,78%,83%,73%,113,106,122,38%,46%,33%,0,0,0,0,0,0
51,https://vlr.gg/player/4951/hardy,2024-11-05 13:10:00,1.33,0.69,1.03,218,227,209,17,10,7,17,8,9,7,3,4,0,-1,+1,78%,75%,82%,159,172,146,33%,43%,24%,3,1,2,3,2,1
52,https://vlr.gg/player/29974/erizillo,2024-11-05 13:10:00,1.13,0.84,0.99,146,170,120,12,7,5,15,8,7,10,6,4,+1,0,+1,87%,83%,91%,97,98,95,26%,20%,36%,1,0,1,0,0,0
53,https://vlr.gg/player/42557/6ankai,2024-11-05 13:10:00,0.40,1.37,0.86,198,103,302,16,5,11,17,9,8,6,1,5,-3,-4,+1,61%,50%,73%,146,88,208,29%,29%,30%,2,0,2,5,4,1
54,https://vlr.gg/player/42521/jahbu,2024-11-05 13:10:00,0.77,0.38,0.59,168,216,116,13,9,4,19,10,9,2,0,2,-1,+1,-2,52%,58%,45%,111,135,85,36%,43%,25%,4,3,1,5,2,3
55,https://vlr.gg/player/23082/cobra,2024-11-05 13:10:00,1.54,1.38,1.46,249,263,237,21,11,10,12,6,6,8,6,2,0,0,0,83%,82%,83%,164,168,161,26%,23%,29%,1,0,1,1,0,1
56,https://vlr.gg/player/48956/bujaxd,2024-11-05 13:10:00,1.27,1.36,1.32,214,169,257,19,8,11,13,6,7,10,5,5,-3,-3,0,70%,73%,67%,134,94,170,37%,31%,41%,0,0,0,3,3,0
57,https://vlr.gg/player/48953/t1tan,2024-11-05 13:10:00,1.20,0.69,0.93,209,273,151,17,10,7,16,8,8,4,3,1,+1,+1,0,70%,73%,67%,134,171,101,42%,47%,36%,4,3,1,3,2,1
58,https://vlr.gg/player/48955/dubstep,2024-11-05 13:10:00,0.78,0.95,0.87,176,132,217,13,4,9,17,8,9,5,3,2,+1,0,+1,65%,64%,67%,120,100,138,36%,13%,63%,2,0,2,1,0,1
59,https://vlr.gg/player/48952/xpiryy,2024-11-05 13:10:00,0.89,0.80,0.84,168,190,150,13,7,6,17,9,8,2,1,1,+4,+1,+3,78%,82%,75%,110,127,94,29%,42%,19%,6,2,4,2,1,1
60,https://vlr.gg/player/41207/jade,2024-11-05 12:00:00,1.56,1.21,1.45,237,245,222,16,11,5,10,7,3,10,9,1,0,0,0,100%,100%,100%,144,150,132,12%,21%,0%,0,0,0,0,0,0
61,https://vlr.gg/player/37969/ellie,2024-11-05 12:00:00,0.85,1.73,1.25,278,210,363,60,24,36,44,30,14,20,12,8,+3,-6,+9,74%,68%,82%,166,141,196,32%,35%,27%,16,5,11,13,11,2
62,https://vlr.gg/player/17318/blossi,2024-11-05 12:00:00,1.17,1.11,1.15,208,219,187,46,26,20,36,24,12,22,11,11,-3,0,-3,76%,71%,82%,132,146,116,32%,29%,37%,2,1,1,5,1,4
63,https://vlr.gg/player/12623/f4int,2024-11-05 12:00:00,1.05,1.15,1.10,203,215,192,31,17,14,25,15,10,20,8,12,+3,+1,+2,80%,77%,82%,133,147,118,20%,20%,20%,3,1,2,0,0,0
64,https://vlr.gg/player/30042/harmonee,2024-11-05 12:00:00,0.73,1.28,0.98,180,152,220,39,18,21,37,24,13,17,6,11,+2,+3,-1,69%,62%,79%,127,103,156,22%,16%,28%,6,5,1,4,2,2
65,https://vlr.gg/player/19373/ginger,2024-11-05 12:00:00,0.98,0.91,0.95,187,218,150,40,26,14,39,26,13,15,6,9,+7,+2,+5,76%,71%,82%,119,141,91,25%,30%,19%,10,5,5,3,3,0
66,https://vlr.gg/player/30163/tessko,2024-11-05 12:00:00,0.67,1.41,1.07,191,136,237,42,12,30,41,22,19,14,5,9,-2,-2,0,60%,46%,71%,128,92,158,17%,13%,20%,1,1,0,3,3,0
67,https://vlr.gg/player/38997/eggy,2024-11-05 12:00:00,0.99,0.85,0.91,186,163,201,40,16,24,49,21,28,21,9,12,-2,-3,+1,56%,46%,65%,124,112,133,23%,17%,29%,6,1,5,8,4,4
68,https://vlr.gg/player/30211/lizz,2024-11-05 12:00:00,0.77,0.99,0.89,172,141,206,39,14,25,47,23,24,11,7,4,-1,0,-1,63%,54%,71%,117,89,140,45%,47%,44%,3,1,2,4,1,3
69,https://vlr.gg/player/38097/mais,2024-11-05 12:00:00,0.54,1.06,0.82,172,129,208,36,11,25,48,23,25,16,3,13,0,-2,+2,53%,46%,59%,106,81,126,25%,45%,18%,9,5,4,9,7,2
70,https://vlr.gg/player/40181/sofia,2024-11-05 12:00:00,0.72,0.80,0.76,161,129,191,34,12,22,47,21,26,8,3,5,-7,-5,-2,50%,46%,53%,105,83,123,43%,41%,45%,6,0,6,13,5,8
71,https://vlr.gg/player/48950/zeni,2024-11-05 12:00:00,1.02,0.98,1.00,203,217,197,11,4,7,13,4,9,9,4,5,-2,0,-2,78%,100%,67%,139,159,129,24%,27%,23%,0,0,0,2,0,2
72,https://vlr.gg/player/48951/hassan,2024-11-05 12:00:00,1.27,0.67,0.87,179,274,132,13,7,6,14,5,9,1,0,1,+2,+2,0,67%,83%,58%,130,165,113,38%,33%,41%,2,2,0,0,0,0
73,https://vlr.gg/player/46233/kz,2024-11-05 12:00:00,1.10,0.48,0.69,185,266,145,11,6,5,16,5,11,1,1,0,+1,+2,-1,50%,67%,42%,116,143,102,29%,19%,40%,4,2,2,3,0,3
74,https://vlr.gg/player/33833/pepecho,2024-11-05 12:00:00,0.56,0.56,0.56,119,114,122,7,2,5,14,5,9,9,4,5,-2,0,-2,61%,67%,58%,68,82,62,37%,25%,45%,0,0,0,2,0,2
75,https://vlr.gg/player/44130/bern1,2024-11-05 12:00:00,0.17,0.55,0.43,121,74,145,7,1,6,15,5,10,4,1,3,-1,-2,+1,67%,50%,75%,84,71,90,12%,11%,13%,2,0,2,3,2,1
76,https://vlr.gg/player/22291/razziss,2024-11-05 12:00:00,1.60,1.59,1.59,323,310,350,21,14,7,11,6,5,3,1,2,+2,+3,-1,89%,92%,83%,209,206,217,30%,34%,24%,6,5,1,4,2,2
77,https://vlr.gg/player/8595/skygi,2024-11-05 12:00:00,1.45,1.80,1.57,277,263,306,19,12,7,10,7,3,5,3,2,-1,0,-1,89%,92%,83%,170,161,189,42%,46%,37%,0,0,0,1,0,1
78,https://vlr.gg/player/22495/mochi,2024-11-05 12:00:00,1.24,1.34,1.27,207,203,216,15,10,5,10,6,4,5,2,3,+1,0,+1,78%,83%,67%,132,134,128,24%,27%,17%,2,1,1,1,1,0
79,https://vlr.gg/player/16012/akira,2024-11-05 12:00:00,0.95,0.94,0.94,144,163,110,9,7,2,8,5,3,10,5,5,0,0,0,78%,75%,83%,116,128,91,23%,32%,12%,1,1,0,1,1,0
80,https://vlr.gg/player/15487/aqua,2024-11-05 12:00:00,0.94,0.51,0.80,125,123,130,8,5,3,10,5,5,4,3,1,0,+1,-1,89%,92%,83%,94,90,103,30%,38%,18%,1,1,0,1,0,1
81,https://vlr.gg/player/41477/tysonrcx,2024-11-05 03:20:00,0.71,1.24,0.96,191,179,205,20,9,11,27,16,11,9,3,6,+1,+1,0,68%,67%,69%,135,130,140,25%,31%,20%,1,1,0,0,0,0
82,https://vlr.gg/player/41476/d4tt,2024-11-05 03:20:00,0.81,0.79,0.80,170,189,147,21,11,10,31,17,14,5,2,3,0,+2,-2,56%,44%,69%,109,117,101,38%,40%,35%,2,2,0,2,0,2
83,https://vlr.gg/player/22833/bru,2024-11-05 03:20:00,0.49,0.73,0.61,158,141,176,18,8,10,32,18,14,8,4,4,-8,-4,-4,53%,50%,56%,92,87,97,18%,16%,20%,3,2,1,11,6,5
84,https://vlr.gg/player/41478/wintr,2024-11-05 03:20:00,0.45,0.76,0.60,168,139,201,18,8,10,33,18,15,6,1,5,-2,-1,-1,65%,50%,81%,117,100,137,27%,30%,25%,1,1,0,3,2,1
85,https://vlr.gg/player/44701/akanekay,2024-11-05 03:20:00,0.37,0.53,0.44,152,143,165,16,8,8,33,18,15,5,2,3,+1,-2,+3,56%,44%,69%,98,91,105,14%,21%,9%,6,1,5,5,3,2
86,https://vlr.gg/player/34257/strame,2024-11-05 03:20:00,1.27,1.80,1.55,285,259,305,37,14,23,17,10,7,10,7,3,+3,+3,0,94%,94%,94%,189,173,203,36%,28%,43%,3,3,0,0,0,0
87,https://vlr.gg/player/28843/abbas,2024-11-05 03:20:00,1.57,1.36,1.46,279,292,269,36,18,18,19,9,10,20,9,11,+6,+2,+4,88%,88%,89%,174,198,152,24%,32%,17%,7,2,5,1,0,1
88,https://vlr.gg/player/10089/andy,2024-11-05 03:20:00,1.11,1.69,1.42,247,236,254,31,14,17,15,9,6,8,1,7,+3,+1,+2,82%,75%,89%,167,165,169,27%,26%,29%,5,2,3,2,1,1
89,https://vlr.gg/player/48913/zek,2024-11-05 03:20:00,0.72,1.53,1.15,238,176,292,32,10,22,23,13,10,4,1,3,0,+1,-1,91%,94%,89%,158,110,200,29%,36%,24%,3,2,1,3,1,2
90,https://vlr.gg/player/33714/vina,2024-11-05 03:20:00,1.37,0.81,1.08,179,209,155,20,13,7,19,8,11,15,6,9,-4,-3,-1,76%,75%,78%,138,147,129,28%,34%,23%,3,1,2,7,4,3
91,https://vlr.gg/player/27550/exirst,2024-11-05 02:30:00,0.97,1.20,1.09,244,250,238,34,16,18,35,19,16,10,4,6,+1,+4,-3,64%,67%,62%,166,169,163,26%,26%,27%,8,6,2,7,2,5
92,https://vlr.gg/player/11106/m1ke,2024-11-05 02:30:00,1.14,1.01,1.07,213,212,215,30,15,15,30,14,16,11,4,7,+2,+2,0,67%,62%,71%,142,139,146,26%,27%,24%,4,4,0,2,2,0
93,https://vlr.gg/player/31629/muzz,2024-11-05 02:30:00,0.90,1.03,0.96,182,178,186,28,14,14,31,16,15,9,6,3,+1,-1,+2,67%,57%,76%,123,115,130,35%,40%,32%,4,1,3,3,2,1
94,https://vlr.gg/player/1176/nozz,2024-11-05 02:30:00,0.61,1.26,0.94,204,141,268,29,11,18,34,18,16,18,5,13,0,-1,+1,67%,57%,76%,137,96,177,26%,23%,28%,3,1,2,3,2,1
95,https://vlr.gg/player/14336/loubert,2024-11-05 02:30:00,0.44,0.47,0.46,112,85,140,13,4,9,36,17,19,18,10,8,-2,+1,-3,62%,67%,57%,76,57,96,19%,11%,26%,3,1,2,5,0,5
96,https://vlr.gg/player/43129/dasani,2024-11-05 02:30:00,1.69,1.49,1.59,322,347,297,50,27,23,29,15,14,7,4,3,+5,+5,0,79%,86%,71%,213,232,195,39%,46%,31%,13,8,5,8,3,5
97,https://vlr.gg/player/15078/noir,2024-11-05 02:30:00,0.97,1.37,1.17,203,169,237,30,13,17,23,12,11,18,9,9,-4,-1,-3,76%,71%,81%,151,123,178,28%,26%,29%,2,1,1,6,2,4
98,https://vlr.gg/player/22831/art,2024-11-05 02:30:00,1.12,1.15,1.13,207,203,212,33,15,18,26,14,12,18,11,7,0,0,0,81%,86%,76%,132,130,134,27%,27%,27%,0,0,0,0,0,0
99,https://vlr.gg/player/22829/ibrocky,2024-11-05 02:30:00,0.84,1.14,0.99,187,169,205,23,12,11,26,15,11,24,9,15,-3,-1,-2,79%,76%,81%,133,114,151,24%,35%,19%,2,1,1,5,2,3
100,https://vlr.gg/player/33061/brock,2024-11-05 02:30:00,0.88,1.08,0.98,191,210,173,30,15,15,30,18,12,15,7,8,0,0,0,74%,76%,71%,125,152,97,16%,18%,14%,3,2,1,3,2,1
101,https://vlr.gg/player/47212/ecco,2024-11-05 02:30:00,1.55,1.42,1.49,298,335,250,49,30,19,24,15,9,8,2,6,-1,0,-1,79%,75%,83%,204,220,183,46%,45%,47%,3,3,0,4,3,1
102,https://vlr.gg/player/49003/cybxr,2024-11-05 02:30:00,1.08,1.47,1.25,245,198,308,35,17,18,25,14,11,17,14,3,+2,-1,+3,79%,83%,72%,153,132,180,40%,38%,42%,5,1,4,3,2,1
103,https://vlr.gg/player/46768/indraa,2024-11-05 02:30:00,1.35,1.08,1.24,275,300,242,40,24,16,29,15,14,13,9,4,-1,0,-1,81%,79%,83%,177,198,148,20%,21%,20%,8,6,2,9,6,3
104,https://vlr.gg/player/46994/tisoyy,2024-11-05 02:30:00,1.05,0.96,1.02,157,156,158,23,14,9,20,11,9,14,9,5,+1,0,+1,86%,75%,100%,109,112,105,22%,32%,13%,1,0,1,0,0,0
105,https://vlr.gg/player/36676/novae,2024-11-05 02:30:00,0.83,0.85,0.84,181,190,171,28,17,11,30,18,12,4,2,2,-1,+1,-2,69%,63%,78%,115,107,126,35%,42%,26%,4,2,2,5,1,4
106,https://vlr.gg/player/42196/icy,2024-11-05 02:30:00,1.29,0.99,1.12,213,274,168,31,17,14,31,14,17,9,5,4,+1,+2,-1,69%,72%,67%,143,183,113,26%,28%,24%,8,5,3,7,3,4
107,https://vlr.gg/player/48911/kruise,2024-11-05 02:30:00,0.79,1.13,0.99,217,185,243,30,10,20,34,16,18,6,5,1,+3,0,+3,62%,72%,54%,148,123,167,24%,18%,29%,6,0,6,3,0,3
108,https://vlr.gg/player/44694/dazeryuf,2024-11-05 02:30:00,1.14,0.68,0.88,209,224,198,29,14,15,40,16,24,18,10,8,-2,0,-2,71%,72%,71%,134,141,129,31%,26%,37%,1,1,0,3,1,2
109,https://vlr.gg/player/48912/kookie,2024-11-05 02:30:00,0.62,0.67,0.65,149,137,158,21,8,13,34,13,21,6,3,3,+1,+1,0,55%,50%,58%,95,92,97,19%,30%,13%,5,3,2,4,2,2
110,https://vlr.gg/player/43105/capy,2024-11-05 02:30:00,0.25,0.66,0.48,127,80,163,16,5,11,36,15,21,16,5,11,-3,-3,0,67%,61%,71%,82,51,104,35%,36%,34%,1,0,1,4,3,1
111,https://vlr.gg/player/35739/evoluzionz,2024-11-04 16:00:00,0.87,1.22,1.07,203,162,234,43,14,29,44,20,24,15,9,6,+4,0,+4,81%,78%,83%,135,114,151,22%,18%,25%,7,1,6,3,1,2
112,https://vlr.gg/player/3677/fross,2024-11-04 16:00:00,1.21,0.90,1.04,183,223,156,40,21,19,42,17,25,32,13,19,-3,-3,0,68%,63%,72%,122,143,106,26%,27%,25%,2,0,2,5,3,2
113,https://vlr.gg/player/43926/crazy-ny,2024-11-04 16:00:00,0.89,0.98,0.94,155,136,172,38,14,24,41,18,23,17,11,6,0,0,0,73%,67%,78%,108,87,124,37%,33%,39%,2,0,2,2,0,2
114,https://vlr.gg/player/46902/21,2024-11-04 16:00:00,1.09,0.81,0.93,180,228,147,42,23,19,45,20,25,17,8,9,-1,-3,+2,76%,78%,75%,111,139,90,25%,25%,25%,5,1,4,6,4,2
115,https://vlr.gg/player/35665/miyeon,2024-11-04 16:00:00,0.55,1.21,0.93,241,168,297,49,14,35,53,23,30,15,6,9,-3,-3,0,60%,48%,69%,165,118,200,27%,27%,27%,14,7,7,17,10,7
116,https://vlr.gg/player/3828/tacolilla,2024-11-04 16:00:00,1.12,1.34,1.21,209,175,251,47,23,24,39,21,18,15,9,6,+6,-1,+7,79%,81%,78%,144,130,163,26%,28%,23%,7,0,7,1,1,0
117,https://vlr.gg/player/13860/rubkkoide,2024-11-04 16:00:00,0.91,1.41,1.12,242,220,273,53,27,26,44,27,17,12,7,5,-2,-5,+3,67%,58%,78%,158,145,175,30%,32%,28%,12,6,6,14,11,3
118,https://vlr.gg/player/2464/suther,2024-11-04 16:00:00,1.00,1.18,1.08,181,180,179,42,24,18,40,24,16,34,17,17,-4,-3,-1,75%,75%,74%,128,126,130,24%,32%,17%,2,1,1,6,4,2
119,https://vlr.gg/player/783/murizzz,2024-11-04 16:00:00,1.04,0.80,0.94,198,237,150,45,30,15,47,30,17,17,12,5,+4,+6,-2,67%,67%,67%,123,148,90,31%,32%,29%,8,7,1,4,1,3
120,https://vlr.gg/player/12872/david,2024-11-04 16:00:00,0.99,0.82,0.92,185,196,168,38,23,15,42,24,18,30,21,9,-1,-3,+2,75%,72%,78%,117,125,106,28%,34%,20%,4,1,3,5,4,1
121,https://vlr.gg/player/22314/mober,2024-11-04 14:00:00,1.08,1.28,1.18,203,234,173,24,13,11,17,11,6,3,2,1,-1,0,-1,79%,79%,79%,137,153,121,40%,29%,59%,1,1,0,2,1,1
122,https://vlr.gg/player/14894/facepalm,2024-11-04 14:00:00,1.13,0.98,1.05,232,207,258,23,11,12,20,9,11,5,2,3,+2,+1,+1,68%,71%,64%,155,125,185,35%,29%,41%,6,4,2,4,3,1
123,https://vlr.gg/player/2853/apex,2024-11-04 14:00:00,0.56,1.41,0.99,215,189,242,21,9,12,20,14,6,7,3,4,0,-1,+1,79%,71%,86%,147,141,153,30%,17%,53%,2,0,2,2,1,1
124,https://vlr.gg/player/32300/varuxx,2024-11-04 14:00:00,0.83,1.10,0.97,219,188,251,20,9,11,21,11,10,5,1,4,+5,+1,+4,68%,57%,79%,134,122,146,29%,48%,9%,7,2,5,2,1,1
125,https://vlr.gg/player/16139/enrik,2024-11-04 14:00:00,0.56,0.46,0.51,112,129,95,8,4,4,21,12,9,13,8,5,+2,+1,+1,64%,64%,64%,83,95,71,14%,7%,31%,2,1,1,0,0,0
126,https://vlr.gg/player/22495/mochi,2024-11-04 14:00:00,0.97,1.48,1.23,225,205,246,25,10,15,19,11,8,5,3,2,-2,-3,+1,64%,57%,71%,132,127,136,25%,27%,24%,2,0,2,4,3,1
127,https://vlr.gg/player/16012/akira,2024-11-04 14:00:00,1.14,1.20,1.17,219,232,206,21,11,10,18,10,8,9,2,7,0,+1,-1,82%,79%,86%,143,138,147,40%,47%,35%,2,2,0,2,1,1
128,https://vlr.gg/player/8595/skygi,2024-11-04 14:00:00,0.62,1.52,1.07,199,121,278,19,5,14,21,12,9,12,5,7,-3,-2,-1,75%,64%,86%,127,70,184,31%,33%,30%,2,0,2,5,2,3
129,https://vlr.gg/player/22291/razziss,2024-11-04 14:00:00,0.82,1.30,1.06,196,150,243,20,8,12,17,9,8,5,0,5,-2,-2,0,75%,64%,86%,130,100,160,24%,25%,23%,2,1,1,4,3,1
130,https://vlr.gg/player/15487/aqua,2024-11-04 14:00:00,1.03,0.44,0.73,156,165,148,14,8,6,21,8,13,6,1,5,-1,0,-1,68%,64%,71%,109,114,103,25%,24%,26%,2,1,1,3,1,2
131,https://vlr.gg/player/29243/neon,2024-11-04 14:00:00,2.13,1.51,1.86,331,353,299,44,27,17,16,7,9,9,5,4,+6,+2,+4,89%,90%,88%,211,230,187,38%,34%,46%,10,2,8,4,0,4
132,https://vlr.gg/player/29242/erde,2024-11-04 14:00:00,1.15,1.56,1.33,251,255,244,33,18,15,19,13,6,7,4,3,+2,+1,+1,81%,75%,88%,164,170,156,30%,28%,34%,3,2,1,1,1,0
133,https://vlr.gg/player/29240/skyppervz,2024-11-04 14:00:00,0.97,1.26,1.10,197,167,241,29,14,15,22,13,9,10,7,3,-1,-1,0,81%,75%,88%,137,111,169,37%,48%,31%,2,1,1,3,2,1
134,https://vlr.gg/player/29241/miradaninja,2024-11-04 14:00:00,0.52,1.44,0.93,203,163,260,27,12,15,23,16,7,9,4,5,+1,0,+1,81%,70%,94%,132,98,175,36%,41%,33%,5,4,1,4,4,0
135,https://vlr.gg/player/29244/mikey-tap,2024-11-04 14:00:00,0.95,0.88,0.92,173,158,186,21,11,10,22,11,11,12,5,7,-2,-2,0,78%,65%,94%,115,109,123,33%,32%,33%,1,1,0,3,3,0
136,https://vlr.gg/player/38857/beng,2024-11-04 14:00:00,0.87,1.09,0.99,178,143,212,25,9,16,28,13,15,6,3,3,+2,0,+2,56%,56%,55%,106,74,132,31%,25%,34%,7,2,5,5,2,3
137,https://vlr.gg/player/8730/1kuzohh,2024-11-04 14:00:00,0.65,0.97,0.83,218,193,235,24,10,14,32,16,16,5,2,3,-3,0,-3,58%,56%,60%,138,138,138,22%,24%,19%,3,3,0,6,3,3
138,https://vlr.gg/player/8278/knzy,2024-11-04 14:00:00,0.50,0.88,0.71,154,107,193,19,6,13,30,14,16,7,2,5,-1,-1,0,58%,50%,65%,98,82,112,17%,14%,19%,2,0,2,3,1,2
139,https://vlr.gg/player/1309/tio,2024-11-04 14:00:00,0.74,0.59,0.65,141,166,130,16,9,7,31,14,17,15,5,10,-2,-2,0,61%,56%,65%,101,113,91,16%,15%,18%,0,0,0,2,2,0
140,https://vlr.gg/player/2909/alca,2024-11-04 14:00:00,0.55,0.67,0.62,162,158,158,18,8,10,33,15,18,9,5,4,-2,-3,+1,58%,50%,65%,105,102,106,25%,17%,36%,3,0,3,5,3,2
141,https://vlr.gg/player/44137/levi,2024-11-04 13:00:00,1.25,1.76,1.42,269,270,270,19,13,6,9,8,1,1,0,1,-1,-2,+1,83%,75%,100%,171,179,154,22%,25%,13%,1,0,1,2,2,0
142,https://vlr.gg/player/2862/chechuu,2024-11-04 13:00:00,1.45,1.00,1.30,211,245,144,15,11,4,8,6,2,6,6,0,0,+1,-1,78%,75%,83%,141,169,85,32%,35%,25%,2,2,0,2,1,1
143,https://vlr.gg/player/42519/lolito,2024-11-04 13:00:00,1.04,1.15,1.08,194,191,201,13,8,5,12,9,3,4,4,0,-2,-2,0,67%,67%,67%,133,132,135,28%,23%,36%,0,0,0,2,2,0
144,https://vlr.gg/player/48946/juandee,2024-11-04 13:00:00,1.28,0.50,1.02,153,200,61,10,9,1,10,6,4,3,2,1,+2,+2,0,72%,83%,50%,101,128,47,36%,42%,17%,2,2,0,0,0,0
145,https://vlr.gg/player/31553/pukytoo,2024-11-04 13:00:00,0.58,1.54,0.90,194,154,277,13,7,6,14,10,4,2,2,0,+1,-1,+2,67%,67%,67%,113,87,164,71%,56%,88%,4,1,3,3,2,1
146,https://vlr.gg/player/48953/t1tan,2024-11-04 13:00:00,0.83,1.08,1.00,234,167,268,15,4,11,14,4,10,4,1,3,+1,0,+1,78%,83%,75%,140,82,169,61%,100%,53%,3,0,3,2,0,2
147,https://vlr.gg/player/48952/xpiryy,2024-11-04 13:00:00,0.74,0.76,0.75,197,166,213,11,3,8,15,5,10,1,1,0,+2,+1,+1,44%,50%,42%,125,109,133,33%,43%,29%,4,1,3,2,0,2
148,https://vlr.gg/player/48955/dubstep,2024-11-04 13:00:00,1.33,0.46,0.75,176,252,139,10,5,5,15,4,11,11,3,8,0,0,0,78%,67%,83%,112,186,75,45%,45%,45%,0,0,0,0,0,0
149,https://vlr.gg/player/48956/bujaxd,2024-11-04 13:00:00,0.39,0.89,0.72,172,110,204,10,2,8,13,4,9,5,1,4,-2,-2,0,56%,33%,67%,115,71,137,21%,11%,24%,2,1,1,4,3,1
150,https://vlr.gg/player/23082/cobra,2024-11-04 13:00:00,0.05,0.94,0.65,110,9,160,7,0,7,13,5,8,5,1,4,-1,-1,0,61%,33%,75%,83,5,122,32%,0%,33%,0,0,0,1,1,0
151,https://vlr.gg/player/4951/hardy,2024-11-04 12:00:00,0.76,1.87,1.24,289,184,432,20,7,13,16,10,6,4,2,2,+1,0,+1,67%,58%,78%,207,123,319,40%,32%,46%,3,1,2,2,1,1
152,https://vlr.gg/player/29974/erizillo,2024-11-04 12:00:00,1.10,1.05,1.08,195,208,179,15,9,6,15,9,6,4,2,2,-1,-1,0,57%,58%,56%,139,157,114,36%,38%,33%,0,0,0,1,1,0
153,https://vlr.gg/player/42521/jahbu,2024-11-04 12:00:00,1.08,0.87,0.99,215,275,136,16,12,4,16,11,5,2,1,1,-3,-2,-1,67%,67%,67%,131,157,96,29%,27%,33%,1,1,0,4,3,1
154,https://vlr.gg/player/42557/6ankai,2024-11-04 12:00:00,0.44,0.56,0.49,125,137,111,8,5,3,17,10,7,3,1,2,-3,-3,0,57%,50%,67%,88,100,72,25%,35%,9%,1,0,1,4,3,1
155,https://vlr.gg/player/49004/synkhro,2024-11-04 12:00:00,0.35,0.43,0.38,86,64,117,5,2,3,17,10,7,5,3,2,-1,0,-1,43%,42%,44%,54,38,74,29%,11%,50%,2,1,1,3,1,2
156,https://vlr.gg/player/2893/hastack,2024-11-04 12:00:00,1.69,1.47,1.56,264,307,232,20,10,10,9,4,5,9,3,6,-1,0,-1,67%,67%,67%,161,171,154,11%,17%,6%,2,2,0,3,2,1
157,https://vlr.gg/player/2996/neiker,2024-11-04 12:00:00,1.24,1.32,1.29,220,226,217,18,8,10,13,6,7,9,0,9,+3,+1,+2,57%,44%,67%,149,146,151,47%,46%,48%,3,1,2,0,0,0
158,https://vlr.gg/player/22154/pika,2024-11-04 12:00:00,0.98,1.10,1.05,151,177,132,10,5,5,12,6,6,14,6,8,0,0,0,62%,67%,58%,105,116,96,26%,30%,21%,1,1,0,1,1,0
159,https://vlr.gg/player/5487/adm1k,2024-11-04 12:00:00,1.12,0.99,1.04,214,157,258,15,5,10,13,4,9,4,1,3,+2,0,+2,81%,67%,92%,143,108,170,25%,21%,29%,3,0,3,1,0,1
160,https://vlr.gg/player/22501/amore,2024-11-04 12:00:00,0.14,1.57,0.96,231,119,315,18,3,15,17,9,8,2,1,1,+3,0,+3,57%,33%,75%,145,68,203,29%,20%,33%,5,1,4,2,1,1
161,https://vlr.gg/player/36747/bonobo,2024-11-04 02:30:00,1.65,2.41,2.03,362,323,402,44,20,24,11,8,3,11,3,8,+6,+5,+1,81%,75%,88%,228,196,260,46%,38%,53%,6,5,1,0,0,0
162,https://vlr.gg/player/17272/dokja,2024-11-04 02:30:00,1.76,2.01,1.88,330,305,356,42,19,23,12,6,6,4,3,1,+3,+1,+2,88%,81%,94%,214,189,240,28%,25%,31%,4,2,2,1,1,0
163,https://vlr.gg/player/1771/myth,2024-11-04 02:30:00,1.19,1.19,1.19,135,159,111,14,8,6,10,6,4,25,14,11,+1,0,+1,97%,94%,100%,76,92,60,20%,20%,21%,1,0,1,0,0,0
164,https://vlr.gg/player/31580/vizsla,2024-11-04 02:30:00,1.02,0.93,0.98,124,150,98,14,8,6,14,8,6,14,8,6,+2,+2,0,72%,69%,75%,90,99,82,41%,43%,38%,2,2,0,0,0,0
165,https://vlr.gg/player/44437/ace,2024-11-04 02:30:00,1.08,0.87,0.97,214,183,245,23,11,12,22,10,12,13,8,5,0,-2,+2,94%,94%,94%,143,123,164,24%,26%,22%,9,2,7,9,4,5
166,https://vlr.gg/player/41476/d4tt,2024-11-04 02:30:00,0.51,1.04,0.78,186,116,257,21,6,15,28,15,13,0,0,0,+2,+2,0,56%,38%,75%,123,78,167,49%,50%,48%,3,2,1,1,0,1
167,https://vlr.gg/player/22833/bru,2024-11-04 02:30:00,0.69,0.77,0.73,151,139,164,16,8,8,25,13,12,2,2,0,-3,-2,-1,53%,50%,56%,105,106,104,18%,19%,17%,3,1,2,6,3,3
168,https://vlr.gg/player/41478/wintr,2024-11-04 02:30:00,0.68,0.51,0.60,128,135,121,14,8,6,27,13,14,5,1,4,-1,0,-1,50%,44%,56%,76,81,71,50%,64%,42%,2,1,1,3,1,2
169,https://vlr.gg/player/41477/tysonrcx,2024-11-04 02:30:00,0.67,0.44,0.56,126,147,105,11,7,4,28,14,14,5,2,3,-3,-1,-2,41%,44%,38%,98,108,89,27%,35%,18%,0,0,0,3,1,2
170,https://vlr.gg/player/44701/akanekay,2024-11-04 02:30:00,0.07,0.63,0.32,92,75,111,7,2,5,29,16,13,8,3,5,-7,-5,-2,50%,44%,56%,69,60,78,10%,4%,15%,2,1,1,9,6,3
171,https://vlr.gg/player/26310/ikana,2024-11-04 02:30:00,1.94,0.59,1.40,197,370,146,25,16,3,17,6,7,14,7,2,-1,0,-1,75%,100%,38%,183,235,104,22%,29%,5%,2,2,0,3,2,1
172,https://vlr.gg/player/1062/lew,2024-11-04 02:30:00,1.44,0.98,1.25,305,251,220,36,11,6,20,5,7,5,2,1,+4,+1,-1,70%,83%,50%,166,171,158,33%,41%,19%,8,2,2,4,1,3
173,https://vlr.gg/player/5228/minimise,2024-11-04 02:30:00,1.26,1.16,1.22,225,215,191,26,10,4,19,7,5,32,13,6,-2,-2,0,85%,100%,63%,129,119,143,26%,29%,23%,0,0,0,2,2,0
174,https://vlr.gg/player/6659/dragon,2024-11-04 02:30:00,1.16,1.05,1.11,192,213,191,24,9,6,22,7,7,7,2,2,+4,-1,+2,80%,92%,63%,137,148,120,22%,30%,14%,5,0,2,1,1,0
175,https://vlr.gg/player/12968/tixx,2024-11-04 02:30:00,1.14,0.72,0.97,289,235,197,34,11,4,21,8,8,23,6,5,+2,0,0,90%,100%,75%,133,139,123,32%,30%,35%,3,1,0,1,1,0
176,https://vlr.gg/player/36676/novae,2024-11-04 02:30:00,1.06,0.96,1.00,207,201,201,26,7,10,29,5,11,5,0,1,0,-1,0,65%,75%,58%,125,125,125,30%,45%,23%,2,0,1,2,1,1
177,https://vlr.gg/player/47212/ecco,2024-11-04 02:30:00,1.37,0.57,0.89,135,259,172,15,7,6,29,4,12,6,3,2,+1,-1,+2,80%,88%,75%,137,170,115,26%,22%,32%,2,0,2,1,1,0
178,https://vlr.gg/player/49003/cybxr,2024-11-04 02:30:00,1.04,0.64,0.80,146,260,185,17,7,7,31,6,12,16,5,5,+3,+1,+2,80%,100%,67%,121,143,106,18%,33%,9%,3,1,2,0,0,0
179,https://vlr.gg/player/46994/tisoyy,2024-11-04 02:30:00,0.94,0.61,0.74,164,166,150,21,5,6,28,4,11,4,2,2,0,0,-1,60%,75%,50%,102,104,100,29%,28%,31%,2,0,1,2,0,2
180,https://vlr.gg/player/46768/indraa,2024-11-04 02:30:00,1.26,0.38,0.73,185,257,123,20,8,4,28,4,11,8,3,2,+3,+1,-1,50%,63%,42%,110,140,90,16%,20%,13%,7,3,1,4,2,2
181,https://vlr.gg/player/33039/kakashiii,2024-11-04 02:30:00,1.18,0.91,1.07,237,244,269,37,21,16,37,20,17,14,6,8,+3,0,+3,70%,65%,75%,176,168,185,27%,28%,27%,8,4,4,5,4,1
182,https://vlr.gg/player/43143/astin,2024-11-04 02:30:00,0.75,1.20,0.95,222,178,280,35,17,18,40,23,17,18,4,14,-1,0,-1,76%,69%,85%,137,103,183,30%,50%,21%,2,1,1,3,1,2
183,https://vlr.gg/player/44958/planko,2024-11-04 02:30:00,0.65,1.28,0.92,200,152,256,31,13,18,36,23,13,6,3,3,-6,-2,-4,61%,54%,70%,132,111,159,36%,27%,44%,2,2,0,8,4,4
184,https://vlr.gg/player/34217/monokuma,2024-11-04 02:30:00,0.60,1.15,0.84,180,154,219,30,13,17,34,21,13,7,4,3,-2,-1,-1,61%,62%,60%,128,107,156,24%,27%,20%,4,2,2,6,3,3
185,https://vlr.gg/player/12965/mythical,2024-11-04 02:30:00,0.76,0.43,0.62,145,181,106,21,14,7,38,24,14,17,12,5,-2,+1,-3,72%,73%,70%,97,119,67,22%,26%,15%,3,3,0,5,2,3
186,https://vlr.gg/player/48911/kruise,2024-11-04 02:30:00,1.05,1.76,1.45,269,191,325,44,13,31,28,14,14,16,7,9,+5,+3,+2,89%,90%,88%,175,130,209,21%,24%,20%,8,4,4,3,1,2
187,https://vlr.gg/player/48912/kookie,2024-11-04 02:30:00,1.52,1.14,1.30,228,285,197,42,22,20,29,15,14,13,4,9,-5,+1,-6,76%,70%,81%,159,188,137,34%,41%,27%,4,3,1,9,2,7
188,https://vlr.gg/player/44694/dazeryuf,2024-11-04 02:30:00,0.99,1.29,1.16,249,206,277,39,16,23,36,15,21,30,10,20,+2,-1,+3,85%,85%,85%,168,147,184,23%,20%,25%,6,1,5,4,2,2
189,https://vlr.gg/player/42196/icy,2024-11-04 02:30:00,1.05,1.11,1.09,237,223,223,34,14,20,33,16,17,16,7,9,+6,+3,+3,74%,75%,73%,155,158,152,34%,27%,40%,7,4,3,1,1,0
190,https://vlr.gg/player/43105/capy,2024-11-04 02:30:00,0.69,1.06,0.90,159,148,171,26,10,16,29,16,13,16,7,9,0,0,0,80%,65%,92%,110,104,114,28%,36%,23%,2,1,1,2,1,1
191,https://vlr.gg/player/28843/abbas,2024-11-04 02:30:00,0.90,1.52,1.31,294,211,338,55,13,42,41,15,26,11,2,9,-2,-1,-1,69%,67%,69%,187,121,220,24%,16%,26%,9,3,6,11,4,7
192,https://vlr.gg/player/48913/zek,2024-11-04 02:30:00,0.73,1.56,1.29,253,171,286,50,11,39,36,15,21,4,3,1,+5,-1,+6,72%,56%,81%,164,117,187,28%,23%,31%,9,2,7,4,3,1
193,https://vlr.gg/player/34257/strame,2024-11-04 02:30:00,1.43,1.05,1.17,231,217,228,44,17,27,36,11,25,11,2,9,+3,-2,+5,69%,56%,75%,149,145,151,33%,38%,31%,7,0,7,4,2,2
194,https://vlr.gg/player/48914/lordshadow,2024-11-04 02:30:00,0.97,0.96,0.96,178,207,162,32,12,20,36,14,22,23,9,14,+1,+1,0,80%,78%,81%,119,137,110,23%,21%,24%,5,2,3,4,1,3
195,https://vlr.gg/player/33714/vina,2024-11-04 02:30:00,0.87,0.76,0.80,132,180,110,23,10,13,35,14,21,28,10,18,-1,-1,0,76%,72%,78%,93,125,77,41%,35%,47%,0,0,0,1,1,0
196,https://vlr.gg/player/34234/shinon,2024-11-04 02:30:00,0.92,1.61,1.15,242,203,331,46,24,22,39,27,12,20,12,8,+3,0,+3,69%,61%,83%,152,123,212,18%,17%,19%,6,3,3,3,3,0
197,https://vlr.gg/player/43107/cman,2024-11-04 02:30:00,1.06,0.85,0.99,204,239,155,42,31,11,40,27,13,5,4,1,-4,-2,-2,69%,69%,67%,151,167,119,31%,36%,21%,3,2,1,7,4,3
198,https://vlr.gg/player/33037/bineddie,2024-11-04 02:30:00,0.72,1.36,0.93,170,136,231,32,17,15,37,26,11,12,8,4,-2,-2,0,63%,58%,72%,106,90,139,20%,18%,24%,2,1,1,4,3,1
199,https://vlr.gg/player/43101/onob,2024-11-04 02:30:00,0.72,0.82,0.76,207,200,232,36,22,14,45,31,14,11,8,3,-4,-5,+1,63%,56%,78%,130,123,143,25%,24%,27%,9,5,4,13,10,3
200,https://vlr.gg/player/37161/ponk,2024-11-04 02:30:00,0.81,0.71,0.76,159,169,144,28,21,7,43,30,13,30,12,18,+1,-1,+2,74%,72%,78%,104,112,88,26%,28%,23%,4,2,2,3,3,0
201,https://vlr.gg/player/5132/mada,2024-11-03 19:00:00,1.03,1.88,1.44,317,259,378,41,16,25,22,13,9,5,2,3,+5,+3,+2,83%,78%,88%,198,161,238,24%,20%,28%,8,6,2,3,3,0
202,https://vlr.gg/player/4164/s0m,2024-11-03 19:00:00,1.73,1.10,1.42,226,259,192,31,20,11,17,8,9,19,11,8,+5,+1,+4,80%,83%,76%,150,173,126,25%,34%,18%,7,2,5,2,1,1
203,https://vlr.gg/player/21668/verno,2024-11-03 19:00:00,0.86,1.46,1.16,202,195,211,27,13,14,19,14,5,5,2,3,+1,+2,-1,83%,78%,88%,135,131,140,29%,23%,35%,3,3,0,2,1,1
204,https://vlr.gg/player/817/finesse,2024-11-03 19:00:00,0.67,1.34,1.00,171,135,214,23,9,14,19,12,7,10,7,3,0,-2,+2,77%,78%,76%,101,88,114,37%,32%,41%,3,0,3,3,2,1
205,https://vlr.gg/player/11225/ethan,2024-11-03 19:00:00,1.00,0.89,0.95,154,171,133,16,9,7,21,10,11,29,16,13,0,0,0,86%,89%,82%,109,117,100,22%,24%,20%,2,0,2,2,0,2
206,https://vlr.gg/player/36245/n4rrate,2024-11-03 19:00:00,1.00,1.70,1.36,273,214,331,32,12,20,27,14,13,10,3,7,-1,-1,0,66%,59%,72%,175,127,221,33%,29%,35%,4,1,3,5,2,3
207,https://vlr.gg/player/1265/johnqt,2024-11-03 19:00:00,0.72,1.13,0.93,185,183,189,20,9,11,25,14,11,12,2,10,+1,+1,0,74%,53%,94%,128,124,132,26%,22%,29%,1,1,0,0,0,0
208,https://vlr.gg/player/3880/bang,2024-11-03 19:00:00,0.71,0.98,0.85,168,151,183,21,8,13,26,13,13,10,5,5,-6,-5,-1,66%,59%,72%,103,102,105,36%,22%,54%,1,0,1,7,5,2
209,https://vlr.gg/player/4004/zekken,2024-11-03 19:00:00,0.46,0.59,0.52,162,162,162,16,8,8,31,16,15,5,0,5,-4,-3,-1,57%,35%,78%,106,112,101,21%,23%,19%,4,1,3,8,4,4
210,https://vlr.gg/player/729/zellsis,2024-11-03 19:00:00,0.44,0.31,0.37,88,97,79,9,4,5,29,14,15,9,4,5,-1,+1,-2,46%,47%,44%,55,63,48,11%,6%,20%,2,2,0,3,1,2
211,https://vlr.gg/player/4004/zekken,2024-11-03 16:00:00,1.80,1.34,1.62,347,372,292,52,36,16,27,16,11,11,9,2,+4,+4,0,84%,96%,65%,206,219,187,23%,24%,20%,12,8,4,8,4,4
212,https://vlr.gg/player/729/zellsis,2024-11-03 16:00:00,1.48,1.10,1.33,238,263,198,38,27,11,21,12,9,22,12,10,-3,-1,-2,84%,85%,82%,150,166,125,24%,21%,28%,2,1,1,5,2,3
213,https://vlr.gg/player/3880/bang,2024-11-03 16:00:00,1.31,1.29,1.30,234,249,195,38,25,13,26,16,10,11,7,4,-2,-1,-1,84%,85%,82%,147,156,134,36%,30%,52%,1,1,0,3,2,1
214,https://vlr.gg/player/1265/johnqt,2024-11-03 16:00:00,1.35,1.06,1.24,195,194,147,30,19,11,18,10,8,19,15,4,-2,-1,-1,79%,88%,65%,113,135,80,27%,33%,17%,1,1,0,3,2,1
215,https://vlr.gg/player/36245/n4rrate,2024-11-03 16:00:00,0.60,0.72,0.65,158,145,196,23,12,11,33,18,15,12,7,5,-1,+1,-2,77%,81%,71%,113,101,131,25%,29%,22%,3,3,0,4,2,2
216,https://vlr.gg/player/826/supamen,2024-11-03 16:00:00,0.81,1.16,1.02,216,148,244,30,9,21,33,11,22,8,2,6,+2,0,+2,56%,47%,62%,152,96,188,36%,31%,38%,5,1,4,3,1,2
217,https://vlr.gg/player/881/yay,2024-11-03 16:00:00,1.02,0.74,0.85,219,178,205,29,11,18,37,11,26,4,1,3,+3,+1,+2,60%,71%,54%,125,127,123,34%,27%,39%,5,1,4,2,0,2
218,https://vlr.gg/player/1533/derrek,2024-11-03 16:00:00,1.03,0.45,0.68,159,259,113,26,16,10,36,12,24,7,3,4,-1,+3,-4,56%,71%,46%,115,170,79,32%,43%,21%,4,3,1,5,0,5
219,https://vlr.gg/player/3702/sym,2024-11-03 16:00:00,0.78,0.51,0.61,163,220,143,24,12,12,41,14,27,7,3,4,+3,+5,-2,56%,65%,50%,110,136,93,30%,27%,33%,10,7,3,7,2,5
220,https://vlr.gg/player/4927/nature,2024-11-03 16:00:00,0.42,0.68,0.55,108,106,129,16,6,10,35,14,21,13,4,9,-3,-2,-1,51%,47%,54%,81,69,89,23%,7%,32%,0,0,0,3,2,1
221,https://vlr.gg/player/2658/xuss,2024-11-03 13:20:00,1.65,1.66,1.65,315,341,291,43,24,19,18,11,7,6,0,6,+5,+2,+3,81%,67%,95%,197,214,181,28%,29%,27%,12,7,5,7,5,2
222,https://vlr.gg/player/5292/al0rante,2024-11-03 13:20:00,1.15,1.81,1.49,251,209,294,38,13,25,16,9,7,4,2,2,0,-1,+1,81%,78%,84%,156,132,177,48%,50%,47%,1,0,1,1,1,0
223,https://vlr.gg/player/2690/hoody,2024-11-03 13:20:00,1.51,1.04,1.27,193,222,164,23,16,7,18,7,11,26,8,18,+2,0,+2,86%,94%,79%,141,145,138,36%,47%,28%,3,0,3,1,0,1
224,https://vlr.gg/player/1457/mistic,2024-11-03 13:20:00,1.16,1.25,1.21,225,222,225,32,15,17,20,10,10,13,4,9,+3,+1,+2,81%,72%,89%,146,154,139,33%,29%,38%,3,1,2,0,0,0
225,https://vlr.gg/player/4244/yaboilewis,2024-11-03 13:20:00,0.56,1.25,0.92,174,129,215,23,8,15,22,13,9,17,7,10,+5,0,+5,86%,78%,95%,108,91,125,42%,41%,42%,7,2,5,2,2,0
226,https://vlr.gg/player/10359/daveeski,2024-11-03 13:20:00,0.87,1.13,0.99,214,187,243,28,13,15,31,15,16,2,0,2,-5,-6,+1,46%,37%,56%,144,141,148,32%,25%,39%,4,0,4,9,6,3
227,https://vlr.gg/player/22381/s-mplex,2024-11-03 13:20:00,0.55,1.12,0.83,159,128,193,19,7,12,29,17,12,16,9,7,-1,-1,0,59%,53%,67%,109,80,139,36%,13%,70%,1,1,0,2,2,0
228,https://vlr.gg/player/33875/spexleon,2024-11-03 13:20:00,0.53,0.89,0.71,171,145,204,20,9,11,32,17,15,5,1,4,-4,-4,0,54%,58%,50%,109,92,127,33%,36%,30%,2,1,1,6,5,1
229,https://vlr.gg/player/33732/nunmeister,2024-11-03 13:20:00,0.66,0.21,0.44,106,153,56,14,10,4,34,17,17,6,4,2,-3,-1,-2,43%,47%,39%,75,104,46,28%,31%,23%,1,1,0,4,2,2
230,https://vlr.gg/player/3924/sh0utyy,2024-11-03 13:20:00,0.36,0.48,0.42,127,100,155,13,5,8,33,17,16,8,5,3,-2,-1,-1,54%,53%,56%,88,73,105,31%,28%,33%,3,0,3,5,1,4
231,https://vlr.gg/player/18400/bipo,2024-11-03 11:00:00,1.61,1.32,1.44,320,371,286,49,23,26,31,14,17,9,7,2,+9,+5,+4,80%,94%,69%,200,232,178,25%,23%,26%,14,6,8,5,1,4
232,https://vlr.gg/player/7660/fizzy,2024-11-03 11:00:00,1.54,1.12,1.29,243,248,223,33,16,17,25,8,17,27,11,16,+6,+3,+3,91%,94%,88%,158,163,155,29%,28%,30%,9,4,5,3,1,2
233,https://vlr.gg/player/3674/iluri,2024-11-03 11:00:00,0.88,1.48,1.24,218,121,267,34,8,26,22,9,13,17,7,10,+2,+1,+1,80%,72%,85%,126,71,164,38%,28%,42%,2,1,1,0,0,0
234,https://vlr.gg/player/402/insider,2024-11-03 11:00:00,1.26,0.98,1.09,169,190,161,28,12,16,22,9,13,11,9,2,-4,-3,-1,82%,89%,77%,118,133,107,34%,33%,35%,1,0,1,5,3,2
235,https://vlr.gg/player/3753/obnoks,2024-11-03 11:00:00,1.36,0.73,0.99,193,224,161,33,17,16,26,9,17,7,3,4,-3,0,-3,70%,83%,62%,125,148,109,24%,33%,17%,1,1,0,4,1,3
236,https://vlr.gg/player/45834/aidan,2024-11-03 11:00:00,1.01,0.93,0.98,222,242,226,35,21,14,37,22,15,6,5,1,-3,-1,-2,55%,50%,61%,154,156,152,37%,34%,44%,9,6,3,12,7,5
237,https://vlr.gg/player/44548/nomiss,2024-11-03 11:00:00,1.29,0.42,0.93,217,275,138,32,24,8,37,20,17,11,9,2,+3,+3,0,73%,88%,50%,142,181,84,28%,30%,22%,4,3,1,1,0,1
238,https://vlr.gg/player/24831/complexit,2024-11-03 11:00:00,0.72,0.76,0.74,133,141,140,23,13,10,34,20,14,8,6,2,-4,-2,-2,64%,69%,56%,93,93,93,45%,54%,35%,1,1,0,5,3,2
239,https://vlr.gg/player/33392/zeikosha,2024-11-03 11:00:00,0.86,0.55,0.73,127,133,129,20,13,7,33,18,15,9,4,5,-3,-2,-1,57%,62%,50%,94,99,87,21%,25%,17%,2,1,1,5,3,2
240,https://vlr.gg/player/4361/radenz,2024-11-03 11:00:00,0.37,0.71,0.51,117,81,174,16,6,10,36,21,15,13,9,4,-3,-2,-1,64%,62%,67%,73,47,111,23%,27%,20%,1,0,1,4,2,2
241,https://vlr.gg/player/40908/skyisblue,2024-11-03 08:40:00,0.81,1.24,1.06,226,174,256,47,15,32,47,17,30,16,4,12,-2,-4,+2,73%,75%,72%,141,116,157,27%,29%,25%,9,2,7,11,6,5
242,https://vlr.gg/player/44770/cxix666,2024-11-03 08:40:00,1.00,0.83,0.90,207,229,195,43,19,24,49,17,32,14,8,6,+1,+1,0,58%,63%,56%,139,154,129,31%,20%,42%,6,3,3,5,2,3
243,https://vlr.gg/player/40910/consz,2024-11-03 08:40:00,1.06,0.76,0.88,174,164,187,34,13,21,44,13,31,12,5,7,0,+3,-3,63%,75%,56%,126,124,128,25%,23%,26%,8,6,2,8,3,5
244,https://vlr.gg/player/44930/nex1sphix,2024-11-03 08:40:00,1.46,0.42,0.83,156,253,99,32,23,9,46,14,32,22,11,11,-4,-1,-3,68%,83%,58%,107,160,72,31%,40%,23%,1,0,1,5,1,4
245,https://vlr.gg/player/40907/mnfear,2024-11-03 08:40:00,1.18,0.45,0.75,148,180,140,33,16,17,45,12,33,17,9,8,-5,-1,-4,63%,75%,56%,100,125,83,29%,29%,29%,1,0,1,6,1,5
246,https://vlr.gg/player/7746/kevzii,2024-11-03 08:40:00,1.81,1.02,1.49,241,267,185,50,36,14,31,14,17,22,13,9,+2,+2,0,73%,75%,71%,169,198,125,37%,41%,29%,6,4,2,4,2,2
247,https://vlr.gg/player/13744/patmen,2024-11-03 08:40:00,1.19,1.26,1.22,294,307,275,62,40,22,44,26,18,11,6,5,+6,+3,+3,77%,72%,83%,189,194,183,29%,28%,31%,17,10,7,11,7,4
248,https://vlr.gg/player/16953/zynd,2024-11-03 08:40:00,1.20,0.90,1.08,217,225,189,44,28,16,38,21,17,18,16,2,+3,+2,+1,75%,86%,58%,137,145,124,24%,32%,15%,6,4,2,3,2,1
249,https://vlr.gg/player/21677/jeee,2024-11-03 08:40:00,1.20,0.66,0.99,170,198,131,39,28,11,38,20,18,17,10,7,+1,+1,0,72%,78%,63%,114,133,85,37%,43%,27%,4,2,2,3,1,2
250,https://vlr.gg/player/9737/kakarot,2024-11-03 08:40:00,1.01,0.70,0.89,170,194,133,36,26,10,38,22,16,27,13,14,-2,0,-2,72%,75%,67%,109,127,82,24%,34%,10%,2,2,0,4,2,2
251,https://vlr.gg/player/22047/rarga,2024-11-03 06:20:00,,,,316,,,45,,,32,,,10,,,,,,,,,,,,,,,,,,,,
252,https://vlr.gg/player/37927/happywei,2024-11-03 06:20:00,,,,237,,,35,,,20,,,13,,,,,,,,,,,,,,,,,,,,
253,https://vlr.gg/player/4710/you,2024-11-03 06:20:00,,,,214,,,33,,,26,,,10,,,,,,,,,,,,,,,,,,,,
254,https://vlr.gg/player/37674/mrcani,2024-11-03 06:20:00,,,,170,,,27,,,22,,,24,,,,,,,,,,,,,,,,,,,,
255,https://vlr.gg/player/36668/mart1n,2024-11-03 06:20:00,,,,149,,,21,,,20,,,20,,,,,,,,,,,,,,,,,,,,
256,https://vlr.gg/player/4720/haodong,2024-11-03 06:20:00,,,,183,,,27,,,34,,,8,,,,,,,,,,,,,,,,,,,,
257,https://vlr.gg/player/488/rb,2024-11-03 06:20:00,,,,178,,,25,,,34,,,9,,,,,,,,,,,,,,,,,,,,
258,https://vlr.gg/player/5011/abo,2024-11-03 06:20:00,,,,177,,,25,,,30,,,5,,,,,,,,,,,,,,,,,,,,
259,https://vlr.gg/player/14445/ac,2024-11-03 06:20:00,,,,161,,,23,,,29,,,8,,,,,,,,,,,,,,,,,,,,
260,https://vlr.gg/player/41053/snail,2024-11-03 06:20:00,,,,154,,,20,,,34,,,8,,,,,,,,,,,,,,,,,,,,
261,https://vlr.gg/player/27254/leviathan,2024-11-03 06:00:00,1.71,0.72,1.30,243,281,161,48,35,13,35,15,20,19,15,4,+1,0,+1,75%,88%,57%,148,184,95,33%,34%,32%,6,2,4,5,2,3
262,https://vlr.gg/player/3342/sushiboys,2024-11-03 06:00:00,1.76,0.48,1.24,198,272,87,40,33,7,31,13,18,29,18,11,-2,+2,-4,79%,88%,65%,118,157,61,27%,27%,29%,4,3,1,6,1,5
263,https://vlr.gg/player/4377/johnolsen,2024-11-03 06:00:00,1.32,0.65,1.05,210,251,120,39,30,9,32,15,17,11,8,3,+1,+3,-2,63%,70%,52%,132,159,94,29%,29%,28%,4,4,0,3,1,2
264,https://vlr.gg/player/2366/alert,2024-11-03 06:00:00,1.08,1.00,1.05,193,173,229,39,22,17,34,17,17,8,5,3,+1,0,+1,79%,85%,70%,137,126,152,31%,31%,30%,3,2,1,2,2,0
265,https://vlr.gg/player/23930/potter,2024-11-03 06:00:00,0.77,1.05,0.88,195,174,220,38,21,17,40,22,18,9,7,2,-7,-8,+1,71%,82%,57%,131,117,150,37%,35%,38%,8,4,4,15,12,3
266,https://vlr.gg/player/23976/crus,2024-11-03 06:00:00,1.74,0.49,1.00,191,305,116,36,24,12,38,10,28,16,10,6,+3,+2,+1,66%,83%,55%,128,199,78,35%,39%,28%,5,3,2,2,1,1
267,https://vlr.gg/player/1437/yesican,2024-11-03 06:00:00,1.22,0.80,0.97,169,180,166,32,15,17,35,10,25,19,8,11,+2,+1,+1,71%,87%,61%,129,135,124,37%,39%,35%,4,1,3,2,0,2
268,https://vlr.gg/player/46463/twilight,2024-11-03 06:00:00,1.40,0.61,0.93,202,248,171,37,22,15,43,13,30,13,5,8,+1,+1,0,64%,74%,58%,138,159,123,40%,61%,28%,9,4,5,8,3,5
269,https://vlr.gg/player/48574/nia,2024-11-03 06:00:00,0.87,0.90,0.88,198,212,210,42,18,24,46,17,29,7,5,2,+2,+1,+1,66%,70%,64%,140,144,138,39%,46%,36%,11,5,6,9,4,5
270,https://vlr.gg/player/48876/foxy,2024-11-03 06:00:00,1.01,0.63,0.77,126,138,129,25,11,14,42,13,29,28,14,14,-2,-2,0,68%,78%,61%,95,98,93,29%,39%,24%,2,0,2,4,2,2
271,https://vlr.gg/player/872/autumn,2024-11-03 04:00:00,,,,281,,,45,,,27,,,13,,,,,,,,,,,,,,,,,,,,
272,https://vlr.gg/player/3028/life,2024-11-03 04:00:00,,,,239,,,38,,,26,,,8,,,,,,,,,,,,,,,,,,,,
273,https://vlr.gg/player/19530/aaaay,2024-11-03 04:00:00,,,,193,,,32,,,25,,,10,,,,,,,,,,,,,,,,,,,,
274,https://vlr.gg/player/6022/yosemite,2024-11-03 04:00:00,,,,181,,,28,,,25,,,13,,,,,,,,,,,,,,,,,,,,
275,https://vlr.gg/player/7857/berlin,2024-11-03 04:00:00,,,,166,,,22,,,28,,,21,,,,,,,,,,,,,,,,,,,,
276,https://vlr.gg/player/41739/slowly,2024-11-03 04:00:00,,,,236,,,35,,,32,,,11,,,,,,,,,,,,,,,,,,,,
277,https://vlr.gg/player/3547/ninebody,2024-11-03 04:00:00,,,,234,,,36,,,34,,,6,,,,,,,,,,,,,,,,,,,,
278,https://vlr.gg/player/47101/5cm,2024-11-03 04:00:00,,,,161,,,21,,,36,,,11,,,,,,,,,,,,,,,,,,,,
279,https://vlr.gg/player/14453/sunshine,2024-11-03 04:00:00,,,,144,,,20,,,32,,,10,,,,,,,,,,,,,,,,,,,,
280,https://vlr.gg/player/3124/core,2024-11-03 04:00:00,,,,119,,,19,,,31,,,10,,,,,,,,,,,,,,,,,,,,
281,https://vlr.gg/player/31254/feta,2024-11-03 02:30:00,1.20,1.27,1.23,276,287,265,44,25,19,34,20,14,9,4,5,+3,+2,+1,73%,79%,67%,188,181,197,34%,43%,25%,8,5,3,5,3,2
282,https://vlr.gg/player/43125/kadiri,2024-11-03 02:30:00,0.86,1.53,1.18,212,181,250,35,15,20,28,17,11,12,7,5,+5,+3,+2,78%,71%,86%,145,123,170,34%,29%,39%,5,3,2,0,0,0
283,https://vlr.gg/player/29821/sinaway,2024-11-03 02:30:00,1.10,1.24,1.17,227,210,246,40,20,20,30,16,14,15,7,8,0,-4,+4,76%,75%,76%,153,144,163,26%,25%,28%,5,0,5,5,4,1
284,https://vlr.gg/player/31255/biggiecheese,2024-11-03 02:30:00,1.12,1.11,1.12,204,214,195,31,17,14,30,16,14,28,16,12,+1,0,+1,76%,79%,71%,126,130,122,22%,21%,24%,7,3,4,6,3,3
285,https://vlr.gg/player/29790/zauqk,2024-11-03 02:30:00,0.94,1.10,1.01,207,212,200,31,17,14,29,17,12,10,6,4,-4,-3,-1,73%,67%,81%,137,142,131,20%,24%,16%,0,0,0,4,3,1
286,https://vlr.gg/player/44437/ace,2024-11-03 02:30:00,1.33,1.08,1.20,257,274,243,39,21,18,37,15,22,11,4,7,+2,+1,+1,76%,81%,71%,179,190,170,37%,32%,43%,6,2,4,4,1,3
287,https://vlr.gg/player/31580/vizsla,2024-11-03 02:30:00,0.91,1.03,0.98,219,248,195,31,17,14,35,19,16,22,8,14,-1,-3,+2,82%,86%,79%,139,157,123,23%,31%,18%,6,1,5,7,4,3
288,https://vlr.gg/player/1771/myth,2024-11-03 02:30:00,0.58,1.31,0.97,168,96,230,25,6,19,33,16,17,14,5,9,-1,0,-1,71%,67%,75%,119,75,157,21%,21%,21%,1,1,0,2,1,1
289,https://vlr.gg/player/17272/dokja,2024-11-03 02:30:00,0.38,0.95,0.68,178,126,224,30,10,20,40,19,21,8,3,5,-2,-3,+1,64%,57%,71%,112,76,144,21%,27%,18%,4,1,3,6,4,2
290,https://vlr.gg/player/36747/bonobo,2024-11-03 02:30:00,0.60,0.70,0.65,157,163,151,26,12,14,37,18,19,5,1,4,-3,-2,-1,60%,62%,58%,110,115,106,34%,30%,38%,3,2,1,6,4,2
291,https://vlr.gg/player/1062/lew,2024-11-03 02:30:00,1.66,1.80,1.70,308,319,244,38,29,9,12,10,2,3,1,2,+4,+2,+2,85%,83%,89%,197,218,141,34%,34%,33%,5,3,2,1,1,0
292,https://vlr.gg/player/5228/minimise,2024-11-03 02:30:00,1.12,1.93,1.34,301,271,373,36,24,12,20,16,4,12,7,5,0,-2,+2,79%,75%,89%,188,169,241,24%,21%,30%,5,3,2,5,5,0
293,https://vlr.gg/player/12968/tixx,2024-11-03 02:30:00,1.18,1.12,1.16,193,197,191,24,16,8,18,13,5,12,9,3,+3,+2,+1,82%,83%,78%,126,131,113,24%,32%,16%,5,4,1,2,2,0
294,https://vlr.gg/player/6659/dragon,2024-11-03 02:30:00,0.90,1.74,1.13,178,135,317,21,12,9,18,13,5,14,7,7,+2,-1,+3,82%,75%,100%,140,102,243,24%,31%,17%,4,1,3,2,2,0
295,https://vlr.gg/player/26310/ikana,2024-11-03 02:30:00,1.19,0.75,1.07,203,236,120,26,21,5,18,12,6,8,6,2,+2,+1,+1,88%,88%,89%,126,146,73,26%,28%,18%,3,2,1,1,1,0
296,https://vlr.gg/player/22829/ibrocky,2024-11-03 02:30:00,1.16,0.94,1.00,174,235,160,22,8,14,27,8,19,14,3,11,+2,0,+2,70%,78%,67%,113,154,98,40%,37%,43%,3,0,3,1,0,1
297,https://vlr.gg/player/33061/brock,2024-11-03 02:30:00,0.49,0.77,0.70,150,125,156,13,3,10,28,8,20,11,4,7,-3,-1,-2,61%,67%,58%,115,97,122,23%,21%,23%,1,0,1,4,1,3
298,https://vlr.gg/player/22831/art,2024-11-03 02:30:00,0.67,0.67,0.67,141,146,140,15,4,11,26,9,17,6,2,4,-1,0,-1,55%,56%,54%,100,103,99,30%,33%,29%,0,0,0,1,0,1
299,https://vlr.gg/player/15078/noir,2024-11-03 02:30:00,0.81,0.54,0.61,174,240,157,20,7,13,32,9,23,4,1,3,-2,-2,0,55%,56%,54%,118,157,104,24%,19%,26%,1,0,1,3,2,1
300,https://vlr.gg/player/43129/dasani,2024-11-03 02:30:00,0.01,0.73,0.45,154,20,203,16,0,16,32,9,23,7,1,6,-7,-6,-1,39%,11%,50%,103,20,134,33%,25%,34%,6,0,6,13,6,7
301,https://vlr.gg/player/11106/m1ke,2024-11-03 02:30:00,1.04,1.58,1.32,247,214,279,41,15,26,31,19,12,15,8,7,-3,-4,+1,71%,50%,91%,170,149,190,26%,25%,28%,3,0,3,6,4,2
302,https://vlr.gg/player/31629/muzz,2024-11-03 02:30:00,1.11,1.24,1.18,227,236,219,32,16,16,28,16,12,20,8,12,-2,-1,-1,69%,64%,74%,162,165,159,32%,29%,36%,4,1,3,6,2,4
303,https://vlr.gg/player/27550/exirst,2024-11-03 02:30:00,0.54,1.57,1.06,251,146,349,40,12,28,35,20,15,6,2,4,0,-1,+1,71%,55%,87%,161,89,231,27%,23%,29%,8,3,5,8,4,4
304,https://vlr.gg/player/1176/nozz,2024-11-03 02:30:00,0.76,1.24,1.00,182,147,215,29,11,18,31,18,13,17,3,14,-2,-1,-1,76%,59%,91%,116,93,139,25%,22%,28%,2,2,0,4,3,1
305,https://vlr.gg/player/14336/loubert,2024-11-03 02:30:00,0.61,1.11,0.87,151,113,187,24,9,15,30,17,13,24,8,16,0,-1,+1,71%,55%,87%,91,68,113,29%,30%,29%,2,1,1,2,2,0
306,https://vlr.gg/player/48914/lordshadow,2024-11-03 02:30:00,0.86,1.48,1.16,222,167,278,35,13,22,29,18,11,12,5,7,-1,-2,+1,69%,48%,91%,152,126,179,23%,27%,21%,3,1,2,4,3,1
307,https://vlr.gg/player/28843/abbas,2024-11-03 02:30:00,0.67,1.43,1.04,249,204,300,36,14,22,36,23,13,16,7,9,+4,+1,+3,76%,65%,86%,167,132,203,33%,33%,33%,11,5,6,7,4,3
308,https://vlr.gg/player/33714/vina,2024-11-03 02:30:00,0.67,1.08,0.87,166,143,192,27,13,14,32,20,12,15,8,7,+1,+1,0,67%,61%,73%,103,86,122,38%,46%,33%,2,1,1,1,0,1
309,https://vlr.gg/player/48913/zek,2024-11-03 02:30:00,0.79,0.85,0.82,186,211,158,29,17,12,33,22,11,4,0,4,+1,0,+1,67%,65%,68%,121,134,108,30%,33%,25%,6,4,2,5,4,1
310,https://vlr.gg/player/34257/strame,2024-11-03 02:30:00,0.50,1.04,0.76,165,115,218,28,8,20,37,21,16,9,6,3,+2,-1,+3,69%,52%,86%,103,79,128,45%,44%,46%,4,0,4,2,1,1
311,https://vlr.gg/player/48708/squish,2024-11-03 02:30:00,1.15,1.19,1.17,276,281,278,66,33,33,58,28,30,19,11,8,+5,+5,0,74%,71%,78%,177,178,176,23%,22%,24%,16,10,6,11,5,6
312,https://vlr.gg/player/44684/bored,2024-11-03 02:30:00,1.26,1.04,1.15,206,202,209,51,27,24,44,19,25,29,13,16,-2,+1,-3,73%,76%,69%,142,140,144,32%,41%,27%,4,2,2,6,1,5
313,https://vlr.gg/player/44671/emiya,2024-11-03 02:30:00,1.21,0.91,1.06,225,234,219,56,29,27,52,26,26,21,15,6,+5,0,+5,76%,76%,75%,145,149,141,20%,20%,19%,9,4,5,4,4,0
314,https://vlr.gg/player/44673/mikey,2024-11-03 02:30:00,0.87,1.22,1.05,223,192,252,53,20,33,52,27,25,33,24,9,+4,0,+4,83%,79%,86%,142,127,155,29%,32%,27%,5,1,4,1,1,0
315,https://vlr.gg/player/44674/b1n,2024-11-03 02:30:00,0.80,0.66,0.73,154,157,149,37,20,17,51,22,29,27,14,13,-2,-2,0,69%,71%,67%,97,96,98,29%,25%,32%,6,2,4,8,4,4
316,https://vlr.gg/player/31246/lychii,2024-11-03 02:30:00,1.16,1.27,1.21,220,216,222,55,27,28,47,24,23,26,11,15,-2,0,-2,79%,78%,79%,141,137,146,22%,20%,23%,3,1,2,5,1,4
317,https://vlr.gg/player/44438/kash,2024-11-03 02:30:00,1.07,1.25,1.16,236,229,245,56,27,29,50,25,25,35,19,16,+4,0,+4,77%,78%,76%,149,147,151,25%,24%,25%,11,5,6,7,5,2
318,https://vlr.gg/player/25402/irya,2024-11-03 02:30:00,1.18,0.75,0.97,214,247,178,49,31,18,56,26,30,34,14,20,-5,0,-5,76%,83%,68%,136,157,114,26%,28%,25%,5,3,2,10,3,7
319,https://vlr.gg/player/34255/fish,2024-11-03 02:30:00,0.69,1.18,0.93,216,192,244,49,23,26,56,31,25,22,8,14,-2,-4,+2,69%,64%,74%,151,129,174,16%,18%,15%,7,3,4,9,7,2
320,https://vlr.gg/player/34252/zabi,2024-11-03 02:30:00,0.83,0.66,0.75,181,208,152,48,28,20,55,28,27,4,0,4,-5,-2,-3,63%,67%,59%,116,135,95,51%,59%,41%,4,3,1,9,5,4
321,https://vlr.gg/player/2489/munchkin,2024-11-03 02:20:00,1.57,1.68,1.63,249,189,295,30,10,20,12,5,7,25,16,9,+5,+2,+3,86%,94%,79%,181,135,219,28%,15%,41%,7,2,5,2,0,2
322,https://vlr.gg/player/9196/t3xture,2024-11-03 02:20:00,1.64,1.18,1.39,282,367,217,38,22,16,21,11,10,7,4,3,+5,+4,+1,83%,88%,79%,169,207,137,28%,30%,25%,7,5,2,2,1,1
323,https://vlr.gg/player/11600/foxy9,2024-11-03 02:20:00,1.15,1.42,1.30,235,184,272,30,12,18,18,8,10,8,5,3,+2,-2,+4,86%,94%,79%,163,134,186,30%,27%,32%,6,1,5,4,3,1
324,https://vlr.gg/player/34974/karon,2024-11-03 02:20:00,0.90,1.52,1.24,191,175,205,25,11,14,14,9,5,18,5,13,+1,0,+1,80%,69%,89%,130,124,135,39%,43%,36%,2,1,1,1,1,0
325,https://vlr.gg/player/25081/yoman,2024-11-03 02:20:00,1.15,1.14,1.15,195,193,197,23,11,12,17,8,9,11,6,5,0,0,0,80%,81%,79%,140,150,132,24%,27%,22%,2,1,1,2,1,1
326,https://vlr.gg/player/48959/toast,2024-11-03 02:20:00,0.76,0.98,0.86,137,103,188,16,7,9,28,15,13,14,9,5,+1,0,+1,60%,53%,69%,93,66,124,23%,24%,22%,3,1,2,2,1,1
327,https://vlr.gg/player/13768/s1mon,2024-11-03 02:20:00,0.77,0.80,0.78,141,136,154,16,8,8,28,15,13,16,7,9,-2,-2,0,54%,53%,56%,93,81,107,26%,17%,39%,0,0,0,2,2,0
328,https://vlr.gg/player/3017/nobody,2024-11-03 02:20:00,0.54,0.81,0.66,155,155,156,17,8,9,30,17,13,6,4,2,-4,-1,-3,54%,53%,56%,105,105,104,18%,15%,22%,1,1,0,5,2,3
329,https://vlr.gg/player/48960/potter,2024-11-03 02:20:00,0.55,0.65,0.60,156,141,176,17,8,9,32,16,16,5,5,0,-4,-5,+1,49%,53%,44%,106,102,110,38%,32%,45%,5,2,3,9,7,2
330,https://vlr.gg/player/15559/chichoo,2024-11-03 02:20:00,0.59,0.56,0.58,123,141,102,15,10,5,28,17,11,1,0,1,-4,-1,-3,51%,47%,56%,79,85,72,35%,41%,25%,2,1,1,6,2,4
331,https://vlr.gg/player/485/stax,2024-11-03 00:55:00,1.33,1.34,1.34,216,219,208,29,19,10,21,14,7,19,14,5,+3,+1,+2,84%,83%,86%,152,154,150,21%,18%,25%,3,1,2,0,0,0
332,https://vlr.gg/player/4056/sylvan,2024-11-03 00:55:00,1.29,1.37,1.32,231,226,248,31,19,12,22,14,8,24,16,8,+3,+3,0,87%,83%,93%,152,139,174,34%,33%,35%,4,3,1,1,0,1
333,https://vlr.gg/player/29833/izu,2024-11-03 00:55:00,1.28,1.29,1.28,239,254,186,33,22,11,23,17,6,17,13,4,+2,+1,+1,79%,75%,86%,140,156,113,25%,24%,27%,4,3,1,2,2,0
334,https://vlr.gg/player/804/buzz,2024-11-03 00:55:00,0.87,1.15,0.97,232,233,230,31,20,11,28,19,9,7,2,5,0,+1,-1,74%,75%,71%,131,135,124,15%,16%,14%,8,5,3,8,4,4
335,https://vlr.gg/player/13039/meteor,2024-11-03 00:55:00,0.73,1.14,0.88,194,167,212,26,17,9,25,15,10,11,3,8,-2,-2,0,68%,67%,71%,126,114,145,38%,43%,31%,3,2,1,5,4,1
336,https://vlr.gg/player/4770/fengf,2024-11-03 00:55:00,1.13,1.16,1.12,257,235,289,31,10,21,33,11,22,18,4,14,-1,-1,0,68%,57%,75%,190,161,207,33%,39%,30%,6,3,3,7,4,3
337,https://vlr.gg/player/42235/dynamite,2024-11-03 00:55:00,0.49,1.21,0.94,206,115,230,26,5,21,27,10,17,7,3,4,+3,0,+3,68%,71%,67%,113,81,131,19%,20%,19%,5,1,4,2,1,1
338,https://vlr.gg/player/3045/luok1ng,2024-11-03 00:55:00,0.85,0.85,0.85,179,195,178,24,9,15,30,11,19,15,4,11,-2,0,-2,71%,71%,71%,124,119,127,36%,29%,41%,2,1,1,4,1,3
339,https://vlr.gg/player/4712/heybay,2024-11-03 00:55:00,0.97,0.65,0.77,146,166,147,18,8,10,31,11,20,10,4,6,-1,+1,-2,61%,57%,63%,103,109,100,26%,27%,26%,2,1,1,3,0,3
340,https://vlr.gg/player/3021/biank,2024-11-03 00:55:00,0.62,0.72,0.68,151,138,167,19,7,12,29,11,18,10,2,8,-5,-2,-3,61%,43%,71%,108,107,108,18%,21%,17%,1,0,1,6,2,4
341,https://vlr.gg/player/3880/bang,2024-11-02 23:00:00,1.15,1.12,1.14,229,264,218,42,20,22,39,19,20,27,13,14,-1,-3,+2,77%,79%,76%,167,183,154,38%,39%,38%,4,0,4,5,3,2
342,https://vlr.gg/player/1265/johnqt,2024-11-02 23:00:00,0.44,1.49,1.02,208,119,270,38,9,29,32,19,13,15,6,9,-4,-2,-2,68%,50%,83%,134,75,183,25%,31%,24%,2,1,1,6,3,3
343,https://vlr.gg/player/36245/n4rrate,2024-11-02 23:00:00,0.60,1.13,0.89,163,148,189,33,12,21,39,21,18,11,3,8,-1,+1,-2,66%,54%,76%,105,87,120,23%,17%,28%,2,2,0,3,1,2
344,https://vlr.gg/player/729/zellsis,2024-11-02 23:00:00,1.05,0.71,0.87,200,215,176,36,20,16,42,19,23,20,6,14,-2,-2,0,68%,58%,76%,116,121,112,31%,29%,34%,5,1,4,7,3,4
345,https://vlr.gg/player/4004/zekken,2024-11-02 23:00:00,0.43,1.20,0.86,192,134,247,35,10,25,40,20,20,11,5,6,-7,-8,+1,66%,54%,76%,132,90,167,21%,20%,21%,6,1,5,13,9,4
346,https://vlr.gg/player/21668/verno,2024-11-02 23:00:00,0.97,1.58,1.25,268,224,308,49,23,26,39,23,16,20,4,16,+6,+3,+3,77%,69%,88%,157,129,190,30%,27%,34%,9,4,5,3,1,2
347,https://vlr.gg/player/5132/mada,2024-11-02 23:00:00,1.21,1.19,1.20,275,302,199,47,29,18,38,24,14,12,4,8,+7,+4,+3,75%,69%,83%,169,189,144,22%,21%,23%,14,9,5,7,5,2
348,https://vlr.gg/player/4164/s0m,2024-11-02 23:00:00,0.99,1.21,1.09,201,195,198,37,21,16,35,22,13,22,12,10,+2,0,+2,74%,69%,79%,126,120,133,28%,37%,22%,3,1,2,1,1,0
349,https://vlr.gg/player/817/finesse,2024-11-02 23:00:00,0.80,1.14,0.96,145,121,177,29,12,17,33,20,13,19,12,7,+1,-1,+2,74%,69%,79%,95,90,101,34%,34%,33%,2,0,2,1,1,0
350,https://vlr.gg/player/11225/ethan,2024-11-02 23:00:00,0.36,1.38,0.82,165,110,248,30,9,21,39,24,15,21,11,10,-1,-5,+4,75%,59%,96%,118,76,169,23%,29%,21%,6,1,5,7,6,1
351,https://vlr.gg/player/5132/mada,2024-11-02 19:30:00,1.40,1.10,1.26,264,307,216,56,34,22,40,21,19,13,7,6,+2,-1,+3,75%,74%,77%,170,193,147,25%,29%,20%,14,8,6,12,9,3
352,https://vlr.gg/player/21668/verno,2024-11-02 19:30:00,1.16,1.21,1.19,196,193,195,44,21,23,34,19,15,20,10,10,+3,-1,+4,77%,81%,73%,127,138,115,32%,38%,27%,6,1,5,3,2,1
353,https://vlr.gg/player/11225/ethan,2024-11-02 19:30:00,1.15,1.20,1.18,214,193,229,44,23,21,36,18,18,31,18,13,-5,-2,-3,70%,71%,70%,137,111,164,28%,24%,31%,4,2,2,9,4,5
354,https://vlr.gg/player/817/finesse,2024-11-02 19:30:00,0.96,0.83,0.90,150,180,131,34,19,15,39,21,18,14,7,7,0,-1,+1,67%,71%,63%,101,115,87,26%,25%,27%,3,1,2,3,2,1
355,https://vlr.gg/player/4164/s0m,2024-11-02 19:30:00,0.56,1.05,0.80,149,114,176,29,11,18,46,25,21,36,19,17,-3,-2,-1,70%,68%,73%,90,65,116,25%,22%,27%,2,0,2,5,2,3
356,https://vlr.gg/player/18796/oxy,2024-11-02 19:30:00,1.05,1.32,1.19,248,243,256,52,24,28,42,23,19,12,8,4,+2,-1,+3,72%,63%,81%,163,163,163,27%,30%,24%,12,6,6,10,7,3
357,https://vlr.gg/player/7871/xeppaa,2024-11-02 19:30:00,1.10,1.26,1.18,227,224,234,50,24,26,42,22,20,28,14,14,+4,+1,+3,69%,70%,68%,142,136,149,28%,24%,32%,9,5,4,5,4,1
358,https://vlr.gg/player/17433/v1c,2024-11-02 19:30:00,0.94,0.76,0.85,144,113,174,31,15,16,39,16,23,22,9,13,+4,0,+4,72%,73%,71%,89,63,114,20%,16%,23%,7,1,6,3,1,2
359,https://vlr.gg/player/7458/moose,2024-11-02 19:30:00,0.79,0.86,0.82,151,112,186,31,11,20,40,17,23,12,5,7,-4,-2,-2,64%,70%,58%,98,72,124,16%,13%,18%,3,1,2,7,3,4
360,https://vlr.gg/player/1129/rossy,2024-11-02 19:30:00,0.78,0.70,0.74,148,170,130,31,17,14,44,21,23,18,8,10,-3,-2,-1,66%,77%,55%,100,112,88,24%,22%,29%,1,0,1,4,2,2
361,https://vlr.gg/player/1533/derrek,2024-11-02 16:00:00,0.96,1.29,1.15,219,194,240,48,17,31,40,18,22,16,6,10,0,-1,+1,73%,62%,81%,148,128,162,37%,40%,34%,5,1,4,5,2,3
362,https://vlr.gg/player/826/supamen,2024-11-02 16:00:00,0.99,1.12,1.06,196,181,220,45,17,28,40,18,22,19,8,11,+5,+2,+3,74%,69%,78%,121,111,127,37%,45%,33%,6,2,4,1,0,1
363,https://vlr.gg/player/881/yay,2024-11-02 16:00:00,1.00,1.03,1.02,224,233,215,49,21,28,45,21,24,13,3,10,+2,+2,0,74%,73%,75%,154,153,154,31%,31%,30%,7,4,3,5,2,3
364,https://vlr.gg/player/4927/nature,2024-11-02 16:00:00,0.60,1.05,0.85,136,104,158,30,10,20,40,20,20,28,10,18,-2,-1,-1,76%,69%,81%,89,75,98,24%,21%,27%,2,1,1,4,2,2
365,https://vlr.gg/player/3702/sym,2024-11-02 16:00:00,0.72,0.93,0.84,176,155,202,40,14,26,44,19,25,6,4,2,-3,-2,-1,61%,58%,64%,120,109,128,26%,33%,22%,12,5,7,15,7,8
366,https://vlr.gg/player/18796/oxy,2024-11-02 16:00:00,1.25,1.51,1.36,319,289,337,66,36,30,46,28,18,10,5,5,+3,0,+3,73%,67%,81%,190,180,203,32%,32%,32%,15,8,7,12,8,4
367,https://vlr.gg/player/7458/moose,2024-11-02 16:00:00,0.81,1.18,0.96,163,130,214,35,16,19,38,24,14,16,11,5,0,-2,+2,77%,75%,81%,107,87,135,32%,27%,37%,3,1,2,3,3,0
368,https://vlr.gg/player/7871/xeppaa,2024-11-02 16:00:00,0.82,1.07,0.93,170,184,161,36,20,16,43,30,13,30,17,13,-1,-1,0,81%,83%,77%,112,116,106,23%,19%,30%,5,3,2,6,4,2
369,https://vlr.gg/player/1129/rossy,2024-11-02 16:00:00,0.85,1.04,0.93,170,150,201,38,19,19,43,25,18,16,10,6,-4,0,-4,74%,78%,69%,117,106,133,41%,36%,46%,2,1,1,6,1,5
370,https://vlr.gg/player/17433/v1c,2024-11-02 16:00:00,0.81,0.70,0.76,162,174,139,34,22,12,42,26,16,27,17,10,0,+1,-1,77%,81%,73%,103,110,93,33%,32%,35%,5,4,1,5,3,2
371,https://vlr.gg/player/122/luckerrr,2024-11-02 15:00:00,1.23,0.89,1.02,233,275,205,29,15,14,33,13,20,13,2,11,-1,0,-1,64%,73%,58%,163,190,146,23%,26%,21%,3,0,3,4,0,4
372,https://vlr.gg/player/7987/kovaq,2024-11-02 15:00:00,0.85,0.86,0.86,184,180,182,25,10,15,30,11,19,0,0,0,+2,0,+2,56%,60%,54%,126,135,120,33%,36%,31%,9,4,5,7,4,3
373,https://vlr.gg/player/12593/felix,2024-11-02 15:00:00,0.83,0.84,0.84,182,176,188,22,8,14,31,12,19,14,7,7,-1,+1,-2,59%,60%,58%,125,119,129,28%,36%,23%,1,1,0,2,0,2
374,https://vlr.gg/player/7968/stavinci,2024-11-02 15:00:00,0.74,0.87,0.82,165,153,168,22,7,15,33,13,20,13,8,5,+2,+1,+1,67%,73%,63%,106,107,106,40%,50%,33%,3,2,1,1,1,0
375,https://vlr.gg/player/20302/jini,2024-11-02 15:00:00,0.37,0.90,0.70,137,129,147,19,6,13,29,13,16,16,10,6,-9,-3,-6,64%,73%,58%,86,68,97,21%,21%,21%,0,0,0,9,3,6
376,https://vlr.gg/player/12528/disisjohn,2024-11-02 15:00:00,1.05,2.67,1.74,311,240,407,25,11,14,11,8,3,2,2,0,+2,0,+2,86%,75%,100%,181,139,238,19%,15%,26%,6,3,3,4,3,1
377,https://vlr.gg/player/4969/shazeon,2024-11-02 15:00:00,1.60,0.91,1.34,246,282,183,35,26,9,22,12,10,17,10,7,+3,+2,+1,85%,88%,80%,161,188,118,26%,31%,17%,5,3,2,2,1,1
378,https://vlr.gg/player/7865/xanarchy,2024-11-02 15:00:00,1.01,1.47,1.19,208,181,257,30,16,14,23,15,8,13,7,6,+3,+2,+1,87%,92%,80%,131,109,167,34%,22%,56%,4,3,1,1,1,0
379,https://vlr.gg/player/4629/azury,2024-11-02 15:00:00,1.73,0.12,1.19,209,297,33,14,14,0,11,7,4,6,4,2,-4,-1,-3,67%,75%,50%,167,236,29,36%,40%,0%,0,0,0,4,1,3
380,https://vlr.gg/player/9508/leosen,2024-11-02 15:00:00,0.98,1.47,1.17,247,212,281,35,18,17,27,17,10,16,13,3,+4,+3,+1,79%,88%,67%,142,124,169,37%,39%,35%,6,5,1,2,2,0
381,https://vlr.gg/player/30750/enes,2024-11-02 15:00:00,0.82,0.73,0.78,136,119,165,17,9,8,23,12,11,20,13,7,-1,0,-1,77%,71%,87%,95,86,110,30%,22%,39%,2,1,1,3,1,2
382,https://vlr.gg/player/45490/ico,2024-11-02 12:00:00,1.10,1.39,1.22,282,280,287,60,33,27,47,28,19,14,9,5,+6,+2,+4,74%,72%,77%,175,169,182,22%,21%,23%,19,11,8,13,9,4
383,https://vlr.gg/player/22180/spmak,2024-11-02 12:00:00,1.09,0.71,0.93,189,226,138,36,27,9,42,25,17,18,9,9,0,-1,+1,73%,75%,69%,130,143,111,18%,16%,21%,2,0,2,2,1,1
384,https://vlr.gg/player/4525/stix,2024-11-02 12:00:00,0.76,1.15,0.92,173,136,227,36,15,21,45,26,19,21,12,9,-1,-2,+1,71%,69%,73%,126,99,162,29%,21%,40%,3,1,2,4,3,1
385,https://vlr.gg/player/30754/karma,2024-11-02 12:00:00,0.90,0.90,0.90,187,181,197,39,22,17,46,26,20,33,17,16,-4,-1,-3,65%,61%,69%,121,109,139,22%,24%,20%,4,3,1,8,4,4
386,https://vlr.gg/player/5477/leon,2024-11-02 12:00:00,0.83,0.85,0.84,184,178,194,42,23,19,47,27,20,9,7,2,+1,-2,+3,68%,64%,73%,121,118,124,25%,24%,27%,4,1,3,3,3,0
387,https://vlr.gg/player/45494/proxh,2024-11-02 12:00:00,1.22,1.59,1.44,291,269,307,66,26,40,45,21,24,19,6,13,+1,-1,+2,81%,77%,83%,194,173,209,29%,33%,27%,5,1,4,4,2,2
388,https://vlr.gg/player/27789/deyten,2024-11-02 12:00:00,1.69,1.01,1.29,222,278,182,51,28,23,39,13,26,12,3,9,-1,-2,+1,66%,69%,64%,158,193,132,27%,27%,28%,5,1,4,6,3,3
389,https://vlr.gg/player/33974/appa,2024-11-02 12:00:00,1.03,0.88,0.94,194,233,168,43,20,23,43,20,23,14,5,9,0,0,0,74%,69%,78%,140,161,124,24%,26%,22%,11,6,5,11,6,5
390,https://vlr.gg/player/22518/mimori,2024-11-02 12:00:00,0.65,1.02,0.86,151,116,176,31,9,22,42,19,23,14,4,10,0,0,0,71%,65%,75%,108,79,129,26%,30%,25%,4,2,2,4,2,2
391,https://vlr.gg/player/7991/hyperr,2024-11-02 12:00:00,0.59,1.00,0.83,162,132,185,36,12,24,44,20,24,32,12,20,-2,-3,+1,76%,65%,83%,102,88,112,30%,39%,26%,5,0,5,7,3,4
392,https://vlr.gg/player/23976/crus,2024-11-02 08:50:00,0.88,1.46,1.14,214,170,269,47,21,26,40,23,17,30,15,15,0,-3,+3,71%,63%,82%,143,115,179,39%,28%,53%,4,0,4,4,3,1
393,https://vlr.gg/player/1437/yesican,2024-11-02 08:50:00,1.26,0.99,1.14,198,202,181,41,24,17,39,21,18,31,23,8,-2,0,-2,79%,80%,79%,130,135,124,41%,41%,41%,3,1,2,5,1,4
394,https://vlr.gg/player/46463/twilight,2024-11-02 08:50:00,0.94,1.25,1.08,220,208,222,47,25,22,44,26,18,14,6,8,+4,+1,+3,70%,71%,68%,143,148,135,36%,38%,33%,8,5,3,4,4,0
395,https://vlr.gg/player/48876/foxy,2024-11-02 08:50:00,1.31,0.70,1.04,172,210,131,40,27,13,40,20,20,33,19,14,-1,0,-1,71%,80%,61%,110,135,78,39%,39%,38%,2,1,1,3,1,2
396,https://vlr.gg/player/48574/nia,2024-11-02 08:50:00,0.88,1.22,1.03,242,228,258,55,28,27,47,28,19,10,3,7,+14,+9,+5,70%,69%,71%,152,134,174,31%,34%,28%,22,14,8,8,5,3
397,https://vlr.gg/player/7443/riza,2024-11-02 08:50:00,0.86,1.43,1.18,227,177,268,48,15,33,46,22,24,19,9,10,-1,-1,0,76%,68%,83%,145,113,171,39%,38%,39%,4,1,3,5,2,3
398,https://vlr.gg/player/7513/markl,2024-11-02 08:50:00,1.17,1.04,1.10,213,234,197,45,22,23,42,19,23,17,4,13,-3,-2,-1,70%,71%,69%,143,158,131,26%,28%,23%,3,1,2,6,3,3
399,https://vlr.gg/player/5886/flaring,2024-11-02 08:50:00,0.80,0.90,0.86,162,141,179,38,15,23,46,20,26,20,7,13,-2,-1,-1,67%,68%,66%,100,82,115,33%,33%,32%,4,1,3,6,2,4
400,https://vlr.gg/player/45876/fixy,2024-11-02 08:50:00,0.86,0.87,0.86,213,252,194,49,26,23,49,23,26,9,1,8,-4,-1,-3,67%,61%,71%,138,143,134,30%,27%,32%,11,6,5,15,7,8
401,https://vlr.gg/player/3480/thedoctorr,2024-11-02 08:50:00,0.71,0.71,0.71,149,153,142,30,14,16,47,21,26,19,9,10,-5,-3,-2,62%,61%,63%,95,97,94,30%,24%,33%,2,1,1,7,4,3
402,https://vlr.gg/player/10821/delb,2024-11-02 08:30:00,,,,241,,,52,,,46,,,13,,,,,,,,,,,,,,,,,,,,
403,https://vlr.gg/player/4881/spitfires,2024-11-02 08:30:00,,,,217,,,44,,,50,,,13,,,,,,,,,,,,,,,,,,,,
404,https://vlr.gg/player/25949/bunt,2024-11-02 08:30:00,,,,165,,,31,,,45,,,26,,,,,,,,,,,,,,,,,,,,
405,https://vlr.gg/player/37019/x3b,2024-11-02 08:30:00,,,,148,,,32,,,45,,,17,,,,,,,,,,,,,,,,,,,,
406,https://vlr.gg/player/46748/k1ra,2024-11-02 08:30:00,,,,144,,,32,,,45,,,19,,,,,,,,,,,,,,,,,,,,
407,https://vlr.gg/player/5011/abo,2024-11-02 08:30:00,,,,278,,,64,,,35,,,12,,,,,,,,,,,,,,,,,,,,
408,https://vlr.gg/player/14445/ac,2024-11-02 08:30:00,,,,250,,,51,,,37,,,27,,,,,,,,,,,,,,,,,,,,
409,https://vlr.gg/player/488/rb,2024-11-02 08:30:00,,,,224,,,46,,,43,,,11,,,,,,,,,,,,,,,,,,,,
410,https://vlr.gg/player/4720/haodong,2024-11-02 08:30:00,,,,204,,,45,,,36,,,22,,,,,,,,,,,,,,,,,,,,
411,https://vlr.gg/player/41053/snail,2024-11-02 08:30:00,,,,127,,,24,,,40,,,24,,,,,,,,,,,,,,,,,,,,
412,https://vlr.gg/player/16953/zynd,2024-11-02 07:00:00,1.51,1.14,1.39,216,228,196,30,21,9,17,9,8,8,5,3,-2,0,-2,83%,88%,75%,144,152,129,25%,21%,37%,1,1,0,3,1,2
413,https://vlr.gg/player/9737/kakarot,2024-11-02 07:00:00,1.64,0.78,1.35,249,285,164,31,25,6,20,11,9,19,13,6,+1,+3,-2,81%,92%,58%,166,192,114,26%,25%,27%,3,3,0,2,0,2
414,https://vlr.gg/player/21677/jeee,2024-11-02 07:00:00,1.20,1.27,1.23,201,197,237,29,18,11,21,14,7,13,13,0,0,0,0,86%,92%,75%,141,135,154,35%,36%,33%,1,0,1,1,0,1
415,https://vlr.gg/player/7746/kevzii,2024-11-02 07:00:00,1.47,0.75,1.23,208,239,133,27,22,5,19,10,9,11,5,6,+3,+1,+2,75%,71%,83%,136,155,97,37%,40%,32%,4,2,2,1,1,0
416,https://vlr.gg/player/13744/patmen,2024-11-02 07:00:00,0.82,1.78,1.14,281,250,342,36,21,15,28,21,7,4,3,1,+8,+4,+4,75%,71%,83%,181,157,227,40%,41%,38%,14,10,4,6,6,0
417,https://vlr.gg/player/46043/answerz,2024-11-02 07:00:00,1.34,0.94,1.08,227,236,229,31,12,19,29,7,22,6,1,5,-3,-1,-2,72%,75%,71%,144,144,144,34%,32%,35%,4,1,3,7,2,5
418,https://vlr.gg/player/40889/decoy,2024-11-02 07:00:00,1.29,0.69,0.89,237,322,200,29,14,15,32,10,22,7,5,2,-2,-2,0,69%,92%,58%,154,209,127,29%,29%,29%,3,0,3,5,2,3
419,https://vlr.gg/player/40912/123,2024-11-02 07:00:00,0.61,0.75,0.70,174,63,234,20,6,14,32,10,22,4,1,3,+3,+2,+1,58%,50%,63%,119,115,121,34%,50%,28%,4,2,2,1,0,1
420,https://vlr.gg/player/40894/chintu,2024-11-02 07:00:00,0.65,0.57,0.60,123,127,122,13,5,8,29,9,20,12,6,6,-2,0,-2,64%,58%,67%,93,77,101,31%,41%,27%,1,1,0,3,1,2
421,https://vlr.gg/player/40901/orgil,2024-11-02 07:00:00,0.41,0.48,0.46,118,75,136,12,3,9,31,10,21,14,7,7,-6,-1,-5,61%,75%,54%,81,63,90,31%,17%,37%,1,1,0,7,2,5
422,https://vlr.gg/player/3547/ninebody,2024-11-02 05:10:00,,,,274,,,63,,,44,,,15,,,,,,,,,,,,,,,,,,,,
423,https://vlr.gg/player/47101/5cm,2024-11-02 05:10:00,,,,247,,,57,,,44,,,22,,,,,,,,,,,,,,,,,,,,
424,https://vlr.gg/player/3124/core,2024-11-02 05:10:00,,,,204,,,51,,,41,,,22,,,,,,,,,,,,,,,,,,,,
425,https://vlr.gg/player/41739/slowly,2024-11-02 05:10:00,,,,198,,,47,,,44,,,25,,,,,,,,,,,,,,,,,,,,
426,https://vlr.gg/player/14453/sunshine,2024-11-02 05:10:00,,,,124,,,29,,,49,,,20,,,,,,,,,,,,,,,,,,,,
427,https://vlr.gg/player/3741/vo0kashu,2024-11-02 05:10:00,,,,241,,,61,,,44,,,11,,,,,,,,,,,,,,,,,,,,
428,https://vlr.gg/player/11524/nicc,2024-11-02 05:10:00,,,,210,,,49,,,47,,,27,,,,,,,,,,,,,,,,,,,,
429,https://vlr.gg/player/31753/spiritz1,2024-11-02 05:10:00,,,,193,,,45,,,48,,,25,,,,,,,,,,,,,,,,,,,,
430,https://vlr.gg/player/7841/tvirusluke,2024-11-02 05:10:00,,,,171,,,39,,,58,,,18,,,,,,,,,,,,,,,,,,,,
431,https://vlr.gg/player/46527/cangshu,2024-11-02 05:10:00,,,,133,,,28,,,50,,,36,,,,,,,,,,,,,,,,,,,,
432,https://vlr.gg/player/804/buzz,2024-11-02 04:20:00,0.82,1.82,1.42,294,209,311,39,10,29,23,15,8,8,5,3,+10,0,+10,86%,71%,96%,172,140,195,20%,39%,13%,13,3,10,3,3,0
433,https://vlr.gg/player/29833/izu,2024-11-02 04:20:00,0.62,1.78,1.31,209,92,282,27,5,22,21,13,8,25,3,22,+2,-2,+4,81%,53%,100%,131,55,182,17%,14%,17%,6,1,5,4,3,1
434,https://vlr.gg/player/485/stax,2024-11-02 04:20:00,1.12,1.35,1.26,223,228,220,34,12,22,21,12,9,15,8,7,0,-1,+1,81%,71%,88%,156,160,153,21%,18%,23%,2,1,1,2,2,0
435,https://vlr.gg/player/13039/meteor,2024-11-02 04:20:00,1.03,1.21,1.14,188,148,228,32,10,22,22,11,11,7,3,4,+1,-1,+2,81%,71%,88%,129,104,147,24%,31%,21%,5,1,4,4,2,2
436,https://vlr.gg/player/4056/sylvan,2024-11-02 04:20:00,0.76,1.03,0.92,124,144,123,18,8,10,23,15,8,21,7,14,-3,-1,-2,83%,71%,92%,89,98,82,32%,23%,42%,0,0,0,3,1,2
437,https://vlr.gg/player/48959/toast,2024-11-02 04:20:00,0.86,1.03,0.93,133,124,164,21,11,10,27,18,9,11,4,7,+4,+1,+3,71%,56%,94%,93,77,116,37%,27%,48%,4,1,3,0,0,0
438,https://vlr.gg/player/15559/chichoo,2024-11-02 04:20:00,0.69,1.08,0.85,164,122,232,23,10,13,28,19,9,7,3,4,-2,-2,0,62%,52%,76%,106,89,130,19%,16%,23%,2,0,2,4,2,2
439,https://vlr.gg/player/13768/s1mon,2024-11-02 04:20:00,0.53,1.28,0.82,147,123,226,23,9,14,32,22,10,22,8,14,-5,-6,+1,60%,44%,82%,101,75,138,18%,21%,17%,2,0,2,7,6,1
440,https://vlr.gg/player/3017/nobody,2024-11-02 04:20:00,0.53,0.99,0.72,134,93,207,18,7,11,31,22,9,7,2,5,-1,0,-1,64%,56%,76%,98,77,128,26%,24%,29%,3,2,1,4,2,2
441,https://vlr.gg/player/48960/potter,2024-11-02 04:20:00,0.22,1.41,0.67,142,47,311,25,7,18,32,24,8,3,1,2,-6,-8,+2,52%,32%,82%,97,54,161,24%,39%,15%,5,2,3,11,10,1
442,https://vlr.gg/player/31589/murza,2024-11-02 03:30:00,1.62,1.15,1.36,293,350,248,48,25,23,29,14,15,7,5,2,-1,-1,0,80%,70%,88%,195,228,167,29%,24%,37%,6,3,3,7,4,3
443,https://vlr.gg/player/26316/ramen,2024-11-02 03:30:00,1.00,1.54,1.29,255,190,302,35,12,23,30,13,17,19,7,12,+8,+1,+7,84%,85%,83%,162,123,194,18%,18%,18%,10,3,7,2,2,0
444,https://vlr.gg/player/34226/sh0pan,2024-11-02 03:30:00,1.06,1.45,1.27,256,230,279,41,18,23,29,14,15,11,5,6,+3,+1,+2,84%,85%,83%,171,159,180,17%,31%,10%,7,3,4,4,2,2
445,https://vlr.gg/player/31593/kiss,2024-11-02 03:30:00,1.32,0.82,1.05,172,236,127,26,17,9,29,14,15,27,14,13,-2,0,-2,84%,90%,79%,126,160,97,40%,50%,30%,1,1,0,3,1,2
446,https://vlr.gg/player/46993/long,2024-11-02 03:30:00,0.97,1.00,0.98,174,164,176,23,9,14,28,13,15,37,23,14,-2,-1,-1,75%,85%,67%,108,110,106,19%,17%,20%,1,0,1,3,1,2
447,https://vlr.gg/player/48914/lordshadow,2024-11-02 03:30:00,1.38,0.98,1.20,237,244,233,38,23,15,31,15,16,10,2,8,+3,+2,+1,68%,63%,75%,154,148,162,21%,21%,20%,5,3,2,2,1,1
448,https://vlr.gg/player/34257/strame,2024-11-02 03:30:00,0.95,1.01,0.98,183,184,194,29,15,14,32,17,15,8,6,2,-1,-1,0,55%,58%,50%,121,127,113,41%,38%,45%,4,1,3,5,2,3
449,https://vlr.gg/player/33714/vina,2024-11-02 03:30:00,0.89,0.80,0.85,164,166,169,26,14,12,35,18,17,24,12,12,-1,-1,0,70%,71%,70%,117,117,118,40%,39%,41%,1,1,0,2,2,0
450,https://vlr.gg/player/28843/abbas,2024-11-02 03:30:00,0.60,0.86,0.72,178,164,194,24,12,12,36,20,16,17,8,9,-3,-4,+1,73%,75%,70%,119,115,124,22%,20%,24%,6,2,4,9,6,3
451,https://vlr.gg/player/48913/zek,2024-11-02 03:30:00,0.47,0.82,0.63,181,155,210,28,13,15,39,22,17,4,2,2,-4,-2,-2,61%,63%,60%,115,106,125,17%,24%,9%,3,2,1,7,4,3
452,https://vlr.gg/player/31255/biggiecheese,2024-11-02 03:30:00,2.34,1.64,1.76,282,367,266,30,7,23,13,0,13,24,3,21,+1,+1,0,97%,100%,96%,169,224,158,28%,29%,28%,4,1,3,3,0,3
453,https://vlr.gg/player/29821/sinaway,2024-11-02 03:30:00,0.68,1.87,1.67,297,105,339,32,1,31,11,3,8,10,4,6,+5,+1,+4,83%,60%,88%,195,65,222,33%,33%,33%,5,1,4,0,0,0
454,https://vlr.gg/player/31254/feta,2024-11-02 03:30:00,1.86,1.58,1.63,263,290,255,31,6,25,13,2,11,6,2,4,+4,+1,+3,90%,100%,88%,172,178,171,41%,45%,40%,5,1,4,1,0,1
455,https://vlr.gg/player/29790/zauqk,2024-11-02 03:30:00,2.15,1.25,1.40,245,312,229,25,6,19,13,1,12,12,4,8,+4,+1,+3,90%,100%,88%,166,196,160,22%,23%,21%,5,1,4,1,0,1
456,https://vlr.gg/player/43125/kadiri,2024-11-02 03:30:00,1.19,1.15,1.16,187,233,180,21,5,16,13,2,11,9,0,9,-1,-1,0,90%,100%,88%,141,175,134,35%,50%,31%,2,0,2,3,1,2
457,https://vlr.gg/player/41476/d4tt,2024-11-02 03:30:00,0.77,0.18,0.66,208,220,135,19,17,2,27,22,5,2,2,0,-3,-2,-1,48%,50%,40%,139,151,81,40%,45%,27%,2,1,1,5,3,2
458,https://vlr.gg/player/22833/bru,2024-11-02 03:30:00,0.65,0.45,0.60,174,187,119,17,15,2,28,23,5,2,1,1,0,+1,-1,55%,58%,40%,101,107,72,20%,21%,12%,6,6,0,6,5,1
459,https://vlr.gg/player/41477/tysonrcx,2024-11-02 03:30:00,0.62,0.39,0.57,163,176,100,14,13,1,29,24,5,2,1,1,-1,-1,0,45%,46%,40%,112,121,67,43%,36%,86%,0,0,0,1,1,0
460,https://vlr.gg/player/44701/akanekay,2024-11-02 03:30:00,0.24,0.65,0.30,92,81,153,8,5,3,27,22,5,7,7,0,-6,-5,-1,48%,50%,40%,58,53,86,37%,35%,43%,0,0,0,6,5,1
461,https://vlr.gg/player/41478/wintr,2024-11-02 03:30:00,0.21,0.03,0.16,66,72,32,5,5,0,28,23,5,4,3,1,-3,-3,0,31%,33%,20%,45,48,32,17%,14%,33%,0,0,0,3,3,0
462,https://vlr.gg/player/1771/myth,2024-11-02 03:30:00,0.82,1.80,1.42,218,114,283,30,5,25,20,9,11,25,12,13,+1,0,+1,87%,73%,96%,127,72,162,17%,29%,15%,2,0,2,1,0,1
463,https://vlr.gg/player/36747/bonobo,2024-11-02 03:30:00,1.40,1.25,1.31,236,257,224,35,14,21,21,9,12,7,3,4,-1,+1,-2,72%,67%,75%,152,157,148,40%,35%,44%,2,2,0,3,1,2
464,https://vlr.gg/player/17272/dokja,2024-11-02 03:30:00,1.25,1.17,1.20,232,257,219,33,15,18,25,10,15,8,1,7,+2,+1,+1,79%,73%,83%,163,177,155,26%,28%,23%,6,2,4,4,1,3
465,https://vlr.gg/player/31580/vizsla,2024-11-02 03:30:00,1.19,1.00,1.07,220,221,219,30,12,18,27,9,18,22,13,9,+4,+2,+2,77%,87%,71%,136,132,138,24%,34%,18%,5,2,3,1,0,1
466,https://vlr.gg/player/44437/ace,2024-11-02 03:30:00,1.49,0.72,0.99,247,319,186,33,17,16,29,11,18,6,5,1,+3,+3,0,67%,87%,54%,151,211,114,38%,39%,36%,9,5,4,6,2,4
467,https://vlr.gg/player/1176/nozz,2024-11-02 03:30:00,1.10,0.89,1.01,190,207,170,27,18,9,30,19,11,10,5,5,-1,+2,-3,69%,79%,53%,117,121,112,26%,28%,21%,4,4,0,5,2,3
468,https://vlr.gg/player/31629/muzz,2024-11-02 03:30:00,0.93,0.97,0.94,209,204,235,29,18,11,30,18,12,9,5,4,-5,-4,-1,69%,75%,60%,147,133,168,25%,26%,24%,3,1,2,8,5,3
469,https://vlr.gg/player/27550/exirst,2024-11-02 03:30:00,0.88,1.02,0.93,241,227,239,29,17,12,33,20,13,8,4,4,-2,-1,-1,62%,58%,67%,155,155,155,22%,24%,20%,4,3,1,6,4,2
470,https://vlr.gg/player/14336/loubert,2024-11-02 03:30:00,0.63,0.58,0.61,129,133,139,17,9,8,33,20,13,15,12,3,-1,0,-1,56%,63%,47%,96,95,97,30%,31%,29%,0,0,0,1,0,1
471,https://vlr.gg/player/11106/m1ke,2024-11-02 03:30:00,0.53,0.71,0.60,133,131,198,20,12,8,35,21,14,6,2,4,0,+1,-1,62%,63%,60%,101,83,131,22%,42%,10%,4,3,1,4,2,2
472,https://vlr.gg/player/5436/azoh,2024-11-02 03:30:00,1.38,0.97,1.18,221,240,201,36,20,16,31,15,16,17,8,9,+4,+3,+1,74%,79%,68%,132,140,123,26%,27%,25%,4,3,1,0,0,0
473,https://vlr.gg/player/41185/kaza,2024-11-02 03:30:00,0.81,1.28,1.03,214,183,251,36,16,20,31,17,14,11,8,3,-3,-2,-1,67%,75%,59%,156,132,181,36%,27%,45%,3,1,2,6,3,3
474,https://vlr.gg/player/5240/indie,2024-11-02 03:30:00,1.09,0.79,0.95,201,238,162,31,20,11,33,17,16,10,6,4,0,0,0,76%,79%,73%,140,170,108,23%,23%,24%,6,3,3,6,3,3
475,https://vlr.gg/player/3287/exempt,2024-11-02 03:30:00,1.13,0.69,0.92,187,214,156,28,19,9,34,17,17,21,8,13,-2,-1,-1,80%,75%,86%,120,131,108,25%,28%,22%,3,0,3,5,1,4
476,https://vlr.gg/player/31632/zenox,2024-11-02 03:30:00,0.76,1.02,0.89,189,184,198,31,15,16,35,21,14,17,11,6,-1,-2,+1,74%,83%,64%,131,122,140,28%,25%,31%,6,4,2,7,6,1
477,https://vlr.gg/player/36676/novae,2024-11-02 03:30:00,1.18,1.51,1.35,278,243,309,44,19,25,33,16,17,7,3,4,+7,+4,+3,76%,77%,75%,176,143,206,41%,36%,44%,12,6,6,5,2,3
478,https://vlr.gg/player/47212/ecco,2024-11-02 03:30:00,1.27,1.06,1.16,241,226,261,42,21,21,36,14,22,10,5,5,+1,-1,+2,72%,73%,71%,161,153,169,46%,39%,54%,4,1,3,3,2,1
479,https://vlr.gg/player/46768/indraa,2024-11-02 03:30:00,0.86,1.11,0.99,212,174,238,33,12,21,31,14,17,9,6,3,+2,+1,+1,65%,68%,63%,141,125,156,22%,17%,27%,6,3,3,4,2,2
480,https://vlr.gg/player/12964/jawsy,2024-11-02 03:30:00,1.00,0.65,0.82,156,189,127,27,16,11,34,15,19,12,3,9,-6,-3,-3,59%,59%,58%,100,114,88,32%,45%,23%,1,1,0,7,4,3
481,https://vlr.gg/player/46994/tisoyy,2024-11-02 03:30:00,0.90,0.57,0.73,124,142,107,18,10,8,30,14,16,14,6,8,-2,-1,-1,65%,64%,67%,84,95,74,36%,53%,25%,1,0,1,3,1,2
482,https://vlr.gg/player/43143/astin,2024-11-02 03:30:00,1.18,1.84,1.40,254,214,330,33,18,15,19,14,5,19,15,4,+4,+2,+2,94%,92%,100%,158,141,194,27%,38%,16%,5,3,2,1,1,0
483,https://vlr.gg/player/34217/monokuma,2024-11-02 03:30:00,1.06,1.59,1.23,239,234,256,30,18,12,20,16,4,10,7,3,+4,+3,+1,81%,79%,83%,154,151,161,33%,38%,27%,7,6,1,3,3,0
484,https://vlr.gg/player/12965/mythical,2024-11-02 03:30:00,0.99,1.53,1.17,249,240,266,33,22,11,24,18,6,4,1,3,+4,+3,+1,75%,71%,83%,154,150,163,33%,27%,47%,8,4,4,4,1,3
485,https://vlr.gg/player/44958/planko,2024-11-02 03:30:00,1.13,1.21,1.16,199,207,186,28,19,9,19,13,6,8,5,3,-1,-1,0,83%,75%,100%,140,151,118,30%,36%,19%,1,1,0,2,2,0
486,https://vlr.gg/player/33039/kakashiii,2024-11-02 03:30:00,1.39,0.66,1.15,229,263,152,30,23,7,21,14,7,9,8,1,-1,-1,0,75%,75%,75%,162,196,93,23%,24%,21%,2,1,1,3,2,1
487,https://vlr.gg/player/25402/irya,2024-11-02 03:30:00,0.89,1.15,1.06,232,212,241,27,8,19,32,10,22,19,4,15,-1,0,-1,67%,50%,75%,147,143,149,41%,56%,35%,3,1,2,4,1,3
488,https://vlr.gg/player/31246/lychii,2024-11-02 03:30:00,0.81,1.15,1.03,210,192,225,24,6,18,28,10,18,10,2,8,-1,+1,-2,53%,42%,58%,134,140,132,12%,21%,7%,2,1,1,3,0,3
489,https://vlr.gg/player/44438/kash,2024-11-02 03:30:00,0.08,1.22,0.84,214,70,282,24,3,21,33,12,21,10,1,9,-2,-3,+1,58%,33%,71%,134,51,175,18%,29%,17%,4,0,4,6,3,3
490,https://vlr.gg/player/34255/fish,2024-11-02 03:30:00,0.43,0.64,0.57,117,122,114,14,6,8,30,11,19,8,0,8,-2,-1,-1,50%,33%,58%,82,65,90,26%,60%,16%,3,1,2,5,2,3
491,https://vlr.gg/player/34252/zabi,2024-11-02 03:30:00,0.45,0.38,0.40,107,137,92,14,6,8,32,11,21,2,1,1,-4,-1,-3,58%,67%,54%,72,78,68,38%,43%,35%,1,1,0,5,2,3
492,https://vlr.gg/player/9196/t3xture,2024-11-02 01:20:00,1.23,1.35,1.29,298,282,317,48,24,24,32,16,16,8,3,5,+9,+7,+2,78%,79%,77%,179,172,186,24%,25%,24%,15,11,4,6,4,2
493,https://vlr.gg/player/25081/yoman,2024-11-02 01:20:00,1.11,1.22,1.16,179,190,168,32,17,15,22,12,10,14,5,9,+1,+2,-1,85%,88%,82%,119,136,101,29%,33%,25%,3,2,1,2,0,2
494,https://vlr.gg/player/34974/karon,2024-11-02 01:20:00,1.24,1.05,1.15,197,206,187,33,20,13,26,10,16,15,5,10,+1,+1,0,74%,79%,68%,126,125,126,29%,29%,29%,4,1,3,3,0,3
495,https://vlr.gg/player/2489/munchkin,2024-11-02 01:20:00,1.34,0.79,1.07,180,203,156,26,17,9,25,10,15,20,12,8,+1,0,+1,70%,79%,59%,118,134,100,21%,29%,13%,4,1,3,3,1,2
496,https://vlr.gg/player/11600/foxy9,2024-11-02 01:20:00,0.60,0.97,0.78,150,138,163,24,10,14,31,17,14,10,5,5,-2,0,-2,61%,63%,59%,104,92,117,18%,16%,20%,2,2,0,4,2,2
497,https://vlr.gg/player/4770/fengf,2024-11-02 01:20:00,0.97,1.43,1.21,217,169,261,37,15,22,30,14,16,3,0,3,0,+1,-1,67%,64%,71%,149,109,186,32%,39%,29%,3,3,0,3,2,1
498,https://vlr.gg/player/3045/luok1ng,2024-11-02 01:20:00,1.22,0.69,0.94,180,233,132,30,19,11,32,14,18,8,1,7,0,+3,-3,67%,82%,54%,117,157,81,45%,49%,38%,3,3,0,3,0,3
499,https://vlr.gg/player/42235/dynamite,2024-11-02 01:20:00,0.92,0.80,0.86,174,216,137,31,18,13,34,17,17,2,2,0,-3,+1,-4,57%,68%,46%,118,143,95,23%,20%,30%,6,3,3,9,2,7
500,https://vlr.gg/player/3021/biank,2024-11-02 01:20:00,0.73,0.95,0.85,159,120,196,22,8,14,31,14,17,16,9,7,-4,-3,-1,65%,64%,67%,109,87,129,17%,19%,15%,4,1,3,8,4,4
501,https://vlr.gg/player/4712/heybay,2024-11-02 01:20:00,0.72,0.44,0.57,111,137,88,16,11,5,36,16,20,21,11,10,-3,-2,-1,65%,73%,58%,69,78,61,29%,39%,19%,2,1,1,5,3,2
0,https://vlr.gg/player/21668/verno,2024-11-01 23:10:00,1.24,1.53,1.38,253,215,303,54,26,28,35,16,19,14,5,9,+1,+1,0,76%,71%,82%,177,152,205,37%,35%,38%,3,2,1,2,1,1
1,https://vlr.gg/player/4164/s0m,2024-11-01 23:10:00,1.28,0.93,1.11,213,229,195,44,25,19,39,19,20,29,20,9,-4,-2,-2,78%,77%,79%,133,140,125,34%,39%,29%,5,3,2,9,5,4
2,https://vlr.gg/player/5132/mada,2024-11-01 23:10:00,1.33,0.78,1.07,213,244,181,43,26,17,39,18,21,12,8,4,+2,+3,-1,73%,81%,64%,137,156,117,23%,22%,24%,11,7,4,9,4,5
3,https://vlr.gg/player/11225/ethan,2024-11-01 23:10:00,0.76,1.28,1.01,186,143,231,39,16,23,40,20,20,24,12,12,-2,-2,0,78%,71%,86%,115,89,143,30%,24%,34%,4,2,2,6,4,2
4,https://vlr.gg/player/817/finesse,2024-11-01 23:10:00,1.04,0.60,0.83,162,197,125,34,24,10,40,19,21,18,9,9,-2,-1,-1,73%,68%,79%,103,120,84,19%,33%,9%,4,1,3,6,2,4
5,https://vlr.gg/player/826/supamen,2024-11-01 23:10:00,1.68,0.78,1.20,217,297,140,48,33,15,39,16,23,19,9,10,+1,+3,-2,71%,82%,61%,142,182,106,26%,25%,26%,6,4,2,5,1,4
6,https://vlr.gg/player/1533/derrek,2024-11-01 23:10:00,0.86,1.14,1.01,184,150,219,39,15,24,40,19,21,16,12,4,+5,+2,+3,69%,68%,71%,137,122,150,38%,30%,47%,7,3,4,2,1,1
7,https://vlr.gg/player/881/yay,2024-11-01 23:10:00,1.15,0.73,0.93,202,262,149,44,27,17,44,21,23,7,6,1,+6,+5,+1,63%,71%,55%,129,174,89,31%,36%,24%,9,5,4,3,0,3
8,https://vlr.gg/player/4927/nature,2024-11-01 23:10:00,0.85,0.80,0.82,160,141,174,31,14,17,41,17,24,19,12,7,-2,-1,-1,73%,79%,68%,108,97,118,27%,27%,28%,2,1,1,4,2,2
9,https://vlr.gg/player/3702/sym,2024-11-01 23:10:00,0.40,0.79,0.61,156,129,188,31,12,19,50,24,26,14,6,8,-5,-5,0,63%,64%,61%,111,102,120,18%,19%,18%,8,3,5,13,8,5
10,https://vlr.gg/player/4004/zekken,2024-11-01 19:30:00,1.32,1.44,1.38,300,296,301,69,36,33,46,24,22,10,3,7,+10,+2,+8,78%,78%,77%,197,195,199,28%,27%,29%,17,7,10,7,5,2
11,https://vlr.gg/player/1265/johnqt,2024-11-01 19:30:00,0.98,1.35,1.17,182,164,201,43,19,24,33,19,14,25,12,13,-5,-3,-2,75%,66%,84%,119,105,134,27%,25%,30%,1,1,0,6,4,2
12,https://vlr.gg/player/3880/bang,2024-11-01 19:30:00,1.28,1.06,1.17,211,207,218,47,23,24,40,18,22,22,10,12,+1,+2,-1,75%,75%,74%,132,127,137,35%,33%,37%,5,4,1,4,2,2
13,https://vlr.gg/player/36245/n4rrate,2024-11-01 19:30:00,1.18,1.13,1.16,233,224,239,48,22,26,42,20,22,18,10,8,+8,+3,+5,70%,63%,77%,157,168,145,27%,29%,25%,11,5,6,3,2,1
14,https://vlr.gg/player/729/zellsis,2024-11-01 19:30:00,0.70,0.68,0.69,145,147,144,30,16,14,47,25,22,27,13,14,-1,0,-1,63%,59%,68%,97,90,105,18%,20%,16%,4,1,3,5,1,4
15,https://vlr.gg/player/881/yay,2024-11-01 19:30:00,1.36,0.95,1.15,238,285,192,53,33,20,44,23,21,11,6,5,-5,-1,-4,70%,74%,66%,159,184,135,30%,35%,24%,6,4,2,11,5,6
16,https://vlr.gg/player/4927/nature,2024-11-01 19:30:00,0.83,0.99,0.91,190,174,209,43,19,24,47,24,23,17,9,8,-1,-1,0,68%,68%,69%,117,116,117,28%,31%,25%,4,2,2,5,3,2
17,https://vlr.gg/player/826/supamen,2024-11-01 19:30:00,0.91,0.91,0.91,195,196,197,43,21,22,49,25,24,21,11,10,+2,-1,+3,73%,81%,66%,127,134,119,36%,36%,35%,7,3,4,5,4,1
18,https://vlr.gg/player/1533/derrek,2024-11-01 19:30:00,0.83,0.97,0.90,177,160,199,36,15,21,45,22,23,26,13,13,0,+1,-1,70%,74%,66%,129,124,134,26%,22%,29%,4,1,3,4,0,4
19,https://vlr.gg/player/3702/sym,2024-11-01 19:30:00,0.44,0.75,0.60,162,142,183,33,14,19,52,27,25,9,3,6,-9,-7,-2,57%,58%,56%,115,104,126,18%,27%,12%,4,1,3,13,8,5
20,https://vlr.gg/player/8730/1kuzohh,2024-11-01 17:20:00,1.45,1.12,1.28,254,279,231,42,23,19,32,15,17,11,7,4,0,0,0,72%,86%,58%,168,180,156,27%,25%,29%,8,2,6,8,2,6
21,https://vlr.gg/player/1309/tio,2024-11-01 17:20:00,1.19,0.96,1.07,200,214,191,34,18,16,29,12,17,21,11,10,+1,+2,-1,78%,82%,75%,133,140,125,20%,19%,21%,3,2,1,2,0,2
22,https://vlr.gg/player/8278/knzy,2024-11-01 17:20:00,1.41,0.75,1.07,194,269,126,32,21,11,28,12,16,9,5,4,+3,+2,+1,72%,86%,58%,121,174,73,14%,15%,12%,5,4,1,2,2,0
23,https://vlr.gg/player/38857/beng,2024-11-01 17:20:00,1.24,0.72,0.97,166,201,133,28,17,11,26,10,16,12,4,8,+2,+3,-1,70%,82%,58%,107,130,87,31%,29%,36%,4,3,1,2,0,2
24,https://vlr.gg/player/2909/alca,2024-11-01 17:20:00,0.62,0.79,0.71,151,141,159,24,12,12,32,16,16,9,6,3,-2,-1,-1,63%,64%,63%,97,90,105,30%,34%,26%,5,3,2,7,4,3
25,https://vlr.gg/player/2586/hanling,2024-11-01 17:20:00,1.25,1.21,1.23,243,244,244,37,19,18,30,14,16,14,7,7,0,+3,-3,76%,88%,64%,162,162,162,26%,30%,22%,5,5,0,5,2,3
26,https://vlr.gg/player/2403/mizu,2024-11-01 17:20:00,1.06,1.13,1.09,211,186,241,36,17,19,31,13,18,4,2,2,-2,-2,0,59%,58%,59%,136,121,153,32%,45%,24%,4,1,3,6,3,3
27,https://vlr.gg/player/2818/neto,2024-11-01 17:20:00,1.52,0.32,0.95,190,278,96,31,24,7,34,14,20,10,7,3,-2,+2,-4,63%,75%,50%,129,190,63,39%,37%,50%,5,4,1,7,2,5
28,https://vlr.gg/player/15916/jotinha,2024-11-01 17:20:00,1.04,0.69,0.88,175,150,201,25,12,13,31,12,19,14,9,5,0,0,0,67%,75%,59%,115,102,129,23%,23%,24%,4,1,3,4,1,3
29,https://vlr.gg/player/1291/bnj,2024-11-01 17:20:00,0.70,0.57,0.64,134,132,135,18,10,8,34,16,18,14,10,4,0,-1,+1,65%,75%,55%,101,98,103,17%,18%,17%,3,2,1,3,3,0
30,https://vlr.gg/player/4004/zekken,2024-11-01 17:00:00,1.62,1.65,1.63,318,305,341,49,26,23,24,12,12,10,6,4,+4,+4,0,90%,86%,94%,186,194,176,28%,31%,26%,9,7,2,5,3,2
31,https://vlr.gg/player/36245/n4rrate,2024-11-01 17:00:00,1.38,1.42,1.39,263,268,247,37,22,15,23,14,9,13,8,5,+3,+2,+1,82%,77%,88%,170,184,152,31%,37%,25%,6,3,3,3,1,2
32,https://vlr.gg/player/3880/bang,2024-11-01 17:00:00,1.23,1.44,1.32,226,202,257,33,16,17,22,12,10,19,14,5,0,-1,+1,82%,86%,76%,147,137,161,36%,39%,33%,3,1,2,3,2,1
33,https://vlr.gg/player/729/zellsis,2024-11-01 17:00:00,1.00,1.03,1.01,179,170,186,24,13,11,25,13,12,23,13,10,0,+1,-1,82%,82%,82%,109,98,123,16%,13%,19%,3,1,2,3,0,3
34,https://vlr.gg/player/1265/johnqt,2024-11-01 17:00:00,0.64,0.60,0.62,127,132,121,17,11,6,28,14,14,13,4,9,+2,+2,0,67%,64%,71%,96,88,106,27%,36%,19%,3,3,0,1,1,0
35,https://vlr.gg/player/7871/xeppaa,2024-11-01 17:00:00,0.67,1.28,1.01,228,199,248,30,11,19,32,16,16,18,8,10,-1,-1,0,69%,76%,64%,141,133,148,39%,39%,40%,1,0,1,2,1,1
36,https://vlr.gg/player/1129/rossy,2024-11-01 17:00:00,1.04,0.87,0.94,191,239,168,29,16,13,33,15,18,9,3,6,-1,-1,0,72%,76%,68%,123,156,98,34%,38%,31%,1,0,1,2,1,1
37,https://vlr.gg/player/17433/v1c,2024-11-01 17:00:00,0.76,1.01,0.90,178,156,201,23,9,14,30,12,18,20,8,12,-2,-2,0,67%,59%,73%,123,102,139,21%,15%,25%,1,0,1,3,2,1
38,https://vlr.gg/player/7458/moose,2024-11-01 17:00:00,0.88,0.77,0.82,149,162,140,20,9,11,29,13,16,8,6,2,-1,+2,-3,64%,65%,64%,111,134,92,28%,26%,31%,2,2,0,3,0,3
39,https://vlr.gg/player/18796/oxy,2024-11-01 17:00:00,0.63,0.36,0.48,171,217,135,20,12,8,36,16,20,5,3,2,-4,+1,-5,62%,71%,55%,110,135,91,30%,34%,27%,10,6,4,14,5,9
40,https://vlr.gg/player/15547/forcee,2024-11-01 15:00:00,0.88,1.15,1.03,169,137,193,26,10,16,27,11,16,23,11,12,+2,+1,+1,82%,79%,84%,110,104,114,30%,25%,33%,3,1,2,1,0,1
41,https://vlr.gg/player/46082/jcz,2024-11-01 15:00:00,0.62,1.20,0.95,218,146,264,33,10,23,36,16,20,8,4,4,+3,-1,+4,70%,63%,76%,138,102,164,29%,45%,24%,6,1,5,3,2,1
42,https://vlr.gg/player/39154/kimb0,2024-11-01 15:00:00,0.92,0.95,0.94,190,224,181,32,16,16,33,15,18,9,3,6,0,-3,+3,64%,63%,64%,127,151,108,25%,30%,18%,9,4,5,9,7,2
43,https://vlr.gg/player/29123/kivary,2024-11-01 15:00:00,0.90,0.71,0.79,165,197,145,24,12,12,36,16,20,24,13,11,-3,0,-3,77%,89%,68%,108,129,93,22%,18%,28%,1,1,0,4,1,3
44,https://vlr.gg/player/2931/vaiz,2024-11-01 15:00:00,0.53,0.92,0.75,182,149,203,24,9,15,34,15,19,7,0,7,0,-2,+2,73%,68%,76%,131,109,149,23%,25%,22%,4,0,4,4,2,2
45,https://vlr.gg/player/2464/suther,2024-11-01 15:00:00,1.61,1.27,1.46,233,258,185,35,23,12,23,13,10,25,16,9,+2,+1,+1,86%,84%,89%,151,168,129,20%,19%,20%,4,3,1,2,2,0
46,https://vlr.gg/player/3828/tacolilla,2024-11-01 15:00:00,0.77,1.55,1.11,203,166,255,32,14,18,26,17,9,12,7,5,-2,-3,+1,80%,72%,89%,127,105,155,12%,8%,17%,2,0,2,4,3,1
47,https://vlr.gg/player/12872/david,2024-11-01 15:00:00,1.10,1.03,1.07,192,199,205,33,19,14,28,16,12,13,10,3,0,-1,+1,75%,76%,74%,134,136,132,25%,29%,20%,4,2,2,4,3,1
48,https://vlr.gg/player/13860/rubkkoide,2024-11-01 15:00:00,0.66,1.49,1.02,252,214,287,38,19,19,34,22,12,9,4,5,0,-2,+2,64%,56%,74%,156,140,177,28%,36%,20%,8,4,4,8,6,2
49,https://vlr.gg/player/783/murizzz,2024-11-01 15:00:00,1.11,0.74,0.95,185,195,154,27,17,10,28,15,13,16,11,5,-2,-2,0,70%,72%,68%,114,126,98,26%,25%,28%,3,0,3,5,2,3
50,https://vlr.gg/player/23717/nythan,2024-11-01 09:00:00,1.11,1.16,1.13,217,192,268,31,16,15,30,18,12,8,6,2,-2,-2,0,65%,63%,69%,144,124,173,25%,35%,16%,2,0,2,4,2,2
51,https://vlr.gg/player/9279/kylee,2024-11-01 09:00:00,1.10,0.96,1.04,201,223,167,27,18,9,31,20,11,8,3,5,+3,+3,0,63%,58%,69%,142,146,135,48%,51%,44%,6,4,2,3,1,2
52,https://vlr.gg/player/34100/scar,2024-11-01 09:00:00,0.54,1.27,0.83,148,114,216,22,9,13,32,22,10,14,8,6,0,0,0,65%,63%,69%,102,76,142,47%,50%,44%,1,0,1,1,0,1
53,https://vlr.gg/player/37057/woody,2024-11-01 09:00:00,0.69,0.93,0.78,157,158,154,20,13,7,34,22,12,21,10,11,-3,-3,0,68%,67%,69%,104,99,111,25%,31%,19%,0,0,0,3,3,0
54,https://vlr.gg/player/34096/faustao,2024-11-01 09:00:00,0.70,0.55,0.63,155,179,137,22,14,8,34,21,13,7,4,3,-8,-6,-2,58%,58%,56%,101,117,77,32%,35%,25%,6,4,2,14,10,4
55,https://vlr.gg/player/45876/fixy,2024-11-01 09:00:00,1.21,1.65,1.47,355,327,382,47,16,31,29,13,16,12,6,6,+2,-2,+4,80%,69%,88%,237,230,241,24%,36%,18%,10,4,6,8,6,2
56,https://vlr.gg/player/5886/flaring,2024-11-01 09:00:00,0.95,1.71,1.41,245,124,307,37,8,29,21,8,13,22,8,14,+2,-1,+3,90%,88%,92%,135,71,178,30%,24%,32%,4,0,4,2,1,1
57,https://vlr.gg/player/7443/riza,2024-11-01 09:00:00,1.53,0.95,1.18,214,271,177,33,17,16,22,9,13,10,1,9,+4,+3,+1,80%,69%,88%,135,153,123,24%,29%,21%,4,3,1,0,0,0
58,https://vlr.gg/player/3480/thedoctorr,2024-11-01 09:00:00,1.03,0.86,0.93,157,180,142,23,12,11,24,10,14,20,9,11,-2,0,-2,78%,81%,75%,102,114,94,31%,33%,30%,1,0,1,3,0,3
59,https://vlr.gg/player/7513/markl,2024-11-01 09:00:00,0.55,0.78,0.69,160,107,179,21,6,15,27,12,15,7,4,3,+4,+2,+2,68%,56%,75%,96,71,113,21%,27%,19%,6,2,4,2,0,2
60,https://vlr.gg/player/4885/whzy,2024-11-01 08:30:00,,,,283,,,69,,,55,,,17,,,,,,,,,,,,,,,,,,,,
61,https://vlr.gg/player/10698/nephh,2024-11-01 08:30:00,,,,243,,,60,,,47,,,30,,,,,,,,,,,,,,,,,,,,
62,https://vlr.gg/player/40845/levius,2024-11-01 08:30:00,,,,236,,,59,,,48,,,18,,,,,,,,,,,,,,,,,,,,
63,https://vlr.gg/player/4774/knight,2024-11-01 08:30:00,,,,168,,,37,,,47,,,30,,,,,,,,,,,,,,,,,,,,
64,https://vlr.gg/player/48878/rushia,2024-11-01 08:30:00,,,,141,,,34,,,48,,,38,,,,,,,,,,,,,,,,,,,,
65,https://vlr.gg/player/22047/rarga,2024-11-01 08:30:00,,,,252,,,60,,,53,,,16,,,,,,,,,,,,,,,,,,,,
66,https://vlr.gg/player/37927/happywei,2024-11-01 08:30:00,,,,240,,,60,,,54,,,15,,,,,,,,,,,,,,,,,,,,
67,https://vlr.gg/player/4710/you,2024-11-01 08:30:00,,,,200,,,47,,,51,,,11,,,,,,,,,,,,,,,,,,,,
68,https://vlr.gg/player/36668/mart1n,2024-11-01 08:30:00,,,,158,,,44,,,45,,,24,,,,,,,,,,,,,,,,,,,,
69,https://vlr.gg/player/37674/mrcani,2024-11-01 08:30:00,,,,143,,,34,,,56,,,26,,,,,,,,,,,,,,,,,,,,
70,https://vlr.gg/player/48876/foxy,2024-11-01 07:00:00,1.01,1.21,1.09,193,188,219,28,16,12,27,19,8,17,8,9,0,0,0,74%,67%,86%,124,124,126,27%,26%,29%,3,2,1,3,2,1
71,https://vlr.gg/player/1437/yesican,2024-11-01 07:00:00,0.86,1.06,0.93,218,216,202,25,16,9,29,21,8,4,0,4,-2,-2,0,63%,54%,79%,146,151,137,37%,40%,29%,4,2,2,6,4,2
72,https://vlr.gg/player/23976/crus,2024-11-01 07:00:00,0.76,0.93,0.82,155,155,151,18,12,6,31,20,11,20,8,12,-1,-2,+1,79%,75%,86%,106,105,109,31%,34%,26%,1,0,1,2,2,0
73,https://vlr.gg/player/48574/nia,2024-11-01 07:00:00,0.23,1.79,0.80,200,121,352,26,7,19,31,23,8,7,4,3,-1,-3,+2,55%,46%,71%,138,86,228,23%,13%,33%,4,1,3,5,4,1
74,https://vlr.gg/player/46463/twilight,2024-11-01 07:00:00,0.41,0.77,0.54,122,119,129,17,10,7,32,23,9,5,3,2,-2,-3,+1,68%,67%,71%,78,81,74,22%,18%,33%,4,2,2,6,5,1
75,https://vlr.gg/player/40910/consz,2024-11-01 07:00:00,1.74,1.95,1.87,332,296,341,48,15,33,20,9,11,9,4,5,+4,+2,+2,87%,79%,92%,222,229,218,37%,32%,40%,6,2,4,2,0,2
76,https://vlr.gg/player/40908/skyisblue,2024-11-01 07:00:00,0.96,1.52,1.31,261,269,241,36,13,23,23,13,10,11,2,9,0,-1,+1,84%,79%,88%,147,162,138,25%,21%,27%,5,2,3,5,3,2
77,https://vlr.gg/player/44770/cxix666,2024-11-01 07:00:00,0.54,1.64,1.24,211,105,276,29,4,25,20,10,10,9,2,7,+1,-3,+4,79%,57%,92%,152,88,190,16%,14%,17%,4,0,4,3,3,0
78,https://vlr.gg/player/44930/nex1sphix,2024-11-01 07:00:00,0.63,0.86,0.77,132,125,135,17,7,10,22,10,12,12,1,11,-1,-1,0,66%,36%,83%,98,79,110,19%,19%,19%,2,0,2,3,1,2
79,https://vlr.gg/player/40907/mnfear,2024-11-01 07:00:00,0.46,0.86,0.71,162,106,198,20,5,15,29,11,18,13,1,12,+2,-1,+3,79%,64%,88%,109,69,131,25%,20%,28%,5,1,4,3,2,1
80,https://vlr.gg/player/6022/yosemite,2024-11-01 05:00:00,,,,241,,,56,,,48,,,15,,,,,,,,,,,,,,,,,,,,
81,https://vlr.gg/player/3028/life,2024-11-01 05:00:00,,,,221,,,49,,,56,,,11,,,,,,,,,,,,,,,,,,,,
82,https://vlr.gg/player/19530/aaaay,2024-11-01 05:00:00,,,,182,,,41,,,42,,,14,,,,,,,,,,,,,,,,,,,,
83,https://vlr.gg/player/7857/berlin,2024-11-01 05:00:00,,,,180,,,40,,,51,,,24,,,,,,,,,,,,,,,,,,,,
84,https://vlr.gg/player/872/autumn,2024-11-01 05:00:00,,,,136,,,32,,,51,,,13,,,,,,,,,,,,,,,,,,,,
85,https://vlr.gg/player/14125/spring,2024-11-01 05:00:00,,,,258,,,63,,,47,,,10,,,,,,,,,,,,,,,,,,,,
86,https://vlr.gg/player/37489/lysoar,2024-11-01 05:00:00,,,,220,,,54,,,41,,,13,,,,,,,,,,,,,,,,,,,,
87,https://vlr.gg/player/45104/v1ya,2024-11-01 05:00:00,,,,199,,,48,,,42,,,27,,,,,,,,,,,,,,,,,,,,
88,https://vlr.gg/player/11218/yuicaw,2024-11-01 05:00:00,,,,198,,,45,,,44,,,34,,,,,,,,,,,,,,,,,,,,
89,https://vlr.gg/player/7849/siufatbb,2024-11-01 05:00:00,,,,169,,,38,,,45,,,22,,,,,,,,,,,,,,,,,,,,
90,https://vlr.gg/player/31589/murza,2024-11-01 03:30:00,1.31,2.03,1.91,328,345,324,38,6,32,10,4,6,9,2,7,+3,0,+3,97%,100%,96%,198,196,199,26%,33%,24%,5,1,4,2,1,1
91,https://vlr.gg/player/34226/sh0pan,2024-11-01 03:30:00,1.93,1.59,1.65,271,340,254,30,7,23,12,3,9,9,2,7,+2,+1,+1,83%,80%,83%,184,202,180,30%,18%,34%,3,1,2,1,0,1
92,https://vlr.gg/player/46993/long,2024-11-01 03:30:00,0.90,1.43,1.34,245,181,257,26,4,22,15,4,11,22,2,20,+1,-1,+2,90%,100%,88%,145,116,151,25%,7%,30%,3,0,3,2,1,1
93,https://vlr.gg/player/31593/kiss,2024-11-01 03:30:00,1.35,1.29,1.29,239,197,249,23,4,19,18,3,15,24,3,21,+3,0,+3,90%,100%,88%,151,114,159,30%,33%,29%,5,0,5,2,0,2
94,https://vlr.gg/player/26316/ramen,2024-11-01 03:30:00,0.75,1.19,1.11,163,180,163,17,3,14,12,3,9,15,1,14,0,+1,-1,86%,100%,83%,115,140,110,23%,23%,23%,3,1,2,3,0,3
95,https://vlr.gg/player/43105/capy,2024-11-01 03:30:00,0.68,1.24,0.78,185,159,307,18,13,5,27,22,5,5,3,2,+2,0,+2,55%,50%,80%,115,97,205,33%,52%,13%,2,0,2,0,0,0
96,https://vlr.gg/player/42196/icy,2024-11-01 03:30:00,0.53,0.81,0.58,138,127,195,14,10,4,27,22,5,3,3,0,-2,-1,-1,55%,50%,80%,86,80,114,17%,19%,13%,4,4,0,6,5,1
97,https://vlr.gg/player/44694/dazeryuf,2024-11-01 03:30:00,0.35,1.27,0.51,140,99,336,14,7,7,26,22,4,4,4,0,-2,-2,0,48%,42%,80%,88,71,167,24%,29%,20%,0,0,0,2,2,0
98,https://vlr.gg/player/48912/kookie,2024-11-01 03:30:00,0.56,0.11,0.48,102,108,66,9,9,0,26,21,5,5,1,4,0,0,0,48%,42%,80%,74,75,66,20%,25%,9%,1,1,0,1,1,0
99,https://vlr.gg/player/48911/kruise,2024-11-01 03:30:00,0.47,0.10,0.39,136,151,72,12,11,1,28,23,5,0,0,0,-7,-5,-2,48%,54%,20%,97,105,57,25%,24%,25%,3,3,0,10,8,2
100,https://vlr.gg/player/29790/zauqk,2024-11-01 03:30:00,1.33,1.20,1.27,213,228,202,35,20,15,21,10,11,12,7,5,-1,-2,+1,75%,78%,71%,147,171,122,24%,25%,23%,2,0,2,3,2,1
101,https://vlr.gg/player/31255/biggiecheese,2024-11-01 03:30:00,1.17,1.36,1.26,217,195,241,35,17,18,28,16,12,25,11,14,0,0,0,84%,87%,81%,139,136,142,36%,36%,36%,4,2,2,4,2,2
102,https://vlr.gg/player/29821/sinaway,2024-11-01 03:30:00,1.18,1.29,1.23,227,238,219,38,20,18,25,14,11,11,8,3,+3,+1,+2,80%,87%,71%,162,162,163,30%,33%,26%,6,3,3,3,2,1
103,https://vlr.gg/player/31254/feta,2024-11-01 03:30:00,1.18,1.04,1.11,236,239,233,32,18,14,32,16,16,20,7,13,+8,+4,+4,77%,74%,81%,162,161,163,28%,22%,35%,11,6,5,3,2,1
104,https://vlr.gg/player/43125/kadiri,2024-11-01 03:30:00,1.02,0.96,0.99,202,225,175,33,19,14,30,17,13,3,2,1,-2,0,-2,70%,70%,71%,138,153,121,44%,43%,45%,3,2,1,5,2,3
105,https://vlr.gg/player/43129/dasani,2024-11-01 03:30:00,1.25,1.36,1.31,298,294,303,45,21,24,35,17,18,4,3,1,+4,+1,+3,73%,67%,78%,198,180,215,35%,29%,40%,10,5,5,6,4,2
106,https://vlr.gg/player/33061/brock,2024-11-01 03:30:00,1.15,0.77,0.95,208,228,182,30,17,13,33,15,18,5,3,2,0,0,0,64%,67%,61%,136,159,115,28%,24%,33%,4,1,3,4,1,3
107,https://vlr.gg/player/22829/ibrocky,2024-11-01 03:30:00,0.75,0.81,0.78,130,103,153,21,9,12,32,14,18,15,7,8,-2,0,-2,68%,67%,70%,94,79,108,25%,45%,16%,2,2,0,4,2,2
108,https://vlr.gg/player/31597/water,2024-11-01 03:30:00,0.33,0.82,0.59,140,95,187,20,6,14,37,18,19,12,4,8,-4,-3,-1,50%,38%,61%,97,62,129,24%,13%,29%,1,0,1,5,3,2
109,https://vlr.gg/player/15078/noir,2024-11-01 03:30:00,0.72,0.46,0.59,149,154,145,19,9,10,36,16,20,8,4,4,-6,-3,-3,50%,48%,52%,108,119,98,22%,24%,20%,1,0,1,7,3,4
110,https://vlr.gg/player/1771/myth,2024-11-01 03:30:00,0.88,1.85,1.51,293,166,348,35,8,27,18,8,10,18,4,14,0,-1,+1,81%,77%,83%,191,110,235,20%,20%,19%,3,0,3,3,1,2
111,https://vlr.gg/player/36747/bonobo,2024-11-01 03:30:00,1.22,1.35,1.30,251,240,247,31,11,20,22,9,13,16,4,12,+6,+2,+4,76%,69%,79%,163,152,169,43%,34%,49%,8,2,6,2,0,2
112,https://vlr.gg/player/31580/vizsla,2024-11-01 03:30:00,1.84,0.97,1.27,218,310,176,29,15,14,20,6,14,16,8,8,+4,+3,+1,78%,85%,75%,143,189,118,17%,24%,13%,6,4,2,2,1,1
113,https://vlr.gg/player/44437/ace,2024-11-01 03:30:00,0.85,1.29,1.13,221,156,264,30,8,22,23,8,15,5,2,3,+3,+1,+2,70%,69%,71%,143,105,163,26%,23%,27%,5,2,3,2,1,1
114,https://vlr.gg/player/17272/dokja,2024-11-01 03:30:00,1.08,0.94,0.99,208,209,202,29,10,19,23,6,17,9,3,6,0,0,0,76%,77%,75%,137,125,143,28%,26%,29%,3,1,2,3,1,2
115,https://vlr.gg/player/34234/shinon,2024-11-01 03:30:00,1.93,0.37,1.37,264,351,101,33,29,4,27,16,11,8,8,0,0,+2,-2,57%,71%,31%,172,228,67,28%,30%,18%,2,2,0,2,0,2
116,https://vlr.gg/player/48916/nyli,2024-11-01 03:30:00,0.60,1.58,0.92,197,153,317,26,11,15,32,22,10,7,7,0,+1,0,+1,54%,54%,54%,135,95,210,38%,30%,50%,6,5,1,5,5,0
117,https://vlr.gg/player/37161/ponk,2024-11-01 03:30:00,0.60,1.13,0.78,164,131,207,19,11,8,30,20,10,12,4,8,-2,-2,0,57%,50%,69%,100,88,122,17%,14%,20%,1,0,1,3,2,1
118,https://vlr.gg/player/43101/onob,2024-11-01 03:30:00,0.30,0.60,0.41,140,131,179,18,11,7,36,24,12,8,5,3,-5,-5,0,49%,42%,62%,95,82,119,25%,31%,20%,3,1,2,8,6,2
119,https://vlr.gg/player/43107/cman,2024-11-01 03:30:00,0.40,0.42,0.41,92,102,71,10,7,3,29,20,9,6,4,2,-7,-3,-4,49%,50%,46%,62,67,54,20%,21%,18%,0,0,0,7,3,4
120,https://vlr.gg/player/1062/lew,2024-11-01 03:30:00,1.24,1.03,1.14,237,268,207,43,25,18,39,21,18,13,8,5,+8,+5,+3,82%,85%,80%,157,170,144,22%,21%,22%,9,6,3,1,1,0
121,https://vlr.gg/player/5228/minimise,2024-11-01 03:30:00,0.97,1.10,1.03,209,201,223,38,18,20,40,21,19,27,14,13,0,+1,-1,84%,81%,88%,131,130,132,23%,21%,26%,5,2,3,5,1,4
122,https://vlr.gg/player/3294/punda,2024-11-01 03:30:00,1.11,0.85,0.98,215,259,167,34,22,12,39,20,19,25,14,11,0,+1,-1,75%,81%,68%,151,172,129,26%,33%,21%,4,3,1,4,2,2
123,https://vlr.gg/player/12968/tixx,2024-11-01 03:30:00,0.85,1.06,0.95,207,174,231,32,14,18,37,18,19,17,10,7,+10,+3,+7,75%,81%,68%,131,111,152,29%,38%,24%,11,4,7,1,1,0
124,https://vlr.gg/player/6659/dragon,2024-11-01 03:30:00,0.93,0.44,0.69,135,153,127,27,15,12,36,15,21,10,6,4,-1,0,-1,53%,58%,48%,96,112,79,28%,34%,21%,5,3,2,6,3,3
125,https://vlr.gg/player/48914/lordshadow,2024-11-01 03:30:00,1.29,1.30,1.30,209,208,216,41,20,21,30,15,15,12,5,7,-4,-1,-3,78%,76%,81%,150,152,147,27%,36%,19%,1,1,0,5,2,3
126,https://vlr.gg/player/48913/zek,2024-11-01 03:30:00,0.98,1.40,1.20,227,202,250,40,18,22,33,17,16,11,6,5,0,-1,+1,73%,68%,77%,158,136,180,27%,27%,28%,1,0,1,1,1,0
127,https://vlr.gg/player/28843/abbas,2024-11-01 03:30:00,0.98,1.14,1.07,253,225,282,44,19,25,39,18,21,9,6,3,-6,-4,-2,61%,64%,58%,159,138,179,33%,22%,46%,7,3,4,13,7,6
128,https://vlr.gg/player/33714/vina,2024-11-01 03:30:00,1.31,0.60,0.94,190,251,127,34,23,11,37,16,21,26,10,16,-7,-2,-5,67%,72%,62%,129,172,87,38%,44%,29%,2,2,0,9,4,5
129,https://vlr.gg/player/34257/strame,2024-11-01 03:30:00,1.10,0.75,0.92,188,179,195,32,16,16,35,14,21,10,4,6,0,+1,-1,67%,76%,58%,127,122,133,26%,31%,23%,6,3,3,6,2,4
130,https://vlr.gg/player/26315/tout,2024-11-01 03:30:00,0.60,1.76,1.11,226,170,317,52,21,31,47,33,14,8,3,5,+5,-1,+6,65%,43%,93%,152,107,208,24%,30%,20%,10,4,6,5,5,0
131,https://vlr.gg/player/31243/avi,2024-11-01 03:30:00,0.91,1.17,1.03,179,161,206,42,19,23,44,27,17,17,10,7,+1,-3,+4,71%,62%,83%,120,116,125,20%,22%,17%,6,1,5,5,4,1
132,https://vlr.gg/player/48915/sz-xz,2024-11-01 03:30:00,1.00,0.92,0.96,191,184,192,42,22,20,48,28,20,19,14,5,-6,-5,-1,74%,76%,72%,131,125,140,22%,20%,24%,2,0,2,8,5,3
133,https://vlr.gg/player/33042/velora,2024-11-01 03:30:00,0.70,1.14,0.90,230,191,286,53,22,31,56,34,22,16,9,7,-6,-6,0,61%,57%,66%,151,128,179,25%,25%,25%,7,3,4,13,9,4
134,https://vlr.gg/player/26311/binjo,2024-11-01 03:30:00,0.70,0.80,0.74,141,158,133,31,18,13,49,31,18,14,6,8,+4,+2,+2,58%,54%,62%,95,103,85,21%,22%,21%,7,4,3,3,2,1
135,https://vlr.gg/player/41477/tysonrcx,2024-11-01 03:30:00,1.22,1.43,1.34,235,245,238,56,23,33,35,19,16,17,6,11,+2,-1,+3,79%,69%,86%,164,170,160,28%,28%,28%,5,1,4,3,2,1
136,https://vlr.gg/player/44701/akanekay,2024-11-01 03:30:00,0.59,1.36,1.02,215,152,262,48,16,32,48,26,22,27,5,22,-4,-5,+1,70%,52%,84%,146,99,183,24%,24%,24%,7,1,6,11,6,5
137,https://vlr.gg/player/22833/bru,2024-11-01 03:30:00,0.90,1.07,0.99,224,239,206,50,22,28,49,27,22,16,6,10,+1,-1,+2,65%,59%,70%,139,142,136,14%,9%,22%,10,6,4,9,7,2
138,https://vlr.gg/player/41476/d4tt,2024-11-01 03:30:00,0.60,1.23,0.94,178,105,225,45,11,34,42,21,21,11,6,5,0,-2,+2,65%,52%,76%,110,74,138,25%,23%,27%,4,0,4,4,2,2
139,https://vlr.gg/player/41478/wintr,2024-11-01 03:30:00,0.70,1.08,0.91,196,184,196,45,19,26,46,25,21,17,6,11,+3,-2,+5,67%,72%,62%,119,118,120,28%,36%,23%,8,1,7,5,3,2
140,https://vlr.gg/player/31629/muzz,2024-11-01 03:30:00,1.49,1.64,1.57,285,284,285,37,18,19,16,8,8,11,6,5,-2,-2,0,86%,88%,83%,173,171,174,31%,13%,59%,2,1,1,4,3,1
141,https://vlr.gg/player/11106/m1ke,2024-11-01 03:30:00,1.53,1.44,1.48,328,338,318,40,21,19,23,10,13,14,5,9,+3,+1,+2,80%,71%,89%,217,223,212,28%,30%,26%,3,1,2,0,0,0
142,https://vlr.gg/player/1176/nozz,2024-11-01 03:30:00,1.96,0.88,1.41,178,277,88,23,19,4,13,5,8,30,11,19,+2,+1,+1,89%,100%,78%,126,204,52,27%,30%,18%,2,1,1,0,0,0
143,https://vlr.gg/player/27550/exirst,2024-11-01 03:30:00,0.85,1.41,1.14,226,183,266,29,11,18,19,10,9,6,4,2,+8,+1,+7,86%,82%,89%,145,134,156,24%,32%,15%,11,3,8,3,2,1
144,https://vlr.gg/player/14336/loubert,2024-11-01 03:30:00,0.76,1.39,1.08,207,147,264,27,9,18,21,11,10,14,7,7,+4,+2,+2,83%,82%,83%,136,96,174,36%,35%,37%,7,4,3,3,2,1
145,https://vlr.gg/player/44673/mikey,2024-11-01 03:30:00,1.39,0.77,1.09,209,274,142,27,17,10,29,14,15,8,2,6,0,0,0,63%,72%,53%,139,194,82,32%,29%,38%,2,1,1,2,1,1
146,https://vlr.gg/player/44671/emiya,2024-11-01 03:30:00,0.72,0.87,0.79,190,190,190,21,11,10,31,16,15,7,2,5,-1,-1,0,60%,61%,59%,136,133,141,29%,19%,43%,1,1,0,2,2,0
147,https://vlr.gg/player/44674/b1n,2024-11-01 03:30:00,0.88,0.59,0.74,145,163,128,16,10,6,29,14,15,10,6,4,-2,-1,-1,49%,50%,47%,96,103,88,23%,19%,27%,2,0,2,4,1,3
148,https://vlr.gg/player/48708/squish,2024-11-01 03:30:00,0.27,0.81,0.47,139,84,197,14,4,10,34,17,17,7,3,4,-8,-7,-1,51%,50%,53%,99,63,137,14%,8%,17%,3,1,2,11,8,3
149,https://vlr.gg/player/44684/bored,2024-11-01 03:30:00,0.35,0.58,0.46,124,112,141,14,6,8,33,17,16,7,5,2,-4,-3,-1,54%,50%,59%,79,77,80,23%,17%,29%,2,0,2,6,3,3
150,https://vlr.gg/player/48865/nezek,2024-10-31 17:15:00,0.73,1.19,1.00,215,147,255,23,7,16,27,11,16,12,6,6,-1,0,-1,65%,64%,65%,129,96,152,31%,22%,37%,1,0,1,2,0,2
151,https://vlr.gg/player/41107/zeravla,2024-10-31 17:15:00,0.84,1.03,0.95,229,194,264,26,9,17,30,11,19,3,2,1,-3,-5,+2,53%,43%,60%,153,127,171,23%,23%,22%,6,2,4,9,7,2
152,https://vlr.gg/player/48863/mystizip,2024-10-31 17:15:00,1.21,0.37,0.72,164,267,96,19,13,6,29,11,18,13,9,4,-2,+1,-3,56%,79%,40%,97,147,62,19%,13%,33%,3,2,1,5,1,4
153,https://vlr.gg/player/48864/mrtn,2024-10-31 17:15:00,0.67,0.59,0.63,142,140,147,16,7,9,29,11,18,5,0,5,+1,0,+1,44%,43%,45%,93,90,95,24%,17%,31%,3,1,2,2,1,1
154,https://vlr.gg/player/48862/cl4yerr,2024-10-31 17:15:00,0.63,0.51,0.55,151,137,160,15,6,9,30,11,19,11,6,5,-3,0,-3,53%,57%,50%,100,89,107,14%,13%,14%,0,0,0,3,0,3
155,https://vlr.gg/player/38857/beng,2024-10-31 17:15:00,1.59,1.27,1.46,233,239,229,32,21,11,15,8,7,12,8,4,-1,-1,0,74%,75%,71%,154,169,133,34%,31%,41%,0,0,0,1,1,0
156,https://vlr.gg/player/1309/tio,2024-10-31 17:15:00,1.36,1.35,1.36,203,211,204,27,16,11,16,10,6,19,12,7,+3,+3,0,82%,90%,71%,128,127,128,20%,19%,21%,4,3,1,1,0,1
157,https://vlr.gg/player/2909/alca,2024-10-31 17:15:00,1.14,1.25,1.19,266,278,226,29,19,10,24,15,9,14,8,6,+8,+4,+4,88%,90%,86%,168,174,158,30%,27%,39%,9,4,5,1,0,1
158,https://vlr.gg/player/8278/knzy,2024-10-31 17:15:00,1.28,0.92,1.13,196,189,192,24,15,9,19,9,10,14,8,6,-1,0,-1,76%,85%,64%,115,115,116,16%,13%,21%,1,0,1,2,0,2
159,https://vlr.gg/player/8730/1kuzohh,2024-10-31 17:15:00,0.99,1.28,1.11,274,278,270,33,19,14,25,15,10,8,5,3,-1,-2,+1,76%,75%,79%,169,177,158,28%,25%,33%,7,5,2,8,7,1
160,https://vlr.gg/player/35660/tok1o,2024-10-31 15:00:00,1.24,1.18,1.20,246,300,216,32,14,18,27,12,15,6,2,4,+1,+2,-1,73%,77%,71%,161,182,150,26%,25%,26%,2,2,0,1,0,1
161,https://vlr.gg/player/42378/nicky,2024-10-31 15:00:00,0.14,1.25,0.85,183,59,252,27,3,24,29,12,17,3,2,1,+1,-1,+2,62%,38%,75%,103,37,139,29%,60%,27%,3,0,3,2,1,1
162,https://vlr.gg/player/33177/none,2024-10-31 15:00:00,0.74,0.75,0.74,199,233,180,26,11,15,32,12,20,3,0,3,0,+1,-1,54%,46%,58%,120,144,108,24%,29%,21%,8,3,5,8,2,6
163,https://vlr.gg/player/21548/adenina,2024-10-31 15:00:00,0.44,0.72,0.62,177,160,190,22,7,15,33,12,21,6,2,4,0,0,0,70%,77%,67%,114,91,127,30%,38%,28%,2,0,2,2,0,2
164,https://vlr.gg/player/21108/ponix,2024-10-31 15:00:00,0.21,0.38,0.32,102,92,107,10,3,7,30,11,19,15,7,8,-3,-1,-2,57%,62%,54%,65,60,68,22%,25%,21%,3,2,1,6,3,3
165,https://vlr.gg/player/1291/bnj,2024-10-31 15:00:00,1.60,1.82,1.68,290,284,297,39,25,14,19,13,6,15,7,8,+3,+1,+2,84%,79%,92%,184,185,181,36%,45%,24%,6,4,2,3,3,0
166,https://vlr.gg/player/2818/neto,2024-10-31 15:00:00,0.81,1.97,1.22,260,204,369,36,17,19,28,20,8,5,3,2,+4,+3,+1,68%,63%,77%,171,139,230,33%,35%,30%,9,6,3,5,3,2
167,https://vlr.gg/player/2586/hanling,2024-10-31 15:00:00,1.33,0.99,1.21,196,222,149,27,20,7,23,15,8,17,10,7,-1,+1,-2,84%,88%,77%,137,146,118,32%,33%,30%,1,1,0,2,0,2
168,https://vlr.gg/player/15916/jotinha,2024-10-31 15:00:00,0.94,1.60,1.18,207,189,238,27,15,12,21,16,5,14,10,4,-4,-4,0,81%,79%,85%,145,130,172,32%,27%,41%,1,0,1,5,4,1
169,https://vlr.gg/player/2403/mizu,2024-10-31 15:00:00,0.81,0.59,0.73,161,163,159,22,15,7,26,15,11,4,2,2,-1,+1,-2,70%,67%,77%,115,118,109,37%,33%,47%,2,2,0,3,1,2
170,https://vlr.gg/player/40912/123,2024-10-31 09:00:00,1.34,1.30,1.32,258,238,280,44,22,22,29,14,15,12,8,4,+1,-1,+2,81%,83%,78%,166,165,168,30%,38%,22%,7,2,5,6,3,3
171,https://vlr.gg/player/40901/orgil,2024-10-31 09:00:00,1.12,1.42,1.27,209,173,246,37,15,22,27,14,13,13,8,5,+5,+2,+3,72%,71%,74%,132,112,153,47%,38%,54%,5,2,3,0,0,0
172,https://vlr.gg/player/40889/decoy,2024-10-31 09:00:00,1.46,0.74,1.11,239,348,127,41,30,11,33,20,13,11,7,4,+1,+4,-3,81%,88%,74%,156,220,90,21%,19%,26%,8,7,1,7,3,4
173,https://vlr.gg/player/40894/chintu,2024-10-31 09:00:00,0.82,1.12,0.96,181,138,223,29,11,18,31,16,15,26,14,12,+2,0,+2,81%,75%,87%,115,93,138,33%,36%,32%,3,0,3,1,0,1
174,https://vlr.gg/player/46043/answerz,2024-10-31 09:00:00,0.79,0.82,0.81,171,184,156,28,14,14,34,19,15,10,4,6,-4,-5,+1,60%,50%,70%,132,146,117,27%,27%,26%,3,1,2,7,6,1
175,https://vlr.gg/player/27645/amernone,2024-10-31 09:00:00,1.37,0.98,1.17,251,290,214,41,23,18,36,17,19,10,4,6,0,-2,+2,68%,65%,71%,157,184,131,17%,17%,18%,9,4,5,9,6,3
176,https://vlr.gg/player/10833/owen,2024-10-31 09:00:00,1.10,1.11,1.11,228,222,235,37,17,20,36,17,19,17,11,6,-1,-2,+1,79%,83%,75%,144,131,156,21%,18%,23%,3,1,2,4,3,1
177,https://vlr.gg/player/13119/artaa,2024-10-31 09:00:00,1.13,0.80,0.96,164,167,159,27,13,14,32,14,18,23,12,11,-1,0,-1,70%,70%,71%,105,102,109,27%,30%,25%,4,2,2,5,2,3
178,https://vlr.gg/player/37028/goldenblue,2024-10-31 09:00:00,0.40,1.11,0.77,173,103,242,29,8,21,39,19,20,11,4,7,-4,-3,-1,60%,43%,75%,115,78,151,23%,15%,28%,2,0,2,6,3,3
179,https://vlr.gg/player/11475/vs,2024-10-31 09:00:00,0.54,0.73,0.63,133,130,135,20,10,10,36,20,16,14,5,9,+1,+2,-1,64%,61%,67%,86,80,91,32%,50%,23%,3,2,1,2,0,2
180,https://vlr.gg/player/4133/lawrence,2024-10-31 07:35:00,1.07,0.75,0.94,239,270,185,30,20,10,31,19,12,6,4,2,0,+1,-1,68%,70%,67%,157,175,128,57%,54%,64%,3,2,1,3,1,2
181,https://vlr.gg/player/45813/requ1em,2024-10-31 07:35:00,0.55,1.33,0.86,176,132,265,25,11,14,28,19,9,4,3,1,-4,-5,+1,61%,52%,73%,115,87,156,21%,23%,19%,2,0,2,6,5,1
182,https://vlr.gg/player/48879/sin,2024-10-31 07:35:00,0.86,0.89,0.86,155,163,139,20,13,7,27,18,9,10,6,4,+2,-1,+3,66%,65%,67%,107,115,95,48%,46%,50%,4,0,4,2,1,1
183,https://vlr.gg/player/48877/heesu,2024-10-31 07:35:00,0.66,0.80,0.72,195,214,175,26,16,10,31,20,11,7,6,1,-2,-1,-1,58%,57%,60%,119,130,103,21%,22%,18%,6,5,1,8,6,2
184,https://vlr.gg/player/4425/richard,2024-10-31 07:35:00,0.44,0.64,0.49,99,94,128,12,6,6,32,19,13,15,8,7,-2,-3,+1,71%,65%,80%,71,64,82,24%,13%,60%,1,0,1,3,3,0
185,https://vlr.gg/player/25089/cabeza,2024-10-31 07:35:00,1.05,1.55,1.35,232,160,256,30,10,20,18,8,10,11,0,11,+1,-1,+2,74%,60%,83%,152,115,176,29%,25%,31%,3,0,3,2,1,1
186,https://vlr.gg/player/25082/rico,2024-10-31 07:35:00,1.52,1.20,1.33,225,239,215,33,13,20,22,8,14,15,7,8,-1,0,-1,89%,87%,91%,136,144,131,28%,38%,22%,2,1,1,3,1,2
187,https://vlr.gg/player/17049/hermes,2024-10-31 07:35:00,0.89,1.56,1.29,254,206,264,33,11,22,23,11,12,7,2,5,+1,-2,+3,71%,53%,83%,156,120,179,25%,23%,26%,5,1,4,4,3,1
188,https://vlr.gg/player/25080/empty,2024-10-31 07:35:00,1.06,1.27,1.19,245,244,234,32,12,20,25,10,15,12,6,6,+6,+1,+5,76%,73%,78%,145,135,152,17%,21%,16%,11,4,7,5,3,2
189,https://vlr.gg/player/4127/felix,2024-10-31 07:35:00,0.87,0.87,0.87,152,184,154,21,8,13,25,10,15,15,5,10,-1,-1,0,74%,67%,78%,112,137,96,23%,26%,21%,1,0,1,2,1,1
190,https://vlr.gg/player/46748/k1ra,2024-10-31 07:20:00,,,,235,,,29,,,31,,,11,,,,,,,,,,,,,,,,,,,,
191,https://vlr.gg/player/10821/delb,2024-10-31 07:20:00,,,,173,,,21,,,29,,,5,,,,,,,,,,,,,,,,,,,,
192,https://vlr.gg/player/46749/player,2024-10-31 07:20:00,,,,161,,,19,,,31,,,4,,,,,,,,,,,,,,,,,,,,
193,https://vlr.gg/player/37019/x3b,2024-10-31 07:20:00,,,,140,,,15,,,30,,,22,,,,,,,,,,,,,,,,,,,,
194,https://vlr.gg/player/4881/spitfires,2024-10-31 07:20:00,,,,135,,,16,,,30,,,9,,,,,,,,,,,,,,,,,,,,
195,https://vlr.gg/player/1209/swerl,2024-10-31 07:20:00,,,,283,,,38,,,20,,,7,,,,,,,,,,,,,,,,,,,,
196,https://vlr.gg/player/4402/o0o0o,2024-10-31 07:20:00,,,,232,,,31,,,20,,,21,,,,,,,,,,,,,,,,,,,,
197,https://vlr.gg/player/41054/guang,2024-10-31 07:20:00,,,,229,,,30,,,19,,,5,,,,,,,,,,,,,,,,,,,,
198,https://vlr.gg/player/39697/cb,2024-10-31 07:20:00,,,,218,,,27,,,17,,,20,,,,,,,,,,,,,,,,,,,,
199,https://vlr.gg/player/46460/ezeir,2024-10-31 07:20:00,,,,205,,,25,,,24,,,25,,,,,,,,,,,,,,,,,,,,
200,https://vlr.gg/player/23930/potter,2024-10-31 07:00:00,1.35,1.77,1.53,334,318,361,49,27,22,29,16,13,7,4,3,0,+1,-1,83%,92%,72%,220,204,240,33%,35%,32%,6,5,1,6,4,2
201,https://vlr.gg/player/27254/leviathan,2024-10-31 07:00:00,1.54,1.15,1.37,237,262,203,37,24,13,25,13,12,14,10,4,-3,-1,-2,74%,83%,61%,151,161,138,50%,45%,61%,2,1,1,5,2,3
202,https://vlr.gg/player/4377/johnolsen,2024-10-31 07:00:00,1.27,1.15,1.22,233,258,209,37,25,12,27,15,12,11,7,4,+3,0,+3,74%,71%,78%,153,167,135,25%,29%,21%,5,2,3,2,2,0
203,https://vlr.gg/player/3342/sushiboys,2024-10-31 07:00:00,0.96,0.71,0.85,164,161,141,23,14,9,27,15,12,18,14,4,-5,-4,-1,74%,75%,72%,96,109,80,32%,33%,29%,2,1,1,7,5,2
204,https://vlr.gg/player/2366/alert,2024-10-31 07:00:00,1.05,0.43,0.79,140,162,105,19,13,6,28,13,15,12,10,2,-3,0,-3,67%,79%,50%,92,107,73,36%,37%,33%,2,1,1,5,1,4
205,https://vlr.gg/player/13744/patmen,2024-10-31 07:00:00,1.26,0.94,1.08,239,265,234,33,16,17,33,11,22,12,3,9,+5,+3,+2,76%,83%,71%,160,158,162,31%,33%,29%,11,5,6,6,2,4
206,https://vlr.gg/player/21677/jeee,2024-10-31 07:00:00,0.97,0.76,0.85,188,229,167,29,15,14,33,14,19,10,8,2,-1,0,-1,76%,89%,67%,134,153,120,38%,47%,29%,2,0,2,3,0,3
207,https://vlr.gg/player/7746/kevzii,2024-10-31 07:00:00,1.06,0.65,0.83,171,207,138,26,15,11,32,12,20,4,2,2,+1,+2,-1,60%,67%,54%,111,122,103,31%,31%,30%,2,2,0,1,0,1
208,https://vlr.gg/player/9737/kakarot,2024-10-31 07:00:00,0.84,0.74,0.78,144,126,151,19,7,12,30,10,20,16,9,7,-1,-1,0,69%,72%,67%,97,88,103,23%,24%,22%,2,1,1,3,2,1
209,https://vlr.gg/player/16953/zynd,2024-10-31 07:00:00,0.63,0.84,0.75,205,178,224,29,11,18,37,15,22,10,6,4,+4,0,+4,71%,89%,58%,125,123,126,27%,31%,24%,8,3,5,4,3,1
210,https://vlr.gg/player/3547/ninebody,2024-10-31 05:00:00,,,,220,,,35,,,33,,,7,,,,,,,,,,,,,,,,,,,,
211,https://vlr.gg/player/47101/5cm,2024-10-31 05:00:00,,,,211,,,35,,,34,,,9,,,,,,,,,,,,,,,,,,,,
212,https://vlr.gg/player/3124/core,2024-10-31 05:00:00,,,,200,,,30,,,35,,,12,,,,,,,,,,,,,,,,,,,,
213,https://vlr.gg/player/41739/slowly,2024-10-31 05:00:00,,,,144,,,22,,,36,,,10,,,,,,,,,,,,,,,,,,,,
214,https://vlr.gg/player/14453/sunshine,2024-10-31 05:00:00,,,,113,,,15,,,32,,,19,,,,,,,,,,,,,,,,,,,,
215,https://vlr.gg/player/16924/stew,2024-10-31 05:00:00,,,,287,,,43,,,30,,,11,,,,,,,,,,,,,,,,,,,,
216,https://vlr.gg/player/36415/viva,2024-10-31 05:00:00,,,,239,,,42,,,25,,,12,,,,,,,,,,,,,,,,,,,,
217,https://vlr.gg/player/41029/z1yan,2024-10-31 05:00:00,,,,230,,,36,,,30,,,8,,,,,,,,,,,,,,,,,,,,
218,https://vlr.gg/player/3049/sword9,2024-10-31 05:00:00,,,,179,,,27,,,27,,,18,,,,,,,,,,,,,,,,,,,,
219,https://vlr.gg/player/3519/jkuro,2024-10-31 05:00:00,,,,136,,,22,,,25,,,25,,,,,,,,,,,,,,,,,,,,
220,https://vlr.gg/player/4426/klaus,2024-10-31 04:00:00,1.53,0.89,1.25,229,253,183,49,31,18,40,21,19,26,18,8,+1,+3,-2,77%,85%,68%,150,172,122,35%,45%,25%,4,3,1,3,0,3
221,https://vlr.gg/player/37532/zexy,2024-10-31 04:00:00,1.28,1.12,1.21,316,330,283,62,38,24,50,27,23,20,10,10,+10,+7,+3,73%,74%,71%,199,216,178,22%,24%,20%,22,15,7,12,8,4
222,https://vlr.gg/player/42733/xuna,2024-10-31 04:00:00,1.20,1.19,1.19,198,189,216,44,24,20,35,19,16,25,14,11,0,0,0,77%,85%,68%,138,128,149,32%,28%,38%,1,0,1,1,0,1
223,https://vlr.gg/player/34926/oonzmlp,2024-10-31 04:00:00,0.90,1.30,1.08,199,179,238,47,23,24,41,24,17,30,18,12,-3,-3,0,81%,85%,75%,126,101,156,27%,21%,34%,4,2,2,7,5,2
224,https://vlr.gg/player/2149/c1nder,2024-10-31 04:00:00,1.03,0.84,0.95,166,181,153,38,23,15,40,21,19,37,20,17,+2,+1,+1,79%,76%,82%,102,107,94,21%,15%,34%,5,1,4,3,0,3
225,https://vlr.gg/player/45097/dipa,2024-10-31 04:00:00,1.04,1.12,1.08,195,186,195,42,18,24,43,19,24,20,9,11,0,+1,-1,71%,64%,76%,124,119,128,33%,25%,40%,4,2,2,4,1,3
226,https://vlr.gg/player/4650/gangazi,2024-10-31 04:00:00,1.35,0.86,1.07,212,235,209,47,25,22,46,18,28,20,10,10,-2,-2,0,79%,82%,76%,141,150,134,32%,32%,31%,5,2,3,7,4,3
227,https://vlr.gg/player/44586/annyeon,2024-10-31 04:00:00,1.22,0.69,0.93,200,235,181,43,22,21,49,19,30,27,14,13,-3,+2,-5,69%,79%,62%,135,155,119,34%,31%,37%,7,4,3,10,2,8
228,https://vlr.gg/player/34892/mir,2024-10-31 04:00:00,0.63,0.92,0.78,183,154,217,38,15,23,51,22,29,13,4,9,+1,0,+1,71%,64%,76%,123,103,140,14%,15%,14%,10,5,5,9,5,4
229,https://vlr.gg/player/42845/xenus,2024-10-31 04:00:00,0.70,0.76,0.74,147,132,168,35,14,21,51,23,28,17,9,8,-6,-3,-3,63%,71%,56%,92,81,102,22%,38%,15%,0,0,0,6,3,3
230,https://vlr.gg/player/46902/21,2024-10-30 18:10:00,1.38,1.08,1.23,223,260,185,53,29,24,41,23,18,20,8,12,+3,+3,0,69%,64%,74%,147,172,119,29%,28%,30%,6,5,1,3,2,1
231,https://vlr.gg/player/35739/evoluzionz,2024-10-30 18:10:00,0.86,1.31,1.08,186,150,226,40,15,25,38,22,16,21,12,9,+2,-1,+3,72%,70%,74%,128,104,153,25%,21%,28%,5,2,3,3,3,0
232,https://vlr.gg/player/35665/miyeon,2024-10-30 18:10:00,0.71,1.46,1.07,257,213,307,56,22,34,50,29,21,17,8,9,0,-7,+7,67%,52%,84%,172,146,199,22%,22%,22%,15,4,11,15,11,4
233,https://vlr.gg/player/3677/fross,2024-10-30 18:10:00,0.70,1.36,1.02,198,148,250,39,15,24,44,25,19,35,15,20,+3,+1,+2,66%,58%,74%,134,96,175,16%,13%,18%,5,1,4,2,0,2
234,https://vlr.gg/player/43926/crazy-ny,2024-10-30 18:10:00,0.71,0.81,0.76,142,131,153,35,19,16,44,25,19,11,3,8,-2,-3,+1,66%,64%,68%,93,85,102,30%,24%,36%,4,1,3,6,4,2
235,https://vlr.gg/player/46082/jcz,2024-10-30 18:10:00,0.90,1.43,1.18,235,179,287,50,19,31,45,25,20,17,5,12,+2,+1,+1,70%,61%,79%,158,122,191,38%,32%,42%,10,4,6,8,3,5
236,https://vlr.gg/player/2931/vaiz,2024-10-30 18:10:00,0.85,1.39,1.13,245,196,290,54,20,34,46,25,21,11,5,6,-1,-3,+2,73%,61%,85%,157,126,186,25%,31%,22%,7,2,5,8,5,3
237,https://vlr.gg/player/15547/forcee,2024-10-30 18:10:00,0.83,1.08,0.96,143,148,140,33,16,17,37,22,15,29,14,15,-1,-2,+1,77%,77%,76%,100,99,100,27%,33%,23%,1,0,1,2,2,0
238,https://vlr.gg/player/39154/kimb0,2024-10-30 18:10:00,0.67,1.15,0.92,178,145,209,42,16,26,46,26,20,14,6,8,-3,-5,+2,59%,55%,64%,118,93,142,23%,23%,22%,9,2,7,12,7,5
239,https://vlr.gg/player/29123/kivary,2024-10-30 18:10:00,0.96,0.63,0.79,164,204,126,38,22,16,50,26,24,25,17,8,-3,-4,+1,64%,61%,67%,103,127,82,22%,17%,31%,2,1,1,5,5,0
240,https://vlr.gg/player/29242/erde,2024-10-30 15:00:00,1.28,1.47,1.39,265,248,292,60,24,36,41,21,20,26,13,13,0,-3,+3,75%,66%,83%,184,167,197,32%,32%,32%,9,2,7,9,5,4
241,https://vlr.gg/player/29243/neon,2024-10-30 15:00:00,0.75,1.45,1.13,243,187,275,52,17,35,42,24,18,12,5,7,+7,+1,+6,66%,52%,77%,145,115,170,22%,17%,28%,13,5,8,6,4,2
242,https://vlr.gg/player/29240/skyppervz,2024-10-30 15:00:00,1.01,1.16,1.09,171,140,196,38,15,23,37,18,19,31,13,18,+2,+1,+1,75%,62%,86%,115,99,128,38%,42%,35%,4,1,3,2,0,2
243,https://vlr.gg/player/29241/miradaninja,2024-10-30 15:00:00,1.10,0.86,0.97,170,217,134,37,22,15,38,21,17,16,7,9,-2,-2,0,69%,66%,71%,105,131,83,22%,28%,17%,5,3,2,7,5,2
244,https://vlr.gg/player/29244/mikey-tap,2024-10-30 15:00:00,0.47,1.31,0.93,175,93,238,39,9,30,40,21,19,17,8,9,-3,-2,-1,66%,52%,77%,121,64,169,30%,29%,30%,3,1,2,6,3,3
245,https://vlr.gg/player/12872/david,2024-10-30 15:00:00,0.74,1.62,1.14,220,150,313,51,17,34,44,27,17,23,12,11,0,-2,+2,70%,60%,83%,153,107,209,29%,29%,30%,4,0,4,4,2,2
246,https://vlr.gg/player/2464/suther,2024-10-30 15:00:00,0.71,1.20,0.93,167,133,211,37,15,22,44,28,16,26,15,11,-2,0,-2,70%,63%,79%,116,86,152,21%,11%,32%,4,2,2,6,2,4
247,https://vlr.gg/player/3828/tacolilla,2024-10-30 15:00:00,0.90,0.91,0.90,148,161,138,35,21,14,41,24,17,12,4,8,0,-2,+2,63%,63%,62%,98,99,96,17%,24%,12%,5,2,3,5,4,1
248,https://vlr.gg/player/783/murizzz,2024-10-30 15:00:00,0.90,0.86,0.86,175,175,177,39,22,17,47,27,20,18,9,9,-4,-3,-1,55%,49%,62%,122,121,124,29%,33%,26%,5,3,2,9,6,3
249,https://vlr.gg/player/13860/rubkkoide,2024-10-30 15:00:00,0.61,0.91,0.74,163,159,166,36,18,18,50,33,17,13,9,4,+2,-2,+4,64%,57%,72%,100,97,104,27%,23%,33%,12,6,6,10,8,2
250,https://vlr.gg/player/7443/riza,2024-10-30 10:20:00,1.20,1.28,1.24,268,280,254,69,36,33,48,25,23,16,9,7,+7,+1,+6,83%,82%,84%,178,191,166,36%,38%,33%,10,3,7,3,2,1
251,https://vlr.gg/player/7513/markl,2024-10-30 10:20:00,1.38,1.01,1.19,226,252,206,58,32,26,48,19,29,22,6,16,-2,+1,-3,77%,85%,70%,157,169,146,26%,29%,23%,3,1,2,5,0,5
252,https://vlr.gg/player/5886/flaring,2024-10-30 10:20:00,1.00,0.91,0.96,180,206,166,45,24,21,51,24,27,29,11,18,-1,-1,0,75%,71%,78%,124,142,107,30%,27%,35%,5,3,2,6,4,2
253,https://vlr.gg/player/45876/fixy,2024-10-30 10:20:00,0.96,0.83,0.89,230,256,201,58,32,26,57,26,31,9,2,7,-6,-2,-4,66%,68%,65%,146,157,135,20%,28%,14%,11,8,3,17,10,7
254,https://vlr.gg/player/3480/thedoctorr,2024-10-30 10:20:00,0.63,1.09,0.87,190,135,231,44,15,29,51,24,27,33,16,17,-1,+1,-2,69%,74%,65%,120,88,150,24%,27%,23%,5,2,3,6,1,5
255,https://vlr.gg/player/40910/consz,2024-10-30 10:20:00,1.22,1.33,1.27,247,252,241,63,33,30,54,28,26,15,11,4,+1,0,+1,77%,78%,76%,163,163,164,30%,31%,30%,9,3,6,8,3,5
256,https://vlr.gg/player/44770/cxix666,2024-10-30 10:20:00,0.92,1.17,1.04,178,162,197,49,23,26,46,24,22,15,8,7,+1,+1,0,76%,78%,74%,119,105,134,23%,22%,24%,5,3,2,4,2,2
257,https://vlr.gg/player/40908/skyisblue,2024-10-30 10:20:00,1.17,0.86,1.02,235,256,217,57,33,24,59,28,31,24,12,12,+2,+4,-2,66%,65%,68%,146,155,136,27%,26%,28%,12,10,2,10,6,4
258,https://vlr.gg/player/40907/mnfear,2024-10-30 10:20:00,0.80,1.06,0.92,214,186,246,51,25,26,60,30,30,24,7,17,+2,-2,+4,66%,65%,68%,141,129,154,26%,26%,25%,9,3,6,7,5,2
259,https://vlr.gg/player/44930/nex1sphix,2024-10-30 10:20:00,0.98,0.53,0.76,145,184,104,35,23,12,55,25,30,27,14,13,-3,0,-3,70%,73%,68%,107,136,77,25%,30%,18%,2,1,1,5,1,4
260,https://vlr.gg/player/3741/vo0kashu,2024-10-30 07:05:00,,,,239,,,47,,,40,,,9,,,,,,,,,,,,,,,,,,,,
261,https://vlr.gg/player/7841/tvirusluke,2024-10-30 07:05:00,,,,206,,,39,,,46,,,8,,,,,,,,,,,,,,,,,,,,
262,https://vlr.gg/player/31753/spiritz1,2024-10-30 07:05:00,,,,190,,,35,,,45,,,20,,,,,,,,,,,,,,,,,,,,
263,https://vlr.gg/player/11524/nicc,2024-10-30 07:05:00,,,,122,,,18,,,43,,,30,,,,,,,,,,,,,,,,,,,,
264,https://vlr.gg/player/46527/cangshu,2024-10-30 07:05:00,,,,110,,,18,,,45,,,32,,,,,,,,,,,,,,,,,,,,
265,https://vlr.gg/player/37927/happywei,2024-10-30 07:05:00,,,,286,,,55,,,36,,,10,,,,,,,,,,,,,,,,,,,,
266,https://vlr.gg/player/22047/rarga,2024-10-30 07:05:00,,,,263,,,56,,,34,,,10,,,,,,,,,,,,,,,,,,,,
267,https://vlr.gg/player/4710/you,2024-10-30 07:05:00,,,,251,,,43,,,28,,,20,,,,,,,,,,,,,,,,,,,,
268,https://vlr.gg/player/36668/mart1n,2024-10-30 07:05:00,,,,175,,,33,,,33,,,27,,,,,,,,,,,,,,,,,,,,
269,https://vlr.gg/player/37674/mrcani,2024-10-30 07:05:00,,,,156,,,31,,,26,,,35,,,,,,,,,,,,,,,,,,,,
270,https://vlr.gg/player/46463/twilight,2024-10-30 07:00:00,1.39,1.37,1.38,256,259,249,71,33,38,48,26,22,25,18,7,+6,+1,+5,73%,72%,75%,171,174,169,37%,37%,36%,8,1,7,2,0,2
271,https://vlr.gg/player/1437/yesican,2024-10-30 07:00:00,1.30,1.40,1.35,263,254,283,73,35,38,52,27,25,25,17,8,+3,+1,+2,76%,79%,73%,180,170,189,38%,38%,38%,7,3,4,4,2,2
272,https://vlr.gg/player/23976/crus,2024-10-30 07:00:00,0.84,0.93,0.88,165,156,173,45,22,23,56,27,29,33,13,20,0,-1,+1,75%,74%,75%,112,104,121,34%,32%,37%,4,2,2,4,3,1
273,https://vlr.gg/player/48574/nia,2024-10-30 07:00:00,0.62,1.10,0.86,219,189,250,60,25,35,67,36,31,14,5,9,-3,-7,+4,57%,54%,60%,140,116,164,21%,18%,24%,19,8,11,22,15,7
274,https://vlr.gg/player/48876/foxy,2024-10-30 07:00:00,0.86,0.80,0.83,171,180,156,46,23,23,61,32,29,38,21,17,-5,-3,-2,75%,85%,65%,109,115,104,26%,24%,29%,2,1,1,7,4,3
275,https://vlr.gg/player/9279/kylee,2024-10-30 07:00:00,1.51,0.77,1.14,227,300,146,63,43,20,57,28,29,20,7,13,+4,0,+4,71%,70%,72%,141,188,93,41%,49%,29%,9,4,5,5,4,1
276,https://vlr.gg/player/37057/woody,2024-10-30 07:00:00,0.86,1.28,1.07,210,171,259,61,24,37,56,29,27,28,15,13,-2,+1,-3,73%,73%,74%,141,118,164,26%,24%,27%,2,1,1,4,0,4
277,https://vlr.gg/player/34100/scar,2024-10-30 07:00:00,0.86,1.11,0.98,180,155,208,49,22,27,55,28,27,34,16,18,+8,+2,+6,73%,68%,79%,120,98,143,36%,37%,35%,9,2,7,1,0,1
278,https://vlr.gg/player/23717/nythan,2024-10-30 07:00:00,0.76,1.01,0.88,202,185,214,51,21,30,61,34,27,28,18,10,-6,-4,-2,75%,73%,77%,135,128,143,20%,19%,20%,7,3,4,13,7,6
279,https://vlr.gg/player/34096/faustao,2024-10-30 07:00:00,0.60,1.14,0.87,213,186,251,60,26,34,66,38,28,14,5,9,-5,-9,+4,70%,65%,74%,150,126,174,29%,38%,22%,12,5,7,17,14,3
280,https://vlr.gg/player/42710/froz,2024-10-30 06:10:00,1.31,1.91,1.65,277,219,314,48,17,31,26,15,11,16,4,12,0,-1,+1,85%,75%,92%,191,147,225,39%,44%,37%,2,1,1,2,2,0
281,https://vlr.gg/player/42769/wezzy,2024-10-30 06:10:00,1.17,1.29,1.24,245,263,240,40,18,22,31,15,16,15,4,11,+2,+1,+1,65%,60%,69%,170,165,174,30%,44%,22%,7,4,3,5,3,2
282,https://vlr.gg/player/42771/nameless,2024-10-30 06:10:00,0.91,1.28,1.12,226,201,236,35,14,21,30,14,16,13,3,10,0,-2,+2,67%,55%,77%,151,135,163,35%,31%,38%,4,0,4,4,2,2
283,https://vlr.gg/player/4666/acme,2024-10-30 06:10:00,0.59,0.94,0.79,189,114,243,28,7,21,37,16,21,19,6,13,+1,-1,+2,76%,60%,88%,118,77,149,26%,32%,23%,7,2,5,6,3,3
284,https://vlr.gg/player/4060/daegi,2024-10-30 06:10:00,0.68,0.80,0.75,179,174,180,30,11,19,36,17,19,9,3,6,-1,+1,-2,74%,60%,85%,115,117,113,23%,22%,24%,4,2,2,5,1,4
285,https://vlr.gg/player/4040/nezz,2024-10-30 06:10:00,1.13,1.09,1.11,224,263,190,37,22,15,34,22,12,12,8,4,+2,+2,0,85%,88%,80%,155,184,118,25%,22%,33%,3,3,0,1,1,0
286,https://vlr.gg/player/1986/idg,2024-10-30 06:10:00,0.92,1.23,1.05,245,184,288,38,18,20,36,21,15,16,10,6,+4,+1,+3,65%,65%,65%,140,107,183,26%,23%,28%,6,1,5,2,0,2
287,https://vlr.gg/player/20928/seolho,2024-10-30 06:10:00,0.79,1.15,0.94,189,171,228,29,15,14,37,24,13,30,12,18,-1,-1,0,85%,81%,90%,123,104,148,25%,23%,28%,3,1,2,4,2,2
288,https://vlr.gg/player/42721/awayk,2024-10-30 06:10:00,0.86,1.02,0.93,215,203,236,36,18,18,37,23,14,10,7,3,-1,-2,+1,70%,73%,65%,127,123,133,30%,31%,29%,8,5,3,9,7,2
289,https://vlr.gg/player/9194/blueming,2024-10-30 06:10:00,0.41,0.83,0.59,140,134,144,20,11,9,38,24,14,26,16,10,-6,-4,-2,74%,69%,80%,86,87,86,22%,26%,18%,2,1,1,8,5,3
290,https://vlr.gg/player/488/rb,2024-10-30 05:00:00,,,,204,,,26,,,33,,,14,,,,,,,,,,,,,,,,,,,,
291,https://vlr.gg/player/5011/abo,2024-10-30 05:00:00,,,,203,,,25,,,33,,,6,,,,,,,,,,,,,,,,,,,,
292,https://vlr.gg/player/14445/ac,2024-10-30 05:00:00,,,,202,,,27,,,29,,,8,,,,,,,,,,,,,,,,,,,,
293,https://vlr.gg/player/41053/snail,2024-10-30 05:00:00,,,,169,,,22,,,33,,,7,,,,,,,,,,,,,,,,,,,,
294,https://vlr.gg/player/4720/haodong,2024-10-30 05:00:00,,,,107,,,14,,,30,,,6,,,,,,,,,,,,,,,,,,,,
295,https://vlr.gg/player/14125/spring,2024-10-30 05:00:00,,,,309,,,44,,,23,,,9,,,,,,,,,,,,,,,,,,,,
296,https://vlr.gg/player/37489/lysoar,2024-10-30 05:00:00,,,,243,,,32,,,24,,,5,,,,,,,,,,,,,,,,,,,,
297,https://vlr.gg/player/7849/siufatbb,2024-10-30 05:00:00,,,,229,,,34,,,16,,,11,,,,,,,,,,,,,,,,,,,,
298,https://vlr.gg/player/45104/v1ya,2024-10-30 05:00:00,,,,190,,,25,,,23,,,24,,,,,,,,,,,,,,,,,,,,
299,https://vlr.gg/player/11218/yuicaw,2024-10-30 05:00:00,,,,160,,,23,,,28,,,19,,,,,,,,,,,,,,,,,,,,
300,https://vlr.gg/player/985/efina,2024-10-30 04:00:00,1.96,1.29,1.61,292,358,228,37,21,16,21,10,11,9,4,5,+4,+4,0,89%,94%,84%,205,251,164,40%,46%,33%,5,4,1,1,0,1
301,https://vlr.gg/player/9783/doenmo,2024-10-30 04:00:00,1.40,1.67,1.54,266,251,281,35,16,19,18,9,9,22,9,13,+3,0,+3,78%,65%,89%,165,161,167,25%,25%,26%,6,2,4,3,2,1
302,https://vlr.gg/player/4827/goddead,2024-10-30 04:00:00,1.18,1.39,1.29,208,212,209,28,14,14,21,13,8,20,14,6,+1,-2,+3,83%,76%,89%,136,131,141,19%,22%,17%,3,0,3,2,2,0
303,https://vlr.gg/player/5283/bunny,2024-10-30 04:00:00,0.71,1.59,1.18,246,162,315,30,8,22,25,12,13,14,8,6,+1,0,+1,81%,82%,79%,153,109,193,15%,7%,20%,5,2,3,4,2,2
304,https://vlr.gg/player/28401/pkm,2024-10-30 04:00:00,1.09,1.18,1.14,216,199,235,30,13,17,20,10,10,10,3,7,-1,-1,0,75%,76%,74%,144,146,143,32%,32%,32%,3,1,2,4,2,2
305,https://vlr.gg/player/48873/maine,2024-10-30 04:00:00,1.54,1.47,1.51,347,342,348,42,22,20,30,16,14,7,3,4,+3,+3,0,67%,68%,65%,225,225,225,30%,27%,32%,10,5,5,7,2,5
306,https://vlr.gg/player/34906/danger,2024-10-30 04:00:00,0.47,1.02,0.73,180,147,220,18,7,11,32,18,14,13,7,6,-1,-1,0,58%,47%,71%,127,105,152,13%,15%,11%,2,0,2,3,1,2
307,https://vlr.gg/player/34908/goofy,2024-10-30 04:00:00,0.50,0.56,0.51,128,159,96,16,10,6,30,17,13,5,3,2,-4,-4,0,56%,63%,47%,85,105,63,32%,42%,18%,1,0,1,5,4,1
308,https://vlr.gg/player/48872/wooda,2024-10-30 04:00:00,0.23,0.51,0.36,126,105,152,17,7,10,34,18,16,6,2,4,-2,-2,0,47%,42%,53%,85,76,96,28%,39%,21%,1,1,0,3,3,0
309,https://vlr.gg/player/48874/grit,2024-10-30 04:00:00,0.22,0.50,0.35,108,93,125,12,5,7,34,19,15,13,5,8,-4,-3,-1,61%,53%,71%,76,70,82,32%,29%,35%,0,0,0,4,3,1
310,https://vlr.gg/player/29243/neon,2024-10-29 17:20:00,2.24,1.96,2.10,372,429,324,41,22,19,11,6,5,12,4,8,+8,+6,+2,93%,93%,93%,222,267,181,39%,31%,54%,9,7,2,1,1,0
311,https://vlr.gg/player/29242/erde,2024-10-29 17:20:00,1.90,1.85,1.88,337,328,343,38,18,20,12,5,7,14,6,8,+2,0,+2,93%,86%,100%,209,201,216,17%,20%,14%,3,0,3,1,0,1
312,https://vlr.gg/player/29244/mikey-tap,2024-10-29 17:20:00,1.11,1.40,1.26,185,158,210,22,8,14,13,7,6,5,2,3,+3,0,+3,90%,86%,93%,130,107,151,41%,41%,42%,4,1,3,1,1,0
313,https://vlr.gg/player/29240/skyppervz,2024-10-29 17:20:00,1.35,0.94,1.14,162,186,143,18,11,7,14,6,8,16,8,8,0,0,0,79%,86%,73%,124,149,100,40%,43%,36%,2,0,2,2,0,2
314,https://vlr.gg/player/29241/miradaninja,2024-10-29 17:20:00,0.75,1.42,1.10,185,113,246,18,6,12,16,8,8,14,5,9,-2,-2,0,83%,86%,80%,118,78,156,16%,22%,15%,2,1,1,4,3,1
315,https://vlr.gg/player/35660/tok1o,2024-10-29 17:20:00,0.86,0.76,0.81,185,202,166,19,10,9,25,13,12,2,0,2,0,0,0,59%,53%,64%,118,132,104,21%,16%,27%,1,1,0,1,1,0
316,https://vlr.gg/player/42378/nicky,2024-10-29 17:20:00,0.86,0.22,0.54,141,212,60,13,11,2,27,14,13,4,1,3,-3,-2,-1,41%,53%,29%,97,131,61,41%,38%,45%,0,0,0,3,2,1
317,https://vlr.gg/player/21548/adenina,2024-10-29 17:20:00,0.46,0.40,0.43,148,142,151,12,6,6,28,15,13,7,3,4,-2,-1,-1,62%,60%,64%,97,100,94,33%,25%,41%,1,0,1,3,1,2
318,https://vlr.gg/player/33177/none,2024-10-29 17:20:00,0.04,0.89,0.42,134,72,205,13,3,10,29,15,14,3,1,2,-2,-3,+1,31%,27%,36%,77,48,109,29%,22%,38%,7,3,4,9,6,3
319,https://vlr.gg/player/21108/ponix,2024-10-29 17:20:00,0.23,0.39,0.31,96,90,100,9,4,5,28,15,13,5,2,3,-4,-1,-3,55%,53%,57%,63,64,62,22%,25%,19%,0,0,0,4,1,3
320,https://vlr.gg/player/1291/bnj,2024-10-29 15:00:00,1.40,0.92,1.18,197,220,176,28,17,11,25,11,14,12,5,7,+1,+1,0,76%,77%,74%,134,157,108,33%,34%,31%,2,1,1,1,0,1
321,https://vlr.gg/player/2818/neto,2024-10-29 15:00:00,1.06,0.85,0.96,197,188,215,29,15,14,32,15,17,7,3,4,0,+1,-1,68%,73%,63%,125,119,132,43%,44%,41%,5,4,1,5,3,2
322,https://vlr.gg/player/15916/jotinha,2024-10-29 15:00:00,0.78,0.70,0.74,146,150,138,18,10,8,30,14,16,12,6,6,-2,-2,0,71%,68%,74%,92,99,84,23%,15%,39%,4,2,2,6,4,2
323,https://vlr.gg/player/2403/mizu,2024-10-29 15:00:00,0.85,0.50,0.69,151,182,119,22,14,8,32,16,16,5,3,2,-1,0,-1,61%,68%,53%,100,120,77,38%,46%,26%,4,2,2,5,2,3
324,https://vlr.gg/player/2586/hanling,2024-10-29 15:00:00,0.60,0.44,0.50,97,95,102,12,7,5,31,15,16,19,11,8,-7,-4,-3,59%,64%,53%,62,56,69,25%,23%,28%,1,0,1,8,4,4
325,https://vlr.gg/player/15547/forcee,2024-10-29 15:00:00,1.53,1.51,1.52,211,199,228,32,14,18,15,6,9,28,14,14,+4,+1,+3,83%,84%,82%,146,144,147,40%,39%,40%,4,1,3,0,0,0
326,https://vlr.gg/player/39154/kimb0,2024-10-29 15:00:00,1.35,1.37,1.36,220,278,175,36,20,16,22,13,9,5,2,3,+6,+4,+2,78%,79%,77%,135,171,103,26%,28%,21%,9,5,4,3,1,2
327,https://vlr.gg/player/46082/jcz,2024-10-29 15:00:00,1.53,0.84,1.16,202,219,185,28,16,12,21,7,14,11,5,6,+1,+2,-1,76%,89%,64%,133,137,130,19%,20%,19%,4,2,2,3,0,3
328,https://vlr.gg/player/29123/kivary,2024-10-29 15:00:00,1.21,1.03,1.11,205,198,207,30,14,16,26,10,16,26,15,11,-4,-3,-1,78%,79%,77%,134,126,141,31%,32%,30%,4,1,3,8,4,4
329,https://vlr.gg/player/2931/vaiz,2024-10-29 15:00:00,1.05,0.68,0.85,170,203,139,24,15,9,25,10,15,12,4,8,+2,+1,+1,76%,89%,64%,118,123,113,21%,26%,18%,4,3,1,2,2,0
330,https://vlr.gg/player/7746/kevzii,2024-10-29 09:00:00,1.51,0.89,1.18,198,265,146,41,27,14,40,18,22,19,8,11,0,+1,-1,68%,75%,63%,139,183,101,31%,34%,27%,5,3,2,5,2,3
331,https://vlr.gg/player/13744/patmen,2024-10-29 09:00:00,1.20,1.04,1.10,258,285,260,53,27,26,50,23,27,14,7,7,-1,+2,-3,73%,79%,69%,179,189,171,29%,27%,31%,13,7,6,14,5,9
332,https://vlr.gg/player/21677/jeee,2024-10-29 09:00:00,0.99,0.97,0.98,192,188,203,43,20,23,47,21,26,12,10,2,-2,+3,-5,70%,79%,63%,135,127,142,40%,33%,47%,3,3,0,5,0,5
333,https://vlr.gg/player/16953/zynd,2024-10-29 09:00:00,1.11,0.72,0.90,161,195,136,34,19,15,43,17,26,10,6,4,-8,-4,-4,58%,71%,47%,113,135,94,28%,28%,27%,1,1,0,9,5,4
334,https://vlr.gg/player/9737/kakarot,2024-10-29 09:00:00,0.57,1.16,0.88,168,93,217,31,8,23,44,21,23,20,11,9,-1,0,-1,70%,68%,72%,111,65,151,32%,14%,42%,2,1,1,3,1,2
335,https://vlr.gg/player/10833/owen,2024-10-29 09:00:00,1.41,0.81,1.13,216,252,176,47,30,17,36,16,20,17,14,3,+5,+4,+1,70%,78%,61%,143,156,129,31%,31%,31%,9,7,2,4,3,1
336,https://vlr.gg/player/37028/goldenblue,2024-10-29 09:00:00,1.03,1.04,1.03,240,248,211,51,29,22,43,23,20,8,4,4,+2,+2,0,75%,75%,75%,156,165,145,32%,38%,26%,9,5,4,7,3,4
337,https://vlr.gg/player/27645/amernone,2024-10-29 09:00:00,1.24,0.68,0.98,231,296,142,49,34,15,43,22,21,11,5,6,+4,+7,-3,72%,81%,61%,149,188,106,26%,29%,21%,10,9,1,6,2,4
338,https://vlr.gg/player/11475/vs,2024-10-29 09:00:00,0.71,1.24,0.95,182,126,247,41,15,26,38,20,18,13,9,4,+2,+2,0,78%,78%,79%,125,96,159,21%,18%,23%,5,2,3,3,0,3
339,https://vlr.gg/player/13119/artaa,2024-10-29 09:00:00,0.84,0.98,0.90,166,127,226,36,16,20,42,20,22,16,7,9,-1,-1,0,77%,75%,79%,121,90,158,30%,26%,33%,3,0,3,4,1,3
340,https://vlr.gg/player/23930/potter,2024-10-29 07:00:00,1.60,1.29,1.45,250,288,211,38,22,16,21,10,11,10,7,3,+2,+4,-2,75%,86%,63%,159,178,138,32%,31%,32%,6,5,1,4,1,3
341,https://vlr.gg/player/2366/alert,2024-10-29 07:00:00,1.15,1.56,1.35,210,150,285,32,13,19,21,9,12,10,1,9,+3,0,+3,90%,86%,95%,151,106,201,35%,37%,33%,4,1,3,1,1,0
342,https://vlr.gg/player/3342/sushiboys,2024-10-29 07:00:00,1.54,0.99,1.28,203,249,148,29,19,10,21,9,12,22,13,9,+3,+3,0,83%,81%,84%,121,147,91,20%,22%,16%,4,3,1,1,0,1
343,https://vlr.gg/player/4377/johnolsen,2024-10-29 07:00:00,0.93,0.84,0.89,214,214,207,29,15,14,32,16,16,11,8,3,-1,-3,+2,73%,76%,68%,139,148,129,27%,34%,20%,3,1,2,4,4,0
344,https://vlr.gg/player/27254/leviathan,2024-10-29 07:00:00,1.09,0.55,0.83,195,217,172,26,16,10,30,13,17,17,9,8,+1,-1,+2,63%,62%,63%,131,144,116,31%,37%,26%,7,2,5,6,3,3
345,https://vlr.gg/player/40894/chintu,2024-10-29 07:00:00,1.02,1.12,1.07,208,193,218,27,11,16,30,14,16,21,14,7,0,+1,-1,73%,84%,62%,132,126,138,46%,34%,59%,1,1,0,1,0,1
346,https://vlr.gg/player/40889/decoy,2024-10-29 07:00:00,0.97,0.81,0.89,201,210,193,29,15,14,32,13,19,4,1,3,+3,-2,+5,68%,68%,67%,124,122,125,24%,24%,24%,11,3,8,8,5,3
347,https://vlr.gg/player/40912/123,2024-10-29 07:00:00,1.11,0.65,0.87,199,250,158,29,17,12,33,15,18,10,6,4,-2,+1,-3,65%,84%,48%,135,159,113,49%,55%,42%,3,3,0,5,2,3
348,https://vlr.gg/player/46043/answerz,2024-10-29 07:00:00,1.02,0.71,0.86,155,206,113,21,14,7,30,14,16,20,9,11,-3,-2,-1,73%,79%,67%,108,139,80,33%,34%,30%,1,0,1,4,2,2
349,https://vlr.gg/player/40891/be,2024-10-29 07:00:00,0.73,0.56,0.64,126,138,116,19,11,8,29,13,16,6,0,6,-6,-3,-3,65%,68%,62%,81,84,79,29%,23%,35%,0,0,0,6,3,3
350,https://vlr.gg/player/41107/zeravla,2024-10-28 17:20:00,1.12,0.99,1.03,242,270,233,54,26,28,50,20,30,7,3,4,0,+2,-2,55%,58%,53%,154,162,149,27%,23%,30%,12,8,4,12,6,6
351,https://vlr.gg/player/48862/cl4yerr,2024-10-28 17:20:00,1.16,0.84,0.97,179,198,177,34,15,19,44,17,27,29,17,12,+1,+1,0,71%,85%,61%,126,136,119,29%,30%,28%,4,1,3,3,0,3
352,https://vlr.gg/player/48865/nezek,2024-10-28 17:20:00,1.08,0.72,0.87,142,227,99,34,22,12,43,21,22,17,7,10,-2,+1,-3,68%,77%,61%,106,156,70,29%,31%,26%,2,1,1,4,0,4
353,https://vlr.gg/player/48864/mrtn,2024-10-28 17:20:00,0.56,0.95,0.79,175,158,199,36,12,24,47,21,26,10,4,6,-2,-3,+1,56%,46%,64%,120,103,132,28%,18%,35%,8,3,5,10,6,4
354,https://vlr.gg/player/48863/mystizip,2024-10-28 17:20:00,0.73,0.82,0.78,137,100,170,30,9,21,43,16,27,20,11,9,-1,+1,-2,58%,77%,44%,92,69,110,24%,13%,31%,3,1,2,4,0,4
355,https://vlr.gg/player/3828/tacolilla,2024-10-28 17:20:00,1.34,1.15,1.26,229,227,219,50,29,21,34,17,17,18,15,3,+3,+4,-1,71%,75%,65%,151,154,146,22%,21%,22%,8,6,2,5,2,3
356,https://vlr.gg/player/12872/david,2024-10-28 17:20:00,1.16,1.19,1.17,235,211,249,50,28,22,39,22,17,22,12,10,+7,+3,+4,76%,72%,81%,152,138,172,36%,40%,33%,9,4,5,2,1,1
357,https://vlr.gg/player/13860/rubkkoide,2024-10-28 17:20:00,0.87,1.37,1.08,225,200,247,51,27,24,40,25,15,8,4,4,-3,-2,-1,68%,64%,73%,146,125,174,39%,34%,44%,11,7,4,14,9,5
358,https://vlr.gg/player/783/murizzz,2024-10-28 17:20:00,1.17,0.85,1.04,174,185,174,40,24,16,37,20,17,15,10,5,0,+2,-2,73%,72%,73%,122,127,114,27%,23%,33%,5,4,1,5,2,3
359,https://vlr.gg/player/2464/suther,2024-10-28 17:20:00,1.18,0.82,1.03,169,186,135,36,24,12,38,20,18,34,21,13,-3,-1,-2,84%,81%,88%,111,116,105,32%,31%,32%,0,0,0,3,1,2
360,https://vlr.gg/player/27813/zery,2024-10-28 15:30:00,1.24,1.17,1.21,282,300,259,41,25,16,37,23,14,5,2,3,+3,+2,+1,69%,71%,67%,180,191,167,45%,51%,38%,10,6,4,7,4,3
361,https://vlr.gg/player/27954/movi,2024-10-28 15:30:00,1.01,0.91,0.97,193,208,174,29,19,10,32,19,13,9,4,5,-1,-3,+2,67%,71%,61%,128,134,120,26%,29%,24%,3,1,2,4,4,0
362,https://vlr.gg/player/15382/kongi,2024-10-28 15:30:00,1.08,0.61,0.88,187,214,154,24,16,8,31,17,14,11,7,4,-1,-1,0,64%,63%,67%,127,139,111,31%,37%,23%,2,1,1,3,2,1
363,https://vlr.gg/player/39062/terrox,2024-10-28 15:30:00,0.50,0.88,0.66,129,114,150,21,10,11,33,19,14,7,5,2,-2,-4,+2,71%,63%,83%,79,77,82,27%,24%,30%,3,0,3,5,4,1
364,https://vlr.gg/player/12514/spocki,2024-10-28 15:30:00,0.47,0.35,0.42,122,129,113,17,11,6,37,21,16,9,4,5,-3,-2,-1,50%,50%,50%,82,84,79,45%,50%,41%,1,0,1,4,2,2
365,https://vlr.gg/player/7987/kovaq,2024-10-28 15:30:00,1.33,1.18,1.24,250,249,251,39,17,22,27,11,16,5,2,3,+6,-1,+7,79%,78%,79%,159,159,159,27%,26%,28%,9,1,8,3,2,1
366,https://vlr.gg/player/122/luckerrr,2024-10-28 15:30:00,0.94,1.47,1.24,222,170,261,35,12,23,28,12,16,12,3,9,-2,-2,0,74%,72%,75%,145,120,164,40%,35%,43%,3,1,2,5,3,2
367,https://vlr.gg/player/12593/felix,2024-10-28 15:30:00,1.12,1.32,1.23,248,204,282,35,12,23,24,10,14,18,6,12,+1,-2,+3,83%,72%,92%,166,144,183,34%,26%,38%,4,1,3,3,3,0
368,https://vlr.gg/player/7968/stavinci,2024-10-28 15:30:00,1.31,0.92,1.09,199,198,200,30,13,17,26,9,17,21,13,8,0,-1,+1,83%,89%,79%,131,123,136,33%,29%,37%,4,1,3,4,2,2
369,https://vlr.gg/player/20302/jini,2024-10-28 15:30:00,1.42,0.68,0.99,202,276,147,31,17,14,28,10,18,11,7,4,-1,+2,-3,74%,83%,67%,123,167,90,25%,33%,19%,3,3,0,4,1,3
370,https://vlr.gg/player/8730/1kuzohh,2024-10-28 15:00:00,1.14,1.02,1.07,245,278,240,32,14,18,32,12,20,9,2,7,+1,-1,+2,75%,69%,79%,164,174,157,18%,15%,20%,7,2,5,6,3,3
371,https://vlr.gg/player/2909/alca,2024-10-28 15:00:00,0.83,1.10,0.98,177,166,203,26,9,17,30,12,18,13,3,10,0,+1,-1,70%,69%,71%,125,109,136,34%,47%,28%,3,2,1,3,1,2
372,https://vlr.gg/player/1309/tio,2024-10-28 15:00:00,0.66,1.03,0.88,198,120,233,25,5,20,29,10,19,15,7,8,-4,-1,-3,68%,63%,71%,120,81,146,19%,12%,23%,2,1,1,6,2,4
373,https://vlr.gg/player/8278/knzy,2024-10-28 15:00:00,0.94,0.54,0.70,137,183,123,20,11,9,29,10,19,7,1,6,-3,0,-3,63%,69%,58%,97,120,82,23%,24%,22%,2,2,0,5,2,3
374,https://vlr.gg/player/38857/beng,2024-10-28 15:00:00,0.78,0.51,0.62,144,150,136,20,7,13,33,11,22,10,7,3,-6,-1,-5,63%,69%,58%,87,97,80,23%,16%,32%,0,0,0,6,1,5
375,https://vlr.gg/player/43926/crazy-ny,2024-10-28 15:00:00,1.66,0.80,1.32,227,307,121,36,29,7,24,14,10,16,11,5,+5,+3,+2,78%,79%,75%,159,204,90,38%,41%,30%,5,3,2,0,0,0
376,https://vlr.gg/player/35739/evoluzionz,2024-10-28 15:00:00,1.20,1.32,1.25,216,206,199,30,19,11,19,13,6,10,3,7,-3,0,-3,73%,67%,81%,134,134,133,22%,20%,24%,1,1,0,4,1,3
377,https://vlr.gg/player/35665/miyeon,2024-10-28 15:00:00,0.98,1.38,1.14,286,259,322,39,20,19,32,20,12,8,6,2,+12,+8,+4,83%,92%,69%,198,178,227,34%,31%,39%,17,10,7,5,2,3
378,https://vlr.gg/player/3677/fross,2024-10-28 15:00:00,1.11,1.04,1.08,155,173,132,23,15,8,22,14,8,16,13,3,0,0,0,78%,79%,75%,111,119,98,26%,30%,19%,1,1,0,1,1,0
379,https://vlr.gg/player/46902/21,2024-10-28 15:00:00,0.83,1.10,0.94,178,163,189,25,15,10,26,16,10,3,1,2,-2,-1,-1,60%,50%,75%,113,100,134,34%,30%,38%,2,2,0,4,3,1
380,https://vlr.gg/player/4525/stix,2024-10-28 12:00:00,1.20,1.39,1.29,204,194,214,35,17,18,26,16,10,17,8,9,+1,+1,0,74%,67%,83%,137,129,145,34%,38%,30%,3,2,1,2,1,1
381,https://vlr.gg/player/5477/leon,2024-10-28 12:00:00,0.83,1.08,0.95,196,166,226,33,13,20,31,16,15,11,5,6,+2,0,+2,79%,79%,78%,125,105,147,19%,19%,19%,5,2,3,3,2,1
382,https://vlr.gg/player/30754/karma,2024-10-28 12:00:00,0.68,1.19,0.93,226,167,288,36,15,21,39,22,17,16,5,11,+1,-2,+3,74%,67%,83%,137,101,175,29%,24%,32%,7,2,5,6,4,2
383,https://vlr.gg/player/45490/ico,2024-10-28 12:00:00,1.03,0.80,0.92,177,211,143,30,18,12,31,17,14,16,8,8,-6,-4,-2,70%,71%,70%,116,142,89,27%,31%,22%,3,2,1,9,6,3
384,https://vlr.gg/player/22180/spmak,2024-10-28 12:00:00,0.60,1.05,0.82,166,139,195,25,10,15,35,21,14,17,9,8,-1,-1,0,66%,54%,78%,107,92,123,13%,21%,8%,4,1,3,5,2,3
385,https://vlr.gg/player/7865/xanarchy,2024-10-28 12:00:00,1.50,0.81,1.15,223,288,160,36,23,13,31,15,16,12,8,4,+1,0,+1,72%,78%,67%,152,190,115,26%,32%,19%,2,1,1,1,1,0
386,https://vlr.gg/player/9508/leosen,2024-10-28 12:00:00,0.93,1.26,1.10,219,186,255,36,16,20,31,17,14,13,4,9,+8,+2,+6,66%,61%,71%,143,118,166,30%,45%,24%,12,6,6,4,4,0
387,https://vlr.gg/player/4969/shazeon,2024-10-28 12:00:00,0.95,1.05,1.00,188,208,169,32,16,16,32,20,12,17,10,7,+2,+2,0,66%,70%,63%,121,133,109,28%,30%,26%,4,3,1,2,1,1
388,https://vlr.gg/player/4629/azury,2024-10-28 12:00:00,1.20,0.65,0.92,167,159,175,14,7,7,15,6,9,3,1,2,-3,0,-3,75%,75%,75%,116,95,137,38%,41%,35%,0,0,0,3,0,3
389,https://vlr.gg/player/30750/enes,2024-10-28 12:00:00,0.47,1.35,0.92,173,94,249,27,5,22,33,19,14,22,9,13,-2,-1,-1,66%,52%,79%,104,73,134,28%,25%,29%,2,0,2,4,1,3
390,https://vlr.gg/player/12528/disisjohn,2024-10-28 12:00:00,0.31,1.49,0.92,227,120,325,17,3,14,17,9,8,2,0,2,-3,-6,+3,61%,45%,75%,150,90,205,23%,16%,28%,5,0,5,8,6,2
391,https://vlr.gg/player/11666/ray4c,2024-10-28 06:35:00,1.13,1.26,1.20,253,266,241,57,27,30,44,23,21,14,6,8,0,-2,+2,73%,69%,76%,154,166,145,22%,20%,24%,9,5,4,9,7,2
392,https://vlr.gg/player/16852/nakya,2024-10-28 06:35:00,0.95,1.29,1.13,234,192,271,52,18,34,45,22,23,25,15,10,+2,+1,+1,73%,79%,68%,156,136,172,32%,29%,34%,9,4,5,7,3,4
393,https://vlr.gg/player/23710/gotten,2024-10-28 06:35:00,1.03,1.06,1.05,196,171,214,43,17,26,43,19,24,28,17,11,0,0,0,71%,76%,68%,126,103,145,46%,39%,50%,7,2,5,7,2,5
394,https://vlr.gg/player/2346/cud,2024-10-28 06:35:00,1.41,0.69,1.02,167,235,112,40,28,12,37,16,21,11,4,7,-3,0,-3,70%,79%,62%,115,151,84,29%,42%,17%,2,1,1,5,1,4
395,https://vlr.gg/player/7807/valdyn,2024-10-28 06:35:00,0.96,0.97,0.97,175,143,201,36,13,23,44,19,25,25,14,11,0,0,0,78%,86%,71%,113,92,132,27%,38%,23%,4,2,2,4,2,2
396,https://vlr.gg/player/26829/damaraa,2024-10-28 06:35:00,1.05,1.62,1.31,316,259,387,70,30,40,50,29,21,13,9,4,+5,+2,+3,79%,76%,83%,193,157,236,22%,18%,26%,15,8,7,10,6,4
397,https://vlr.gg/player/9263/sayoo,2024-10-28 06:35:00,1.25,0.85,1.07,221,269,165,48,30,18,45,26,19,23,15,8,-2,+1,-3,71%,79%,62%,145,175,110,27%,32%,21%,4,3,1,6,2,4
398,https://vlr.gg/player/4872/frostmind,2024-10-28 06:35:00,1.19,0.75,0.99,189,191,192,41,22,19,45,21,24,30,21,9,-1,-3,+2,70%,74%,66%,128,139,116,37%,33%,42%,3,0,3,4,3,1
399,https://vlr.gg/player/10749/k1ngkappa,2024-10-28 06:35:00,0.84,0.73,0.79,138,159,115,30,19,11,43,24,19,16,9,7,+2,0,+2,70%,65%,76%,95,112,75,30%,37%,20%,7,4,3,5,4,1
400,https://vlr.gg/player/9290/madelyn,2024-10-28 06:35:00,0.61,0.71,0.66,125,115,136,24,13,11,45,25,20,24,10,14,-3,0,-3,62%,59%,66%,80,69,94,20%,32%,10%,3,2,1,6,2,4
401,https://vlr.gg/player/7783/zhar,2024-10-28 04:55:00,0.89,0.52,0.72,154,174,135,17,11,6,29,15,14,11,5,6,-1,0,-1,59%,53%,67%,99,110,86,35%,44%,26%,1,0,1,2,0,2
402,https://vlr.gg/player/7047/vascalizz,2024-10-28 04:55:00,0.62,0.84,0.72,200,175,231,24,11,13,29,16,13,3,2,1,-4,-2,-2,53%,65%,40%,123,114,134,29%,31%,26%,0,0,0,4,2,2
403,https://vlr.gg/player/7046/no1syboy,2024-10-28 04:55:00,0.80,0.59,0.69,179,201,157,17,12,5,28,15,13,8,1,7,0,+1,-1,47%,41%,53%,114,110,119,15%,8%,27%,2,2,0,2,1,1
404,https://vlr.gg/player/7802/flynch,2024-10-28 04:55:00,0.35,0.62,0.48,132,110,167,14,7,7,30,16,14,5,2,3,-2,-3,+1,50%,47%,53%,93,82,106,26%,24%,28%,2,1,1,4,4,0
405,https://vlr.gg/player/4867/onigiri,2024-10-28 04:55:00,0.41,0.41,0.41,126,101,160,12,5,7,29,15,14,5,4,1,-11,-5,-6,50%,59%,40%,95,90,100,25%,33%,19%,2,1,1,13,6,7
406,https://vlr.gg/player/26829/damaraa,2024-10-28 04:55:00,1.32,1.78,1.56,336,301,363,41,17,24,20,11,9,7,5,2,+6,+5,+1,81%,73%,88%,194,161,222,18%,23%,15%,7,6,1,1,1,0
407,https://vlr.gg/player/10749/k1ngkappa,2024-10-28 04:55:00,1.72,1.38,1.54,315,319,308,36,18,18,19,7,12,4,2,2,+6,+2,+4,88%,87%,88%,204,206,202,32%,33%,30%,8,2,6,2,0,2
408,https://vlr.gg/player/4872/frostmind,2024-10-28 04:55:00,1.50,1.42,1.46,208,216,202,24,11,13,14,7,7,23,15,8,0,0,0,91%,87%,94%,139,147,131,29%,22%,36%,2,1,1,2,1,1
409,https://vlr.gg/player/9263/sayoo,2024-10-28 04:55:00,1.27,1.29,1.28,229,267,203,29,17,12,19,9,10,19,8,11,+3,+1,+2,91%,93%,88%,159,187,134,28%,29%,28%,5,2,3,2,1,1
410,https://vlr.gg/player/9290/madelyn,2024-10-28 04:55:00,1.28,1.11,1.19,147,116,168,15,6,9,13,4,9,22,11,11,+3,+1,+2,88%,93%,82%,104,70,135,24%,18%,28%,3,1,2,0,0,0
411,https://vlr.gg/player/23710/gotten,2024-10-28 02:00:00,1.10,1.47,1.28,261,206,312,55,21,34,42,20,22,29,18,11,+5,+4,+1,80%,77%,83%,162,124,202,38%,27%,46%,8,6,2,3,2,1
412,https://vlr.gg/player/7807/valdyn,2024-10-28 02:00:00,1.27,1.23,1.25,233,210,249,50,25,25,42,19,23,27,12,15,+2,+1,+1,82%,84%,80%,144,135,153,23%,21%,24%,5,2,3,3,1,2
413,https://vlr.gg/player/11666/ray4c,2024-10-28 02:00:00,1.56,0.73,1.16,272,333,203,54,34,20,46,20,26,21,14,7,+1,+3,-2,75%,87%,63%,173,218,126,15%,15%,13%,11,7,4,10,4,6
414,https://vlr.gg/player/16852/nakya,2024-10-28 02:00:00,1.18,0.89,1.04,226,234,219,50,30,20,44,18,26,16,6,10,-4,0,-4,79%,81%,77%,143,142,145,39%,42%,35%,6,3,3,10,3,7
415,https://vlr.gg/player/2346/cud,2024-10-28 02:00:00,1.35,0.68,1.02,170,226,119,39,26,13,35,15,20,12,8,4,-1,-1,0,70%,77%,63%,115,158,71,32%,39%,19%,2,1,1,3,2,1
416,https://vlr.gg/player/7046/no1syboy,2024-10-28 02:00:00,1.45,0.75,1.10,217,252,187,49,30,19,44,18,26,17,10,7,-2,+1,-3,70%,90%,52%,138,165,112,23%,26%,19%,2,1,1,4,0,4
417,https://vlr.gg/player/7802/flynch,2024-10-28 02:00:00,1.17,0.93,1.05,227,252,206,47,27,20,49,24,25,17,10,7,+7,+4,+3,62%,77%,48%,146,161,133,32%,32%,32%,11,6,5,4,2,2
418,https://vlr.gg/player/7783/zhar,2024-10-28 02:00:00,1.00,0.55,0.77,183,214,148,38,22,16,50,23,27,22,15,7,-1,0,-1,72%,73%,71%,110,134,87,26%,34%,18%,4,2,2,5,2,3
419,https://vlr.gg/player/4867/onigiri,2024-10-28 02:00:00,0.63,0.77,0.70,193,188,207,39,18,21,56,27,29,14,10,4,-4,-1,-3,64%,73%,55%,126,119,132,25%,23%,28%,7,4,3,11,5,6
420,https://vlr.gg/player/7047/vascalizz,2024-10-28 02:00:00,0.83,0.57,0.70,162,163,166,35,19,16,49,21,28,11,5,6,-3,0,-3,67%,77%,58%,112,104,119,21%,16%,27%,5,4,1,8,4,4
421,https://vlr.gg/player/29547/ion2x,2024-10-27 20:20:00,1.09,1.56,1.37,244,218,268,39,13,26,26,12,14,11,5,6,-1,+1,-2,75%,81%,71%,167,147,180,45%,31%,57%,1,1,0,2,0,2
422,https://vlr.gg/player/36560/canezerra,2024-10-27 20:20:00,0.81,1.04,0.95,258,193,306,34,10,24,37,13,24,10,4,6,-3,-3,0,78%,63%,88%,170,135,193,31%,25%,35%,9,3,6,12,6,6
423,https://vlr.gg/player/64/gmd,2024-10-27 20:20:00,0.76,0.76,0.76,178,187,174,21,9,12,36,15,21,25,8,17,-4,-2,-2,70%,63%,75%,116,121,113,24%,28%,22%,1,0,1,5,2,3
424,https://vlr.gg/player/8399/mocking,2024-10-27 20:20:00,0.57,0.73,0.67,131,119,144,16,5,11,28,13,15,17,10,7,-2,-2,0,70%,75%,67%,101,97,105,26%,21%,29%,2,0,2,4,2,2
425,https://vlr.gg/player/6584/curry,2024-10-27 20:20:00,0.89,0.48,0.64,135,191,97,20,11,9,30,13,17,3,2,1,0,0,0,60%,69%,54%,85,130,56,32%,36%,29%,2,1,1,2,1,1
426,https://vlr.gg/player/29893/timotino,2024-10-27 20:20:00,1.59,1.19,1.43,310,338,232,42,29,13,29,18,11,9,4,5,+3,0,+3,78%,75%,81%,186,215,143,32%,37%,26%,6,2,4,3,2,1
427,https://vlr.gg/player/17357/papi,2024-10-27 20:20:00,0.93,1.89,1.31,247,206,326,37,17,20,26,17,9,17,7,10,0,-1,+1,83%,75%,94%,166,130,218,26%,24%,29%,4,2,2,4,3,1
428,https://vlr.gg/player/9835/ali,2024-10-27 20:20:00,1.15,1.43,1.26,200,214,193,28,18,10,21,14,7,18,7,11,+6,+4,+2,80%,83%,75%,134,138,127,26%,30%,19%,7,5,2,1,1,0
429,https://vlr.gg/player/893/retrq,2024-10-27 20:20:00,0.81,1.35,1.03,196,150,249,27,12,15,27,18,9,20,11,9,0,0,0,88%,88%,88%,124,96,167,21%,25%,18%,2,1,1,2,1,1
430,https://vlr.gg/player/3719/matt,2024-10-27 20:20:00,0.87,0.68,0.80,167,168,154,23,15,8,27,15,12,13,5,8,+1,+1,0,73%,75%,69%,116,112,121,18%,17%,18%,6,4,2,5,3,2
431,https://vlr.gg/player/893/retrq,2024-10-27 18:10:00,1.32,1.40,1.35,210,221,232,36,21,15,23,12,11,11,5,6,0,-1,+1,78%,73%,84%,153,143,168,31%,35%,26%,1,0,1,1,1,0
432,https://vlr.gg/player/9835/ali,2024-10-27 18:10:00,1.26,1.29,1.27,262,231,261,38,21,17,28,16,12,21,13,8,+1,+3,-2,73%,73%,74%,149,141,161,34%,31%,38%,5,4,1,4,1,3
433,https://vlr.gg/player/29893/timotino,2024-10-27 18:10:00,1.18,1.19,1.19,289,274,275,41,24,17,31,17,14,12,7,5,+3,+1,+2,64%,65%,63%,169,164,176,24%,25%,22%,12,7,5,9,6,3
434,https://vlr.gg/player/17357/papi,2024-10-27 18:10:00,0.86,1.17,0.99,177,148,206,27,12,15,27,15,12,23,12,11,-1,0,-1,80%,77%,84%,123,108,143,16%,17%,14%,2,1,1,3,1,2
435,https://vlr.gg/player/3719/matt,2024-10-27 18:10:00,0.72,1.22,0.94,164,148,182,26,14,12,26,18,8,9,2,7,+2,+1,+1,80%,73%,89%,106,105,108,29%,22%,41%,5,3,2,3,2,1
436,https://vlr.gg/player/2125/nanners,2024-10-27 18:10:00,0.79,1.28,1.07,226,201,268,39,15,24,36,15,21,11,4,7,+1,-1,+2,67%,68%,65%,141,115,159,31%,38%,28%,5,2,3,4,3,1
437,https://vlr.gg/player/20959/toozy,2024-10-27 18:10:00,0.93,0.82,0.87,181,152,179,23,11,12,31,12,19,15,6,9,-2,-1,-1,64%,63%,65%,120,102,133,30%,30%,29%,0,0,0,2,1,1
438,https://vlr.gg/player/8758/benjii,2024-10-27 18:10:00,0.80,0.91,0.86,164,206,152,28,13,15,33,16,17,6,2,4,-5,-2,-3,56%,53%,58%,110,129,97,26%,29%,23%,2,2,0,7,4,3
439,https://vlr.gg/player/29076/satellite,2024-10-27 18:10:00,0.68,0.79,0.75,174,178,162,22,10,12,34,16,18,9,2,7,0,+2,-2,62%,58%,65%,114,106,120,16%,10%,23%,5,3,2,5,1,4
440,https://vlr.gg/player/29074/sonofcar,2024-10-27 18:10:00,0.55,0.86,0.73,158,158,172,23,9,14,35,17,18,10,3,7,+1,+1,0,56%,47%,62%,109,113,107,18%,29%,13%,8,2,6,7,1,6
441,https://vlr.gg/player/7660/fizzy,2024-10-27 14:30:00,1.38,1.16,1.26,269,276,264,65,31,34,48,19,29,19,7,12,+8,+3,+5,77%,80%,75%,156,160,152,26%,23%,29%,13,4,9,5,1,4
442,https://vlr.gg/player/3753/obnoks,2024-10-27 14:30:00,1.22,1.24,1.23,248,261,244,60,28,32,45,20,25,17,9,8,-2,-1,-1,71%,67%,75%,159,165,153,26%,21%,33%,5,3,2,7,4,3
443,https://vlr.gg/player/3674/iluri,2024-10-27 14:30:00,1.04,1.00,1.02,200,178,211,45,20,25,45,19,26,17,4,13,-4,-1,-3,73%,73%,72%,136,137,135,30%,41%,24%,2,2,0,6,3,3
444,https://vlr.gg/player/1363/kundikundi,2024-10-27 14:30:00,1.07,0.64,0.84,177,211,140,38,23,15,48,21,27,25,12,13,-5,-3,-2,68%,77%,61%,105,121,92,22%,21%,23%,4,1,3,9,4,5
445,https://vlr.gg/player/13435/fragger,2024-10-27 14:30:00,0.77,0.79,0.78,155,159,153,37,19,18,47,21,26,20,8,12,-1,-2,+1,67%,60%,72%,110,105,114,35%,41%,32%,7,3,4,8,5,3
446,https://vlr.gg/player/22381/s-mplex,2024-10-27 14:30:00,1.44,0.88,1.18,228,267,190,56,38,18,49,24,25,35,17,18,+1,+1,0,82%,89%,73%,148,166,127,31%,33%,28%,4,3,1,3,2,1
447,https://vlr.gg/player/22179/shy,2024-10-27 14:30:00,1.20,0.96,1.09,224,238,207,56,32,24,49,25,24,3,2,1,+3,+2,+1,67%,67%,67%,148,155,139,34%,35%,32%,14,8,6,11,6,5
448,https://vlr.gg/player/33732/nunmeister,2024-10-27 14:30:00,0.86,1.21,1.02,200,164,232,46,21,25,45,23,22,11,6,5,+2,0,+2,73%,69%,77%,130,112,151,25%,18%,33%,5,1,4,3,1,2
449,https://vlr.gg/player/3924/sh0utyy,2024-10-27 14:30:00,0.79,0.94,0.86,160,136,196,35,16,19,47,24,23,25,14,11,+2,-2,+4,71%,72%,70%,109,102,117,24%,17%,34%,6,1,5,4,3,1
450,https://vlr.gg/player/33875/spexleon,2024-10-27 14:30:00,0.90,0.49,0.72,174,210,139,39,26,13,55,28,27,17,12,5,-4,-1,-3,67%,81%,50%,120,134,102,41%,49%,32%,6,5,1,10,6,4
451,https://vlr.gg/player/5554/profek,2024-10-27 14:00:00,1.55,1.15,1.39,226,246,197,34,21,13,19,9,10,22,17,5,+2,+2,0,80%,83%,76%,145,162,120,28%,27%,29%,4,3,1,2,1,1
452,https://vlr.gg/player/321/chiwa,2024-10-27 14:00:00,1.20,1.49,1.32,241,224,282,37,20,17,22,12,10,7,2,5,+5,+4,+1,83%,83%,82%,169,152,192,41%,41%,40%,5,4,1,0,0,0
453,https://vlr.gg/player/5568/sociablee,2024-10-27 14:00:00,1.37,0.79,1.13,199,243,131,28,22,6,23,12,11,17,11,6,+3,+2,+1,78%,92%,59%,136,168,91,15%,15%,16%,8,5,3,5,3,2
454,https://vlr.gg/player/20144/lewn,2024-10-27 14:00:00,1.69,0.28,1.11,220,306,86,34,29,5,26,11,15,4,3,1,+4,+4,0,68%,83%,47%,137,195,56,35%,36%,29%,8,5,3,4,1,3
455,https://vlr.gg/player/9780/jamppi,2024-10-27 14:00:00,1.16,0.94,1.07,189,173,209,29,16,13,26,12,14,15,11,4,-1,-2,+1,80%,96%,59%,118,113,125,23%,18%,30%,2,0,2,3,2,1
456,https://vlr.gg/player/15473/yuno,2024-10-27 14:00:00,1.35,0.81,1.04,213,241,195,30,16,14,31,10,21,9,3,6,-1,0,-1,71%,76%,67%,133,147,124,28%,26%,30%,2,1,1,3,1,2
457,https://vlr.gg/player/2700/jas,2024-10-27 14:00:00,0.64,0.92,0.80,199,187,198,26,10,16,34,14,20,9,5,4,-7,-3,-4,59%,59%,58%,130,127,132,32%,35%,29%,5,2,3,12,5,7
458,https://vlr.gg/player/6959/flickless,2024-10-27 14:00:00,1.13,0.46,0.74,127,165,113,19,11,8,32,9,23,4,2,2,+1,+2,-1,54%,82%,33%,85,93,80,31%,29%,35%,3,2,1,2,0,2
459,https://vlr.gg/player/341/quick,2024-10-27 14:00:00,1.00,0.49,0.70,140,141,142,19,8,11,30,8,22,7,4,3,-5,-2,-3,61%,65%,58%,88,93,84,38%,28%,53%,2,1,1,7,3,4
460,https://vlr.gg/player/8834/bucher,2024-10-27 14:00:00,0.95,0.35,0.60,153,244,98,22,15,7,35,13,22,5,1,4,-1,0,-1,51%,59%,46%,103,152,69,32%,39%,24%,2,1,1,3,1,2
461,https://vlr.gg/player/7046/no1syboy,2024-10-27 10:10:00,1.91,1.30,1.61,284,329,257,57,34,23,28,13,15,17,4,13,-1,-1,0,81%,85%,77%,195,215,174,19%,22%,17%,4,1,3,5,2,3
462,https://vlr.gg/player/7047/vascalizz,2024-10-27 10:10:00,1.42,1.64,1.53,281,270,269,55,28,27,25,13,12,13,6,7,+1,0,+1,83%,74%,92%,180,171,189,30%,34%,27%,5,3,2,4,3,1
463,https://vlr.gg/player/7783/zhar,2024-10-27 10:10:00,1.04,1.65,1.34,222,157,291,42,15,27,29,16,13,32,14,18,+5,+1,+4,89%,85%,92%,136,103,171,22%,27%,19%,7,2,5,2,1,1
464,https://vlr.gg/player/7802/flynch,2024-10-27 10:10:00,0.89,1.19,1.04,166,172,167,32,16,16,28,18,10,15,7,8,-3,-3,0,77%,67%,88%,127,123,131,34%,32%,36%,1,1,0,4,4,0
465,https://vlr.gg/player/4867/onigiri,2024-10-27 10:10:00,0.87,1.18,1.02,254,200,273,44,19,25,37,19,18,12,5,7,-1,-6,+5,81%,78%,85%,153,131,175,26%,27%,25%,10,2,8,11,8,3
466,https://vlr.gg/player/48815/surge,2024-10-27 10:10:00,0.87,0.71,0.79,170,175,172,33,17,16,47,24,23,16,7,9,+2,0,+2,66%,62%,70%,111,118,105,36%,38%,34%,4,1,3,2,1,1
467,https://vlr.gg/player/46089/acm,2024-10-27 10:10:00,0.79,0.72,0.75,165,163,165,31,15,16,43,22,21,10,6,4,-2,-1,-1,62%,65%,59%,101,95,106,35%,40%,32%,3,2,1,5,3,2
468,https://vlr.gg/player/48817/kikilnwza,2024-10-27 10:10:00,0.63,0.82,0.72,190,165,239,34,14,20,49,23,26,12,5,7,-6,-7,+1,58%,50%,67%,131,109,152,21%,22%,21%,6,1,5,12,8,4
469,https://vlr.gg/player/46087/theearth,2024-10-27 10:10:00,0.40,0.96,0.68,153,114,197,28,9,19,47,25,22,16,9,7,+5,+1,+4,55%,50%,59%,89,62,115,24%,36%,19%,10,4,6,5,3,2
470,https://vlr.gg/player/48816/againist,2024-10-27 10:10:00,0.61,0.64,0.61,129,171,109,21,13,8,44,24,20,12,6,6,0,-3,+3,49%,50%,48%,108,126,90,17%,16%,18%,3,0,3,3,3,0
471,https://vlr.gg/player/16321/nelo,2024-10-27 10:00:00,0.96,1.02,0.99,194,184,213,38,20,18,44,22,22,18,7,11,+1,-3,+4,64%,59%,70%,122,114,130,42%,47%,38%,5,0,5,4,3,1
472,https://vlr.gg/player/30076/ritsu,2024-10-27 10:00:00,1.27,0.50,0.90,188,262,111,40,30,10,43,20,23,5,2,3,+1,+1,0,59%,59%,59%,131,181,78,36%,37%,34%,5,3,2,4,2,2
473,https://vlr.gg/player/26738/riri,2024-10-27 10:00:00,0.56,0.97,0.76,166,130,216,32,12,20,47,24,23,12,5,7,+1,0,+1,63%,59%,67%,114,95,134,35%,42%,30%,5,3,2,4,3,1
474,https://vlr.gg/player/37954/bellatr1x,2024-10-27 10:00:00,0.52,0.64,0.58,146,128,171,28,12,16,48,25,23,10,7,3,-4,-1,-3,57%,62%,52%,95,92,99,45%,39%,52%,5,3,2,9,4,5
475,https://vlr.gg/player/41196/ja2,2024-10-27 10:00:00,0.52,0.65,0.57,140,121,167,27,12,15,48,24,24,10,6,4,-5,-4,-1,55%,62%,48%,89,78,100,27%,19%,37%,5,2,3,10,6,4
476,https://vlr.gg/player/41207/jade,2024-10-27 10:00:00,1.42,1.56,1.49,276,253,296,58,26,32,31,15,16,21,10,11,+7,+3,+4,89%,89%,90%,176,158,192,39%,44%,36%,8,3,5,1,0,1
477,https://vlr.gg/player/37969/ellie,2024-10-27 10:00:00,1.59,1.32,1.45,270,284,248,58,30,28,34,14,20,9,5,4,+3,-3,+6,77%,74%,79%,189,204,174,41%,45%,37%,7,0,7,4,3,1
478,https://vlr.gg/player/17318/blossi,2024-10-27 10:00:00,1.35,1.18,1.27,210,235,194,40,22,18,30,14,16,34,14,20,0,0,0,79%,70%,86%,142,151,134,26%,26%,25%,6,3,3,6,3,3
479,https://vlr.gg/player/19373/ginger,2024-10-27 10:00:00,0.71,1.22,0.98,187,142,205,38,15,23,34,18,16,8,2,6,-2,-2,0,64%,59%,69%,114,95,131,31%,30%,32%,6,4,2,8,6,2
480,https://vlr.gg/player/30042/harmonee,2024-10-27 10:00:00,1.10,0.81,0.95,182,238,147,36,22,14,36,18,18,16,9,7,-2,+1,-3,75%,81%,69%,131,153,110,22%,27%,16%,4,3,1,6,2,4
481,https://vlr.gg/player/40591/comeback,2024-10-27 08:45:00,1.07,0.97,1.02,214,244,217,94,51,43,87,50,37,16,9,7,+5,-1,+6,66%,66%,67%,147,152,141,24%,30%,18%,20,8,12,15,9,6
482,https://vlr.gg/player/24344/loita,2024-10-27 08:45:00,0.91,1.05,0.98,219,205,231,82,40,42,89,54,35,50,29,21,-4,-4,0,71%,71%,70%,144,132,158,40%,38%,43%,13,6,7,17,10,7
483,https://vlr.gg/player/31305/lar0k,2024-10-27 08:45:00,0.98,0.94,0.96,170,187,159,71,41,30,78,45,33,44,23,21,-4,-3,-1,70%,61%,80%,109,118,99,28%,26%,31%,2,1,1,6,4,2
484,https://vlr.gg/player/12795/crewen,2024-10-27 08:45:00,0.60,1.17,0.86,186,149,236,81,33,48,87,53,34,16,5,11,+1,-7,+8,65%,56%,74%,126,103,152,35%,31%,39%,10,1,9,9,8,1
485,https://vlr.gg/player/5565/ros,2024-10-27 08:45:00,0.63,0.93,0.77,177,144,211,65,29,36,90,51,39,25,10,15,-4,-7,+3,68%,56%,81%,123,99,152,27%,26%,27%,10,4,6,14,11,3
486,https://vlr.gg/player/8369/yetujey,2024-10-27 08:45:00,1.13,1.19,1.16,229,213,248,96,40,56,79,39,40,23,9,14,-1,-6,+5,72%,61%,81%,155,152,159,26%,25%,27%,11,1,10,12,7,5
487,https://vlr.gg/player/8044/mrfalin,2024-10-27 08:45:00,0.84,1.42,1.15,226,158,278,88,25,63,78,40,38,50,23,27,+6,-3,+9,76%,70%,81%,148,114,177,22%,19%,23%,15,3,12,9,6,3
488,https://vlr.gg/player/12793/xeus,2024-10-27 08:45:00,0.90,1.25,1.09,232,223,239,95,41,54,85,45,40,25,8,17,+6,-1,+7,71%,56%,84%,152,142,161,31%,32%,30%,24,13,11,18,14,4
489,https://vlr.gg/player/15735/krostaly,2024-10-27 08:45:00,1.02,1.03,1.03,179,165,191,79,34,45,77,38,39,24,8,16,-2,-3,+1,72%,67%,76%,118,106,128,39%,34%,43%,7,1,6,9,4,5
490,https://vlr.gg/player/1139/qraxs,2024-10-27 08:45:00,1.10,0.95,1.02,190,199,169,73,38,35,74,37,37,49,23,26,-3,-3,0,76%,74%,77%,124,124,123,31%,27%,34%,4,1,3,7,4,3
491,https://vlr.gg/player/11475/vs,2024-10-27 07:00:00,1.31,1.08,1.20,232,248,205,57,33,24,47,24,23,25,11,14,+3,0,+3,73%,78%,69%,143,157,129,28%,31%,24%,8,3,5,5,3,2
492,https://vlr.gg/player/37028/goldenblue,2024-10-27 07:00:00,1.13,1.23,1.18,217,228,208,54,28,26,49,29,20,21,10,11,+1,-2,+3,70%,67%,74%,146,150,140,45%,44%,46%,7,3,4,6,5,1
493,https://vlr.gg/player/10833/owen,2024-10-27 07:00:00,0.77,1.18,0.97,186,170,207,47,21,26,48,28,20,19,15,4,-2,-2,0,77%,72%,83%,120,102,138,23%,23%,24%,3,1,2,5,3,2
494,https://vlr.gg/player/27645/amernone,2024-10-27 07:00:00,0.52,1.35,0.93,238,161,317,59,19,40,57,32,25,16,11,5,+1,-2,+3,73%,67%,80%,151,112,191,18%,18%,18%,13,5,8,12,7,5
495,https://vlr.gg/player/13119/artaa,2024-10-27 07:00:00,0.86,0.74,0.80,151,180,126,36,21,15,51,29,22,28,16,12,+2,+4,-2,68%,64%,71%,99,113,85,19%,16%,24%,7,5,2,5,1,4
496,https://vlr.gg/player/52235/kael,2024-10-27 07:00:00,0.87,1.37,1.12,200,144,262,52,19,33,46,24,22,18,6,12,-1,-2,+1,70%,60%,81%,139,107,170,24%,27%,22%,6,2,4,7,4,3
497,https://vlr.gg/player/25375/scarymd2,2024-10-27 07:00:00,0.94,1.29,1.11,216,184,249,54,22,32,48,26,22,19,10,9,+4,+4,0,82%,83%,81%,137,122,152,39%,41%,38%,7,4,3,3,0,3
498,https://vlr.gg/player/35967/taphtaph,2024-10-27 07:00:00,1.24,0.89,1.06,206,256,152,51,30,21,50,25,25,33,10,23,+2,+3,-1,80%,69%,92%,131,159,104,34%,37%,30%,6,3,3,4,0,4
499,https://vlr.gg/player/27199/jaso,2024-10-27 07:00:00,0.68,1.13,0.91,191,153,231,46,18,28,53,28,25,26,12,14,-9,-6,-3,72%,71%,72%,133,100,164,38%,32%,42%,2,0,2,11,6,5
500,https://vlr.gg/player/35963/migz,2024-10-27 07:00:00,0.70,1.03,0.87,205,186,225,49,21,28,56,28,28,19,7,12,-1,-6,+5,69%,54%,83%,131,124,138,22%,21%,22%,12,5,7,13,11,2
0,https://vlr.gg/player/13221/azys,2024-10-27 06:30:00,1.35,1.24,1.29,285,282,289,102,48,54,71,32,39,22,6,16,+9,+1,+8,71%,62%,79%,173,166,179,29%,38%,23%,23,11,12,14,10,4
1,https://vlr.gg/player/18704/levi,2024-10-27 06:30:00,0.85,1.63,1.26,218,148,288,79,24,55,63,33,30,37,15,22,0,+1,-1,75%,68%,81%,148,98,193,41%,45%,39%,6,3,3,6,2,4
2,https://vlr.gg/player/3628/deathmaker,2024-10-27 06:30:00,0.88,1.26,1.08,205,166,238,67,24,43,65,34,31,25,10,15,+3,+2,+1,67%,60%,73%,141,122,159,25%,22%,28%,7,3,4,4,1,3
3,https://vlr.gg/player/3269/antidote,2024-10-27 06:30:00,1.05,0.87,0.96,162,165,159,57,27,30,66,30,36,43,15,28,0,+1,-1,70%,60%,79%,109,109,108,26%,29%,24%,6,2,4,6,1,5
4,https://vlr.gg/player/12947/rawfiul,2024-10-27 06:30:00,0.67,1.02,0.85,169,158,183,60,26,34,65,35,30,25,8,17,-9,-10,+1,67%,53%,79%,106,94,117,36%,41%,32%,9,2,7,18,12,6
5,https://vlr.gg/player/27336/venka,2024-10-27 06:30:00,1.05,1.30,1.17,268,258,274,87,45,42,75,45,30,30,15,15,+5,0,+5,72%,67%,77%,174,162,188,38%,43%,35%,20,10,10,15,10,5
6,https://vlr.gg/player/3639/hoax,2024-10-27 06:30:00,0.89,1.14,1.01,194,185,209,66,35,31,66,39,27,32,11,21,-3,-4,+1,68%,67%,68%,127,122,134,25%,30%,21%,4,0,4,7,4,3
7,https://vlr.gg/player/27775/techno,2024-10-27 06:30:00,0.85,0.81,0.83,182,197,163,59,33,26,73,43,30,24,12,12,+1,+4,-3,64%,62%,66%,121,127,115,24%,22%,25%,9,7,2,8,3,5
8,https://vlr.gg/player/30693/makaveli,2024-10-27 06:30:00,0.50,1.17,0.82,167,127,213,61,22,39,72,44,28,16,7,9,-2,-4,+2,62%,58%,66%,105,80,132,29%,24%,34%,6,1,5,8,5,3
9,https://vlr.gg/player/3627/hellff,2024-10-27 06:30:00,0.81,0.82,0.81,167,178,158,57,31,26,79,45,34,28,14,14,-4,-4,0,63%,60%,66%,117,123,111,38%,38%,39%,9,4,5,13,8,5
10,https://vlr.gg/player/1209/swerl,2024-10-27 06:00:00,,,,255,,,79,,,66,,,14,,,,,,,,,,,,,,,,,,,,
11,https://vlr.gg/player/41054/guang,2024-10-27 06:00:00,,,,229,,,73,,,65,,,16,,,,,,,,,,,,,,,,,,,,
12,https://vlr.gg/player/46460/ezeir,2024-10-27 06:00:00,,,,195,,,58,,,65,,,53,,,,,,,,,,,,,,,,,,,,
13,https://vlr.gg/player/39697/cb,2024-10-27 06:00:00,,,,170,,,52,,,60,,,25,,,,,,,,,,,,,,,,,,,,
14,https://vlr.gg/player/4402/o0o0o,2024-10-27 06:00:00,,,,153,,,46,,,61,,,39,,,,,,,,,,,,,,,,,,,,
15,https://vlr.gg/player/14125/spring,2024-10-27 06:00:00,,,,246,,,76,,,66,,,13,,,,,,,,,,,,,,,,,,,,
16,https://vlr.gg/player/37489/lysoar,2024-10-27 06:00:00,,,,220,,,69,,,62,,,23,,,,,,,,,,,,,,,,,,,,
17,https://vlr.gg/player/11218/yuicaw,2024-10-27 06:00:00,,,,208,,,65,,,65,,,38,,,,,,,,,,,,,,,,,,,,
18,https://vlr.gg/player/45104/v1ya,2024-10-27 06:00:00,,,,182,,,54,,,60,,,41,,,,,,,,,,,,,,,,,,,,
19,https://vlr.gg/player/7849/siufatbb,2024-10-27 06:00:00,,,,176,,,53,,,56,,,20,,,,,,,,,,,,,,,,,,,,
20,https://vlr.gg/player/36685/splash,2024-10-27 05:20:00,1.37,1.63,1.51,329,294,350,73,29,44,43,20,23,15,7,8,+15,+7,+8,78%,76%,81%,204,178,225,24%,28%,21%,20,10,10,5,3,2
21,https://vlr.gg/player/11737/xan,2024-10-27 05:20:00,1.03,1.38,1.22,236,196,270,55,19,36,44,19,25,30,14,16,-3,-2,-1,80%,83%,78%,144,125,159,19%,16%,21%,2,0,2,5,2,3
22,https://vlr.gg/player/24654/tempz,2024-10-27 05:20:00,0.93,0.88,0.90,189,172,203,43,19,24,44,19,25,20,5,15,+2,-1,+3,68%,59%,75%,128,118,136,21%,18%,23%,8,2,6,6,3,3
23,https://vlr.gg/player/8137/lenne,2024-10-27 05:20:00,1.13,0.65,0.86,188,235,145,42,26,16,45,19,26,18,8,10,0,+2,-2,77%,76%,78%,120,147,98,21%,21%,21%,5,3,2,5,1,4
24,https://vlr.gg/player/7381/redkoh,2024-10-27 05:20:00,0.43,0.86,0.67,111,82,139,23,6,17,45,22,23,24,8,16,-1,+1,-2,72%,69%,75%,77,61,90,18%,22%,16%,4,3,1,5,2,3
25,https://vlr.gg/player/24628/wayne,2024-10-27 05:20:00,1.05,1.49,1.25,252,229,285,61,30,31,49,30,19,17,11,6,-3,-1,-2,80%,75%,86%,163,151,179,28%,23%,34%,2,1,1,5,2,3
26,https://vlr.gg/player/7426/juicy,2024-10-27 05:20:00,1.16,1.26,1.20,233,237,227,50,28,22,43,25,18,16,11,5,-2,+1,-3,69%,69%,69%,164,169,157,19%,19%,18%,9,7,2,11,6,5
27,https://vlr.gg/player/24653/vera,2024-10-27 05:20:00,0.93,0.88,0.91,212,220,205,47,27,20,51,29,22,19,11,8,-6,-5,-1,68%,69%,66%,133,130,138,19%,20%,17%,9,5,4,15,10,5
28,https://vlr.gg/player/9152/deryeon,2024-10-27 05:20:00,0.91,0.71,0.82,146,137,162,35,19,16,46,26,20,29,14,15,-1,-1,0,66%,58%,76%,91,89,95,25%,41%,13%,2,0,2,3,1,2
29,https://vlr.gg/player/11704/styron,2024-10-27 05:20:00,0.71,0.73,0.69,118,135,107,27,17,10,47,28,19,21,10,11,-1,0,-1,60%,58%,62%,87,90,83,24%,27%,21%,4,2,2,5,2,3
30,https://vlr.gg/player/34974/karon,2024-10-27 03:55:00,0.98,1.61,1.33,246,171,301,54,18,36,35,17,18,25,5,20,+1,-1,+2,71%,62%,78%,137,96,171,37%,40%,36%,6,1,5,5,2,3
31,https://vlr.gg/player/2489/munchkin,2024-10-27 03:55:00,1.00,1.26,1.14,219,191,232,41,17,24,34,15,19,24,7,17,-2,-1,-1,74%,65%,81%,135,114,152,22%,18%,24%,3,2,1,5,3,2
32,https://vlr.gg/player/11600/foxy9,2024-10-27 03:55:00,0.72,1.46,1.12,239,176,274,50,16,34,39,20,19,12,4,8,-3,-2,-1,72%,62%,81%,146,103,182,27%,24%,29%,4,2,2,7,4,3
33,https://vlr.gg/player/9196/t3xture,2024-10-27 03:55:00,0.83,1.16,1.01,239,216,259,49,18,31,43,21,22,9,5,4,+4,-3,+7,79%,73%,84%,157,132,177,29%,26%,31%,13,4,9,9,7,2
34,https://vlr.gg/player/25081/yoman,2024-10-27 03:55:00,0.96,0.96,0.96,143,136,141,29,12,17,31,15,16,15,6,9,-2,-1,-1,76%,73%,78%,97,93,101,29%,29%,30%,2,0,2,4,1,3
35,https://vlr.gg/player/3977/crws,2024-10-27 03:55:00,0.91,1.38,1.12,224,200,264,46,22,24,44,28,16,26,18,8,+2,+2,0,72%,69%,77%,158,145,174,34%,31%,38%,4,2,2,2,0,2
36,https://vlr.gg/player/13788/jitboys,2024-10-27 03:55:00,0.52,1.18,0.82,166,136,218,34,14,20,44,29,15,16,7,9,0,-2,+2,64%,56%,73%,109,84,139,36%,38%,34%,5,2,3,5,4,1
37,https://vlr.gg/player/3980/governor,2024-10-27 03:55:00,1.00,0.58,0.81,157,203,99,33,23,10,44,26,18,10,5,5,+1,+1,0,66%,69%,62%,105,135,67,36%,39%,29%,2,2,0,1,1,0
38,https://vlr.gg/player/25255/primmie,2024-10-27 03:55:00,0.48,1.21,0.80,199,174,232,39,18,21,45,31,14,3,2,1,-6,-8,+2,60%,50%,73%,125,112,141,29%,23%,40%,10,4,6,16,12,4
39,https://vlr.gg/player/5129/ban,2024-10-27 03:55:00,0.61,0.76,0.68,152,153,145,30,17,13,48,30,18,6,2,4,+5,+1,+4,64%,56%,73%,95,96,95,41%,44%,39%,9,3,6,4,2,2
40,https://vlr.gg/player/46463/twilight,2024-10-27 03:00:00,1.49,1.06,1.25,238,307,188,55,30,25,44,21,23,8,3,5,+4,+3,+1,62%,71%,54%,158,196,128,37%,38%,34%,11,6,5,7,3,4
41,https://vlr.gg/player/1437/yesican,2024-10-27 03:00:00,0.68,1.10,0.91,203,178,224,42,15,27,49,24,25,20,11,9,+4,+2,+2,65%,61%,69%,139,116,158,37%,43%,33%,6,3,3,2,1,1
42,https://vlr.gg/player/23976/crus,2024-10-27 03:00:00,0.90,0.83,0.86,163,151,173,35,16,19,51,21,30,29,10,19,0,-2,+2,73%,75%,71%,117,108,124,38%,29%,47%,2,0,2,2,2,0
43,https://vlr.gg/player/48573/tok1o,2024-10-27 03:00:00,0.67,0.88,0.79,165,152,176,36,15,21,49,22,27,18,5,13,+1,-1,+2,57%,50%,63%,107,87,124,30%,22%,40%,9,3,6,8,4,4
44,https://vlr.gg/player/48574/nia,2024-10-27 03:00:00,0.36,0.97,0.70,180,134,218,39,14,25,52,24,28,10,6,4,0,-2,+2,65%,68%,63%,127,87,158,26%,31%,24%,8,2,6,8,4,4
45,https://vlr.gg/player/48575/bucute,2024-10-27 03:00:00,1.30,1.37,1.33,250,265,225,57,33,24,39,24,15,19,10,9,0,+1,-1,79%,77%,82%,167,181,150,31%,25%,39%,7,6,1,7,5,2
46,https://vlr.gg/player/36180/mihlog,2024-10-27 03:00:00,1.04,1.23,1.12,183,137,234,45,20,25,37,19,18,14,9,5,+2,+1,+1,73%,69%,79%,118,99,143,39%,42%,37%,3,1,2,1,0,1
47,https://vlr.gg/player/8036/k1llers,2024-10-27 03:00:00,1.12,1.02,1.08,193,194,200,42,22,20,43,24,19,27,19,8,-3,-1,-2,71%,77%,64%,137,139,135,41%,41%,41%,1,0,1,4,1,3
48,https://vlr.gg/player/8240/alyal,2024-10-27 03:00:00,0.83,1.34,1.06,226,203,254,51,24,27,44,26,18,19,7,12,0,-5,+5,65%,57%,75%,144,133,158,45%,51%,40%,9,2,7,9,7,2
49,https://vlr.gg/player/14213/ting2k5,2024-10-27 03:00:00,1.07,0.76,0.93,210,248,170,49,33,16,44,25,19,6,1,5,-8,-5,-3,68%,69%,68%,141,158,119,31%,33%,26%,7,4,3,15,9,6
50,https://vlr.gg/player/3977/crws,2024-10-27 02:05:00,1.44,1.71,1.63,270,237,284,34,9,25,15,5,10,17,3,14,+2,+1,+1,88%,70%,96%,166,166,166,35%,36%,34%,4,1,3,2,0,2
51,https://vlr.gg/player/25255/primmie,2024-10-27 02:05:00,1.54,1.63,1.60,340,370,328,42,14,28,20,8,12,9,2,7,+8,+2,+6,85%,90%,83%,226,257,214,41%,37%,43%,8,2,6,0,0,0
52,https://vlr.gg/player/13788/jitboys,2024-10-27 02:05:00,0.97,1.22,1.15,203,205,203,23,6,17,20,7,13,17,6,11,0,+1,-1,76%,70%,79%,135,140,133,30%,46%,23%,3,1,2,3,0,3
53,https://vlr.gg/player/3980/governor,2024-10-27 02:05:00,0.60,1.38,1.15,186,119,215,24,4,20,15,6,9,5,0,5,+3,0,+3,82%,60%,92%,111,66,130,20%,27%,19%,5,2,3,2,2,0
54,https://vlr.gg/player/5129/ban,2024-10-27 02:05:00,0.87,1.10,1.04,213,215,212,29,8,21,23,8,15,10,1,9,-1,0,-1,88%,80%,92%,146,149,144,34%,33%,35%,3,1,2,4,1,3
55,https://vlr.gg/player/35013/flashback,2024-10-27 02:05:00,0.88,1.30,1.00,194,175,242,25,15,10,29,21,8,4,2,2,0,0,0,62%,58%,70%,130,120,153,23%,24%,22%,4,3,1,4,3,1
56,https://vlr.gg/player/1916/free1ng,2024-10-27 02:05:00,0.84,0.58,0.76,178,207,110,19,16,3,29,21,8,4,2,2,-4,-3,-1,47%,46%,50%,112,129,73,32%,46%,10%,1,1,0,5,4,1
57,https://vlr.gg/player/4462/mako,2024-10-27 02:05:00,0.36,1.47,0.69,137,93,245,19,9,10,29,22,7,7,3,4,-1,-2,+1,56%,46%,80%,80,53,142,25%,15%,32%,3,2,1,4,4,0
58,https://vlr.gg/player/34982/athan,2024-10-27 02:05:00,0.65,0.67,0.66,169,164,183,16,10,6,32,23,9,22,17,5,-1,+1,-2,71%,71%,70%,117,120,111,29%,28%,31%,1,1,0,2,0,2
59,https://vlr.gg/player/28400/hyunmin,2024-10-27 02:05:00,0.31,0.54,0.38,137,132,149,14,9,5,33,24,9,6,4,2,-6,-4,-2,59%,58%,60%,97,96,98,33%,35%,29%,2,1,1,8,5,3
60,https://vlr.gg/player/7447/firstlove,2024-10-27 01:15:00,0.84,1.41,1.17,233,204,293,43,15,28,34,16,18,6,1,5,0,-2,+2,78%,68%,85%,168,141,187,26%,26%,25%,7,1,6,7,3,4
61,https://vlr.gg/player/2383/lexy,2024-10-27 01:15:00,1.09,0.88,0.97,186,220,157,31,16,15,33,14,19,9,0,9,-1,-3,+2,56%,53%,58%,122,153,100,26%,29%,23%,3,1,2,4,4,0
62,https://vlr.gg/player/25960/irex,2024-10-27 01:15:00,0.83,1.00,0.92,176,161,186,25,10,15,36,16,20,27,11,16,-2,-1,-1,71%,74%,69%,122,108,133,29%,40%,24%,0,0,0,2,1,1
63,https://vlr.gg/player/36704/impecunity,2024-10-27 01:15:00,1.04,0.64,0.81,175,205,158,27,14,13,34,14,20,16,6,10,-2,+3,-5,71%,74%,69%,128,142,117,31%,45%,21%,5,5,0,7,2,5
64,https://vlr.gg/player/36705/kestrel,2024-10-27 01:15:00,0.47,0.78,0.65,154,123,182,22,6,16,38,17,21,16,8,8,-2,0,-2,62%,53%,69%,112,104,118,22%,26%,20%,4,1,3,6,1,5
65,https://vlr.gg/player/36685/splash,2024-10-27 01:15:00,1.35,1.36,1.35,312,315,290,47,28,19,32,19,13,13,5,8,+8,+6,+2,76%,73%,79%,189,196,179,33%,36%,28%,17,10,7,9,4,5
66,https://vlr.gg/player/8137/lenne,2024-10-27 01:15:00,0.71,1.70,1.13,189,126,247,27,10,17,28,19,9,18,7,11,-3,-3,0,73%,58%,95%,132,99,177,29%,28%,30%,0,0,0,3,3,0
67,https://vlr.gg/player/24654/tempz,2024-10-27 01:15:00,1.25,0.91,1.11,237,273,184,36,23,13,30,17,13,8,3,5,+1,0,+1,69%,73%,63%,159,182,126,18%,15%,23%,6,3,3,5,3,2
68,https://vlr.gg/player/11737/xan,2024-10-27 01:15:00,1.00,1.26,1.11,186,162,252,33,16,17,29,16,13,20,8,12,+2,+1,+1,82%,73%,95%,122,100,152,27%,26%,27%,3,2,1,1,1,0
69,https://vlr.gg/player/7381/redkoh,2024-10-27 01:15:00,1.19,0.97,1.09,202,224,185,32,21,11,29,16,13,27,14,13,-1,0,-1,82%,85%,79%,130,139,117,18%,24%,11%,0,0,0,1,0,1
70,https://vlr.gg/player/31498/lorangez,2024-10-27 01:00:00,1.37,1.46,1.41,235,216,241,71,39,32,47,28,19,39,24,15,+3,+4,-1,73%,72%,74%,150,147,153,37%,32%,45%,6,4,2,3,0,3
71,https://vlr.gg/player/27225/d4rf,2024-10-27 01:00:00,1.02,1.48,1.21,242,195,296,67,33,34,58,34,24,48,30,18,+4,-2,+6,79%,82%,74%,152,122,196,31%,28%,33%,11,4,7,7,6,1
72,https://vlr.gg/player/16977/socools0da,2024-10-27 01:00:00,1.22,1.04,1.15,192,198,187,63,41,22,51,29,22,17,9,8,-3,-5,+2,84%,86%,80%,130,133,125,37%,40%,33%,5,1,4,8,6,2
73,https://vlr.gg/player/12291/arpoom,2024-10-27 01:00:00,1.28,0.85,1.11,202,227,172,62,41,21,54,28,26,35,16,19,-3,0,-3,84%,86%,80%,136,155,109,28%,32%,22%,4,3,1,7,3,4
74,https://vlr.gg/player/25535/vickyz,2024-10-27 01:00:00,0.87,0.74,0.82,212,234,171,58,39,19,72,45,27,18,11,7,-10,-7,-3,67%,68%,66%,134,144,119,15%,17%,11%,12,8,4,22,15,7
75,https://vlr.gg/player/1908/kongared,2024-10-27 01:00:00,1.35,1.03,1.16,233,267,216,72,34,38,60,23,37,33,17,16,+2,0,+2,72%,77%,68%,155,179,138,35%,33%,36%,8,2,6,6,2,4
76,https://vlr.gg/player/23930/potter,2024-10-27 01:00:00,0.83,0.98,0.92,194,195,202,62,24,38,65,30,35,15,8,7,-1,+2,-3,74%,74%,74%,128,120,134,35%,23%,48%,11,7,4,12,5,7
77,https://vlr.gg/player/2366/alert,2024-10-27 01:00:00,0.90,0.80,0.84,173,191,175,50,22,28,63,25,38,21,10,11,+6,+2,+4,67%,66%,68%,123,118,126,27%,24%,30%,13,6,7,7,4,3
78,https://vlr.gg/player/12289/siraww,2024-10-27 01:00:00,0.95,0.71,0.81,186,193,178,54,25,29,66,24,42,24,6,18,-2,-3,+1,68%,63%,72%,120,134,111,32%,31%,33%,6,0,6,8,3,5
79,https://vlr.gg/player/2368/b3ta,2024-10-27 01:00:00,0.63,0.88,0.78,158,117,197,44,13,31,67,26,41,38,13,25,+4,-2,+6,71%,66%,74%,110,80,131,31%,24%,35%,9,2,7,5,4,1
80,https://vlr.gg/player/35013/flashback,2024-10-27 01:00:00,1.87,1.52,1.64,312,365,286,21,8,13,9,3,6,3,2,1,+3,0,+3,72%,67%,75%,208,240,191,37%,44%,32%,5,1,4,2,1,1
81,https://vlr.gg/player/34982/athan,2024-10-27 01:00:00,1.51,1.32,1.39,245,253,242,16,5,11,10,3,7,10,4,6,-1,-2,+1,72%,67%,75%,159,162,157,33%,42%,30%,1,0,1,2,2,0
82,https://vlr.gg/player/1916/free1ng,2024-10-27 01:00:00,1.32,1.25,1.27,245,250,243,16,6,10,11,4,7,6,1,5,-1,0,-1,72%,67%,75%,153,146,157,22%,23%,21%,2,1,1,3,1,2
83,https://vlr.gg/player/28400/hyunmin,2024-10-27 01:00:00,0.03,1.52,1.01,191,121,227,14,3,11,11,5,6,2,1,1,-1,0,-1,72%,50%,83%,117,87,132,13%,33%,5%,0,0,0,1,0,1
84,https://vlr.gg/player/4462/mako,2024-10-27 01:00:00,1.10,0.97,1.01,162,139,174,9,3,6,10,3,7,12,4,8,0,0,0,83%,100%,75%,103,85,112,26%,25%,27%,1,0,1,1,0,1
85,https://vlr.gg/player/4763/zixuan,2024-10-27 01:00:00,1.12,0.66,0.97,225,279,117,13,11,2,14,10,4,4,2,2,-2,-1,-1,72%,75%,67%,150,183,83,19%,21%,10%,0,0,0,2,1,1
86,https://vlr.gg/player/7857/berlin,2024-10-27 01:00:00,0.76,1.22,0.91,215,178,289,14,7,7,15,10,5,2,0,2,0,+1,-1,50%,42%,67%,125,117,140,24%,26%,22%,2,2,0,2,1,1
87,https://vlr.gg/player/19530/aaaay,2024-10-27 01:00:00,0.81,0.42,0.68,156,193,84,10,8,2,16,11,5,3,3,0,-1,-1,0,56%,58%,50%,103,119,71,43%,54%,25%,0,0,0,1,1,0
88,https://vlr.gg/player/3028/life,2024-10-27 01:00:00,0.31,1.17,0.60,143,83,266,8,3,5,16,11,5,2,1,1,+2,-2,+4,72%,67%,83%,108,62,199,42%,30%,50%,6,2,4,4,4,0
89,https://vlr.gg/player/872/autumn,2024-10-27 01:00:00,0.29,0.65,0.41,97,87,119,5,4,1,16,10,6,2,1,1,+1,+1,0,56%,58%,50%,79,66,105,17%,15%,18%,1,1,0,0,0,0
90,https://vlr.gg/player/301/takas,2024-10-26 16:20:00,0.91,1.29,1.07,238,233,246,16,9,7,17,11,6,4,0,4,+1,+3,-2,71%,75%,67%,152,149,157,17%,22%,12%,4,4,0,3,1,2
91,https://vlr.gg/player/3579/marctylinho,2024-10-26 16:20:00,0.44,1.55,0.92,155,86,248,12,3,9,14,10,4,9,4,5,-2,-2,0,67%,58%,78%,100,69,140,37%,33%,38%,0,0,0,2,2,0
92,https://vlr.gg/player/868/logan,2024-10-26 16:20:00,0.93,0.78,0.87,184,175,198,13,7,6,15,8,7,3,2,1,+1,-1,+2,71%,67%,78%,115,114,117,38%,33%,43%,2,0,2,1,1,0
93,https://vlr.gg/player/2625/sh1n,2024-10-26 16:20:00,0.84,0.50,0.70,182,198,161,14,9,5,18,10,8,5,4,1,-3,-2,-1,62%,67%,56%,122,141,97,32%,43%,22%,3,1,2,6,3,3
94,https://vlr.gg/player/2841/foxie,2024-10-26 16:20:00,0.77,0.26,0.55,95,133,46,6,5,1,15,9,6,5,4,1,0,0,0,52%,50%,56%,65,84,40,9%,11%,0%,0,0,0,0,0,0
95,https://vlr.gg/player/5554/profek,2024-10-26 16:20:00,1.41,1.66,1.55,223,215,230,18,7,11,10,5,5,15,5,10,+2,+2,0,90%,89%,92%,145,123,162,52%,45%,55%,3,2,1,1,0,1
96,https://vlr.gg/player/20144/lewn,2024-10-26 16:20:00,0.68,1.82,1.33,268,157,352,20,4,16,14,7,7,4,3,1,+1,-2,+3,62%,56%,67%,172,115,214,35%,20%,44%,5,1,4,4,3,1
97,https://vlr.gg/player/5568/sociablee,2024-10-26 16:20:00,1.00,1.41,1.23,250,166,315,19,6,13,12,5,7,4,3,1,+2,+1,+1,86%,89%,83%,171,104,222,28%,6%,38%,3,1,2,1,0,1
98,https://vlr.gg/player/321/chiwa,2024-10-26 16:20:00,1.17,1.00,1.08,174,248,120,13,8,5,11,7,4,4,1,3,-1,0,-1,76%,78%,75%,124,160,96,39%,44%,33%,1,1,0,2,1,1
99,https://vlr.gg/player/9780/jamppi,2024-10-26 16:20:00,1.24,0.44,0.78,154,214,109,9,6,3,14,4,10,7,0,7,-1,0,-1,62%,67%,58%,99,132,75,33%,50%,19%,0,0,0,1,0,1
100,https://vlr.gg/player/5566/jeyj7y,2024-10-26 15:15:00,1.32,0.89,1.18,254,279,205,15,11,4,15,9,6,7,6,1,-1,-1,0,67%,67%,67%,159,155,167,23%,15%,50%,1,1,0,2,2,0
101,https://vlr.gg/player/5564/deadink,2024-10-26 15:15:00,1.01,0.19,0.73,183,229,93,10,9,1,15,9,6,4,2,2,-2,-2,0,50%,58%,33%,129,153,82,21%,13%,57%,2,2,0,4,4,0
102,https://vlr.gg/player/4890/l7,2024-10-26 15:15:00,0.73,0.29,0.58,134,147,109,8,6,2,16,10,6,3,2,1,-2,0,-2,50%,58%,33%,98,117,60,24%,27%,14%,1,1,0,3,1,2
103,https://vlr.gg/player/1397/mini,2024-10-26 15:15:00,0.64,0.37,0.55,176,177,175,10,7,3,16,10,6,1,1,0,0,0,0,67%,83%,33%,112,111,114,48%,44%,57%,0,0,0,0,0,0
104,https://vlr.gg/player/5500/docent,2024-10-26 15:15:00,0.72,0.11,0.52,83,98,54,5,4,1,14,8,6,7,6,1,-3,-1,-2,50%,58%,33%,46,53,30,25%,15%,67%,1,0,1,4,1,3
105,https://vlr.gg/player/2625/sh1n,2024-10-26 15:15:00,2.63,1.77,2.06,328,376,305,22,9,13,6,0,6,11,4,7,+2,0,+2,89%,100%,83%,195,208,188,30%,26%,32%,3,0,3,1,0,1
106,https://vlr.gg/player/868/logan,2024-10-26 15:15:00,2.11,0.79,1.23,219,350,154,16,9,7,9,1,8,4,1,3,0,0,0,83%,100%,75%,151,247,103,50%,63%,38%,0,0,0,0,0,0
107,https://vlr.gg/player/3579/marctylinho,2024-10-26 15:15:00,1.02,1.34,1.23,178,88,223,11,2,9,8,2,6,8,3,5,+1,+1,0,78%,83%,75%,126,64,157,22%,20%,22%,1,1,0,0,0,0
108,https://vlr.gg/player/301/takas,2024-10-26 15:15:00,1.21,1.04,1.10,305,347,285,18,7,11,15,6,9,5,2,3,+5,+3,+2,78%,100%,67%,187,205,178,23%,15%,31%,7,4,3,2,1,1
109,https://vlr.gg/player/2841/foxie,2024-10-26 15:15:00,0.99,0.84,0.89,131,101,147,9,3,6,10,2,8,4,1,3,0,0,0,78%,83%,75%,95,80,102,26%,100%,15%,2,0,2,2,0,2
110,https://vlr.gg/player/20032/treelover,2024-10-26 14:30:00,1.33,1.27,1.31,282,288,268,36,21,15,26,14,12,11,4,7,+5,+3,+2,77%,79%,75%,180,204,151,47%,53%,38%,6,3,3,1,0,1
111,https://vlr.gg/player/2540/happen,2024-10-26 14:30:00,1.25,1.34,1.29,242,238,252,31,16,15,22,13,9,15,11,4,-2,-1,-1,77%,79%,75%,173,179,166,21%,18%,26%,2,1,1,4,2,2
112,https://vlr.gg/player/13238/shiio,2024-10-26 14:30:00,1.19,1.14,1.17,190,217,160,27,17,10,19,11,8,5,0,5,+1,+1,0,74%,68%,81%,142,161,119,28%,36%,19%,1,1,0,0,0,0
113,https://vlr.gg/player/3934/eleo,2024-10-26 14:30:00,1.25,1.08,1.17,199,225,163,25,15,10,20,12,8,20,14,6,+2,+1,+1,86%,84%,88%,130,155,101,21%,22%,18%,2,1,1,0,0,0
114,https://vlr.gg/player/47270/darkwinjett,2024-10-26 14:30:00,0.89,1.47,1.15,237,186,309,30,13,17,22,12,10,4,2,2,-3,-3,0,74%,68%,81%,142,106,185,21%,21%,21%,8,4,4,11,7,4
115,https://vlr.gg/player/33398/miyamura,2024-10-26 14:30:00,1.01,0.89,0.94,226,212,237,26,11,15,31,13,18,9,4,5,0,+2,-2,60%,50%,68%,156,143,167,30%,29%,31%,4,2,2,4,0,4
116,https://vlr.gg/player/39664/insanedini,2024-10-26 14:30:00,1.14,0.56,0.83,174,226,141,24,14,10,29,12,17,4,2,2,-3,-2,-1,66%,69%,63%,116,140,96,20%,16%,30%,4,1,3,7,3,4
117,https://vlr.gg/player/30292/bruhbruhfish,2024-10-26 14:30:00,0.63,1.00,0.83,213,202,215,25,11,14,33,15,18,4,4,0,+5,+2,+3,69%,69%,68%,132,121,140,46%,55%,41%,6,3,3,1,1,0
118,https://vlr.gg/player/46466/frazune,2024-10-26 14:30:00,0.75,0.78,0.76,164,141,185,20,8,12,28,12,16,16,7,9,-3,-2,-1,63%,56%,68%,118,107,127,24%,21%,26%,0,0,0,3,2,1
119,https://vlr.gg/player/46468/dokusei,2024-10-26 14:30:00,0.20,0.89,0.56,147,81,198,14,3,11,28,15,13,11,4,7,-2,-2,0,60%,56%,63%,108,68,142,44%,45%,43%,2,1,1,4,3,1
120,https://vlr.gg/player/20144/lewn,2024-10-26 14:05:00,0.35,2.21,1.32,301,145,445,25,6,19,18,11,7,2,0,2,0,-5,+5,57%,45%,67%,202,93,302,34%,50%,29%,8,2,6,8,7,1
121,https://vlr.gg/player/321/chiwa,2024-10-26 14:05:00,1.49,0.88,1.17,205,245,170,17,10,7,14,7,7,4,2,2,+2,+1,+1,61%,55%,67%,145,161,130,30%,23%,40%,2,1,1,0,0,0
122,https://vlr.gg/player/5568/sociablee,2024-10-26 14:05:00,1.16,0.94,1.05,177,210,147,13,7,6,14,8,6,10,4,6,-2,-1,-1,83%,73%,92%,125,151,102,13%,14%,10%,0,0,0,2,1,1
123,https://vlr.gg/player/9780/jamppi,2024-10-26 14:05:00,0.94,1.12,1.03,193,181,204,14,6,8,16,9,7,16,10,6,+1,0,+1,87%,82%,92%,125,115,134,27%,24%,30%,1,0,1,0,0,0
124,https://vlr.gg/player/5554/profek,2024-10-26 14:05:00,0.82,0.57,0.69,94,94,95,8,3,5,15,7,8,11,7,4,0,0,0,70%,64%,75%,61,65,58,23%,6%,67%,1,0,1,1,0,1
125,https://vlr.gg/player/6959/flickless,2024-10-26 14:05:00,1.49,1.28,1.39,240,251,229,18,11,7,14,7,7,17,3,14,+2,+1,+1,74%,58%,91%,154,159,148,28%,42%,17%,2,1,1,0,0,0
126,https://vlr.gg/player/8834/bucher,2024-10-26 14:05:00,0.99,1.49,1.23,223,192,259,18,7,11,14,9,5,5,2,3,+1,0,+1,70%,50%,91%,153,126,183,29%,27%,31%,2,1,1,1,1,0
127,https://vlr.gg/player/341/quick,2024-10-26 14:05:00,0.72,1.30,1.00,192,143,246,16,6,10,15,9,6,2,0,2,0,-1,+1,74%,75%,73%,126,94,161,48%,42%,53%,3,1,2,3,2,1
128,https://vlr.gg/player/2700/jas,2024-10-26 14:05:00,0.56,1.09,0.82,177,159,198,16,7,9,15,10,5,1,1,0,-3,-4,+1,57%,50%,64%,106,95,118,43%,50%,38%,2,0,2,5,4,1
129,https://vlr.gg/player/15473/yuno,2024-10-26 14:05:00,0.56,0.44,0.50,123,110,138,9,4,5,19,10,9,7,5,2,-1,-2,+1,65%,67%,64%,85,88,81,26%,35%,19%,2,0,2,3,2,1
130,https://vlr.gg/player/2700/jas,2024-10-26 13:00:00,2.66,1.91,2.16,427,585,349,28,12,16,9,3,6,7,4,3,+7,+3,+4,94%,100%,92%,260,347,216,27%,31%,23%,7,3,4,0,0,0
131,https://vlr.gg/player/8834/bucher,2024-10-26 13:00:00,2.00,1.35,1.57,271,263,275,20,8,12,9,1,8,4,0,4,+2,0,+2,78%,83%,75%,175,196,164,34%,38%,32%,2,0,2,0,0,0
132,https://vlr.gg/player/15473/yuno,2024-10-26 13:00:00,0.91,1.42,1.25,184,113,220,13,3,10,8,2,6,10,3,7,+2,-1,+3,89%,100%,83%,99,61,118,28%,33%,26%,3,0,3,1,1,0
133,https://vlr.gg/player/6959/flickless,2024-10-26 13:00:00,1.38,0.72,0.94,147,161,142,9,3,6,10,2,8,12,7,5,-1,0,-1,89%,100%,83%,105,121,98,27%,11%,50%,0,0,0,1,0,1
134,https://vlr.gg/player/341/quick,2024-10-26 13:00:00,0.69,0.99,0.89,188,155,205,11,4,7,12,4,8,6,0,6,0,0,0,83%,83%,83%,133,85,157,27%,60%,20%,2,1,1,2,1,1
135,https://vlr.gg/player/569/paura,2024-10-26 13:00:00,0.92,0.39,0.74,177,188,155,11,8,3,14,8,6,1,1,0,-1,-2,+1,56%,58%,50%,120,131,97,52%,45%,71%,3,1,2,4,3,1
136,https://vlr.gg/player/451/shadow,2024-10-26 13:00:00,0.50,0.89,0.63,145,117,203,9,5,4,16,10,6,2,1,1,-1,-1,0,61%,58%,67%,85,72,112,29%,29%,30%,0,0,0,1,1,0
137,https://vlr.gg/player/562/zeek,2024-10-26 13:00:00,0.59,0.68,0.62,151,145,166,9,6,3,17,11,6,5,4,1,0,0,0,56%,67%,33%,89,86,95,24%,24%,25%,0,0,0,0,0,0
138,https://vlr.gg/player/92/scream,2024-10-26 13:00:00,0.91,0.01,0.53,157,231,9,10,10,0,17,11,6,0,0,0,-6,-4,-2,28%,42%,,103,150,9,45%,47%,0%,1,1,0,7,5,2
139,https://vlr.gg/player/10146/reazy,2024-10-26 13:00:00,0.56,0.22,0.45,141,166,94,9,7,2,17,11,6,4,4,0,-2,-1,-1,39%,50%,17%,103,112,86,38%,41%,29%,0,0,0,2,1,1
140,https://vlr.gg/player/8044/mrfalin,2024-10-26 12:35:00,1.83,1.69,1.79,263,285,212,34,26,8,13,11,2,18,13,5,+1,+1,0,79%,75%,90%,168,182,134,21%,22%,18%,2,1,1,1,0,1
141,https://vlr.gg/player/8369/yetujey,2024-10-26 12:35:00,1.73,1.88,1.78,326,326,329,41,29,12,18,15,3,8,6,2,+5,+3,+2,91%,88%,100%,200,210,177,20%,23%,14%,8,5,3,3,2,1
142,https://vlr.gg/player/15735/krostaly,2024-10-26 12:35:00,0.69,1.38,0.89,142,131,168,20,13,7,20,17,3,4,0,4,+1,+1,0,65%,54%,90%,99,89,123,40%,36%,47%,1,1,0,0,0,0
143,https://vlr.gg/player/1139/qraxs,2024-10-26 12:35:00,0.52,1.35,0.77,151,110,248,17,6,11,23,18,5,11,11,0,0,0,0,85%,88%,80%,104,89,142,31%,26%,40%,1,1,0,1,1,0
144,https://vlr.gg/player/12793/xeus,2024-10-26 12:35:00,0.38,1.66,0.75,195,139,329,21,9,12,28,22,6,10,7,3,-3,-3,0,76%,67%,100%,131,95,215,26%,19%,41%,7,5,2,10,8,2
145,https://vlr.gg/player/10152/padisah,2024-10-26 12:35:00,1.42,0.77,0.96,233,349,184,28,12,16,29,10,19,3,0,3,0,+1,-1,76%,80%,75%,149,209,124,43%,55%,36%,3,1,2,3,0,3
146,https://vlr.gg/player/3604/mojj,2024-10-26 12:35:00,0.17,1.19,0.89,201,74,255,23,2,21,27,10,17,7,1,6,+2,0,+2,65%,30%,79%,132,57,164,42%,18%,48%,5,1,4,3,1,2
147,https://vlr.gg/player/19776/jrayn,2024-10-26 12:35:00,0.02,1.07,0.74,169,41,222,20,1,19,27,10,17,14,1,13,-1,-1,0,71%,40%,83%,108,31,140,34%,50%,33%,0,0,0,1,1,0
148,https://vlr.gg/player/3549/touven,2024-10-26 12:35:00,0.15,0.84,0.61,153,86,182,17,2,15,24,10,14,8,3,5,-3,-1,-2,56%,50%,58%,103,54,124,36%,14%,41%,2,1,1,5,2,3
149,https://vlr.gg/player/33523/vuexlex,2024-10-26 12:35:00,0.19,0.71,0.54,129,74,152,14,2,12,26,10,16,9,3,6,-2,-1,-1,56%,40%,63%,83,45,99,21%,10%,25%,5,1,4,7,2,5
150,https://vlr.gg/player/321/chiwa,2024-10-26 12:00:00,1.37,1.87,1.60,274,245,310,22,10,12,11,7,4,7,2,5,-1,0,-1,73%,58%,90%,179,166,195,31%,35%,29%,0,0,0,1,0,1
151,https://vlr.gg/player/20144/lewn,2024-10-26 12:00:00,1.61,1.29,1.46,292,344,232,23,14,9,15,8,7,6,4,2,+3,+1,+2,86%,92%,80%,188,217,154,45%,43%,47%,6,4,2,3,3,0
152,https://vlr.gg/player/5554/profek,2024-10-26 12:00:00,1.04,0.94,1.00,193,181,210,15,8,7,15,7,8,9,5,4,+1,0,+1,82%,83%,80%,124,126,121,32%,42%,23%,2,1,1,1,1,0
153,https://vlr.gg/player/9780/jamppi,2024-10-26 12:00:00,0.80,1.09,0.93,159,122,204,13,5,8,13,7,6,7,4,3,0,+1,-1,68%,67%,70%,105,76,140,38%,50%,32%,2,1,1,2,0,2
154,https://vlr.gg/player/5568/sociablee,2024-10-26 12:00:00,0.93,0.83,0.89,192,181,205,14,8,6,16,9,7,3,0,3,-1,0,-1,68%,67%,70%,140,142,137,10%,14%,6%,2,1,1,3,1,2
155,https://vlr.gg/player/16209/famsii,2024-10-26 12:00:00,1.46,0.99,1.20,306,375,250,23,13,10,18,9,9,2,1,1,+4,+3,+1,73%,90%,58%,197,235,165,42%,37%,50%,5,3,2,1,0,1
156,https://vlr.gg/player/3127/monsteerr,2024-10-26 12:00:00,0.85,1.08,0.98,220,183,252,18,7,11,17,8,9,2,1,1,+1,0,+1,64%,60%,67%,149,136,159,33%,32%,33%,3,2,1,2,2,0
157,https://vlr.gg/player/314/ambi,2024-10-26 12:00:00,0.86,0.98,0.93,181,172,188,14,6,8,16,8,8,7,4,3,-2,-1,-1,77%,80%,75%,122,116,127,36%,43%,32%,1,0,1,3,1,2
158,https://vlr.gg/player/2653/jesse,2024-10-26 12:00:00,0.58,0.81,0.71,147,107,181,11,3,8,18,8,10,9,5,4,-3,-1,-2,59%,50%,67%,103,75,126,32%,30%,33%,0,0,0,3,1,2
159,https://vlr.gg/player/8805/sacake,2024-10-26 12:00:00,0.32,0.26,0.29,77,109,51,4,3,1,18,9,9,6,4,2,-2,-1,-1,50%,50%,50%,58,75,44,44%,42%,50%,1,0,1,3,1,2
160,https://vlr.gg/player/33974/appa,2024-10-26 11:00:00,1.42,1.01,1.21,239,296,185,60,37,23,44,21,23,6,3,3,+2,+3,-1,68%,76%,60%,153,191,118,32%,36%,26%,14,10,4,12,7,5
161,https://vlr.gg/player/45494/proxh,2024-10-26 11:00:00,1.03,1.16,1.10,222,199,243,53,25,28,48,23,25,21,10,11,0,+2,-2,71%,73%,69%,146,126,164,25%,21%,28%,9,4,5,9,2,7
162,https://vlr.gg/player/7991/hyperr,2024-10-26 11:00:00,0.87,1.14,1.01,170,127,210,36,13,23,44,20,24,30,13,17,-2,-1,-1,71%,67%,74%,113,89,136,22%,28%,20%,3,1,2,5,2,3
163,https://vlr.gg/player/22518/mimori,2024-10-26 11:00:00,0.91,1.02,0.97,183,156,210,42,18,24,46,22,24,16,9,7,-2,-1,-1,65%,64%,66%,137,116,158,38%,32%,42%,4,1,3,6,2,4
164,https://vlr.gg/player/27789/deyten,2024-10-26 11:00:00,1.18,0.73,0.95,164,199,131,40,22,18,44,19,25,14,8,6,0,+2,-2,63%,70%,57%,111,138,85,27%,27%,27%,3,3,0,3,1,2
165,https://vlr.gg/player/45834/aidan,2024-10-26 11:00:00,1.19,1.14,1.16,267,259,281,65,34,31,48,24,24,15,8,7,+2,-1,+3,66%,66%,67%,175,162,190,28%,30%,26%,15,7,8,13,8,5
166,https://vlr.gg/player/24831/complexit,2024-10-26 11:00:00,1.19,0.86,1.03,211,226,194,49,28,21,48,25,23,17,11,6,+5,+6,-1,69%,69%,70%,137,152,120,31%,25%,38%,9,7,2,4,1,3
167,https://vlr.gg/player/33392/zeikosha,2024-10-26 11:00:00,1.25,0.75,1.00,187,230,148,47,30,17,46,22,24,17,11,6,-4,+3,-7,69%,74%,64%,130,150,108,23%,29%,15%,5,4,1,9,1,8
168,https://vlr.gg/player/44548/nomiss,2024-10-26 11:00:00,0.76,0.97,0.86,158,146,174,37,16,21,46,24,22,25,17,8,0,-1,+1,69%,71%,67%,112,109,115,25%,20%,31%,4,2,2,4,3,1
169,https://vlr.gg/player/4361/radenz,2024-10-26 11:00:00,0.72,0.92,0.82,143,124,165,28,14,14,45,22,23,30,17,13,-1,0,-1,63%,69%,58%,95,77,115,26%,26%,25%,2,1,1,3,1,2
170,https://vlr.gg/player/14310/annja,2024-10-26 10:15:00,0.84,1.30,1.07,243,214,273,40,17,23,38,20,18,5,2,3,+1,-2,+3,70%,61%,78%,159,147,170,40%,36%,43%,7,4,3,6,6,0
171,https://vlr.gg/player/20116/jademwah,2024-10-26 10:15:00,0.79,1.15,0.97,230,216,245,37,18,19,38,20,18,7,2,5,+2,+2,0,61%,57%,65%,145,130,159,25%,28%,23%,11,5,6,9,3,6
172,https://vlr.gg/player/38142/dream,2024-10-26 10:15:00,1.09,0.84,0.96,158,173,144,25,13,12,31,14,17,20,11,9,-2,-1,-1,67%,70%,65%,106,113,99,25%,25%,25%,0,0,0,2,1,1
173,https://vlr.gg/player/38011/misa,2024-10-26 10:15:00,1.16,0.73,0.95,167,185,149,27,16,11,32,15,17,7,3,4,+2,0,+2,59%,65%,52%,114,123,105,22%,27%,17%,5,2,3,3,2,1
174,https://vlr.gg/player/31272/els,2024-10-26 10:15:00,0.67,0.70,0.69,145,110,181,20,8,12,33,14,19,13,5,8,+2,+1,+1,57%,48%,65%,109,79,138,27%,19%,32%,3,1,2,1,0,1
175,https://vlr.gg/player/37969/ellie,2024-10-26 10:15:00,1.48,1.18,1.33,283,325,241,47,27,20,30,16,14,6,4,2,+2,-2,+4,76%,78%,74%,177,210,145,37%,38%,35%,9,4,5,7,6,1
176,https://vlr.gg/player/41207/jade,2024-10-26 10:15:00,0.97,1.27,1.12,192,184,200,33,15,18,28,15,13,16,8,8,0,-1,+1,76%,74%,78%,120,112,127,30%,35%,26%,2,1,1,2,2,0
177,https://vlr.gg/player/17318/blossi,2024-10-26 10:15:00,1.18,0.94,1.06,203,237,169,30,18,12,28,14,14,20,12,8,-2,+1,-3,76%,83%,70%,139,158,121,29%,32%,26%,3,1,2,5,0,5
178,https://vlr.gg/player/30042/harmonee,2024-10-26 10:15:00,0.97,1.00,0.99,189,189,190,29,15,14,28,14,14,9,4,5,-3,0,-3,65%,74%,57%,125,123,127,21%,28%,16%,2,1,1,5,1,4
179,https://vlr.gg/player/19373/ginger,2024-10-26 10:15:00,0.73,0.91,0.82,198,162,233,32,14,18,35,18,17,10,5,5,-2,-2,0,72%,74%,70%,137,111,163,22%,17%,25%,4,2,2,6,4,2
180,https://vlr.gg/player/40910/consz,2024-10-26 09:25:00,1.55,1.49,1.51,281,282,281,35,12,23,19,5,14,9,2,7,+2,-3,+5,89%,91%,88%,191,190,191,17%,23%,12%,5,0,5,3,3,0
181,https://vlr.gg/player/44770/cxix666,2024-10-26 09:25:00,1.64,1.36,1.45,241,291,211,31,12,19,17,5,12,16,3,13,+1,+1,0,91%,82%,96%,140,156,132,34%,38%,31%,3,2,1,2,1,1
182,https://vlr.gg/player/44930/nex1sphix,2024-10-26 09:25:00,1.63,1.34,1.43,244,239,250,32,11,21,20,5,15,14,7,7,+1,+1,0,83%,91%,79%,171,153,180,37%,43%,35%,2,1,1,1,0,1
183,https://vlr.gg/player/40908/skyisblue,2024-10-26 09:25:00,1.59,1.01,1.19,266,344,232,37,15,22,26,8,18,7,3,4,+5,+2,+3,80%,91%,75%,174,184,170,26%,17%,33%,9,3,6,4,1,3
184,https://vlr.gg/player/40907/mnfear,2024-10-26 09:25:00,0.71,1.34,1.14,220,104,274,27,3,24,22,7,15,17,7,10,-4,0,-4,80%,91%,75%,145,73,178,20%,19%,20%,1,0,1,5,0,5
185,https://vlr.gg/player/46087/theearth,2024-10-26 09:25:00,1.16,1.62,1.31,281,252,330,35,21,14,29,20,9,10,7,3,-2,-1,-1,69%,63%,82%,170,156,201,43%,40%,46%,1,1,0,3,2,1
186,https://vlr.gg/player/46089/acm,2024-10-26 09:25:00,1.28,0.23,0.95,203,261,101,23,21,2,29,18,11,10,4,6,-2,-1,-1,57%,58%,55%,142,172,76,26%,34%,0%,1,0,1,3,1,2
187,https://vlr.gg/player/48817/kikilnwza,2024-10-26 09:25:00,0.64,0.72,0.67,198,182,238,21,13,8,33,22,11,11,6,5,-2,-3,+1,69%,63%,82%,132,116,166,13%,16%,8%,7,5,2,9,8,1
188,https://vlr.gg/player/48816/againist,2024-10-26 09:25:00,0.31,0.19,0.25,83,95,62,9,7,2,33,22,11,1,1,0,+1,-1,+2,37%,46%,18%,54,62,35,16%,29%,5%,3,1,2,2,2,0
189,https://vlr.gg/player/48815/surge,2024-10-26 09:25:00,0.19,0.30,0.21,131,140,106,16,12,4,38,27,11,7,4,3,0,+2,-2,54%,58%,45%,85,95,63,29%,32%,20%,3,3,0,3,1,2
190,https://vlr.gg/player/40591/comeback,2024-10-26 08:55:00,1.32,1.44,1.39,324,311,312,76,34,42,49,26,23,9,2,7,+20,+8,+12,81%,71%,89%,188,187,189,29%,39%,20%,26,11,15,6,3,3
191,https://vlr.gg/player/24344/loita,2024-10-26 08:55:00,0.87,1.52,1.23,218,176,261,55,19,36,41,23,18,31,12,19,+1,-3,+4,81%,71%,89%,146,110,175,41%,34%,45%,7,1,6,6,4,2
192,https://vlr.gg/player/31305/lar0k,2024-10-26 08:55:00,1.04,1.15,1.10,169,172,165,42,20,22,40,23,17,40,19,21,0,0,0,84%,81%,87%,109,109,110,31%,30%,31%,1,0,1,1,0,1
193,https://vlr.gg/player/12795/crewen,2024-10-26 08:55:00,0.82,1.21,1.04,213,200,219,52,20,32,44,26,18,20,10,10,-2,-3,+1,70%,58%,79%,140,133,146,30%,24%,35%,5,2,3,7,5,2
194,https://vlr.gg/player/5565/ros,2024-10-26 08:55:00,0.77,1.21,1.01,189,141,224,45,17,28,44,23,21,26,9,17,0,-1,+1,72%,65%,79%,120,97,138,16%,17%,15%,5,2,3,5,3,2
195,https://vlr.gg/player/12774/anima,2024-10-26 08:55:00,0.54,1.61,1.02,192,121,309,46,13,33,52,33,19,32,17,15,0,-2,+2,72%,58%,90%,144,87,214,36%,19%,47%,2,0,2,2,2,0
196,https://vlr.gg/player/10160/izzy,2024-10-26 08:55:00,0.72,1.28,0.97,200,194,226,49,23,26,52,34,18,15,7,8,-10,-8,-2,64%,53%,77%,138,129,148,31%,29%,35%,5,3,2,15,11,4
197,https://vlr.gg/player/10163/cyderx,2024-10-26 08:55:00,0.85,0.83,0.84,136,143,145,33,19,14,49,29,20,18,7,11,0,-1,+1,64%,53%,77%,110,111,108,29%,29%,30%,2,1,1,2,2,0
198,https://vlr.gg/player/8041/brave,2024-10-26 08:55:00,0.68,0.92,0.79,172,142,204,41,19,22,56,32,24,20,9,11,-5,-2,-3,58%,47%,71%,114,97,134,29%,29%,29%,5,3,2,10,5,5
199,https://vlr.gg/player/10161/qutionerx,2024-10-26 08:55:00,0.78,0.73,0.76,193,175,223,49,23,26,61,32,29,11,5,6,-4,-5,+1,62%,58%,68%,127,117,138,27%,28%,27%,11,3,8,15,8,7
200,https://vlr.gg/player/27336/venka,2024-10-26 08:30:00,1.27,1.20,1.23,270,302,241,42,22,20,27,14,13,7,3,4,+9,+7,+2,80%,75%,86%,184,200,168,34%,33%,35%,12,8,4,3,1,2
201,https://vlr.gg/player/3639/hoax,2024-10-26 08:30:00,0.97,1.48,1.23,228,162,290,39,15,24,27,12,15,15,5,10,0,-2,+2,83%,75%,90%,151,103,196,24%,24%,25%,2,0,2,2,2,0
202,https://vlr.gg/player/3627/hellff,2024-10-26 08:30:00,1.21,1.20,1.20,220,237,205,32,16,16,24,13,11,9,5,4,+5,+1,+4,76%,80%,71%,150,169,132,40%,31%,57%,6,2,4,1,1,0
203,https://vlr.gg/player/30693/makaveli,2024-10-26 08:30:00,1.13,1.17,1.15,223,199,244,33,14,19,24,11,13,8,4,4,+2,0,+2,80%,75%,86%,160,141,177,36%,39%,33%,6,2,4,4,2,2
204,https://vlr.gg/player/27775/techno,2024-10-26 08:30:00,0.75,0.92,0.84,160,157,163,23,11,12,25,14,11,10,3,7,-1,0,-1,71%,70%,71%,107,104,110,27%,26%,29%,2,1,1,3,1,2
205,https://vlr.gg/player/30286/karam1l,2024-10-26 08:30:00,1.06,1.29,1.17,264,237,293,36,16,20,34,17,17,4,1,3,-3,-1,-2,61%,57%,65%,180,163,198,33%,33%,32%,3,1,2,6,2,4
206,https://vlr.gg/player/23931/kata,2024-10-26 08:30:00,0.78,1.29,1.03,209,201,217,31,14,17,34,20,14,3,2,1,-3,-3,0,56%,52%,60%,142,137,146,29%,30%,26%,5,3,2,8,6,2
207,https://vlr.gg/player/4089/doxz3r,2024-10-26 08:30:00,0.96,1.01,0.98,180,190,169,26,14,12,31,17,14,11,4,7,-1,-2,+1,54%,48%,60%,120,127,112,32%,48%,17%,1,0,1,2,2,0
208,https://vlr.gg/player/14208/kishi,2024-10-26 08:30:00,1.07,0.69,0.88,185,211,159,24,13,11,34,17,17,17,11,6,0,+1,-1,73%,76%,70%,112,125,97,31%,26%,38%,4,2,2,4,1,3
209,https://vlr.gg/player/41834/panda,2024-10-26 08:30:00,0.18,0.33,0.23,71,75,67,10,6,4,36,20,16,8,2,6,-8,-4,-4,49%,52%,45%,54,55,52,34%,40%,29%,0,0,0,8,4,4
210,https://vlr.gg/player/40895/anotherrr,2024-10-26 07:00:00,1.53,1.28,1.41,312,355,264,56,34,22,32,18,14,8,0,8,+4,+1,+3,67%,68%,67%,192,217,165,29%,40%,19%,8,3,5,4,2,2
211,https://vlr.gg/player/40903/rina,2024-10-26 07:00:00,1.03,0.91,0.97,153,175,128,25,15,10,29,16,13,19,10,9,-1,+1,-2,67%,68%,67%,101,116,85,24%,32%,17%,1,1,0,2,0,2
212,https://vlr.gg/player/47596/hyper,2024-10-26 07:00:00,1.02,0.88,0.95,166,194,140,26,16,10,31,17,14,10,7,3,-2,-3,+1,73%,76%,71%,112,122,101,40%,45%,33%,2,0,2,4,3,1
213,https://vlr.gg/player/40890/cinjvv,2024-10-26 07:00:00,0.62,1.13,0.87,180,154,210,31,12,19,34,20,14,6,4,2,-4,-2,-2,63%,56%,71%,115,98,133,21%,21%,22%,5,3,2,9,5,4
214,https://vlr.gg/player/40892/diky,2024-10-26 07:00:00,0.50,1.25,0.87,219,135,310,38,11,27,41,19,22,10,4,6,-2,-2,0,65%,60%,71%,141,92,192,28%,21%,33%,6,3,3,8,5,3
215,https://vlr.gg/player/35963/migz,2024-10-26 07:00:00,1.31,1.35,1.33,311,285,331,52,23,29,39,18,21,13,9,4,+9,+4,+5,76%,71%,80%,188,179,197,28%,25%,31%,16,9,7,7,5,2
216,https://vlr.gg/player/52235/kael,2024-10-26 07:00:00,1.13,1.10,1.12,190,199,182,33,17,16,30,15,15,8,3,5,+1,0,+1,71%,79%,64%,134,130,138,21%,20%,22%,2,0,2,1,0,1
217,https://vlr.gg/player/25375/scarymd2,2024-10-26 07:00:00,0.78,1.02,0.90,163,172,157,28,14,14,34,19,15,16,7,9,-4,-3,-1,71%,67%,76%,105,108,103,26%,24%,28%,2,0,2,6,3,3
218,https://vlr.gg/player/35967/taphtaph,2024-10-26 07:00:00,0.54,1.13,0.84,165,100,236,29,9,20,33,16,17,23,7,16,-4,-2,-2,71%,71%,72%,102,58,144,29%,17%,35%,2,1,1,6,3,3
219,https://vlr.gg/player/27199/jaso,2024-10-26 07:00:00,0.76,0.72,0.74,164,183,143,24,13,11,40,20,20,23,11,12,+3,+1,+2,78%,79%,76%,116,129,104,32%,33%,32%,5,2,3,2,1,1
220,https://vlr.gg/player/13788/jitboys,2024-10-26 06:45:00,1.33,1.45,1.38,204,215,191,17,10,7,11,7,4,8,3,5,+3,+2,+1,81%,83%,78%,128,141,110,35%,45%,24%,4,2,2,1,0,1
221,https://vlr.gg/player/3980/governor,2024-10-26 06:45:00,1.48,1.02,1.29,217,248,175,16,11,5,12,7,5,4,2,2,+4,+2,+2,67%,67%,67%,152,182,111,40%,32%,60%,4,2,2,0,0,0
222,https://vlr.gg/player/3977/crws,2024-10-26 06:45:00,0.87,1.43,1.11,220,189,262,16,8,8,12,7,5,9,4,5,+2,+1,+1,76%,67%,89%,141,122,167,41%,30%,53%,2,1,1,0,0,0
223,https://vlr.gg/player/25255/primmie,2024-10-26 06:45:00,0.81,1.17,0.96,215,187,254,17,8,9,16,9,7,0,0,0,-2,-2,0,76%,67%,89%,144,129,164,41%,35%,50%,2,1,1,4,3,1
224,https://vlr.gg/player/5129/ban,2024-10-26 06:45:00,0.42,0.89,0.62,140,142,139,11,6,5,14,9,5,2,1,1,0,-1,+1,67%,58%,78%,91,84,101,17%,20%,15%,2,1,1,2,2,0
225,https://vlr.gg/player/19530/aaaay,2024-10-26 06:45:00,1.09,1.08,1.09,225,217,231,18,8,10,15,6,9,2,0,2,-3,-3,0,76%,56%,92%,136,130,140,56%,46%,64%,1,0,1,4,3,1
226,https://vlr.gg/player/7857/berlin,2024-10-26 06:45:00,0.90,0.94,0.92,172,181,166,12,5,7,16,7,9,6,2,4,-2,0,-2,57%,56%,58%,153,144,160,26%,20%,32%,0,0,0,2,0,2
227,https://vlr.gg/player/3028/life,2024-10-26 06:45:00,0.72,1.06,0.91,161,116,195,12,3,9,14,6,8,3,2,1,-2,-1,-1,62%,44%,75%,113,96,125,39%,21%,57%,2,1,1,4,2,2
228,https://vlr.gg/player/4763/zixuan,2024-10-26 06:45:00,0.50,0.96,0.77,175,175,176,12,5,7,16,8,8,5,1,4,-1,-1,0,57%,56%,58%,133,142,127,19%,28%,13%,1,0,1,2,1,1
229,https://vlr.gg/player/872/autumn,2024-10-26 06:45:00,0.51,0.54,0.53,144,140,148,10,5,5,16,7,9,2,0,2,+1,0,+1,67%,67%,67%,102,97,105,26%,40%,20%,3,1,2,2,1,1
230,https://vlr.gg/player/13221/azys,2024-10-26 06:30:00,1.56,1.69,1.65,343,342,345,43,13,30,23,7,16,8,1,7,+7,+3,+4,80%,82%,79%,210,203,213,24%,27%,22%,10,4,6,3,1,2
231,https://vlr.gg/player/3628/deathmaker,2024-10-26 06:30:00,1.68,1.54,1.58,262,253,263,36,12,24,18,4,14,7,0,7,+3,+1,+2,89%,91%,88%,172,154,181,36%,43%,33%,4,1,3,1,0,1
232,https://vlr.gg/player/12947/rawfiul,2024-10-26 06:30:00,0.84,1.34,1.18,242,211,257,31,8,23,21,8,13,9,4,5,+2,0,+2,83%,73%,88%,168,152,175,39%,32%,43%,6,1,5,4,1,3
233,https://vlr.gg/player/3269/antidote,2024-10-26 06:30:00,0.94,1.11,1.05,172,115,198,21,5,16,18,5,13,17,4,13,+1,0,+1,80%,73%,83%,116,67,138,26%,31%,25%,2,1,1,1,1,0
234,https://vlr.gg/player/18704/levi,2024-10-26 06:30:00,1.25,0.73,0.89,152,173,143,19,8,11,20,5,15,8,5,3,0,+1,-1,63%,91%,50%,113,125,107,33%,32%,34%,2,1,1,2,0,2
235,https://vlr.gg/player/44919/aplycs,2024-10-26 06:30:00,0.98,1.46,1.13,239,205,310,28,17,11,29,20,9,6,4,2,+1,+1,0,66%,67%,64%,158,138,201,26%,22%,33%,1,1,0,0,0,0
236,https://vlr.gg/player/48426/ghostxd,2024-10-26 06:30:00,0.82,0.55,0.74,160,166,147,20,15,5,28,19,9,4,2,2,-1,0,-1,63%,63%,64%,109,114,96,45%,52%,35%,1,0,1,2,0,2
237,https://vlr.gg/player/18702/deadly10,2024-10-26 06:30:00,0.86,0.22,0.65,176,225,73,18,17,1,30,21,9,10,9,1,-6,-3,-3,54%,58%,45%,121,147,64,29%,32%,14%,6,6,0,12,9,3
238,https://vlr.gg/player/8156/mojo,2024-10-26 06:30:00,0.59,0.63,0.60,148,148,142,17,12,5,30,21,9,9,8,1,-4,-4,0,57%,63%,45%,90,80,110,24%,27%,19%,1,0,1,5,4,1
239,https://vlr.gg/player/3271/excali,2024-10-26 06:30:00,0.45,0.74,0.54,146,132,179,17,10,7,33,23,10,11,8,3,-3,-2,-1,60%,58%,64%,89,84,99,25%,33%,16%,2,1,1,5,3,2
240,https://vlr.gg/player/14125/spring,2024-10-26 06:00:00,,,,268,,,77,,,58,,,26,,,,,,,,,,,,,,,,,,,,
241,https://vlr.gg/player/37489/lysoar,2024-10-26 06:00:00,,,,262,,,71,,,56,,,17,,,,,,,,,,,,,,,,,,,,
242,https://vlr.gg/player/11218/yuicaw,2024-10-26 06:00:00,,,,221,,,67,,,45,,,53,,,,,,,,,,,,,,,,,,,,
243,https://vlr.gg/player/45104/v1ya,2024-10-26 06:00:00,,,,201,,,51,,,57,,,42,,,,,,,,,,,,,,,,,,,,
244,https://vlr.gg/player/7849/siufatbb,2024-10-26 06:00:00,,,,176,,,52,,,49,,,23,,,,,,,,,,,,,,,,,,,,
245,https://vlr.gg/player/37927/happywei,2024-10-26 06:00:00,,,,226,,,71,,,58,,,21,,,,,,,,,,,,,,,,,,,,
246,https://vlr.gg/player/36668/mart1n,2024-10-26 06:00:00,,,,209,,,53,,,68,,,27,,,,,,,,,,,,,,,,,,,,
247,https://vlr.gg/player/4710/you,2024-10-26 06:00:00,,,,196,,,57,,,59,,,22,,,,,,,,,,,,,,,,,,,,
248,https://vlr.gg/player/22047/rarga,2024-10-26 06:00:00,,,,179,,,48,,,71,,,14,,,,,,,,,,,,,,,,,,,,
249,https://vlr.gg/player/37674/mrcani,2024-10-26 06:00:00,,,,140,,,36,,,62,,,36,,,,,,,,,,,,,,,,,,,,
250,https://vlr.gg/player/41207/jade,2024-10-26 06:00:00,0.81,1.19,1.00,214,192,227,60,29,31,65,36,29,38,13,25,-4,-1,-3,63%,56%,70%,138,128,147,33%,36%,31%,2,1,1,6,2,4
251,https://vlr.gg/player/37969/ellie,2024-10-26 06:00:00,0.75,1.25,1.00,203,179,220,60,26,34,60,38,22,14,9,5,+1,-6,+7,67%,60%,74%,130,117,143,30%,22%,40%,16,5,11,15,11,4
252,https://vlr.gg/player/19373/ginger,2024-10-26 06:00:00,0.85,1.04,0.94,202,205,208,64,29,35,67,38,29,20,13,7,+4,+1,+3,66%,65%,67%,137,146,127,23%,25%,21%,9,4,5,5,3,2
253,https://vlr.gg/player/30042/harmonee,2024-10-26 06:00:00,0.69,1.10,0.90,169,141,203,56,24,32,60,34,26,16,4,12,-3,-3,0,60%,56%,65%,116,90,143,23%,25%,22%,7,2,5,10,5,5
254,https://vlr.gg/player/17318/blossi,2024-10-26 06:00:00,0.78,0.90,0.84,166,171,170,47,23,24,63,35,28,38,23,15,-4,-4,0,66%,63%,70%,110,108,111,34%,39%,29%,6,3,3,10,7,3
255,https://vlr.gg/player/38025/addi,2024-10-26 06:00:00,1.00,1.61,1.31,281,247,312,83,33,50,59,36,23,27,13,14,+11,+3,+8,78%,70%,86%,177,158,195,28%,29%,28%,15,5,10,4,2,2
256,https://vlr.gg/player/30240/noze,2024-10-26 06:00:00,1.10,1.40,1.25,211,197,243,65,29,36,51,28,23,19,7,12,-1,-1,0,70%,65%,74%,153,132,174,21%,19%,22%,5,3,2,6,4,2
257,https://vlr.gg/player/21163/ninzakar,2024-10-26 06:00:00,1.06,0.92,0.99,184,185,178,58,31,27,55,28,27,27,14,13,-1,-2,+1,73%,70%,77%,125,132,119,29%,32%,26%,7,2,5,8,4,4
258,https://vlr.gg/player/38116/xanti,2024-10-26 06:00:00,0.92,1.02,0.97,168,151,179,53,24,29,56,27,29,30,10,20,-3,-2,-1,69%,63%,74%,102,95,110,31%,29%,32%,6,3,3,9,5,4
259,https://vlr.gg/player/43884/mali,2024-10-26 06:00:00,0.45,1.22,0.84,194,128,264,56,17,39,66,37,29,18,9,9,0,-5,+5,71%,53%,88%,127,82,172,24%,17%,29%,13,5,8,13,10,3
260,https://vlr.gg/player/25081/yoman,2024-10-26 05:45:00,0.94,2.05,1.49,300,180,421,26,7,19,17,11,6,3,2,1,+4,+1,+3,67%,42%,92%,190,134,247,24%,58%,17%,4,1,3,0,0,0
261,https://vlr.gg/player/34974/karon,2024-10-26 05:45:00,0.70,1.53,1.11,171,141,202,16,5,11,15,10,5,8,1,7,-2,-3,+1,71%,50%,92%,115,94,136,33%,28%,38%,1,0,1,3,3,0
262,https://vlr.gg/player/2489/munchkin,2024-10-26 05:45:00,1.20,0.70,0.95,224,234,216,18,10,8,19,9,10,7,2,5,-2,+1,-3,63%,67%,58%,149,141,157,26%,27%,26%,1,1,0,3,0,3
263,https://vlr.gg/player/11600/foxy9,2024-10-26 05:45:00,0.47,0.42,0.45,131,136,126,9,5,4,21,11,10,5,0,5,0,0,0,58%,50%,67%,95,105,86,23%,35%,15%,2,0,2,2,0,2
264,https://vlr.gg/player/9196/t3xture,2024-10-26 05:45:00,0.02,0.75,0.31,129,58,201,10,1,9,22,12,10,3,2,1,-8,-7,-1,38%,17%,58%,86,46,126,24%,22%,25%,0,0,0,8,7,1
265,https://vlr.gg/player/1916/free1ng,2024-10-26 05:45:00,1.39,1.15,1.27,253,274,233,22,12,10,16,8,8,9,3,6,0,0,0,83%,83%,83%,171,183,158,30%,39%,24%,2,1,1,2,1,1
266,https://vlr.gg/player/34982/athan,2024-10-26 05:45:00,0.69,1.79,1.24,217,164,270,18,6,12,15,11,4,11,8,3,-1,-2,+1,75%,67%,83%,157,112,201,21%,21%,20%,2,0,2,3,2,1
267,https://vlr.gg/player/28400/hyunmin,2024-10-26 05:45:00,1.08,1.35,1.22,277,261,295,22,10,12,18,11,7,6,3,3,+7,+2,+5,88%,83%,92%,173,155,191,28%,45%,19%,8,3,5,1,1,0
268,https://vlr.gg/player/4462/mako,2024-10-26 05:45:00,0.54,1.43,0.98,179,150,209,16,6,10,14,10,4,9,2,7,0,-2,+2,75%,58%,92%,107,96,117,19%,18%,20%,2,0,2,2,2,0
269,https://vlr.gg/player/35013/flashback,2024-10-26 05:45:00,0.88,1.06,0.97,161,155,168,16,7,9,16,11,5,3,2,1,+2,+2,0,67%,67%,67%,109,107,111,30%,29%,31%,2,2,0,0,0,0
270,https://vlr.gg/player/2489/munchkin,2024-10-26 04:35:00,1.33,1.55,1.46,277,257,292,22,9,13,12,5,7,4,1,3,+2,+1,+1,81%,67%,92%,175,166,182,25%,33%,21%,4,3,1,2,2,0
271,https://vlr.gg/player/9196/t3xture,2024-10-26 04:35:00,0.76,1.62,1.25,219,153,268,19,5,14,13,7,6,0,0,0,0,0,0,81%,78%,83%,151,91,197,25%,11%,33%,2,1,1,2,1,1
272,https://vlr.gg/player/34974/karon,2024-10-26 04:35:00,1.24,0.98,1.10,170,183,161,12,5,7,12,5,7,9,6,3,+1,0,+1,81%,78%,83%,130,134,127,29%,25%,33%,1,0,1,0,0,0
273,https://vlr.gg/player/11600/foxy9,2024-10-26 04:35:00,0.81,1.16,1.01,231,172,276,16,5,11,16,7,9,6,2,4,+4,-1,+5,86%,89%,83%,148,123,166,41%,29%,48%,5,0,5,1,1,0
274,https://vlr.gg/player/25081/yoman,2024-10-26 04:35:00,0.96,1.00,0.98,187,232,154,15,8,7,13,7,6,7,2,5,0,+1,-1,71%,67%,75%,114,146,90,31%,35%,26%,2,1,1,2,0,2
275,https://vlr.gg/player/25255/primmie,2024-10-26 04:35:00,0.85,1.35,1.07,235,206,276,17,8,9,18,11,7,6,4,2,+1,+1,0,67%,67%,67%,141,111,181,60%,50%,71%,2,1,1,1,0,1
276,https://vlr.gg/player/3980/governor,2024-10-26 04:35:00,0.71,0.96,0.82,186,184,189,13,7,6,16,10,6,4,2,2,-2,-4,+2,62%,50%,78%,118,119,118,28%,23%,36%,5,2,3,7,6,1
277,https://vlr.gg/player/3977/crws,2024-10-26 04:35:00,1.04,0.43,0.78,168,233,82,12,10,2,15,9,6,4,1,3,-1,0,-1,67%,67%,67%,108,145,59,18%,22%,9%,0,0,0,1,0,1
278,https://vlr.gg/player/13788/jitboys,2024-10-26 04:35:00,0.41,1.08,0.70,160,130,202,13,6,7,18,12,6,2,1,1,-3,-2,-1,57%,50%,67%,106,79,143,57%,67%,50%,0,0,0,3,2,1
279,https://vlr.gg/player/5129/ban,2024-10-26 04:35:00,0.45,0.85,0.63,138,105,183,11,4,7,17,10,7,3,2,1,-2,-1,-1,71%,58%,89%,105,84,133,33%,22%,47%,0,0,0,2,1,1
280,https://vlr.gg/player/28400/hyunmin,2024-10-26 03:30:00,1.14,1.46,1.32,286,274,295,21,8,13,17,8,9,4,2,2,+2,+1,+1,81%,100%,67%,173,164,179,31%,40%,26%,6,3,3,4,2,2
281,https://vlr.gg/player/34982/athan,2024-10-26 03:30:00,0.80,1.36,1.12,187,118,239,15,4,11,14,6,8,10,4,6,-1,-1,0,76%,78%,75%,122,76,157,27%,7%,41%,0,0,0,1,1,0
282,https://vlr.gg/player/4462/mako,2024-10-26 03:30:00,0.56,0.94,0.78,180,124,223,12,4,8,17,7,10,10,4,6,0,0,0,76%,89%,67%,115,62,155,33%,38%,32%,2,1,1,2,1,1
283,https://vlr.gg/player/35013/flashback,2024-10-26 03:30:00,0.81,0.65,0.72,172,208,147,11,6,5,17,8,9,7,4,3,0,0,0,71%,67%,75%,140,174,115,23%,19%,28%,0,0,0,0,0,0
284,https://vlr.gg/player/1916/free1ng,2024-10-26 03:30:00,0.56,0.77,0.68,144,129,157,12,5,7,16,7,9,6,2,4,-4,-1,-3,67%,67%,67%,93,83,101,33%,56%,25%,1,0,1,5,1,4
285,https://vlr.gg/player/13788/jitboys,2024-10-26 03:30:00,1.18,1.88,1.48,214,191,245,18,9,9,11,7,4,7,4,3,0,-1,+1,86%,83%,89%,135,120,156,42%,32%,57%,1,0,1,1,1,0
286,https://vlr.gg/player/3980/governor,2024-10-26 03:30:00,0.98,1.46,1.19,221,198,253,15,8,7,14,9,5,7,2,5,+4,+3,+1,76%,67%,89%,147,128,172,38%,45%,26%,4,3,1,0,0,0
287,https://vlr.gg/player/3977/crws,2024-10-26 03:30:00,1.24,1.03,1.15,258,246,275,19,10,9,15,8,7,6,5,1,-3,-2,-1,76%,75%,78%,177,189,161,40%,37%,44%,1,0,1,4,2,2
288,https://vlr.gg/player/5129/ban,2024-10-26 03:30:00,0.89,1.03,0.95,211,230,187,16,10,6,15,10,5,5,2,3,+2,+2,0,71%,67%,78%,134,143,123,27%,24%,31%,3,3,0,1,1,0
289,https://vlr.gg/player/25255/primmie,2024-10-26 03:30:00,0.72,0.75,0.73,167,188,142,13,8,5,16,10,6,1,1,0,0,0,0,67%,58%,78%,107,125,83,34%,53%,17%,3,1,2,3,1,2
290,https://vlr.gg/player/34982/athan,2024-10-26 02:20:00,1.02,1.46,1.24,227,166,289,21,7,14,16,9,7,17,9,8,0,0,0,77%,62%,92%,154,101,206,29%,25%,31%,0,0,0,0,0,0
291,https://vlr.gg/player/1916/free1ng,2024-10-26 02:20:00,0.72,1.72,1.22,197,138,257,18,5,13,14,10,4,2,0,2,0,-2,+2,77%,54%,100%,140,97,184,30%,22%,35%,3,1,2,3,3,0
292,https://vlr.gg/player/4462/mako,2024-10-26 02:20:00,1.06,1.23,1.14,227,232,222,19,9,10,17,11,6,14,6,8,-3,-3,0,69%,54%,85%,140,142,138,28%,32%,25%,3,1,2,6,4,2
293,https://vlr.gg/player/28400/hyunmin,2024-10-26 02:20:00,0.40,1.17,0.79,185,145,226,18,6,12,21,12,9,1,0,1,+1,-1,+2,58%,31%,85%,116,91,140,56%,73%,48%,4,1,3,3,2,1
294,https://vlr.gg/player/35013/flashback,2024-10-26 02:20:00,0.54,0.82,0.68,133,104,163,12,5,7,20,11,9,5,2,3,-4,-1,-3,62%,46%,77%,90,63,117,40%,45%,37%,0,0,0,4,1,3
295,https://vlr.gg/player/19530/aaaay,2024-10-26 02:20:00,0.66,1.82,1.24,211,151,272,19,6,13,16,12,4,16,6,10,+3,+1,+2,85%,77%,92%,134,86,183,54%,50%,57%,3,1,2,0,0,0
296,https://vlr.gg/player/3028/life,2024-10-26 02:20:00,0.87,1.54,1.21,289,216,363,27,10,17,20,11,9,3,1,2,+3,0,+3,73%,54%,92%,172,145,199,34%,42%,27%,7,4,3,4,4,0
297,https://vlr.gg/player/4763/zixuan,2024-10-26 02:20:00,1.20,1.04,1.12,207,245,170,18,11,7,17,10,7,14,5,9,+2,+1,+1,88%,85%,92%,147,173,121,34%,24%,55%,4,1,3,2,0,2
298,https://vlr.gg/player/7857/berlin,2024-10-26 02:20:00,0.14,1.30,0.72,139,60,218,12,2,10,18,12,6,7,2,5,+1,-1,+2,58%,38%,77%,98,44,151,14%,25%,12%,2,0,2,1,1,0
299,https://vlr.gg/player/872/autumn,2024-10-26 02:20:00,0.64,0.78,0.71,128,140,116,12,6,6,17,11,6,5,2,3,-3,-2,-1,69%,69%,69%,93,97,88,25%,21%,29%,0,0,0,3,2,1
300,https://vlr.gg/player/23930/potter,2024-10-26 02:00:00,1.23,1.40,1.33,259,285,242,42,20,22,25,13,12,4,1,3,+2,-1,+3,71%,67%,75%,152,167,140,29%,21%,46%,8,3,5,6,4,2
301,https://vlr.gg/player/2368/b3ta,2024-10-26 02:00:00,1.02,1.52,1.31,222,170,258,33,11,22,25,12,13,24,10,14,+1,0,+1,79%,67%,88%,137,95,169,35%,26%,40%,5,2,3,4,2,2
302,https://vlr.gg/player/1908/kongared,2024-10-26 02:00:00,1.14,1.21,1.18,225,201,243,34,12,22,29,14,15,19,10,9,+1,+1,0,74%,67%,79%,146,133,156,37%,40%,35%,2,1,1,1,0,1
303,https://vlr.gg/player/2366/alert,2024-10-26 02:00:00,0.55,1.45,1.09,216,141,268,14,3,11,14,7,7,8,2,6,+1,0,+1,80%,75%,83%,147,100,179,20%,12%,25%,2,0,2,1,0,1
304,https://vlr.gg/player/12289/siraww,2024-10-26 02:00:00,0.94,1.05,1.00,198,173,217,28,11,17,29,13,16,14,3,11,+3,-1,+4,81%,78%,83%,137,120,150,31%,40%,26%,6,1,5,3,2,1
305,https://vlr.gg/player/10791/bnwgiggs,2024-10-26 02:00:00,0.92,0.78,0.84,177,158,195,12,5,7,16,6,10,12,3,9,+2,+1,+1,73%,60%,83%,120,101,135,28%,58%,16%,3,2,1,1,1,0
306,https://vlr.gg/player/3342/sushiboys,2024-10-26 02:00:00,1.07,1.15,1.11,196,188,214,29,16,13,30,17,13,16,3,13,-2,-3,+1,69%,58%,83%,140,134,149,32%,30%,35%,2,0,2,4,3,1
307,https://vlr.gg/player/2388/theelovefamily,2024-10-26 02:00:00,0.76,1.01,0.87,157,147,171,23,12,11,29,18,11,13,6,7,-2,-2,0,62%,63%,61%,108,101,117,27%,26%,28%,1,0,1,3,2,1
308,https://vlr.gg/player/4377/johnolsen,2024-10-26 02:00:00,0.65,1.14,0.86,244,236,243,35,18,17,37,25,12,6,4,2,-2,-1,-1,69%,63%,78%,165,165,164,30%,33%,27%,5,3,2,7,4,3
309,https://vlr.gg/player/4378/lammysnax,2024-10-26 02:00:00,0.71,0.98,0.82,173,147,205,26,13,13,32,19,13,11,4,7,+1,0,+1,67%,71%,61%,117,102,138,33%,52%,22%,4,2,2,3,2,1
310,https://vlr.gg/player/27254/leviathan,2024-10-26 02:00:00,0.59,0.90,0.73,182,169,204,25,14,11,35,22,13,11,4,7,-5,-4,-1,64%,58%,72%,124,103,152,21%,28%,16%,4,2,2,9,6,3
311,https://vlr.gg/player/2489/munchkin,2024-10-26 01:00:00,1.52,1.51,1.52,316,307,331,23,13,10,15,9,6,16,11,5,0,-1,+1,85%,83%,88%,179,185,171,22%,21%,23%,1,0,1,1,1,0
312,https://vlr.gg/player/25081/yoman,2024-10-26 01:00:00,1.35,0.95,1.19,173,165,186,14,9,5,10,5,5,6,4,2,+1,0,+1,85%,92%,75%,113,108,122,24%,40%,13%,1,0,1,0,0,0
313,https://vlr.gg/player/11600/foxy9,2024-10-26 01:00:00,0.77,1.35,1.01,242,226,266,19,10,9,17,11,6,4,3,1,0,+1,-1,75%,67%,88%,156,143,176,39%,30%,53%,2,2,0,2,1,1
314,https://vlr.gg/player/9196/t3xture,2024-10-26 01:00:00,0.61,1.49,0.96,243,194,319,18,8,10,16,11,5,3,2,1,+3,+3,0,65%,58%,75%,153,128,191,20%,23%,16%,5,4,1,2,1,1
315,https://vlr.gg/player/34974/karon,2024-10-26 01:00:00,0.89,0.60,0.78,166,201,115,10,8,2,13,8,5,11,5,6,0,+1,-1,85%,92%,75%,102,117,79,22%,32%,11%,3,2,1,3,1,2
316,https://vlr.gg/player/3028/life,2024-10-26 01:00:00,0.92,1.95,1.54,334,240,397,23,7,16,18,8,10,6,1,5,+1,-1,+2,90%,75%,100%,226,147,279,44%,47%,43%,3,1,2,2,2,0
317,https://vlr.gg/player/872/autumn,2024-10-26 01:00:00,1.09,1.27,1.20,202,162,229,15,5,10,14,5,9,3,1,2,-2,-1,-1,65%,63%,67%,160,142,171,28%,25%,31%,0,0,0,2,1,1
318,https://vlr.gg/player/4763/zixuan,2024-10-26 01:00:00,1.28,0.34,0.71,158,262,90,10,6,4,17,7,10,12,8,4,-1,0,-1,60%,75%,50%,98,165,54,21%,26%,13%,1,0,1,2,0,2
319,https://vlr.gg/player/19530/aaaay,2024-10-26 01:00:00,0.56,0.76,0.68,192,177,203,13,5,8,18,8,10,9,4,5,-1,0,-1,70%,63%,75%,117,98,130,24%,8%,40%,2,1,1,3,1,2
320,https://vlr.gg/player/7857/berlin,2024-10-26 01:00:00,0.55,0.67,0.62,156,174,145,10,4,6,17,8,9,7,3,4,-1,+2,-3,75%,75%,75%,109,111,108,11%,0%,25%,2,2,0,3,0,3
321,https://vlr.gg/player/14310/annja,2024-10-25 13:00:00,1.39,0.68,1.09,237,304,145,53,41,12,48,25,23,12,8,4,-2,+1,-3,67%,78%,52%,148,188,95,37%,38%,33%,7,5,2,9,4,5
322,https://vlr.gg/player/38142/dream,2024-10-25 13:00:00,1.30,0.76,1.07,208,234,175,48,32,16,46,23,23,29,15,14,-5,-1,-4,75%,83%,63%,133,156,102,28%,28%,29%,2,2,0,7,3,4
323,https://vlr.gg/player/31272/els,2024-10-25 13:00:00,0.89,1.05,0.96,191,179,212,44,25,19,47,25,22,14,7,7,-1,+1,-2,62%,67%,56%,138,125,156,27%,26%,28%,3,2,1,4,1,3
324,https://vlr.gg/player/38011/misa,2024-10-25 13:00:00,1.07,0.77,0.94,187,211,158,40,26,14,46,23,23,14,9,5,+3,+2,+1,75%,86%,59%,129,146,108,22%,23%,20%,7,4,3,4,2,2
325,https://vlr.gg/player/20116/jademwah,2024-10-25 13:00:00,0.88,0.86,0.87,207,195,211,44,25,19,49,25,24,23,16,7,-6,-1,-5,68%,72%,63%,124,118,132,18%,17%,20%,7,6,1,13,7,6
326,https://vlr.gg/player/16321/nelo,2024-10-25 13:00:00,1.50,1.16,1.31,257,260,259,61,28,33,44,13,31,13,4,9,+5,+5,0,76%,78%,75%,172,175,169,31%,32%,30%,8,5,3,3,0,3
327,https://vlr.gg/player/30076/ritsu,2024-10-25 13:00:00,1.81,0.78,1.22,242,347,160,53,34,19,42,13,29,20,10,10,+4,+4,0,70%,81%,61%,162,229,112,28%,32%,24%,6,5,1,2,1,1
328,https://vlr.gg/player/26738/riri,2024-10-25 13:00:00,1.14,0.82,0.96,169,182,157,42,20,22,41,14,27,15,11,4,-2,0,-2,78%,89%,69%,107,107,107,33%,22%,47%,4,2,2,6,2,4
329,https://vlr.gg/player/37954/bellatr1x,2024-10-25 13:00:00,0.65,0.91,0.80,181,151,206,39,14,25,50,20,30,22,11,11,-1,+1,-2,70%,74%,67%,119,105,129,39%,29%,47%,8,3,5,9,2,7
330,https://vlr.gg/player/41196/ja2,2024-10-25 13:00:00,0.75,0.80,0.78,189,192,194,40,19,21,52,20,32,10,1,9,+5,+3,+2,60%,63%,58%,125,121,129,38%,38%,37%,11,5,6,6,2,4
331,https://vlr.gg/player/40910/consz,2024-10-25 10:15:00,1.14,1.89,1.57,297,274,331,46,16,30,25,14,11,13,5,8,+2,-2,+4,85%,76%,91%,200,173,221,40%,39%,41%,8,2,6,6,4,2
332,https://vlr.gg/player/44930/nex1sphix,2024-10-25 10:15:00,1.11,1.57,1.38,235,167,286,34,11,23,22,9,13,18,6,12,+1,+1,0,88%,82%,91%,160,113,195,34%,33%,35%,1,1,0,0,0,0
333,https://vlr.gg/player/40907/mnfear,2024-10-25 10:15:00,1.22,1.39,1.32,244,217,251,35,14,21,21,9,12,14,5,9,+7,+2,+5,90%,82%,96%,175,152,192,36%,42%,31%,7,2,5,0,0,0
334,https://vlr.gg/player/44770/cxix666,2024-10-25 10:15:00,1.07,1.10,1.09,207,204,200,29,12,17,22,11,11,8,4,4,+3,+1,+2,83%,88%,78%,142,153,135,26%,34%,21%,6,2,4,3,1,2
335,https://vlr.gg/player/40908/skyisblue,2024-10-25 10:15:00,1.21,0.83,0.99,227,296,167,31,18,13,29,13,16,14,5,9,-1,+1,-2,75%,76%,74%,164,193,143,22%,36%,15%,4,3,1,5,2,3
336,https://vlr.gg/player/7802/flynch,2024-10-25 10:15:00,1.19,1.09,1.15,203,213,169,31,20,11,30,18,12,9,1,8,0,0,0,75%,70%,82%,135,142,126,41%,46%,34%,1,1,0,1,1,0
337,https://vlr.gg/player/7047/vascalizz,2024-10-25 10:15:00,0.88,1.43,1.12,217,194,263,31,16,15,33,21,12,11,4,7,+2,+1,+1,63%,57%,71%,145,112,188,19%,13%,24%,4,2,2,2,1,1
338,https://vlr.gg/player/7046/no1syboy,2024-10-25 10:15:00,0.74,0.68,0.71,157,152,177,22,12,10,35,20,15,7,4,3,-1,0,-1,60%,52%,71%,118,109,131,19%,19%,19%,4,2,2,5,2,3
339,https://vlr.gg/player/7783/zhar,2024-10-25 10:15:00,0.22,0.75,0.45,156,122,204,19,8,11,39,23,16,14,8,6,-6,-6,0,63%,57%,71%,94,72,124,24%,31%,20%,2,1,1,8,7,1
340,https://vlr.gg/player/4867/onigiri,2024-10-25 10:15:00,0.38,0.52,0.44,124,120,155,16,7,9,38,22,16,10,9,1,-7,-4,-3,53%,61%,41%,97,92,104,34%,27%,41%,3,1,2,10,5,5
341,https://vlr.gg/player/22047/rarga,2024-10-25 09:10:00,,,,323,,,52,,,38,,,9,,,,,,,,,,,,,,,,,,,,
342,https://vlr.gg/player/37927/happywei,2024-10-25 09:10:00,,,,216,,,34,,,32,,,14,,,,,,,,,,,,,,,,,,,,
343,https://vlr.gg/player/4710/you,2024-10-25 09:10:00,,,,204,,,35,,,30,,,9,,,,,,,,,,,,,,,,,,,,
344,https://vlr.gg/player/37674/mrcani,2024-10-25 09:10:00,,,,179,,,28,,,27,,,14,,,,,,,,,,,,,,,,,,,,
345,https://vlr.gg/player/36668/mart1n,2024-10-25 09:10:00,,,,162,,,24,,,27,,,17,,,,,,,,,,,,,,,,,,,,
346,https://vlr.gg/player/25949/bunt,2024-10-25 09:10:00,,,,232,,,36,,,33,,,14,,,,,,,,,,,,,,,,,,,,
347,https://vlr.gg/player/46748/k1ra,2024-10-25 09:10:00,,,,214,,,36,,,33,,,7,,,,,,,,,,,,,,,,,,,,
348,https://vlr.gg/player/4881/spitfires,2024-10-25 09:10:00,,,,198,,,31,,,37,,,9,,,,,,,,,,,,,,,,,,,,
349,https://vlr.gg/player/10821/delb,2024-10-25 09:10:00,,,,159,,,28,,,36,,,13,,,,,,,,,,,,,,,,,,,,
350,https://vlr.gg/player/37019/x3b,2024-10-25 09:10:00,,,,156,,,23,,,34,,,13,,,,,,,,,,,,,,,,,,,,
351,https://vlr.gg/player/46121/marcai,2024-10-25 09:00:00,1.21,1.24,1.23,265,293,236,51,27,24,40,23,17,9,3,6,-2,-2,0,81%,78%,85%,169,188,150,27%,35%,17%,6,3,3,8,5,3
352,https://vlr.gg/player/1770/wat,2024-10-25 09:00:00,0.91,1.22,1.06,220,199,240,46,20,26,37,20,17,21,11,10,-1,-1,0,74%,70%,78%,143,133,152,36%,41%,32%,4,2,2,5,3,2
353,https://vlr.gg/player/3502/ri0,2024-10-25 09:00:00,1.07,0.70,0.89,181,189,175,33,18,15,36,16,20,16,11,5,+6,0,+6,78%,85%,70%,119,124,113,27%,20%,40%,8,1,7,2,1,1
354,https://vlr.gg/player/12323/rvk,2024-10-25 09:00:00,1.09,0.66,0.87,176,220,130,32,22,10,37,19,18,18,5,13,-2,-1,-1,69%,59%,78%,110,138,82,30%,35%,25%,6,4,2,8,5,3
355,https://vlr.gg/player/40057/batman,2024-10-25 09:00:00,0.67,1.01,0.84,164,131,197,32,13,19,38,21,17,15,5,10,-1,+1,-2,72%,70%,74%,102,86,117,38%,41%,37%,3,2,1,4,1,3
356,https://vlr.gg/player/44919/aplycs,2024-10-25 09:00:00,1.35,1.07,1.21,204,233,177,41,24,17,34,16,18,12,2,10,+3,+1,+2,76%,74%,78%,140,156,123,25%,25%,25%,4,2,2,1,1,0
357,https://vlr.gg/player/18702/deadly10,2024-10-25 09:00:00,0.93,1.35,1.14,262,216,311,44,18,26,45,24,21,14,7,7,+4,-1,+5,61%,59%,63%,173,147,199,29%,25%,32%,13,5,8,9,6,3
358,https://vlr.gg/player/48426/ghostxd,2024-10-25 09:00:00,0.94,1.31,1.12,204,171,234,37,14,23,37,19,18,26,12,14,+1,+1,0,74%,70%,78%,138,127,148,31%,36%,28%,3,1,2,2,0,2
359,https://vlr.gg/player/3271/excali,2024-10-25 09:00:00,1.19,0.87,1.03,189,176,203,37,17,20,37,16,21,29,14,15,-2,-1,-1,69%,70%,67%,123,121,125,30%,19%,44%,5,2,3,7,3,4
360,https://vlr.gg/player/8156/mojo,2024-10-25 09:00:00,0.81,0.61,0.71,160,183,137,28,16,12,42,20,22,17,8,9,-6,-3,-3,63%,63%,63%,112,128,96,22%,22%,23%,2,2,0,8,5,3
361,https://vlr.gg/player/40892/diky,2024-10-25 07:00:00,1.40,0.97,1.18,317,349,276,59,35,24,45,20,25,11,7,4,+7,+5,+2,70%,78%,63%,188,204,171,32%,26%,40%,14,9,5,7,4,3
362,https://vlr.gg/player/40890/cinjvv,2024-10-25 07:00:00,1.02,1.06,1.04,226,230,242,43,21,22,40,19,21,14,6,8,+1,+1,0,67%,70%,63%,153,160,147,29%,31%,28%,3,2,1,2,1,1
363,https://vlr.gg/player/40903/rina,2024-10-25 07:00:00,1.06,0.66,0.86,159,178,149,33,20,13,39,17,22,10,4,6,-2,0,-2,67%,67%,67%,119,134,103,27%,31%,22%,2,1,1,4,1,3
364,https://vlr.gg/player/47596/hyper,2024-10-25 07:00:00,1.08,0.59,0.83,151,173,127,27,17,10,35,15,20,14,7,7,-1,+1,-2,59%,70%,48%,101,116,86,27%,20%,39%,2,2,0,3,1,2
365,https://vlr.gg/player/40895/anotherrr,2024-10-25 07:00:00,0.71,0.71,0.71,178,178,172,32,16,16,44,22,22,13,10,3,+3,0,+3,65%,63%,67%,114,116,112,43%,42%,44%,10,3,7,7,3,4
366,https://vlr.gg/player/13119/artaa,2024-10-25 07:00:00,1.58,0.87,1.23,203,244,167,38,23,15,35,14,21,25,16,9,+1,+2,-1,72%,78%,67%,133,159,108,27%,31%,21%,3,2,1,2,0,2
367,https://vlr.gg/player/37028/goldenblue,2024-10-25 07:00:00,1.03,1.23,1.13,237,217,254,46,22,24,40,19,21,7,1,6,-3,-3,0,63%,59%,67%,166,152,180,34%,35%,33%,2,1,1,5,4,1
368,https://vlr.gg/player/27645/amernone,2024-10-25 07:00:00,1.55,0.68,1.12,264,345,180,48,33,15,43,19,24,9,4,5,-3,+4,-7,76%,78%,74%,161,213,109,15%,19%,9%,11,9,2,14,5,9
369,https://vlr.gg/player/11475/vs,2024-10-25 07:00:00,1.19,0.84,1.02,191,192,192,37,19,18,35,14,21,17,7,10,0,0,0,70%,74%,67%,131,133,128,41%,44%,37%,3,1,2,3,1,2
370,https://vlr.gg/player/10833/owen,2024-10-25 07:00:00,0.64,1.09,0.87,177,131,221,32,12,20,41,20,21,18,10,8,-3,-4,+1,67%,67%,67%,114,83,146,25%,23%,26%,4,0,4,7,4,3
371,https://vlr.gg/player/7485/ezzy,2024-10-25 06:30:00,0.78,1.16,0.99,217,225,226,35,16,19,34,17,17,7,3,4,0,+2,-2,67%,74%,63%,143,140,145,39%,38%,40%,6,4,2,6,2,4
372,https://vlr.gg/player/43390/d1sease,2024-10-25 06:30:00,0.92,1.01,0.97,172,131,204,28,11,17,32,11,21,12,3,9,-5,-4,-1,63%,53%,71%,114,85,138,30%,24%,34%,0,0,0,5,4,1
373,https://vlr.gg/player/5536/whimp,2024-10-25 06:30:00,0.87,0.83,0.85,163,138,177,25,10,15,33,13,20,12,7,5,0,0,0,70%,68%,71%,119,101,133,35%,44%,29%,3,1,2,3,1,2
374,https://vlr.gg/player/46104/envy2k,2024-10-25 06:30:00,1.06,0.62,0.82,223,304,156,31,20,11,37,16,21,9,2,7,-1,-1,0,63%,58%,67%,139,182,105,22%,34%,15%,6,2,4,7,3,4
375,https://vlr.gg/player/31355/acestarrrrr,2024-10-25 06:30:00,0.62,0.94,0.79,164,114,202,24,7,17,33,13,20,16,8,8,+1,0,+1,72%,79%,67%,108,79,130,33%,29%,35%,4,1,3,3,1,2
376,https://vlr.gg/player/23931/kata,2024-10-25 06:30:00,0.90,1.83,1.31,271,229,323,43,21,22,29,18,11,5,1,4,+1,-1,+2,74%,67%,84%,170,153,191,45%,48%,42%,9,5,4,8,6,2
377,https://vlr.gg/player/4089/doxz3r,2024-10-25 06:30:00,1.52,1.01,1.30,252,309,181,36,25,11,26,14,12,13,8,5,+2,0,+2,77%,88%,63%,174,217,121,35%,36%,33%,3,0,3,1,0,1
378,https://vlr.gg/player/14208/kishi,2024-10-25 06:30:00,1.43,1.03,1.26,216,226,191,35,23,12,25,11,14,15,6,9,+3,+2,+1,72%,71%,74%,130,135,125,31%,38%,24%,3,2,1,0,0,0
379,https://vlr.gg/player/30286/karam1l,2024-10-25 06:30:00,1.01,0.82,0.93,229,231,231,34,20,14,34,18,16,4,2,2,+2,+2,0,65%,71%,58%,143,147,140,43%,48%,38%,6,4,2,4,2,2
380,https://vlr.gg/player/41834/panda,2024-10-25 06:30:00,0.63,0.96,0.78,142,135,153,21,10,11,29,18,11,21,16,5,-3,-1,-2,74%,75%,74%,101,93,110,27%,13%,48%,3,2,1,6,3,3
381,https://vlr.gg/player/14125/spring,2024-10-25 06:00:00,,,,248,,,50,,,50,,,13,,,,,,,,,,,,,,,,,,,,
382,https://vlr.gg/player/37489/lysoar,2024-10-25 06:00:00,,,,202,,,39,,,44,,,19,,,,,,,,,,,,,,,,,,,,
383,https://vlr.gg/player/11218/yuicaw,2024-10-25 06:00:00,,,,153,,,33,,,50,,,21,,,,,,,,,,,,,,,,,,,,
384,https://vlr.gg/player/7849/siufatbb,2024-10-25 06:00:00,,,,151,,,34,,,41,,,12,,,,,,,,,,,,,,,,,,,,
385,https://vlr.gg/player/45104/v1ya,2024-10-25 06:00:00,,,,143,,,31,,,47,,,19,,,,,,,,,,,,,,,,,,,,
386,https://vlr.gg/player/39697/cb,2024-10-25 06:00:00,,,,304,,,63,,,35,,,24,,,,,,,,,,,,,,,,,,,,
387,https://vlr.gg/player/1209/swerl,2024-10-25 06:00:00,,,,231,,,47,,,39,,,14,,,,,,,,,,,,,,,,,,,,
388,https://vlr.gg/player/41054/guang,2024-10-25 06:00:00,,,,231,,,51,,,43,,,7,,,,,,,,,,,,,,,,,,,,
389,https://vlr.gg/player/46460/ezeir,2024-10-25 06:00:00,,,,174,,,38,,,35,,,27,,,,,,,,,,,,,,,,,,,,
390,https://vlr.gg/player/4402/o0o0o,2024-10-25 06:00:00,,,,159,,,32,,,36,,,36,,,,,,,,,,,,,,,,,,,,
391,https://vlr.gg/player/1770/wat,2024-10-24 09:05:00,1.23,0.94,1.15,237,258,200,30,22,8,29,20,9,8,7,1,-1,0,-1,74%,75%,70%,156,162,141,41%,47%,29%,1,1,0,2,1,1
392,https://vlr.gg/player/40057/batman,2024-10-24 09:05:00,0.93,0.50,0.82,180,194,141,10,8,2,14,10,4,2,1,1,+1,0,+1,44%,33%,75%,118,132,73,43%,50%,20%,2,1,1,1,1,0
393,https://vlr.gg/player/46048/r0meo,2024-10-24 09:05:00,0.73,0.54,0.67,149,163,122,8,6,2,14,9,5,3,2,1,+1,+1,0,50%,50%,50%,101,113,78,25%,25%,25%,2,1,1,1,0,1
394,https://vlr.gg/player/12323/rvk,2024-10-24 09:05:00,0.62,0.61,0.62,160,150,188,17,12,5,31,21,10,15,10,5,-5,-4,-1,62%,58%,70%,101,91,124,30%,26%,35%,2,2,0,7,6,1
395,https://vlr.gg/player/3502/ri0,2024-10-24 09:05:00,0.71,0.22,0.57,139,145,126,15,12,3,28,19,9,6,5,1,-2,+1,-3,65%,71%,50%,99,105,85,31%,37%,20%,1,1,0,3,0,3
396,https://vlr.gg/player/46121/marcai,2024-10-24 09:05:00,0.50,0.33,0.44,142,157,105,15,12,3,30,21,9,5,4,1,-6,-6,0,53%,58%,40%,89,97,69,31%,37%,14%,3,2,1,9,8,1
397,https://vlr.gg/player/30693/makaveli,2024-10-24 09:05:00,1.46,1.60,1.56,287,240,310,37,10,27,17,5,12,9,4,5,+6,0,+6,85%,90%,83%,180,150,193,36%,43%,33%,7,1,6,1,1,0
398,https://vlr.gg/player/3639/hoax,2024-10-24 09:05:00,1.53,1.34,1.40,268,287,261,35,11,24,20,5,15,12,4,8,+4,+1,+3,91%,100%,88%,170,168,170,26%,17%,30%,6,1,5,2,0,2
399,https://vlr.gg/player/3627/hellff,2024-10-24 09:05:00,1.36,1.18,1.23,208,230,195,25,8,17,20,5,15,18,6,12,+1,+2,-1,88%,90%,88%,135,136,135,31%,40%,28%,4,3,1,3,1,2
400,https://vlr.gg/player/27336/venka,2024-10-24 09:05:00,2.00,0.86,1.19,224,334,178,28,13,15,20,4,16,6,4,2,+3,+2,+1,74%,90%,67%,161,244,127,32%,38%,29%,5,2,3,2,0,2
401,https://vlr.gg/player/27775/techno,2024-10-24 09:05:00,0.92,1.19,1.11,172,100,200,21,4,17,18,4,14,11,3,8,-2,-1,-1,76%,80%,75%,121,61,146,28%,18%,30%,1,0,1,3,1,2
402,https://vlr.gg/player/15500/trent,2024-10-24 08:00:00,1.54,0.90,1.26,238,255,215,68,44,24,54,25,29,25,15,10,+1,+1,0,72%,78%,64%,164,182,141,39%,38%,40%,8,5,3,7,4,3
403,https://vlr.gg/player/3885/valyn,2024-10-24 08:00:00,1.05,0.93,0.99,208,214,200,57,33,24,61,34,27,23,14,9,-2,-2,0,74%,80%,67%,141,144,137,21%,18%,25%,7,3,4,9,5,4
404,https://vlr.gg/player/20064/vania,2024-10-24 08:00:00,0.93,0.91,0.92,176,158,199,49,25,24,57,30,27,26,19,7,0,-1,+1,70%,72%,67%,115,97,139,32%,32%,31%,3,1,2,3,2,1
405,https://vlr.gg/player/3993/jawgemo,2024-10-24 08:00:00,1.09,0.62,0.88,212,255,154,57,40,17,64,36,28,27,16,11,-6,0,-6,71%,70%,72%,143,169,109,20%,20%,19%,12,8,4,18,8,10
406,https://vlr.gg/player/17323/mimi,2024-10-24 08:00:00,0.80,0.91,0.85,155,143,172,46,24,22,59,32,27,20,13,7,-3,0,-3,72%,80%,61%,105,97,117,26%,22%,31%,6,5,1,9,5,4
407,https://vlr.gg/player/1885/purp0,2024-10-24 08:00:00,1.72,1.15,1.40,284,352,233,84,47,37,52,21,31,9,5,4,+8,+6,+2,77%,83%,72%,175,215,145,31%,35%,27%,15,9,6,7,3,4
408,https://vlr.gg/player/34684/westside,2024-10-24 08:00:00,1.22,1.06,1.13,199,209,193,59,29,30,52,22,30,31,10,21,-3,0,-3,80%,78%,83%,141,146,136,32%,31%,33%,3,1,2,6,1,5
409,https://vlr.gg/player/21610/runner,2024-10-24 08:00:00,1.15,0.95,1.04,203,200,215,58,25,33,58,22,36,34,19,15,+5,0,+5,76%,83%,70%,132,133,132,32%,36%,29%,13,3,10,8,3,5
410,https://vlr.gg/player/24101/miyori,2024-10-24 08:00:00,0.76,0.85,0.81,191,177,198,52,21,31,59,24,35,15,8,7,+4,+3,+1,68%,69%,67%,126,115,135,25%,33%,21%,12,7,5,8,4,4
411,https://vlr.gg/player/26632/joliinaa,2024-10-24 08:00:00,0.82,0.75,0.78,150,133,164,42,16,26,56,22,34,33,16,17,-4,-1,-3,70%,75%,65%,107,93,117,26%,28%,25%,3,2,1,7,3,4
412,https://vlr.gg/player/13221/azys,2024-10-24 06:30:00,1.92,1.15,1.57,321,382,246,49,32,17,29,15,14,12,7,5,+3,+4,-1,73%,83%,60%,210,241,174,38%,45%,29%,8,5,3,5,1,4
413,https://vlr.gg/player/12947/rawfiul,2024-10-24 06:30:00,1.24,0.85,1.06,218,247,185,36,22,14,30,14,16,5,4,1,+5,+1,+4,68%,71%,65%,134,151,112,31%,31%,30%,9,4,5,4,3,1
414,https://vlr.gg/player/3269/antidote,2024-10-24 06:30:00,0.94,1.15,1.03,177,139,220,25,11,14,29,14,15,22,12,10,+1,-1,+2,68%,67%,70%,114,82,152,29%,27%,30%,3,1,2,2,2,0
415,https://vlr.gg/player/3628/deathmaker,2024-10-24 06:30:00,0.81,1.03,0.91,147,115,190,25,11,14,25,11,14,1,0,1,-1,-2,+1,64%,63%,65%,96,75,122,37%,45%,32%,3,1,2,4,3,1
416,https://vlr.gg/player/18704/levi,2024-10-24 06:30:00,0.99,0.76,0.88,139,136,149,20,10,10,25,11,14,11,5,6,-2,-4,+2,70%,75%,65%,98,104,90,37%,35%,40%,2,0,2,4,4,0
417,https://vlr.gg/player/46104/envy2k,2024-10-24 06:30:00,1.20,0.91,1.04,252,305,208,36,21,15,34,16,18,9,3,6,0,-2,+2,68%,70%,67%,153,191,122,25%,26%,23%,9,4,5,9,6,3
418,https://vlr.gg/player/31355/acestarrrrr,2024-10-24 06:30:00,0.95,1.02,0.99,196,155,227,29,12,17,31,13,18,10,4,6,+1,-1,+2,70%,80%,63%,144,112,171,31%,32%,30%,3,0,3,2,1,1
419,https://vlr.gg/player/43390/d1sease,2024-10-24 06:30:00,0.75,1.11,0.95,151,102,193,24,7,17,26,11,15,15,7,8,-3,-3,0,70%,60%,79%,104,72,132,46%,42%,49%,1,0,1,4,3,1
420,https://vlr.gg/player/7485/ezzy,2024-10-24 06:30:00,1.26,0.64,0.92,207,305,126,31,22,9,31,14,17,8,2,6,0,-2,+2,68%,75%,63%,132,190,84,36%,43%,26%,5,2,3,5,4,1
421,https://vlr.gg/player/5536/whimp,2024-10-24 06:30:00,0.91,0.39,0.63,118,172,80,18,11,7,33,15,18,14,10,4,-4,0,-4,59%,75%,46%,88,130,54,32%,38%,22%,1,0,1,5,0,5
422,https://vlr.gg/player/18702/deadly10,2024-10-23 10:40:00,1.10,1.56,1.33,299,271,321,75,35,40,49,27,22,7,1,6,+9,-1,+10,79%,69%,89%,178,154,202,24%,29%,20%,21,10,11,12,11,1
423,https://vlr.gg/player/44919/aplycs,2024-10-23 10:40:00,1.26,1.08,1.17,218,205,232,56,28,28,46,20,26,12,2,10,+6,+2,+4,72%,61%,83%,148,138,157,25%,23%,26%,6,2,4,0,0,0
424,https://vlr.gg/player/3271/excali,2024-10-23 10:40:00,0.92,1.24,1.08,201,171,236,52,21,31,51,28,23,40,21,19,+4,0,+4,79%,72%,86%,142,124,161,31%,33%,29%,6,2,4,2,2,0
425,https://vlr.gg/player/48426/ghostxd,2024-10-23 10:40:00,0.96,1.11,1.03,199,190,210,51,24,27,46,25,21,30,14,16,+1,-1,+2,75%,69%,80%,126,123,129,33%,28%,39%,4,2,2,3,3,0
426,https://vlr.gg/player/8156/mojo,2024-10-23 10:40:00,0.75,0.67,0.71,147,167,128,34,17,17,50,28,22,23,18,5,-5,+2,-7,73%,83%,63%,105,117,92,23%,23%,22%,6,3,3,11,1,10
427,https://vlr.gg/player/22054/wave,2024-10-23 10:40:00,0.99,1.17,1.08,193,184,203,48,25,23,48,28,20,20,7,13,+1,0,+1,72%,66%,78%,137,132,143,31%,34%,27%,4,0,4,3,0,3
428,https://vlr.gg/player/27755/icarus,2024-10-23 10:40:00,0.81,1.31,1.06,197,167,231,50,19,31,47,26,21,13,11,2,-3,-3,0,68%,74%,61%,134,114,152,27%,22%,31%,2,1,1,5,4,1
429,https://vlr.gg/player/40060/rage,2024-10-23 10:40:00,1.32,0.76,1.03,205,244,170,51,31,20,57,26,31,25,10,15,-1,+2,-3,65%,63%,67%,136,154,119,30%,34%,26%,7,4,3,8,2,6
430,https://vlr.gg/player/43389/yash,2024-10-23 10:40:00,0.95,1.04,0.99,227,244,214,56,28,28,58,32,26,13,5,8,-2,-2,0,63%,60%,67%,143,155,131,20%,22%,18%,9,5,4,11,7,4
431,https://vlr.gg/player/43398/river,2024-10-23 10:40:00,0.29,0.91,0.60,150,92,210,37,11,26,58,31,27,17,5,12,-10,-10,0,59%,43%,75%,100,57,142,32%,24%,36%,6,1,5,16,11,5
432,https://vlr.gg/player/4881/spitfires,2024-10-23 09:00:00,,,,270,,,58,,,48,,,17,,,,,,,,,,,,,,,,,,,,
433,https://vlr.gg/player/46748/k1ra,2024-10-23 09:00:00,,,,243,,,54,,,39,,,31,,,,,,,,,,,,,,,,,,,,
434,https://vlr.gg/player/10821/delb,2024-10-23 09:00:00,,,,199,,,47,,,47,,,19,,,,,,,,,,,,,,,,,,,,
435,https://vlr.gg/player/25949/bunt,2024-10-23 09:00:00,,,,190,,,37,,,47,,,35,,,,,,,,,,,,,,,,,,,,
436,https://vlr.gg/player/37019/x3b,2024-10-23 09:00:00,,,,149,,,36,,,38,,,15,,,,,,,,,,,,,,,,,,,,
437,https://vlr.gg/player/3547/ninebody,2024-10-23 09:00:00,,,,288,,,61,,,50,,,14,,,,,,,,,,,,,,,,,,,,
438,https://vlr.gg/player/14444/eren,2024-10-23 09:00:00,,,,191,,,44,,,48,,,15,,,,,,,,,,,,,,,,,,,,
439,https://vlr.gg/player/41739/slowly,2024-10-23 09:00:00,,,,190,,,40,,,45,,,23,,,,,,,,,,,,,,,,,,,,
440,https://vlr.gg/player/3124/core,2024-10-23 09:00:00,,,,175,,,42,,,44,,,26,,,,,,,,,,,,,,,,,,,,
441,https://vlr.gg/player/14453/sunshine,2024-10-23 09:00:00,,,,157,,,31,,,45,,,34,,,,,,,,,,,,,,,,,,,,
442,https://vlr.gg/player/3488/gaurang,2024-10-23 06:30:00,1.21,1.02,1.10,206,243,205,50,22,28,51,21,30,19,10,9,+2,+2,0,70%,77%,66%,139,155,128,45%,42%,48%,4,2,2,2,0,2
443,https://vlr.gg/player/15363/mast3r,2024-10-23 06:30:00,0.80,0.95,0.89,161,162,181,35,14,21,52,23,29,43,16,27,-2,-4,+2,69%,65%,71%,115,114,116,19%,27%,15%,3,1,2,5,5,0
444,https://vlr.gg/player/7408/joshs,2024-10-23 06:30:00,0.72,1.01,0.89,179,162,188,43,17,26,52,22,30,15,2,13,-5,0,-5,58%,58%,58%,128,102,146,32%,19%,40%,5,1,4,10,1,9
445,https://vlr.gg/player/17292/cortezz,2024-10-23 06:30:00,0.89,0.84,0.86,171,163,184,41,17,24,49,19,30,10,1,9,-1,-1,0,56%,50%,61%,116,111,120,25%,26%,25%,6,2,4,7,3,4
446,https://vlr.gg/player/43510/kifas,2024-10-23 06:30:00,0.46,0.56,0.52,165,186,159,34,15,19,60,26,34,10,5,5,-2,-1,-1,56%,62%,53%,117,127,110,23%,27%,21%,10,5,5,12,6,6
447,https://vlr.gg/player/30286/karam1l,2024-10-23 06:30:00,1.39,1.51,1.44,271,263,276,66,38,28,38,22,16,10,7,3,+4,+2,+2,80%,74%,88%,186,185,188,36%,36%,37%,9,4,5,5,2,3
448,https://vlr.gg/player/4089/doxz3r,2024-10-23 06:30:00,1.58,1.19,1.42,276,291,260,63,38,25,40,21,19,21,13,8,+4,+3,+1,92%,89%,96%,190,196,181,23%,24%,22%,6,4,2,2,1,1
449,https://vlr.gg/player/14208/kishi,2024-10-23 06:30:00,0.85,1.74,1.21,212,138,332,50,18,32,39,23,16,26,18,8,-1,-3,+2,83%,79%,88%,144,93,220,34%,30%,36%,5,2,3,6,5,1
450,https://vlr.gg/player/23931/kata,2024-10-23 06:30:00,1.05,0.83,0.96,231,256,171,49,34,15,44,28,16,13,6,7,-1,-1,0,69%,66%,73%,141,165,108,26%,31%,19%,9,5,4,10,6,4
451,https://vlr.gg/player/41834/panda,2024-10-23 06:30:00,1.01,0.65,0.86,147,172,119,36,25,11,42,24,18,22,15,7,+2,+3,-1,73%,76%,69%,101,115,80,38%,42%,31%,7,6,1,5,3,2
452,https://vlr.gg/player/3741/vo0kashu,2024-10-23 06:00:00,,,,211,,,41,,,41,,,16,,,,,,,,,,,,,,,,,,,,
453,https://vlr.gg/player/31753/spiritz1,2024-10-23 06:00:00,,,,199,,,41,,,42,,,10,,,,,,,,,,,,,,,,,,,,
454,https://vlr.gg/player/7841/tvirusluke,2024-10-23 06:00:00,,,,156,,,27,,,44,,,8,,,,,,,,,,,,,,,,,,,,
455,https://vlr.gg/player/41774/shion7,2024-10-23 06:00:00,,,,144,,,29,,,43,,,12,,,,,,,,,,,,,,,,,,,,
456,https://vlr.gg/player/11524/nicc,2024-10-23 06:00:00,,,,142,,,23,,,44,,,29,,,,,,,,,,,,,,,,,,,,
457,https://vlr.gg/player/37927/happywei,2024-10-23 06:00:00,,,,312,,,57,,,31,,,15,,,,,,,,,,,,,,,,,,,,
458,https://vlr.gg/player/22047/rarga,2024-10-23 06:00:00,,,,275,,,53,,,40,,,12,,,,,,,,,,,,,,,,,,,,
459,https://vlr.gg/player/4710/you,2024-10-23 06:00:00,,,,205,,,39,,,32,,,11,,,,,,,,,,,,,,,,,,,,
460,https://vlr.gg/player/36668/mart1n,2024-10-23 06:00:00,,,,196,,,40,,,29,,,22,,,,,,,,,,,,,,,,,,,,
461,https://vlr.gg/player/37674/mrcani,2024-10-23 06:00:00,,,,116,,,25,,,30,,,18,,,,,,,,,,,,,,,,,,,,
462,https://vlr.gg/player/36245/n4rrate,2024-10-22 21:30:00,1.83,1.52,1.67,338,385,308,65,35,30,37,19,18,38,16,22,+1,0,+1,82%,85%,80%,233,269,201,19%,20%,17%,6,1,5,5,1,4
463,https://vlr.gg/player/729/zellsis,2024-10-22 21:30:00,0.81,1.48,1.18,243,175,292,26,9,17,20,10,10,10,4,6,-1,-1,0,76%,73%,78%,168,129,201,19%,12%,23%,4,1,3,5,2,3
464,https://vlr.gg/player/3880/bang,2024-10-22 21:30:00,0.99,1.33,1.17,254,206,280,52,19,33,40,20,20,12,7,5,-2,-1,-1,74%,70%,77%,147,131,162,14%,15%,14%,9,5,4,11,6,5
465,https://vlr.gg/player/1265/johnqt,2024-10-22 21:30:00,1.08,1.22,1.15,207,190,207,40,19,21,35,17,18,24,5,19,0,-3,+3,77%,74%,80%,127,129,126,20%,16%,23%,4,1,3,4,4,0
466,https://vlr.gg/player/48702/daph,2024-10-22 21:30:00,1.17,0.94,1.06,147,193,103,13,9,4,14,9,5,12,6,6,0,0,0,79%,75%,83%,95,127,63,20%,23%,15%,0,0,0,0,0,0
467,https://vlr.gg/player/4004/zekken,2024-10-22 21:30:00,1.15,0.88,0.99,182,240,165,41,22,19,41,21,20,25,15,10,-5,-4,-1,70%,70%,70%,127,157,99,14%,17%,11%,2,1,1,7,5,2
468,https://vlr.gg/player/9/tenz,2024-10-22 21:30:00,1.24,1.90,1.55,331,273,394,65,28,37,43,23,20,10,6,4,+3,-1,+4,68%,57%,81%,217,184,254,29%,25%,32%,9,2,7,6,3,3
469,https://vlr.gg/player/729/zellsis,2024-10-22 21:30:00,0.90,1.23,1.06,243,223,263,19,8,11,19,11,8,7,6,1,+1,+1,0,63%,58%,67%,160,151,168,12%,10%,13%,3,1,2,2,0,2
470,https://vlr.gg/player/2170/babybay,2024-10-22 21:30:00,0.98,0.68,0.84,216,245,191,40,23,17,49,26,23,14,6,8,-5,-5,0,61%,57%,67%,147,161,132,18%,24%,11%,6,3,3,11,8,3
471,https://vlr.gg/player/8419/reduxx,2024-10-22 21:30:00,0.79,0.89,0.82,203,185,242,21,11,10,28,14,14,11,4,7,+4,+2,+2,73%,67%,80%,148,126,176,20%,17%,22%,5,3,2,1,1,0
472,https://vlr.gg/player/47/zombs,2024-10-22 21:30:00,0.83,0.59,0.72,176,173,184,30,17,13,47,23,24,17,7,10,+7,+3,+4,67%,63%,70%,115,107,125,11%,13%,10%,9,5,4,2,2,0
473,https://vlr.gg/player/31376/tarik,2024-10-22 21:30:00,0.20,0.64,0.42,112,71,154,9,2,7,20,11,9,4,4,0,-2,-2,0,63%,67%,58%,75,50,100,9%,6%,9%,0,0,0,2,2,0
474,https://vlr.gg/player/48702/daph,2024-10-22 21:30:00,0.27,0.11,0.14,60,72,46,3,2,1,31,16,15,5,4,1,-1,0,-1,33%,44%,20%,58,64,51,8%,8%,7%,0,0,0,1,0,1
475,https://vlr.gg/player/29903/madv,2024-10-22 10:00:00,1.38,1.56,1.46,282,265,292,66,38,28,36,22,14,16,7,9,+3,+3,0,82%,78%,88%,174,166,185,36%,41%,30%,5,4,1,2,1,1
476,https://vlr.gg/player/28679/reta,2024-10-22 10:00:00,1.01,1.37,1.16,216,207,238,52,28,24,38,23,15,17,11,6,+4,0,+4,81%,72%,92%,146,141,155,44%,40%,50%,9,4,5,5,4,1
477,https://vlr.gg/player/20055/toki,2024-10-22 10:00:00,0.95,1.37,1.13,240,231,257,51,28,23,44,27,17,22,10,12,+2,+3,-1,71%,75%,65%,154,151,158,31%,37%,26%,10,7,3,8,4,4
478,https://vlr.gg/player/17333/mary,2024-10-22 10:00:00,0.93,1.19,1.03,221,203,248,49,28,21,42,24,18,13,2,11,+1,-2,+3,73%,72%,73%,151,136,172,25%,32%,18%,7,2,5,6,4,2
479,https://vlr.gg/player/28675/noor,2024-10-22 10:00:00,0.92,0.65,0.80,146,161,119,34,23,11,41,24,17,12,7,5,-4,-2,-2,66%,69%,62%,122,137,100,34%,37%,30%,3,2,1,7,4,3
480,https://vlr.gg/player/39027/leen,2024-10-22 10:00:00,1.04,1.26,1.15,266,246,286,56,22,34,52,22,30,8,3,5,-2,-2,0,68%,65%,69%,166,157,173,44%,45%,44%,11,4,7,13,6,7
481,https://vlr.gg/player/19366/lexa,2024-10-22 10:00:00,1.06,0.98,1.01,192,225,179,41,19,22,47,20,27,20,9,11,+1,+1,0,66%,62%,69%,130,142,121,31%,31%,31%,3,2,1,2,1,1
482,https://vlr.gg/player/29905/luj,2024-10-22 10:00:00,0.60,1.03,0.85,171,127,211,37,11,26,49,20,29,13,4,9,-1,0,-1,73%,65%,78%,117,88,139,38%,36%,39%,5,2,3,6,2,4
483,https://vlr.gg/player/40792/peace,2024-10-22 10:00:00,0.73,0.80,0.77,146,146,148,32,14,18,48,21,27,25,9,16,0,-1,+1,66%,65%,67%,92,97,89,41%,36%,43%,5,2,3,5,3,2
484,https://vlr.gg/player/24131/lexa,2024-10-22 10:00:00,0.60,0.74,0.68,182,172,173,35,15,20,56,24,32,20,9,11,-4,-2,-2,65%,69%,61%,114,109,118,33%,33%,33%,4,1,3,8,3,5
485,https://vlr.gg/player/30693/makaveli,2024-10-22 08:55:00,1.29,1.92,1.62,284,226,340,44,18,26,21,10,11,12,3,9,+2,0,+2,81%,75%,86%,194,154,230,33%,41%,28%,5,2,3,3,2,1
486,https://vlr.gg/player/27336/venka,2024-10-22 08:55:00,1.31,1.41,1.36,314,324,303,47,23,24,30,15,15,7,2,5,+12,+8,+4,79%,75%,82%,194,205,184,40%,52%,30%,14,9,5,2,1,1
487,https://vlr.gg/player/3627/hellff,2024-10-22 08:55:00,1.30,0.93,1.11,170,208,136,26,15,11,21,9,12,14,6,8,+2,0,+2,71%,75%,68%,117,149,87,33%,44%,21%,3,1,2,1,1,0
488,https://vlr.gg/player/27775/techno,2024-10-22 08:55:00,1.66,0.60,1.11,221,305,149,32,22,10,27,9,18,14,6,8,+3,+2,+1,74%,85%,64%,146,193,103,33%,38%,26%,6,2,4,3,0,3
489,https://vlr.gg/player/3639/hoax,2024-10-22 08:55:00,0.63,0.85,0.74,129,111,140,19,7,12,26,13,13,19,11,8,-1,0,-1,76%,75%,77%,89,71,105,16%,15%,17%,2,1,1,3,1,2
490,https://vlr.gg/player/40060/rage,2024-10-22 08:55:00,0.83,1.26,1.04,183,133,241,29,11,18,30,14,16,9,4,5,-5,-2,-3,60%,50%,70%,122,84,164,37%,24%,44%,1,0,1,6,2,4
491,https://vlr.gg/player/43389/yash,2024-10-22 08:55:00,0.92,0.80,0.86,224,242,207,32,18,14,37,18,19,6,3,3,0,0,0,55%,55%,55%,158,168,147,35%,35%,34%,8,5,3,8,5,3
492,https://vlr.gg/player/43398/river,2024-10-22 08:55:00,0.78,0.88,0.83,173,162,184,26,13,13,35,18,17,5,2,3,-2,-2,0,67%,59%,75%,122,115,130,38%,31%,44%,0,0,0,2,2,0
493,https://vlr.gg/player/22054/wave,2024-10-22 08:55:00,0.83,0.57,0.71,139,153,124,20,12,8,33,16,17,11,7,4,-6,-2,-4,60%,59%,60%,92,99,83,23%,33%,14%,3,2,1,9,4,5
494,https://vlr.gg/player/27755/icarus,2024-10-22 08:55:00,0.87,0.26,0.58,134,206,54,18,15,3,33,17,16,3,1,2,-5,-2,-3,50%,64%,35%,88,135,37,37%,39%,30%,0,0,0,5,2,3
495,https://vlr.gg/player/3741/vo0kashu,2024-10-22 08:30:00,,,,260,,,52,,,41,,,19,,,,,,,,,,,,,,,,,,,,
496,https://vlr.gg/player/31753/spiritz1,2024-10-22 08:30:00,,,,218,,,50,,,49,,,10,,,,,,,,,,,,,,,,,,,,
497,https://vlr.gg/player/7841/tvirusluke,2024-10-22 08:30:00,,,,194,,,45,,,51,,,15,,,,,,,,,,,,,,,,,,,,
498,https://vlr.gg/player/11524/nicc,2024-10-22 08:30:00,,,,170,,,33,,,42,,,26,,,,,,,,,,,,,,,,,,,,
499,https://vlr.gg/player/41774/shion7,2024-10-22 08:30:00,,,,123,,,22,,,47,,,27,,,,,,,,,,,,,,,,,,,,
500,https://vlr.gg/player/46460/ezeir,2024-10-22 08:30:00,,,,251,,,52,,,39,,,28,,,,,,,,,,,,,,,,,,,,
501,https://vlr.gg/player/1209/swerl,2024-10-22 08:30:00,,,,246,,,52,,,44,,,11,,,,,,,,,,,,,,,,,,,,
502,https://vlr.gg/player/39697/cb,2024-10-22 08:30:00,,,,240,,,48,,,38,,,30,,,,,,,,,,,,,,,,,,,,
503,https://vlr.gg/player/41054/guang,2024-10-22 08:30:00,,,,183,,,41,,,38,,,11,,,,,,,,,,,,,,,,,,,,
504,https://vlr.gg/player/4402/o0o0o,2024-10-22 08:30:00,,,,169,,,37,,,43,,,21,,,,,,,,,,,,,,,,,,,,
0,https://vlr.gg/player/27225/d4rf,2024-10-22 07:00:00,1.39,0.96,1.19,224,240,202,85,51,34,74,37,37,46,28,18,0,0,0,82%,90%,73%,141,149,131,29%,23%,40%,9,3,6,9,3,6
1,https://vlr.gg/player/12291/arpoom,2024-10-22 07:00:00,1.12,0.88,1.01,184,188,183,68,37,31,76,36,40,40,26,14,-3,-2,-1,74%,81%,65%,130,133,126,30%,30%,31%,5,2,3,8,4,4
2,https://vlr.gg/player/31498/lorangez,2024-10-22 07:00:00,0.96,0.95,0.96,188,202,180,74,44,30,78,43,35,38,20,18,0,+3,-3,68%,68%,69%,123,125,120,31%,33%,29%,9,8,1,9,5,4
3,https://vlr.gg/player/25535/vickyz,2024-10-22 07:00:00,0.77,0.79,0.78,176,177,181,69,37,32,85,44,41,22,13,9,-7,-7,0,65%,66%,65%,117,117,117,24%,34%,17%,13,7,6,20,14,6
4,https://vlr.gg/player/16977/socools0da,2024-10-22 07:00:00,0.79,0.65,0.73,177,194,156,69,42,27,86,45,41,15,5,10,+5,0,+5,60%,61%,59%,120,127,112,42%,46%,37%,16,6,10,11,6,5
5,https://vlr.gg/player/13784/killua,2024-10-22 07:00:00,1.33,1.10,1.20,229,251,210,94,48,46,76,32,44,30,10,20,+9,+8,+1,76%,84%,69%,153,166,142,43%,44%,42%,15,10,5,6,2,4
6,https://vlr.gg/player/27244/seph1roth,2024-10-22 07:00:00,0.89,1.17,1.04,192,160,215,79,31,48,69,31,38,32,17,15,0,-1,+1,77%,78%,76%,126,99,150,35%,36%,35%,8,2,6,8,3,5
7,https://vlr.gg/player/12098/kadoom,2024-10-22 07:00:00,1.02,1.02,1.01,224,228,224,88,42,46,79,35,44,20,7,13,0,-4,+4,69%,69%,69%,147,138,154,23%,24%,21%,16,8,8,16,12,4
8,https://vlr.gg/player/24679/cgrs,2024-10-22 07:00:00,1.12,0.92,1.01,188,186,185,72,35,37,69,28,41,28,14,14,-3,-4,+1,75%,82%,68%,122,132,113,22%,30%,16%,9,2,7,12,6,6
9,https://vlr.gg/player/8582/laz,2024-10-22 07:00:00,1.27,0.76,1.00,186,214,164,65,38,27,72,28,44,35,12,23,-1,0,-1,71%,75%,68%,131,140,122,21%,25%,17%,9,3,6,10,3,7
10,https://vlr.gg/player/4089/doxz3r,2024-10-22 06:30:00,1.01,1.07,1.04,215,187,238,27,10,17,30,11,19,9,3,6,0,-2,+2,73%,63%,79%,150,141,157,25%,11%,39%,3,0,3,3,2,1
11,https://vlr.gg/player/30286/karam1l,2024-10-22 06:30:00,1.09,0.99,1.03,210,236,212,31,14,17,30,12,18,7,2,5,+5,+2,+3,55%,50%,58%,137,137,137,39%,38%,40%,7,2,5,2,0,2
12,https://vlr.gg/player/14208/kishi,2024-10-22 06:30:00,0.97,0.96,0.96,190,188,202,27,11,16,28,11,17,13,5,8,+1,0,+1,60%,56%,63%,131,142,124,30%,18%,42%,2,1,1,1,1,0
13,https://vlr.gg/player/41834/panda,2024-10-22 06:30:00,0.19,0.87,0.60,163,82,200,19,3,16,32,14,18,9,5,4,-3,-2,-1,63%,75%,54%,104,62,132,39%,22%,47%,2,1,1,5,3,2
14,https://vlr.gg/player/23931/kata,2024-10-22 06:30:00,0.67,0.39,0.50,128,189,107,19,10,9,35,14,21,4,1,3,-3,0,-3,60%,69%,54%,93,120,75,20%,15%,26%,6,3,3,9,3,6
15,https://vlr.gg/player/7485/ezzy,2024-10-22 06:30:00,1.22,1.76,1.44,262,247,289,40,22,18,23,16,7,9,4,5,+1,0,+1,73%,67%,81%,170,166,175,43%,37%,55%,4,2,2,3,2,1
16,https://vlr.gg/player/46104/envy2k,2024-10-22 06:30:00,1.09,1.54,1.27,241,217,314,37,18,19,24,15,9,12,9,3,-4,-4,0,78%,71%,88%,156,140,179,21%,28%,15%,5,3,2,9,7,2
17,https://vlr.gg/player/43390/d1sease,2024-10-22 06:30:00,1.38,0.59,1.07,152,199,76,24,19,5,23,12,11,14,8,6,+1,+1,0,75%,79%,69%,97,133,43,35%,40%,21%,3,2,1,2,1,1
18,https://vlr.gg/player/5536/whimp,2024-10-22 06:30:00,1.17,0.83,1.03,246,226,205,31,20,11,26,15,11,17,10,7,0,0,0,68%,71%,63%,133,140,124,41%,41%,41%,4,2,2,4,2,2
19,https://vlr.gg/player/31355/acestarrrrr,2024-10-22 06:30:00,0.72,1.24,0.93,170,152,195,22,13,9,27,18,9,15,6,9,+2,+1,+1,85%,79%,94%,124,113,142,18%,13%,26%,4,2,2,2,1,1
20,https://vlr.gg/player/46748/k1ra,2024-10-22 06:00:00,,,,213,,,44,,,37,,,17,,,,,,,,,,,,,,,,,,,,
21,https://vlr.gg/player/37019/x3b,2024-10-22 06:00:00,,,,187,,,33,,,41,,,13,,,,,,,,,,,,,,,,,,,,
22,https://vlr.gg/player/4881/spitfires,2024-10-22 06:00:00,,,,185,,,34,,,46,,,12,,,,,,,,,,,,,,,,,,,,
23,https://vlr.gg/player/10821/delb,2024-10-22 06:00:00,,,,154,,,29,,,41,,,15,,,,,,,,,,,,,,,,,,,,
24,https://vlr.gg/player/25949/bunt,2024-10-22 06:00:00,,,,146,,,27,,,39,,,25,,,,,,,,,,,,,,,,,,,,
25,https://vlr.gg/player/7849/siufatbb,2024-10-22 06:00:00,,,,243,,,50,,,23,,,17,,,,,,,,,,,,,,,,,,,,
26,https://vlr.gg/player/37489/lysoar,2024-10-22 06:00:00,,,,227,,,41,,,32,,,20,,,,,,,,,,,,,,,,,,,,
27,https://vlr.gg/player/14125/spring,2024-10-22 06:00:00,,,,223,,,41,,,43,,,18,,,,,,,,,,,,,,,,,,,,
28,https://vlr.gg/player/45104/v1ya,2024-10-22 06:00:00,,,,202,,,36,,,36,,,32,,,,,,,,,,,,,,,,,,,,
29,https://vlr.gg/player/11218/yuicaw,2024-10-22 06:00:00,,,,181,,,36,,,33,,,34,,,,,,,,,,,,,,,,,,,,
30,https://vlr.gg/player/8834/bucher,2024-10-21 15:10:00,1.15,1.92,1.48,280,206,379,42,17,25,27,16,11,11,6,5,+3,+1,+2,76%,71%,83%,195,158,246,40%,34%,46%,5,2,3,2,1,1
31,https://vlr.gg/player/5292/al0rante,2024-10-21 15:10:00,0.94,1.34,1.11,199,178,232,33,17,16,25,16,9,4,2,2,-3,-2,-1,74%,67%,83%,138,132,146,56%,44%,76%,1,1,0,4,3,1
32,https://vlr.gg/player/2052/kuba,2024-10-21 15:10:00,0.91,1.27,1.07,206,215,193,31,18,13,28,20,8,14,7,7,0,0,0,71%,63%,83%,139,150,125,37%,39%,34%,3,1,2,3,1,2
33,https://vlr.gg/player/23237/unfair,2024-10-21 15:10:00,1.02,0.80,0.93,182,212,144,28,19,9,29,18,11,5,2,3,-1,-2,+1,62%,58%,67%,124,131,114,44%,44%,44%,5,3,2,6,5,1
34,https://vlr.gg/player/4244/yaboilewis,2024-10-21 15:10:00,0.71,0.87,0.78,217,202,235,29,15,14,35,21,14,12,7,5,-1,-1,0,69%,71%,67%,147,129,170,38%,32%,46%,6,3,3,7,4,3
35,https://vlr.gg/player/19505/szalony,2024-10-21 15:10:00,1.07,1.30,1.20,264,260,265,40,18,22,33,15,18,6,1,5,+1,-1,+2,76%,72%,79%,173,151,189,23%,39%,14%,6,2,4,5,3,2
36,https://vlr.gg/player/31313/geneticzz,2024-10-21 15:10:00,0.70,1.34,1.07,253,203,295,37,12,25,35,16,19,9,2,7,0,-3,+3,69%,50%,83%,174,146,195,49%,45%,52%,4,1,3,4,4,0
37,https://vlr.gg/player/9143/darkosek,2024-10-21 15:10:00,0.48,1.04,0.80,160,113,194,24,7,17,33,16,17,11,1,10,+2,0,+2,64%,56%,71%,91,72,105,36%,35%,36%,6,1,5,4,1,3
38,https://vlr.gg/player/31377/allthewaypat,2024-10-21 15:10:00,0.77,0.81,0.79,152,161,146,24,10,14,30,15,15,10,4,6,0,+2,-2,71%,72%,71%,102,101,103,27%,34%,21%,4,3,1,4,1,3
39,https://vlr.gg/player/5810/kryo,2024-10-21 15:10:00,0.57,0.86,0.74,153,133,166,19,7,12,33,15,18,18,5,13,-1,0,-1,62%,44%,75%,106,92,117,24%,26%,24%,2,1,1,3,1,2
40,https://vlr.gg/player/12528/disisjohn,2024-10-21 12:00:00,2.05,0.62,1.52,310,386,180,21,17,4,12,6,6,3,2,1,0,0,0,68%,83%,43%,208,255,127,51%,55%,38%,3,1,2,3,1,2
41,https://vlr.gg/player/4629/azury,2024-10-21 12:00:00,1.14,1.33,1.22,224,229,228,35,22,13,26,17,9,7,1,6,0,-2,+2,68%,54%,88%,154,159,146,36%,35%,38%,6,3,3,6,5,1
42,https://vlr.gg/player/9508/leosen,2024-10-21 12:00:00,1.17,1.23,1.19,247,229,279,50,27,23,43,25,18,23,17,6,+3,+1,+2,75%,75%,74%,159,153,168,35%,33%,38%,9,5,4,6,4,2
43,https://vlr.gg/player/7865/xanarchy,2024-10-21 12:00:00,1.02,0.90,0.98,163,165,159,35,20,15,35,22,13,17,10,7,+1,+2,-1,69%,69%,70%,109,114,101,27%,25%,32%,2,2,0,1,0,1
44,https://vlr.gg/player/4969/shazeon,2024-10-21 12:00:00,0.70,1.10,0.86,177,142,232,37,18,19,42,26,16,23,10,13,-1,0,-1,61%,56%,70%,116,96,148,32%,31%,34%,6,4,2,7,4,3
45,https://vlr.gg/player/30750/enes,2024-10-21 12:00:00,0.60,0.65,0.62,116,131,93,24,16,8,40,27,13,17,13,4,-10,-7,-3,58%,56%,61%,77,84,66,36%,41%,29%,0,0,0,10,7,3
46,https://vlr.gg/player/46466/frazune,2024-10-21 12:00:00,1.35,1.06,1.17,201,223,187,42,20,22,35,15,20,23,8,15,0,+1,-1,76%,78%,75%,128,149,115,26%,37%,19%,3,2,1,3,1,2
47,https://vlr.gg/player/39664/insanedini,2024-10-21 12:00:00,1.07,1.12,1.10,230,250,216,48,20,28,41,17,24,9,4,5,+2,+1,+1,68%,78%,61%,150,163,142,27%,29%,25%,8,5,3,6,4,2
48,https://vlr.gg/player/33398/miyamura,2024-10-21 12:00:00,0.99,1.17,1.10,206,177,224,45,16,29,41,16,25,14,5,9,+2,+1,+1,66%,65%,67%,131,122,137,26%,23%,29%,8,1,7,6,0,6
49,https://vlr.gg/player/46468/dokusei,2024-10-21 12:00:00,0.67,0.93,0.83,168,122,201,33,10,23,42,17,25,17,4,13,+5,0,+5,71%,65%,75%,117,83,139,39%,52%,35%,9,2,7,4,2,2
50,https://vlr.gg/player/30292/bruhbruhfish,2024-10-21 12:00:00,0.50,0.77,0.66,139,121,152,29,9,20,43,17,26,10,3,7,-2,-2,0,66%,61%,69%,89,77,96,35%,47%,30%,5,2,3,7,4,3
51,https://vlr.gg/player/8582/laz,2024-10-21 08:50:00,1.28,1.63,1.47,271,257,281,41,17,24,23,13,10,5,3,2,+1,+2,-1,80%,74%,86%,177,168,185,28%,33%,24%,3,2,1,2,0,2
52,https://vlr.gg/player/12098/kadoom,2024-10-21 08:50:00,1.11,1.18,1.15,266,258,264,37,18,19,31,15,16,7,3,4,-1,-4,+3,78%,79%,76%,176,174,178,34%,40%,30%,6,1,5,7,5,2
53,https://vlr.gg/player/24679/cgrs,2024-10-21 08:50:00,0.91,1.28,1.11,178,153,203,26,12,14,23,13,10,15,2,13,-2,-2,0,83%,74%,90%,130,118,141,21%,25%,17%,1,0,1,3,2,1
54,https://vlr.gg/player/13784/killua,2024-10-21 08:50:00,0.89,1.27,1.09,184,158,211,29,11,18,24,14,10,6,3,3,+1,+1,0,70%,68%,71%,130,124,134,46%,44%,48%,4,2,2,3,1,2
55,https://vlr.gg/player/27244/seph1roth,2024-10-21 08:50:00,0.98,1.11,1.05,191,172,210,27,11,16,26,12,14,12,7,5,+5,+4,+1,75%,74%,76%,124,115,132,33%,35%,32%,8,5,3,3,1,2
56,https://vlr.gg/player/23930/potter,2024-10-21 08:50:00,0.63,1.46,1.03,247,206,301,34,13,21,33,20,13,7,3,4,+4,+2,+2,60%,52%,68%,161,131,194,34%,33%,35%,10,6,4,6,4,2
57,https://vlr.gg/player/1908/kongared,2024-10-21 08:50:00,0.72,1.29,0.99,225,157,301,33,12,21,32,17,15,4,4,0,-2,-1,-1,63%,57%,68%,151,114,191,43%,33%,53%,3,1,2,5,2,3
58,https://vlr.gg/player/2366/alert,2024-10-21 08:50:00,0.81,0.71,0.76,167,177,151,21,11,10,32,18,14,15,12,3,0,-1,+1,60%,57%,63%,105,111,99,42%,44%,40%,3,0,3,3,1,2
59,https://vlr.gg/player/12289/siraww,2024-10-21 08:50:00,0.97,0.45,0.72,149,190,100,20,15,5,31,17,14,7,3,4,-1,0,-1,60%,57%,63%,106,138,71,20%,26%,11%,0,0,0,1,0,1
60,https://vlr.gg/player/2368/b3ta,2024-10-21 08:50:00,0.43,0.66,0.54,121,131,114,19,9,10,32,19,13,5,4,1,-5,-3,-2,60%,62%,58%,90,97,82,34%,33%,35%,2,2,0,7,5,2
61,https://vlr.gg/player/48426/ghostxd,2024-10-21 08:45:00,0.93,1.13,1.02,185,168,212,30,14,16,30,17,13,12,7,5,0,0,0,75%,71%,80%,123,114,134,32%,32%,32%,3,2,1,3,2,1
62,https://vlr.gg/player/3271/excali,2024-10-21 08:45:00,1.00,1.04,1.02,233,225,238,36,17,19,35,20,15,16,13,3,+1,0,+1,73%,71%,75%,140,144,136,37%,35%,41%,2,0,2,1,0,1
63,https://vlr.gg/player/44919/aplycs,2024-10-21 08:45:00,1.12,0.72,0.94,190,232,129,28,18,10,31,19,12,10,8,2,-5,-4,-1,61%,63%,60%,127,169,76,26%,33%,16%,0,0,0,5,4,1
64,https://vlr.gg/player/18702/deadly10,2024-10-21 08:45:00,0.64,1.28,0.93,242,190,308,34,14,20,40,22,18,13,5,8,-4,-5,+1,70%,58%,85%,151,123,185,19%,19%,19%,10,5,5,14,10,4
65,https://vlr.gg/player/8156/mojo,2024-10-21 08:45:00,0.82,0.87,0.84,190,188,201,27,14,13,35,20,15,11,6,5,0,+1,-1,61%,63%,60%,123,117,131,26%,28%,24%,3,1,2,3,0,3
66,https://vlr.gg/player/12323/rvk,2024-10-21 08:45:00,1.08,1.51,1.31,253,226,270,40,17,23,29,15,14,19,4,15,+5,-1,+6,80%,75%,83%,154,147,159,33%,46%,27%,7,1,6,2,2,0
67,https://vlr.gg/player/40057/batman,2024-10-21 08:45:00,1.17,1.32,1.25,205,210,201,19,10,9,16,9,7,10,3,7,+1,+2,-1,67%,50%,83%,137,151,123,44%,59%,33%,3,2,1,2,0,2
68,https://vlr.gg/player/1770/wat,2024-10-21 08:45:00,1.11,1.16,1.14,266,269,276,42,19,23,35,16,19,14,4,10,+2,+2,0,80%,70%,88%,184,166,199,38%,38%,38%,4,3,1,2,1,1
69,https://vlr.gg/player/46048/r0meo,2024-10-21 08:45:00,0.88,1.10,1.01,208,261,173,14,7,7,13,6,7,1,0,1,+4,+2,+2,80%,75%,83%,134,167,113,30%,42%,22%,5,2,3,1,0,1
70,https://vlr.gg/player/3502/ri0,2024-10-21 08:45:00,0.72,1.08,0.92,169,151,190,28,9,19,30,16,14,14,7,7,-3,-2,-1,75%,75%,75%,119,101,134,40%,25%,55%,1,0,1,4,2,2
71,https://vlr.gg/player/46121/marcai,2024-10-21 08:45:00,0.73,0.88,0.81,187,166,197,28,11,17,32,16,16,11,6,5,-1,-3,+2,70%,60%,79%,125,122,128,24%,27%,21%,6,2,4,7,5,2
72,https://vlr.gg/player/3547/ninebody,2024-10-21 08:10:00,,,,273,,,54,,,40,,,15,,,,,,,,,,,,,,,,,,,,
73,https://vlr.gg/player/41739/slowly,2024-10-21 08:10:00,,,,231,,,42,,,35,,,15,,,,,,,,,,,,,,,,,,,,
74,https://vlr.gg/player/3124/core,2024-10-21 08:10:00,,,,228,,,47,,,36,,,36,,,,,,,,,,,,,,,,,,,,
75,https://vlr.gg/player/14444/eren,2024-10-21 08:10:00,,,,185,,,43,,,37,,,6,,,,,,,,,,,,,,,,,,,,
76,https://vlr.gg/player/14453/sunshine,2024-10-21 08:10:00,,,,146,,,27,,,41,,,27,,,,,,,,,,,,,,,,,,,,
77,https://vlr.gg/player/488/rb,2024-10-21 08:10:00,,,,294,,,58,,,45,,,13,,,,,,,,,,,,,,,,,,,,
78,https://vlr.gg/player/4720/haodong,2024-10-21 08:10:00,,,,188,,,38,,,42,,,20,,,,,,,,,,,,,,,,,,,,
79,https://vlr.gg/player/5011/abo,2024-10-21 08:10:00,,,,171,,,34,,,43,,,10,,,,,,,,,,,,,,,,,,,,
80,https://vlr.gg/player/30526/b1ack,2024-10-21 08:10:00,,,,170,,,32,,,41,,,38,,,,,,,,,,,,,,,,,,,,
81,https://vlr.gg/player/14445/ac,2024-10-21 08:10:00,,,,142,,,27,,,42,,,14,,,,,,,,,,,,,,,,,,,,
82,https://vlr.gg/player/4377/johnolsen,2024-10-21 07:00:00,0.45,1.20,0.95,256,140,307,31,5,26,30,9,21,2,1,1,-6,-6,0,68%,40%,79%,157,92,185,30%,14%,33%,4,0,4,10,6,4
83,https://vlr.gg/player/2388/theelovefamily,2024-10-21 07:00:00,0.98,0.83,0.87,202,234,185,23,8,15,29,9,20,5,2,3,-1,-1,0,71%,60%,75%,116,131,109,36%,37%,35%,3,1,2,4,2,2
84,https://vlr.gg/player/27254/leviathan,2024-10-21 07:00:00,0.82,0.61,0.67,156,211,136,18,7,11,30,9,21,8,3,5,-3,+1,-4,68%,80%,63%,100,120,92,36%,39%,34%,2,1,1,5,0,5
85,https://vlr.gg/player/3401/ptc,2024-10-21 07:00:00,0.54,0.64,0.61,121,104,131,14,4,10,26,8,18,4,1,3,-1,0,-1,56%,50%,58%,91,80,95,42%,75%,34%,1,0,1,2,0,2
86,https://vlr.gg/player/3342/sushiboys,2024-10-21 07:00:00,0.22,0.67,0.53,86,40,107,9,1,8,28,9,19,10,0,10,-3,0,-3,56%,40%,63%,70,48,80,22%,22%,22%,0,0,0,3,0,3
87,https://vlr.gg/player/27225/d4rf,2024-10-21 07:00:00,1.57,1.51,1.55,274,269,292,38,26,12,18,12,6,15,10,5,+1,0,+1,91%,96%,80%,177,175,182,39%,32%,63%,3,1,2,2,1,1
88,https://vlr.gg/player/31498/lorangez,2024-10-21 07:00:00,1.29,1.93,1.48,257,228,326,31,19,12,16,12,4,20,16,4,+4,+2,+2,82%,79%,90%,171,157,206,38%,32%,50%,5,3,2,1,1,0
89,https://vlr.gg/player/16977/socools0da,2024-10-21 07:00:00,1.17,1.85,1.37,232,198,306,29,17,12,19,14,5,10,7,3,+3,0,+3,82%,79%,90%,158,139,202,38%,34%,44%,5,2,3,2,2,0
90,https://vlr.gg/player/12291/arpoom,2024-10-21 07:00:00,1.08,0.97,1.05,178,197,133,23,18,5,19,14,5,8,4,4,+1,+1,0,79%,79%,80%,126,136,100,32%,39%,16%,3,3,0,2,2,0
91,https://vlr.gg/player/25535/vickyz,2024-10-21 07:00:00,0.94,0.64,0.85,188,229,97,22,19,3,23,18,5,4,4,0,+5,+5,0,82%,83%,80%,122,144,68,21%,19%,43%,8,7,1,3,2,1
92,https://vlr.gg/player/13221/azys,2024-10-21 06:30:00,1.68,1.67,1.68,296,267,320,36,17,19,15,7,8,16,13,3,+4,+3,+1,79%,88%,71%,190,170,208,27%,22%,31%,5,3,2,1,0,1
93,https://vlr.gg/player/3628/deathmaker,2024-10-21 06:30:00,1.31,1.53,1.42,243,213,271,31,13,18,14,7,7,8,6,2,+3,+2,+1,82%,81%,82%,160,145,174,32%,42%,26%,4,3,1,1,1,0
94,https://vlr.gg/player/3269/antidote,2024-10-21 06:30:00,1.45,1.06,1.25,187,211,165,22,13,9,17,7,10,26,9,17,0,-1,+1,88%,94%,82%,128,143,113,42%,50%,35%,2,0,2,2,1,1
95,https://vlr.gg/player/18704/levi,2024-10-21 06:30:00,1.16,1.18,1.17,191,195,185,22,10,12,14,6,8,10,6,4,+7,+4,+3,85%,88%,82%,130,146,114,40%,40%,39%,8,4,4,1,0,1
96,https://vlr.gg/player/12947/rawfiul,2024-10-21 06:30:00,1.61,0.73,1.16,275,380,181,32,22,10,24,11,13,11,6,5,+7,+4,+3,85%,94%,76%,184,240,132,35%,39%,28%,8,4,4,1,0,1
97,https://vlr.gg/player/17292/cortezz,2024-10-21 06:30:00,1.12,0.46,0.77,173,225,120,20,15,5,30,14,16,1,0,1,0,+1,-1,55%,71%,38%,114,145,82,25%,33%,18%,3,2,1,3,1,2
98,https://vlr.gg/player/7408/joshs,2024-10-21 06:30:00,0.97,0.49,0.74,180,195,160,18,10,8,29,13,16,3,2,1,-3,-1,-2,52%,59%,44%,113,122,105,16%,20%,9%,3,2,1,6,3,3
99,https://vlr.gg/player/3488/gaurang,2024-10-21 06:30:00,0.85,0.61,0.72,153,158,151,16,8,8,27,13,14,10,8,2,-6,-2,-4,64%,76%,50%,98,96,99,24%,11%,47%,0,0,0,6,2,4
100,https://vlr.gg/player/15363/mast3r,2024-10-21 06:30:00,0.61,0.67,0.64,140,118,164,15,6,9,27,13,14,12,11,1,-6,-4,-2,52%,65%,38%,91,74,108,25%,25%,26%,0,0,0,6,4,2
101,https://vlr.gg/player/43510/kifas,2024-10-21 06:30:00,0.48,0.69,0.59,156,143,173,15,7,8,30,15,15,7,5,2,-6,-3,-3,48%,53%,44%,105,96,115,24%,20%,30%,0,0,0,6,3,3
102,https://vlr.gg/player/16924/stew,2024-10-21 06:00:00,,,,237,,,35,,,29,,,7,,,,,,,,,,,,,,,,,,,,
103,https://vlr.gg/player/3519/jkuro,2024-10-21 06:00:00,,,,212,,,34,,,29,,,16,,,,,,,,,,,,,,,,,,,,
104,https://vlr.gg/player/41029/z1yan,2024-10-21 06:00:00,,,,185,,,27,,,35,,,10,,,,,,,,,,,,,,,,,,,,
105,https://vlr.gg/player/3049/sword9,2024-10-21 06:00:00,,,,165,,,25,,,30,,,14,,,,,,,,,,,,,,,,,,,,
106,https://vlr.gg/player/36415/viva,2024-10-21 06:00:00,,,,118,,,16,,,29,,,16,,,,,,,,,,,,,,,,,,,,
107,https://vlr.gg/player/22047/rarga,2024-10-21 06:00:00,,,,301,,,41,,,31,,,9,,,,,,,,,,,,,,,,,,,,
108,https://vlr.gg/player/37927/happywei,2024-10-21 06:00:00,,,,223,,,32,,,28,,,13,,,,,,,,,,,,,,,,,,,,
109,https://vlr.gg/player/36668/mart1n,2024-10-21 06:00:00,,,,216,,,35,,,25,,,19,,,,,,,,,,,,,,,,,,,,
110,https://vlr.gg/player/4710/you,2024-10-21 06:00:00,,,,160,,,21,,,25,,,14,,,,,,,,,,,,,,,,,,,,
111,https://vlr.gg/player/37674/mrcani,2024-10-21 06:00:00,,,,142,,,22,,,28,,,12,,,,,,,,,,,,,,,,,,,,
112,https://vlr.gg/player/17397/noia,2024-10-20 17:00:00,1.55,1.45,1.48,291,310,271,58,24,34,31,12,19,18,7,11,+3,-1,+4,86%,86%,86%,187,206,175,33%,43%,27%,7,2,5,4,3,1
113,https://vlr.gg/player/17976/florescent,2024-10-20 17:00:00,1.06,1.46,1.31,301,279,321,61,20,41,38,16,22,12,6,6,+4,-2,+6,70%,55%,80%,198,186,206,28%,34%,25%,13,3,10,9,5,4
114,https://vlr.gg/player/3063/mel,2024-10-20 17:00:00,1.13,1.35,1.27,176,150,198,38,12,26,26,11,15,31,13,18,+1,-1,+2,82%,86%,80%,112,95,122,22%,27%,20%,5,1,4,4,2,2
115,https://vlr.gg/player/21486/sarahcat,2024-10-20 17:00:00,0.86,1.46,1.23,246,153,286,47,12,35,35,13,22,23,5,18,+2,-1,+3,84%,77%,89%,148,99,179,26%,28%,26%,4,1,3,2,2,0
116,https://vlr.gg/player/3079/alexis,2024-10-20 17:00:00,1.23,0.81,0.98,164,222,133,33,18,15,34,13,21,33,10,23,-1,+3,-4,79%,73%,83%,113,143,95,38%,48%,31%,4,3,1,5,0,5
117,https://vlr.gg/player/8329/starbound,2024-10-20 17:00:00,0.94,0.84,0.89,179,202,157,39,26,13,43,27,16,6,2,4,0,0,0,61%,69%,50%,115,127,97,20%,27%,11%,5,4,1,5,4,1
118,https://vlr.gg/player/9185/dodonut,2024-10-20 17:00:00,0.54,1.26,0.82,190,154,257,37,17,20,49,33,16,6,4,2,+1,-4,+5,61%,60%,64%,131,110,166,37%,27%,53%,8,1,7,7,5,2
119,https://vlr.gg/player/8849/sonder,2024-10-20 17:00:00,0.63,1.07,0.80,191,166,229,35,17,18,50,32,18,17,14,3,+2,+1,+1,63%,63%,64%,117,111,126,21%,21%,21%,7,5,2,5,4,1
120,https://vlr.gg/player/33694/evv,2024-10-20 17:00:00,0.81,0.56,0.70,171,195,127,31,23,8,47,29,18,9,4,5,-6,-3,-3,58%,60%,55%,111,123,91,23%,26%,19%,2,1,1,8,4,4
121,https://vlr.gg/player/17/theia,2024-10-20 17:00:00,0.57,0.53,0.55,116,126,118,22,16,6,48,30,18,21,12,9,-6,-5,-1,65%,63%,68%,78,74,83,16%,14%,18%,2,1,1,8,6,2
122,https://vlr.gg/player/12670/nekky,2024-10-20 14:30:00,0.67,1.30,0.97,251,222,284,19,8,11,19,11,8,8,4,4,+3,+1,+2,83%,83%,82%,169,156,183,29%,40%,21%,3,1,2,0,0,0
123,https://vlr.gg/player/19580/logicman,2024-10-20 14:30:00,1.11,0.74,0.93,175,200,148,15,9,6,16,7,9,5,4,1,0,+1,-1,70%,75%,64%,130,157,102,21%,20%,22%,1,1,0,1,0,1
124,https://vlr.gg/player/33551/slaughter,2024-10-20 14:30:00,0.85,0.81,0.83,136,111,165,12,6,6,16,8,8,7,4,3,+1,0,+1,74%,67%,82%,86,73,100,33%,33%,33%,2,0,2,1,0,1
125,https://vlr.gg/player/41719/mepeezy,2024-10-20 14:30:00,0.93,0.61,0.78,160,183,135,12,7,5,18,9,9,7,2,5,+1,-1,+2,70%,67%,73%,107,136,75,22%,32%,6%,2,0,2,1,1,0
126,https://vlr.gg/player/3599/ixeonn,2024-10-20 14:30:00,0.91,0.64,0.78,214,260,165,16,11,5,19,12,7,5,2,3,+2,+3,-1,74%,83%,64%,143,155,131,24%,31%,15%,7,6,1,5,3,2
127,https://vlr.gg/player/19776/jrayn,2024-10-20 14:30:00,1.64,1.09,1.35,231,297,171,20,13,7,13,6,7,11,5,6,-1,-1,0,83%,91%,75%,146,190,105,37%,38%,35%,1,0,1,2,1,1
128,https://vlr.gg/player/3549/touven,2024-10-20 14:30:00,1.29,1.30,1.29,231,207,254,19,9,10,13,5,8,14,5,9,0,-1,+1,91%,91%,92%,135,131,139,19%,19%,19%,2,0,2,2,1,1
129,https://vlr.gg/player/33523/vuexlex,2024-10-20 14:30:00,0.88,1.18,1.04,195,178,213,16,6,10,16,8,8,5,4,1,-3,-1,-2,65%,73%,58%,135,128,143,33%,20%,50%,1,1,0,4,2,2
130,https://vlr.gg/player/3604/mojj,2024-10-20 14:30:00,1.14,0.56,0.84,155,194,119,12,8,4,15,6,9,14,4,10,-1,+1,-2,70%,73%,67%,106,129,85,43%,57%,29%,1,1,0,2,0,2
131,https://vlr.gg/player/10152/padisah,2024-10-20 14:30:00,0.36,1.18,0.79,229,155,298,17,5,12,18,9,9,5,1,4,-2,-1,-1,78%,64%,92%,149,99,196,35%,46%,30%,3,2,1,5,3,2
132,https://vlr.gg/player/8369/yetujey,2024-10-20 13:30:00,1.99,0.90,1.47,294,380,200,24,17,7,16,7,9,5,3,2,+4,+3,+1,78%,83%,73%,189,246,127,40%,38%,45%,7,4,3,3,1,2
133,https://vlr.gg/player/8044/mrfalin,2024-10-20 13:30:00,1.83,0.82,1.34,245,321,164,21,15,6,17,7,10,7,3,4,+1,+1,0,65%,92%,36%,165,206,121,30%,34%,24%,1,1,0,0,0,0
134,https://vlr.gg/player/12793/xeus,2024-10-20 13:30:00,0.95,1.24,1.09,225,199,255,18,8,10,18,9,9,4,3,1,0,0,0,78%,75%,82%,158,154,163,40%,36%,44%,1,1,0,1,1,0
135,https://vlr.gg/player/1139/qraxs,2024-10-20 13:30:00,1.11,0.85,0.98,142,104,184,10,4,6,13,4,9,9,7,2,-1,0,-1,78%,92%,64%,100,80,122,24%,5%,54%,1,0,1,2,0,2
136,https://vlr.gg/player/15735/krostaly,2024-10-20 13:30:00,0.99,0.54,0.77,155,170,140,13,8,5,15,6,9,2,1,1,-3,-2,-1,65%,67%,64%,110,125,94,46%,50%,42%,2,1,1,5,3,2
137,https://vlr.gg/player/10160/izzy,2024-10-20 13:30:00,1.03,1.01,1.02,230,286,179,18,11,7,17,8,9,7,1,6,+2,+2,0,74%,73%,75%,159,201,119,29%,24%,36%,5,3,2,3,1,2
138,https://vlr.gg/player/12774/anima,2024-10-20 13:30:00,1.58,0.44,0.99,192,252,138,16,11,5,16,5,11,11,8,3,-1,0,-1,70%,91%,50%,119,145,96,28%,28%,28%,1,0,1,2,0,2
139,https://vlr.gg/player/8041/brave,2024-10-20 13:30:00,1.03,0.76,0.89,219,212,226,17,8,9,18,7,11,8,4,4,+1,+1,0,74%,91%,58%,141,150,133,37%,36%,38%,3,1,2,2,0,2
140,https://vlr.gg/player/10161/qutionerx,2024-10-20 13:30:00,0.80,0.75,0.77,204,185,222,17,8,9,18,8,10,4,2,2,-2,-1,-1,70%,64%,75%,132,117,146,15%,18%,12%,1,1,0,3,2,1
141,https://vlr.gg/player/10163/cyderx,2024-10-20 13:30:00,1.20,0.34,0.75,138,198,83,11,8,3,17,6,11,3,2,1,-1,-1,0,70%,91%,50%,116,160,75,32%,29%,40%,1,1,0,2,2,0
142,https://vlr.gg/player/10146/reazy,2024-10-20 13:30:00,1.11,1.75,1.38,292,209,404,22,10,12,15,9,6,4,1,3,+3,0,+3,76%,75%,78%,176,134,232,54%,60%,50%,5,1,4,2,1,1
143,https://vlr.gg/player/18615/batujnax,2024-10-20 13:30:00,0.75,0.94,0.83,165,144,194,11,5,6,17,10,7,9,5,4,-1,-1,0,67%,58%,78%,131,124,142,24%,19%,36%,0,0,0,1,1,0
144,https://vlr.gg/player/31307/yigox,2024-10-20 13:30:00,1.00,0.52,0.80,178,203,146,10,7,3,18,10,8,11,7,4,+1,+1,0,71%,75%,67%,134,143,121,27%,29%,24%,4,3,1,3,2,1
145,https://vlr.gg/player/11531/patrui,2024-10-20 13:30:00,0.99,0.54,0.80,174,203,135,12,8,4,15,8,7,2,2,0,+3,+2,+1,71%,75%,67%,124,144,99,35%,33%,38%,3,2,1,0,0,0
146,https://vlr.gg/player/5510/oxmann,2024-10-20 13:30:00,0.71,0.42,0.58,111,136,79,10,6,4,15,9,6,6,3,3,-3,-2,-1,62%,58%,67%,74,100,40,30%,43%,11%,0,0,0,3,2,1
147,https://vlr.gg/player/3604/mojj,2024-10-20 13:30:00,1.78,1.53,1.64,302,298,305,24,11,13,13,5,8,5,1,4,+2,0,+2,71%,56%,83%,175,183,169,32%,43%,26%,4,2,2,2,2,0
148,https://vlr.gg/player/19776/jrayn,2024-10-20 13:30:00,1.79,0.97,1.32,182,261,123,15,8,7,9,3,6,8,6,2,0,0,0,81%,78%,83%,118,167,82,44%,45%,42%,0,0,0,0,0,0
149,https://vlr.gg/player/10152/padisah,2024-10-20 13:30:00,1.42,1.17,1.28,254,241,264,19,8,11,11,4,7,9,4,5,-3,-2,-1,90%,89%,92%,164,154,172,40%,39%,41%,1,0,1,4,2,2
150,https://vlr.gg/player/3549/touven,2024-10-20 13:30:00,0.95,1.06,1.01,173,173,175,13,6,7,16,9,7,12,5,7,-1,+1,-2,67%,67%,67%,112,102,120,46%,56%,40%,1,1,0,2,0,2
151,https://vlr.gg/player/33523/vuexlex,2024-10-20 13:30:00,0.28,0.87,0.61,151,73,210,9,1,8,16,8,8,9,7,2,-1,-2,+1,67%,78%,58%,116,63,156,24%,25%,23%,3,0,3,4,2,2
152,https://vlr.gg/player/33392/zeikosha,2024-10-20 13:00:00,0.73,1.72,1.22,235,135,341,41,13,28,31,17,14,7,0,7,0,0,0,68%,63%,74%,157,87,231,32%,31%,32%,4,2,2,4,2,2
153,https://vlr.gg/player/24831/complexit,2024-10-20 13:00:00,1.21,0.84,1.03,225,242,207,34,19,15,34,18,16,14,8,6,-7,-1,-6,66%,71%,61%,164,172,155,27%,31%,23%,3,2,1,10,3,7
154,https://vlr.gg/player/45834/aidan,2024-10-20 13:00:00,0.95,0.93,0.94,204,233,175,34,20,14,37,21,16,7,3,4,+4,+1,+3,57%,67%,48%,127,145,108,22%,30%,11%,8,4,4,4,3,1
155,https://vlr.gg/player/4361/radenz,2024-10-20 13:00:00,0.73,0.97,0.85,146,133,159,23,10,13,31,18,13,15,9,6,0,-1,+1,74%,71%,78%,104,94,116,30%,35%,26%,2,1,1,2,2,0
156,https://vlr.gg/player/44548/nomiss,2024-10-20 13:00:00,0.53,0.93,0.72,152,132,173,21,10,11,33,19,14,21,9,12,-2,-1,-1,66%,54%,78%,97,79,116,19%,27%,14%,4,2,2,6,3,3
157,https://vlr.gg/player/22179/shy,2024-10-20 13:00:00,1.39,1.63,1.51,308,323,295,53,25,28,31,17,14,3,2,1,+7,+4,+3,77%,74%,79%,193,187,198,24%,26%,20%,13,7,6,6,3,3
158,https://vlr.gg/player/22381/s-mplex,2024-10-20 13:00:00,0.75,1.34,1.05,185,143,224,29,11,18,31,17,14,30,14,16,0,+1,-1,70%,61%,79%,113,89,137,26%,25%,27%,3,2,1,3,1,2
159,https://vlr.gg/player/3924/sh0utyy,2024-10-20 13:00:00,1.00,0.96,0.98,153,163,142,25,12,13,29,16,13,21,12,9,-1,+2,-3,77%,78%,75%,93,96,91,33%,38%,28%,2,2,0,3,0,3
160,https://vlr.gg/player/33732/nunmeister,2024-10-20 13:00:00,0.66,1.25,0.96,191,111,270,29,8,21,31,15,16,13,5,8,-2,-4,+2,60%,43%,75%,131,86,174,26%,18%,29%,3,0,3,5,4,1
161,https://vlr.gg/player/33875/spexleon,2024-10-20 13:00:00,0.99,0.87,0.93,193,209,179,29,17,12,31,16,15,15,2,13,+1,0,+1,62%,57%,67%,141,146,136,31%,27%,38%,5,2,3,4,2,2
162,https://vlr.gg/player/3557/skylen,2024-10-20 12:30:00,1.14,2.06,1.48,269,185,415,19,9,10,11,6,5,8,5,3,+1,0,+1,79%,75%,86%,169,121,252,40%,42%,38%,2,1,1,1,1,0
163,https://vlr.gg/player/22676/ventt,2024-10-20 12:30:00,1.25,0.97,1.15,168,184,142,11,7,4,11,7,4,8,4,4,-1,0,-1,89%,83%,100%,105,123,73,30%,35%,20%,0,0,0,1,0,1
164,https://vlr.gg/player/31855/celasun,2024-10-20 12:30:00,1.22,0.85,1.08,184,250,73,13,11,2,10,8,2,7,3,4,0,0,0,74%,75%,71%,111,151,41,38%,45%,14%,2,1,1,2,1,1
165,https://vlr.gg/player/40935/umu7,2024-10-20 12:30:00,1.35,0.32,0.97,222,284,117,15,13,2,13,7,6,5,1,4,+3,+4,-1,74%,75%,71%,135,160,93,24%,24%,27%,6,5,1,3,1,2
166,https://vlr.gg/player/10137/ip0tt,2024-10-20 12:30:00,0.58,1.58,0.95,196,115,336,12,4,8,13,8,5,10,6,4,-2,-2,0,74%,67%,86%,143,90,235,31%,21%,40%,0,0,0,2,2,0
167,https://vlr.gg/player/39357/s0pp,2024-10-20 12:30:00,1.50,1.58,1.55,369,353,379,24,8,16,14,5,9,2,1,1,+4,+2,+2,74%,71%,75%,228,202,244,29%,25%,31%,5,2,3,1,0,1
168,https://vlr.gg/player/4892/mersa,2024-10-20 12:30:00,1.20,0.58,0.81,134,204,94,8,6,2,13,5,8,12,3,9,-1,0,-1,74%,86%,67%,93,130,71,42%,50%,33%,0,0,0,1,0,1
169,https://vlr.gg/player/40843/audaz,2024-10-20 12:30:00,0.63,0.82,0.75,154,111,180,11,3,8,14,5,9,6,2,4,-2,0,-2,58%,57%,58%,100,65,121,65%,33%,79%,3,2,1,5,2,3
170,https://vlr.gg/player/13545/werlass,2024-10-20 12:30:00,0.51,0.74,0.66,117,63,148,6,1,5,14,5,9,4,1,3,-2,0,-2,53%,57%,50%,91,68,104,15%,11%,17%,0,0,0,2,0,2
171,https://vlr.gg/player/16552/pckwn,2024-10-20 12:30:00,0.45,0.60,0.55,142,150,137,9,4,5,15,6,9,3,0,3,0,-1,+1,63%,57%,67%,96,101,94,32%,67%,21%,1,0,1,1,1,0
172,https://vlr.gg/player/18615/batujnax,2024-10-20 12:10:00,1.62,1.45,1.54,245,211,288,17,8,9,10,3,7,16,12,4,-2,-1,-1,86%,100%,70%,166,134,205,24%,21%,28%,0,0,0,2,1,1
173,https://vlr.gg/player/10146/reazy,2024-10-20 12:10:00,1.39,1.05,1.24,269,282,254,19,11,8,17,8,9,10,7,3,+4,-1,+5,82%,92%,70%,187,206,165,31%,33%,29%,5,0,5,1,1,0
174,https://vlr.gg/player/31307/yigox,2024-10-20 12:10:00,1.47,0.35,0.96,232,309,139,18,14,4,17,7,10,9,4,5,+1,+2,-1,82%,83%,80%,152,206,86,24%,31%,10%,4,4,0,3,2,1
175,https://vlr.gg/player/5510/oxmann,2024-10-20 12:10:00,1.29,0.57,0.96,180,217,137,16,11,5,15,6,9,8,6,2,-4,-2,-2,64%,67%,60%,121,145,92,68%,65%,75%,0,0,0,4,2,2
176,https://vlr.gg/player/11531/patrui,2024-10-20 12:10:00,1.07,0.74,0.92,152,176,124,14,9,5,13,5,8,3,1,2,+1,0,+1,77%,83%,70%,103,116,88,29%,44%,13%,2,1,1,1,1,0
177,https://vlr.gg/player/12226/sturnn,2024-10-20 12:10:00,1.47,0.75,1.08,206,248,173,17,10,7,15,5,10,4,3,1,0,-1,+1,68%,90%,50%,123,140,110,23%,17%,30%,2,0,2,2,1,1
178,https://vlr.gg/player/21584/deminatix,2024-10-20 12:10:00,1.85,0.41,1.06,229,378,105,19,14,5,18,7,11,8,7,1,+2,+2,0,73%,90%,58%,145,246,62,28%,39%,15%,5,3,2,3,1,2
179,https://vlr.gg/player/16483/gloomy,2024-10-20 12:10:00,0.85,1.14,1.01,209,163,249,15,6,9,16,6,10,4,3,1,0,-2,+2,73%,80%,67%,148,108,182,24%,17%,27%,2,0,2,2,2,0
180,https://vlr.gg/player/11516/drky,2024-10-20 12:10:00,1.18,0.61,0.87,161,187,140,10,5,5,17,6,11,17,11,6,-1,0,-1,68%,90%,50%,101,119,85,17%,12%,25%,1,1,0,2,1,1
181,https://vlr.gg/player/10114/baha,2024-10-20 12:10:00,1.00,0.40,0.67,142,186,107,11,8,3,18,7,11,7,5,2,-1,-1,0,68%,90%,50%,101,133,74,26%,33%,19%,1,0,1,2,1,1
182,https://vlr.gg/player/13024/vuubit,2024-10-20 12:00:00,1.22,1.36,1.29,267,242,285,80,39,41,60,29,31,20,8,12,+5,+3,+2,76%,78%,73%,165,152,179,49%,57%,44%,10,4,6,5,1,4
183,https://vlr.gg/player/4214/eso177,2024-10-20 12:00:00,1.08,0.84,0.96,187,212,163,59,35,24,61,31,30,10,4,6,+1,+4,-3,66%,71%,61%,127,139,114,26%,31%,21%,6,6,0,5,2,3
184,https://vlr.gg/player/8590/killdream,2024-10-20 12:00:00,0.81,0.94,0.87,156,149,165,44,23,21,54,28,26,21,12,9,-6,-4,-2,67%,69%,66%,110,103,118,33%,29%,36%,3,0,3,9,4,5
185,https://vlr.gg/player/46179/davia,2024-10-20 12:00:00,0.67,1.06,0.85,189,174,207,58,28,30,68,37,31,12,8,4,-12,-12,0,66%,60%,73%,121,110,134,36%,37%,36%,13,5,8,25,17,8
186,https://vlr.gg/player/29998/drastz,2024-10-20 12:00:00,0.86,0.76,0.81,145,156,136,43,24,19,58,29,29,32,20,12,+2,+2,0,66%,76%,56%,93,92,94,16%,15%,18%,6,4,2,4,2,2
187,https://vlr.gg/player/402/insider,2024-10-20 12:00:00,1.03,1.08,1.06,216,228,209,64,34,30,54,27,27,12,5,7,-1,-2,+1,69%,68%,69%,147,155,139,32%,29%,35%,9,3,6,10,5,5
188,https://vlr.gg/player/443/zeddy,2024-10-20 12:00:00,1.10,0.97,1.03,180,189,174,56,29,27,53,23,30,26,13,13,+1,0,+1,71%,73%,69%,122,120,123,35%,33%,36%,6,3,3,5,3,2
189,https://vlr.gg/player/1615/destrian,2024-10-20 12:00:00,0.92,1.13,1.03,180,166,191,54,24,30,52,27,25,24,15,9,+5,+2,+3,77%,78%,76%,122,116,128,23%,23%,23%,7,3,4,2,1,1
190,https://vlr.gg/player/252/d3ffo,2024-10-20 12:00:00,1.05,1.00,1.02,227,250,206,70,38,32,61,30,31,11,3,8,+12,+8,+4,72%,78%,67%,145,155,136,22%,20%,24%,19,10,9,7,2,5
191,https://vlr.gg/player/1524/h1ber,2024-10-20 12:00:00,0.79,1.00,0.90,188,157,216,57,22,35,64,28,36,25,14,11,-7,-5,-2,71%,71%,71%,123,102,141,31%,29%,33%,7,3,4,14,8,6
192,https://vlr.gg/player/3604/mojj,2024-10-20 11:35:00,0.62,1.08,0.91,178,121,211,11,3,8,13,5,8,4,3,1,-3,-1,-2,63%,71%,58%,114,72,140,44%,38%,47%,1,0,1,4,1,3
193,https://vlr.gg/player/19776/jrayn,2024-10-20 11:35:00,1.40,0.54,0.86,168,278,104,11,7,4,15,6,9,3,0,3,-1,-1,0,68%,71%,67%,112,177,74,43%,50%,36%,1,1,0,2,2,0
194,https://vlr.gg/player/3549/touven,2024-10-20 11:35:00,0.94,0.67,0.77,157,155,159,10,5,5,15,5,10,7,3,4,0,0,0,47%,57%,42%,105,90,114,26%,33%,23%,1,0,1,1,0,1
195,https://vlr.gg/player/10152/padisah,2024-10-20 11:35:00,1.05,0.53,0.72,139,183,114,10,4,6,14,5,9,6,5,1,-2,-1,-1,68%,71%,67%,81,118,59,16%,17%,15%,0,0,0,2,1,1
196,https://vlr.gg/player/33523/vuexlex,2024-10-20 11:35:00,0.79,0.37,0.53,113,152,90,7,3,4,14,5,9,5,2,3,-3,-2,-1,53%,71%,42%,77,131,46,19%,20%,18%,2,0,2,5,2,3
197,https://vlr.gg/player/31305/lar0k,2024-10-20 11:35:00,1.36,1.63,1.46,236,199,301,17,9,8,9,5,4,9,5,4,+4,+1,+3,89%,92%,86%,138,108,187,36%,39%,33%,4,1,3,0,0,0
198,https://vlr.gg/player/24344/loita,2024-10-20 11:35:00,1.40,1.09,1.28,205,210,198,14,9,5,8,4,4,12,8,4,-1,-1,0,79%,83%,71%,151,146,160,29%,24%,38%,0,0,0,1,1,0
199,https://vlr.gg/player/40591/comeback,2024-10-20 11:35:00,1.35,1.16,1.28,234,253,204,16,11,5,10,6,4,5,3,2,+3,0,+3,89%,83%,100%,152,158,141,19%,21%,18%,4,1,3,1,1,0
200,https://vlr.gg/player/12795/crewen,2024-10-20 11:35:00,1.05,1.13,1.08,176,153,216,11,6,5,11,6,5,10,6,4,0,+1,-1,79%,75%,86%,120,101,154,39%,29%,50%,3,3,0,3,2,1
201,https://vlr.gg/player/5565/ros,2024-10-20 11:35:00,1.39,0.54,1.07,201,245,128,13,10,3,11,6,5,8,5,3,+3,+3,0,84%,92%,71%,140,178,74,31%,32%,25%,3,3,0,0,0,0
202,https://vlr.gg/player/1139/qraxs,2024-10-20 11:30:00,2.62,0.86,2.18,316,356,196,22,19,3,5,2,3,1,1,0,0,0,0,94%,100%,75%,226,258,128,45%,50%,27%,0,0,0,0,0,0
203,https://vlr.gg/player/15735/krostaly,2024-10-20 11:30:00,1.43,0.83,1.28,241,259,189,15,12,3,10,7,3,4,4,0,-3,-3,0,81%,75%,100%,167,180,128,42%,39%,60%,0,0,0,3,3,0
204,https://vlr.gg/player/12793/xeus,2024-10-20 11:30:00,1.10,0.82,1.03,293,308,250,16,12,4,14,10,4,5,5,0,+3,+3,0,75%,67%,100%,183,190,164,38%,38%,38%,5,4,1,2,1,1
205,https://vlr.gg/player/8369/yetujey,2024-10-20 11:30:00,0.86,1.39,1.00,171,161,203,11,7,4,9,7,2,2,2,0,-1,0,-1,81%,75%,100%,118,103,162,35%,20%,83%,2,2,0,3,2,1
206,https://vlr.gg/player/8044/mrfalin,2024-10-20 11:30:00,0.56,0.97,0.66,130,127,139,6,5,1,12,9,3,9,4,5,+1,0,+1,75%,67%,100%,79,76,85,17%,29%,0%,1,0,1,0,0,0
207,https://vlr.gg/player/33522/bex,2024-10-20 11:30:00,0.72,0.97,0.91,252,205,268,13,3,10,15,4,11,3,0,3,0,+1,-1,75%,75%,75%,157,136,164,31%,50%,27%,4,2,2,4,1,3
208,https://vlr.gg/player/12673/bard0lf,2024-10-20 11:30:00,1.74,0.61,0.89,180,288,144,11,5,6,13,2,11,5,1,4,+1,0,+1,63%,75%,58%,126,196,102,61%,71%,55%,1,0,1,0,0,0
209,https://vlr.gg/player/6559/destruct1vee,2024-10-20 11:30:00,0.92,0.85,0.87,200,185,205,11,3,8,13,3,10,4,0,4,-1,0,-1,88%,100%,83%,113,90,121,38%,67%,33%,0,0,0,1,0,1
210,https://vlr.gg/player/7353/glovee,2024-10-20 11:30:00,0.74,0.58,0.62,153,136,159,9,2,7,15,3,12,4,2,2,-1,-1,0,81%,100%,75%,84,85,83,12%,33%,5%,2,0,2,3,1,2
211,https://vlr.gg/player/1399/sterben,2024-10-20 11:30:00,0.58,0.43,0.47,119,121,120,6,2,4,14,3,11,3,0,3,+1,0,+1,56%,50%,58%,92,70,100,40%,20%,47%,1,0,1,0,0,0
212,https://vlr.gg/player/20032/treelover,2024-10-20 11:00:00,1.93,1.35,1.65,275,346,202,40,26,14,18,9,9,17,11,6,+2,-1,+3,84%,89%,78%,164,209,116,29%,31%,27%,4,1,3,2,2,0
213,https://vlr.gg/player/2540/happen,2024-10-20 11:00:00,1.44,1.20,1.32,213,236,192,26,15,11,19,8,11,26,12,14,-3,0,-3,95%,100%,89%,145,155,135,18%,14%,26%,1,0,1,4,0,4
214,https://vlr.gg/player/3649/litshii,2024-10-20 11:00:00,0.74,1.64,1.18,202,119,289,25,8,17,22,11,11,24,12,12,+2,-1,+3,86%,89%,83%,128,72,187,21%,11%,26%,4,1,3,2,2,0
215,https://vlr.gg/player/47270/darkwinjett,2024-10-20 11:00:00,1.34,0.99,1.17,260,259,261,35,19,16,25,11,14,8,6,2,0,-2,+2,68%,74%,61%,166,171,161,23%,21%,25%,9,5,4,9,7,2
216,https://vlr.gg/player/13238/shiio,2024-10-20 11:00:00,1.11,1.15,1.13,188,203,172,25,13,12,19,10,9,9,4,5,+2,+1,+1,81%,84%,78%,123,135,111,17%,25%,9%,2,1,1,0,0,0
217,https://vlr.gg/player/16278/oli,2024-10-20 11:00:00,0.92,0.90,0.91,166,182,152,21,11,10,25,12,13,10,7,3,+3,+1,+2,73%,67%,79%,112,122,103,24%,26%,22%,3,1,2,0,0,0
218,https://vlr.gg/player/22042/arishikii,2024-10-20 11:00:00,0.46,1.28,0.88,180,139,216,26,10,16,30,16,14,1,0,1,+1,-1,+2,68%,61%,74%,110,91,128,30%,32%,29%,5,2,3,4,3,1
219,https://vlr.gg/player/9540/rxyal,2024-10-20 11:00:00,0.83,0.78,0.81,206,191,222,24,11,13,32,14,18,4,2,2,-1,-4,+3,54%,39%,68%,148,139,156,24%,36%,19%,5,1,4,6,5,1
220,https://vlr.gg/player/10301/wheelzonfire,2024-10-20 11:00:00,1.06,0.42,0.73,174,210,144,23,14,9,32,13,19,10,5,5,-2,-1,-1,59%,67%,53%,113,139,89,32%,29%,36%,3,1,2,5,2,3
221,https://vlr.gg/player/48432/nikolaslo,2024-10-20 11:00:00,0.55,0.07,0.29,101,139,66,9,8,1,32,15,17,9,3,6,-4,-1,-3,49%,56%,42%,82,102,63,16%,15%,18%,1,1,0,5,2,3
222,https://vlr.gg/player/33551/slaughter,2024-10-20 10:30:00,1.33,1.37,1.34,216,199,239,17,9,8,10,5,5,5,3,2,+2,+1,+1,71%,75%,67%,145,132,162,37%,38%,37%,2,1,1,0,0,0
223,https://vlr.gg/player/41719/mepeezy,2024-10-20 10:30:00,1.59,0.82,1.26,233,282,168,17,11,6,12,6,6,8,7,1,-1,0,-1,67%,75%,56%,151,192,96,29%,24%,45%,0,0,0,1,0,1
224,https://vlr.gg/player/19580/logicman,2024-10-20 10:30:00,0.73,1.66,1.13,216,152,302,17,8,9,16,8,8,2,0,2,+4,0,+4,57%,50%,67%,131,77,202,29%,13%,42%,6,2,4,2,2,0
225,https://vlr.gg/player/12670/nekky,2024-10-20 10:30:00,1.02,0.56,0.82,183,246,101,14,11,3,15,9,6,7,5,2,-1,0,-1,71%,83%,56%,113,152,62,29%,27%,40%,1,1,0,2,1,1
226,https://vlr.gg/player/3599/ixeonn,2024-10-20 10:30:00,0.84,0.69,0.78,151,178,117,11,8,3,13,8,5,4,3,1,-1,+1,-2,57%,67%,44%,109,119,95,23%,25%,19%,3,3,0,4,2,2
227,https://vlr.gg/player/11516/drky,2024-10-20 10:30:00,1.19,1.44,1.33,249,204,284,18,7,11,14,5,9,6,1,5,+1,0,+1,67%,67%,67%,162,124,190,28%,18%,37%,3,1,2,2,1,1
228,https://vlr.gg/player/21584/deminatix,2024-10-20 10:30:00,1.34,0.76,1.01,240,298,197,18,10,8,16,5,11,2,0,2,-4,-1,-3,57%,56%,58%,152,184,128,36%,52%,24%,3,2,1,7,3,4
229,https://vlr.gg/player/12226/sturnn,2024-10-20 10:30:00,0.57,1.01,0.82,159,124,187,10,3,7,16,7,9,4,3,1,+2,0,+2,62%,67%,58%,105,88,118,36%,30%,40%,2,0,2,0,0,0
230,https://vlr.gg/player/16483/gloomy,2024-10-20 10:30:00,0.93,0.68,0.79,169,171,169,12,6,6,16,6,10,5,1,4,+1,+1,0,67%,67%,67%,114,110,117,24%,36%,19%,1,1,0,0,0,0
231,https://vlr.gg/player/10114/baha,2024-10-20 10:30:00,0.56,0.75,0.67,131,130,132,8,4,4,14,6,8,8,2,6,-3,-1,-2,62%,56%,67%,92,92,92,27%,44%,18%,0,0,0,3,1,2
232,https://vlr.gg/player/12774/anima,2024-10-20 10:30:00,1.29,1.45,1.38,212,198,226,17,8,9,10,5,5,8,3,5,0,0,0,82%,70%,92%,145,126,160,22%,19%,25%,0,0,0,0,0,0
233,https://vlr.gg/player/10160/izzy,2024-10-20 10:30:00,1.50,1.03,1.25,235,331,155,19,11,8,12,7,5,1,0,1,+5,+3,+2,77%,80%,75%,157,215,108,40%,41%,37%,5,3,2,0,0,0
234,https://vlr.gg/player/8041/brave,2024-10-20 10:30:00,1.24,1.22,1.23,196,200,193,15,8,7,12,7,5,14,9,5,+1,0,+1,73%,70%,75%,127,114,138,39%,58%,29%,4,1,3,3,1,2
235,https://vlr.gg/player/10161/qutionerx,2024-10-20 10:30:00,0.89,1.09,1.00,246,218,270,20,8,12,17,8,9,2,1,1,+2,0,+2,64%,60%,67%,158,157,158,19%,26%,7%,5,2,3,3,2,1
236,https://vlr.gg/player/10163/cyderx,2024-10-20 10:30:00,0.17,0.90,0.57,144,101,180,10,2,8,15,9,6,4,3,1,-2,-1,-1,68%,60%,75%,107,74,136,15%,0%,33%,0,0,0,2,1,1
237,https://vlr.gg/player/16552/pckwn,2024-10-20 10:30:00,1.43,0.72,1.11,198,233,158,15,10,5,15,7,8,7,4,3,0,+1,-1,55%,58%,50%,129,143,113,26%,23%,32%,1,1,0,1,0,1
238,https://vlr.gg/player/40843/audaz,2024-10-20 10:30:00,1.10,0.86,0.99,164,165,165,13,7,6,16,8,8,9,6,3,-3,0,-3,55%,50%,60%,89,89,88,29%,18%,54%,0,0,0,3,0,3
239,https://vlr.gg/player/39357/s0pp,2024-10-20 10:30:00,0.44,1.63,0.98,252,167,354,18,6,12,18,11,7,3,1,2,-3,-5,+2,73%,50%,100%,158,103,225,21%,27%,14%,6,2,4,9,7,2
240,https://vlr.gg/player/4892/mersa,2024-10-20 10:30:00,0.77,1.09,0.92,145,98,204,10,4,6,16,9,7,9,2,7,+1,+1,0,64%,58%,70%,110,71,156,26%,13%,35%,1,1,0,0,0,0
241,https://vlr.gg/player/13545/werlass,2024-10-20 10:30:00,0.48,0.82,0.63,130,88,181,10,3,7,16,9,7,4,3,1,-1,-1,0,55%,58%,50%,90,69,116,35%,21%,47%,0,0,0,1,1,0
242,https://vlr.gg/player/10146/reazy,2024-10-20 09:30:00,1.61,0.73,1.26,311,410,164,21,16,5,15,9,6,5,4,1,-2,0,-2,60%,75%,38%,204,270,104,40%,36%,63%,1,1,0,3,1,2
243,https://vlr.gg/player/18615/batujnax,2024-10-20 09:30:00,1.09,0.61,0.90,157,174,133,11,8,3,15,8,7,5,5,0,-1,-1,0,55%,67%,38%,99,94,105,24%,23%,25%,0,0,0,1,1,0
244,https://vlr.gg/player/5510/oxmann,2024-10-20 09:30:00,0.79,0.46,0.65,156,185,114,10,8,2,17,10,7,8,7,1,+1,-1,+2,65%,83%,38%,107,119,89,30%,29%,33%,2,0,2,1,1,0
245,https://vlr.gg/player/11531/patrui,2024-10-20 09:30:00,0.42,0.89,0.61,133,83,211,8,3,5,16,9,7,5,2,3,0,-1,+1,60%,58%,63%,92,62,138,24%,30%,21%,1,0,1,1,1,0
246,https://vlr.gg/player/31307/yigox,2024-10-20 09:30:00,0.65,0.38,0.54,148,183,98,11,8,3,18,10,8,2,2,0,+2,+3,-1,65%,83%,38%,90,109,62,24%,31%,7%,6,5,1,4,2,2
247,https://vlr.gg/player/24344/loita,2024-10-20 09:30:00,1.69,1.31,1.46,252,248,256,19,8,11,10,2,8,13,5,8,+1,0,+1,90%,88%,92%,143,139,146,33%,46%,27%,2,1,1,1,1,0
248,https://vlr.gg/player/31305/lar0k,2024-10-20 09:30:00,1.54,1.17,1.32,229,242,221,16,7,9,12,4,8,14,6,8,-2,-1,-1,85%,88%,83%,144,156,136,36%,40%,33%,1,0,1,3,1,2
249,https://vlr.gg/player/12795/crewen,2024-10-20 09:30:00,1.61,1.03,1.26,258,272,249,17,7,10,13,3,10,5,2,3,+2,+1,+1,85%,88%,83%,173,194,158,27%,30%,24%,2,1,1,0,0,0
250,https://vlr.gg/player/40591/comeback,2024-10-20 09:30:00,1.30,1.22,1.25,220,250,202,15,6,9,12,4,8,6,3,3,+1,+1,0,90%,100%,83%,144,166,130,45%,43%,46%,5,2,3,4,1,3
251,https://vlr.gg/player/5565/ros,2024-10-20 09:30:00,0.90,0.96,0.94,190,210,177,14,7,7,14,5,9,11,1,10,-2,-1,-1,80%,75%,83%,116,135,104,20%,20%,19%,0,0,0,2,1,1
252,https://vlr.gg/player/31855/celasun,2024-10-20 09:30:00,1.35,1.66,1.47,249,210,309,19,10,9,9,5,4,6,1,5,+2,0,+2,90%,83%,100%,136,121,158,31%,26%,38%,2,0,2,0,0,0
253,https://vlr.gg/player/10137/ip0tt,2024-10-20 09:30:00,0.85,1.76,1.22,195,106,330,14,4,10,11,6,5,8,5,3,0,-1,+1,85%,83%,88%,147,79,250,41%,27%,50%,1,0,1,1,1,0
254,https://vlr.gg/player/40935/umu7,2024-10-20 09:30:00,0.57,2.15,1.20,185,125,276,14,5,9,10,8,2,6,3,3,-1,-2,+1,85%,83%,88%,138,79,226,12%,10%,14%,2,1,1,3,3,0
255,https://vlr.gg/player/22676/ventt,2024-10-20 09:30:00,1.27,0.81,1.09,206,210,201,14,9,5,13,7,6,9,5,4,+5,+4,+1,85%,83%,88%,136,144,125,26%,37%,17%,6,4,2,1,0,1
256,https://vlr.gg/player/3557/skylen,2024-10-20 09:30:00,1.29,0.56,1.00,210,278,109,15,13,2,12,7,5,7,2,5,0,+1,-1,90%,92%,88%,149,196,78,38%,39%,33%,2,2,0,2,1,1
257,https://vlr.gg/player/7353/glovee,2024-10-20 09:30:00,1.16,1.30,1.24,250,261,244,17,7,10,16,8,8,6,3,3,-2,0,-2,75%,75%,75%,140,138,142,18%,19%,18%,2,1,1,4,1,3
258,https://vlr.gg/player/12673/bard0lf,2024-10-20 09:30:00,0.71,1.01,0.89,126,113,134,9,3,6,12,6,6,5,3,2,+1,0,+1,70%,63%,75%,92,97,89,32%,17%,46%,1,0,1,0,0,0
259,https://vlr.gg/player/1399/sterben,2024-10-20 09:30:00,0.97,0.78,0.86,187,199,180,12,6,6,16,6,10,1,0,1,+2,0,+2,55%,63%,50%,123,131,117,23%,19%,26%,2,0,2,0,0,0
260,https://vlr.gg/player/6559/destruct1vee,2024-10-20 09:30:00,0.64,0.68,0.66,133,180,103,9,5,4,14,7,7,5,2,3,-2,0,-2,70%,75%,67%,83,108,67,17%,5%,50%,1,1,0,3,1,2
261,https://vlr.gg/player/33522/bex,2024-10-20 09:30:00,0.02,0.61,0.33,104,54,138,8,1,7,18,8,10,0,0,0,-5,-4,-1,40%,25%,50%,72,55,82,33%,40%,30%,1,0,1,6,4,2
262,https://vlr.gg/player/4720/haodong,2024-10-20 08:20:00,,,,246,,,60,,,63,,,20,,,,,,,,,,,,,,,,,,,,
263,https://vlr.gg/player/14445/ac,2024-10-20 08:20:00,,,,233,,,55,,,54,,,16,,,,,,,,,,,,,,,,,,,,
264,https://vlr.gg/player/488/rb,2024-10-20 08:20:00,,,,213,,,51,,,53,,,14,,,,,,,,,,,,,,,,,,,,
265,https://vlr.gg/player/5011/abo,2024-10-20 08:20:00,,,,189,,,49,,,52,,,10,,,,,,,,,,,,,,,,,,,,
266,https://vlr.gg/player/30526/b1ack,2024-10-20 08:20:00,,,,131,,,29,,,55,,,38,,,,,,,,,,,,,,,,,,,,
267,https://vlr.gg/player/41054/guang,2024-10-20 08:20:00,,,,274,,,68,,,42,,,11,,,,,,,,,,,,,,,,,,,,
268,https://vlr.gg/player/39697/cb,2024-10-20 08:20:00,,,,262,,,67,,,46,,,22,,,,,,,,,,,,,,,,,,,,
269,https://vlr.gg/player/1209/swerl,2024-10-20 08:20:00,,,,243,,,59,,,52,,,19,,,,,,,,,,,,,,,,,,,,
270,https://vlr.gg/player/46460/ezeir,2024-10-20 08:20:00,,,,199,,,49,,,53,,,36,,,,,,,,,,,,,,,,,,,,
271,https://vlr.gg/player/4402/o0o0o,2024-10-20 08:20:00,,,,158,,,34,,,51,,,57,,,,,,,,,,,,,,,,,,,,
272,https://vlr.gg/player/41739/slowly,2024-10-20 06:00:00,,,,242,,,40,,,36,,,18,,,,,,,,,,,,,,,,,,,,
273,https://vlr.gg/player/3547/ninebody,2024-10-20 06:00:00,,,,239,,,36,,,38,,,11,,,,,,,,,,,,,,,,,,,,
274,https://vlr.gg/player/14444/eren,2024-10-20 06:00:00,,,,216,,,36,,,43,,,18,,,,,,,,,,,,,,,,,,,,
275,https://vlr.gg/player/3124/core,2024-10-20 06:00:00,,,,177,,,26,,,34,,,28,,,,,,,,,,,,,,,,,,,,
276,https://vlr.gg/player/14453/sunshine,2024-10-20 06:00:00,,,,151,,,25,,,32,,,11,,,,,,,,,,,,,,,,,,,,
277,https://vlr.gg/player/7841/tvirusluke,2024-10-20 06:00:00,,,,289,,,48,,,36,,,15,,,,,,,,,,,,,,,,,,,,
278,https://vlr.gg/player/31753/spiritz1,2024-10-20 06:00:00,,,,272,,,44,,,37,,,12,,,,,,,,,,,,,,,,,,,,
279,https://vlr.gg/player/3741/vo0kashu,2024-10-20 06:00:00,,,,209,,,36,,,25,,,13,,,,,,,,,,,,,,,,,,,,
280,https://vlr.gg/player/11524/nicc,2024-10-20 06:00:00,,,,206,,,31,,,30,,,24,,,,,,,,,,,,,,,,,,,,
281,https://vlr.gg/player/41774/shion7,2024-10-20 06:00:00,,,,165,,,24,,,35,,,23,,,,,,,,,,,,,,,,,,,,
282,https://vlr.gg/player/13232/muffyn,2024-10-20 05:00:00,,,,312,,,73,,,47,,,23,,,,,,,,,,,,,,,,,,,,
283,https://vlr.gg/player/48160/laiyin,2024-10-20 05:00:00,,,,225,,,58,,,43,,,24,,,,,,,,,,,,,,,,,,,,
284,https://vlr.gg/player/25415/yusin,2024-10-20 05:00:00,,,,210,,,49,,,41,,,22,,,,,,,,,,,,,,,,,,,,
285,https://vlr.gg/player/1909/jinny,2024-10-20 05:00:00,,,,186,,,49,,,38,,,33,,,,,,,,,,,,,,,,,,,,
286,https://vlr.gg/player/48161/1hp,2024-10-20 05:00:00,,,,147,,,31,,,41,,,28,,,,,,,,,,,,,,,,,,,,
287,https://vlr.gg/player/48205/x1aowen,2024-10-20 05:00:00,,,,208,,,51,,,47,,,14,,,,,,,,,,,,,,,,,,,,
288,https://vlr.gg/player/17447/alyssa,2024-10-20 05:00:00,,,,206,,,51,,,50,,,11,,,,,,,,,,,,,,,,,,,,
289,https://vlr.gg/player/48206/7er,2024-10-20 05:00:00,,,,165,,,42,,,54,,,11,,,,,,,,,,,,,,,,,,,,
290,https://vlr.gg/player/25443/bambi,2024-10-20 05:00:00,,,,158,,,33,,,51,,,20,,,,,,,,,,,,,,,,,,,,
291,https://vlr.gg/player/48207/elina,2024-10-20 05:00:00,,,,155,,,33,,,58,,,13,,,,,,,,,,,,,,,,,,,,
292,https://vlr.gg/player/29833/izu,2024-10-20 03:50:00,1.56,1.39,1.47,265,263,263,73,35,38,43,19,24,27,11,16,+10,+5,+5,84%,86%,83%,173,170,175,33%,38%,29%,14,7,7,4,2,2
293,https://vlr.gg/player/13039/meteor,2024-10-20 03:50:00,1.31,1.48,1.40,279,249,292,74,32,42,48,23,25,25,12,13,+1,-2,+3,75%,81%,71%,191,174,205,33%,27%,38%,10,3,7,9,5,4
294,https://vlr.gg/player/804/buzz,2024-10-20 03:50:00,0.76,1.33,1.06,220,195,240,61,26,35,50,27,23,10,3,7,-1,-3,+2,75%,75%,76%,140,124,154,19%,17%,20%,11,5,6,12,8,4
295,https://vlr.gg/player/4056/sylvan,2024-10-20 03:50:00,0.98,1.00,0.99,170,181,163,47,23,24,49,26,23,43,22,21,+2,+1,+1,84%,89%,80%,116,128,107,39%,44%,34%,6,1,5,4,0,4
296,https://vlr.gg/player/485/stax,2024-10-20 03:50:00,0.90,0.82,0.86,135,165,114,38,21,17,49,24,25,30,9,21,-3,-3,0,77%,69%,83%,92,114,72,21%,17%,29%,2,1,1,5,4,1
297,https://vlr.gg/player/424/dep,2024-10-20 03:50:00,0.91,1.62,1.24,267,237,310,78,35,43,57,33,24,5,3,2,-3,-8,+5,58%,49%,69%,160,134,189,29%,29%,30%,13,5,8,16,13,3
298,https://vlr.gg/player/12990/syouta,2024-10-20 03:50:00,0.98,0.67,0.84,175,197,160,51,29,22,59,31,28,12,8,4,+1,+1,0,66%,61%,72%,120,129,109,37%,34%,40%,4,3,1,3,2,1
299,https://vlr.gg/player/6668/sugarz3ro,2024-10-20 03:50:00,0.69,0.86,0.77,151,129,184,41,19,22,60,31,29,35,14,21,-2,-3,+1,70%,66%,75%,101,85,118,36%,33%,38%,7,3,4,9,6,3
300,https://vlr.gg/player/25221/xdll,2024-10-20 03:50:00,0.81,0.64,0.73,145,153,143,37,22,15,61,31,30,23,12,11,0,+3,-3,64%,63%,64%,104,106,101,31%,35%,27%,8,4,4,8,1,7
301,https://vlr.gg/player/2615/clz,2024-10-20 03:50:00,0.60,0.73,0.66,127,121,138,32,15,17,56,30,26,31,17,14,-5,-4,-1,65%,63%,67%,81,83,80,19%,18%,20%,2,0,2,7,4,3
302,https://vlr.gg/player/23930/potter,2024-10-20 03:00:00,1.32,1.67,1.52,329,303,354,51,19,32,28,13,15,10,3,7,0,0,0,76%,67%,83%,190,177,201,36%,40%,33%,9,4,5,9,4,5
303,https://vlr.gg/player/2366/alert,2024-10-20 03:00:00,1.10,1.27,1.20,256,280,226,39,18,21,27,14,13,7,4,3,+5,+3,+2,81%,83%,79%,151,168,138,30%,41%,22%,7,4,3,2,1,1
304,https://vlr.gg/player/12289/siraww,2024-10-20 03:00:00,1.06,1.27,1.18,246,204,265,35,14,21,28,12,16,15,5,10,+3,0,+3,74%,67%,79%,168,134,193,32%,30%,33%,4,0,4,1,0,1
305,https://vlr.gg/player/1908/kongared,2024-10-20 03:00:00,0.69,1.18,0.97,159,126,187,22,8,14,24,12,12,23,8,15,-1,0,-1,76%,78%,75%,110,84,129,32%,26%,36%,1,0,1,2,0,2
306,https://vlr.gg/player/2368/b3ta,2024-10-20 03:00:00,0.71,0.92,0.83,165,189,141,25,12,13,27,14,13,16,7,9,-1,-3,+2,79%,83%,75%,108,122,97,41%,48%,36%,3,1,2,4,4,0
307,https://vlr.gg/player/23896/itaoearth,2024-10-20 03:00:00,0.74,1.96,1.26,239,184,289,35,14,21,30,20,10,17,6,11,-2,-2,0,69%,58%,83%,144,115,182,39%,38%,41%,5,3,2,7,5,2
308,https://vlr.gg/player/31497/allr1ghtt,2024-10-20 03:00:00,1.17,1.10,1.14,211,207,233,32,19,13,32,17,15,9,2,7,+3,0,+3,81%,75%,89%,157,151,165,34%,44%,24%,4,1,3,1,1,0
309,https://vlr.gg/player/40546/georgebest,2024-10-20 03:00:00,0.84,0.79,0.82,211,237,186,31,19,12,38,22,16,4,0,4,+1,+1,0,67%,63%,72%,143,149,136,32%,37%,26%,5,3,2,4,2,2
310,https://vlr.gg/player/48482/examp1e,2024-10-20 03:00:00,0.77,0.89,0.82,165,145,202,22,12,10,33,19,14,17,8,9,-4,-2,-2,62%,54%,72%,119,95,152,23%,26%,21%,1,0,1,5,2,3
311,https://vlr.gg/player/40547/zuokew,2024-10-20 03:00:00,0.22,0.59,0.34,95,76,132,14,5,9,39,23,16,5,2,3,-4,-3,-1,62%,54%,72%,67,51,89,43%,35%,50%,3,2,1,7,5,2
312,https://vlr.gg/player/24895/jemkin,2024-10-20 02:45:00,1.75,2.07,1.87,314,317,310,24,15,9,8,6,2,4,2,2,+2,+1,+1,84%,75%,100%,202,215,181,42%,54%,25%,2,1,1,0,0,0
313,https://vlr.gg/player/25255/primmie,2024-10-20 02:45:00,1.66,1.94,1.76,327,333,316,24,15,9,11,8,3,5,3,2,+3,+3,0,84%,75%,100%,206,204,208,28%,25%,38%,4,4,0,1,1,0
314,https://vlr.gg/player/6702/bazz,2024-10-20 02:45:00,0.84,1.65,1.14,183,119,294,12,5,7,10,6,4,5,1,4,+1,-1,+2,89%,83%,100%,109,75,167,34%,60%,24%,2,0,2,1,1,0
315,https://vlr.gg/player/48577/gyen,2024-10-20 02:45:00,0.60,1.05,0.76,159,128,214,10,5,5,13,7,6,6,4,2,0,+1,-1,74%,75%,71%,124,93,176,34%,27%,43%,2,2,0,2,1,1
316,https://vlr.gg/player/13788/jitboys,2024-10-20 02:45:00,0.60,0.46,0.55,143,142,146,9,6,3,14,8,6,9,6,3,-3,-2,-1,63%,67%,57%,95,90,104,24%,25%,23%,1,0,1,4,2,2
317,https://vlr.gg/player/4052/jinboong,2024-10-20 02:45:00,1.10,1.01,1.04,221,287,183,14,7,7,15,7,8,2,0,2,0,-1,+1,63%,57%,67%,150,199,121,34%,44%,27%,2,1,1,2,2,0
318,https://vlr.gg/player/4866/kushy,2024-10-20 02:45:00,0.38,1.32,0.97,226,147,272,14,4,10,16,7,9,8,2,6,-1,0,-1,68%,71%,67%,142,81,178,24%,27%,23%,0,0,0,1,0,1
319,https://vlr.gg/player/3980/governor,2024-10-20 02:45:00,0.73,0.87,0.82,163,211,135,10,5,5,14,7,7,2,1,1,+2,+1,+1,68%,71%,67%,128,144,119,35%,33%,36%,3,1,2,1,0,1
320,https://vlr.gg/player/8497/monyet,2024-10-20 02:45:00,0.18,0.99,0.69,171,97,215,10,2,8,17,7,10,4,1,3,+1,-1,+2,53%,43%,58%,128,75,160,26%,33%,24%,3,1,2,2,2,0
321,https://vlr.gg/player/2400/brofeld,2024-10-20 02:45:00,0.48,0.39,0.43,113,107,116,7,2,5,17,6,11,4,0,4,-5,0,-5,58%,57%,58%,82,91,77,30%,22%,36%,0,0,0,5,0,5
322,https://vlr.gg/player/25535/vickyz,2024-10-20 01:00:00,1.03,1.77,1.43,273,220,322,41,15,26,26,13,13,13,4,9,+3,-2,+5,85%,79%,91%,166,127,200,18%,13%,21%,7,2,5,4,4,0
323,https://vlr.gg/player/27225/d4rf,2024-10-20 01:00:00,1.03,1.61,1.34,233,181,270,37,13,24,25,12,13,19,8,11,-1,-2,+1,85%,79%,91%,141,108,171,38%,40%,37%,2,0,2,3,2,1
324,https://vlr.gg/player/31498/lorangez,2024-10-20 01:00:00,0.93,1.21,1.08,185,180,195,28,12,16,27,13,14,13,2,11,+1,-2,+3,73%,74%,73%,117,116,118,33%,33%,33%,6,1,5,5,3,2
325,https://vlr.gg/player/12291/arpoom,2024-10-20 01:00:00,1.01,1.03,1.02,172,160,181,22,11,11,26,12,14,21,8,13,-5,-2,-3,76%,84%,68%,127,115,137,29%,35%,26%,0,0,0,5,2,3
326,https://vlr.gg/player/16977/socools0da,2024-10-20 01:00:00,1.25,0.82,1.02,202,274,138,26,18,8,24,11,13,9,3,6,+3,+1,+2,76%,79%,73%,137,177,103,28%,33%,23%,6,3,3,3,2,1
327,https://vlr.gg/player/31537/basbabe,2024-10-20 01:00:00,0.88,1.39,1.11,220,161,299,33,13,20,32,16,16,24,15,9,+3,-1,+4,80%,82%,79%,146,102,198,31%,19%,43%,5,1,4,2,2,0
328,https://vlr.gg/player/20623/harddora,2024-10-20 01:00:00,1.40,0.62,1.04,228,292,154,33,24,9,30,15,15,9,4,5,+2,+3,-1,61%,68%,53%,141,175,103,28%,29%,26%,6,4,2,4,1,3
329,https://vlr.gg/player/35071/cher0z,2024-10-20 01:00:00,0.87,1.05,0.96,183,173,190,25,14,11,27,16,11,10,4,6,+2,0,+2,66%,59%,74%,122,106,141,34%,28%,43%,3,0,3,1,0,1
330,https://vlr.gg/player/17303/fontuz,2024-10-20 01:00:00,0.57,0.89,0.72,168,165,165,22,12,10,32,19,13,13,5,8,-1,-3,+2,63%,59%,68%,116,118,114,18%,12%,32%,4,1,3,5,4,1
331,https://vlr.gg/player/23892/ayanokoji,2024-10-20 01:00:00,0.15,0.85,0.47,113,69,165,15,4,11,33,19,14,10,6,4,-7,-7,0,66%,59%,74%,79,54,108,24%,14%,32%,2,1,1,9,8,1
332,https://vlr.gg/player/424/dep,2024-10-19 22:45:00,1.06,1.17,1.11,238,237,248,57,28,29,48,26,22,9,5,4,+7,+1,+6,78%,79%,76%,163,165,162,28%,33%,23%,15,7,8,8,6,2
333,https://vlr.gg/player/6668/sugarz3ro,2024-10-19 22:45:00,1.04,0.98,1.01,172,174,167,40,21,19,46,24,22,35,19,16,-4,-2,-2,75%,79%,70%,115,113,117,29%,28%,30%,2,2,0,6,4,2
334,https://vlr.gg/player/25221/xdll,2024-10-19 22:45:00,0.67,1.21,0.94,202,172,232,47,18,29,50,27,23,18,7,11,-2,-1,-1,67%,56%,79%,134,111,157,26%,25%,27%,6,2,4,8,3,5
335,https://vlr.gg/player/12990/syouta,2024-10-19 22:45:00,0.95,0.92,0.93,175,187,169,44,23,21,48,24,24,13,4,9,-1,-4,+3,76%,74%,79%,124,134,113,31%,33%,30%,4,1,3,5,5,0
336,https://vlr.gg/player/2615/clz,2024-10-19 22:45:00,1.07,0.76,0.92,178,184,176,41,22,19,49,23,26,29,14,15,-3,-2,-1,73%,65%,82%,120,128,112,24%,27%,22%,5,1,4,8,3,5
337,https://vlr.gg/player/6672/meiy,2024-10-19 22:45:00,0.97,1.32,1.15,234,219,262,57,26,31,46,25,21,15,8,7,+1,0,+1,76%,73%,79%,150,132,168,23%,23%,23%,13,8,5,12,8,4
338,https://vlr.gg/player/48577/gyen,2024-10-19 22:45:00,1.13,1.14,1.14,219,195,245,53,24,29,48,23,25,31,19,12,+1,-1,+2,81%,79%,82%,143,125,160,32%,33%,32%,7,2,5,6,3,3
339,https://vlr.gg/player/10627/art,2024-10-19 22:45:00,1.24,0.95,1.09,219,245,193,49,27,22,44,22,22,17,9,8,+6,+3,+3,78%,73%,82%,136,147,126,10%,14%,6%,8,3,5,2,0,2
340,https://vlr.gg/player/13002/akame,2024-10-19 22:45:00,0.91,1.03,0.97,186,176,187,41,20,21,45,23,22,20,11,9,-6,-4,-2,69%,73%,65%,126,114,139,24%,23%,25%,2,1,1,8,5,3
341,https://vlr.gg/player/4052/jinboong,2024-10-19 22:45:00,0.85,0.90,0.87,168,165,175,41,20,21,46,24,22,14,7,7,+1,-3,+4,78%,76%,79%,119,117,120,30%,34%,26%,5,0,5,4,3,1
342,https://vlr.gg/player/9185/dodonut,2024-10-19 17:00:00,1.42,1.28,1.36,264,279,240,96,61,35,60,36,24,23,11,12,+8,+4,+4,73%,75%,70%,161,163,157,25%,26%,23%,20,11,9,12,7,5
343,https://vlr.gg/player/33694/evv,2024-10-19 17:00:00,0.71,1.73,1.14,223,151,316,83,32,51,71,48,23,39,23,16,+1,0,+1,77%,67%,91%,139,95,201,30%,31%,29%,6,3,3,5,3,2
344,https://vlr.gg/player/8329/starbound,2024-10-19 17:00:00,1.04,1.14,1.08,217,215,224,83,47,36,69,40,29,19,11,8,+3,+3,0,81%,78%,84%,140,141,137,16%,16%,16%,15,9,6,12,6,6
345,https://vlr.gg/player/17/theia,2024-10-19 17:00:00,1.17,0.84,1.03,161,183,139,58,39,19,61,34,27,38,22,16,-1,0,-1,79%,80%,77%,115,129,95,25%,26%,22%,6,4,2,7,4,3
346,https://vlr.gg/player/8849/sonder,2024-10-19 17:00:00,1.09,0.84,0.98,229,238,191,78,50,28,74,42,32,37,23,14,-3,-4,+1,77%,77%,77%,139,154,118,26%,24%,30%,8,4,4,11,8,3
347,https://vlr.gg/player/14403/marceline,2024-10-19 17:00:00,0.60,1.17,0.92,216,143,275,79,23,56,82,36,46,9,3,6,-2,-4,+2,58%,53%,62%,132,91,162,29%,23%,33%,18,5,13,20,9,11
348,https://vlr.gg/player/19556/melya,2024-10-19 17:00:00,1.18,0.70,0.90,188,237,159,68,37,31,77,30,47,27,12,15,-2,+1,-3,67%,72%,63%,126,153,106,33%,39%,27%,5,1,4,7,0,7
349,https://vlr.gg/player/28870/k0rupt,2024-10-19 17:00:00,0.89,0.86,0.87,188,200,188,66,29,37,80,36,44,27,11,16,0,+1,-1,64%,67%,62%,130,132,128,28%,29%,27%,7,4,3,7,3,4
350,https://vlr.gg/player/30700/elab0rate,2024-10-19 17:00:00,0.71,0.90,0.82,173,161,188,65,24,41,83,34,49,18,7,11,-2,-1,-1,62%,63%,62%,114,102,123,31%,34%,30%,10,6,4,12,7,5
351,https://vlr.gg/player/32667/nora,2024-10-19 17:00:00,0.68,0.79,0.74,163,154,169,57,22,35,78,34,44,22,9,13,-2,-3,+1,58%,47%,67%,106,97,112,34%,38%,32%,8,3,5,10,6,4
352,https://vlr.gg/player/15735/krostaly,2024-10-19 15:25:00,1.01,1.40,1.18,222,183,274,17,8,9,15,9,6,1,1,0,+1,+1,0,71%,75%,67%,138,111,175,35%,26%,43%,1,1,0,0,0,0
353,https://vlr.gg/player/8369/yetujey,2024-10-19 15:25:00,0.77,1.36,1.02,230,208,261,18,9,9,17,12,5,2,1,1,+3,+1,+2,67%,50%,89%,155,152,158,44%,43%,44%,5,3,2,2,2,0
354,https://vlr.gg/player/12793/xeus,2024-10-19 15:25:00,0.82,1.24,1.00,248,192,323,17,7,10,17,10,7,4,4,0,+3,0,+3,86%,83%,89%,152,132,179,23%,29%,19%,6,2,4,3,2,1
355,https://vlr.gg/player/8044/mrfalin,2024-10-19 15:25:00,1.04,0.84,0.95,198,197,201,15,8,7,16,9,7,5,1,4,-2,-1,-1,67%,67%,67%,131,136,123,37%,45%,28%,0,0,0,2,1,1
356,https://vlr.gg/player/1139/qraxs,2024-10-19 15:25:00,0.24,0.14,0.20,69,67,73,5,3,2,18,10,8,2,0,2,-2,-1,-1,43%,42%,44%,43,37,50,19%,29%,11%,0,0,0,2,1,1
357,https://vlr.gg/player/8041/brave,2024-10-19 15:25:00,1.65,1.40,1.51,348,367,334,25,11,14,16,7,9,12,3,9,+1,0,+1,81%,78%,83%,240,265,221,35%,45%,28%,3,1,2,2,1,1
358,https://vlr.gg/player/10161/qutionerx,2024-10-19 15:25:00,1.29,1.19,1.23,221,262,191,18,9,9,14,7,7,4,0,4,-2,-3,+1,86%,78%,92%,148,175,128,37%,53%,20%,4,2,2,6,5,1
359,https://vlr.gg/player/10163/cyderx,2024-10-19 15:25:00,0.56,1.57,1.14,204,140,253,16,4,12,14,8,6,4,2,2,0,0,0,81%,78%,83%,143,98,177,48%,40%,52%,0,0,0,0,0,0
360,https://vlr.gg/player/10160/izzy,2024-10-19 15:25:00,0.70,1.04,0.89,159,124,185,13,4,9,14,7,7,5,4,1,-1,0,-1,67%,56%,75%,109,85,128,41%,24%,59%,2,0,2,3,0,3
361,https://vlr.gg/player/12774/anima,2024-10-19 15:25:00,0.73,0.97,0.87,153,159,149,11,5,6,14,8,6,12,5,7,-1,0,-1,71%,67%,75%,114,96,127,19%,44%,13%,0,0,0,1,0,1
362,https://vlr.gg/player/19776/jrayn,2024-10-19 15:15:00,0.44,1.14,1.00,251,124,284,12,1,11,14,3,11,4,0,4,+1,0,+1,73%,33%,83%,161,89,179,44%,17%,50%,2,0,2,1,0,1
363,https://vlr.gg/player/10152/padisah,2024-10-19 15:15:00,0.94,0.52,0.60,132,171,123,7,2,5,13,3,10,5,1,4,-4,0,-4,60%,33%,67%,74,82,72,26%,33%,24%,0,0,0,4,0,4
364,https://vlr.gg/player/3549/touven,2024-10-19 15:15:00,0.22,0.68,0.59,127,130,127,6,1,5,12,3,9,2,0,2,-1,+1,-2,53%,33%,58%,88,91,87,27%,25%,28%,1,1,0,2,0,2
365,https://vlr.gg/player/33523/vuexlex,2024-10-19 15:15:00,0.02,0.70,0.53,195,28,237,7,0,7,14,3,11,3,1,2,-2,-1,-1,40%,33%,42%,150,28,181,32%,100%,30%,1,0,1,3,1,2
366,https://vlr.gg/player/3604/mojj,2024-10-19 15:15:00,0.01,0.70,0.50,107,19,129,6,0,6,14,3,11,0,0,0,-1,-1,0,47%,33%,50%,75,19,89,20%,0%,22%,0,0,0,1,1,0
367,https://vlr.gg/player/33551/slaughter,2024-10-19 15:15:00,1.80,2.10,1.86,264,235,384,16,12,4,4,3,1,10,6,4,+1,0,+1,80%,75%,100%,164,153,211,24%,21%,36%,2,1,1,1,1,0
368,https://vlr.gg/player/19580/logicman,2024-10-19 15:15:00,1.33,3.33,1.73,325,277,520,18,12,6,7,7,0,6,5,1,+1,+1,0,73%,67%,100%,193,163,311,32%,37%,26%,1,1,0,0,0,0
369,https://vlr.gg/player/41719/mepeezy,2024-10-19 15:15:00,1.37,0.52,1.20,218,271,9,12,12,0,8,7,1,4,4,0,0,+1,-1,93%,92%,100%,148,182,9,31%,32%,0%,1,1,0,1,0,1
370,https://vlr.gg/player/12670/nekky,2024-10-19 15:15:00,0.75,2.21,1.05,193,136,427,11,6,5,10,9,1,7,6,1,+2,+1,+1,93%,92%,100%,116,83,248,25%,45%,12%,2,1,1,0,0,0
371,https://vlr.gg/player/3599/ixeonn,2024-10-19 15:15:00,1.21,0.41,1.05,211,264,,10,10,0,9,8,1,3,3,0,+3,+3,0,87%,92%,67%,144,180,,32%,32%,,5,5,0,2,2,0
372,https://vlr.gg/player/24344/loita,2024-10-19 14:20:00,1.37,0.85,1.10,251,267,238,20,10,10,19,8,11,5,4,1,0,-1,+1,61%,64%,58%,159,152,165,39%,38%,39%,4,2,2,4,3,1
373,https://vlr.gg/player/31305/lar0k,2024-10-19 14:20:00,0.96,1.10,1.03,145,133,157,12,5,7,13,6,7,7,3,4,+1,0,+1,83%,82%,83%,109,97,119,21%,29%,16%,1,0,1,0,0,0
374,https://vlr.gg/player/40591/comeback,2024-10-19 14:20:00,1.05,0.77,0.90,155,184,129,14,8,6,14,7,7,1,0,1,+1,+2,-1,70%,82%,58%,97,110,85,38%,64%,26%,3,2,1,2,0,2
375,https://vlr.gg/player/12795/crewen,2024-10-19 14:20:00,0.37,1.27,0.84,214,113,308,17,4,13,18,10,8,2,1,1,0,-1,+1,52%,18%,83%,140,84,192,25%,36%,22%,2,0,2,2,1,1
376,https://vlr.gg/player/5565/ros,2024-10-19 14:20:00,0.86,0.79,0.82,153,155,152,11,6,5,14,7,7,6,2,4,-1,+1,-2,74%,73%,75%,115,112,117,37%,42%,33%,2,2,0,3,1,2
377,https://vlr.gg/player/21584/deminatix,2024-10-19 14:20:00,0.74,2.12,1.40,304,192,428,24,7,17,15,10,5,2,2,0,+3,-1,+4,78%,67%,91%,192,141,248,34%,44%,28%,7,2,5,4,3,1
378,https://vlr.gg/player/10114/baha,2024-10-19 14:20:00,1.66,0.58,1.14,203,300,97,17,13,4,14,7,7,6,3,3,0,+2,-2,70%,83%,55%,133,192,69,32%,27%,50%,3,3,0,3,1,2
379,https://vlr.gg/player/11516/drky,2024-10-19 14:20:00,0.69,1.40,1.03,176,108,251,15,6,9,14,8,6,6,1,5,-1,-1,0,70%,58%,82%,109,68,154,24%,20%,27%,0,0,0,1,1,0
380,https://vlr.gg/player/12226/sturnn,2024-10-19 14:20:00,1.15,0.58,0.88,162,198,124,12,8,4,15,8,7,5,4,1,-1,0,-1,70%,75%,64%,100,113,86,28%,33%,22%,1,1,0,2,1,1
381,https://vlr.gg/player/16483/gloomy,2024-10-19 14:20:00,0.73,0.54,0.64,140,138,143,10,6,4,16,8,8,7,3,4,-2,0,-2,83%,92%,73%,96,89,104,23%,40%,7%,0,0,0,2,0,2
382,https://vlr.gg/player/29553/dagg3r,2024-10-19 14:00:00,1.44,0.85,1.16,204,248,161,49,33,16,44,21,23,17,5,12,-1,0,-1,70%,77%,63%,137,163,108,52%,61%,42%,3,1,2,4,1,3
383,https://vlr.gg/player/5854/z3ro,2024-10-19 14:00:00,0.98,1.19,1.08,190,180,202,45,22,23,46,24,22,30,16,14,-3,-5,+2,72%,74%,69%,131,133,129,31%,33%,29%,5,2,3,8,7,1
384,https://vlr.gg/player/3784/katu,2024-10-19 14:00:00,0.74,1.28,1.00,254,209,303,59,25,34,53,29,24,8,3,5,+5,-1,+6,66%,63%,69%,162,138,188,34%,31%,37%,13,6,7,8,7,1
385,https://vlr.gg/player/2313/feqew,2024-10-19 14:00:00,0.76,0.78,0.77,149,146,154,35,19,16,53,27,26,11,4,7,+3,+2,+1,64%,63%,66%,100,94,106,28%,28%,27%,6,3,3,3,1,2
386,https://vlr.gg/player/173/l0udly,2024-10-19 14:00:00,1.03,0.35,0.71,156,187,122,35,24,11,52,23,29,15,6,9,+1,+1,0,61%,66%,56%,101,117,84,43%,49%,36%,9,4,5,8,3,5
387,https://vlr.gg/player/443/zeddy,2024-10-19 14:00:00,1.10,1.28,1.19,225,221,229,52,24,28,41,19,22,20,15,5,+1,-2,+3,79%,84%,74%,146,142,150,32%,25%,42%,6,1,5,5,3,2
388,https://vlr.gg/player/1615/destrian,2024-10-19 14:00:00,1.23,0.94,1.08,194,202,187,48,25,23,41,17,24,22,11,11,-1,0,-1,79%,84%,74%,133,145,122,33%,37%,29%,3,3,0,4,3,1
389,https://vlr.gg/player/402/insider,2024-10-19 14:00:00,1.16,0.93,1.04,201,222,183,49,26,23,42,20,22,18,8,10,-5,-5,0,70%,59%,80%,135,156,117,28%,26%,31%,3,1,2,8,6,2
390,https://vlr.gg/player/252/d3ffo,2024-10-19 14:00:00,1.13,0.87,0.99,209,214,205,53,28,25,48,22,26,5,3,2,0,-2,+2,73%,81%,66%,131,138,124,24%,34%,15%,11,3,8,11,5,6
391,https://vlr.gg/player/1524/h1ber,2024-10-19 14:00:00,1.00,0.86,0.93,214,211,217,46,21,25,51,22,29,29,15,14,0,+1,-1,75%,78%,71%,145,142,147,28%,28%,28%,8,4,4,8,3,5
392,https://vlr.gg/player/1399/sterben,2024-10-19 14:00:00,0.89,2.11,1.50,251,199,304,23,8,15,18,12,6,10,2,8,-2,0,-2,77%,77%,77%,172,156,187,33%,35%,31%,2,2,0,4,2,2
393,https://vlr.gg/player/6559/destruct1vee,2024-10-19 14:00:00,1.84,0.66,1.25,255,301,210,24,16,8,20,9,11,10,4,6,+1,0,+1,65%,69%,62%,158,188,127,40%,46%,30%,2,0,2,1,0,1
394,https://vlr.gg/player/12673/bard0lf,2024-10-19 14:00:00,1.42,0.77,1.09,207,242,173,21,12,9,20,10,10,5,3,2,-1,-1,0,69%,62%,77%,128,142,114,46%,59%,35%,0,0,0,1,1,0
395,https://vlr.gg/player/33522/bex,2024-10-19 14:00:00,0.30,1.09,0.69,192,142,243,16,5,11,22,13,9,4,2,2,+2,-1,+3,65%,62%,69%,124,93,155,15%,19%,11%,7,3,4,5,4,1
396,https://vlr.gg/player/7353/glovee,2024-10-19 14:00:00,0.38,0.87,0.63,120,119,123,10,4,6,19,12,7,9,7,2,-2,-1,-1,69%,77%,62%,80,68,91,21%,13%,26%,1,0,1,3,1,2
397,https://vlr.gg/player/16552/pckwn,2024-10-19 14:00:00,1.54,1.36,1.45,308,332,286,27,15,12,17,9,8,11,4,7,0,0,0,92%,85%,100%,225,229,220,30%,21%,44%,1,1,0,1,1,0
398,https://vlr.gg/player/13545/werlass,2024-10-19 14:00:00,1.09,1.20,1.15,264,237,292,24,10,14,18,9,9,11,4,7,+2,+1,+1,85%,77%,92%,165,154,176,14%,19%,10%,4,2,2,2,1,1
399,https://vlr.gg/player/40843/audaz,2024-10-19 14:00:00,0.43,1.75,1.09,194,97,291,21,5,16,17,10,7,6,3,3,-3,-2,-1,73%,62%,85%,140,54,226,42%,43%,42%,0,0,0,3,2,1
400,https://vlr.gg/player/39357/s0pp,2024-10-19 14:00:00,0.75,0.59,0.67,181,174,189,17,8,9,23,11,12,5,3,2,+3,0,+3,69%,69%,69%,121,116,126,24%,26%,23%,5,0,5,2,0,2
401,https://vlr.gg/player/4892/mersa,2024-10-19 14:00:00,0.55,0.57,0.56,124,135,115,10,5,5,19,10,9,12,7,5,0,0,0,73%,77%,69%,79,75,82,14%,15%,13%,4,3,1,4,3,1
402,https://vlr.gg/player/27813/zery,2024-10-19 13:25:00,0.72,2.14,1.33,275,178,384,65,21,44,39,30,9,13,9,4,+5,-1,+6,81%,72%,93%,163,113,231,24%,28%,22%,12,5,7,7,6,1
403,https://vlr.gg/player/27954/movi,2024-10-19 13:25:00,0.84,1.79,1.25,209,150,294,45,18,27,38,28,10,39,15,24,+4,0,+4,84%,72%,100%,135,98,186,31%,20%,40%,5,1,4,1,1,0
404,https://vlr.gg/player/39062/terrox,2024-10-19 13:25:00,1.08,1.42,1.23,245,241,258,52,29,23,41,28,13,19,9,10,+2,-4,+6,78%,67%,93%,168,166,170,27%,30%,24%,7,1,6,5,5,0
405,https://vlr.gg/player/15382/kongi,2024-10-19 13:25:00,1.04,1.06,1.05,181,215,146,40,26,14,38,27,11,20,10,10,-3,-3,0,71%,64%,81%,132,158,97,38%,34%,48%,3,1,2,6,4,2
406,https://vlr.gg/player/12514/spocki,2024-10-19 13:25:00,0.70,0.92,0.79,152,148,153,33,20,13,44,30,14,28,11,17,-7,-4,-3,71%,72%,70%,96,89,106,23%,21%,26%,5,4,1,12,8,4
407,https://vlr.gg/player/35513/samed,2024-10-19 13:25:00,0.57,2.04,1.40,323,166,439,73,15,58,48,25,23,9,1,8,+5,-5,+10,68%,48%,83%,199,109,266,26%,35%,23%,19,4,15,14,9,5
408,https://vlr.gg/player/18374/sevkaan,2024-10-19 13:25:00,0.78,1.14,0.98,190,134,232,42,13,29,44,22,22,6,1,5,+2,-1,+3,60%,44%,72%,135,95,164,26%,22%,28%,4,1,3,2,2,0
409,https://vlr.gg/player/7231/kya,2024-10-19 13:25:00,0.51,1.06,0.82,156,133,166,30,10,20,44,25,19,17,5,12,-4,-3,-1,70%,52%,83%,112,96,124,17%,14%,19%,3,1,2,7,4,3
410,https://vlr.gg/player/2832/patix,2024-10-19 13:25:00,0.37,0.94,0.69,140,116,159,30,9,21,49,26,23,22,8,14,-4,-4,0,70%,48%,86%,94,73,111,39%,36%,42%,3,1,2,7,5,2
411,https://vlr.gg/player/12381/wanted,2024-10-19 13:25:00,0.62,0.56,0.59,106,114,108,25,10,15,50,23,27,23,9,14,0,0,0,60%,41%,75%,71,70,73,17%,14%,20%,2,0,2,2,0,2
412,https://vlr.gg/player/10146/reazy,2024-10-19 12:50:00,1.51,1.86,1.58,207,188,286,12,9,3,5,3,2,4,4,0,+1,+1,0,93%,100%,67%,145,130,206,38%,45%,22%,1,1,0,0,0,0
413,https://vlr.gg/player/31307/yigox,2024-10-19 12:50:00,1.63,0.99,1.51,260,289,148,14,12,2,6,4,2,2,2,0,+1,+2,-1,80%,83%,67%,164,180,98,30%,28%,50%,4,4,0,3,2,1
414,https://vlr.gg/player/11531/patrui,2024-10-19 12:50:00,1.67,0.17,1.37,142,179,,9,9,0,3,1,2,0,0,0,0,+1,-1,87%,100%,33%,100,125,,53%,53%,,1,1,0,1,0,1
415,https://vlr.gg/player/18615/batujnax,2024-10-19 12:50:00,1.34,1.08,1.29,259,248,307,13,10,3,8,5,3,6,5,1,+1,+1,0,87%,92%,67%,160,158,171,38%,45%,28%,1,1,0,0,0,0
416,https://vlr.gg/player/5510/oxmann,2024-10-19 12:50:00,1.43,0.32,1.21,219,247,111,11,11,0,7,4,3,7,5,2,0,+1,-1,73%,75%,67%,152,164,103,32%,42%,10%,2,2,0,2,1,1
417,https://vlr.gg/player/3599/ixeonn,2024-10-19 12:50:00,1.45,0.52,0.71,183,370,137,8,4,4,11,2,9,3,2,1,+1,+2,-1,60%,100%,50%,119,245,88,18%,33%,11%,4,2,2,3,0,3
418,https://vlr.gg/player/33551/slaughter,2024-10-19 12:50:00,1.46,0.48,0.67,125,166,116,7,2,5,12,1,11,4,4,0,-1,0,-1,47%,100%,33%,71,80,69,24%,17%,27%,0,0,0,1,0,1
419,https://vlr.gg/player/41719/mepeezy,2024-10-19 12:50:00,1.19,0.34,0.51,108,104,109,5,1,4,11,1,10,6,2,4,-1,0,-1,73%,100%,67%,71,53,75,24%,0%,33%,0,0,0,1,0,1
420,https://vlr.gg/player/12670/nekky,2024-10-19 12:50:00,0.91,0.28,0.41,89,196,62,5,3,2,12,2,10,2,0,2,-2,0,-2,53%,67%,50%,67,95,60,27%,50%,18%,0,0,0,2,0,2
421,https://vlr.gg/player/19580/logicman,2024-10-19 12:50:00,0.60,0.21,0.29,108,186,89,4,2,2,13,2,11,1,0,1,0,+1,-1,40%,67%,33%,69,79,67,17%,0%,27%,2,1,1,2,0,2
422,https://vlr.gg/player/3557/skylen,2024-10-19 12:50:00,1.39,1.62,1.51,274,247,303,26,11,15,15,7,8,3,2,1,-2,0,-2,71%,67%,75%,162,142,181,77%,82%,74%,1,1,0,3,1,2
423,https://vlr.gg/player/22676/ventt,2024-10-19 12:50:00,1.08,1.22,1.15,250,217,284,22,10,12,17,8,9,7,4,3,+1,+1,0,79%,75%,83%,148,107,189,55%,71%,46%,2,1,1,1,0,1
424,https://vlr.gg/player/10137/ip0tt,2024-10-19 12:50:00,1.04,0.40,0.72,155,185,125,10,7,3,18,8,10,8,4,4,-1,0,-1,71%,83%,58%,117,141,93,39%,50%,23%,1,0,1,2,0,2
425,https://vlr.gg/player/31855/celasun,2024-10-19 12:50:00,0.80,0.55,0.67,174,198,151,13,9,4,19,9,10,3,0,3,+1,-1,+2,50%,58%,42%,121,135,107,26%,41%,16%,2,0,2,1,1,0
426,https://vlr.gg/player/40935/umu7,2024-10-19 12:50:00,0.63,0.61,0.62,141,149,134,11,6,5,18,9,9,2,1,1,-3,-2,-1,58%,50%,67%,93,99,87,16%,17%,15%,4,3,1,7,5,2
427,https://vlr.gg/player/10160/izzy,2024-10-19 12:50:00,1.43,1.10,1.27,240,237,244,22,11,11,16,6,10,4,2,2,+1,+1,0,71%,67%,75%,147,149,144,18%,12%,25%,2,2,0,1,1,0
428,https://vlr.gg/player/8041/brave,2024-10-19 12:50:00,0.88,1.28,1.08,249,195,303,19,8,11,18,9,9,10,5,5,+3,-1,+4,67%,75%,58%,160,117,204,21%,20%,21%,4,0,4,1,1,0
429,https://vlr.gg/player/10163/cyderx,2024-10-19 12:50:00,1.31,0.60,0.96,165,209,122,13,9,4,13,6,7,4,2,2,0,+1,-1,75%,83%,67%,110,130,90,33%,32%,36%,2,1,1,2,0,2
430,https://vlr.gg/player/12774/anima,2024-10-19 12:50:00,0.96,0.94,0.95,161,184,139,15,8,7,13,7,6,5,3,2,+1,0,+1,83%,83%,83%,104,115,93,23%,17%,36%,1,0,1,0,0,0
431,https://vlr.gg/player/10161/qutionerx,2024-10-19 12:50:00,0.68,0.86,0.77,215,236,195,18,10,8,22,11,11,4,2,2,-1,+1,-2,67%,58%,75%,138,139,136,38%,45%,32%,5,4,1,6,3,3
432,https://vlr.gg/player/8590/killdream,2024-10-19 12:00:00,1.36,1.46,1.40,233,198,293,35,19,16,22,11,11,18,14,4,+2,-1,+3,85%,92%,75%,146,124,179,28%,25%,32%,3,0,3,1,1,0
433,https://vlr.gg/player/4214/eso177,2024-10-19 12:00:00,1.52,0.93,1.29,266,289,192,35,26,9,22,12,10,7,4,3,-3,-2,-1,75%,88%,56%,160,186,120,20%,24%,14%,3,1,2,6,3,3
434,https://vlr.gg/player/13024/vuubit,2024-10-19 12:00:00,1.56,0.64,1.19,205,274,116,36,28,8,23,12,11,4,3,1,+3,+5,-2,83%,100%,56%,139,172,90,48%,46%,57%,6,6,0,3,1,2
435,https://vlr.gg/player/46179/davia,2024-10-19 12:00:00,1.23,0.98,1.13,249,280,204,34,22,12,26,16,10,14,10,4,-1,0,-1,78%,79%,75%,153,174,122,31%,27%,44%,5,3,2,6,3,3
436,https://vlr.gg/player/29998/drastz,2024-10-19 12:00:00,0.84,0.94,0.88,144,131,145,18,12,6,23,13,10,15,8,7,+1,0,+1,70%,79%,56%,105,103,109,19%,21%,16%,4,3,1,3,3,0
437,https://vlr.gg/player/10448/kozok,2024-10-19 12:00:00,1.57,0.94,1.19,210,241,186,30,14,16,27,8,19,11,4,7,+1,+1,0,78%,81%,75%,130,145,120,32%,27%,35%,4,1,3,3,0,3
438,https://vlr.gg/player/33517/tripsy,2024-10-19 12:00:00,1.23,0.66,0.89,208,260,184,30,15,15,33,11,22,5,4,1,-1,0,-1,60%,69%,54%,131,164,109,44%,36%,56%,6,2,4,7,2,5
439,https://vlr.gg/player/42557/6ankai,2024-10-19 12:00:00,1.08,0.59,0.79,168,255,123,25,15,10,31,10,21,3,0,3,-2,0,-2,63%,69%,58%,121,171,87,29%,39%,17%,6,5,1,8,5,3
440,https://vlr.gg/player/16012/akira,2024-10-19 12:00:00,0.44,0.69,0.59,133,70,162,15,2,13,33,11,22,8,3,5,+1,0,+1,53%,50%,54%,86,52,108,46%,44%,46%,1,0,1,0,0,0
441,https://vlr.gg/player/26789/pdr,2024-10-19 12:00:00,0.73,0.49,0.58,120,121,129,16,6,10,34,11,23,15,9,6,-1,-1,0,58%,75%,46%,89,94,85,34%,35%,33%,2,0,2,3,1,2
442,https://vlr.gg/player/12226/sturnn,2024-10-19 11:50:00,1.10,0.92,1.00,175,208,151,14,7,7,14,7,7,3,1,2,0,0,0,62%,56%,67%,116,131,105,52%,62%,44%,1,1,0,1,1,0
443,https://vlr.gg/player/21584/deminatix,2024-10-19 11:50:00,0.79,0.94,0.88,200,194,205,14,6,8,16,7,9,1,1,0,-2,-3,+1,62%,67%,58%,134,127,140,37%,44%,30%,3,0,3,5,3,2
444,https://vlr.gg/player/10114/baha,2024-10-19 11:50:00,0.61,1.02,0.85,191,168,209,14,4,10,16,7,9,7,6,1,0,0,0,71%,78%,67%,131,114,143,30%,19%,38%,1,1,0,1,1,0
445,https://vlr.gg/player/11516/drky,2024-10-19 11:50:00,1.06,0.59,0.79,134,174,105,9,6,3,15,6,9,8,3,5,-1,0,-1,71%,89%,58%,94,125,71,28%,50%,12%,0,0,0,1,0,1
446,https://vlr.gg/player/16483/gloomy,2024-10-19 11:50:00,0.05,0.75,0.45,156,94,203,9,2,7,17,8,9,5,2,3,-2,-2,0,71%,78%,67%,100,67,125,22%,6%,32%,3,0,3,5,2,3
447,https://vlr.gg/player/10152/padisah,2024-10-19 11:50:00,1.73,1.31,1.55,273,344,180,21,15,6,12,8,4,12,6,6,+1,+2,-1,86%,83%,89%,175,213,123,30%,32%,25%,2,2,0,1,0,1
448,https://vlr.gg/player/3549/touven,2024-10-19 11:50:00,1.08,1.83,1.40,228,156,326,15,5,10,12,6,6,9,5,4,+1,0,+1,86%,83%,89%,190,117,286,29%,25%,31%,3,1,2,2,1,1
449,https://vlr.gg/player/19776/jrayn,2024-10-19 11:50:00,1.29,1.07,1.20,189,200,175,15,10,5,10,6,4,11,3,8,+1,0,+1,81%,83%,78%,124,129,118,35%,45%,24%,2,1,1,1,1,0
450,https://vlr.gg/player/3604/mojj,2024-10-19 11:50:00,1.07,1.05,1.06,160,142,186,14,7,7,11,6,5,1,1,0,+3,+1,+2,76%,67%,89%,101,88,117,44%,28%,78%,3,1,2,0,0,0
451,https://vlr.gg/player/33523/vuexlex,2024-10-19 11:50:00,0.47,1.01,0.70,164,122,222,13,6,7,15,9,6,1,0,1,-1,-3,+2,67%,58%,78%,113,86,149,25%,33%,22%,3,1,2,4,4,0
452,https://vlr.gg/player/13545/werlass,2024-10-19 11:45:00,1.30,1.36,1.33,259,282,237,22,12,10,15,8,7,7,3,4,0,+1,-1,79%,67%,92%,160,164,155,24%,23%,24%,4,3,1,4,2,2
453,https://vlr.gg/player/16552/pckwn,2024-10-19 11:45:00,1.32,0.86,1.09,250,263,238,19,10,9,17,7,10,4,2,2,+1,-1,+2,67%,67%,67%,181,202,160,36%,40%,32%,4,1,3,3,2,1
454,https://vlr.gg/player/40843/audaz,2024-10-19 11:45:00,1.12,0.96,1.04,200,220,182,18,9,9,17,8,9,10,6,4,-1,0,-1,71%,83%,58%,123,142,104,41%,38%,47%,1,0,1,2,0,2
455,https://vlr.gg/player/39357/s0pp,2024-10-19 11:45:00,0.63,0.74,0.69,204,204,205,17,9,8,22,11,11,1,0,1,-1,-1,0,58%,67%,50%,125,114,136,19%,14%,25%,1,1,0,2,2,0
456,https://vlr.gg/player/4892/mersa,2024-10-19 11:45:00,0.64,0.55,0.59,106,113,100,8,5,3,16,8,8,11,5,6,-3,-1,-2,71%,83%,58%,75,80,69,24%,20%,29%,0,0,0,3,1,2
457,https://vlr.gg/player/12793/xeus,2024-10-19 11:45:00,1.02,1.80,1.41,284,227,343,26,10,16,16,8,8,5,4,1,-1,-2,+1,71%,75%,67%,191,154,229,32%,21%,43%,5,2,3,6,4,2
458,https://vlr.gg/player/8369/yetujey,2024-10-19 11:45:00,1.54,0.64,1.09,253,322,184,20,14,6,19,8,11,6,1,5,+2,+1,+1,88%,92%,83%,162,201,123,20%,25%,13%,5,2,3,3,1,2
459,https://vlr.gg/player/8044/mrfalin,2024-10-19 11:45:00,1.22,0.72,0.97,181,238,125,13,9,4,16,7,9,12,7,5,+2,+1,+1,71%,83%,58%,132,164,101,29%,42%,17%,2,1,1,0,0,0
460,https://vlr.gg/player/1139/qraxs,2024-10-19 11:45:00,0.65,1.12,0.88,177,129,225,17,6,11,19,10,9,5,3,2,+1,+1,0,71%,75%,67%,117,83,151,27%,21%,31%,1,1,0,0,0,0
461,https://vlr.gg/player/15735/krostaly,2024-10-19 11:45:00,0.97,0.74,0.86,126,128,125,11,6,5,14,6,8,6,3,3,0,+1,-1,71%,67%,75%,89,85,92,32%,27%,38%,1,1,0,1,0,1
462,https://vlr.gg/player/18400/bipo,2024-10-19 11:00:00,1.46,1.69,1.57,305,290,311,43,23,20,21,11,10,8,4,4,+6,+4,+2,82%,81%,82%,177,182,171,45%,43%,47%,10,6,4,4,2,2
463,https://vlr.gg/player/3674/iluri,2024-10-19 11:00:00,1.46,1.05,1.27,188,238,126,28,20,8,17,10,7,13,7,6,-1,-1,0,79%,86%,71%,125,156,87,51%,64%,35%,0,0,0,1,1,0
464,https://vlr.gg/player/4519/kamisseq,2024-10-19 11:00:00,1.27,1.25,1.26,226,206,242,32,17,15,18,9,9,15,12,3,0,0,0,84%,86%,82%,135,121,152,41%,30%,55%,2,1,1,2,1,1
465,https://vlr.gg/player/3753/obnoks,2024-10-19 11:00:00,1.09,1.03,1.06,194,201,183,24,14,10,22,11,11,17,11,6,+4,+1,+3,76%,81%,71%,130,139,119,15%,20%,10%,5,1,4,1,0,1
466,https://vlr.gg/player/8502/olizera,2024-10-19 11:00:00,0.85,1.03,0.93,173,203,140,22,14,8,21,14,7,11,4,7,-1,+1,-2,79%,76%,82%,112,128,93,28%,26%,31%,6,5,1,7,4,3
467,https://vlr.gg/player/40587/nyshaa,2024-10-19 11:00:00,0.98,1.45,1.24,218,181,253,29,8,21,26,12,14,13,11,2,+3,+1,+2,71%,71%,71%,144,117,165,30%,31%,29%,5,2,3,2,1,1
468,https://vlr.gg/player/28344/spitzer,2024-10-19 11:00:00,0.72,0.71,0.71,152,140,164,18,7,11,34,14,20,10,5,5,0,+1,-1,50%,47%,52%,98,92,102,15%,10%,19%,2,2,0,2,1,1
469,https://vlr.gg/player/27957/ike,2024-10-19 11:00:00,0.66,0.63,0.64,134,130,141,19,8,11,28,11,17,8,6,2,-2,-1,-1,58%,65%,52%,88,81,94,36%,30%,42%,3,1,2,5,2,3
470,https://vlr.gg/player/28102/snabbi3,2024-10-19 11:00:00,1.15,0.12,0.58,138,238,66,18,16,2,30,12,18,6,2,4,-7,-3,-4,53%,65%,43%,96,149,54,15%,15%,13%,3,1,2,10,4,6
471,https://vlr.gg/player/28346/stolen,2024-10-19 11:00:00,0.40,0.64,0.53,125,79,159,15,5,10,31,12,19,5,1,4,-2,-1,-1,50%,53%,48%,91,55,120,23%,17%,26%,2,1,1,4,2,2
472,https://vlr.gg/player/40591/comeback,2024-10-19 10:30:00,2.13,1.38,1.75,411,501,322,39,24,15,19,8,11,10,3,7,+5,+5,0,82%,93%,71%,232,272,191,27%,28%,25%,8,5,3,3,0,3
473,https://vlr.gg/player/24344/loita,2024-10-19 10:30:00,1.27,1.41,1.34,238,221,257,24,11,13,15,7,8,5,3,2,0,+1,-1,71%,79%,64%,167,154,180,46%,41%,52%,3,2,1,3,1,2
474,https://vlr.gg/player/12795/crewen,2024-10-19 10:30:00,1.00,0.92,0.96,178,176,180,19,10,9,18,9,9,2,1,1,0,0,0,68%,64%,71%,112,107,117,31%,29%,32%,0,0,0,0,0,0
475,https://vlr.gg/player/5565/ros,2024-10-19 10:30:00,0.76,1.14,0.95,162,132,193,15,7,8,17,8,9,10,1,9,0,-2,+2,68%,64%,71%,105,92,119,16%,13%,19%,3,1,2,3,3,0
476,https://vlr.gg/player/31305/lar0k,2024-10-19 10:30:00,0.26,0.59,0.42,116,94,138,8,3,5,22,11,11,9,3,6,-3,-2,-1,54%,50%,57%,85,71,98,18%,20%,17%,1,0,1,4,2,2
477,https://vlr.gg/player/41719/mepeezy,2024-10-19 10:30:00,1.00,1.08,1.04,210,204,216,22,10,12,22,10,12,8,5,3,0,0,0,79%,86%,71%,136,143,130,27%,19%,38%,0,0,0,0,0,0
478,https://vlr.gg/player/12670/nekky,2024-10-19 10:30:00,1.38,0.50,0.94,202,275,131,20,15,5,21,9,12,11,5,6,-3,-1,-2,68%,86%,50%,116,136,96,42%,38%,50%,1,1,0,4,2,2
479,https://vlr.gg/player/3599/ixeonn,2024-10-19 10:30:00,0.81,0.99,0.90,224,202,246,21,10,11,22,11,11,6,3,3,+2,0,+2,64%,57%,71%,140,134,146,28%,27%,29%,8,4,4,6,4,2
480,https://vlr.gg/player/33551/slaughter,2024-10-19 10:30:00,1.01,0.74,0.87,159,186,132,15,8,7,20,10,10,12,10,2,0,+1,-1,61%,79%,43%,103,125,81,26%,25%,28%,1,1,0,1,0,1
481,https://vlr.gg/player/19580/logicman,2024-10-19 10:30:00,0.76,0.93,0.84,140,117,164,13,5,8,20,10,10,7,5,2,-1,0,-1,54%,57%,50%,102,98,106,15%,19%,10%,3,1,2,4,1,3
482,https://vlr.gg/player/6559/destruct1vee,2024-10-19 10:30:00,1.45,1.03,1.25,266,298,233,21,13,8,19,9,10,11,4,7,0,+1,-1,83%,83%,82%,167,172,162,21%,18%,25%,2,2,0,2,1,1
483,https://vlr.gg/player/33522/bex,2024-10-19 10:30:00,1.00,1.49,1.24,283,265,304,24,12,12,20,11,9,2,1,1,+2,-2,+4,74%,67%,82%,169,163,176,31%,24%,40%,7,2,5,5,4,1
484,https://vlr.gg/player/1399/sterben,2024-10-19 10:30:00,1.54,0.90,1.23,217,272,158,18,12,6,15,8,7,2,1,1,-2,-1,-1,74%,83%,64%,157,200,110,25%,26%,24%,0,0,0,2,1,1
485,https://vlr.gg/player/7353/glovee,2024-10-19 10:30:00,0.85,1.31,1.07,198,144,258,17,7,10,17,8,9,11,3,8,+1,0,+1,74%,67%,82%,118,92,146,42%,29%,52%,2,1,1,1,1,0
486,https://vlr.gg/player/12673/bard0lf,2024-10-19 10:30:00,0.70,1.14,0.91,159,118,205,12,4,8,15,8,7,12,7,5,0,0,0,87%,83%,91%,109,90,130,31%,33%,30%,1,0,1,1,0,1
487,https://vlr.gg/player/10160/izzy,2024-10-19 10:30:00,0.99,1.49,1.25,263,229,294,23,10,13,17,8,9,3,3,0,+2,-2,+4,74%,73%,75%,182,161,201,39%,35%,42%,6,1,5,4,3,1
488,https://vlr.gg/player/10161/qutionerx,2024-10-19 10:30:00,1.16,0.63,0.88,241,317,173,21,12,9,19,9,10,4,3,1,-2,0,-2,70%,82%,58%,162,199,129,27%,26%,29%,3,3,0,5,3,2
489,https://vlr.gg/player/10163/cyderx,2024-10-19 10:30:00,0.68,0.95,0.82,179,175,185,14,7,7,17,9,8,7,3,4,+1,0,+1,74%,82%,67%,119,125,112,24%,29%,21%,1,0,1,0,0,0
490,https://vlr.gg/player/12774/anima,2024-10-19 10:30:00,0.70,0.82,0.76,172,169,176,15,7,8,19,9,10,13,3,10,-1,-1,0,87%,82%,92%,115,117,113,22%,23%,22%,0,0,0,1,1,0
491,https://vlr.gg/player/8041/brave,2024-10-19 10:30:00,0.76,0.74,0.75,188,168,208,13,6,7,20,9,11,12,5,7,-1,0,-1,87%,91%,83%,126,111,139,23%,30%,17%,1,0,1,2,0,2
492,https://vlr.gg/player/33523/vuexlex,2024-10-19 09:30:00,0.93,2.76,1.54,347,266,509,22,10,12,14,11,3,5,4,1,+3,-2,+5,78%,67%,100%,239,183,350,27%,28%,26%,7,2,5,4,4,0
493,https://vlr.gg/player/3604/mojj,2024-10-19 09:30:00,1.46,1.25,1.39,236,230,249,17,12,5,10,6,4,2,1,1,+2,+1,+1,78%,67%,100%,151,143,165,41%,45%,33%,3,2,1,1,1,0
494,https://vlr.gg/player/19776/jrayn,2024-10-19 09:30:00,1.28,1.04,1.20,199,245,108,14,11,3,10,8,2,2,2,0,0,0,0,89%,92%,83%,122,150,67,26%,30%,13%,0,0,0,0,0,0
495,https://vlr.gg/player/3549/touven,2024-10-19 09:30:00,1.24,1.07,1.18,177,196,140,10,8,2,10,7,3,17,7,10,+2,+2,0,94%,92%,100%,118,132,91,17%,12%,38%,2,2,0,0,0,0
496,https://vlr.gg/player/10152/padisah,2024-10-19 09:30:00,0.43,1.32,0.72,189,154,261,12,6,6,14,11,3,5,3,2,+1,+1,0,72%,67%,83%,121,93,175,31%,22%,41%,1,1,0,0,0,0
497,https://vlr.gg/player/11531/patrui,2024-10-19 09:30:00,1.37,1.22,1.27,280,305,268,18,6,12,14,5,9,3,1,2,-2,-1,-1,61%,50%,67%,194,201,191,44%,40%,46%,1,0,1,3,1,2
498,https://vlr.gg/player/10146/reazy,2024-10-19 09:30:00,0.30,1.08,0.82,148,101,172,9,2,7,14,6,8,4,0,4,-2,-2,0,78%,50%,92%,99,58,119,19%,13%,21%,0,0,0,2,2,0
499,https://vlr.gg/player/31307/yigox,2024-10-19 09:30:00,0.27,0.99,0.75,206,139,239,12,2,10,16,6,10,3,1,2,+1,-1,+2,56%,33%,67%,134,95,153,19%,21%,17%,3,0,3,2,1,1
500,https://vlr.gg/player/5510/oxmann,2024-10-19 09:30:00,0.46,0.65,0.59,190,160,206,11,3,8,17,6,11,7,2,5,0,0,0,72%,83%,67%,128,106,139,50%,45%,53%,1,0,1,1,0,1
501,https://vlr.gg/player/18615/batujnax,2024-10-19 09:30:00,0.39,0.61,0.53,132,108,144,8,2,6,14,5,9,6,1,5,-5,-2,-3,61%,50%,67%,82,67,89,24%,29%,22%,0,0,0,5,2,3
0,https://vlr.gg/player/8369/yetujey,2024-10-19 09:30:00,1.62,1.27,1.44,297,356,240,24,14,10,18,9,9,7,4,3,+5,+4,+1,75%,83%,67%,183,231,136,34%,36%,31%,6,4,2,1,0,1
1,https://vlr.gg/player/12793/xeus,2024-10-19 09:30:00,1.82,1.06,1.44,309,366,253,26,17,9,17,8,9,10,4,6,0,-1,+1,75%,75%,75%,217,238,196,35%,39%,29%,5,1,4,5,2,3
2,https://vlr.gg/player/8044/mrfalin,2024-10-19 09:30:00,0.72,1.04,0.88,165,124,208,15,5,10,16,8,8,7,4,3,-3,-2,-1,71%,58%,83%,99,73,125,15%,22%,13%,0,0,0,3,2,1
3,https://vlr.gg/player/1139/qraxs,2024-10-19 09:30:00,0.74,0.99,0.87,137,107,167,12,4,8,13,6,7,7,4,3,0,0,0,67%,58%,75%,93,76,109,57%,50%,62%,0,0,0,0,0,0
4,https://vlr.gg/player/15735/krostaly,2024-10-19 09:30:00,0.55,1.16,0.86,168,109,228,16,5,11,17,8,9,6,2,4,-2,-3,+1,71%,58%,83%,111,68,154,44%,40%,46%,1,0,1,3,3,0
5,https://vlr.gg/player/22676/ventt,2024-10-19 09:30:00,1.11,1.12,1.12,214,166,264,20,9,11,17,7,10,6,4,2,-4,-3,-1,67%,58%,75%,130,109,152,31%,46%,24%,2,0,2,6,3,3
6,https://vlr.gg/player/40935/umu7,2024-10-19 09:30:00,1.09,0.79,0.94,245,269,223,18,10,8,20,10,10,7,6,1,+4,+2,+2,71%,83%,58%,166,180,151,20%,11%,30%,4,2,2,0,0,0
7,https://vlr.gg/player/3557/skylen,2024-10-19 09:30:00,0.75,0.98,0.87,195,230,162,15,9,6,20,12,8,7,0,7,+2,+2,0,63%,67%,58%,138,168,109,40%,38%,44%,3,2,1,1,0,1
8,https://vlr.gg/player/31855/celasun,2024-10-19 09:30:00,1.07,0.53,0.80,177,246,109,16,11,5,19,10,9,4,4,0,-2,-3,+1,71%,75%,67%,123,171,75,38%,46%,25%,1,0,1,3,3,0
9,https://vlr.gg/player/10137/ip0tt,2024-10-19 09:30:00,0.41,1.08,0.75,152,83,222,12,3,9,17,9,8,4,3,1,0,0,0,67%,50%,83%,94,53,136,46%,30%,56%,2,1,1,2,1,1
10,https://vlr.gg/player/14125/spring,2024-10-19 09:15:00,,,,318,,,48,,,34,,,17,,,,,,,,,,,,,,,,,,,,
11,https://vlr.gg/player/11218/yuicaw,2024-10-19 09:15:00,,,,228,,,36,,,26,,,20,,,,,,,,,,,,,,,,,,,,
12,https://vlr.gg/player/37489/lysoar,2024-10-19 09:15:00,,,,200,,,33,,,27,,,10,,,,,,,,,,,,,,,,,,,,
13,https://vlr.gg/player/45104/v1ya,2024-10-19 09:15:00,,,,180,,,26,,,27,,,18,,,,,,,,,,,,,,,,,,,,
14,https://vlr.gg/player/7849/siufatbb,2024-10-19 09:15:00,,,,159,,,25,,,28,,,8,,,,,,,,,,,,,,,,,,,,
15,https://vlr.gg/player/37927/happywei,2024-10-19 09:15:00,,,,226,,,33,,,32,,,12,,,,,,,,,,,,,,,,,,,,
16,https://vlr.gg/player/4710/you,2024-10-19 09:15:00,,,,198,,,30,,,31,,,11,,,,,,,,,,,,,,,,,,,,
17,https://vlr.gg/player/22047/rarga,2024-10-19 09:15:00,,,,184,,,26,,,42,,,9,,,,,,,,,,,,,,,,,,,,
18,https://vlr.gg/player/36668/mart1n,2024-10-19 09:15:00,,,,179,,,26,,,31,,,16,,,,,,,,,,,,,,,,,,,,
19,https://vlr.gg/player/37674/mrcani,2024-10-19 09:15:00,,,,160,,,27,,,32,,,7,,,,,,,,,,,,,,,,,,,,
20,https://vlr.gg/player/8497/monyet,2024-10-19 07:20:00,0.85,1.45,1.23,238,144,316,34,8,26,32,11,21,13,4,9,+2,-1,+3,74%,79%,71%,166,100,204,39%,35%,40%,8,1,7,6,2,4
21,https://vlr.gg/player/4871/xffero,2024-10-19 07:20:00,0.82,1.00,0.93,177,195,191,26,10,16,30,13,17,5,3,2,-2,-1,-1,61%,50%,67%,141,139,143,32%,30%,34%,1,0,1,3,1,2
22,https://vlr.gg/player/4866/kushy,2024-10-19 07:20:00,0.66,0.82,0.74,152,175,144,20,8,12,29,13,16,10,5,5,0,+1,-1,66%,71%,63%,98,101,97,21%,25%,18%,3,2,1,3,1,2
23,https://vlr.gg/player/25025/estrella,2024-10-19 07:20:00,0.70,0.67,0.68,162,150,163,19,7,12,31,11,20,10,3,7,0,0,0,58%,57%,58%,109,111,108,22%,32%,17%,2,1,1,2,1,1
24,https://vlr.gg/player/24895/jemkin,2024-10-19 07:20:00,0.24,0.61,0.47,130,95,146,16,4,12,32,13,19,6,4,2,-4,-3,-1,53%,36%,63%,91,66,106,20%,14%,26%,3,1,2,7,4,3
25,https://vlr.gg/player/485/stax,2024-10-19 07:20:00,1.15,1.73,1.36,224,193,278,29,15,14,23,16,7,30,19,11,+1,0,+1,87%,88%,86%,153,130,192,24%,22%,26%,1,0,1,0,0,0
26,https://vlr.gg/player/13039/meteor,2024-10-19 07:20:00,1.24,1.42,1.31,268,271,265,38,24,14,24,17,7,6,5,1,+1,+1,0,74%,75%,71%,169,174,161,20%,23%,13%,5,2,3,4,1,3
27,https://vlr.gg/player/4056/sylvan,2024-10-19 07:20:00,1.16,1.13,1.15,169,169,174,25,17,8,20,12,8,17,7,10,0,-1,+1,84%,83%,86%,103,101,108,24%,24%,24%,2,1,1,2,2,0
28,https://vlr.gg/player/804/buzz,2024-10-19 07:20:00,0.95,1.46,1.14,243,228,263,34,21,13,26,18,8,10,4,6,+3,+2,+1,82%,79%,86%,152,141,171,28%,34%,22%,8,6,2,5,4,1
29,https://vlr.gg/player/29833/izu,2024-10-19 07:20:00,0.97,1.15,1.03,192,180,199,28,16,12,22,15,7,8,7,1,-1,-2,+1,82%,79%,86%,107,107,108,26%,24%,31%,5,3,2,6,5,1
30,https://vlr.gg/player/16924/stew,2024-10-19 06:00:00,,,,264,,,54,,,39,,,14,,,,,,,,,,,,,,,,,,,,
31,https://vlr.gg/player/41029/z1yan,2024-10-19 06:00:00,,,,195,,,40,,,43,,,10,,,,,,,,,,,,,,,,,,,,
32,https://vlr.gg/player/3049/sword9,2024-10-19 06:00:00,,,,192,,,41,,,37,,,18,,,,,,,,,,,,,,,,,,,,
33,https://vlr.gg/player/3519/jkuro,2024-10-19 06:00:00,,,,188,,,39,,,38,,,26,,,,,,,,,,,,,,,,,,,,
34,https://vlr.gg/player/36415/viva,2024-10-19 06:00:00,,,,173,,,33,,,38,,,22,,,,,,,,,,,,,,,,,,,,
35,https://vlr.gg/player/10821/delb,2024-10-19 06:00:00,,,,248,,,54,,,42,,,16,,,,,,,,,,,,,,,,,,,,
36,https://vlr.gg/player/25949/bunt,2024-10-19 06:00:00,,,,182,,,39,,,43,,,24,,,,,,,,,,,,,,,,,,,,
37,https://vlr.gg/player/46748/k1ra,2024-10-19 06:00:00,,,,177,,,37,,,40,,,17,,,,,,,,,,,,,,,,,,,,
38,https://vlr.gg/player/4881/spitfires,2024-10-19 06:00:00,,,,172,,,33,,,46,,,17,,,,,,,,,,,,,,,,,,,,
39,https://vlr.gg/player/37019/x3b,2024-10-19 06:00:00,,,,161,,,32,,,36,,,16,,,,,,,,,,,,,,,,,,,,
40,https://vlr.gg/player/4056/sylvan,2024-10-19 05:45:00,1.27,1.48,1.37,263,293,231,21,12,9,14,10,4,12,5,7,+2,+1,+1,96%,92%,100%,159,168,149,31%,39%,21%,3,2,1,1,1,0
41,https://vlr.gg/player/804/buzz,2024-10-19 05:45:00,1.17,1.34,1.25,262,267,257,20,10,10,16,10,6,7,4,3,+1,-1,+2,83%,75%,91%,177,188,165,16%,16%,16%,5,1,4,4,2,2
42,https://vlr.gg/player/29833/izu,2024-10-19 05:45:00,0.97,1.49,1.22,194,169,223,17,7,10,13,8,5,7,5,2,-1,-1,0,78%,67%,91%,141,116,168,35%,35%,35%,1,0,1,2,1,1
43,https://vlr.gg/player/13039/meteor,2024-10-19 05:45:00,1.02,1.12,1.07,220,249,191,19,12,7,14,9,5,5,3,2,-3,-1,-2,65%,50%,82%,149,152,147,19%,12%,29%,1,1,0,4,2,2
44,https://vlr.gg/player/485/stax,2024-10-19 05:45:00,0.64,1.39,1.00,182,106,266,15,4,11,15,9,6,10,7,3,0,0,0,70%,58%,82%,132,79,190,30%,18%,37%,1,1,0,1,1,0
45,https://vlr.gg/player/2400/brofeld,2024-10-19 05:45:00,1.40,1.39,1.39,265,243,286,24,11,13,18,8,10,7,2,5,+2,0,+2,74%,64%,83%,172,154,188,31%,31%,31%,4,2,2,2,2,0
46,https://vlr.gg/player/6702/bazz,2024-10-19 05:45:00,0.87,1.22,1.05,199,188,210,17,7,10,17,9,8,6,1,5,-3,0,-3,61%,55%,67%,143,137,150,23%,29%,18%,0,0,0,3,0,3
47,https://vlr.gg/player/1009/sakurai,2024-10-19 05:45:00,0.14,1.15,0.67,131,44,212,12,2,10,18,10,8,2,0,2,+2,0,+2,57%,45%,67%,88,24,147,27%,40%,24%,4,2,2,2,2,0
48,https://vlr.gg/player/40736/kapi,2024-10-19 05:45:00,0.53,0.76,0.65,116,93,138,9,3,6,19,10,9,10,4,6,-1,0,-1,70%,64%,75%,80,63,96,21%,20%,21%,0,0,0,1,0,1
49,https://vlr.gg/player/45962/ken,2024-10-19 05:45:00,0.37,0.83,0.61,182,146,216,10,3,7,20,10,10,9,5,4,+1,-1,+2,65%,64%,67%,135,119,151,14%,16%,13%,4,1,3,3,2,1
50,https://vlr.gg/player/17526/clem,2024-10-19 05:00:00,,,,291,,,66,,,52,,,9,,,,,,,,,,,,,,,,,,,,
51,https://vlr.gg/player/25489/chloe,2024-10-19 05:00:00,,,,206,,,43,,,50,,,25,,,,,,,,,,,,,,,,,,,,
52,https://vlr.gg/player/15307/jue,2024-10-19 05:00:00,,,,200,,,46,,,49,,,26,,,,,,,,,,,,,,,,,,,,
53,https://vlr.gg/player/41164/ysy,2024-10-19 05:00:00,,,,151,,,35,,,51,,,12,,,,,,,,,,,,,,,,,,,,
54,https://vlr.gg/player/15304/xixi,2024-10-19 05:00:00,,,,127,,,28,,,51,,,13,,,,,,,,,,,,,,,,,,,,
55,https://vlr.gg/player/48206/7er,2024-10-19 05:00:00,,,,266,,,62,,,39,,,33,,,,,,,,,,,,,,,,,,,,
56,https://vlr.gg/player/48207/elina,2024-10-19 05:00:00,,,,240,,,56,,,41,,,12,,,,,,,,,,,,,,,,,,,,
57,https://vlr.gg/player/48205/x1aowen,2024-10-19 05:00:00,,,,238,,,58,,,49,,,17,,,,,,,,,,,,,,,,,,,,
58,https://vlr.gg/player/25443/bambi,2024-10-19 05:00:00,,,,190,,,43,,,42,,,19,,,,,,,,,,,,,,,,,,,,
59,https://vlr.gg/player/17447/alyssa,2024-10-19 05:00:00,,,,160,,,34,,,48,,,17,,,,,,,,,,,,,,,,,,,,
60,https://vlr.gg/player/25255/primmie,2024-10-19 04:30:00,1.77,1.44,1.60,289,363,221,26,15,11,14,8,6,4,4,0,+2,+3,-1,87%,91%,83%,193,237,152,38%,38%,38%,4,4,0,2,1,1
61,https://vlr.gg/player/5129/ban,2024-10-19 04:30:00,1.45,1.30,1.37,237,248,228,21,11,10,13,5,8,5,1,4,-1,-1,0,74%,73%,75%,158,177,141,31%,21%,45%,1,0,1,2,1,1
62,https://vlr.gg/player/13788/jitboys,2024-10-19 04:30:00,1.20,0.88,1.03,165,173,158,14,7,7,14,6,8,8,5,3,-2,0,-2,78%,73%,83%,113,126,102,38%,47%,30%,0,0,0,2,0,2
63,https://vlr.gg/player/3977/crws,2024-10-19 04:30:00,0.52,0.58,0.55,123,113,134,9,5,4,17,7,10,5,0,5,-2,-1,-1,65%,64%,67%,86,74,98,23%,13%,30%,0,0,0,2,1,1
64,https://vlr.gg/player/3980/governor,2024-10-19 04:30:00,0.84,0.26,0.53,148,176,123,11,6,5,18,7,11,4,4,0,0,0,0,57%,73%,42%,92,118,69,14%,25%,6%,5,2,3,5,2,3
65,https://vlr.gg/player/13002/akame,2024-10-19 04:30:00,1.24,1.13,1.19,206,195,219,17,9,8,15,6,9,9,1,8,-1,0,-1,83%,92%,73%,126,122,131,24%,41%,15%,2,2,0,3,2,1
66,https://vlr.gg/player/48577/gyen,2024-10-19 04:30:00,0.92,1.17,1.04,172,132,217,15,7,8,15,7,8,4,2,2,0,0,0,83%,92%,73%,134,122,148,39%,39%,39%,2,1,1,2,1,1
67,https://vlr.gg/player/6672/meiy,2024-10-19 04:30:00,0.98,0.87,0.93,203,199,209,17,9,8,17,8,9,3,1,2,+3,+2,+1,74%,83%,64%,118,113,122,21%,18%,23%,5,3,2,2,1,1
68,https://vlr.gg/player/10627/art,2024-10-19 04:30:00,1.23,0.59,0.93,200,240,157,14,9,5,16,7,9,13,10,3,+1,+2,-1,70%,83%,55%,123,140,104,7%,7%,9%,3,2,1,2,0,2
69,https://vlr.gg/player/4052/jinboong,2024-10-19 04:30:00,1.02,0.47,0.76,152,216,83,13,9,4,18,9,9,4,3,1,0,0,0,61%,67%,55%,106,152,57,23%,16%,50%,1,0,1,1,0,1
70,https://vlr.gg/player/40546/georgebest,2024-10-19 04:00:00,1.77,1.02,1.35,266,347,198,61,37,24,41,15,26,15,4,11,+5,+3,+2,75%,79%,71%,165,212,128,44%,46%,41%,11,7,4,6,4,2
71,https://vlr.gg/player/40547/zuokew,2024-10-19 04:00:00,1.03,1.56,1.32,285,245,320,64,24,40,40,19,21,10,4,6,+5,0,+5,84%,86%,83%,180,163,194,33%,39%,28%,11,3,8,6,3,3
72,https://vlr.gg/player/31497/allr1ghtt,2024-10-19 04:00:00,1.45,1.12,1.27,220,265,184,50,27,23,34,16,18,14,3,11,+5,+4,+1,75%,79%,71%,149,170,132,35%,33%,37%,9,5,4,4,1,3
73,https://vlr.gg/player/23896/itaoearth,2024-10-19 04:00:00,0.64,1.21,0.96,205,138,257,44,12,32,42,20,22,26,16,10,+4,0,+4,83%,82%,83%,124,88,153,34%,32%,34%,8,2,6,4,2,2
74,https://vlr.gg/player/48482/examp1e,2024-10-19 04:00:00,0.65,0.86,0.77,128,105,148,26,9,17,39,19,20,30,15,15,+2,+1,+1,83%,75%,89%,79,66,90,18%,12%,22%,3,1,2,1,0,1
75,https://vlr.gg/player/48510/russody,2024-10-19 04:00:00,0.92,1.18,1.03,195,181,221,42,20,22,47,26,21,20,12,8,-2,-2,0,71%,71%,71%,137,121,158,36%,30%,42%,4,1,3,6,3,3
76,https://vlr.gg/player/48511/immawrecked,2024-10-19 04:00:00,0.89,0.99,0.93,193,165,232,41,20,21,50,25,25,20,10,10,-3,-2,-1,70%,69%,71%,123,110,139,22%,24%,21%,1,0,1,4,2,2
77,https://vlr.gg/player/48509/tongk,2024-10-19 04:00:00,0.77,1.11,0.92,180,163,204,41,22,19,49,29,20,20,7,13,-3,-4,+1,63%,60%,68%,128,116,143,29%,25%,33%,3,1,2,6,5,1
78,https://vlr.gg/player/48508/,2024-10-19 04:00:00,0.86,0.75,0.81,170,183,161,38,23,15,51,28,23,25,12,13,-3,-2,-1,60%,57%,64%,111,122,98,31%,30%,32%,5,2,3,8,4,4
79,https://vlr.gg/player/48512/sulliva4n,2024-10-19 04:00:00,0.82,0.60,0.72,159,186,126,34,22,12,48,28,20,6,3,3,-10,-3,-7,54%,63%,43%,108,119,93,30%,31%,28%,8,7,1,18,10,8
80,https://vlr.gg/player/2615/clz,2024-10-19 03:25:00,1.46,2.09,1.71,245,196,321,18,9,9,9,5,4,15,5,10,+1,0,+1,90%,92%,88%,152,118,204,41%,44%,38%,1,0,1,0,0,0
81,https://vlr.gg/player/25221/xdll,2024-10-19 03:25:00,1.76,0.81,1.38,295,364,194,21,16,5,12,6,6,11,7,4,-1,0,-1,85%,92%,75%,208,247,149,25%,20%,38%,3,2,1,4,2,2
82,https://vlr.gg/player/6668/sugarz3ro,2024-10-19 03:25:00,1.77,0.52,1.27,166,237,61,12,11,1,10,4,6,12,6,6,-2,-2,0,75%,83%,63%,114,164,39,39%,33%,75%,0,0,0,2,2,0
83,https://vlr.gg/player/424/dep,2024-10-19 03:25:00,1.22,1.21,1.22,255,248,267,17,10,7,13,7,6,7,5,2,+1,-1,+2,70%,83%,50%,170,157,189,24%,24%,24%,5,2,3,4,3,1
84,https://vlr.gg/player/12990/syouta,2024-10-19 03:25:00,0.29,1.14,0.63,140,82,229,9,3,6,13,8,5,3,2,1,-1,-1,0,60%,58%,63%,106,66,165,25%,23%,26%,0,0,0,1,1,0
85,https://vlr.gg/player/804/buzz,2024-10-19 03:25:00,1.36,1.17,1.24,267,342,217,19,10,9,15,6,9,2,1,1,+1,+1,0,55%,75%,42%,181,236,144,17%,19%,15%,2,2,0,1,1,0
86,https://vlr.gg/player/29833/izu,2024-10-19 03:25:00,1.02,0.96,0.98,160,170,154,11,5,6,13,5,8,4,0,4,+1,0,+1,75%,88%,67%,99,110,92,38%,56%,27%,1,0,1,0,0,0
87,https://vlr.gg/player/13039/meteor,2024-10-19 03:25:00,1.06,0.53,0.74,156,180,141,12,6,6,17,5,12,2,0,2,0,-1,+1,50%,50%,50%,113,113,113,35%,50%,29%,4,1,3,4,2,2
88,https://vlr.gg/player/4056/sylvan,2024-10-19 03:25:00,0.84,0.46,0.61,136,120,147,8,3,5,16,5,11,8,4,4,0,-1,+1,75%,88%,67%,94,83,102,29%,21%,33%,2,0,2,2,1,1
89,https://vlr.gg/player/485/stax,2024-10-19 03:25:00,0.38,0.57,0.50,100,105,98,7,3,4,16,7,9,4,2,2,0,-1,+1,50%,50%,50%,66,62,69,44%,22%,71%,2,0,2,2,1,1
90,https://vlr.gg/player/3977/crws,2024-10-19 01:35:00,1.09,1.37,1.23,250,228,272,20,9,11,17,10,7,4,1,3,+1,0,+1,75%,58%,92%,177,162,193,27%,19%,36%,2,0,2,1,0,1
91,https://vlr.gg/player/13788/jitboys,2024-10-19 01:35:00,1.12,1.28,1.20,218,230,207,19,10,9,14,9,5,9,5,4,0,0,0,79%,83%,75%,141,144,138,41%,33%,53%,1,1,0,1,1,0
92,https://vlr.gg/player/5129/ban,2024-10-19 01:35:00,1.25,1.10,1.17,203,230,177,18,10,8,16,9,7,15,6,9,+2,+1,+1,79%,67%,92%,131,151,112,66%,63%,69%,2,1,1,0,0,0
93,https://vlr.gg/player/25255/primmie,2024-10-19 01:35:00,0.47,1.43,0.95,183,117,250,17,5,12,16,10,6,5,2,3,+2,-1,+3,71%,50%,92%,119,78,160,37%,33%,38%,3,0,3,1,1,0
94,https://vlr.gg/player/3980/governor,2024-10-19 01:35:00,0.48,1.26,0.87,202,138,267,16,5,11,17,10,7,3,2,1,+1,0,+1,75%,67%,83%,136,97,176,28%,29%,27%,7,4,3,6,4,2
95,https://vlr.gg/player/8497/monyet,2024-10-19 01:35:00,0.57,1.67,1.12,201,142,261,17,6,11,17,12,5,10,4,6,+1,0,+1,75%,75%,75%,128,89,166,25%,18%,29%,3,2,1,2,2,0
96,https://vlr.gg/player/4871/xffero,2024-10-19 01:35:00,0.72,1.31,1.02,193,159,227,17,7,10,18,10,8,8,2,6,+1,0,+1,67%,42%,92%,118,90,146,21%,25%,18%,3,0,3,2,0,2
97,https://vlr.gg/player/25025/estrella,2024-10-19 01:35:00,0.81,0.95,0.88,136,105,167,11,4,7,15,8,7,12,6,6,-1,-1,0,67%,50%,83%,92,78,106,31%,50%,22%,0,0,0,1,1,0
98,https://vlr.gg/player/24895/jemkin,2024-10-19 01:35:00,0.76,0.98,0.87,218,203,234,19,8,11,21,11,10,6,2,4,-5,-2,-3,75%,58%,92%,146,124,168,29%,38%,21%,1,1,0,6,3,3
99,https://vlr.gg/player/4866/kushy,2024-10-19 01:35:00,0.69,0.94,0.82,191,162,221,16,7,9,19,10,9,2,1,1,-2,-3,+1,71%,67%,75%,134,101,168,24%,24%,24%,2,0,2,4,3,1
100,https://vlr.gg/player/35071/cher0z,2024-10-19 01:00:00,1.45,1.24,1.34,225,235,211,51,27,24,38,18,20,18,9,9,-1,+1,-2,83%,83%,82%,145,158,135,31%,32%,31%,1,1,0,2,0,2
101,https://vlr.gg/player/23892/ayanokoji,2024-10-19 01:00:00,0.81,1.40,1.13,226,197,259,52,20,32,44,23,21,16,7,9,-7,-4,-3,69%,67%,71%,153,126,177,27%,29%,26%,11,7,4,18,11,7
102,https://vlr.gg/player/31537/basbabe,2024-10-19 01:00:00,1.15,0.92,1.03,192,179,202,44,21,23,43,16,27,29,9,20,+2,0,+2,75%,73%,76%,128,110,144,36%,29%,41%,4,0,4,2,0,2
103,https://vlr.gg/player/20623/harddora,2024-10-19 01:00:00,1.10,0.75,0.92,171,212,137,40,22,18,44,21,23,15,8,7,+3,+3,0,67%,70%,65%,115,135,96,31%,31%,30%,9,5,4,6,2,4
104,https://vlr.gg/player/17303/fontuz,2024-10-19 01:00:00,0.87,0.86,0.87,196,159,213,42,17,25,47,21,26,23,13,10,+3,0,+3,73%,80%,68%,123,102,141,28%,24%,31%,7,2,5,4,2,2
105,https://vlr.gg/player/19150/niffy,2024-10-19 01:00:00,1.42,0.84,1.15,200,239,160,47,31,16,38,19,19,5,2,3,+1,+2,-1,67%,71%,63%,141,162,117,36%,44%,28%,3,2,1,2,0,2
106,https://vlr.gg/player/15891/krx,2024-10-19 01:00:00,1.17,1.04,1.11,261,268,251,56,31,25,51,28,23,13,8,5,+7,+4,+3,70%,74%,67%,173,176,170,25%,22%,29%,15,8,7,8,4,4
107,https://vlr.gg/player/6733/xze,2024-10-19 01:00:00,0.73,1.13,0.91,179,166,208,46,22,24,48,27,21,24,12,12,-1,-2,+1,66%,59%,73%,121,101,142,66%,77%,57%,4,3,1,5,5,0
108,https://vlr.gg/player/23918/reality,2024-10-19 01:00:00,0.95,0.64,0.81,152,165,149,35,19,16,46,23,23,12,9,3,-6,-3,-3,63%,65%,60%,104,112,95,28%,29%,26%,4,2,2,10,5,5
109,https://vlr.gg/player/1910/acetics,2024-10-19 01:00:00,0.66,0.88,0.76,142,119,177,32,14,18,46,25,21,15,10,5,-1,-1,0,64%,62%,67%,97,86,109,30%,23%,38%,6,2,4,7,3,4
110,https://vlr.gg/player/12990/syouta,2024-10-19 00:25:00,1.03,2.12,1.50,298,224,399,23,9,14,13,9,4,5,5,0,+3,+1,+2,71%,58%,89%,177,141,225,41%,50%,36%,4,2,2,1,1,0
111,https://vlr.gg/player/25221/xdll,2024-10-19 00:25:00,0.86,1.86,1.29,219,168,288,18,7,11,13,9,4,3,2,1,0,-1,+1,86%,75%,100%,150,114,198,27%,25%,29%,1,0,1,1,1,0
112,https://vlr.gg/player/6668/sugarz3ro,2024-10-19 00:25:00,1.00,1.27,1.12,153,155,150,12,7,5,9,7,2,9,6,3,0,0,0,81%,67%,100%,112,112,111,34%,32%,38%,0,0,0,0,0,0
113,https://vlr.gg/player/2615/clz,2024-10-19 00:25:00,1.52,0.52,1.09,229,315,115,16,13,3,16,9,7,10,4,6,-2,0,-2,81%,83%,78%,160,222,78,35%,28%,71%,2,2,0,4,2,2
114,https://vlr.gg/player/424/dep,2024-10-19 00:25:00,0.64,0.92,0.76,228,187,284,15,7,8,18,10,8,8,4,4,0,+2,-2,62%,67%,56%,141,123,164,21%,28%,15%,4,3,1,4,1,3
115,https://vlr.gg/player/45962/ken,2024-10-19 00:25:00,0.39,1.82,1.21,237,127,320,16,3,13,15,9,6,4,1,3,+3,+1,+2,62%,56%,67%,172,84,237,12%,7%,14%,4,2,2,1,1,0
116,https://vlr.gg/player/2400/brofeld,2024-10-19 00:25:00,0.90,0.99,0.95,205,199,211,16,6,10,18,8,10,2,2,0,0,+1,-1,76%,67%,83%,120,111,126,11%,14%,10%,2,1,1,2,0,2
117,https://vlr.gg/player/1009/sakurai,2024-10-19 00:25:00,0.63,0.92,0.80,196,166,219,13,5,8,17,8,9,10,2,8,-1,-1,0,67%,56%,75%,123,102,140,25%,36%,21%,2,1,1,3,2,1
118,https://vlr.gg/player/6702/bazz,2024-10-19 00:25:00,0.40,1.05,0.77,165,131,191,13,4,9,17,8,9,5,1,4,-1,+1,-2,71%,56%,83%,113,89,131,42%,36%,45%,2,1,1,3,0,3
119,https://vlr.gg/player/40736/kapi,2024-10-19 00:25:00,0.72,0.49,0.59,150,215,103,11,7,4,17,8,9,2,0,2,-2,-1,-1,62%,56%,67%,92,116,74,48%,55%,40%,0,0,0,2,1,1
120,https://vlr.gg/player/4866/kushy,2024-10-18 22:15:00,0.86,2.42,1.60,312,214,420,29,10,19,13,10,3,3,2,1,+2,-2,+4,78%,58%,100%,170,106,240,37%,29%,42%,5,1,4,3,3,0
121,https://vlr.gg/player/25025/estrella,2024-10-18 22:15:00,1.25,1.76,1.49,216,179,257,19,8,11,10,6,4,15,4,11,0,-1,+1,87%,75%,100%,155,132,179,33%,17%,55%,1,0,1,1,1,0
122,https://vlr.gg/player/8497/monyet,2024-10-18 22:15:00,1.09,0.98,1.03,190,210,169,17,10,7,16,9,7,10,6,4,-3,0,-3,91%,92%,91%,131,140,122,28%,24%,32%,0,0,0,3,0,3
123,https://vlr.gg/player/24895/jemkin,2024-10-18 22:15:00,1.04,0.78,0.92,210,225,195,16,8,8,17,9,8,6,4,2,+3,+3,0,70%,75%,64%,133,151,114,21%,19%,25%,5,4,1,2,1,1
124,https://vlr.gg/player/4871/xffero,2024-10-18 22:15:00,0.49,0.87,0.67,154,131,181,13,6,7,17,10,7,4,1,3,+1,0,+1,74%,58%,91%,92,77,109,33%,38%,30%,2,1,1,1,1,0
125,https://vlr.gg/player/4052/jinboong,2024-10-18 22:15:00,0.91,1.06,0.99,213,187,238,17,7,10,20,10,10,4,1,3,0,-1,+1,65%,45%,83%,146,125,166,32%,32%,32%,4,1,3,4,2,2
126,https://vlr.gg/player/6672/meiy,2024-10-18 22:15:00,0.80,1.04,0.92,229,257,204,18,9,9,19,11,8,4,1,3,+1,+1,0,70%,73%,67%,154,178,132,36%,36%,36%,5,3,2,4,2,2
127,https://vlr.gg/player/10627/art,2024-10-18 22:15:00,0.68,0.93,0.81,178,158,198,13,6,7,19,10,9,7,1,6,-2,-2,0,65%,45%,83%,122,110,133,16%,21%,13%,1,0,1,3,2,1
128,https://vlr.gg/player/13002/akame,2024-10-18 22:15:00,0.29,1.25,0.79,192,108,271,17,4,13,21,11,10,6,2,4,0,0,0,61%,36%,83%,116,62,166,20%,12%,26%,0,0,0,0,0,0
129,https://vlr.gg/player/48577/gyen,2024-10-18 22:15:00,0.40,0.98,0.70,93,91,97,8,3,5,15,10,5,6,2,4,-2,-1,-1,61%,55%,67%,60,70,52,29%,27%,30%,0,0,0,2,1,1
130,https://vlr.gg/player/19556/melya,2024-10-18 19:30:00,1.38,1.26,1.33,214,220,217,49,26,23,34,19,15,19,15,4,0,-6,+6,75%,71%,79%,144,151,136,28%,33%,25%,7,1,6,7,7,0
131,https://vlr.gg/player/30700/elab0rate,2024-10-18 19:30:00,1.04,1.15,1.09,250,236,236,53,29,24,40,25,15,11,8,3,+6,+4,+2,73%,63%,86%,151,154,146,32%,28%,36%,7,5,2,1,1,0
132,https://vlr.gg/player/28870/k0rupt,2024-10-18 19:30:00,1.14,0.88,1.02,192,205,167,41,25,16,39,21,18,17,8,9,-8,-4,-4,75%,77%,71%,128,142,110,27%,23%,33%,2,1,1,10,5,5
133,https://vlr.gg/player/14403/marceline,2024-10-18 19:30:00,0.69,1.26,0.94,222,185,274,48,22,26,47,30,17,16,8,8,-1,+1,-2,71%,66%,79%,145,122,174,25%,33%,18%,9,6,3,10,5,5
134,https://vlr.gg/player/32667/nora,2024-10-18 19:30:00,0.79,0.90,0.84,180,142,214,40,20,20,41,23,18,21,8,13,-4,-2,-2,68%,66%,71%,117,99,138,35%,37%,33%,3,1,2,7,3,4
135,https://vlr.gg/player/14867/emluo,2024-10-18 19:30:00,1.14,1.14,1.14,212,236,214,50,22,28,44,21,23,9,3,6,+3,+4,-1,65%,64%,66%,149,155,145,42%,37%,46%,8,4,4,5,0,5
136,https://vlr.gg/player/25400/riv,2024-10-18 19:30:00,0.99,1.04,1.02,168,173,180,41,19,22,42,20,22,23,10,13,0,-2,+2,67%,64%,69%,104,98,108,25%,35%,18%,4,1,3,4,3,1
137,https://vlr.gg/player/37901/aluvily,2024-10-18 19:30:00,1.13,0.88,0.99,174,210,163,41,21,20,46,20,26,22,7,15,-1,+1,-2,73%,75%,71%,123,141,108,35%,38%,31%,8,3,5,9,2,7
138,https://vlr.gg/player/25167/kazler,2024-10-18 19:30:00,0.52,1.23,0.91,185,122,237,39,11,28,47,24,23,18,7,11,-3,-5,+2,63%,57%,69%,127,81,163,30%,34%,28%,3,1,2,6,6,0
139,https://vlr.gg/player/28187/mili,2024-10-18 19:30:00,0.48,0.79,0.65,148,117,171,30,10,20,52,24,28,8,2,6,+8,+2,+6,68%,64%,71%,103,76,125,24%,30%,22%,12,5,7,4,3,1
140,https://vlr.gg/player/8849/sonder,2024-10-18 17:00:00,0.96,1.22,1.08,245,216,279,39,19,20,34,19,15,11,2,9,-2,-1,-1,62%,63%,62%,153,139,169,28%,21%,35%,7,2,5,9,3,6
141,https://vlr.gg/player/17/theia,2024-10-18 17:00:00,1.38,0.50,0.97,175,234,108,28,18,10,32,15,17,15,14,1,+3,+3,0,67%,75%,57%,110,153,61,23%,23%,22%,4,3,1,1,0,1
142,https://vlr.gg/player/8329/starbound,2024-10-18 17:00:00,0.83,0.99,0.90,173,176,172,28,16,12,34,20,14,7,1,6,+1,0,+1,58%,54%,62%,115,110,121,25%,21%,29%,3,2,1,2,2,0
143,https://vlr.gg/player/9185/dodonut,2024-10-18 17:00:00,0.62,0.92,0.76,167,151,185,22,10,12,35,19,16,10,5,5,-3,-3,0,69%,63%,76%,115,105,127,23%,24%,21%,6,4,2,9,7,2
144,https://vlr.gg/player/33694/evv,2024-10-18 17:00:00,0.58,0.39,0.49,116,120,114,18,10,8,37,19,18,8,6,2,0,-1,+1,53%,58%,48%,78,89,66,33%,48%,22%,2,0,2,2,1,1
145,https://vlr.gg/player/21486/sarahcat,2024-10-18 17:00:00,1.23,1.74,1.50,263,192,325,41,15,26,23,10,13,16,6,10,+2,-1,+3,82%,71%,92%,177,131,217,29%,19%,36%,4,1,3,2,2,0
146,https://vlr.gg/player/17976/florescent,2024-10-18 17:00:00,1.58,1.20,1.38,289,337,246,44,25,19,28,13,15,12,5,7,+3,+3,0,69%,71%,67%,189,213,168,37%,38%,37%,11,6,5,8,3,5
147,https://vlr.gg/player/17397/noia,2024-10-18 17:00:00,1.03,1.11,1.08,225,185,258,35,13,22,29,13,16,10,6,4,0,-2,+2,69%,62%,75%,146,134,157,26%,40%,20%,4,1,3,4,3,1
148,https://vlr.gg/player/3063/mel,2024-10-18 17:00:00,1.09,0.79,0.93,201,232,174,32,17,15,31,15,16,14,11,3,-1,+1,-2,73%,86%,63%,128,150,109,26%,28%,24%,4,2,2,5,1,4
149,https://vlr.gg/player/3079/alexis,2024-10-18 17:00:00,1.04,0.81,0.92,111,125,99,20,10,10,24,11,13,26,13,13,-3,-2,-1,80%,86%,75%,66,74,59,40%,35%,47%,0,0,0,3,2,1
150,https://vlr.gg/player/45494/proxh,2024-10-18 15:30:00,1.28,1.91,1.52,312,258,404,43,21,22,26,16,10,19,13,6,+8,+2,+6,87%,88%,87%,206,177,253,31%,33%,28%,10,4,6,2,2,0
151,https://vlr.gg/player/22518/mimori,2024-10-18 15:30:00,0.89,1.68,1.19,180,132,260,25,9,16,21,14,7,16,11,5,-1,-1,0,87%,83%,93%,139,100,200,27%,21%,33%,1,0,1,2,1,1
152,https://vlr.gg/player/27789/deyten,2024-10-18 15:30:00,1.15,1.01,1.09,181,193,163,28,20,8,22,13,9,8,1,7,0,0,0,74%,67%,87%,125,132,113,38%,52%,24%,2,1,1,2,1,1
153,https://vlr.gg/player/33974/appa,2024-10-18 15:30:00,1.13,0.96,1.06,264,313,186,38,26,12,30,21,9,13,7,6,+3,+3,0,77%,71%,87%,176,202,136,19%,19%,19%,8,6,2,5,3,2
154,https://vlr.gg/player/7991/hyperr,2024-10-18 15:30:00,0.96,1.13,1.02,145,143,144,21,13,8,19,13,6,18,10,8,+1,+2,-1,82%,75%,93%,92,92,92,17%,22%,10%,4,4,0,3,2,1
155,https://vlr.gg/player/23174/snowi,2024-10-18 15:30:00,1.18,1.49,1.37,253,227,270,34,11,23,26,11,15,9,3,6,-1,-1,0,59%,47%,67%,180,157,195,31%,33%,30%,2,0,2,3,1,2
156,https://vlr.gg/player/36403/tenji,2024-10-18 15:30:00,1.06,1.17,1.13,222,221,220,29,11,18,29,12,17,15,3,12,+2,+1,+1,72%,73%,71%,145,150,142,36%,32%,38%,2,1,1,0,0,0
157,https://vlr.gg/player/18192/ryn,2024-10-18 15:30:00,0.73,0.86,0.81,163,173,157,22,8,14,31,13,18,14,3,11,-6,-2,-4,56%,53%,58%,106,123,95,28%,42%,22%,1,0,1,7,2,5
158,https://vlr.gg/player/42696/yorkings,2024-10-18 15:30:00,0.31,0.86,0.65,150,120,169,17,5,12,33,15,18,11,3,8,+1,+1,0,64%,53%,71%,101,88,109,29%,32%,28%,4,2,2,3,1,2
159,https://vlr.gg/player/29951/ziad,2024-10-18 15:30:00,0.37,0.50,0.45,138,156,128,16,6,10,36,15,21,8,4,4,-7,-4,-3,54%,60%,50%,90,104,80,20%,17%,23%,5,2,3,12,6,6
160,https://vlr.gg/player/1524/h1ber,2024-10-18 14:10:00,1.46,1.14,1.32,236,237,214,37,25,12,26,12,14,13,3,10,+3,0,+3,73%,77%,68%,145,145,146,34%,38%,31%,5,2,3,2,2,0
161,https://vlr.gg/player/252/d3ffo,2024-10-18 14:10:00,1.33,1.17,1.26,247,237,244,38,21,17,24,13,11,10,7,3,+4,+6,-2,69%,69%,68%,154,151,157,25%,25%,25%,11,9,2,7,3,4
162,https://vlr.gg/player/402/insider,2024-10-18 14:10:00,1.40,0.98,1.22,232,259,171,37,27,10,27,14,13,5,3,2,+3,+1,+2,76%,81%,68%,140,158,116,33%,33%,31%,4,2,2,1,1,0
163,https://vlr.gg/player/443/zeddy,2024-10-18 14:10:00,0.89,1.13,1.00,195,184,201,31,17,14,31,18,13,12,5,7,-4,0,-4,67%,69%,63%,123,127,119,33%,40%,26%,1,1,0,5,1,4
164,https://vlr.gg/player/1615/destrian,2024-10-18 14:10:00,0.66,0.92,0.77,119,93,160,18,8,10,27,14,13,10,4,6,+1,+1,0,64%,62%,68%,82,60,113,26%,20%,32%,5,3,2,4,2,2
165,https://vlr.gg/player/2884/daniel0,2024-10-18 14:10:00,1.62,0.84,1.17,210,311,162,36,22,14,30,11,19,14,7,7,0,+2,-2,64%,68%,62%,146,192,112,40%,43%,37%,5,4,1,5,2,3
166,https://vlr.gg/player/17861/blastinho,2024-10-18 14:10:00,0.64,1.29,1.01,216,161,267,34,10,24,30,13,17,5,5,0,+1,0,+1,69%,68%,69%,141,109,164,22%,18%,25%,7,2,5,6,2,4
167,https://vlr.gg/player/13430/krysys,2024-10-18 14:10:00,0.86,0.75,0.80,164,164,154,25,11,14,33,13,20,9,4,5,-3,-1,-2,64%,79%,54%,111,105,115,31%,39%,26%,0,0,0,3,1,2
168,https://vlr.gg/player/19588/neptuno,2024-10-18 14:10:00,0.81,0.50,0.63,121,135,118,18,9,9,32,11,21,9,4,5,-4,+1,-5,47%,58%,38%,75,72,77,26%,39%,17%,4,3,1,8,2,6
169,https://vlr.gg/player/8811/humanz,2024-10-18 14:10:00,0.64,0.56,0.59,151,181,140,22,12,10,36,15,21,5,3,2,-1,-1,0,47%,53%,42%,110,113,109,32%,26%,37%,3,1,2,4,2,2
170,https://vlr.gg/player/4851/rexs,2024-10-18 12:00:00,1.03,1.13,1.08,221,215,221,36,16,20,36,18,18,14,11,3,+3,+1,+2,70%,73%,67%,142,146,139,30%,24%,36%,7,1,6,4,0,4
171,https://vlr.gg/player/2835/kyrrz,2024-10-18 12:00:00,0.75,1.04,0.90,176,145,208,28,10,18,36,19,17,20,16,4,-2,0,-2,65%,73%,58%,112,87,135,40%,42%,38%,1,1,0,3,1,2
172,https://vlr.gg/player/29972/michel,2024-10-18 12:00:00,0.94,0.81,0.87,223,251,209,35,18,17,41,20,21,8,4,4,-1,-4,+3,54%,59%,50%,147,159,135,27%,28%,27%,8,4,4,9,8,1
173,https://vlr.gg/player/31553/pukytoo,2024-10-18 12:00:00,1.01,0.72,0.86,191,221,159,31,17,14,35,17,18,2,2,0,-1,-2,+1,63%,68%,58%,119,135,105,40%,37%,43%,3,1,2,4,3,1
174,https://vlr.gg/player/24359/faska,2024-10-18 12:00:00,0.77,0.64,0.70,154,160,147,24,14,10,36,18,18,11,2,9,-3,-1,-2,74%,77%,71%,111,111,111,25%,27%,25%,2,1,1,5,2,3
175,https://vlr.gg/player/2313/feqew,2024-10-18 12:00:00,1.54,1.30,1.42,291,311,276,50,28,22,30,16,14,9,5,4,+3,0,+3,76%,67%,86%,181,183,180,36%,41%,31%,5,2,3,2,2,0
176,https://vlr.gg/player/29553/dagg3r,2024-10-18 12:00:00,1.61,1.15,1.39,243,249,233,40,21,19,26,11,15,16,8,8,+1,+1,0,80%,83%,77%,163,175,151,39%,47%,31%,5,2,3,4,1,3
177,https://vlr.gg/player/5854/z3ro,2024-10-18 12:00:00,0.99,1.50,1.24,224,186,270,37,16,21,30,17,13,17,7,10,+3,+2,+1,83%,79%,86%,146,124,170,36%,38%,35%,4,2,2,1,0,1
178,https://vlr.gg/player/3784/katu,2024-10-18 12:00:00,0.74,0.92,0.83,197,181,211,34,16,18,34,17,17,6,2,4,0,-2,+2,80%,83%,77%,133,134,131,34%,33%,34%,6,2,4,6,4,2
179,https://vlr.gg/player/173/l0udly,2024-10-18 12:00:00,0.59,0.69,0.64,138,125,149,23,11,12,34,18,16,17,10,7,-3,-3,0,67%,71%,64%,83,72,94,34%,31%,37%,5,3,2,8,6,2
180,https://vlr.gg/player/7987/kovaq,2024-10-18 12:00:00,1.29,1.15,1.23,256,271,234,71,40,31,50,25,25,8,7,1,-6,-5,-1,69%,67%,71%,167,181,150,30%,30%,30%,8,6,2,14,11,3
181,https://vlr.gg/player/12593/felix,2024-10-18 12:00:00,1.19,0.92,1.06,218,215,216,53,32,21,51,23,28,29,14,15,+7,+2,+5,80%,87%,71%,146,150,141,22%,27%,17%,14,5,9,7,3,4
182,https://vlr.gg/player/122/luckerrr,2024-10-18 12:00:00,1.10,0.93,1.02,207,216,204,53,30,23,52,25,27,13,6,7,-2,+1,-3,69%,77%,60%,140,147,133,26%,22%,31%,8,4,4,10,3,7
183,https://vlr.gg/player/20302/jini,2024-10-18 12:00:00,1.01,0.71,0.86,174,204,141,46,29,17,56,29,27,36,19,17,-3,-2,-1,74%,82%,66%,114,141,84,23%,30%,15%,2,1,1,5,3,2
184,https://vlr.gg/player/7968/stavinci,2024-10-18 12:00:00,0.80,0.81,0.81,151,149,163,40,20,20,53,26,27,24,13,11,0,-1,+1,69%,77%,60%,103,103,103,38%,38%,39%,3,1,2,3,2,1
185,https://vlr.gg/player/15178/canefis,2024-10-18 12:00:00,1.14,1.24,1.19,199,176,227,53,23,30,45,17,28,29,11,18,+2,0,+2,80%,77%,82%,140,115,163,34%,36%,33%,4,2,2,2,2,0
186,https://vlr.gg/player/45490/ico,2024-10-18 12:00:00,1.34,0.98,1.15,258,307,223,68,38,30,57,25,32,10,4,6,+6,+1,+5,70%,66%,74%,159,184,137,25%,21%,30%,20,10,10,14,9,5
187,https://vlr.gg/player/30754/karma,2024-10-18 12:00:00,0.99,1.11,1.05,203,182,230,52,23,29,54,24,30,41,21,20,+3,-1,+4,78%,80%,77%,136,125,146,24%,26%,23%,7,1,6,4,2,2
188,https://vlr.gg/player/5477/leon,2024-10-18 12:00:00,1.28,0.60,0.92,177,221,128,45,29,16,49,20,29,15,7,8,-5,0,-5,65%,74%,56%,112,139,89,23%,26%,19%,3,2,1,8,2,6
189,https://vlr.gg/player/22180/spmak,2024-10-18 12:00:00,0.71,0.93,0.83,191,168,214,42,20,22,58,27,31,22,8,14,-2,-1,-1,68%,66%,69%,137,121,152,15%,19%,12%,5,2,3,7,3,4
190,https://vlr.gg/player/4377/johnolsen,2024-10-18 09:15:00,1.02,1.41,1.20,250,229,269,61,28,33,46,27,19,16,8,8,-1,+3,-4,74%,64%,85%,162,154,171,24%,25%,23%,14,11,3,15,8,7
191,https://vlr.gg/player/4378/lammysnax,2024-10-18 09:15:00,0.97,1.19,1.08,197,196,200,47,25,22,44,25,19,21,9,12,0,+1,-1,77%,78%,76%,138,131,144,27%,28%,26%,1,1,0,1,0,1
192,https://vlr.gg/player/27254/leviathan,2024-10-18 09:15:00,0.92,1.07,0.99,209,204,214,52,27,25,53,28,25,15,7,8,+2,0,+2,80%,81%,79%,135,132,138,44%,38%,52%,6,2,4,4,2,2
193,https://vlr.gg/player/3401/ptc,2024-10-18 09:15:00,1.08,0.91,0.99,210,230,190,48,27,21,50,26,24,13,9,4,-2,-1,-1,68%,67%,70%,138,146,128,31%,36%,26%,9,3,6,11,4,7
194,https://vlr.gg/player/2388/theelovefamily,2024-10-18 09:15:00,0.68,0.98,0.82,159,127,194,44,18,26,48,25,23,19,11,8,+2,+1,+1,67%,67%,67%,97,82,112,33%,37%,30%,5,3,2,3,2,1
195,https://vlr.gg/player/2366/alert,2024-10-18 09:15:00,1.10,1.31,1.21,263,277,249,63,30,33,52,27,25,18,4,14,+3,+4,-1,72%,73%,72%,172,180,165,29%,29%,29%,12,9,3,9,5,4
196,https://vlr.gg/player/23930/potter,2024-10-18 09:15:00,0.94,1.27,1.11,238,243,235,59,28,31,51,28,23,14,5,9,+3,+5,-2,72%,70%,75%,152,153,152,32%,29%,36%,12,8,4,9,3,6
197,https://vlr.gg/player/12289/siraww,2024-10-18 09:15:00,1.10,0.78,0.93,181,212,151,43,24,19,48,23,25,18,9,9,-4,-1,-3,64%,67%,61%,128,151,108,24%,25%,23%,0,0,0,4,1,3
198,https://vlr.gg/player/2368/b3ta,2024-10-18 09:15:00,0.51,1.18,0.86,195,134,254,46,13,33,53,26,27,25,15,10,-1,-4,+3,67%,70%,64%,120,83,154,34%,31%,36%,7,1,6,8,5,3
199,https://vlr.gg/player/1908/kongared,2024-10-18 09:15:00,0.71,0.82,0.77,140,126,149,30,15,15,48,23,25,33,10,23,-2,-1,-1,71%,79%,64%,87,79,95,30%,35%,27%,3,0,3,5,1,4
200,https://vlr.gg/player/48206/7er,2024-10-18 07:00:00,,,,252,,,63,,,43,,,29,,,,,,,,,,,,,,,,,,,,
201,https://vlr.gg/player/17447/alyssa,2024-10-18 07:00:00,,,,221,,,58,,,51,,,14,,,,,,,,,,,,,,,,,,,,
202,https://vlr.gg/player/48205/x1aowen,2024-10-18 07:00:00,,,,182,,,41,,,50,,,29,,,,,,,,,,,,,,,,,,,,
203,https://vlr.gg/player/25443/bambi,2024-10-18 07:00:00,,,,173,,,43,,,45,,,15,,,,,,,,,,,,,,,,,,,,
204,https://vlr.gg/player/48207/elina,2024-10-18 07:00:00,,,,118,,,28,,,56,,,11,,,,,,,,,,,,,,,,,,,,
205,https://vlr.gg/player/48159/yyni,2024-10-18 07:00:00,,,,274,,,66,,,47,,,27,,,,,,,,,,,,,,,,,,,,
206,https://vlr.gg/player/48156/yumiiurx,2024-10-18 07:00:00,,,,244,,,58,,,54,,,21,,,,,,,,,,,,,,,,,,,,
207,https://vlr.gg/player/48158/xkb,2024-10-18 07:00:00,,,,216,,,51,,,42,,,29,,,,,,,,,,,,,,,,,,,,
208,https://vlr.gg/player/48157/kiaki,2024-10-18 07:00:00,,,,160,,,37,,,45,,,10,,,,,,,,,,,,,,,,,,,,
209,https://vlr.gg/player/39397/7wyy,2024-10-18 07:00:00,,,,153,,,33,,,45,,,38,,,,,,,,,,,,,,,,,,,,
210,https://vlr.gg/player/12098/kadoom,2024-10-18 07:00:00,1.19,1.39,1.29,268,266,271,44,22,22,29,13,16,5,4,1,-2,-2,0,75%,77%,73%,170,165,175,24%,23%,25%,7,5,2,9,7,2
211,https://vlr.gg/player/24679/cgrs,2024-10-18 07:00:00,1.16,1.36,1.26,236,185,288,36,14,22,25,10,15,12,7,5,+3,+2,+1,82%,91%,73%,147,120,174,21%,14%,27%,4,2,2,1,0,1
212,https://vlr.gg/player/13784/killua,2024-10-18 07:00:00,1.62,0.57,1.10,222,283,160,37,24,13,31,12,19,2,1,1,-3,+1,-4,70%,91%,50%,148,196,101,42%,43%,41%,5,3,2,8,2,6
213,https://vlr.gg/player/8582/laz,2024-10-18 07:00:00,1.25,0.70,0.97,179,214,145,27,17,10,27,10,17,13,6,7,-1,+1,-2,77%,86%,68%,123,140,106,30%,26%,38%,2,1,1,3,0,3
214,https://vlr.gg/player/27244/seph1roth,2024-10-18 07:00:00,1.01,0.71,0.86,155,143,167,24,13,11,29,11,18,17,8,9,-2,-1,-1,80%,91%,68%,101,91,111,37%,38%,35%,1,0,1,3,1,2
215,https://vlr.gg/player/12291/arpoom,2024-10-18 07:00:00,1.38,1.01,1.19,255,325,186,44,28,16,34,17,17,5,3,2,0,0,0,73%,82%,64%,157,195,120,39%,46%,29%,3,0,3,3,0,3
216,https://vlr.gg/player/31498/lorangez,2024-10-18 07:00:00,1.24,0.65,0.95,187,222,153,29,19,10,32,12,20,17,7,10,+5,+4,+1,84%,95%,73%,126,130,122,34%,37%,31%,6,4,2,1,0,1
217,https://vlr.gg/player/16977/socools0da,2024-10-18 07:00:00,1.00,0.71,0.85,178,201,156,25,14,11,32,14,18,14,10,4,+2,+2,0,61%,73%,50%,126,141,111,30%,28%,33%,5,4,1,3,2,1
218,https://vlr.gg/player/27225/d4rf,2024-10-18 07:00:00,0.94,0.57,0.76,159,175,144,23,14,9,34,15,19,16,8,8,-1,+1,-2,66%,73%,59%,106,113,99,35%,34%,35%,5,3,2,6,2,4
219,https://vlr.gg/player/25535/vickyz,2024-10-18 07:00:00,0.40,0.60,0.50,136,140,131,20,10,10,37,21,16,6,4,2,-1,-2,+1,55%,45%,64%,87,87,86,26%,24%,28%,6,3,3,7,5,2
220,https://vlr.gg/player/13232/muffyn,2024-10-18 05:00:00,,,,330,,,40,,,28,,,9,,,,,,,,,,,,,,,,,,,,
221,https://vlr.gg/player/48160/laiyin,2024-10-18 05:00:00,,,,267,,,34,,,22,,,16,,,,,,,,,,,,,,,,,,,,
222,https://vlr.gg/player/25415/yusin,2024-10-18 05:00:00,,,,223,,,23,,,23,,,15,,,,,,,,,,,,,,,,,,,,
223,https://vlr.gg/player/1909/jinny,2024-10-18 05:00:00,,,,192,,,26,,,20,,,24,,,,,,,,,,,,,,,,,,,,
224,https://vlr.gg/player/48161/1hp,2024-10-18 05:00:00,,,,140,,,20,,,23,,,8,,,,,,,,,,,,,,,,,,,,
225,https://vlr.gg/player/17526/clem,2024-10-18 05:00:00,,,,286,,,35,,,31,,,3,,,,,,,,,,,,,,,,,,,,
226,https://vlr.gg/player/15307/jue,2024-10-18 05:00:00,,,,216,,,25,,,30,,,13,,,,,,,,,,,,,,,,,,,,
227,https://vlr.gg/player/41164/ysy,2024-10-18 05:00:00,,,,174,,,20,,,28,,,10,,,,,,,,,,,,,,,,,,,,
228,https://vlr.gg/player/15304/xixi,2024-10-18 05:00:00,,,,159,,,20,,,29,,,3,,,,,,,,,,,,,,,,,,,,
229,https://vlr.gg/player/25489/chloe,2024-10-18 05:00:00,,,,138,,,16,,,25,,,10,,,,,,,,,,,,,,,,,,,,
230,https://vlr.gg/player/14403/marceline,2024-10-17 19:15:00,0.83,1.72,1.26,277,223,340,76,30,46,53,31,22,12,3,9,+6,0,+6,76%,71%,81%,170,135,208,29%,44%,22%,15,8,7,9,8,1
231,https://vlr.gg/player/19556/melya,2024-10-17 19:15:00,0.93,1.38,1.15,229,212,238,58,28,30,47,30,17,22,13,9,+1,0,+1,77%,79%,75%,152,142,163,23%,27%,20%,3,1,2,2,1,1
232,https://vlr.gg/player/32667/nora,2024-10-17 19:15:00,1.05,0.94,0.99,166,181,138,40,24,16,45,28,17,27,14,13,-1,-1,0,76%,71%,81%,103,117,89,30%,26%,35%,2,0,2,3,1,2
233,https://vlr.gg/player/28870/k0rupt,2024-10-17 19:15:00,0.68,1.30,0.98,210,168,270,59,23,36,56,32,24,20,4,16,-2,-2,0,74%,66%,83%,146,113,181,28%,24%,32%,11,6,5,13,8,5
234,https://vlr.gg/player/30700/elab0rate,2024-10-17 19:15:00,0.62,1.14,0.87,202,160,229,49,21,28,52,30,22,12,2,10,+2,-3,+5,68%,58%,78%,123,105,142,27%,41%,21%,9,1,8,7,4,3
235,https://vlr.gg/player/17951/karie,2024-10-17 19:15:00,0.79,1.46,1.13,237,179,294,62,21,41,55,29,26,20,8,12,0,-4,+4,66%,53%,79%,159,119,197,33%,32%,34%,4,0,4,4,4,0
236,https://vlr.gg/player/17950/avery,2024-10-17 19:15:00,0.62,1.29,0.96,208,166,246,53,20,33,57,33,24,26,8,18,-4,-3,-1,73%,67%,79%,135,114,156,29%,26%,31%,5,3,2,9,6,3
237,https://vlr.gg/player/28549/superkat,2024-10-17 19:15:00,0.68,1.16,0.93,191,176,207,47,20,27,55,32,23,13,9,4,-6,-6,0,66%,61%,71%,134,126,141,27%,26%,29%,9,3,6,15,9,6
238,https://vlr.gg/player/26032/panday,2024-10-17 19:15:00,1.00,0.78,0.89,170,210,135,46,26,20,56,30,26,9,3,6,+1,+1,0,65%,67%,63%,109,129,91,34%,35%,33%,7,4,3,6,3,3
239,https://vlr.gg/player/45801/terror,2024-10-17 19:15:00,0.51,1.14,0.83,181,133,229,45,15,30,59,32,27,26,14,12,+3,0,+3,70%,58%,82%,125,84,163,32%,26%,35%,9,2,7,6,2,4
240,https://vlr.gg/player/14867/emluo,2024-10-17 17:00:00,1.91,1.44,1.65,311,318,304,48,22,26,28,8,20,13,5,8,+7,+4,+3,84%,84%,83%,193,201,187,58%,58%,58%,10,5,5,3,1,2
241,https://vlr.gg/player/37901/aluvily,2024-10-17 17:00:00,1.37,1.51,1.44,250,260,244,43,20,23,25,11,14,9,6,3,+2,+1,+1,86%,89%,83%,162,174,153,40%,41%,38%,2,1,1,0,0,0
242,https://vlr.gg/player/28187/mili,2024-10-17 17:00:00,1.75,0.65,1.14,206,287,143,33,21,12,28,9,19,13,5,8,-3,+1,-4,84%,95%,75%,142,182,111,38%,35%,41%,2,2,0,5,1,4
243,https://vlr.gg/player/25167/kazler,2024-10-17 17:00:00,0.58,1.18,0.91,202,131,258,29,8,21,33,14,19,11,6,5,+2,-1,+3,77%,74%,79%,135,97,165,16%,22%,14%,7,2,5,5,3,2
244,https://vlr.gg/player/25400/riv,2024-10-17 17:00:00,0.77,0.40,0.56,101,125,82,14,8,6,29,11,18,17,9,8,-3,0,-3,67%,84%,54%,72,78,66,18%,17%,20%,3,2,1,6,2,4
245,https://vlr.gg/player/25510/teddyisfluffy,2024-10-17 17:00:00,1.17,0.99,1.09,242,257,220,35,22,13,32,17,15,12,5,7,+3,+3,0,70%,79%,58%,147,157,133,28%,23%,37%,6,4,2,3,1,2
246,https://vlr.gg/player/28547/habibti,2024-10-17 17:00:00,1.38,0.60,1.03,233,302,144,34,24,10,34,17,17,18,17,1,-5,-2,-3,65%,79%,47%,148,192,94,24%,22%,32%,1,1,0,6,3,3
247,https://vlr.gg/player/14722/slandy,2024-10-17 17:00:00,0.94,0.66,0.81,143,136,153,22,13,9,29,14,15,10,7,3,-3,-2,-1,56%,58%,53%,96,98,94,25%,32%,18%,0,0,0,3,2,1
248,https://vlr.gg/player/25246/bunnybee,2024-10-17 17:00:00,0.76,0.64,0.71,191,212,167,28,17,11,37,21,16,7,6,1,+1,+2,-1,56%,63%,47%,122,142,96,25%,30%,14%,9,6,3,8,4,4
249,https://vlr.gg/player/6575/aniemal,2024-10-17 17:00:00,0.70,0.68,0.69,177,168,191,24,14,10,35,19,16,8,5,3,-1,-1,0,67%,71%,63%,128,123,134,20%,18%,22%,3,1,2,4,2,2
250,https://vlr.gg/player/10448/kozok,2024-10-17 14:35:00,1.20,1.23,1.22,187,161,207,31,12,19,23,9,14,26,11,15,-2,-1,-1,86%,85%,88%,113,103,121,17%,38%,10%,3,1,2,5,2,3
251,https://vlr.gg/player/16012/akira,2024-10-17 14:35:00,1.24,1.11,1.17,242,244,236,35,17,18,27,12,15,16,7,9,+4,+3,+1,68%,75%,63%,159,166,153,28%,30%,26%,5,3,2,1,0,1
252,https://vlr.gg/player/42557/6ankai,2024-10-17 14:35:00,1.21,1.13,1.17,242,240,248,39,18,21,33,14,19,6,3,3,-2,-3,+1,73%,80%,67%,159,160,159,28%,33%,23%,6,2,4,8,5,3
253,https://vlr.gg/player/33517/tripsy,2024-10-17 14:35:00,1.13,1.13,1.13,253,306,207,38,22,16,31,15,16,8,1,7,-3,-2,-1,80%,80%,79%,155,176,139,33%,40%,27%,4,2,2,7,4,3
254,https://vlr.gg/player/26789/pdr,2024-10-17 14:35:00,0.91,1.21,1.07,156,136,176,25,10,15,23,11,12,24,6,18,-3,-1,-2,82%,70%,92%,100,94,105,17%,20%,15%,1,0,1,4,1,3
255,https://vlr.gg/player/29827/repteyy,2024-10-17 14:35:00,0.96,1.16,1.05,184,163,210,30,15,15,30,16,14,15,9,6,+3,+2,+1,77%,88%,65%,117,110,127,27%,37%,20%,3,2,1,0,0,0
256,https://vlr.gg/player/29638/kotaro,2024-10-17 14:35:00,1.08,0.77,0.94,180,211,144,28,18,10,32,16,16,12,5,7,-2,-1,-1,66%,75%,55%,118,137,95,49%,34%,93%,4,2,2,6,3,3
257,https://vlr.gg/player/29994/xini,2024-10-17 14:35:00,0.78,1.07,0.91,238,223,264,36,18,18,37,21,16,10,7,3,+6,+2,+4,70%,67%,75%,149,137,165,23%,22%,24%,14,7,7,8,5,3
258,https://vlr.gg/player/41846/shiro,2024-10-17 14:35:00,0.91,0.52,0.73,135,163,112,22,15,7,35,18,17,10,7,3,-1,-1,0,68%,71%,65%,101,117,83,32%,35%,26%,1,0,1,2,1,1
259,https://vlr.gg/player/31569/cyan,2024-10-17 14:35:00,0.62,0.71,0.66,132,113,153,21,10,11,34,18,16,7,2,5,0,0,0,64%,54%,75%,90,84,97,24%,24%,24%,3,2,1,3,2,1
260,https://vlr.gg/player/46179/davia,2024-10-17 12:00:00,1.26,1.36,1.32,269,259,275,63,24,39,40,16,24,7,3,4,+11,+8,+3,80%,79%,81%,165,167,164,30%,33%,28%,14,9,5,3,1,2
261,https://vlr.gg/player/13024/vuubit,2024-10-17 12:00:00,1.67,1.05,1.30,242,251,234,55,25,30,39,11,28,19,6,13,+2,+1,+1,78%,92%,69%,172,188,161,44%,41%,46%,7,1,6,5,0,5
262,https://vlr.gg/player/29998/drastz,2024-10-17 12:00:00,0.99,1.17,1.10,209,204,214,45,18,27,41,17,24,27,9,18,+4,+1,+3,78%,79%,78%,144,136,149,19%,20%,18%,5,2,3,1,1,0
263,https://vlr.gg/player/4214/eso177,2024-10-17 12:00:00,0.75,1.03,0.92,185,161,198,38,14,24,39,16,23,15,4,11,+2,+1,+1,72%,63%,78%,126,117,132,21%,27%,18%,8,4,4,6,3,3
264,https://vlr.gg/player/8590/killdream,2024-10-17 12:00:00,0.83,0.94,0.89,162,158,158,32,13,19,38,17,21,22,13,9,+1,-3,+4,70%,67%,72%,108,107,109,25%,22%,27%,6,0,6,5,3,2
265,https://vlr.gg/player/15473/yuno,2024-10-17 12:00:00,1.41,1.18,1.32,254,283,231,55,35,20,46,28,18,21,15,6,+4,+5,-1,80%,81%,79%,165,171,156,28%,33%,22%,8,6,2,4,1,3
266,https://vlr.gg/player/22314/mober,2024-10-17 12:00:00,0.90,1.19,1.01,199,186,216,46,26,20,43,26,17,5,5,0,-6,-6,0,70%,69%,71%,139,138,140,33%,28%,41%,1,0,1,7,6,1
267,https://vlr.gg/player/29958/ximy,2024-10-17 12:00:00,0.93,0.70,0.83,210,225,187,41,26,15,50,29,21,13,10,3,-3,-3,0,63%,72%,50%,130,141,113,29%,32%,21%,9,5,4,12,8,4
268,https://vlr.gg/player/31549/pando,2024-10-17 12:00:00,0.75,0.63,0.70,129,136,114,25,16,9,47,28,19,13,7,6,-4,-2,-2,68%,69%,67%,90,94,84,47%,51%,40%,1,0,1,5,2,3
269,https://vlr.gg/player/36645/tomatte,2024-10-17 12:00:00,0.54,0.75,0.62,147,131,169,30,17,13,48,29,19,24,13,11,-11,-6,-5,67%,69%,63%,93,83,108,35%,30%,40%,1,1,0,12,7,5
270,https://vlr.gg/player/23930/potter,2024-10-17 10:00:00,1.45,1.62,1.53,308,276,341,39,19,20,19,8,11,7,2,5,+2,+2,0,79%,82%,75%,197,178,217,38%,33%,44%,4,3,1,2,1,1
271,https://vlr.gg/player/2366/alert,2024-10-17 10:00:00,1.19,1.66,1.42,253,234,272,30,13,17,17,10,7,13,7,6,+6,+5,+1,88%,88%,88%,156,142,171,28%,19%,38%,8,6,2,2,1,1
272,https://vlr.gg/player/1908/kongared,2024-10-17 10:00:00,1.73,1.04,1.39,219,280,155,26,19,7,17,7,10,26,11,15,0,+1,-1,82%,82%,81%,140,182,95,28%,29%,25%,2,2,0,2,1,1
273,https://vlr.gg/player/12289/siraww,2024-10-17 10:00:00,1.36,1.37,1.36,231,208,257,28,14,14,16,7,9,7,4,3,-1,0,-1,85%,88%,81%,156,145,167,41%,59%,26%,2,1,1,3,1,2
274,https://vlr.gg/player/2368/b3ta,2024-10-17 10:00:00,1.44,0.44,0.95,153,200,101,19,14,5,18,6,12,12,5,7,-2,+1,-3,76%,88%,63%,103,140,64,31%,34%,25%,3,1,2,5,0,5
275,https://vlr.gg/player/48512/sulliva4n,2024-10-17 10:00:00,1.23,0.78,1.00,224,253,197,26,15,11,27,12,15,4,2,2,-2,+3,-5,58%,69%,47%,134,144,125,43%,45%,41%,5,5,0,7,2,5
276,https://vlr.gg/player/48511/immawrecked,2024-10-17 10:00:00,1.00,0.54,0.76,151,191,115,17,11,6,27,12,15,8,7,1,+1,+1,0,64%,75%,53%,104,129,80,17%,20%,13%,2,1,1,1,0,1
277,https://vlr.gg/player/48509/tongk,2024-10-17 10:00:00,1.03,0.37,0.69,167,224,115,20,13,7,29,13,16,6,4,2,-1,+2,-3,61%,69%,53%,104,140,71,16%,13%,25%,2,2,0,3,0,3
278,https://vlr.gg/player/48510/russody,2024-10-17 10:00:00,0.20,0.73,0.47,112,61,159,9,1,8,29,13,16,9,6,3,-3,-3,0,58%,63%,53%,82,53,109,22%,19%,24%,1,0,1,4,3,1
279,https://vlr.gg/player/48508/,2024-10-17 10:00:00,0.64,0.29,0.46,147,169,128,15,9,6,30,13,17,6,3,3,0,+1,-1,55%,63%,47%,97,107,88,27%,25%,29%,4,2,2,4,1,3
280,https://vlr.gg/player/3342/sushiboys,2024-10-17 07:00:00,1.55,1.15,1.30,188,235,156,40,20,20,29,11,18,35,12,23,0,0,0,81%,82%,81%,117,141,102,28%,23%,32%,2,2,0,2,2,0
281,https://vlr.gg/player/2388/theelovefamily,2024-10-17 07:00:00,0.75,1.47,1.19,252,183,291,54,17,37,39,17,22,10,2,8,0,0,0,71%,68%,72%,151,125,166,30%,38%,27%,7,2,5,7,2,5
282,https://vlr.gg/player/27254/leviathan,2024-10-17 07:00:00,1.14,1.20,1.18,225,202,229,46,16,30,35,13,22,18,7,11,-2,+2,-4,67%,59%,72%,148,135,157,34%,39%,31%,4,2,2,6,0,6
283,https://vlr.gg/player/4378/lammysnax,2024-10-17 07:00:00,1.09,1.19,1.15,226,187,237,41,14,27,38,15,23,29,10,19,+4,+2,+2,83%,77%,86%,142,112,160,29%,31%,27%,4,2,2,0,0,0
284,https://vlr.gg/player/4377/johnolsen,2024-10-17 07:00:00,0.79,1.09,0.97,215,187,232,43,12,31,41,16,25,12,8,4,-4,+2,-6,72%,77%,69%,140,141,139,20%,13%,26%,11,6,5,15,4,11
285,https://vlr.gg/player/31497/allr1ghtt,2024-10-17 07:00:00,0.99,1.14,1.05,198,192,212,40,24,16,41,25,16,12,6,6,0,+1,-1,79%,75%,86%,139,137,141,24%,28%,18%,3,2,1,3,1,2
286,https://vlr.gg/player/40547/zuokew,2024-10-17 07:00:00,0.93,1.11,1.00,225,227,237,47,28,19,44,30,14,5,4,1,+8,+9,-1,69%,67%,73%,142,147,135,39%,37%,43%,13,10,3,5,1,4
287,https://vlr.gg/player/48482/examp1e,2024-10-17 07:00:00,0.82,0.66,0.74,159,175,138,32,23,9,44,28,16,9,5,4,+1,+1,0,59%,61%,55%,105,111,95,25%,30%,19%,5,3,2,4,2,2
288,https://vlr.gg/player/23896/itaoearth,2024-10-17 07:00:00,0.55,0.94,0.69,134,123,181,29,18,11,44,28,16,11,5,6,-5,-2,-3,53%,42%,73%,101,87,123,26%,23%,29%,3,3,0,8,5,3
289,https://vlr.gg/player/40546/georgebest,2024-10-17 07:00:00,0.48,0.79,0.60,158,150,195,34,18,16,52,34,18,6,4,2,-2,-1,-1,62%,58%,68%,106,96,123,48%,44%,53%,6,4,2,8,5,3
290,https://vlr.gg/player/28870/k0rupt,2024-10-16 19:25:00,1.61,0.61,0.94,162,263,131,33,18,15,38,9,29,11,6,5,-5,+2,-7,67%,89%,56%,121,167,98,28%,29%,26%,2,2,0,7,0,7
291,https://vlr.gg/player/14403/marceline,2024-10-16 19:25:00,0.86,0.92,0.90,214,208,227,41,14,27,44,14,30,8,4,4,-7,-1,-6,61%,61%,61%,150,156,147,34%,33%,35%,5,3,2,12,4,8
292,https://vlr.gg/player/32667/nora,2024-10-16 19:25:00,1.22,0.70,0.87,184,241,165,36,17,19,43,12,31,15,6,9,-2,-1,-1,65%,83%,56%,128,160,112,37%,42%,34%,2,0,2,4,1,3
293,https://vlr.gg/player/19556/melya,2024-10-16 19:25:00,0.79,0.81,0.80,185,232,153,31,13,18,43,16,27,17,9,8,+5,+3,+2,70%,83%,64%,108,134,96,32%,26%,38%,7,4,3,2,1,1
294,https://vlr.gg/player/30700/elab0rate,2024-10-16 19:25:00,0.85,0.26,0.46,112,169,94,20,11,9,45,12,33,8,3,5,-7,-1,-6,52%,67%,44%,77,108,61,23%,26%,20%,3,1,2,10,2,8
295,https://vlr.gg/player/17976/florescent,2024-10-16 19:25:00,1.38,1.48,1.41,303,299,290,55,37,18,36,22,14,19,13,6,+11,+9,+2,87%,81%,100%,189,183,201,30%,30%,31%,15,11,4,4,2,2
296,https://vlr.gg/player/17397/noia,2024-10-16 19:25:00,1.71,0.62,1.34,259,296,146,51,42,9,32,16,16,10,7,3,+4,+6,-2,81%,94%,56%,164,190,112,42%,46%,33%,7,6,1,3,0,3
297,https://vlr.gg/player/3063/mel,2024-10-16 19:25:00,1.40,0.89,1.23,217,233,157,41,30,11,29,16,13,30,22,8,0,+1,-1,76%,78%,72%,130,149,90,39%,40%,38%,8,7,1,8,6,2
298,https://vlr.gg/player/3079/alexis,2024-10-16 19:25:00,0.89,1.37,1.05,157,123,256,32,16,16,31,18,13,29,17,12,+1,0,+1,85%,86%,83%,107,79,161,32%,37%,28%,3,1,2,2,1,1
299,https://vlr.gg/player/21486/sarahcat,2024-10-16 19:25:00,1.21,0.58,1.00,178,194,146,34,25,9,33,16,17,15,9,6,0,+2,-2,78%,81%,72%,118,128,97,28%,29%,26%,2,2,0,2,0,2
300,https://vlr.gg/player/6575/aniemal,2024-10-16 19:25:00,1.23,1.31,1.27,246,272,233,60,35,25,41,25,16,10,5,5,+5,+3,+2,78%,73%,83%,162,166,158,32%,30%,35%,9,6,3,4,3,1
301,https://vlr.gg/player/28547/habibti,2024-10-16 19:25:00,1.12,1.02,1.07,226,241,209,50,27,23,47,25,22,26,14,12,-4,-2,-2,78%,79%,77%,148,159,137,33%,27%,43%,2,1,1,6,3,3
302,https://vlr.gg/player/14722/slandy,2024-10-16 19:25:00,0.75,1.18,0.95,195,155,225,41,16,25,44,24,20,14,8,6,-1,-1,0,70%,64%,77%,132,116,149,27%,19%,38%,3,1,2,4,2,2
303,https://vlr.gg/player/25246/bunnybee,2024-10-16 19:25:00,0.76,0.99,0.87,216,193,241,47,22,25,48,25,23,9,6,3,+4,+1,+3,70%,70%,70%,145,134,157,29%,29%,29%,15,7,8,11,6,5
304,https://vlr.gg/player/25510/teddyisfluffy,2024-10-16 19:25:00,0.85,0.89,0.87,186,197,176,41,23,18,48,25,23,20,11,9,+5,+2,+3,71%,76%,67%,122,128,116,23%,17%,31%,7,3,4,2,1,1
305,https://vlr.gg/player/28530/calsushi,2024-10-16 19:25:00,1.29,1.27,1.27,262,274,256,59,29,30,47,22,25,8,3,5,-2,-3,+1,71%,63%,79%,174,181,167,31%,37%,25%,8,4,4,10,7,3
306,https://vlr.gg/player/43380/aria,2024-10-16 19:25:00,0.55,1.48,1.03,216,164,270,49,16,33,48,26,22,15,8,7,0,-3,+3,68%,60%,76%,143,113,170,40%,38%,42%,8,3,5,8,6,2
307,https://vlr.gg/player/37920/oranges,2024-10-16 19:25:00,0.95,0.92,0.94,187,174,199,43,18,25,46,21,25,17,8,9,+1,0,+1,76%,77%,76%,118,117,119,25%,22%,27%,5,1,4,4,1,3
308,https://vlr.gg/player/38728/raven,2024-10-16 19:25:00,0.75,1.06,0.91,202,160,238,44,18,26,49,25,24,16,6,10,-1,0,-1,65%,60%,70%,128,108,147,35%,29%,40%,2,1,1,3,1,2
309,https://vlr.gg/player/28546/venus,2024-10-16 19:25:00,0.98,0.44,0.69,151,215,98,33,23,10,51,24,27,13,5,8,-7,0,-7,68%,73%,64%,106,136,78,37%,43%,27%,4,3,1,11,3,8
310,https://vlr.gg/player/9185/dodonut,2024-10-16 17:00:00,1.63,1.82,1.73,341,333,351,60,30,30,33,19,14,10,4,6,+2,-1,+3,73%,65%,80%,226,219,233,23%,28%,20%,7,4,3,5,5,0
311,https://vlr.gg/player/33694/evv,2024-10-16 17:00:00,1.17,0.99,1.08,199,225,171,38,22,16,36,17,19,15,10,5,+6,+2,+4,78%,85%,72%,129,140,117,27%,22%,34%,6,2,4,0,0,0
312,https://vlr.gg/player/17/theia,2024-10-16 17:00:00,0.91,1.06,0.99,159,157,161,29,14,15,31,18,13,24,16,8,-2,-2,0,78%,81%,76%,101,97,104,19%,19%,20%,2,1,1,4,3,1
313,https://vlr.gg/player/8849/sonder,2024-10-16 17:00:00,0.79,1.18,0.98,213,184,253,36,14,22,38,21,17,24,11,13,+2,-3,+5,82%,81%,84%,137,123,152,26%,26%,25%,9,2,7,7,5,2
314,https://vlr.gg/player/8329/starbound,2024-10-16 17:00:00,0.64,0.79,0.71,153,140,159,25,12,13,35,19,16,14,4,10,-1,-4,+3,76%,77%,76%,98,94,101,16%,16%,16%,5,0,5,6,4,2
315,https://vlr.gg/player/37901/aluvily,2024-10-16 17:00:00,1.15,1.25,1.20,221,206,238,40,17,23,35,17,18,14,3,11,-1,-1,0,71%,60%,81%,143,140,146,24%,19%,29%,2,0,2,3,1,2
316,https://vlr.gg/player/14867/emluo,2024-10-16 17:00:00,1.00,1.08,1.04,202,195,202,38,19,19,33,17,16,11,6,5,+3,0,+3,63%,56%,69%,138,132,144,43%,55%,36%,5,1,4,2,1,1
317,https://vlr.gg/player/28187/mili,2024-10-16 17:00:00,0.89,0.82,0.85,192,225,176,33,18,15,38,20,18,9,3,6,-7,-5,-2,71%,68%,73%,136,148,125,23%,32%,15%,4,2,2,11,7,4
318,https://vlr.gg/player/25167/kazler,2024-10-16 17:00:00,0.60,0.99,0.79,182,146,218,31,11,20,40,20,20,16,10,6,-3,-4,+1,63%,64%,62%,119,92,144,23%,27%,22%,3,1,2,6,5,1
319,https://vlr.gg/player/25400/riv,2024-10-16 17:00:00,0.52,0.92,0.73,183,151,213,30,14,16,42,22,20,19,6,13,+1,-5,+6,67%,60%,73%,121,100,141,33%,37%,31%,8,1,7,7,6,1
320,https://vlr.gg/player/46200/wire,2024-10-16 17:00:00,0.74,1.48,1.10,259,207,327,50,18,32,43,25,18,3,2,1,+2,-4,+6,53%,39%,67%,164,130,200,27%,35%,23%,13,4,9,11,8,3
321,https://vlr.gg/player/39710/aurelia,2024-10-16 17:00:00,0.81,1.12,0.96,173,162,191,32,14,18,40,24,16,14,5,9,+1,0,+1,58%,46%,70%,121,113,129,23%,27%,20%,3,2,1,2,2,0
322,https://vlr.gg/player/26008/gia,2024-10-16 17:00:00,0.52,1.08,0.79,150,93,216,28,8,20,43,24,19,14,5,9,+1,-1,+2,58%,46%,70%,101,61,142,22%,18%,24%,6,1,5,5,2,3
323,https://vlr.gg/player/41746/celeste,2024-10-16 17:00:00,0.57,0.82,0.68,139,136,160,27,14,13,42,24,18,9,2,7,-5,-7,+2,56%,50%,63%,102,90,115,29%,45%,20%,3,0,3,8,7,1
324,https://vlr.gg/player/29784/hyungwonho,2024-10-16 17:00:00,0.31,0.85,0.57,108,94,119,20,8,12,42,26,16,15,5,10,-4,-2,-2,56%,46%,67%,72,58,86,16%,11%,21%,0,0,0,4,2,2
325,https://vlr.gg/player/26032/panday,2024-10-16 17:00:00,1.10,1.51,1.31,240,217,264,47,21,26,30,18,12,15,3,12,+1,-3,+4,69%,63%,75%,149,135,162,42%,57%,34%,9,3,6,8,6,2
326,https://vlr.gg/player/17951/karie,2024-10-16 17:00:00,1.05,1.47,1.26,250,251,250,53,26,27,34,20,14,19,6,13,+3,+1,+2,82%,78%,86%,151,159,143,35%,40%,31%,5,3,2,2,2,0
327,https://vlr.gg/player/45801/terror,2024-10-16 17:00:00,0.93,1.56,1.25,231,153,287,40,14,26,30,18,12,18,4,14,+2,-1,+3,80%,74%,86%,153,110,193,38%,28%,45%,4,0,4,2,1,1
328,https://vlr.gg/player/17950/avery,2024-10-16 17:00:00,1.13,1.25,1.19,197,195,193,38,18,20,29,18,11,31,17,14,-1,-1,0,78%,74%,82%,125,123,127,18%,21%,15%,2,1,1,3,2,1
329,https://vlr.gg/player/28549/superkat,2024-10-16 17:00:00,0.46,1.19,0.82,157,104,200,32,9,23,35,21,14,8,6,2,0,-5,+5,69%,52%,86%,99,71,125,23%,21%,23%,10,2,8,10,7,3
330,https://vlr.gg/player/19150/niffy,2024-10-16 09:20:00,0.89,1.60,1.26,232,179,308,60,20,40,53,30,23,35,17,18,-1,-2,+1,74%,71%,78%,164,121,204,27%,25%,29%,3,1,2,4,3,1
331,https://vlr.gg/player/6733/xze,2024-10-16 09:20:00,0.99,0.85,0.92,191,204,190,50,26,24,59,30,29,10,3,7,+2,-1,+3,63%,59%,67%,129,127,132,48%,54%,42%,8,3,5,6,4,2
332,https://vlr.gg/player/23918/reality,2024-10-16 09:20:00,0.70,1.06,0.89,155,158,162,38,17,21,52,30,22,29,9,20,+2,-2,+4,70%,59%,81%,112,110,115,24%,23%,24%,4,0,4,2,2,0
333,https://vlr.gg/player/1910/acetics,2024-10-16 09:20:00,0.52,1.04,0.78,168,136,203,41,14,27,54,30,24,17,9,8,-6,-3,-3,66%,53%,78%,113,94,131,37%,37%,38%,2,1,1,8,4,4
334,https://vlr.gg/player/15891/krx,2024-10-16 09:20:00,0.51,0.73,0.62,166,191,151,38,20,18,60,34,26,9,5,4,-7,-6,-1,60%,53%,67%,110,127,94,22%,31%,11%,13,5,8,20,11,9
335,https://vlr.gg/player/12291/arpoom,2024-10-16 09:20:00,1.04,1.56,1.29,194,160,251,52,22,30,39,23,16,27,8,19,+4,0,+4,86%,83%,88%,142,118,168,36%,38%,34%,8,2,6,4,2,2
336,https://vlr.gg/player/16977/socools0da,2024-10-16 09:20:00,1.21,1.18,1.19,239,254,203,60,34,26,42,25,17,16,6,10,+4,-1,+5,73%,64%,82%,157,166,149,37%,34%,40%,8,2,6,4,3,1
337,https://vlr.gg/player/27225/d4rf,2024-10-16 09:20:00,1.17,1.18,1.17,193,188,205,52,24,28,43,23,20,36,19,17,+2,+2,0,77%,72%,82%,128,113,144,31%,24%,37%,6,3,3,4,1,3
338,https://vlr.gg/player/25535/vickyz,2024-10-16 09:20:00,0.82,1.53,1.16,293,246,327,69,30,39,54,32,22,29,12,17,+1,-2,+3,74%,67%,82%,180,147,215,18%,17%,19%,13,7,6,12,9,3
339,https://vlr.gg/player/31498/lorangez,2024-10-16 09:20:00,0.65,1.41,1.02,184,141,249,45,14,31,49,27,22,40,14,26,-1,-3,+2,79%,72%,85%,126,97,157,24%,24%,24%,5,2,3,6,5,1
340,https://vlr.gg/player/27244/seph1roth,2024-10-16 07:00:00,1.45,1.21,1.33,247,274,223,40,22,18,28,14,14,27,9,18,+2,+1,+1,82%,82%,83%,157,180,136,34%,42%,26%,4,2,2,2,1,1
341,https://vlr.gg/player/8582/laz,2024-10-16 07:00:00,1.01,1.46,1.24,211,159,263,35,13,22,26,12,14,14,5,9,+3,+1,+2,78%,68%,87%,144,112,175,31%,30%,32%,3,1,2,0,0,0
342,https://vlr.gg/player/24679/cgrs,2024-10-16 07:00:00,0.76,1.28,1.03,206,149,263,31,10,21,29,15,14,13,6,7,-2,-2,0,78%,73%,83%,141,111,170,23%,26%,21%,3,1,2,5,3,2
343,https://vlr.gg/player/12098/kadoom,2024-10-16 07:00:00,0.59,1.32,0.96,218,180,256,35,13,22,33,19,14,8,4,4,-1,-1,0,71%,64%,78%,140,119,160,25%,20%,29%,6,3,3,7,4,3
344,https://vlr.gg/player/13784/killua,2024-10-16 07:00:00,1.04,0.39,0.71,181,252,111,30,21,9,35,18,17,9,6,3,-7,+1,-8,64%,77%,52%,115,160,72,29%,25%,36%,4,4,0,11,3,8
345,https://vlr.gg/player/20623/harddora,2024-10-16 07:00:00,1.39,1.17,1.28,260,277,241,41,23,18,33,17,16,5,2,3,+6,+3,+3,69%,65%,73%,164,183,145,35%,28%,46%,9,5,4,3,2,1
346,https://vlr.gg/player/31537/basbabe,2024-10-16 07:00:00,0.78,1.33,1.05,205,156,256,32,11,21,31,18,13,15,9,6,+2,+3,-1,69%,65%,73%,121,93,150,39%,37%,41%,4,3,1,2,0,2
347,https://vlr.gg/player/17303/fontuz,2024-10-16 07:00:00,0.96,0.79,0.88,173,205,141,27,18,9,34,17,17,19,7,12,-2,+1,-3,76%,87%,64%,115,137,93,29%,28%,30%,3,2,1,5,1,4
348,https://vlr.gg/player/35071/cher0z,2024-10-16 07:00:00,0.75,0.96,0.86,159,139,182,25,12,13,34,19,15,8,3,5,+1,+1,0,60%,52%,68%,111,107,116,33%,50%,25%,3,1,2,2,0,2
349,https://vlr.gg/player/23892/ayanokoji,2024-10-16 07:00:00,0.32,0.77,0.54,165,126,204,25,10,15,40,21,19,7,3,4,-2,-3,+1,60%,43%,77%,105,88,122,25%,30%,21%,6,3,3,8,6,2
350,https://vlr.gg/player/19556/melya,2024-10-15 20:00:00,2.06,1.67,1.84,341,369,304,51,24,27,21,10,11,19,14,5,+5,+1,+4,91%,94%,88%,219,259,190,32%,40%,27%,7,1,6,2,0,2
351,https://vlr.gg/player/14403/marceline,2024-10-15 20:00:00,1.09,1.11,1.10,244,232,258,38,16,22,32,13,19,5,2,3,+5,+1,+4,72%,83%,64%,153,141,162,32%,25%,41%,8,2,6,3,1,2
352,https://vlr.gg/player/32667/nora,2024-10-15 20:00:00,1.15,0.99,1.05,159,167,154,24,11,13,22,9,13,16,4,12,-2,-1,-1,77%,83%,72%,103,110,97,23%,28%,19%,3,1,2,5,2,3
353,https://vlr.gg/player/30700/elab0rate,2024-10-15 20:00:00,1.18,0.89,1.02,173,191,161,29,15,14,25,10,15,6,1,5,-1,0,-1,72%,72%,72%,123,147,105,35%,43%,30%,4,3,1,5,3,2
354,https://vlr.gg/player/28870/k0rupt,2024-10-15 20:00:00,0.87,0.84,0.85,202,204,179,27,12,15,31,13,18,13,6,7,+2,+1,+1,60%,67%,56%,138,155,125,34%,42%,28%,4,3,1,2,2,0
355,https://vlr.gg/player/3092/starlight,2024-10-15 20:00:00,1.03,0.98,1.01,187,184,212,29,16,13,31,16,15,11,7,4,-5,-1,-4,70%,64%,78%,130,125,137,26%,28%,24%,1,1,0,6,2,4
356,https://vlr.gg/player/14722/slandy,2024-10-15 20:00:00,0.89,1.03,0.95,188,169,216,28,15,13,32,18,14,12,5,7,+3,-1,+4,79%,68%,94%,117,101,138,28%,31%,26%,5,1,4,2,2,0
357,https://vlr.gg/player/28547/habibti,2024-10-15 20:00:00,0.96,0.86,0.92,178,172,209,29,16,13,32,16,16,10,6,4,+1,0,+1,65%,72%,56%,121,111,135,41%,41%,42%,3,2,1,2,2,0
358,https://vlr.gg/player/25246/bunnybee,2024-10-15 20:00:00,0.75,0.48,0.63,156,179,155,26,16,10,37,20,17,2,1,1,-5,-2,-3,51%,48%,56%,105,105,105,39%,35%,44%,7,5,2,12,7,5
359,https://vlr.gg/player/6575/aniemal,2024-10-15 20:00:00,0.68,0.34,0.54,142,161,115,19,13,6,37,21,16,9,6,3,-3,-3,0,60%,64%,56%,100,111,86,23%,27%,17%,1,0,1,4,3,1
360,https://vlr.gg/player/17397/noia,2024-10-15 18:45:00,2.28,1.42,1.85,295,353,238,34,22,12,9,4,5,8,4,4,+1,+2,-1,97%,93%,100%,201,239,164,35%,43%,28%,2,2,0,1,0,1
361,https://vlr.gg/player/17976/florescent,2024-10-15 18:45:00,1.55,1.79,1.67,317,266,368,34,16,18,13,7,6,11,6,5,+8,+2,+6,87%,87%,87%,210,193,227,34%,30%,38%,11,4,7,3,2,1
362,https://vlr.gg/player/3079/alexis,2024-10-15 18:45:00,1.12,2.18,1.65,218,109,327,27,7,20,7,4,3,20,9,11,+1,-1,+2,87%,73%,100%,138,73,203,39%,26%,46%,2,0,2,1,1,0
363,https://vlr.gg/player/3063/mel,2024-10-15 18:45:00,1.33,1.26,1.29,213,256,171,24,14,10,11,8,3,9,7,2,+4,+3,+1,83%,80%,87%,132,164,99,23%,17%,32%,6,4,2,2,1,1
364,https://vlr.gg/player/21486/sarahcat,2024-10-15 18:45:00,0.88,1.34,1.11,169,128,212,18,8,10,13,7,6,14,4,10,-2,-1,-1,87%,87%,87%,120,102,138,23%,24%,22%,0,0,0,2,1,1
365,https://vlr.gg/player/38728/raven,2024-10-15 18:45:00,0.61,0.61,0.61,120,140,101,13,7,6,25,13,12,2,1,1,-1,+1,-2,57%,60%,53%,79,95,64,29%,25%,35%,1,1,0,2,0,2
366,https://vlr.gg/player/28530/calsushi,2024-10-15 18:45:00,0.38,0.60,0.48,128,102,153,10,5,5,29,15,14,7,2,5,-1,-1,0,40%,40%,40%,92,73,111,24%,27%,22%,1,1,0,2,2,0
367,https://vlr.gg/player/28546/venus,2024-10-15 18:45:00,0.09,0.85,0.46,110,54,166,11,2,9,27,14,13,1,0,1,-5,-4,-1,37%,33%,40%,79,51,107,32%,40%,28%,3,1,2,8,5,3
368,https://vlr.gg/player/43380/aria,2024-10-15 18:45:00,0.24,0.64,0.44,123,106,141,12,6,6,27,14,13,6,0,6,0,-1,+1,57%,47%,67%,70,57,84,42%,67%,29%,4,1,3,4,2,2
369,https://vlr.gg/player/37920/oranges,2024-10-15 18:45:00,0.27,0.16,0.21,69,63,77,7,3,4,29,14,15,5,2,3,-5,-2,-3,37%,33%,40%,48,45,51,20%,25%,17%,0,0,0,5,2,3
370,https://vlr.gg/player/8849/sonder,2024-10-15 17:00:00,1.67,1.72,1.68,359,344,418,43,34,9,20,12,8,12,8,4,+4,+4,0,84%,88%,71%,216,199,274,21%,20%,23%,6,5,1,2,1,1
371,https://vlr.gg/player/8329/starbound,2024-10-15 17:00:00,1.59,1.80,1.64,282,305,239,34,28,6,13,11,2,9,6,3,+5,+4,+1,87%,83%,100%,186,186,182,23%,25%,17%,5,4,1,0,0,0
372,https://vlr.gg/player/33694/evv,2024-10-15 17:00:00,1.20,1.74,1.32,220,214,227,28,20,8,15,13,2,12,10,2,-1,0,-1,87%,88%,86%,138,143,121,30%,35%,16%,2,2,0,3,2,1
373,https://vlr.gg/player/17/theia,2024-10-15 17:00:00,1.26,1.42,1.30,182,172,226,19,14,5,13,10,3,25,19,6,+1,+1,0,90%,92%,86%,112,106,133,24%,24%,23%,3,2,1,2,1,1
374,https://vlr.gg/player/9185/dodonut,2024-10-15 17:00:00,1.19,0.98,1.14,205,209,148,20,16,4,14,11,3,8,7,1,+4,+3,+1,90%,88%,100%,136,143,110,20%,19%,24%,6,5,1,2,2,0
375,https://vlr.gg/player/39710/aurelia,2024-10-15 17:00:00,0.94,1.07,1.04,198,196,203,21,5,16,24,6,18,5,1,4,-2,-2,0,55%,43%,58%,129,119,132,26%,16%,30%,2,0,2,4,2,2
376,https://vlr.gg/player/41746/celeste,2024-10-15 17:00:00,0.41,0.96,0.84,205,118,231,23,3,20,29,7,22,4,2,2,0,0,0,55%,57%,54%,127,66,145,52%,50%,53%,0,0,0,0,0,0
377,https://vlr.gg/player/46200/wire,2024-10-15 17:00:00,0.75,0.36,0.44,151,189,143,14,4,10,31,7,24,5,2,3,-3,+1,-4,45%,43%,46%,99,126,91,28%,26%,30%,7,3,4,10,2,8
378,https://vlr.gg/player/26008/gia,2024-10-15 17:00:00,0.14,0.46,0.35,99,67,109,8,1,7,29,7,22,10,2,8,-5,0,-5,48%,57%,46%,73,49,80,13%,14%,13%,0,0,0,5,0,5
379,https://vlr.gg/player/29784/hyungwonho,2024-10-15 17:00:00,0.45,0.16,0.23,83,134,66,7,3,4,31,7,24,4,2,2,-3,0,-3,32%,57%,25%,60,76,56,11%,6%,14%,0,0,0,3,0,3
380,https://vlr.gg/player/17950/avery,2024-10-15 17:00:00,1.39,1.03,1.24,221,239,190,47,31,16,36,21,15,15,10,5,-2,-1,-1,68%,69%,67%,138,154,115,20%,25%,13%,3,2,1,5,3,2
381,https://vlr.gg/player/28549/superkat,2024-10-15 17:00:00,0.83,1.33,1.03,241,228,257,47,27,20,45,29,16,11,6,5,+1,-4,+5,67%,69%,63%,154,147,163,25%,23%,29%,10,3,7,9,7,2
382,https://vlr.gg/player/17951/karie,2024-10-15 17:00:00,1.02,0.66,0.88,205,222,179,42,27,15,48,27,21,11,6,5,-3,-2,-1,65%,75%,50%,136,143,126,31%,29%,37%,1,0,1,4,2,2
383,https://vlr.gg/player/45801/terror,2024-10-15 17:00:00,0.64,1.06,0.81,167,155,183,36,20,16,45,30,15,14,10,4,-4,-5,+1,60%,67%,50%,112,97,135,27%,21%,33%,4,2,2,8,7,1
384,https://vlr.gg/player/26032/panday,2024-10-15 17:00:00,0.76,0.79,0.77,157,175,129,32,21,11,43,29,14,15,8,7,-4,-2,-2,68%,72%,63%,104,122,76,28%,35%,18%,6,4,2,10,6,4
385,https://vlr.gg/player/37901/aluvily,2024-10-15 17:00:00,1.20,1.06,1.12,235,266,210,50,21,29,43,17,26,13,5,8,+2,+1,+1,77%,79%,75%,156,170,146,38%,34%,41%,8,3,5,6,2,4
386,https://vlr.gg/player/14867/emluo,2024-10-15 17:00:00,1.11,1.09,1.09,226,201,259,52,18,34,44,15,29,12,5,7,+6,-1,+7,72%,71%,72%,147,136,154,50%,53%,48%,12,2,10,6,3,3
387,https://vlr.gg/player/25167/kazler,2024-10-15 17:00:00,0.78,1.27,1.08,219,167,255,47,16,31,42,19,23,15,3,12,-1,-2,+1,73%,54%,86%,143,102,171,29%,28%,29%,7,2,5,8,4,4
388,https://vlr.gg/player/28187/mili,2024-10-15 17:00:00,0.97,1.04,1.01,187,158,206,41,15,26,38,14,24,12,5,7,+5,+3,+2,75%,71%,78%,124,105,136,23%,27%,21%,5,3,2,0,0,0
389,https://vlr.gg/player/25400/riv,2024-10-15 17:00:00,0.91,0.78,0.83,129,138,129,26,11,15,38,14,24,27,13,14,0,-3,+3,77%,79%,75%,79,84,76,24%,19%,28%,4,1,3,4,4,0
390,https://vlr.gg/player/6126/sibeastw0w,2024-10-15 13:55:00,1.40,0.23,1.16,283,317,135,28,25,3,27,21,6,3,3,0,-1,+1,-2,57%,63%,33%,183,212,69,39%,43%,18%,7,6,1,8,5,3
391,https://vlr.gg/player/24058/tokameite,2024-10-15 13:55:00,0.59,1.13,0.70,177,138,334,18,11,7,27,21,6,7,6,1,-1,-1,0,67%,63%,83%,112,88,210,42%,50%,33%,0,0,0,1,1,0
392,https://vlr.gg/player/15188/a1mly,2024-10-15 13:55:00,0.63,0.59,0.63,135,137,148,12,10,2,26,20,6,9,6,3,-4,-4,0,53%,46%,83%,104,104,104,22%,22%,21%,1,1,0,5,5,0
393,https://vlr.gg/player/21158/marti,2024-10-15 13:55:00,0.42,0.45,0.42,112,100,163,9,6,3,28,22,6,13,10,3,+1,+1,0,53%,54%,50%,70,61,102,16%,24%,6%,3,2,1,2,1,1
394,https://vlr.gg/player/20761/looxie,2024-10-15 13:55:00,0.24,0.54,0.29,86,72,152,9,6,3,29,23,6,6,4,2,-3,-3,0,53%,50%,67%,57,46,99,29%,24%,43%,0,0,0,3,3,0
395,https://vlr.gg/player/1885/purp0,2024-10-15 13:55:00,2.12,1.78,1.84,283,342,267,34,8,26,11,3,8,5,3,2,+5,+1,+4,93%,100%,92%,196,277,176,42%,38%,43%,7,2,5,2,1,1
396,https://vlr.gg/player/21610/runner,2024-10-15 13:55:00,1.49,1.76,1.70,291,205,316,31,5,26,12,3,9,15,6,9,+2,-1,+3,90%,83%,92%,187,116,205,24%,13%,27%,5,0,5,3,1,2
397,https://vlr.gg/player/26632/joliinaa,2024-10-15 13:55:00,2.23,1.22,1.42,258,342,232,29,8,21,15,2,13,16,6,10,0,+1,-1,90%,100%,88%,159,175,155,34%,30%,36%,2,1,1,2,0,2
398,https://vlr.gg/player/34684/westside,2024-10-15 13:55:00,0.85,1.44,1.32,221,167,231,27,4,23,15,5,10,7,3,4,0,0,0,87%,83%,88%,147,131,151,52%,44%,54%,0,0,0,0,0,0
399,https://vlr.gg/player/24101/miyori,2024-10-15 13:55:00,1.10,0.60,0.68,160,221,147,16,5,11,23,5,18,13,2,11,+1,+1,0,73%,67%,75%,120,152,112,17%,21%,16%,5,1,4,4,0,4
400,https://vlr.gg/player/24071/liza,2024-10-15 12:00:00,0.96,0.68,0.89,190,198,178,21,16,5,27,21,6,7,5,2,0,-1,+1,59%,54%,75%,133,146,93,40%,43%,33%,2,1,1,2,2,0
401,https://vlr.gg/player/12928/veqaj,2024-10-15 12:00:00,0.49,1.60,0.77,199,157,361,21,11,10,29,23,6,4,3,1,-3,-2,-1,66%,58%,88%,145,113,239,27%,30%,23%,2,1,1,5,3,2
402,https://vlr.gg/player/11/zyppan,2024-10-15 12:00:00,0.60,0.59,0.58,165,175,151,19,14,5,31,24,7,6,6,0,-1,0,-1,59%,63%,50%,104,103,108,44%,45%,40%,4,4,0,5,4,1
403,https://vlr.gg/player/38142/dream,2024-10-15 12:00:00,0.48,0.63,0.49,104,109,116,11,8,3,28,22,6,10,7,3,-1,-1,0,53%,50%,63%,70,73,61,27%,31%,14%,1,0,1,2,1,1
404,https://vlr.gg/player/6889/neskaas,2024-10-15 12:00:00,0.21,0.37,0.25,104,93,136,10,7,3,30,23,7,5,4,1,-3,-4,+1,41%,38%,50%,63,53,92,21%,12%,57%,3,2,1,6,6,0
405,https://vlr.gg/player/21610/runner,2024-10-15 12:00:00,0.78,2.02,1.71,313,164,354,39,5,34,17,7,10,13,5,8,+1,-1,+2,84%,75%,88%,190,81,226,33%,13%,37%,2,0,2,1,1,0
406,https://vlr.gg/player/34684/westside,2024-10-15 12:00:00,0.73,1.78,1.52,259,115,305,32,4,28,13,5,8,6,1,5,+3,0,+3,84%,75%,88%,176,68,212,62%,60%,62%,4,1,3,1,1,0
407,https://vlr.gg/player/26632/joliinaa,2024-10-15 12:00:00,2.93,0.91,1.42,265,467,198,30,14,16,17,2,15,11,4,7,-1,+2,-3,78%,75%,79%,181,300,142,28%,30%,27%,3,2,1,4,0,4
408,https://vlr.gg/player/1885/purp0,2024-10-15 12:00:00,1.66,1.32,1.41,260,327,240,29,9,20,15,5,10,7,2,5,+2,-1,+3,81%,75%,83%,171,238,148,26%,30%,24%,7,1,6,5,2,3
409,https://vlr.gg/player/24101/miyori,2024-10-15 12:00:00,0.15,0.94,0.74,132,39,160,15,0,15,20,7,13,4,3,1,+3,0,+3,75%,63%,79%,90,40,106,16%,0%,18%,4,0,4,1,0,1
410,https://vlr.gg/player/10307/marteen,2024-10-14 14:30:00,1.33,1.47,1.41,282,273,286,55,22,33,36,17,19,15,10,5,+5,-1,+6,76%,65%,84%,188,187,189,34%,36%,33%,10,3,7,5,4,1
411,https://vlr.gg/player/24439/yohpa,2024-10-14 14:30:00,1.28,1.03,1.14,202,243,172,38,20,18,32,15,17,18,5,13,+1,+2,-1,70%,74%,68%,133,151,120,38%,40%,36%,3,2,1,2,0,2
412,https://vlr.gg/player/16321/nelo,2024-10-14 14:30:00,0.53,1.34,1.09,182,121,203,26,5,21,20,8,12,6,3,3,-1,-1,0,74%,55%,83%,122,88,137,45%,46%,45%,2,0,2,3,1,2
413,https://vlr.gg/player/21216/f4ngeer,2024-10-14 14:30:00,0.66,1.24,1.00,232,156,270,41,13,28,40,18,22,16,4,12,+1,-1,+2,67%,57%,74%,138,96,169,31%,29%,32%,9,4,5,8,5,3
414,https://vlr.gg/player/11183/glance,2024-10-14 14:30:00,0.86,0.80,0.82,141,135,149,24,10,14,38,16,22,31,11,20,0,+1,-1,74%,78%,71%,97,93,100,22%,14%,26%,3,1,2,3,0,3
415,https://vlr.gg/player/21153/matrix,2024-10-14 14:30:00,0.27,0.18,0.24,88,99,71,5,4,1,19,12,7,5,2,3,-4,-3,-1,42%,50%,29%,71,83,51,22%,22%,20%,1,0,1,5,3,2
416,https://vlr.gg/player/21610/runner,2024-10-14 14:30:00,0.87,1.45,1.12,217,193,261,40,19,21,38,24,14,24,12,12,+5,+3,+2,72%,61%,87%,156,146,171,26%,25%,28%,8,6,2,3,3,0
417,https://vlr.gg/player/1885/purp0,2024-10-14 14:30:00,0.81,1.32,1.01,221,212,265,46,22,24,41,26,15,5,3,2,-1,-4,+3,59%,52%,70%,162,141,190,41%,36%,48%,8,4,4,9,8,1
418,https://vlr.gg/player/26632/joliinaa,2024-10-14 14:30:00,1.13,0.80,0.99,184,200,172,30,20,10,36,20,16,30,15,15,-2,0,-2,78%,77%,78%,125,132,116,26%,30%,20%,4,2,2,6,2,4
419,https://vlr.gg/player/34684/westside,2024-10-14 14:30:00,0.78,1.18,0.95,188,180,211,39,21,18,36,23,13,7,3,4,-2,-3,+1,70%,65%,78%,119,104,141,28%,33%,23%,3,0,3,5,3,2
420,https://vlr.gg/player/24107/sarah,2024-10-14 14:30:00,0.90,0.98,0.93,139,136,144,30,17,13,38,22,16,23,11,12,-2,-1,-1,76%,74%,78%,97,94,101,33%,30%,37%,3,1,2,5,2,3
421,https://vlr.gg/player/45490/ico,2024-10-14 14:10:00,1.18,1.41,1.30,258,264,256,64,31,33,44,22,22,9,2,7,+3,+5,-2,68%,70%,67%,162,166,159,30%,29%,31%,10,9,1,7,4,3
422,https://vlr.gg/player/5477/leon,2024-10-14 14:10:00,1.31,0.92,1.10,200,195,191,44,24,20,40,16,24,13,7,6,-3,-1,-2,75%,77%,73%,128,133,123,17%,20%,15%,2,0,2,5,1,4
423,https://vlr.gg/player/22180/spmak,2024-10-14 14:10:00,0.91,0.94,0.93,204,205,195,39,22,17,49,23,26,26,9,17,+1,+3,-2,71%,67%,76%,140,139,140,20%,28%,14%,7,5,2,6,2,4
424,https://vlr.gg/player/15178/canefis,2024-10-14 14:10:00,1.09,0.67,0.87,163,195,145,36,19,17,44,18,26,21,12,9,-1,+4,-5,63%,73%,55%,110,131,92,43%,42%,46%,5,4,1,6,0,6
425,https://vlr.gg/player/30754/karma,2024-10-14 14:10:00,0.49,1.01,0.76,192,136,230,38,12,26,50,24,26,28,13,15,-3,-3,0,63%,53%,73%,121,91,149,29%,17%,36%,6,1,5,9,4,5
426,https://vlr.gg/player/33875/spexleon,2024-10-14 14:10:00,1.20,1.05,1.13,235,232,252,52,30,22,44,21,23,19,7,12,-3,+1,-4,76%,76%,77%,162,141,185,25%,27%,23%,3,2,1,6,1,5
427,https://vlr.gg/player/3924/sh0utyy,2024-10-14 14:10:00,1.05,1.11,1.08,178,181,185,41,20,21,39,21,18,31,21,10,+1,+3,-2,83%,82%,83%,118,117,120,24%,18%,31%,4,4,0,3,1,2
428,https://vlr.gg/player/33732/nunmeister,2024-10-14 14:10:00,0.90,1.21,1.04,217,182,233,44,21,23,42,22,20,9,3,6,+2,+2,0,67%,70%,63%,139,120,159,22%,22%,22%,9,5,4,7,3,4
429,https://vlr.gg/player/22381/s-mplex,2024-10-14 14:10:00,1.03,0.90,0.97,181,202,165,40,24,16,44,22,22,29,16,13,+3,+2,+1,76%,82%,70%,111,118,103,16%,20%,12%,4,3,1,1,1,0
430,https://vlr.gg/player/22179/shy,2024-10-14 14:10:00,1.04,0.88,0.96,221,251,200,50,29,21,52,27,25,14,8,6,0,+3,-3,65%,64%,67%,150,167,131,25%,25%,24%,13,8,5,13,5,8
431,https://vlr.gg/player/44548/nomiss,2024-10-14 12:00:00,1.54,1.24,1.37,215,221,193,33,16,17,20,7,13,19,9,10,+3,+2,+1,77%,84%,71%,123,129,118,23%,19%,26%,3,2,1,0,0,0
432,https://vlr.gg/player/24831/complexit,2024-10-14 12:00:00,1.29,1.18,1.23,251,249,248,37,18,19,28,11,17,17,6,11,+2,+4,-2,77%,79%,75%,160,154,165,25%,20%,28%,6,5,1,4,1,3
433,https://vlr.gg/player/33392/zeikosha,2024-10-14 12:00:00,1.22,1.16,1.19,198,197,214,34,16,18,24,8,16,5,0,5,0,+2,-2,77%,84%,71%,136,126,143,21%,30%,16%,4,3,1,4,1,3
434,https://vlr.gg/player/4361/radenz,2024-10-14 12:00:00,1.53,0.72,1.08,194,213,174,33,18,15,28,7,21,11,6,5,-2,-3,+1,77%,84%,71%,119,138,104,20%,32%,11%,3,0,3,5,3,2
435,https://vlr.gg/player/45834/aidan,2024-10-14 12:00:00,1.14,0.80,0.95,245,302,211,36,19,17,34,15,19,12,9,3,0,-2,+2,77%,89%,67%,158,194,129,13%,9%,20%,7,1,6,7,3,4
436,https://vlr.gg/player/27954/movi,2024-10-14 12:00:00,0.87,1.16,1.00,199,159,260,31,14,17,34,16,18,14,10,4,+2,0,+2,67%,63%,74%,138,104,181,23%,20%,25%,5,2,3,3,2,1
437,https://vlr.gg/player/15382/kongi,2024-10-14 12:00:00,0.94,0.96,0.95,202,199,210,30,17,13,33,16,17,8,6,2,+1,0,+1,70%,75%,63%,132,131,132,28%,30%,27%,2,0,2,1,0,1
438,https://vlr.gg/player/12514/spocki,2024-10-14 12:00:00,1.22,0.31,0.82,169,229,80,23,19,4,33,16,17,29,21,8,-1,+2,-3,67%,75%,58%,101,131,63,26%,26%,26%,3,3,0,4,1,3
439,https://vlr.gg/player/27813/zery,2024-10-14 12:00:00,1.06,0.41,0.78,216,273,139,28,21,7,37,20,17,9,6,3,-1,+1,-2,65%,75%,53%,148,180,108,21%,25%,15%,8,6,2,9,5,4
440,https://vlr.gg/player/39062/terrox,2024-10-14 12:00:00,0.84,0.46,0.68,152,178,127,22,15,7,36,18,18,17,11,6,-4,-3,-1,67%,75%,58%,104,122,82,20%,15%,29%,2,1,1,6,4,2
441,https://vlr.gg/player/19363/proxima,2024-10-14 12:00:00,0.93,1.33,1.13,222,193,251,42,18,24,35,18,17,13,5,8,-1,-1,0,69%,65%,73%,158,139,176,45%,50%,42%,1,0,1,2,1,1
442,https://vlr.gg/player/23049/alkyia,2024-10-14 12:00:00,0.87,1.31,1.09,238,209,268,44,19,25,40,22,18,4,2,2,-4,-3,-1,67%,65%,69%,166,153,179,32%,35%,29%,9,5,4,13,8,5
443,https://vlr.gg/player/20144/lewn,2024-10-14 12:00:00,0.78,1.07,0.93,222,218,227,38,19,19,41,22,19,6,1,5,+2,+1,+1,65%,65%,65%,141,132,151,41%,40%,42%,11,6,5,9,5,4
444,https://vlr.gg/player/47911/berryx,2024-10-14 12:00:00,0.88,0.48,0.68,138,176,100,25,16,9,38,19,19,9,6,3,-1,0,-1,65%,65%,65%,92,117,66,25%,21%,32%,0,0,0,1,0,1
445,https://vlr.gg/player/29442/wens,2024-10-14 12:00:00,0.67,0.66,0.66,154,168,139,27,14,13,40,22,18,5,4,1,-2,-1,-1,56%,62%,50%,106,119,93,27%,22%,39%,2,0,2,4,1,3
446,https://vlr.gg/player/12928/veqaj,2024-10-14 12:00:00,1.53,1.96,1.75,375,329,421,70,30,40,36,18,18,8,3,5,+14,+8,+6,85%,85%,85%,227,208,247,31%,34%,29%,17,10,7,3,2,1
447,https://vlr.gg/player/6889/neskaas,2024-10-14 12:00:00,0.96,1.28,1.12,184,160,209,36,14,22,31,17,14,11,8,3,-5,-3,-2,65%,65%,65%,120,104,135,33%,37%,30%,0,0,0,5,3,2
448,https://vlr.gg/player/11/zyppan,2024-10-14 12:00:00,0.97,1.11,1.04,210,215,206,40,21,19,36,19,17,17,8,9,-2,-2,0,71%,73%,69%,140,153,127,34%,44%,25%,5,2,3,7,4,3
449,https://vlr.gg/player/24071/liza,2024-10-14 12:00:00,1.02,0.67,0.84,180,214,146,31,19,12,37,18,19,7,3,4,-1,0,-1,62%,65%,58%,124,145,103,34%,34%,33%,4,2,2,5,2,3
450,https://vlr.gg/player/38142/dream,2024-10-14 12:00:00,0.53,0.59,0.56,102,89,114,17,7,10,36,18,18,18,12,6,0,-1,+1,71%,65%,77%,67,58,75,31%,29%,32%,3,0,3,3,1,2
451,https://vlr.gg/player/4004/zekken,2024-10-13 19:00:00,1.09,2.38,1.61,299,221,422,47,23,24,23,14,9,14,6,8,+4,0,+4,75%,63%,94%,185,136,258,40%,44%,38%,8,3,5,4,3,1
452,https://vlr.gg/player/8419/reduxx,2024-10-13 19:00:00,1.39,0.75,1.13,223,266,150,32,23,9,25,13,12,10,6,4,+1,+2,-1,78%,88%,63%,140,169,97,26%,29%,19%,5,4,1,4,2,2
453,https://vlr.gg/player/1265/johnqt,2024-10-13 19:00:00,1.08,1.11,1.09,193,203,175,28,18,10,24,15,9,15,6,9,-1,-1,0,68%,63%,75%,124,127,120,36%,39%,33%,1,1,0,2,2,0
454,https://vlr.gg/player/263/marved,2024-10-13 19:00:00,0.94,0.89,0.92,202,220,177,30,20,10,29,16,13,9,5,4,-5,-3,-2,58%,63%,50%,136,147,121,28%,30%,25%,3,2,1,8,5,3
455,https://vlr.gg/player/1533/derrek,2024-10-13 19:00:00,1.10,0.64,0.91,177,193,143,22,15,7,26,14,12,18,9,9,+1,+2,-1,78%,75%,81%,121,138,95,26%,23%,32%,3,2,1,2,0,2
456,https://vlr.gg/player/729/zellsis,2024-10-13 19:00:00,1.28,0.95,1.08,200,218,185,30,14,16,29,10,19,14,4,10,0,+1,-1,78%,75%,79%,127,138,119,25%,30%,22%,3,2,1,3,1,2
457,https://vlr.gg/player/4147/cryocells,2024-10-13 19:00:00,1.05,1.09,1.08,221,226,206,31,14,17,31,13,18,5,2,3,+3,+1,+2,65%,69%,63%,143,167,127,48%,52%,44%,6,3,3,3,2,1
458,https://vlr.gg/player/604/boostio,2024-10-13 19:00:00,1.00,0.60,0.76,178,225,158,24,13,11,34,12,22,9,2,7,+2,+1,+1,58%,56%,58%,120,150,100,29%,36%,22%,7,3,4,5,2,3
459,https://vlr.gg/player/619/c0m,2024-10-13 19:00:00,0.60,0.83,0.72,151,105,186,20,6,14,32,12,20,13,5,8,+1,0,+1,63%,63%,63%,100,67,123,25%,24%,26%,4,0,4,3,0,3
460,https://vlr.gg/player/36245/n4rrate,2024-10-13 19:00:00,0.45,0.88,0.71,176,144,200,21,7,14,33,14,19,14,6,8,-6,-3,-3,60%,44%,71%,131,107,146,28%,36%,25%,0,0,0,6,3,3
461,https://vlr.gg/player/8422/spaz,2024-10-13 18:00:00,1.59,1.52,1.55,257,262,241,74,38,36,42,19,23,46,18,28,+5,+5,0,80%,77%,84%,159,167,152,21%,19%,22%,9,6,3,4,1,3
462,https://vlr.gg/player/23407/pa1nt,2024-10-13 18:00:00,1.38,1.22,1.30,285,289,273,81,40,41,57,27,30,24,9,15,+9,+5,+4,79%,79%,79%,181,189,174,29%,32%,26%,19,9,10,10,4,6
463,https://vlr.gg/player/3972/jovahnii,2024-10-13 18:00:00,0.88,1.03,0.96,187,184,196,53,24,29,55,27,28,33,16,17,-3,-5,+2,71%,69%,72%,126,121,131,22%,24%,20%,4,0,4,7,5,2
464,https://vlr.gg/player/29688/mikee,2024-10-13 18:00:00,0.85,1.01,0.94,203,180,221,58,25,33,59,28,31,19,10,9,-3,-2,-1,70%,62%,77%,138,131,144,25%,29%,22%,8,5,3,11,7,4
465,https://vlr.gg/player/4385/monsi,2024-10-13 18:00:00,0.62,0.86,0.74,129,100,154,40,14,26,54,27,27,15,9,6,+2,-2,+4,73%,82%,65%,82,65,97,35%,31%,37%,6,0,6,4,2,2
466,https://vlr.gg/player/19292/jowa,2024-10-13 18:00:00,1.31,1.24,1.28,235,222,261,68,35,33,54,27,27,19,7,12,+1,0,+1,73%,72%,74%,156,145,168,27%,25%,28%,4,1,3,3,1,2
467,https://vlr.gg/player/2164/paincakes,2024-10-13 18:00:00,0.72,1.03,0.87,168,151,187,50,24,26,63,35,28,26,10,16,-8,-7,-1,67%,60%,74%,113,105,122,34%,46%,26%,4,2,2,12,9,3
468,https://vlr.gg/player/818/mummay,2024-10-13 18:00:00,0.92,0.75,0.84,163,185,145,48,27,21,62,34,28,25,14,11,-2,+2,-4,65%,67%,62%,106,117,94,34%,37%,30%,4,3,1,6,1,5
469,https://vlr.gg/player/3687/jonaaa6,2024-10-13 18:00:00,0.92,0.77,0.84,170,209,132,49,32,17,58,31,27,11,4,7,-4,-5,+1,66%,70%,62%,118,143,90,30%,31%,29%,6,3,3,10,8,2
470,https://vlr.gg/player/4917/kaoticcc,2024-10-13 18:00:00,0.56,1.02,0.77,201,175,243,52,21,31,69,38,31,17,10,7,+3,+1,+2,65%,63%,67%,132,109,157,24%,19%,30%,18,8,10,15,7,8
471,https://vlr.gg/player/2125/nanners,2024-10-13 18:00:00,0.90,1.59,1.25,237,175,299,57,20,37,42,23,19,11,3,8,+4,+3,+1,72%,64%,79%,154,120,188,27%,32%,23%,7,5,2,3,2,1
472,https://vlr.gg/player/2171/cavern,2024-10-13 18:00:00,1.06,0.96,1.01,216,223,210,45,24,21,49,26,23,16,10,6,-2,0,-2,58%,61%,56%,149,149,148,34%,38%,29%,6,2,4,8,2,6
473,https://vlr.gg/player/39021/notexxd,2024-10-13 18:00:00,0.68,1.14,0.91,201,175,232,49,21,28,53,27,26,19,7,12,-2,-3,+1,60%,55%,65%,126,106,146,38%,39%,38%,4,1,3,6,4,2
474,https://vlr.gg/player/5128/polkan,2024-10-13 18:00:00,0.78,0.77,0.77,139,154,126,33,17,16,48,24,24,16,6,10,-4,-2,-2,69%,76%,62%,92,100,84,34%,36%,31%,3,1,2,7,3,4
475,https://vlr.gg/player/29074/sonofcar,2024-10-13 18:00:00,0.72,0.58,0.65,163,194,135,36,20,16,57,29,28,12,6,6,+5,+3,+2,66%,73%,59%,106,127,86,16%,12%,22%,14,8,6,9,5,4
476,https://vlr.gg/player/30556/exa,2024-10-13 18:00:00,1.25,1.63,1.44,268,264,267,62,32,30,39,23,16,20,9,11,+3,0,+3,75%,71%,79%,172,169,176,24%,27%,22%,8,3,5,5,3,2
477,https://vlr.gg/player/64/gmd,2024-10-13 18:00:00,1.23,1.55,1.39,277,249,301,63,29,34,43,23,20,28,13,15,+3,+2,+1,78%,74%,82%,182,166,197,31%,34%,28%,7,3,4,4,1,3
478,https://vlr.gg/player/8376/seven,2024-10-13 18:00:00,1.26,1.11,1.19,240,267,211,57,32,25,44,25,19,11,4,7,0,+1,-1,72%,71%,73%,151,168,134,24%,24%,24%,11,8,3,11,7,4
479,https://vlr.gg/player/8399/mocking,2024-10-13 18:00:00,0.74,0.75,0.74,154,132,180,35,17,18,48,21,27,20,10,10,-6,-2,-4,63%,56%,70%,104,86,123,32%,28%,35%,2,0,2,8,2,6
480,https://vlr.gg/player/8375/bones,2024-10-13 18:00:00,0.46,0.93,0.69,134,109,163,32,11,21,47,26,21,21,8,13,-1,-1,0,61%,47%,76%,96,79,113,32%,29%,34%,5,3,2,6,4,2
481,https://vlr.gg/player/31574/srn,2024-10-13 16:00:00,1.47,1.56,1.52,338,335,344,97,47,50,58,32,26,15,8,7,+11,+7,+4,74%,68%,79%,217,224,209,22%,27%,18%,26,16,10,15,9,6
482,https://vlr.gg/player/21435/jelly,2024-10-13 16:00:00,1.11,1.19,1.15,193,188,189,56,30,26,47,27,20,25,7,18,+4,+4,0,80%,76%,85%,128,124,131,27%,33%,22%,6,4,2,2,0,2
483,https://vlr.gg/player/11239/sayuri,2024-10-13 16:00:00,1.12,1.02,1.07,175,186,158,47,27,20,47,26,21,42,20,22,+1,+2,-1,74%,73%,74%,115,121,108,15%,15%,15%,4,2,2,3,0,3
484,https://vlr.gg/player/14685/jubs,2024-10-13 16:00:00,0.76,1.32,1.03,173,133,216,50,19,31,44,27,17,15,9,6,+2,-2,+4,76%,63%,90%,122,106,138,20%,26%,17%,5,1,4,3,3,0
485,https://vlr.gg/player/19791/mel,2024-10-13 16:00:00,0.79,1.09,0.94,163,135,184,44,19,25,46,26,20,30,15,15,0,0,0,64%,63%,64%,105,93,117,15%,16%,14%,8,3,5,8,3,5
486,https://vlr.gg/player/4807/bstrdd,2024-10-13 16:00:00,0.81,1.25,1.03,226,198,265,60,24,36,60,32,28,15,6,9,-2,-2,0,56%,49%,63%,162,129,192,22%,22%,23%,11,5,6,13,7,6
487,https://vlr.gg/player/12143/bizerra,2024-10-13 16:00:00,0.74,1.14,0.95,175,146,213,50,20,30,59,31,28,22,8,14,-2,-2,0,69%,62%,76%,107,88,126,30%,32%,29%,8,3,5,10,5,5
488,https://vlr.gg/player/15297/joojina,2024-10-13 16:00:00,1.04,0.81,0.92,170,197,148,48,27,21,56,28,28,24,9,15,-6,-1,-5,70%,72%,68%,115,129,101,22%,19%,27%,3,2,1,9,3,6
489,https://vlr.gg/player/14386/isaa,2024-10-13 16:00:00,0.45,1.00,0.73,165,125,209,45,15,30,61,33,28,16,7,9,+1,-1,+2,66%,54%,78%,108,79,136,24%,27%,23%,5,2,3,4,3,1
490,https://vlr.gg/player/11232/daiki,2024-10-13 16:00:00,0.79,0.65,0.72,156,159,152,39,18,21,58,28,30,29,19,10,-9,-1,-8,60%,67%,54%,105,109,100,23%,21%,27%,4,4,0,13,5,8
491,https://vlr.gg/player/39021/notexxd,2024-10-13 15:15:00,0.99,0.98,0.99,189,176,212,33,16,17,36,20,16,19,15,4,0,-2,+2,63%,62%,65%,129,126,132,28%,30%,26%,5,1,4,5,3,2
492,https://vlr.gg/player/29074/sonofcar,2024-10-13 15:15:00,1.00,0.91,0.96,205,219,201,33,17,16,36,20,16,13,9,4,-4,-3,-1,67%,69%,65%,138,145,130,16%,15%,16%,8,4,4,12,7,5
493,https://vlr.gg/player/2171/cavern,2024-10-13 15:15:00,1.07,0.82,0.95,201,218,181,32,20,12,34,18,16,12,5,7,-2,-2,0,69%,65%,74%,144,157,130,32%,39%,24%,3,2,1,5,4,1
494,https://vlr.gg/player/5128/polkan,2024-10-13 15:15:00,1.00,0.87,0.94,188,197,175,33,19,14,32,17,15,14,8,6,+1,+1,0,67%,65%,70%,119,120,118,39%,40%,37%,3,2,1,2,1,1
495,https://vlr.gg/player/2125/nanners,2024-10-13 15:15:00,0.67,0.77,0.72,139,160,111,21,12,9,35,21,14,7,5,2,+1,+2,-1,61%,62%,61%,95,115,72,23%,26%,19%,3,2,1,2,0,2
496,https://vlr.gg/player/3972/jovahnii,2024-10-13 15:15:00,1.04,1.37,1.21,213,179,242,37,16,21,30,14,16,20,6,14,+4,+2,+2,78%,70%,85%,150,129,169,33%,49%,26%,6,2,4,2,0,2
497,https://vlr.gg/player/23407/pa1nt,2024-10-13 15:15:00,1.34,0.90,1.11,222,266,180,38,22,16,32,14,18,7,3,4,+2,+1,+1,73%,74%,73%,146,176,119,21%,29%,12%,8,4,4,6,3,3
498,https://vlr.gg/player/8422/spaz,2024-10-13 15:15:00,0.92,1.28,1.11,196,140,232,33,12,21,28,13,15,22,9,13,0,-2,+2,80%,78%,81%,122,97,145,27%,25%,28%,3,0,3,3,2,1
499,https://vlr.gg/player/4385/monsi,2024-10-13 15:15:00,1.30,0.88,1.08,197,211,176,33,16,17,29,10,19,14,5,9,-1,-1,0,76%,83%,69%,131,146,118,33%,28%,39%,4,1,3,5,2,3
500,https://vlr.gg/player/29688/mikee,2024-10-13 15:15:00,0.60,1.18,0.90,189,151,228,32,11,21,33,17,16,13,6,7,-1,0,-1,67%,70%,65%,131,101,158,30%,26%,33%,5,4,1,6,4,2
0,https://vlr.gg/player/8399/mocking,2024-10-13 15:15:00,1.13,1.10,1.11,220,217,218,55,25,30,47,23,24,19,10,9,-2,-2,0,77%,77%,78%,143,142,144,24%,32%,19%,5,1,4,7,3,4
1,https://vlr.gg/player/30556/exa,2024-10-13 15:15:00,0.87,1.26,1.08,209,182,232,48,17,31,49,24,25,18,8,10,-2,-2,0,71%,67%,75%,149,134,161,25%,24%,25%,2,1,1,4,3,1
2,https://vlr.gg/player/8375/bones,2024-10-13 15:15:00,1.22,0.84,1.01,183,228,144,42,25,17,48,22,26,36,12,24,-5,-2,-3,73%,73%,72%,117,133,103,25%,26%,23%,2,1,1,7,3,4
3,https://vlr.gg/player/8376/seven,2024-10-13 15:15:00,0.86,1.12,1.00,217,200,232,49,20,29,48,24,24,13,6,7,0,0,0,73%,73%,72%,139,128,147,24%,23%,26%,11,5,6,11,5,6
4,https://vlr.gg/player/64/gmd,2024-10-13 15:15:00,0.52,0.97,0.77,192,150,230,43,14,29,61,32,29,27,16,11,+3,0,+3,71%,70%,72%,127,96,153,31%,42%,27%,10,4,6,7,4,3
5,https://vlr.gg/player/2164/paincakes,2024-10-13 15:15:00,1.42,0.95,1.20,226,261,187,57,38,19,44,23,21,20,6,14,0,-2,+2,73%,67%,80%,136,146,124,25%,21%,30%,5,2,3,5,4,1
6,https://vlr.gg/player/4917/kaoticcc,2024-10-13 15:15:00,1.02,1.29,1.14,255,238,280,62,30,32,49,29,20,8,4,4,+6,+2,+4,73%,67%,80%,165,149,183,25%,26%,23%,15,7,8,9,5,4
7,https://vlr.gg/player/19292/jowa,2024-10-13 15:15:00,0.98,1.34,1.14,247,210,295,51,22,29,48,27,21,29,17,12,0,-1,+1,76%,69%,83%,179,153,210,26%,27%,26%,3,1,2,3,2,1
8,https://vlr.gg/player/818/mummay,2024-10-13 15:15:00,0.76,1.08,0.90,171,150,195,39,18,21,47,28,19,42,26,16,-2,-1,-1,77%,75%,80%,108,93,125,26%,22%,31%,5,2,3,7,3,4
9,https://vlr.gg/player/3687/jonaaa6,2024-10-13 15:15:00,0.75,1.03,0.88,191,181,206,43,20,23,49,29,20,19,9,10,+2,+2,0,74%,69%,80%,126,130,121,30%,26%,36%,8,6,2,6,4,2
10,https://vlr.gg/player/7866/click,2024-10-13 13:45:00,0.88,1.02,0.96,256,259,257,34,16,18,35,15,20,6,2,4,+5,+3,+2,63%,72%,55%,162,160,163,33%,37%,29%,11,5,6,6,2,4
11,https://vlr.gg/player/45174/purity,2024-10-13 13:45:00,1.19,0.69,0.92,191,266,138,29,18,11,32,13,19,8,4,4,-1,0,-1,60%,67%,55%,127,169,93,32%,32%,31%,1,1,0,2,1,1
12,https://vlr.gg/player/448/meddo,2024-10-13 13:45:00,0.81,0.87,0.84,160,132,178,19,6,13,29,12,17,15,11,4,-1,-1,0,68%,72%,64%,109,102,114,29%,20%,42%,1,0,1,2,1,1
13,https://vlr.gg/player/30241/majusia,2024-10-13 13:45:00,1.19,0.53,0.83,159,218,117,24,16,8,29,11,18,2,1,1,-5,-3,-2,53%,72%,36%,119,150,94,45%,65%,31%,2,1,1,7,4,3
14,https://vlr.gg/player/7105/qpert,2024-10-13 13:45:00,0.53,0.67,0.57,126,105,133,14,5,9,33,15,18,14,7,7,-4,+1,-5,60%,72%,50%,77,73,80,33%,32%,33%,2,2,0,6,1,5
15,https://vlr.gg/player/34684/westside,2024-10-13 13:45:00,2.15,1.34,1.79,320,372,267,48,31,17,21,8,13,4,2,2,+3,+2,+1,88%,91%,83%,221,250,186,56%,60%,50%,5,3,2,2,1,1
16,https://vlr.gg/player/21610/runner,2024-10-13 13:45:00,1.03,1.47,1.22,222,201,244,32,14,18,22,12,10,22,10,12,+3,+2,+1,80%,68%,94%,136,131,141,27%,21%,34%,5,3,2,2,1,1
17,https://vlr.gg/player/16418/smurfette,2024-10-13 13:45:00,0.94,1.01,0.97,210,201,224,32,18,14,29,15,14,3,1,2,+4,+3,+1,65%,68%,61%,139,140,137,32%,38%,26%,8,5,3,4,2,2
18,https://vlr.gg/player/17343/ness,2024-10-13 13:45:00,0.85,1.01,0.92,154,135,165,19,9,10,21,10,11,10,5,5,-1,-1,0,78%,82%,72%,102,92,114,22%,27%,19%,1,0,1,2,1,1
19,https://vlr.gg/player/26632/joliinaa,2024-10-13 13:45:00,1.12,0.64,0.90,195,251,126,27,20,7,27,14,13,7,3,4,-3,0,-3,68%,77%,56%,136,175,89,32%,37%,24%,4,3,1,7,3,4
20,https://vlr.gg/player/98/ardiis,2024-10-13 13:30:00,0.71,1.39,1.02,193,135,261,29,10,19,33,18,15,15,9,6,+1,-1,+2,70%,63%,80%,139,94,193,24%,21%,27%,3,0,3,2,1,1
21,https://vlr.gg/player/1144/boo,2024-10-13 13:30:00,0.93,1.13,1.02,206,212,200,32,19,13,31,18,13,12,5,7,0,-3,+3,68%,67%,70%,136,131,141,33%,27%,42%,3,0,3,3,3,0
22,https://vlr.gg/player/19691/tomaszy,2024-10-13 13:30:00,0.88,0.88,0.88,207,203,207,30,17,13,37,21,16,6,2,4,-1,0,-1,57%,63%,50%,143,146,140,43%,39%,48%,5,3,2,6,3,3
23,https://vlr.gg/player/18350/miniboo,2024-10-13 13:30:00,0.63,1.11,0.85,201,171,248,31,13,18,36,21,15,10,5,5,0,-2,+2,75%,67%,85%,133,110,159,37%,30%,44%,7,3,4,7,5,2
24,https://vlr.gg/player/309/patitek,2024-10-13 13:30:00,0.99,0.53,0.78,206,245,159,31,20,11,43,23,20,12,7,5,+2,0,+2,68%,75%,60%,140,169,104,28%,29%,25%,5,3,2,3,3,0
25,https://vlr.gg/player/36245/n4rrate,2024-10-13 13:30:00,1.69,1.28,1.46,278,303,249,43,22,21,27,12,15,16,9,7,+1,+3,-2,73%,75%,71%,182,198,169,38%,39%,38%,4,3,1,3,0,3
26,https://vlr.gg/player/4147/cryocells,2024-10-13 13:30:00,0.43,2.16,1.38,257,124,377,44,9,35,29,16,13,8,2,6,-1,-5,+4,66%,50%,79%,170,73,251,21%,26%,19%,8,1,7,9,6,3
27,https://vlr.gg/player/619/c0m,2024-10-13 13:30:00,1.40,0.88,1.11,246,331,183,41,25,16,31,15,16,10,1,9,+1,+1,0,80%,95%,67%,156,194,124,29%,41%,16%,2,1,1,1,0,1
28,https://vlr.gg/player/604/boostio,2024-10-13 13:30:00,0.95,1.15,1.06,224,204,233,35,14,21,31,15,16,7,5,2,+1,-3,+4,75%,75%,75%,154,153,154,43%,38%,47%,6,1,5,5,4,1
29,https://vlr.gg/player/729/zellsis,2024-10-13 13:30:00,0.46,0.56,0.52,131,135,127,17,9,8,35,16,19,23,9,14,-4,-4,0,68%,70%,67%,92,92,92,18%,14%,21%,1,0,1,5,4,1
30,https://vlr.gg/player/22188/jimbk,2024-10-13 12:50:00,1.06,1.25,1.14,226,239,219,37,21,16,31,20,11,7,3,4,+1,+2,-1,76%,69%,85%,156,156,155,21%,18%,24%,2,2,0,1,0,1
31,https://vlr.gg/player/33513/sihw,2024-10-13 12:50:00,1.18,0.75,0.99,203,222,200,36,20,16,37,20,17,6,4,2,+2,-1,+3,59%,62%,55%,135,147,118,35%,33%,39%,6,1,5,4,2,2
32,https://vlr.gg/player/22291/razziss,2024-10-13 12:50:00,0.76,1.04,0.88,219,228,217,33,19,14,39,25,14,5,3,2,0,-6,+6,59%,46%,75%,135,136,134,26%,25%,29%,10,4,6,10,10,0
33,https://vlr.gg/player/16139/enrik,2024-10-13 12:50:00,0.62,0.88,0.73,150,139,172,22,10,12,36,22,14,23,15,8,+1,+2,-1,72%,73%,70%,103,93,115,17%,11%,26%,3,2,1,2,0,2
34,https://vlr.gg/player/45143/francybald,2024-10-13 12:50:00,0.32,0.86,0.56,127,90,163,18,8,10,35,22,13,22,10,12,-6,-3,-3,63%,54%,75%,73,49,104,28%,20%,34%,1,1,0,7,4,3
35,https://vlr.gg/player/3784/katu,2024-10-13 12:50:00,1.29,1.73,1.54,279,257,315,50,17,33,28,13,15,9,5,4,-1,-3,+2,76%,70%,81%,184,173,192,39%,41%,39%,6,2,4,7,5,2
36,https://vlr.gg/player/2313/feqew,2024-10-13 12:50:00,1.43,1.06,1.22,218,272,191,39,20,19,28,13,15,4,2,2,+2,+1,+1,65%,60%,69%,152,179,132,32%,31%,33%,6,3,3,4,2,2
37,https://vlr.gg/player/29553/dagg3r,2024-10-13 12:50:00,1.22,1.13,1.17,245,232,252,38,17,21,29,14,15,14,3,11,+1,+1,0,78%,75%,81%,168,158,176,39%,54%,33%,3,2,1,2,1,1
38,https://vlr.gg/player/5854/z3ro,2024-10-13 12:50:00,0.71,1.35,1.08,200,115,237,30,9,21,29,14,15,22,6,16,+2,-3,+5,74%,55%,88%,129,86,162,45%,61%,39%,6,0,6,4,3,1
39,https://vlr.gg/player/173/l0udly,2024-10-13 12:50:00,0.63,0.82,0.74,142,111,166,21,6,15,32,14,18,22,12,10,-2,0,-2,70%,75%,65%,84,66,98,37%,35%,38%,3,1,2,5,1,4
40,https://vlr.gg/player/15500/trent,2024-10-13 12:00:00,1.76,1.73,1.75,302,298,329,40,22,18,15,9,6,12,9,3,0,0,0,94%,100%,86%,198,181,222,30%,38%,22%,3,1,2,3,1,2
41,https://vlr.gg/player/3885/valyn,2024-10-13 12:00:00,1.60,1.86,1.71,290,272,302,36,20,16,14,8,6,15,7,8,0,-2,+2,82%,84%,79%,194,191,199,35%,36%,33%,4,2,2,4,4,0
42,https://vlr.gg/player/20064/vania,2024-10-13 12:00:00,1.54,1.46,1.51,265,253,258,29,18,11,15,8,7,19,10,9,+4,+3,+1,88%,95%,79%,162,156,169,35%,55%,22%,5,3,2,1,0,1
43,https://vlr.gg/player/3993/jawgemo,2024-10-13 12:00:00,1.37,0.85,1.15,249,275,206,27,18,9,22,11,11,11,6,5,+3,+1,+2,79%,79%,79%,158,174,137,15%,14%,16%,7,4,3,4,3,1
44,https://vlr.gg/player/17323/mimi,2024-10-13 12:00:00,1.03,0.39,0.76,108,135,66,12,9,3,19,9,10,17,14,3,0,-1,+1,79%,84%,71%,58,70,41,16%,10%,33%,1,0,1,1,1,0
45,https://vlr.gg/player/6126/sibeastw0w,2024-10-13 12:00:00,1.02,0.60,0.78,203,226,191,22,10,12,28,11,17,4,4,0,-1,-1,0,55%,64%,47%,132,155,114,26%,16%,35%,6,2,4,7,3,4
46,https://vlr.gg/player/21158/marti,2024-10-13 12:00:00,0.99,0.59,0.76,152,199,121,17,10,7,26,10,16,9,2,7,-3,-1,-2,64%,71%,58%,108,137,87,31%,23%,50%,1,1,0,4,2,2
47,https://vlr.gg/player/20761/looxie,2024-10-13 12:00:00,0.85,0.58,0.70,145,158,142,15,7,8,29,12,17,10,6,4,+1,+1,0,55%,57%,53%,97,94,99,38%,38%,38%,1,1,0,0,0,0
48,https://vlr.gg/player/30186/nami,2024-10-13 12:00:00,0.55,0.56,0.56,151,111,220,9,4,5,18,11,7,8,7,1,+1,0,+1,63%,58%,71%,95,80,122,29%,19%,50%,2,0,2,1,0,1
49,https://vlr.gg/player/24058/tokameite,2024-10-13 12:00:00,1.59,0.38,0.55,154,167,153,7,2,5,13,1,12,0,0,0,0,0,0,36%,50%,33%,93,91,93,23%,20%,24%,1,0,1,1,0,1
50,https://vlr.gg/player/15188/a1mly,2024-10-13 12:00:00,0.46,0.52,0.50,159,151,160,15,7,8,30,12,18,5,2,3,-5,-5,0,48%,50%,47%,104,95,110,37%,42%,34%,2,0,2,7,5,2
51,https://vlr.gg/player/12928/veqaj,2024-10-13 12:00:00,0.96,1.95,1.40,291,250,369,69,29,40,48,32,16,18,10,8,+7,-2,+9,79%,68%,93%,199,167,238,20%,22%,18%,18,9,9,11,11,0
52,https://vlr.gg/player/24071/liza,2024-10-13 12:00:00,1.07,1.23,1.14,202,175,234,50,23,27,41,24,17,6,4,2,0,-1,+1,69%,59%,80%,135,117,157,46%,39%,53%,4,2,2,4,3,1
53,https://vlr.gg/player/11/zyppan,2024-10-13 12:00:00,0.92,0.76,0.85,165,167,164,40,21,19,49,27,22,22,14,8,-1,-2,+1,70%,59%,83%,108,116,98,28%,39%,19%,6,1,5,7,3,4
54,https://vlr.gg/player/38142/dream,2024-10-13 12:00:00,0.85,0.85,0.85,148,146,158,36,19,17,50,30,20,29,17,12,0,0,0,73%,59%,90%,99,98,99,35%,40%,31%,4,2,2,4,2,2
55,https://vlr.gg/player/6889/neskaas,2024-10-13 12:00:00,0.54,0.92,0.70,159,136,193,34,13,21,53,32,21,21,13,8,+1,+2,-1,67%,57%,80%,117,104,134,26%,23%,28%,5,3,2,4,1,3
56,https://vlr.gg/player/4244/yaboilewis,2024-10-13 12:00:00,1.15,1.41,1.29,277,266,303,68,29,39,50,26,24,23,11,12,+5,+1,+4,69%,70%,68%,174,156,188,53%,50%,56%,14,4,10,9,3,6
57,https://vlr.gg/player/5292/al0rante,2024-10-13 12:00:00,0.95,1.45,1.23,235,205,247,58,21,37,46,26,20,24,9,15,-1,-1,0,75%,80%,70%,143,125,158,51%,38%,63%,3,2,1,4,3,1
58,https://vlr.gg/player/2052/kuba,2024-10-13 12:00:00,0.89,1.20,1.06,192,177,197,45,17,28,40,23,17,21,12,9,-5,-3,-2,75%,77%,73%,134,132,136,33%,35%,31%,1,0,1,6,3,3
59,https://vlr.gg/player/20730/karina,2024-10-13 12:00:00,0.91,0.77,0.83,160,166,155,36,16,20,45,22,23,8,3,5,-2,-2,0,66%,60%,70%,113,115,112,38%,37%,39%,3,0,3,5,2,3
60,https://vlr.gg/player/40177/leeni,2024-10-13 12:00:00,0.35,1.00,0.71,164,119,175,34,13,21,48,27,21,11,4,7,-4,-5,+1,60%,53%,65%,106,79,127,13%,18%,10%,9,4,5,13,9,4
61,https://vlr.gg/player/27789/deyten,2024-10-13 11:00:00,0.95,1.35,1.15,211,155,269,45,17,28,36,18,18,10,5,5,+8,+2,+6,74%,67%,82%,130,91,173,33%,28%,37%,11,3,8,3,1,2
62,https://vlr.gg/player/45494/proxh,2024-10-13 11:00:00,1.06,1.14,1.10,233,265,204,46,25,21,42,26,16,12,8,4,+4,+1,+3,72%,67%,79%,165,179,150,24%,27%,21%,8,4,4,4,3,1
63,https://vlr.gg/player/33974/appa,2024-10-13 11:00:00,0.86,1.31,1.08,224,213,240,47,21,26,42,25,17,11,5,6,+5,+3,+2,71%,63%,79%,144,137,153,35%,33%,37%,12,7,5,7,4,3
64,https://vlr.gg/player/7991/hyperr,2024-10-13 11:00:00,0.74,1.23,0.97,177,145,210,36,17,19,35,21,14,20,5,15,0,-1,+1,69%,60%,79%,116,97,135,27%,39%,21%,2,1,1,2,2,0
65,https://vlr.gg/player/22518/mimori,2024-10-13 11:00:00,0.76,0.95,0.85,146,133,163,29,14,15,36,20,16,24,10,14,-1,-1,0,62%,57%,68%,101,81,122,29%,26%,31%,4,2,2,5,3,2
66,https://vlr.gg/player/31313/geneticzz,2024-10-13 11:00:00,1.26,1.34,1.30,244,253,239,51,26,25,38,21,17,7,4,3,0,-2,+2,74%,68%,80%,157,166,149,34%,34%,34%,3,1,2,3,3,0
67,https://vlr.gg/player/19505/szalony,2024-10-13 11:00:00,0.91,1.48,1.20,248,238,263,51,23,28,40,24,16,13,4,9,0,-2,+2,72%,61%,83%,158,145,171,21%,22%,21%,11,5,6,11,7,4
68,https://vlr.gg/player/31377/allthewaypat,2024-10-13 11:00:00,0.75,1.09,0.93,170,125,214,33,10,23,38,19,19,17,6,11,-7,-3,-4,67%,64%,70%,127,101,150,23%,21%,24%,1,0,1,8,3,5
69,https://vlr.gg/player/9143/darkosek,2024-10-13 11:00:00,0.76,0.66,0.71,144,150,139,31,16,15,45,22,23,15,8,7,-5,-2,-3,55%,50%,60%,101,100,101,32%,37%,28%,3,1,2,8,3,5
70,https://vlr.gg/player/5810/kryo,2024-10-13 11:00:00,0.49,0.87,0.69,133,95,172,25,6,19,43,24,19,24,17,7,-4,-3,-1,72%,61%,83%,94,62,124,29%,23%,32%,3,1,2,7,4,3
71,https://vlr.gg/player/17861/blastinho,2024-10-13 10:50:00,0.91,1.65,1.22,237,184,309,35,16,19,25,16,9,6,2,4,+1,-2,+3,67%,63%,72%,160,126,206,27%,35%,22%,9,4,5,8,6,2
72,https://vlr.gg/player/19588/neptuno,2024-10-13 10:50:00,0.84,1.65,1.19,215,185,257,31,14,17,25,18,7,14,8,6,+1,+1,0,76%,79%,72%,142,125,165,39%,37%,41%,4,2,2,3,1,2
73,https://vlr.gg/player/13430/krysys,2024-10-13 10:50:00,1.20,1.06,1.14,213,237,181,32,20,12,30,18,12,35,19,16,-1,0,-1,79%,75%,83%,123,137,106,25%,26%,23%,1,1,0,2,1,1
74,https://vlr.gg/player/8811/humanz,2024-10-13 10:50:00,0.88,1.15,1.00,193,168,227,32,15,17,30,18,12,7,4,3,-1,-1,0,76%,71%,83%,127,102,161,34%,31%,37%,1,1,0,2,2,0
75,https://vlr.gg/player/2884/daniel0,2024-10-13 10:50:00,0.99,0.91,0.96,202,228,168,30,20,10,29,17,12,7,2,5,0,0,0,69%,71%,67%,130,142,114,33%,39%,25%,6,3,3,6,3,3
76,https://vlr.gg/player/7258/nask,2024-10-13 10:50:00,0.79,1.39,1.14,218,170,254,32,12,20,30,14,16,14,3,11,-4,-2,-2,74%,67%,79%,149,108,180,30%,46%,23%,1,1,0,5,3,2
77,https://vlr.gg/player/39564/slaxx,2024-10-13 10:50:00,0.72,1.43,1.13,240,178,287,36,11,25,31,15,16,3,1,2,+1,0,+1,74%,61%,83%,156,109,191,25%,27%,24%,3,2,1,2,2,0
78,https://vlr.gg/player/2880/rlzy,2024-10-13 10:50:00,0.73,1.26,1.03,211,154,254,31,9,22,30,14,16,8,5,3,+5,-1,+6,83%,72%,92%,137,102,163,36%,55%,30%,6,0,6,1,1,0
79,https://vlr.gg/player/29996/stepa,2024-10-13 10:50:00,0.76,0.65,0.69,159,197,132,24,12,12,33,16,17,2,1,1,+2,0,+2,55%,56%,54%,104,129,85,46%,57%,33%,9,3,6,7,3,4
80,https://vlr.gg/player/2879/dimaxx,2024-10-13 10:50:00,0.61,0.47,0.53,133,147,124,16,8,8,36,16,20,16,9,7,-4,+1,-5,60%,61%,58%,97,87,105,24%,26%,23%,2,2,0,6,1,5
81,https://vlr.gg/player/15473/yuno,2024-10-13 09:00:00,1.42,1.47,1.44,246,224,285,36,20,16,23,12,11,24,17,7,0,-2,+2,80%,79%,82%,151,137,171,36%,40%,33%,2,0,2,2,2,0
82,https://vlr.gg/player/29958/ximy,2024-10-13 09:00:00,1.14,1.51,1.29,305,270,359,45,22,23,30,18,12,9,6,3,+7,+3,+4,76%,71%,82%,181,158,215,28%,31%,25%,12,7,5,5,4,1
83,https://vlr.gg/player/22314/mober,2024-10-13 09:00:00,1.31,0.98,1.18,213,241,167,31,20,11,25,14,11,15,9,6,0,0,0,83%,83%,82%,145,170,109,39%,39%,38%,4,2,2,4,2,2
84,https://vlr.gg/player/36645/tomatte,2024-10-13 09:00:00,0.91,1.00,0.95,166,165,173,29,17,12,24,14,10,9,2,7,-5,-4,-1,71%,67%,76%,118,117,120,48%,55%,40%,1,0,1,6,4,2
85,https://vlr.gg/player/31549/pando,2024-10-13 09:00:00,0.97,0.84,0.92,168,190,132,22,15,7,26,17,9,13,8,5,+4,+2,+2,80%,92%,65%,123,138,102,28%,30%,23%,4,2,2,0,0,0
86,https://vlr.gg/player/42521/jahbu,2024-10-13 09:00:00,0.78,1.21,1.03,223,189,253,31,11,20,32,15,17,5,3,2,+1,0,+1,61%,53%,67%,149,123,168,32%,24%,37%,5,2,3,4,2,2
87,https://vlr.gg/player/4951/hardy,2024-10-13 09:00:00,1.16,0.68,0.88,210,260,168,29,15,14,33,14,19,6,2,4,+1,+2,-1,63%,65%,63%,147,182,122,35%,55%,20%,3,2,1,2,0,2
88,https://vlr.gg/player/29974/erizillo,2024-10-13 09:00:00,0.88,0.76,0.81,161,160,159,22,9,13,34,14,20,12,4,8,+3,+1,+2,59%,59%,58%,109,105,112,29%,43%,25%,3,1,2,0,0,0
89,https://vlr.gg/player/15383/khorror,2024-10-13 09:00:00,0.90,0.68,0.77,132,149,126,21,10,11,28,11,17,9,4,5,-6,-3,-3,59%,65%,54%,91,100,85,32%,40%,27%,1,0,1,7,3,4
90,https://vlr.gg/player/23090/krystal,2024-10-13 09:00:00,0.45,0.90,0.71,188,137,227,25,8,17,37,16,21,6,2,4,-5,-8,+3,61%,53%,67%,125,98,144,34%,42%,30%,6,0,6,11,8,3
91,https://vlr.gg/player/17447/alyssa,2024-10-13 08:00:00,,,,270,,,40,,,24,,,4,,,,,,,,,,,,,,,,,,,,
92,https://vlr.gg/player/48207/elina,2024-10-13 08:00:00,,,,255,,,37,,,27,,,9,,,,,,,,,,,,,,,,,,,,
93,https://vlr.gg/player/25443/bambi,2024-10-13 08:00:00,,,,234,,,33,,,21,,,11,,,,,,,,,,,,,,,,,,,,
94,https://vlr.gg/player/48206/7er,2024-10-13 08:00:00,,,,192,,,26,,,27,,,11,,,,,,,,,,,,,,,,,,,,
95,https://vlr.gg/player/48205/x1aowen,2024-10-13 08:00:00,,,,179,,,23,,,25,,,14,,,,,,,,,,,,,,,,,,,,
96,https://vlr.gg/player/41173/jianbao,2024-10-13 08:00:00,,,,200,,,26,,,30,,,12,,,,,,,,,,,,,,,,,,,,
97,https://vlr.gg/player/41171/qbb,2024-10-13 08:00:00,,,,199,,,29,,,30,,,10,,,,,,,,,,,,,,,,,,,,
98,https://vlr.gg/player/41175/m77,2024-10-13 08:00:00,,,,185,,,23,,,33,,,7,,,,,,,,,,,,,,,,,,,,
99,https://vlr.gg/player/48138/end3,2024-10-13 08:00:00,,,,172,,,23,,,34,,,9,,,,,,,,,,,,,,,,,,,,
100,https://vlr.gg/player/30321/pochacco,2024-10-13 08:00:00,,,,163,,,22,,,32,,,9,,,,,,,,,,,,,,,,,,,,
101,https://vlr.gg/player/5292/al0rante,2024-10-13 08:00:00,1.91,1.69,1.81,322,340,293,46,28,18,16,8,8,4,4,0,+2,+2,0,78%,81%,73%,212,216,205,44%,41%,50%,3,3,0,1,1,0
102,https://vlr.gg/player/23237/unfair,2024-10-13 08:00:00,1.54,1.40,1.48,293,304,266,36,22,14,21,11,10,6,4,2,+5,+4,+1,81%,76%,87%,196,191,203,28%,24%,35%,5,4,1,0,0,0
103,https://vlr.gg/player/4244/yaboilewis,2024-10-13 08:00:00,0.93,1.17,1.03,246,228,272,33,18,15,27,16,11,5,2,3,-1,+2,-3,61%,62%,60%,153,142,168,48%,50%,45%,8,5,3,9,3,6
104,https://vlr.gg/player/2052/kuba,2024-10-13 08:00:00,1.01,0.86,0.95,160,156,153,19,11,8,20,11,9,10,7,3,-1,-1,0,81%,86%,73%,114,118,109,38%,35%,42%,1,0,1,2,1,1
105,https://vlr.gg/player/8834/bucher,2024-10-13 08:00:00,0.88,0.74,0.82,122,121,139,16,10,6,19,10,9,12,6,6,-5,-4,-1,81%,81%,80%,87,89,84,33%,39%,25%,1,0,1,6,4,2
106,https://vlr.gg/player/22042/arishikii,2024-10-13 08:00:00,1.13,1.07,1.09,223,228,222,30,14,16,29,11,18,6,1,5,-1,-1,0,64%,67%,62%,149,158,143,46%,44%,48%,2,1,1,3,2,1
107,https://vlr.gg/player/7267/nex,2024-10-13 08:00:00,0.65,0.98,0.85,179,136,215,22,7,15,28,12,16,6,3,3,+3,+2,+1,58%,73%,48%,124,84,153,23%,23%,23%,7,3,4,4,1,3
108,https://vlr.gg/player/9540/rxyal,2024-10-13 08:00:00,0.64,0.68,0.63,163,165,159,20,8,12,32,13,19,2,2,0,0,0,0,58%,67%,52%,110,102,116,29%,25%,30%,5,2,3,5,2,3
109,https://vlr.gg/player/16278/oli,2024-10-13 08:00:00,0.71,0.59,0.62,121,152,113,15,7,8,30,13,17,10,4,6,-2,+1,-3,61%,67%,57%,88,106,76,29%,40%,20%,3,2,1,5,1,4
110,https://vlr.gg/player/10301/wheelzonfire,2024-10-13 08:00:00,1.01,0.30,0.60,146,214,88,16,11,5,31,12,19,14,7,7,0,+1,-1,58%,80%,43%,86,122,60,16%,20%,10%,1,1,0,1,0,1
111,https://vlr.gg/player/18702/deadly10,2024-10-13 06:00:00,1.31,1.17,1.26,257,281,244,52,33,19,45,26,19,16,9,7,+6,+4,+2,69%,69%,68%,168,170,163,27%,27%,27%,15,9,6,9,5,4
112,https://vlr.gg/player/43408/garv,2024-10-13 06:00:00,0.98,0.62,0.82,154,183,126,37,25,12,45,26,19,10,8,2,-7,-4,-3,64%,72%,52%,105,120,85,30%,32%,27%,1,0,1,8,4,4
113,https://vlr.gg/player/8156/mojo,2024-10-13 06:00:00,0.73,0.84,0.77,140,129,157,30,16,14,47,28,19,19,10,9,-4,-3,-1,64%,64%,64%,84,80,91,21%,25%,17%,3,2,1,7,5,2
114,https://vlr.gg/player/44919/aplycs,2024-10-13 06:00:00,0.71,0.72,0.71,142,153,128,28,17,11,47,29,18,9,4,5,-3,0,-3,66%,69%,60%,102,112,87,23%,22%,24%,3,3,0,6,3,3
115,https://vlr.gg/player/48426/ghostxd,2024-10-13 06:00:00,0.46,0.83,0.61,136,106,195,28,12,16,50,29,21,25,13,12,-7,-3,-4,59%,56%,64%,94,67,134,34%,33%,34%,1,1,0,8,4,4
116,https://vlr.gg/player/13221/azys,2024-10-13 06:00:00,1.79,1.35,1.53,317,374,284,68,33,35,36,15,21,14,7,7,+9,+5,+4,77%,76%,78%,199,234,175,27%,28%,26%,16,8,8,7,3,4
117,https://vlr.gg/player/3628/deathmaker,2024-10-13 06:00:00,1.23,1.20,1.21,225,194,225,46,17,29,35,13,22,16,7,9,+7,+3,+4,77%,72%,81%,144,137,148,39%,43%,37%,9,4,5,2,1,1
118,https://vlr.gg/player/12947/rawfiul,2024-10-13 06:00:00,1.18,1.16,1.17,212,198,223,50,19,31,36,15,21,12,6,6,0,+1,-1,70%,72%,69%,148,136,157,44%,37%,49%,6,2,4,6,1,5
119,https://vlr.gg/player/18704/levi,2024-10-13 06:00:00,0.86,1.29,1.12,189,133,223,39,12,27,33,14,19,23,7,16,-1,0,-1,80%,80%,81%,128,91,154,27%,29%,27%,5,2,3,6,2,4
120,https://vlr.gg/player/3269/antidote,2024-10-13 06:00:00,0.89,0.80,0.83,140,161,126,31,15,16,35,15,20,24,12,12,0,0,0,74%,80%,69%,90,102,82,21%,19%,22%,2,1,1,2,1,1
121,https://vlr.gg/player/30334/yang,2024-10-13 05:00:00,,,,208,,,42,,,49,,,20,,,,,,,,,,,,,,,,,,,,
122,https://vlr.gg/player/48168/zora,2024-10-13 05:00:00,,,,185,,,40,,,43,,,8,,,,,,,,,,,,,,,,,,,,
123,https://vlr.gg/player/48167/xiaolan,2024-10-13 05:00:00,,,,177,,,36,,,56,,,13,,,,,,,,,,,,,,,,,,,,
124,https://vlr.gg/player/48169/jennie,2024-10-13 05:00:00,,,,155,,,34,,,48,,,12,,,,,,,,,,,,,,,,,,,,
125,https://vlr.gg/player/48170/anan,2024-10-13 05:00:00,,,,154,,,28,,,52,,,21,,,,,,,,,,,,,,,,,,,,
126,https://vlr.gg/player/48157/kiaki,2024-10-13 05:00:00,,,,264,,,57,,,35,,,20,,,,,,,,,,,,,,,,,,,,
127,https://vlr.gg/player/39397/7wyy,2024-10-13 05:00:00,,,,259,,,55,,,36,,,32,,,,,,,,,,,,,,,,,,,,
128,https://vlr.gg/player/48156/yumiiurx,2024-10-13 05:00:00,,,,227,,,46,,,43,,,19,,,,,,,,,,,,,,,,,,,,
129,https://vlr.gg/player/48159/yyni,2024-10-13 05:00:00,,,,218,,,50,,,32,,,12,,,,,,,,,,,,,,,,,,,,
130,https://vlr.gg/player/48158/xkb,2024-10-13 05:00:00,,,,197,,,40,,,34,,,32,,,,,,,,,,,,,,,,,,,,
131,https://vlr.gg/player/23971/ask,2024-10-13 03:35:00,0.74,1.27,1.03,221,185,250,50,18,32,55,29,26,21,11,10,+4,0,+4,70%,66%,74%,149,137,158,22%,19%,24%,6,1,5,2,1,1
132,https://vlr.gg/player/34785/yowamu,2024-10-13 03:35:00,0.87,1.11,1.00,255,224,274,55,24,31,57,26,31,17,6,11,+2,-4,+6,61%,59%,63%,160,143,175,26%,30%,23%,16,5,11,14,9,5
133,https://vlr.gg/player/10658/kurozooted,2024-10-13 03:35:00,0.77,0.97,0.88,158,114,193,37,12,25,52,24,28,23,12,11,-1,0,-1,64%,59%,68%,103,75,127,22%,23%,21%,2,0,2,3,0,3
134,https://vlr.gg/player/34760/meatpien,2024-10-13 03:35:00,1.02,0.67,0.83,192,248,145,44,25,19,57,28,29,26,15,11,+1,0,+1,66%,78%,55%,123,162,90,32%,38%,25%,7,3,4,6,3,3
135,https://vlr.gg/player/48492/mametu,2024-10-13 03:35:00,0.60,0.56,0.58,115,132,119,31,14,17,58,26,32,13,8,5,-10,-8,-2,61%,53%,68%,89,95,84,40%,38%,42%,2,1,1,12,9,3
136,https://vlr.gg/player/45962/ken,2024-10-13 03:35:00,1.25,1.17,1.21,253,268,239,59,33,26,46,26,20,19,12,7,+9,+2,+7,79%,76%,81%,169,181,155,23%,23%,23%,14,6,8,5,4,1
137,https://vlr.gg/player/40736/kapi,2024-10-13 03:35:00,1.12,1.31,1.21,211,199,233,54,28,26,44,25,19,23,10,13,+3,+2,+1,76%,71%,81%,141,134,148,38%,48%,31%,4,2,2,1,0,1
138,https://vlr.gg/player/2400/brofeld,2024-10-13 03:35:00,0.96,1.45,1.19,197,187,225,51,24,27,41,25,16,14,8,6,+1,-3,+4,80%,74%,88%,132,127,137,25%,21%,30%,8,3,5,7,6,1
139,https://vlr.gg/player/6702/bazz,2024-10-13 03:35:00,1.11,1.21,1.16,257,231,270,65,32,33,46,26,20,30,19,11,-3,-3,0,70%,71%,69%,164,149,181,34%,36%,33%,8,3,5,11,6,5
140,https://vlr.gg/player/1009/sakurai,2024-10-13 03:35:00,1.13,1.03,1.09,193,198,191,50,29,21,40,22,18,22,12,10,-6,-6,0,76%,76%,75%,133,139,127,37%,39%,33%,3,1,2,9,7,2
141,https://vlr.gg/player/17099/bom-alpha,2024-10-13 00:00:00,1.24,1.04,1.13,230,261,210,48,27,21,49,24,25,24,10,14,+4,-1,+5,76%,73%,78%,154,161,147,35%,34%,36%,7,2,5,3,3,0
142,https://vlr.gg/player/33417/fukuken,2024-10-13 00:00:00,0.91,1.25,1.08,196,146,246,43,15,28,43,22,21,30,13,17,0,-1,+1,73%,63%,81%,137,104,169,30%,34%,27%,4,1,3,4,2,2
143,https://vlr.gg/player/40734/hands,2024-10-13 00:00:00,0.67,0.96,0.82,156,143,168,34,15,19,44,23,21,14,5,9,-1,-1,0,66%,63%,69%,110,99,121,27%,33%,23%,5,0,5,6,1,5
144,https://vlr.gg/player/10661/phantom,2024-10-13 00:00:00,0.81,0.76,0.78,142,147,134,33,16,17,42,23,19,8,5,3,-2,0,-2,61%,63%,59%,95,101,90,19%,17%,21%,1,1,0,3,1,2
145,https://vlr.gg/player/48430/rui,2024-10-13 00:00:00,0.40,0.89,0.63,155,124,191,35,13,22,53,28,25,11,6,5,-9,-11,+2,60%,60%,59%,92,69,114,31%,32%,31%,10,4,6,19,15,4
146,https://vlr.gg/player/40726/gwangboong,2024-10-13 00:00:00,1.14,1.56,1.34,292,244,326,65,29,36,39,21,18,12,7,5,+1,-3,+4,81%,69%,93%,186,159,213,31%,31%,31%,12,5,7,11,8,3
147,https://vlr.gg/player/27442/impact,2024-10-13 00:00:00,0.92,1.49,1.20,237,193,286,53,21,32,42,23,19,15,7,8,+4,0,+4,76%,63%,90%,160,133,188,40%,36%,44%,12,5,7,8,5,3
148,https://vlr.gg/player/48431/kippei,2024-10-13 00:00:00,1.17,1.10,1.13,189,213,166,40,24,16,36,20,16,34,12,22,0,-2,+2,84%,78%,90%,122,134,108,28%,36%,20%,4,1,3,4,3,1
149,https://vlr.gg/player/10769/nobita,2024-10-13 00:00:00,0.96,1.13,1.05,195,205,196,40,20,20,41,24,17,31,14,17,0,-1,+1,77%,72%,83%,139,146,131,22%,17%,30%,4,2,2,4,3,1
150,https://vlr.gg/player/10628/misaya,2024-10-13 00:00:00,1.04,1.04,1.04,166,154,171,33,17,16,35,19,16,33,14,19,+3,0,+3,82%,84%,80%,112,101,124,18%,27%,12%,3,0,3,0,0,0
151,https://vlr.gg/player/92/scream,2024-10-12 20:00:00,0.50,1.43,0.91,234,161,349,26,10,16,30,18,12,5,2,3,-2,-4,+2,56%,50%,64%,156,103,224,40%,39%,41%,4,0,4,6,4,2
152,https://vlr.gg/player/29867/hiro,2024-10-12 20:00:00,0.37,1.00,0.65,139,113,166,15,6,9,26,18,8,3,1,2,+1,+2,-1,44%,33%,57%,86,73,103,41%,44%,37%,3,3,0,2,1,1
153,https://vlr.gg/player/101/soulcas,2024-10-12 20:00:00,0.37,0.89,0.60,128,82,194,13,4,9,28,17,11,3,2,1,+2,-2,+4,50%,39%,64%,87,67,113,47%,33%,60%,4,0,4,2,2,0
154,https://vlr.gg/player/1457/mistic,2024-10-12 20:00:00,0.30,0.75,0.50,86,65,114,10,4,6,27,17,10,7,3,4,-1,0,-1,47%,39%,57%,63,48,83,29%,18%,45%,0,0,0,1,0,1
155,https://vlr.gg/player/438/boaster,2024-10-12 20:00:00,0.43,0.42,0.40,127,138,106,12,8,4,29,18,11,8,2,6,-4,-4,0,47%,44%,50%,84,94,72,33%,31%,38%,3,2,1,7,6,1
156,https://vlr.gg/player/604/boostio,2024-10-12 20:00:00,1.11,2.06,1.65,317,262,353,41,13,28,15,10,5,4,3,1,-1,-2,+1,81%,64%,94%,197,164,223,50%,45%,54%,3,1,2,4,3,1
157,https://vlr.gg/player/36245/n4rrate,2024-10-12 20:00:00,1.49,1.55,1.52,220,230,220,28,12,16,12,7,5,12,7,5,+2,0,+2,84%,79%,89%,146,147,145,26%,26%,26%,3,0,3,1,0,1
158,https://vlr.gg/player/619/c0m,2024-10-12 20:00:00,0.94,1.50,1.25,206,151,237,25,8,17,14,8,6,6,2,4,+1,0,+1,75%,50%,94%,135,109,155,41%,33%,44%,3,2,1,2,2,0
159,https://vlr.gg/player/729/zellsis,2024-10-12 20:00:00,0.59,1.69,1.20,201,90,273,21,4,17,15,9,6,16,5,11,+3,0,+3,78%,71%,83%,132,64,185,27%,29%,26%,6,1,5,3,1,2
160,https://vlr.gg/player/4147/cryocells,2024-10-12 20:00:00,1.38,0.97,1.15,227,296,185,25,15,10,20,10,10,5,1,4,-1,-2,+1,72%,57%,83%,156,184,134,29%,42%,18%,3,1,2,4,3,1
161,https://vlr.gg/player/4004/zekken,2024-10-12 18:50:00,0.81,2.40,1.60,341,244,438,30,10,20,14,9,5,4,1,3,0,-3,+3,75%,50%,100%,212,158,266,34%,24%,43%,4,1,3,4,4,0
162,https://vlr.gg/player/8419/reduxx,2024-10-12 18:50:00,1.14,1.49,1.31,237,224,251,21,10,11,15,9,6,10,4,6,-2,-3,+1,79%,75%,83%,162,150,175,35%,44%,28%,2,0,2,4,3,1
163,https://vlr.gg/player/1265/johnqt,2024-10-12 18:50:00,0.91,0.88,0.89,163,162,165,13,6,7,15,8,7,9,1,8,+1,+2,-1,75%,67%,83%,115,116,114,30%,44%,18%,3,2,1,2,0,2
164,https://vlr.gg/player/1533/derrek,2024-10-12 18:50:00,0.50,1.01,0.75,135,79,192,11,3,8,15,8,7,9,3,6,+1,-1,+2,83%,75%,92%,96,56,135,23%,33%,19%,2,0,2,1,1,0
165,https://vlr.gg/player/263/marved,2024-10-12 18:50:00,0.76,0.58,0.67,155,190,121,13,8,5,19,10,9,4,1,3,0,+1,-1,63%,58%,67%,103,131,76,35%,47%,21%,1,1,0,1,0,1
166,https://vlr.gg/player/18350/miniboo,2024-10-12 18:50:00,0.83,1.87,1.35,239,165,313,23,7,16,16,9,7,3,2,1,-2,-4,+2,63%,58%,67%,134,85,183,47%,31%,55%,4,1,3,6,5,1
167,https://vlr.gg/player/309/patitek,2024-10-12 18:50:00,0.94,1.37,1.16,231,205,258,18,8,10,18,11,7,14,6,8,+4,+3,+1,83%,92%,75%,151,138,165,37%,41%,34%,5,3,2,1,0,1
168,https://vlr.gg/player/1144/boo,2024-10-12 18:50:00,0.94,1.02,0.98,173,196,152,13,7,6,15,9,6,8,4,4,-1,-1,0,79%,67%,92%,116,125,107,32%,26%,40%,1,0,1,2,1,1
169,https://vlr.gg/player/98/ardiis,2024-10-12 18:50:00,0.80,0.63,0.72,135,163,107,10,7,3,18,10,8,6,2,4,0,0,0,63%,58%,67%,98,108,87,26%,39%,12%,0,0,0,0,0,0
170,https://vlr.gg/player/19691/tomaszy,2024-10-12 18:50:00,0.30,1.10,0.70,175,125,227,14,5,9,21,12,9,5,1,4,-1,-2,+1,63%,50%,75%,124,74,175,38%,43%,35%,2,0,2,3,2,1
171,https://vlr.gg/player/4147/cryocells,2024-10-12 16:25:00,1.05,1.00,1.03,234,223,258,39,20,19,38,19,19,8,5,3,+3,-1,+4,67%,67%,68%,154,143,168,18%,21%,16%,10,3,7,7,4,3
172,https://vlr.gg/player/729/zellsis,2024-10-12 16:25:00,0.51,1.49,0.95,178,112,262,30,10,20,34,21,13,16,6,10,+2,0,+2,67%,56%,82%,116,74,167,29%,28%,30%,6,4,2,4,4,0
173,https://vlr.gg/player/36245/n4rrate,2024-10-12 16:25:00,0.70,1.02,0.84,146,121,191,26,12,14,33,19,14,20,8,12,+2,+1,+1,73%,70%,77%,88,74,105,24%,26%,23%,4,2,2,2,1,1
174,https://vlr.gg/player/604/boostio,2024-10-12 16:25:00,0.83,0.85,0.84,178,174,183,31,16,15,37,21,16,10,7,3,-1,-2,+1,67%,63%,73%,125,119,134,30%,26%,34%,5,2,3,6,4,2
175,https://vlr.gg/player/619/c0m,2024-10-12 16:25:00,0.62,0.89,0.74,141,116,184,24,10,14,35,20,15,10,3,7,-3,-3,0,59%,52%,68%,101,79,127,23%,21%,24%,1,0,1,4,3,1
176,https://vlr.gg/player/309/patitek,2024-10-12 16:25:00,1.15,1.43,1.31,243,209,256,42,18,24,30,15,15,10,3,7,-2,-4,+2,57%,45%,67%,149,128,166,43%,54%,37%,5,1,4,7,5,2
177,https://vlr.gg/player/98/ardiis,2024-10-12 16:25:00,1.16,1.20,1.18,203,221,189,36,18,18,26,15,11,12,6,6,-1,+1,-2,78%,86%,70%,142,148,138,26%,29%,25%,2,1,1,3,0,3
178,https://vlr.gg/player/18350/miniboo,2024-10-12 16:25:00,1.01,1.28,1.15,262,263,267,45,20,25,34,18,16,3,2,1,+3,0,+3,69%,68%,70%,167,163,171,40%,53%,33%,11,4,7,8,4,4
179,https://vlr.gg/player/19691/tomaszy,2024-10-12 16:25:00,0.59,1.35,1.01,174,127,201,29,9,20,29,18,11,17,6,11,-4,-5,+1,76%,73%,78%,103,78,123,30%,41%,25%,3,0,3,7,5,2
180,https://vlr.gg/player/1144/boo,2024-10-12 16:25:00,0.92,0.95,0.93,156,166,149,25,12,13,31,16,15,27,15,12,+1,0,+1,80%,82%,78%,94,96,92,28%,15%,42%,2,1,1,1,1,0
181,https://vlr.gg/player/12143/bizerra,2024-10-12 16:00:00,1.32,1.44,1.38,252,266,252,90,43,47,63,35,28,47,23,24,-1,-1,0,80%,74%,85%,168,166,169,22%,17%,27%,5,2,3,6,3,3
182,https://vlr.gg/player/4807/bstrdd,2024-10-12 16:00:00,1.06,1.16,1.11,248,260,243,85,41,44,70,39,31,23,15,8,-6,-10,+4,70%,64%,75%,162,164,160,22%,24%,19%,17,5,12,23,15,8
183,https://vlr.gg/player/11232/daiki,2024-10-12 16:00:00,0.96,1.19,1.08,189,150,224,71,28,43,62,31,31,39,20,19,+4,-4,+8,75%,70%,79%,121,100,141,30%,30%,30%,14,3,11,10,7,3
184,https://vlr.gg/player/15297/joojina,2024-10-12 16:00:00,0.85,1.06,0.96,187,171,189,63,28,35,66,35,31,45,17,28,0,-1,+1,75%,72%,77%,120,118,121,22%,20%,24%,4,2,2,4,3,1
185,https://vlr.gg/player/14386/isaa,2024-10-12 16:00:00,0.87,0.98,0.93,196,190,199,63,29,34,70,36,34,32,14,18,+1,-1,+2,72%,66%,77%,138,133,142,30%,27%,33%,9,3,6,8,4,4
186,https://vlr.gg/player/22997/waved,2024-10-12 16:00:00,1.24,1.10,1.17,273,285,246,86,48,38,78,43,35,20,11,9,+3,-1,+4,69%,70%,68%,178,188,168,33%,40%,25%,20,11,9,17,12,5
187,https://vlr.gg/player/9821/m4ndzin,2024-10-12 16:00:00,0.93,1.36,1.13,221,164,294,82,32,50,75,39,36,34,15,19,+6,-3,+9,75%,66%,85%,144,113,178,25%,25%,25%,11,2,9,5,5,0
188,https://vlr.gg/player/11236/antg,2024-10-12 16:00:00,1.04,1.12,1.08,199,184,224,73,35,38,69,36,33,29,14,15,+6,0,+6,75%,72%,79%,133,123,144,27%,19%,37%,13,3,10,7,3,4
189,https://vlr.gg/player/11242/blu,2024-10-12 16:00:00,0.54,0.92,0.71,132,116,164,48,20,28,77,44,33,30,11,19,-11,-7,-4,72%,70%,74%,99,88,111,26%,26%,27%,2,0,2,13,7,6
190,https://vlr.gg/player/27724/natasha,2024-10-12 16:00:00,0.57,0.73,0.65,127,114,143,42,20,22,73,41,32,23,7,16,-2,-4,+2,56%,42%,72%,94,86,103,29%,29%,30%,5,3,2,7,7,0
191,https://vlr.gg/player/34684/westside,2024-10-12 15:15:00,1.23,1.17,1.20,230,265,204,60,32,28,46,23,23,23,9,14,-3,-1,-2,79%,74%,84%,155,173,139,49%,57%,41%,1,1,0,4,2,2
192,https://vlr.gg/player/24107/sarah,2024-10-12 15:15:00,0.97,1.16,1.07,182,162,204,47,21,26,47,22,25,17,8,9,+2,-1,+3,72%,68%,76%,123,107,138,29%,28%,30%,4,1,3,2,2,0
193,https://vlr.gg/player/17343/ness,2024-10-12 15:15:00,1.19,0.76,0.97,163,196,135,39,25,14,45,21,24,19,6,13,-4,-3,-1,73%,76%,70%,117,133,103,33%,48%,23%,1,0,1,5,3,2
194,https://vlr.gg/player/16418/smurfette,2024-10-12 15:15:00,0.53,1.26,0.91,219,171,274,56,19,37,57,30,27,13,6,7,-4,-5,+1,65%,56%,73%,134,99,165,18%,22%,15%,15,7,8,19,12,7
195,https://vlr.gg/player/24101/miyori,2024-10-12 15:15:00,0.61,0.84,0.73,194,165,218,46,19,27,58,27,31,11,5,6,-10,-2,-8,58%,62%,54%,130,117,142,27%,32%,23%,5,2,3,15,4,11
196,https://vlr.gg/player/1428/sheydos,2024-10-12 15:15:00,1.92,1.42,1.68,314,367,273,82,48,34,43,22,21,19,12,7,+8,+4,+4,80%,84%,76%,214,243,183,31%,31%,32%,12,6,6,4,2,2
197,https://vlr.gg/player/5550/grubinho,2024-10-12 15:15:00,1.20,1.31,1.25,264,269,257,65,35,30,53,28,25,25,10,15,+4,+4,0,77%,78%,76%,173,171,176,43%,48%,39%,10,8,2,6,4,2
198,https://vlr.gg/player/29960/nidxvilco,2024-10-12 15:15:00,0.54,1.03,0.77,137,95,187,35,12,23,50,27,23,26,11,15,0,0,0,65%,59%,71%,92,71,114,26%,20%,30%,6,2,4,6,2,4
199,https://vlr.gg/player/30105/ikyoo,2024-10-12 15:15:00,0.58,0.76,0.67,173,158,180,42,21,21,56,30,26,6,2,4,+4,0,+4,62%,62%,62%,110,104,117,29%,35%,21%,11,5,6,7,5,2
200,https://vlr.gg/player/30060/alessia,2024-10-12 15:15:00,0.52,0.77,0.64,114,104,112,29,14,15,46,25,21,8,3,5,+3,-1,+4,66%,70%,62%,77,74,80,43%,47%,38%,6,1,5,3,2,1
201,https://vlr.gg/player/47911/berryx,2024-10-12 15:00:00,0.42,1.21,0.89,191,88,260,26,4,22,32,14,18,7,3,4,0,-1,+1,58%,56%,58%,121,59,161,35%,20%,42%,2,0,2,2,1,1
202,https://vlr.gg/player/19363/proxima,2024-10-12 15:00:00,0.97,0.76,0.84,162,152,174,20,8,12,31,11,20,15,7,8,+1,+1,0,45%,38%,50%,107,92,116,50%,38%,58%,2,1,1,1,0,1
203,https://vlr.gg/player/29442/wens,2024-10-12 15:00:00,1.00,0.64,0.79,184,208,161,26,12,14,32,12,20,5,3,2,-2,+1,-3,53%,56%,50%,107,110,105,33%,23%,47%,4,2,2,6,1,5
204,https://vlr.gg/player/20144/lewn,2024-10-12 15:00:00,0.36,1.04,0.77,202,105,273,27,6,21,34,13,21,5,1,4,-6,-7,+1,45%,31%,54%,135,66,181,20%,26%,18%,4,1,3,10,8,2
205,https://vlr.gg/player/23049/alkyia,2024-10-12 15:00:00,0.28,0.80,0.60,152,125,165,19,6,13,36,16,20,10,4,6,+1,-2,+3,55%,50%,58%,102,86,112,23%,14%,31%,5,0,5,4,2,2
206,https://vlr.gg/player/15188/a1mly,2024-10-12 15:00:00,1.63,1.70,1.66,306,303,319,46,28,18,21,14,7,18,9,9,-1,-1,0,78%,79%,75%,198,198,198,36%,31%,43%,2,1,1,3,2,1
207,https://vlr.gg/player/6126/sibeastw0w,2024-10-12 15:00:00,1.12,1.39,1.23,275,275,259,38,23,15,26,19,7,6,5,1,+6,+2,+4,70%,67%,75%,171,170,173,27%,25%,29%,10,5,5,4,3,1
208,https://vlr.gg/player/30186/nami,2024-10-12 15:00:00,0.98,1.48,1.18,195,181,214,28,16,12,23,17,6,20,11,9,+4,+1,+3,83%,75%,94%,122,116,129,48%,45%,52%,5,2,3,1,1,0
209,https://vlr.gg/player/21158/marti,2024-10-12 15:00:00,0.92,1.32,1.08,211,201,228,32,18,14,25,17,8,15,7,8,-2,-2,0,75%,71%,81%,132,134,130,26%,27%,26%,3,2,1,5,4,1
210,https://vlr.gg/player/20761/looxie,2024-10-12 15:00:00,0.88,0.96,0.91,150,159,135,21,14,7,23,15,8,9,3,6,-1,-2,+1,75%,67%,88%,97,102,90,43%,47%,38%,3,1,2,4,3,1
211,https://vlr.gg/player/4004/zekken,2024-10-12 14:30:00,1.01,1.69,1.36,299,233,351,43,16,27,27,13,14,9,3,6,+4,-1,+5,83%,85%,82%,171,144,196,24%,29%,20%,9,4,5,5,5,0
212,https://vlr.gg/player/263/marved,2024-10-12 14:30:00,1.05,1.50,1.29,234,226,250,38,17,21,24,15,9,12,8,4,-1,-2,+1,81%,80%,82%,148,147,149,41%,39%,43%,3,1,2,4,3,1
213,https://vlr.gg/player/1265/johnqt,2024-10-12 14:30:00,1.24,1.17,1.21,201,179,214,32,13,19,22,10,12,8,3,5,-2,+1,-3,74%,85%,64%,124,114,133,35%,24%,48%,1,1,0,3,0,3
214,https://vlr.gg/player/8419/reduxx,2024-10-12 14:30:00,1.58,0.81,1.18,250,354,159,36,25,11,28,13,15,15,7,8,-2,0,-2,76%,85%,68%,157,227,93,34%,41%,23%,5,3,2,7,3,4
215,https://vlr.gg/player/1533/derrek,2024-10-12 14:30:00,1.27,0.89,1.07,161,175,150,23,13,10,24,10,14,17,8,9,-3,0,-3,79%,85%,73%,114,123,106,37%,43%,31%,1,0,1,4,0,4
216,https://vlr.gg/player/101/soulcas,2024-10-12 14:30:00,0.90,0.95,0.92,227,215,244,33,17,16,37,19,18,9,5,4,+2,0,+2,64%,68%,60%,142,139,147,39%,35%,42%,7,2,5,5,2,3
217,https://vlr.gg/player/92/scream,2024-10-12 14:30:00,0.76,1.07,0.91,204,187,223,31,14,17,32,17,15,6,4,2,+4,+3,+1,62%,64%,60%,132,123,141,47%,41%,53%,8,5,3,4,2,2
218,https://vlr.gg/player/29867/hiro,2024-10-12 14:30:00,0.84,0.68,0.76,161,170,149,22,13,9,35,18,17,7,5,2,0,+1,-1,55%,55%,55%,115,122,107,29%,34%,24%,3,3,0,3,2,1
219,https://vlr.gg/player/1457/mistic,2024-10-12 14:30:00,0.60,0.84,0.71,155,124,190,22,9,13,35,17,18,15,10,5,-1,-1,0,64%,64%,65%,106,84,131,24%,27%,22%,1,0,1,2,1,1
220,https://vlr.gg/player/438/boaster,2024-10-12 14:30:00,0.68,0.27,0.48,118,144,88,16,11,5,33,17,16,7,2,5,-1,-1,0,45%,45%,45%,78,97,58,15%,23%,5%,4,2,2,5,3,2
221,https://vlr.gg/player/10338/lime,2024-10-12 14:00:00,1.42,1.72,1.57,321,288,355,42,18,24,18,11,7,8,3,5,+2,+1,+1,80%,76%,83%,203,185,221,27%,29%,26%,6,3,3,4,2,2
222,https://vlr.gg/player/17644/matrixx,2024-10-12 14:00:00,1.37,1.30,1.34,244,301,187,32,20,12,18,11,7,7,3,4,+2,+2,0,74%,76%,72%,163,188,140,45%,50%,39%,5,3,2,3,1,2
223,https://vlr.gg/player/8502/olizera,2024-10-12 14:00:00,0.89,1.55,1.23,238,202,271,30,12,18,21,12,9,12,3,9,+5,+1,+4,83%,82%,83%,146,125,166,32%,38%,29%,8,4,4,3,3,0
224,https://vlr.gg/player/3674/iluri,2024-10-12 14:00:00,1.05,1.23,1.14,145,131,161,21,9,12,16,8,8,12,5,7,-2,0,-2,69%,71%,67%,92,96,89,43%,21%,86%,1,0,1,3,0,3
225,https://vlr.gg/player/3753/obnoks,2024-10-12 14:00:00,1.11,1.01,1.06,173,192,153,21,12,9,16,9,7,11,4,7,+2,+1,+1,80%,76%,83%,120,129,112,21%,24%,19%,2,1,1,0,0,0
226,https://vlr.gg/player/36403/tenji,2024-10-12 14:00:00,0.58,1.17,0.87,177,135,223,23,8,15,29,15,14,6,4,2,-1,-1,0,57%,61%,53%,118,83,155,40%,35%,44%,0,0,0,1,1,0
227,https://vlr.gg/player/23174/snowi,2024-10-12 14:00:00,0.73,0.87,0.80,180,161,200,19,9,10,27,14,13,5,2,3,-1,0,-1,54%,50%,59%,124,110,140,33%,38%,28%,3,2,1,4,2,2
228,https://vlr.gg/player/28098/linus,2024-10-12 14:00:00,0.77,0.75,0.76,171,163,182,20,10,10,30,15,15,8,3,5,+4,+3,+1,57%,56%,59%,102,92,113,30%,30%,31%,7,3,4,3,0,3
229,https://vlr.gg/player/29951/ziad,2024-10-12 14:00:00,0.38,0.75,0.56,145,92,205,17,5,12,30,15,15,3,1,2,-8,-6,-2,54%,39%,71%,100,64,139,30%,20%,39%,2,1,1,10,7,3
230,https://vlr.gg/player/18192/ryn,2024-10-12 14:00:00,0.41,0.35,0.37,94,109,75,10,6,4,30,16,14,6,3,3,-3,0,-3,46%,44%,47%,73,84,61,28%,19%,43%,1,1,0,4,1,3
231,https://vlr.gg/player/29873/benjyfishy,2024-10-12 14:00:00,1.25,1.00,1.13,249,290,211,53,31,22,45,22,23,10,6,4,0,-1,+1,67%,71%,63%,164,182,144,46%,51%,41%,5,2,3,5,3,2
232,https://vlr.gg/player/14612/lux9,2024-10-12 14:00:00,1.20,0.74,0.97,267,324,209,58,36,22,54,27,27,5,2,3,+9,+13,-4,74%,87%,60%,164,190,136,48%,54%,38%,20,17,3,11,4,7
233,https://vlr.gg/player/11322/sevire,2024-10-12 14:00:00,1.03,0.84,0.93,163,164,170,35,17,18,40,18,22,25,14,11,-2,-1,-1,72%,74%,70%,120,122,119,29%,26%,31%,2,0,2,4,1,3
234,https://vlr.gg/player/43744/akita,2024-10-12 14:00:00,0.51,0.70,0.60,160,138,185,35,17,18,54,25,29,13,7,6,-2,-3,+1,61%,58%,63%,108,88,130,26%,19%,33%,3,0,3,5,3,2
235,https://vlr.gg/player/16078/loupiote,2024-10-12 14:00:00,0.51,0.53,0.52,114,105,122,24,12,12,48,23,25,9,3,6,-2,-1,-1,59%,61%,57%,78,79,78,35%,28%,48%,2,0,2,4,1,3
236,https://vlr.gg/player/5292/al0rante,2024-10-12 14:00:00,1.52,1.45,1.48,288,280,296,65,33,32,41,17,24,16,8,8,+1,+1,0,84%,83%,84%,189,177,201,43%,46%,40%,6,4,2,5,3,2
237,https://vlr.gg/player/4244/yaboilewis,2024-10-12 14:00:00,1.33,1.48,1.41,282,275,277,61,29,32,42,21,21,11,5,6,+3,+3,0,72%,67%,77%,174,170,177,50%,42%,57%,11,7,4,8,4,4
238,https://vlr.gg/player/2052/kuba,2024-10-12 14:00:00,1.29,0.71,0.99,184,229,135,41,26,15,40,17,23,14,8,6,0,+2,-2,74%,87%,61%,125,153,98,39%,44%,32%,4,2,2,4,0,4
239,https://vlr.gg/player/20730/karina,2024-10-12 14:00:00,0.97,1.01,0.99,188,187,194,42,20,22,42,21,21,15,5,10,-2,0,-2,67%,67%,68%,129,125,132,36%,38%,33%,5,3,2,7,3,4
240,https://vlr.gg/player/40177/leeni,2024-10-12 14:00:00,0.95,0.63,0.79,142,148,135,31,17,14,40,17,23,12,7,5,-5,-2,-3,70%,67%,74%,95,91,99,23%,29%,18%,3,1,2,8,3,5
241,https://vlr.gg/player/2835/kyrrz,2024-10-12 13:00:00,1.43,1.58,1.51,226,195,242,32,12,20,17,6,11,25,10,15,+1,-1,+2,95%,94%,95%,136,132,140,41%,31%,50%,2,0,2,1,1,0
242,https://vlr.gg/player/29972/michel,2024-10-12 13:00:00,1.33,1.41,1.37,341,357,317,47,22,25,27,12,15,7,2,5,+6,0,+6,72%,65%,77%,209,224,196,27%,38%,20%,11,3,8,5,3,2
243,https://vlr.gg/player/24359/faska,2024-10-12 13:00:00,1.77,1.03,1.35,231,262,216,30,16,14,21,6,15,20,11,9,+2,+2,0,82%,94%,73%,161,170,154,23%,24%,22%,3,2,1,1,0,1
244,https://vlr.gg/player/4851/rexs,2024-10-12 13:00:00,1.22,1.20,1.20,190,196,187,28,13,15,21,9,12,19,10,9,+1,+1,0,82%,94%,73%,134,142,129,33%,21%,47%,3,1,2,2,0,2
245,https://vlr.gg/player/31553/pukytoo,2024-10-12 13:00:00,0.85,0.82,0.83,167,202,146,24,13,11,26,12,14,5,3,2,+3,+3,0,74%,76%,73%,99,108,92,23%,17%,30%,7,5,2,4,2,2
246,https://vlr.gg/player/3784/katu,2024-10-12 13:00:00,0.97,1.37,1.15,249,236,261,34,18,16,34,19,15,6,2,4,+5,+4,+1,64%,64%,65%,159,141,183,38%,41%,35%,7,5,2,2,1,1
247,https://vlr.gg/player/5854/z3ro,2024-10-12 13:00:00,0.82,0.63,0.74,148,157,152,22,13,9,30,15,15,11,5,6,-3,-2,-1,67%,64%,71%,97,102,91,25%,28%,22%,1,0,1,4,2,2
248,https://vlr.gg/player/29553/dagg3r,2024-10-12 13:00:00,0.74,0.52,0.65,145,157,143,21,13,8,32,17,15,7,5,2,-1,-2,+1,59%,64%,53%,100,101,99,23%,17%,55%,2,0,2,3,2,1
249,https://vlr.gg/player/173/l0udly,2024-10-12 13:00:00,0.62,0.45,0.55,151,154,157,18,10,8,34,18,16,10,8,2,-6,-3,-3,64%,64%,65%,104,101,109,29%,24%,36%,3,2,1,9,5,4
250,https://vlr.gg/player/2313/feqew,2024-10-12 13:00:00,0.71,0.30,0.53,128,157,86,17,13,4,31,16,15,4,1,3,-8,-5,-3,46%,55%,35%,80,98,56,17%,18%,16%,0,0,0,8,5,3
251,https://vlr.gg/player/15500/trent,2024-10-12 12:00:00,1.72,1.00,1.39,253,300,197,60,40,20,42,21,21,22,15,7,-1,-4,+3,69%,77%,60%,170,203,131,34%,33%,34%,7,2,5,8,6,2
252,https://vlr.gg/player/3993/jawgemo,2024-10-12 12:00:00,1.58,1.15,1.38,302,346,263,67,41,26,46,22,24,20,10,10,+11,+7,+4,75%,77%,73%,192,211,171,22%,21%,22%,16,10,6,5,3,2
253,https://vlr.gg/player/20064/vania,2024-10-12 12:00:00,1.11,1.17,1.14,187,185,180,47,25,22,38,22,16,20,10,10,-1,+2,-3,77%,80%,73%,119,122,116,39%,44%,33%,4,3,1,5,1,4
254,https://vlr.gg/player/3885/valyn,2024-10-12 12:00:00,0.56,1.18,0.85,169,134,233,40,18,22,48,26,22,17,6,11,-6,-10,+4,65%,60%,70%,117,92,146,21%,22%,20%,5,0,5,11,10,1
255,https://vlr.gg/player/17323/mimi,2024-10-12 12:00:00,0.68,0.82,0.75,142,113,161,31,14,17,45,22,23,17,6,11,+2,0,+2,68%,69%,67%,95,79,115,22%,22%,22%,3,0,3,1,0,1
256,https://vlr.gg/player/10307/marteen,2024-10-12 12:00:00,1.27,1.35,1.31,277,253,299,63,29,34,44,20,24,16,3,13,+6,-1,+7,75%,60%,89%,176,160,190,34%,27%,42%,12,3,9,6,4,2
257,https://vlr.gg/player/21216/f4ngeer,2024-10-12 12:00:00,1.03,1.08,1.05,243,251,240,53,25,28,53,24,29,18,8,10,+2,-2,+4,71%,70%,71%,158,160,157,27%,26%,28%,10,3,7,8,5,3
258,https://vlr.gg/player/24439/yohpa,2024-10-12 12:00:00,1.02,0.78,0.90,171,192,151,27,16,11,33,14,19,22,13,9,-3,-1,-2,68%,75%,61%,111,116,105,34%,33%,34%,1,1,0,4,2,2
259,https://vlr.gg/player/16321/nelo,2024-10-12 12:00:00,0.64,0.86,0.77,174,154,185,26,10,16,32,14,18,9,1,8,-4,-2,-2,60%,50%,67%,104,84,119,32%,40%,28%,2,1,1,6,3,3
260,https://vlr.gg/player/21153/matrix,2024-10-12 12:00:00,0.95,0.45,0.67,157,231,116,23,15,8,33,15,18,6,3,3,-2,-1,-1,63%,67%,61%,111,148,82,34%,45%,24%,3,2,1,5,3,2
261,https://vlr.gg/player/11183/glance,2024-10-12 12:00:00,0.69,0.53,0.60,119,117,123,27,11,16,50,20,30,27,17,10,-4,-3,-1,68%,77%,60%,73,76,71,25%,20%,30%,2,0,2,6,3,3
262,https://vlr.gg/player/12928/veqaj,2024-10-12 12:00:00,1.45,1.64,1.52,334,341,312,44,28,16,23,17,6,6,4,2,+5,+4,+1,70%,63%,85%,213,216,207,22%,29%,12%,12,9,3,7,5,2
263,https://vlr.gg/player/6889/neskaas,2024-10-12 12:00:00,1.28,1.49,1.36,221,218,231,29,18,11,18,12,6,12,8,4,-2,-2,0,76%,71%,85%,146,145,148,28%,29%,27%,2,1,1,4,3,1
264,https://vlr.gg/player/11/zyppan,2024-10-12 12:00:00,1.01,1.68,1.24,236,164,386,33,14,19,21,14,7,12,10,2,+4,+2,+2,73%,71%,77%,169,131,239,36%,36%,36%,4,2,2,0,0,0
265,https://vlr.gg/player/24071/liza,2024-10-12 12:00:00,1.13,1.31,1.19,216,206,217,31,20,11,19,14,5,7,3,4,+1,+1,0,76%,75%,77%,130,129,132,34%,38%,29%,3,2,1,2,1,1
266,https://vlr.gg/player/38142/dream,2024-10-12 12:00:00,0.79,0.60,0.72,113,148,55,15,12,3,24,18,6,19,18,1,-3,-1,-2,81%,83%,77%,76,91,48,24%,28%,13%,0,0,0,3,1,2
267,https://vlr.gg/player/41207/jade,2024-10-12 12:00:00,0.49,1.13,0.90,176,111,208,22,3,19,30,12,18,13,7,6,-1,0,-1,59%,54%,63%,112,75,131,36%,20%,41%,3,1,2,4,1,3
268,https://vlr.gg/player/20302/jini,2024-10-12 12:00:00,0.78,0.97,0.90,179,169,184,23,8,15,29,12,17,11,3,8,-1,0,-1,51%,54%,50%,129,125,131,33%,37%,31%,2,1,1,3,1,2
269,https://vlr.gg/player/122/luckerrr,2024-10-12 12:00:00,0.73,0.85,0.80,209,203,214,24,8,16,31,12,19,6,2,4,0,-1,+1,49%,46%,50%,131,129,133,29%,37%,25%,8,3,5,8,4,4
270,https://vlr.gg/player/7968/stavinci,2024-10-12 12:00:00,0.97,0.63,0.75,166,190,153,20,8,12,31,11,20,10,4,6,-2,+1,-3,59%,62%,58%,107,128,96,44%,40%,48%,2,1,1,4,0,4
271,https://vlr.gg/player/17318/blossi,2024-10-12 12:00:00,0.29,0.94,0.71,145,96,175,16,3,13,31,13,18,11,2,9,-1,-1,0,54%,31%,67%,103,77,117,15%,14%,16%,1,0,1,2,1,1
272,https://vlr.gg/player/7866/click,2024-10-12 12:00:00,1.25,1.71,1.47,342,308,383,82,37,45,52,31,21,12,5,7,+14,+5,+9,79%,75%,84%,216,190,245,38%,39%,36%,22,13,9,8,8,0
273,https://vlr.gg/player/7105/qpert,2024-10-12 12:00:00,0.85,1.56,1.19,201,140,269,49,18,31,43,26,17,38,16,22,+3,0,+3,74%,69%,78%,132,98,169,27%,25%,28%,6,1,5,3,1,2
274,https://vlr.gg/player/448/meddo,2024-10-12 12:00:00,1.00,1.22,1.10,190,189,190,46,24,22,44,26,18,32,10,22,+1,0,+1,75%,72%,78%,124,124,124,27%,27%,27%,3,1,2,2,1,1
275,https://vlr.gg/player/9434/samsi,2024-10-12 12:00:00,0.76,1.25,1.01,174,149,201,16,6,10,14,8,6,8,4,4,-1,0,-1,79%,75%,83%,123,97,149,28%,22%,32%,0,0,0,1,0,1
276,https://vlr.gg/player/30241/majusia,2024-10-12 12:00:00,0.81,0.61,0.72,129,153,102,19,13,6,29,17,12,11,3,8,-5,-3,-2,68%,54%,85%,87,102,70,36%,39%,32%,4,1,3,9,4,5
277,https://vlr.gg/player/45174/purity,2024-10-12 12:00:00,0.43,0.83,0.62,129,113,150,31,12,19,49,29,20,16,8,8,-4,-2,-2,59%,58%,59%,92,81,104,29%,27%,31%,3,2,1,7,4,3
278,https://vlr.gg/player/1493/starkk,2024-10-12 12:00:00,0.95,1.50,1.24,212,185,236,52,19,33,42,25,17,22,12,10,-4,-3,-1,66%,63%,69%,149,134,162,31%,21%,39%,2,1,1,6,4,2
279,https://vlr.gg/player/4277/n-a-i-s,2024-10-12 12:00:00,0.86,1.10,0.99,205,201,207,47,22,25,49,29,20,19,5,14,-2,0,-2,71%,66%,75%,138,134,141,31%,34%,28%,3,2,1,5,2,3
280,https://vlr.gg/player/24069/mochi,2024-10-12 12:00:00,0.99,0.91,0.95,171,180,165,42,21,21,46,24,22,11,4,7,-1,+2,-3,65%,56%,72%,120,126,115,38%,42%,34%,2,2,0,3,0,3
281,https://vlr.gg/player/23347/alannn,2024-10-12 12:00:00,0.45,1.31,0.90,220,141,290,52,14,38,55,29,26,11,6,5,-6,-8,+2,65%,59%,69%,137,97,172,30%,35%,28%,13,4,9,19,12,7
282,https://vlr.gg/player/46436/sucette,2024-10-12 12:00:00,0.81,0.92,0.87,169,165,173,38,18,20,51,26,25,30,12,18,+5,+1,+4,71%,59%,81%,103,98,107,20%,26%,16%,10,3,7,5,2,3
283,https://vlr.gg/player/20032/treelover,2024-10-12 11:00:00,1.17,1.36,1.25,217,219,207,48,27,21,37,22,15,26,15,11,+4,+4,0,77%,80%,73%,141,141,142,28%,22%,37%,7,5,2,3,1,2
284,https://vlr.gg/player/2540/happen,2024-10-12 11:00:00,1.21,1.17,1.19,238,231,250,51,29,22,37,20,17,21,9,12,+3,+2,+1,77%,80%,73%,164,161,169,25%,27%,24%,5,3,2,2,1,1
285,https://vlr.gg/player/13238/shiio,2024-10-12 11:00:00,1.16,1.20,1.18,211,198,211,45,25,20,35,20,15,15,6,9,+7,+5,+2,82%,77%,88%,135,140,129,19%,20%,17%,9,5,4,2,0,2
286,https://vlr.gg/player/3649/litshii,2024-10-12 11:00:00,1.06,1.11,1.08,170,181,156,37,22,15,35,21,14,36,20,16,-1,0,-1,77%,74%,81%,114,120,107,19%,14%,29%,2,1,1,3,1,2
287,https://vlr.gg/player/47270/darkwinjett,2024-10-12 11:00:00,0.96,1.20,1.06,231,209,267,50,25,25,43,24,19,15,10,5,+4,-2,+6,67%,66%,69%,152,138,170,19%,14%,27%,16,8,8,12,10,2
288,https://vlr.gg/player/46466/frazune,2024-10-12 11:00:00,0.81,1.05,0.95,167,162,170,33,12,21,42,20,22,17,10,7,+2,0,+2,70%,73%,69%,109,121,99,26%,30%,22%,3,0,3,1,0,1
289,https://vlr.gg/player/30292/bruhbruhfish,2024-10-12 11:00:00,0.83,1.01,0.93,193,191,206,43,17,26,42,19,23,11,3,8,-5,-1,-4,67%,65%,69%,126,122,128,33%,41%,29%,3,1,2,8,2,6
290,https://vlr.gg/player/33398/miyamura,2024-10-12 11:00:00,0.80,0.90,0.86,189,184,193,40,17,23,49,21,28,22,9,13,-3,-3,0,66%,62%,69%,110,105,114,21%,31%,17%,6,3,3,9,6,3
291,https://vlr.gg/player/46468/dokusei,2024-10-12 11:00:00,1.18,0.60,0.85,181,249,137,38,23,15,48,20,28,12,2,10,-4,+2,-6,61%,69%,54%,135,178,103,44%,48%,40%,5,3,2,9,1,8
292,https://vlr.gg/player/39664/insanedini,2024-10-12 11:00:00,0.41,0.95,0.72,170,126,207,33,11,22,50,23,27,16,6,10,-7,-6,-1,64%,65%,63%,118,83,144,21%,13%,25%,5,2,3,12,8,4
293,https://vlr.gg/player/15473/yuno,2024-10-12 10:50:00,1.64,1.13,1.40,290,312,269,46,28,18,35,18,17,17,9,8,+4,+1,+3,78%,80%,76%,184,195,170,18%,24%,13%,6,2,4,2,1,1
294,https://vlr.gg/player/29958/ximy,2024-10-12 10:50:00,0.70,1.17,0.91,205,187,242,33,14,19,39,22,17,11,7,4,-4,-4,0,72%,68%,76%,133,114,155,25%,18%,31%,9,4,5,13,8,5
295,https://vlr.gg/player/22314/mober,2024-10-12 10:50:00,0.86,0.80,0.83,168,161,167,29,15,14,33,18,15,6,3,3,-3,-2,-1,72%,72%,71%,105,103,107,38%,48%,29%,3,2,1,6,4,2
296,https://vlr.gg/player/36645/tomatte,2024-10-12 10:50:00,0.94,0.69,0.82,153,159,143,25,14,11,32,15,17,23,13,10,0,0,0,78%,76%,81%,86,95,76,40%,43%,36%,2,1,1,2,1,1
297,https://vlr.gg/player/31549/pando,2024-10-12 10:50:00,0.78,0.58,0.69,164,156,155,23,14,9,36,20,16,9,2,7,-1,-2,+1,74%,72%,76%,124,117,133,37%,50%,28%,1,0,1,2,2,0
298,https://vlr.gg/player/29638/kotaro,2024-10-12 10:50:00,1.47,0.91,1.16,217,227,208,38,19,19,28,11,17,17,12,5,-1,-1,0,83%,86%,80%,141,140,141,35%,29%,44%,3,1,2,4,2,2
299,https://vlr.gg/player/41846/shiro,2024-10-12 10:50:00,0.90,1.29,1.11,213,141,267,36,10,26,28,13,15,14,9,5,-1,-2,+1,70%,62%,76%,139,110,163,23%,25%,22%,3,1,2,4,3,1
300,https://vlr.gg/player/29827/repteyy,2024-10-12 10:50:00,1.24,0.98,1.09,196,213,179,30,15,15,31,13,18,25,9,16,+2,0,+2,76%,67%,84%,126,130,122,15%,13%,18%,5,1,4,3,1,2
301,https://vlr.gg/player/29994/xini,2024-10-12 10:50:00,0.84,1.10,0.98,258,244,265,43,20,23,38,18,20,8,4,4,+4,-2,+6,70%,71%,68%,160,139,177,26%,18%,35%,12,4,8,8,6,2
302,https://vlr.gg/player/31569/cyan,2024-10-12 10:50:00,1.16,0.67,0.90,182,246,130,28,18,10,31,16,15,15,8,7,0,+2,-2,72%,76%,68%,123,167,86,22%,27%,16%,2,2,0,2,0,2
303,https://vlr.gg/player/16139/enrik,2024-10-12 09:00:00,1.76,1.01,1.39,237,299,173,37,24,13,23,11,12,14,7,7,+1,+2,-1,78%,86%,70%,154,194,113,31%,33%,29%,4,2,2,3,0,3
304,https://vlr.gg/player/22291/razziss,2024-10-12 09:00:00,1.42,1.33,1.38,306,324,288,46,25,21,27,14,13,7,4,3,+4,+1,+3,73%,81%,65%,197,221,172,31%,33%,29%,12,7,5,8,6,2
305,https://vlr.gg/player/22188/jimbk,2024-10-12 09:00:00,1.38,1.31,1.35,222,228,214,34,18,16,23,13,10,13,6,7,0,0,0,85%,81%,90%,158,162,153,24%,27%,23%,2,1,1,2,1,1
306,https://vlr.gg/player/33513/sihw,2024-10-12 09:00:00,0.59,1.08,0.83,146,115,182,22,9,13,27,15,12,5,1,4,+2,+1,+1,61%,62%,60%,104,80,128,26%,30%,24%,4,2,2,2,1,1
307,https://vlr.gg/player/45143/francybald,2024-10-12 09:00:00,0.55,0.91,0.73,140,106,177,20,8,12,27,15,12,9,5,4,-4,-1,-3,61%,52%,70%,101,76,126,31%,17%,50%,0,0,0,4,1,3
308,https://vlr.gg/player/3158/theozy,2024-10-12 09:00:00,0.51,1.23,0.88,191,113,265,30,9,21,33,17,16,3,2,1,-3,-4,+1,61%,55%,67%,119,78,159,29%,22%,34%,4,0,4,7,4,3
309,https://vlr.gg/player/22952/caim,2024-10-12 09:00:00,0.60,1.10,0.86,178,117,240,24,8,16,32,15,17,11,4,7,-2,-2,0,71%,65%,76%,130,89,169,27%,33%,24%,1,0,1,3,2,1
310,https://vlr.gg/player/41778/nexy,2024-10-12 09:00:00,0.94,0.77,0.85,166,166,164,23,12,11,29,13,16,6,2,4,+4,+2,+2,63%,60%,67%,109,101,117,31%,32%,30%,5,3,2,1,1,0
311,https://vlr.gg/player/48444/gonzalitos,2024-10-12 09:00:00,1.05,0.63,0.84,149,178,121,23,13,10,31,14,17,9,6,3,-1,+1,-2,54%,50%,57%,100,126,75,30%,33%,26%,1,1,0,2,0,2
312,https://vlr.gg/player/26792/hax,2024-10-12 09:00:00,1.03,0.48,0.75,202,250,159,27,17,10,34,16,18,9,4,5,-1,+3,-4,66%,75%,57%,136,157,117,48%,49%,46%,8,6,2,9,3,6
313,https://vlr.gg/player/27244/seph1roth,2024-10-12 07:35:00,1.54,1.21,1.41,213,210,210,30,18,12,19,8,11,18,12,6,+3,+3,0,90%,92%,88%,135,141,125,38%,37%,38%,5,3,2,2,0,2
314,https://vlr.gg/player/13784/killua,2024-10-12 07:35:00,1.23,1.23,1.23,261,280,230,38,25,13,28,18,10,10,2,8,-1,-1,0,83%,88%,75%,167,176,153,47%,46%,48%,4,2,2,5,3,2
315,https://vlr.gg/player/12098/kadoom,2024-10-12 07:35:00,1.26,1.09,1.19,241,276,195,34,23,11,26,16,10,4,2,2,+4,+6,-2,75%,83%,63%,160,174,138,25%,33%,15%,11,10,1,7,4,3
316,https://vlr.gg/player/24679/cgrs,2024-10-12 07:35:00,1.28,0.99,1.16,201,201,198,27,17,10,25,13,12,21,12,9,0,0,0,80%,88%,69%,139,146,130,30%,27%,33%,1,0,1,1,0,1
317,https://vlr.gg/player/8582/laz,2024-10-12 07:35:00,0.98,1.09,1.02,163,147,189,25,14,11,21,12,9,10,5,5,-2,-2,0,75%,67%,88%,110,104,119,28%,29%,27%,1,0,1,3,2,1
318,https://vlr.gg/player/19150/niffy,2024-10-12 07:35:00,1.23,0.90,1.03,203,217,203,29,13,16,30,11,19,8,5,3,+2,+2,0,78%,81%,75%,135,153,123,38%,37%,39%,4,2,2,2,0,2
319,https://vlr.gg/player/6733/xze,2024-10-12 07:35:00,0.92,0.95,0.94,170,127,198,26,9,17,29,10,19,4,3,1,+1,-1,+2,55%,63%,50%,121,106,131,64%,50%,73%,3,0,3,2,1,1
320,https://vlr.gg/player/23918/reality,2024-10-12 07:35:00,0.77,0.71,0.73,150,146,155,19,7,12,30,11,19,20,10,10,+1,+1,0,70%,75%,67%,104,112,99,31%,24%,38%,3,1,2,2,0,2
321,https://vlr.gg/player/1910/acetics,2024-10-12 07:35:00,0.74,0.59,0.62,161,176,157,22,10,12,32,12,20,9,6,3,-4,-1,-3,63%,56%,67%,105,107,103,29%,32%,27%,4,2,2,8,3,5
322,https://vlr.gg/player/15891/krx,2024-10-12 07:35:00,0.89,0.39,0.59,157,214,116,23,13,10,33,13,20,3,1,2,-4,+1,-5,53%,56%,50%,101,137,76,27%,26%,29%,4,4,0,8,3,5
323,https://vlr.gg/player/17447/alyssa,2024-10-12 07:00:00,,,,242,,,38,,,32,,,5,,,,,,,,,,,,,,,,,,,,
324,https://vlr.gg/player/48205/x1aowen,2024-10-12 07:00:00,,,,199,,,27,,,33,,,22,,,,,,,,,,,,,,,,,,,,
325,https://vlr.gg/player/48207/elina,2024-10-12 07:00:00,,,,195,,,27,,,34,,,8,,,,,,,,,,,,,,,,,,,,
326,https://vlr.gg/player/48206/7er,2024-10-12 07:00:00,,,,164,,,27,,,33,,,13,,,,,,,,,,,,,,,,,,,,
327,https://vlr.gg/player/25443/bambi,2024-10-12 07:00:00,,,,154,,,20,,,35,,,13,,,,,,,,,,,,,,,,,,,,
328,https://vlr.gg/player/17526/clem,2024-10-12 07:00:00,,,,293,,,46,,,29,,,5,,,,,,,,,,,,,,,,,,,,
329,https://vlr.gg/player/15307/jue,2024-10-12 07:00:00,,,,234,,,34,,,28,,,17,,,,,,,,,,,,,,,,,,,,
330,https://vlr.gg/player/41164/ysy,2024-10-12 07:00:00,,,,222,,,33,,,26,,,22,,,,,,,,,,,,,,,,,,,,
331,https://vlr.gg/player/15304/xixi,2024-10-12 07:00:00,,,,209,,,30,,,29,,,7,,,,,,,,,,,,,,,,,,,,
332,https://vlr.gg/player/25489/chloe,2024-10-12 07:00:00,,,,164,,,24,,,27,,,10,,,,,,,,,,,,,,,,,,,,
333,https://vlr.gg/player/7987/kovaq,2024-10-12 07:00:00,1.44,1.15,1.30,309,324,290,48,26,22,35,15,20,14,10,4,+1,-2,+3,77%,79%,74%,199,212,185,34%,39%,28%,12,6,6,11,8,3
334,https://vlr.gg/player/12593/felix,2024-10-12 07:00:00,1.26,1.20,1.23,231,251,212,39,21,18,31,17,14,14,5,9,0,+2,-2,77%,71%,83%,142,156,127,24%,28%,20%,5,3,2,5,1,4
335,https://vlr.gg/player/20302/jini,2024-10-12 07:00:00,1.49,0.83,1.17,194,254,132,37,25,12,30,13,17,13,9,4,+2,0,+2,79%,83%,74%,125,161,88,28%,33%,21%,4,2,2,2,2,0
336,https://vlr.gg/player/122/luckerrr,2024-10-12 07:00:00,0.69,1.16,0.92,174,106,247,27,9,18,32,16,16,8,4,4,+1,+1,0,72%,79%,65%,130,86,176,28%,18%,34%,2,1,1,1,0,1
337,https://vlr.gg/player/7968/stavinci,2024-10-12 07:00:00,0.85,0.87,0.86,138,135,143,23,12,11,30,15,15,25,11,14,-3,-1,-2,74%,79%,70%,94,100,86,37%,41%,33%,1,0,1,4,1,3
338,https://vlr.gg/player/18374/sevkaan,2024-10-12 07:00:00,1.43,0.90,1.16,221,253,192,36,22,14,31,13,18,11,5,6,-1,-1,0,66%,78%,54%,156,181,133,25%,28%,21%,3,1,2,4,2,2
339,https://vlr.gg/player/35513/samed,2024-10-12 07:00:00,0.66,1.19,0.93,239,207,270,40,17,23,39,21,18,9,5,4,-1,-4,+3,64%,57%,71%,151,139,163,27%,35%,23%,10,5,5,11,9,2
340,https://vlr.gg/player/2832/patix,2024-10-12 07:00:00,1.03,0.68,0.85,157,178,136,27,16,11,35,16,19,11,2,9,+2,+3,-1,68%,74%,63%,96,103,89,35%,40%,30%,7,4,3,5,1,4
341,https://vlr.gg/player/12381/wanted,2024-10-12 07:00:00,0.73,0.91,0.82,177,154,200,27,11,16,36,18,18,21,10,11,0,+1,-1,74%,83%,67%,113,96,130,35%,26%,43%,2,1,1,2,0,2
342,https://vlr.gg/player/7231/kya,2024-10-12 07:00:00,0.90,0.71,0.80,156,166,146,27,15,12,33,14,19,9,4,5,-1,0,-1,66%,61%,71%,105,111,100,26%,34%,17%,1,0,1,2,0,2
343,https://vlr.gg/player/16977/socools0da,2024-10-12 06:00:00,1.94,2.13,2.02,353,350,355,44,24,20,13,9,4,14,9,5,+4,+2,+2,85%,74%,100%,213,228,193,42%,43%,41%,5,3,2,1,1,0
344,https://vlr.gg/player/31498/lorangez,2024-10-12 06:00:00,1.54,1.39,1.47,237,223,259,30,16,14,16,9,7,20,12,8,+2,0,+2,88%,79%,100%,154,144,168,33%,26%,43%,5,3,2,3,3,0
345,https://vlr.gg/player/27225/d4rf,2024-10-12 06:00:00,1.32,1.26,1.29,209,216,191,21,13,8,17,10,7,29,13,16,+1,-1,+2,91%,84%,100%,138,149,123,24%,32%,15%,2,0,2,1,1,0
346,https://vlr.gg/player/12291/arpoom,2024-10-12 06:00:00,1.06,1.34,1.18,212,178,252,25,12,13,17,10,7,12,8,4,0,-1,+1,88%,84%,93%,142,110,186,33%,40%,29%,3,0,3,3,1,2
347,https://vlr.gg/player/25535/vickyz,2024-10-12 06:00:00,0.66,1.56,1.04,210,181,245,25,12,13,20,16,4,9,4,5,+2,-1,+3,70%,58%,86%,126,112,145,22%,22%,21%,6,3,3,4,4,0
348,https://vlr.gg/player/48509/tongk,2024-10-12 06:00:00,0.75,1.05,0.92,172,183,168,22,9,13,27,14,13,5,1,4,+1,0,+1,70%,64%,74%,117,123,112,26%,38%,19%,1,0,1,0,0,0
349,https://vlr.gg/player/48512/sulliva4n,2024-10-12 06:00:00,0.49,0.96,0.76,150,127,173,19,6,13,27,14,13,5,2,3,-1,-1,0,55%,50%,58%,107,77,129,49%,60%,45%,3,0,3,4,1,3
350,https://vlr.gg/player/48508/,2024-10-12 06:00:00,0.56,0.79,0.69,168,182,186,17,7,10,30,14,16,9,1,8,-2,-3,+1,45%,43%,47%,123,116,128,19%,33%,12%,6,2,4,8,5,3
351,https://vlr.gg/player/48510/russody,2024-10-12 06:00:00,0.25,0.62,0.45,129,73,173,14,3,11,30,13,17,6,3,3,-5,-6,+1,45%,36%,53%,91,61,114,19%,23%,18%,2,0,2,7,6,1
352,https://vlr.gg/player/48511/immawrecked,2024-10-12 06:00:00,0.43,0.30,0.35,106,91,110,11,4,7,31,13,18,7,5,2,-2,0,-2,55%,50%,58%,63,52,72,33%,36%,32%,0,0,0,2,0,2
353,https://vlr.gg/player/48167/xiaolan,2024-10-12 05:00:00,,,,186,,,20,,,31,,,7,,,,,,,,,,,,,,,,,,,,
354,https://vlr.gg/player/30334/yang,2024-10-12 05:00:00,,,,166,,,20,,,30,,,18,,,,,,,,,,,,,,,,,,,,
355,https://vlr.gg/player/48168/zora,2024-10-12 05:00:00,,,,166,,,21,,,27,,,5,,,,,,,,,,,,,,,,,,,,
356,https://vlr.gg/player/48170/anan,2024-10-12 05:00:00,,,,138,,,14,,,29,,,10,,,,,,,,,,,,,,,,,,,,
357,https://vlr.gg/player/48169/jennie,2024-10-12 05:00:00,,,,108,,,12,,,32,,,6,,,,,,,,,,,,,,,,,,,,
358,https://vlr.gg/player/25415/yusin,2024-10-12 05:00:00,,,,305,,,41,,,14,,,21,,,,,,,,,,,,,,,,,,,,
359,https://vlr.gg/player/13232/muffyn,2024-10-12 05:00:00,,,,282,,,35,,,23,,,9,,,,,,,,,,,,,,,,,,,,
360,https://vlr.gg/player/48160/laiyin,2024-10-12 05:00:00,,,,229,,,30,,,18,,,14,,,,,,,,,,,,,,,,,,,,
361,https://vlr.gg/player/48161/1hp,2024-10-12 05:00:00,,,,200,,,25,,,17,,,15,,,,,,,,,,,,,,,,,,,,
362,https://vlr.gg/player/1909/jinny,2024-10-12 05:00:00,,,,158,,,18,,,15,,,33,,,,,,,,,,,,,,,,,,,,
363,https://vlr.gg/player/10769/nobita,2024-10-12 04:30:00,0.88,1.65,1.26,258,205,312,66,25,41,52,31,21,24,8,16,+2,-2,+4,77%,73%,81%,167,137,198,25%,25%,25%,7,1,6,5,3,2
364,https://vlr.gg/player/27442/impact,2024-10-12 04:30:00,1.02,1.06,1.04,206,199,214,50,24,26,51,28,23,15,5,10,+5,+2,+3,75%,70%,81%,130,129,130,29%,30%,27%,12,5,7,7,3,4
365,https://vlr.gg/player/40726/gwangboong,2024-10-12 04:30:00,0.67,1.38,1.02,226,180,276,57,21,36,57,34,23,19,11,8,-5,-9,+4,70%,54%,86%,153,117,189,26%,21%,31%,9,4,5,14,13,1
366,https://vlr.gg/player/48431/kippei,2024-10-12 04:30:00,0.71,1.13,0.92,165,137,200,46,18,28,49,29,20,25,11,14,-1,-2,+1,68%,59%,78%,107,78,137,32%,26%,38%,4,1,3,5,3,2
367,https://vlr.gg/player/10628/misaya,2024-10-12 04:30:00,0.76,0.89,0.82,153,160,147,33,17,16,52,31,21,45,24,21,-2,-4,+2,75%,73%,78%,96,103,90,14%,13%,15%,4,0,4,6,4,2
368,https://vlr.gg/player/45962/ken,2024-10-12 04:30:00,0.89,1.37,1.13,219,200,239,53,22,31,50,30,20,25,10,15,-4,-6,+2,73%,58%,86%,165,152,178,27%,24%,31%,8,2,6,12,8,4
369,https://vlr.gg/player/1009/sakurai,2024-10-12 04:30:00,1.27,1.00,1.13,211,240,183,55,30,25,50,27,23,33,16,17,-1,-3,+2,71%,64%,78%,139,161,116,35%,44%,25%,6,2,4,7,5,2
370,https://vlr.gg/player/2400/brofeld,2024-10-12 04:30:00,0.67,1.49,1.09,191,140,244,55,18,37,46,29,17,13,6,7,+7,+2,+5,75%,67%,84%,116,89,141,23%,22%,23%,8,3,5,1,1,0
371,https://vlr.gg/player/40736/kapi,2024-10-12 04:30:00,0.83,1.09,0.96,199,194,205,52,24,28,53,30,23,33,17,16,0,-5,+5,78%,67%,89%,137,129,145,34%,35%,32%,8,2,6,8,7,1
372,https://vlr.gg/player/6702/bazz,2024-10-12 04:30:00,0.53,1.27,0.91,181,116,245,46,14,32,53,31,22,25,9,16,-1,-2,+1,71%,67%,76%,123,78,167,36%,44%,33%,7,2,5,8,4,4
373,https://vlr.gg/player/17099/bom-alpha,2024-10-12 01:00:00,0.69,1.36,1.05,215,148,266,30,10,20,31,16,15,16,3,13,+1,0,+1,85%,78%,90%,132,85,171,40%,43%,38%,3,1,2,2,1,1
374,https://vlr.gg/player/33417/fukuken,2024-10-12 01:00:00,0.92,1.02,0.97,205,181,232,26,10,16,31,15,16,21,11,10,+1,+1,0,69%,61%,76%,138,128,147,31%,29%,32%,2,1,1,1,0,1
375,https://vlr.gg/player/48430/rui,2024-10-12 01:00:00,0.75,1.00,0.88,217,186,241,30,12,18,31,14,17,7,4,3,-2,-4,+2,62%,56%,67%,136,97,170,21%,17%,25%,8,3,5,10,7,3
376,https://vlr.gg/player/40734/hands,2024-10-12 01:00:00,0.61,0.90,0.75,165,150,185,20,8,12,30,16,14,9,4,5,0,+2,-2,64%,50%,76%,113,101,123,28%,23%,31%,4,3,1,4,1,3
377,https://vlr.gg/player/10661/phantom,2024-10-12 01:00:00,0.57,0.63,0.60,134,144,126,18,9,9,31,16,15,10,4,6,-3,-1,-2,69%,61%,76%,99,96,102,23%,11%,33%,1,0,1,4,1,3
378,https://vlr.gg/player/48492/mametu,2024-10-12 01:00:00,1.34,1.53,1.43,293,296,293,43,25,18,27,18,9,4,2,2,+6,+6,0,82%,76%,89%,189,185,194,27%,26%,28%,9,7,2,3,1,2
379,https://vlr.gg/player/23971/ask,2024-10-12 01:00:00,1.00,1.72,1.33,209,163,261,28,11,17,20,13,7,15,9,6,+2,0,+2,82%,76%,89%,142,129,158,21%,15%,28%,2,0,2,0,0,0
380,https://vlr.gg/player/34785/yowamu,2024-10-12 01:00:00,1.08,1.47,1.26,270,249,295,34,16,18,27,16,11,15,10,5,+1,-2,+3,79%,67%,94%,182,160,207,27%,28%,27%,8,4,4,7,6,1
381,https://vlr.gg/player/10658/kurozooted,2024-10-12 01:00:00,0.93,1.13,1.02,181,135,230,26,12,14,24,14,10,18,12,6,-1,0,-1,79%,81%,78%,121,102,144,29%,29%,30%,1,0,1,2,0,2
382,https://vlr.gg/player/34760/meatpien,2024-10-12 01:00:00,0.95,0.74,0.85,157,133,189,23,13,10,26,14,12,17,8,9,-5,-3,-2,67%,62%,72%,102,107,97,25%,24%,26%,1,0,1,6,3,3
383,https://vlr.gg/player/21886/furbsa,2024-10-11 21:25:00,0.95,1.35,1.19,210,199,218,33,13,20,23,13,10,6,2,4,-3,-2,-1,73%,63%,79%,139,127,148,41%,30%,48%,2,0,2,5,2,3
384,https://vlr.gg/player/754/nerve,2024-10-11 21:25:00,1.04,1.20,1.14,203,202,195,31,13,18,23,12,11,9,4,5,+2,0,+2,80%,69%,88%,123,122,124,26%,25%,27%,3,1,2,1,1,0
385,https://vlr.gg/player/34057/jerrwin,2024-10-11 21:25:00,1.22,1.09,1.14,266,303,254,38,16,22,28,14,14,11,8,3,0,+1,-1,73%,81%,67%,175,190,164,21%,23%,19%,8,4,4,8,3,5
386,https://vlr.gg/player/8397/dip,2024-10-11 21:25:00,0.94,1.25,1.13,243,235,239,29,12,17,28,15,13,17,7,10,+7,+2,+5,83%,88%,79%,147,149,146,22%,21%,22%,8,2,6,1,0,1
387,https://vlr.gg/player/6437/dark3st,2024-10-11 21:25:00,0.63,1.38,1.08,193,147,230,27,8,19,26,14,12,20,9,11,0,-1,+1,80%,81%,79%,136,86,168,36%,26%,43%,2,1,1,2,2,0
388,https://vlr.gg/player/41966/jar,2024-10-11 21:25:00,0.93,1.43,1.13,235,170,327,34,14,20,31,18,13,6,4,2,0,0,0,75%,63%,94%,156,111,225,43%,41%,45%,6,3,3,6,3,3
389,https://vlr.gg/player/18728/yukine,2024-10-11 21:25:00,0.72,1.64,1.09,188,129,294,26,9,17,28,17,11,12,6,6,+1,-1,+2,70%,54%,94%,134,93,195,27%,29%,25%,3,0,3,2,1,1
390,https://vlr.gg/player/29613/flashh,2024-10-11 21:25:00,0.95,0.71,0.86,204,225,174,29,19,10,33,21,12,5,3,2,-3,-3,0,65%,54%,81%,143,148,136,31%,32%,30%,4,3,1,7,6,1
391,https://vlr.gg/player/27991/wave,2024-10-11 21:25:00,0.64,0.79,0.70,156,141,196,19,9,10,34,20,14,20,9,11,-1,0,-1,60%,67%,50%,112,97,134,36%,26%,55%,2,2,0,3,2,1
392,https://vlr.gg/player/39535/xander,2024-10-11 21:25:00,0.45,0.85,0.61,137,103,188,20,9,11,32,20,12,9,5,4,-3,-2,-1,63%,54%,75%,90,63,130,47%,39%,54%,2,1,1,5,3,2
393,https://vlr.gg/player/31574/srn,2024-10-11 19:00:00,0.80,2.00,1.34,288,203,374,62,22,40,45,29,16,14,9,5,-1,-3,+2,69%,59%,82%,188,136,252,22%,19%,26%,14,8,6,15,11,4
394,https://vlr.gg/player/11239/sayuri,2024-10-11 19:00:00,1.20,1.03,1.13,204,218,172,43,27,16,40,25,15,43,18,25,+2,+4,-2,79%,79%,79%,123,132,112,19%,18%,20%,5,4,1,3,0,3
395,https://vlr.gg/player/14685/jubs,2024-10-11 19:00:00,1.01,1.15,1.07,190,185,205,46,25,21,37,23,14,16,7,9,+1,0,+1,82%,82%,82%,128,123,134,20%,21%,19%,4,0,4,3,0,3
396,https://vlr.gg/player/19791/mel,2024-10-11 19:00:00,1.09,1.04,1.07,202,220,191,43,25,18,40,25,15,26,14,12,+1,+1,0,87%,82%,93%,134,145,121,32%,38%,25%,3,2,1,2,1,1
397,https://vlr.gg/player/21435/jelly,2024-10-11 19:00:00,0.49,1.49,0.94,175,121,253,42,14,28,45,28,17,17,6,11,-1,-4,+3,69%,56%,86%,119,84,163,39%,28%,47%,6,2,4,7,6,1
398,https://vlr.gg/player/4807/bstrdd,2024-10-11 19:00:00,0.96,1.31,1.15,252,231,274,56,20,36,47,24,23,10,7,3,-1,-1,0,71%,61%,79%,161,150,170,21%,21%,22%,13,7,6,14,8,6
399,https://vlr.gg/player/12143/bizerra,2024-10-11 19:00:00,0.69,1.23,0.99,198,141,238,39,11,28,47,24,23,27,13,14,-2,0,-2,68%,57%,76%,135,108,157,23%,15%,29%,2,1,1,4,1,3
400,https://vlr.gg/player/11232/daiki,2024-10-11 19:00:00,0.68,1.16,0.94,188,147,224,41,16,25,48,25,23,26,12,14,0,-2,+2,71%,71%,71%,130,99,156,26%,22%,29%,7,1,6,7,3,4
401,https://vlr.gg/player/15297/joojina,2024-10-11 19:00:00,0.67,1.02,0.86,178,160,200,39,15,24,48,26,22,17,8,9,0,0,0,65%,54%,74%,117,106,126,31%,29%,33%,5,3,2,5,3,2
402,https://vlr.gg/player/14386/isaa,2024-10-11 19:00:00,0.61,0.89,0.76,142,143,153,32,15,17,46,24,22,25,5,20,+1,-1,+2,71%,64%,76%,97,94,100,30%,23%,38%,3,0,3,2,1,1
403,https://vlr.gg/player/18728/yukine,2024-10-11 18:00:00,1.42,0.98,1.23,226,255,174,53,36,17,44,25,19,24,9,15,+2,0,+2,76%,75%,77%,150,165,130,24%,24%,24%,4,2,2,2,2,0
404,https://vlr.gg/player/39535/xander,2024-10-11 18:00:00,0.91,1.10,1.00,210,195,234,52,27,25,52,29,23,22,10,12,0,-1,+1,68%,63%,74%,138,123,157,38%,47%,30%,7,3,4,7,4,3
405,https://vlr.gg/player/29613/flashh,2024-10-11 18:00:00,0.99,0.97,0.97,208,234,194,57,33,24,53,31,22,9,5,4,-2,-1,-1,59%,55%,65%,140,145,134,25%,26%,24%,12,8,4,14,9,5
406,https://vlr.gg/player/41966/jar,2024-10-11 18:00:00,0.68,1.33,0.96,179,133,234,42,17,25,45,26,19,16,10,6,-7,-9,+2,61%,50%,74%,122,94,158,31%,33%,29%,4,0,4,11,9,2
407,https://vlr.gg/player/27991/wave,2024-10-11 18:00:00,0.73,0.73,0.73,146,144,174,35,19,16,55,31,24,28,12,16,-6,-1,-5,69%,65%,74%,103,87,125,27%,35%,22%,2,1,1,8,2,6
408,https://vlr.gg/player/16684/chqse,2024-10-11 18:00:00,1.37,1.03,1.18,269,293,230,63,32,31,49,21,28,16,7,9,-2,-1,-1,72%,71%,73%,171,189,156,21%,20%,23%,12,6,6,14,7,7
409,https://vlr.gg/player/27370/jerado,2024-10-11 18:00:00,1.10,1.13,1.12,210,215,209,55,26,29,47,21,26,21,6,15,+2,-1,+3,72%,71%,73%,131,133,130,25%,30%,22%,5,2,3,3,3,0
410,https://vlr.gg/player/38434/kace,2024-10-11 18:00:00,0.61,1.26,0.98,227,158,259,53,17,36,51,25,26,11,2,9,+6,-1,+7,68%,58%,75%,135,92,168,22%,14%,27%,15,4,11,9,5,4
411,https://vlr.gg/player/19271/foxzao,2024-10-11 18:00:00,1.07,0.86,0.95,171,181,177,43,19,24,47,19,28,29,12,17,+5,+2,+3,79%,81%,78%,117,115,118,30%,25%,33%,7,2,5,2,0,2
412,https://vlr.gg/player/47837/gio-2x,2024-10-11 18:00:00,0.66,1.07,0.89,132,108,160,35,13,22,45,21,24,26,7,19,+2,+2,0,70%,74%,68%,93,69,111,32%,37%,30%,3,2,1,1,0,1
413,https://vlr.gg/player/22997/waved,2024-10-11 16:00:00,1.05,1.27,1.16,230,205,259,61,27,34,53,28,25,16,6,10,+3,+2,+1,74%,68%,79%,166,150,182,35%,33%,37%,12,7,5,9,5,4
414,https://vlr.gg/player/27724/natasha,2024-10-11 16:00:00,1.06,1.14,1.10,214,217,214,57,28,29,49,27,22,15,5,10,-8,-4,-4,71%,61%,82%,158,170,147,31%,31%,30%,4,3,1,12,7,5
415,https://vlr.gg/player/11242/blu,2024-10-11 16:00:00,0.83,1.27,1.05,196,202,190,51,26,25,51,30,21,42,14,28,+3,0,+3,79%,74%,84%,122,126,118,26%,25%,26%,8,3,5,5,3,2
416,https://vlr.gg/player/9821/m4ndzin,2024-10-11 16:00:00,0.89,1.13,1.01,215,183,243,55,24,31,61,31,30,35,17,18,0,0,0,76%,76%,76%,138,112,164,24%,25%,23%,7,2,5,7,2,5
417,https://vlr.gg/player/11236/antg,2024-10-11 16:00:00,0.84,1.09,0.96,198,176,221,55,23,32,55,30,25,15,10,5,-6,-4,-2,71%,68%,74%,124,110,138,36%,30%,41%,3,1,2,9,5,4
418,https://vlr.gg/player/6994/shyz,2024-10-11 16:00:00,1.17,1.29,1.23,216,200,229,61,28,33,49,24,25,22,10,12,+3,+1,+2,78%,68%,87%,141,128,155,27%,25%,30%,3,1,2,0,0,0
419,https://vlr.gg/player/24764/akame,2024-10-11 16:00:00,0.89,1.16,1.01,222,212,236,56,26,30,56,31,25,36,20,16,+4,0,+4,76%,71%,82%,148,144,153,30%,27%,34%,9,2,7,5,2,3
420,https://vlr.gg/player/29179/vii,2024-10-11 16:00:00,1.02,0.99,1.00,246,271,223,61,32,29,64,34,30,15,7,8,+2,+1,+1,71%,68%,74%,156,173,138,27%,23%,32%,15,9,6,13,8,5
421,https://vlr.gg/player/14690/lissa,2024-10-11 16:00:00,0.80,1.01,0.90,205,198,215,54,26,28,56,31,25,20,5,15,+1,+2,-1,72%,71%,74%,129,121,137,33%,28%,38%,12,7,5,11,5,6
422,https://vlr.gg/player/24763/speedy,2024-10-11 16:00:00,0.42,1.20,0.81,152,103,202,37,11,26,54,31,23,40,14,26,-2,-2,0,71%,58%,84%,103,70,137,32%,24%,38%,3,1,2,5,3,2
423,https://vlr.gg/player/12928/veqaj,2024-10-11 14:55:00,1.14,1.59,1.33,266,235,311,63,30,33,45,29,16,13,7,6,+2,-3,+5,70%,61%,82%,181,160,209,17%,14%,21%,10,5,5,8,8,0
424,https://vlr.gg/player/11/zyppan,2024-10-11 14:55:00,0.70,1.37,0.98,205,157,284,48,20,28,53,34,19,24,15,9,+2,-1,+3,73%,66%,82%,138,106,182,35%,38%,33%,7,3,4,5,4,1
425,https://vlr.gg/player/24071/liza,2024-10-11 14:55:00,0.94,0.97,0.95,161,172,154,40,24,16,45,29,16,8,1,7,-4,-3,-1,62%,50%,79%,107,106,108,37%,41%,32%,3,3,0,7,6,1
426,https://vlr.gg/player/6889/neskaas,2024-10-11 14:55:00,0.58,1.27,0.87,181,154,249,43,19,24,49,34,15,17,9,8,+3,-3,+6,64%,55%,75%,131,110,160,29%,31%,27%,11,2,9,8,5,3
427,https://vlr.gg/player/38142/dream,2024-10-11 14:55:00,0.69,0.73,0.71,126,123,132,31,16,15,46,28,18,17,9,8,-3,-2,-1,65%,66%,64%,87,91,83,27%,30%,23%,2,0,2,5,2,3
428,https://vlr.gg/player/10307/marteen,2024-10-11 14:55:00,0.83,1.67,1.32,249,198,293,58,19,39,43,24,19,21,5,16,+6,-1,+7,77%,61%,89%,163,122,193,32%,27%,34%,9,1,8,3,2,1
429,https://vlr.gg/player/21216/f4ngeer,2024-10-11 14:55:00,1.16,1.36,1.28,298,258,320,69,25,44,46,22,24,9,3,6,+1,0,+1,70%,68%,71%,181,160,196,31%,33%,30%,11,5,6,10,5,5
430,https://vlr.gg/player/24439/yohpa,2024-10-11 14:55:00,0.79,1.21,1.05,156,110,181,22,6,16,19,10,9,9,2,7,0,-1,+1,74%,50%,88%,113,87,128,28%,30%,28%,2,0,2,2,1,1
431,https://vlr.gg/player/16321/nelo,2024-10-11 14:55:00,0.80,0.96,0.90,191,170,190,43,16,27,47,22,25,19,9,10,+1,-2,+3,74%,64%,82%,124,114,132,44%,49%,40%,7,1,6,6,3,3
432,https://vlr.gg/player/11183/glance,2024-10-11 14:55:00,0.73,0.69,0.71,122,157,111,29,15,14,46,25,21,18,5,13,-2,-1,-1,71%,61%,79%,94,107,84,38%,43%,33%,2,1,1,4,2,2
433,https://vlr.gg/player/21153/matrix,2024-10-11 14:55:00,0.14,1.08,0.61,168,79,259,17,3,14,24,13,11,3,3,0,-6,-7,+1,61%,57%,64%,126,63,190,31%,21%,38%,2,0,2,8,7,1
434,https://vlr.gg/player/12055/mmonch,2024-10-11 14:00:00,1.19,1.23,1.21,258,246,273,48,22,26,42,18,24,11,4,7,-3,0,-3,70%,63%,76%,174,172,176,40%,34%,44%,3,2,1,6,2,4
435,https://vlr.gg/player/20491/ivy,2024-10-11 14:00:00,0.79,0.67,0.72,155,151,152,30,14,16,44,20,24,8,5,3,-5,-2,-3,61%,59%,62%,101,104,99,40%,45%,36%,2,1,1,7,3,4
436,https://vlr.gg/player/20538/linlin,2024-10-11 14:00:00,0.65,0.76,0.70,146,118,177,30,13,17,49,22,27,15,6,9,+1,+1,0,61%,56%,66%,106,89,123,34%,39%,31%,4,2,2,3,1,2
437,https://vlr.gg/player/20537/andrehs,2024-10-11 14:00:00,0.74,0.53,0.63,136,125,151,25,11,14,46,20,26,14,9,5,+1,+1,0,52%,56%,48%,96,87,104,31%,31%,31%,4,2,2,3,1,2
438,https://vlr.gg/player/20539/juw,2024-10-11 14:00:00,0.81,0.42,0.59,166,236,135,33,21,12,51,23,28,11,6,5,-10,-5,-5,57%,63%,52%,124,148,102,25%,21%,30%,7,4,3,17,9,8
439,https://vlr.gg/player/25663/dods,2024-10-11 14:00:00,1.42,1.37,1.39,346,346,324,64,34,30,43,23,20,13,11,2,+9,+5,+4,77%,86%,67%,214,221,208,35%,40%,29%,17,11,6,8,6,2
440,https://vlr.gg/player/21558/micaela,2024-10-11 14:00:00,1.27,1.19,1.23,201,241,163,46,28,18,31,19,12,9,5,4,+4,+3,+1,77%,76%,78%,133,162,103,38%,44%,31%,4,3,1,0,0,0
441,https://vlr.gg/player/18982/romily,2024-10-11 14:00:00,1.42,0.98,1.21,221,231,198,48,28,20,30,12,18,11,6,5,+2,0,+2,82%,83%,81%,143,148,137,42%,47%,38%,4,0,4,2,0,2
442,https://vlr.gg/player/11235/biazik,2024-10-11 14:00:00,1.21,1.19,1.20,185,195,196,36,21,15,28,14,14,18,10,8,+3,+3,0,82%,76%,89%,133,131,135,28%,31%,23%,8,5,3,5,2,3
443,https://vlr.gg/player/11259/conir,2024-10-11 14:00:00,1.08,0.96,1.02,194,191,183,38,19,19,35,17,18,21,16,5,-2,0,-2,71%,83%,59%,120,126,112,26%,22%,31%,3,1,2,5,1,4
444,https://vlr.gg/player/4277/n-a-i-s,2024-10-11 14:00:00,1.04,1.69,1.37,258,223,294,42,17,25,25,15,10,9,5,4,+4,+2,+2,74%,76%,73%,179,170,187,39%,34%,45%,5,2,3,1,0,1
445,https://vlr.gg/player/1493/starkk,2024-10-11 14:00:00,1.23,1.31,1.27,195,210,182,32,16,16,23,12,11,23,12,11,+1,0,+1,84%,81%,86%,121,133,108,25%,32%,19%,2,0,2,1,0,1
446,https://vlr.gg/player/23347/alannn,2024-10-11 14:00:00,0.98,1.11,1.05,242,265,220,37,19,18,32,19,13,7,3,4,+3,+2,+1,74%,71%,77%,150,161,139,33%,45%,22%,11,6,5,8,4,4
447,https://vlr.gg/player/46436/sucette,2024-10-11 14:00:00,0.61,1.23,0.93,211,144,277,34,12,22,34,17,17,17,5,12,+1,0,+1,77%,71%,82%,140,85,193,35%,36%,34%,4,2,2,3,2,1
448,https://vlr.gg/player/24069/mochi,2024-10-11 14:00:00,0.52,1.14,0.84,167,159,174,25,12,13,28,17,11,6,2,4,+2,+3,-1,65%,57%,73%,116,105,126,30%,36%,25%,5,4,1,3,1,2
449,https://vlr.gg/player/24424/pa1ze,2024-10-11 14:00:00,0.63,2.29,1.44,325,197,461,48,13,35,34,20,14,8,5,3,+4,0,+4,72%,59%,86%,205,133,280,32%,25%,36%,10,4,6,6,4,2
450,https://vlr.gg/player/7460/6sonya,2024-10-11 14:00:00,1.05,0.76,0.91,165,179,152,26,16,10,34,17,17,12,1,11,-4,0,-4,63%,50%,76%,120,125,115,45%,54%,37%,1,1,0,5,1,4
451,https://vlr.gg/player/16417/klaudia,2024-10-11 14:00:00,0.81,0.86,0.84,168,184,149,24,13,11,34,19,15,15,6,9,-3,+1,-4,63%,64%,62%,116,125,107,37%,32%,44%,2,2,0,5,1,4
452,https://vlr.gg/player/28024/thander,2024-10-11 14:00:00,0.53,1.02,0.77,166,173,160,27,13,14,33,20,13,3,2,1,-5,-3,-2,60%,64%,57%,115,113,117,34%,54%,23%,3,2,1,8,5,3
453,https://vlr.gg/player/2570/roxie,2024-10-11 14:00:00,0.41,0.58,0.49,106,81,132,16,6,10,35,19,16,13,7,6,-3,-2,-1,67%,64%,71%,68,48,90,42%,31%,48%,0,0,0,3,2,1
454,https://vlr.gg/player/20761/looxie,2024-10-11 13:55:00,1.46,0.95,1.22,230,259,191,54,34,20,45,23,22,17,12,5,+2,0,+2,66%,72%,58%,152,168,134,41%,35%,54%,5,1,4,3,1,2
455,https://vlr.gg/player/15188/a1mly,2024-10-11 13:55:00,1.17,1.16,1.17,228,232,227,55,30,25,46,23,23,14,3,11,+4,+5,-1,69%,64%,74%,148,149,146,33%,32%,33%,10,9,1,6,4,2
456,https://vlr.gg/player/6126/sibeastw0w,2024-10-11 13:55:00,0.85,1.38,1.09,236,207,275,54,25,29,49,28,21,15,8,7,0,-6,+6,70%,61%,81%,153,139,170,21%,24%,19%,12,4,8,12,10,2
457,https://vlr.gg/player/21158/marti,2024-10-11 13:55:00,1.01,1.04,1.02,176,161,190,41,19,22,42,21,21,38,20,18,-7,-3,-4,76%,75%,77%,113,111,115,20%,18%,22%,1,0,1,8,3,5
458,https://vlr.gg/player/30186/nami,2024-10-11 13:55:00,0.80,0.74,0.77,157,163,149,34,18,16,49,26,23,28,15,13,-5,-2,-3,73%,69%,77%,97,96,97,37%,49%,29%,2,1,1,7,3,4
459,https://vlr.gg/player/7866/click,2024-10-11 13:55:00,1.27,0.93,1.09,279,310,251,63,34,29,55,26,29,14,8,6,+3,-1,+4,72%,77%,67%,177,196,162,35%,30%,39%,18,7,11,15,8,7
460,https://vlr.gg/player/448/meddo,2024-10-11 13:55:00,1.05,1.04,1.05,200,200,200,48,22,26,47,23,24,29,11,18,+1,+2,-1,75%,77%,72%,124,135,115,32%,27%,38%,4,3,1,3,1,2
461,https://vlr.gg/player/30241/majusia,2024-10-11 13:55:00,0.83,1.11,0.98,174,144,199,27,9,18,30,11,19,10,4,6,+3,0,+3,70%,68%,71%,126,109,140,27%,21%,33%,5,1,4,2,1,1
462,https://vlr.gg/player/7105/qpert,2024-10-11 13:55:00,1.07,0.79,0.92,167,215,132,42,25,17,44,22,22,21,10,11,-2,0,-2,72%,74%,69%,112,136,92,29%,33%,25%,3,2,1,5,2,3
463,https://vlr.gg/player/9434/samsi,2024-10-11 13:55:00,0.77,0.92,0.84,138,137,139,12,6,6,13,8,5,4,2,2,0,-1,+1,88%,83%,92%,91,96,86,22%,26%,17%,1,0,1,1,1,0
464,https://vlr.gg/player/45174/purity,2024-10-11 13:55:00,0.50,0.97,0.75,174,139,209,39,15,24,51,23,28,21,7,14,+1,+1,0,67%,65%,69%,115,91,137,25%,26%,24%,6,3,3,5,2,3
465,https://vlr.gg/player/4629/azury,2024-10-11 13:00:00,1.33,1.73,1.51,274,245,310,23,11,12,11,8,3,6,1,5,0,-1,+1,82%,67%,100%,182,165,202,52%,65%,44%,3,1,2,3,2,1
466,https://vlr.gg/player/4969/shazeon,2024-10-11 13:00:00,0.88,1.93,1.40,260,153,372,42,12,30,31,17,14,14,5,9,+5,-1,+6,71%,65%,77%,164,104,227,44%,46%,44%,7,1,6,2,2,0
467,https://vlr.gg/player/12528/disisjohn,2024-10-11 13:00:00,1.25,1.11,1.18,255,314,202,21,12,9,16,8,8,3,2,1,+1,-2,+3,74%,64%,83%,174,224,129,28%,38%,14%,6,3,3,5,5,0
468,https://vlr.gg/player/9508/leosen,2024-10-11 13:00:00,0.92,1.35,1.13,232,189,275,37,15,22,31,17,14,19,10,9,-1,-3,+2,76%,74%,77%,144,126,164,36%,34%,37%,6,1,5,7,4,3
469,https://vlr.gg/player/30750/enes,2024-10-11 13:00:00,1.30,0.86,1.09,157,220,90,24,18,6,24,15,9,19,8,11,0,+1,-1,84%,83%,86%,104,140,66,30%,35%,20%,2,2,0,2,1,1
470,https://vlr.gg/player/7865/xanarchy,2024-10-11 13:00:00,0.69,1.08,0.88,161,131,194,26,10,16,28,16,12,9,5,4,-2,-1,-1,76%,70%,82%,108,86,131,30%,40%,24%,0,0,0,2,1,1
471,https://vlr.gg/player/40587/nyshaa,2024-10-11 13:00:00,0.91,1.08,1.00,197,200,196,31,15,16,33,18,15,16,5,11,+1,0,+1,71%,68%,74%,121,126,117,32%,37%,28%,3,1,2,2,1,1
472,https://vlr.gg/player/28102/snabbi3,2024-10-11 13:00:00,0.55,1.10,0.83,200,166,233,32,13,19,34,19,15,5,1,4,+2,-1,+3,58%,50%,65%,119,99,138,21%,22%,21%,8,4,4,6,5,1
473,https://vlr.gg/player/27957/ike,2024-10-11 13:00:00,0.72,0.82,0.77,173,151,197,28,11,17,35,19,16,12,7,5,-1,-2,+1,62%,50%,74%,113,98,127,30%,32%,28%,3,0,3,4,2,2
474,https://vlr.gg/player/28344/spitzer,2024-10-11 13:00:00,0.55,0.86,0.71,167,117,217,26,10,16,39,20,19,10,3,7,-2,-4,+2,62%,59%,65%,107,77,136,13%,16%,12%,5,0,5,7,4,3
475,https://vlr.gg/player/28346/stolen,2024-10-11 13:00:00,0.36,0.96,0.66,137,136,137,23,10,13,32,20,12,5,2,3,-3,-3,0,53%,36%,70%,83,80,86,38%,32%,44%,2,1,1,5,4,1
476,https://vlr.gg/player/31569/cyan,2024-10-11 13:00:00,1.12,0.96,1.06,239,251,218,33,20,13,29,18,11,11,7,4,+1,+2,-1,72%,71%,73%,154,167,133,35%,35%,34%,3,2,1,2,0,2
477,https://vlr.gg/player/16141/sora,2024-10-11 13:00:00,0.81,1.12,0.93,215,197,238,28,15,13,31,20,11,6,4,2,-1,-2,+1,67%,67%,67%,128,124,133,14%,16%,8%,5,3,2,6,5,1
478,https://vlr.gg/player/41846/shiro,2024-10-11 13:00:00,0.68,1.12,0.85,197,187,269,28,15,13,32,20,12,6,2,4,+1,-3,+4,56%,50%,67%,139,124,162,20%,16%,24%,8,4,4,7,7,0
479,https://vlr.gg/player/29638/kotaro,2024-10-11 13:00:00,0.75,0.74,0.72,151,171,126,18,13,5,31,20,11,18,10,8,+1,+1,0,72%,79%,60%,99,107,86,25%,27%,21%,3,1,2,2,0,2
480,https://vlr.gg/player/29827/repteyy,2024-10-11 13:00:00,0.53,1.00,0.71,126,106,175,19,9,10,30,21,9,18,13,5,-1,0,-1,77%,71%,87%,83,55,129,18%,32%,12%,1,1,0,2,1,1
481,https://vlr.gg/player/13024/vuubit,2024-10-11 13:00:00,0.87,1.81,1.45,251,184,291,36,10,26,20,11,9,8,3,5,0,-1,+1,72%,67%,75%,175,120,209,41%,30%,45%,2,0,2,2,1,1
482,https://vlr.gg/player/29998/drastz,2024-10-11 13:00:00,1.25,1.34,1.30,233,223,226,33,13,20,23,9,14,16,4,12,-3,-1,-2,77%,60%,88%,141,132,147,26%,27%,25%,2,0,2,5,1,4
483,https://vlr.gg/player/8590/killdream,2024-10-11 13:00:00,1.36,1.03,1.16,219,271,180,31,15,16,27,11,16,17,4,13,-2,-1,-1,64%,60%,67%,150,154,148,26%,35%,20%,1,1,0,3,2,1
484,https://vlr.gg/player/4214/eso177,2024-10-11 13:00:00,0.78,1.33,1.12,215,160,244,29,8,21,24,11,13,8,2,6,+3,0,+3,77%,60%,88%,131,105,148,29%,50%,23%,6,2,4,3,2,1
485,https://vlr.gg/player/46179/davia,2024-10-11 13:00:00,0.69,0.78,0.75,178,170,182,24,8,16,32,12,20,3,2,1,+1,0,+1,62%,53%,67%,120,107,127,32%,23%,42%,8,3,5,7,3,4
486,https://vlr.gg/player/17323/mimi,2024-10-11 12:00:00,1.44,1.38,1.43,249,240,278,31,21,10,19,12,7,18,15,3,+2,+1,+1,94%,96%,89%,179,175,190,26%,22%,41%,2,1,1,0,0,0
487,https://vlr.gg/player/20064/vania,2024-10-11 12:00:00,1.35,1.51,1.39,181,179,187,23,17,6,13,9,4,16,10,6,+3,+2,+1,85%,88%,78%,126,124,133,46%,43%,54%,3,2,1,0,0,0
488,https://vlr.gg/player/3993/jawgemo,2024-10-11 12:00:00,1.52,0.96,1.37,272,286,234,34,26,8,23,15,8,9,6,3,-1,-1,0,82%,83%,78%,172,179,152,20%,23%,15%,4,3,1,5,4,1
489,https://vlr.gg/player/3885/valyn,2024-10-11 12:00:00,1.42,1.14,1.34,264,270,247,32,24,8,20,13,7,11,10,1,+3,+2,+1,82%,88%,67%,172,182,147,33%,33%,33%,6,4,2,3,2,1
490,https://vlr.gg/player/15500/trent,2024-10-11 12:00:00,1.32,0.77,1.17,211,242,127,24,20,4,18,12,6,14,11,3,0,0,0,82%,88%,67%,139,156,95,45%,47%,38%,5,4,1,5,4,1
491,https://vlr.gg/player/29873/benjyfishy,2024-10-11 12:00:00,1.31,0.81,0.95,204,289,173,25,10,15,26,7,19,2,1,1,-1,-1,0,67%,100%,54%,141,203,118,48%,61%,43%,5,0,5,6,1,5
492,https://vlr.gg/player/14612/lux9,2024-10-11 12:00:00,0.69,0.82,0.79,224,183,243,27,7,20,31,8,23,2,1,1,-2,-1,-1,55%,56%,54%,130,97,143,38%,40%,37%,2,0,2,4,1,3
493,https://vlr.gg/player/11322/sevire,2024-10-11 12:00:00,0.96,0.59,0.69,171,173,169,17,6,11,29,6,23,8,1,7,-2,0,-2,61%,78%,54%,124,126,123,21%,32%,18%,0,0,0,2,0,2
494,https://vlr.gg/player/43744/akita,2024-10-11 12:00:00,0.77,0.48,0.56,135,158,126,16,5,11,29,7,22,4,2,2,-2,-1,-1,52%,78%,42%,91,117,81,31%,42%,27%,4,2,2,6,3,3
495,https://vlr.gg/player/16078/loupiote,2024-10-11 12:00:00,0.48,0.24,0.31,100,154,80,8,4,4,29,8,21,7,3,4,0,0,0,48%,78%,38%,75,102,65,33%,43%,27%,2,1,1,2,1,1
496,https://vlr.gg/player/17343/ness,2024-10-11 12:00:00,1.23,1.24,1.24,222,219,223,49,24,25,39,20,19,24,12,12,-1,-1,0,71%,73%,69%,150,140,160,26%,31%,22%,2,1,1,3,2,1
497,https://vlr.gg/player/34684/westside,2024-10-11 12:00:00,0.95,1.49,1.23,241,204,277,54,22,32,43,24,19,19,11,8,+4,+2,+2,66%,57%,75%,157,124,187,45%,38%,51%,7,4,3,3,2,1
498,https://vlr.gg/player/1885/purp0,2024-10-11 12:00:00,1.07,1.22,1.15,215,191,235,50,22,28,42,20,22,12,9,3,+1,0,+1,68%,67%,69%,148,128,167,40%,36%,44%,8,2,6,7,2,5
499,https://vlr.gg/player/16418/smurfette,2024-10-11 12:00:00,0.70,0.76,0.73,198,189,210,39,18,21,55,27,28,23,8,15,-5,-4,-1,68%,60%,75%,133,123,143,27%,30%,25%,9,4,5,14,8,6
500,https://vlr.gg/player/24107/sarah,2024-10-11 12:00:00,0.73,0.56,0.64,136,139,136,31,14,17,45,22,23,11,9,2,-5,-3,-2,58%,60%,56%,86,93,80,35%,35%,34%,2,1,1,7,4,3
501,https://vlr.gg/player/20144/lewn,2024-10-11 12:00:00,0.95,1.47,1.20,274,230,317,61,25,36,47,26,21,10,5,5,-1,-1,0,65%,63%,67%,176,157,197,41%,45%,38%,11,5,6,12,6,6
502,https://vlr.gg/player/29442/wens,2024-10-11 12:00:00,1.23,1.09,1.16,217,229,196,49,28,21,40,23,17,12,3,9,+2,0,+2,74%,66%,83%,135,138,132,38%,48%,28%,4,1,3,2,1,1
503,https://vlr.gg/player/47911/berryx,2024-10-11 12:00:00,0.86,1.01,0.93,181,197,174,42,23,19,45,25,20,19,8,11,+3,+2,+1,77%,69%,87%,116,115,116,33%,33%,33%,5,3,2,2,1,1
504,https://vlr.gg/player/23049/alkyia,2024-10-11 12:00:00,0.81,0.98,0.89,199,201,202,43,22,21,47,26,21,8,4,4,+3,0,+3,74%,72%,77%,128,131,126,37%,40%,34%,11,6,5,8,6,2
505,https://vlr.gg/player/17332/jduh,2024-10-11 12:00:00,0.94,0.68,0.84,168,185,141,11,8,3,13,9,4,1,1,0,0,0,0,58%,50%,71%,123,142,92,41%,42%,38%,1,1,0,1,1,0
506,https://vlr.gg/player/19363/proxima,2024-10-11 12:00:00,0.56,0.86,0.72,126,80,174,18,5,13,31,14,17,19,8,11,-1,-1,0,65%,70%,61%,93,59,122,32%,33%,31%,2,0,2,3,1,2
0,https://vlr.gg/player/21302/dane,2024-10-11 12:00:00,1.03,1.01,1.02,208,204,212,34,16,18,38,17,21,24,13,11,+2,+2,0,64%,70%,58%,126,128,124,41%,37%,47%,6,3,3,4,1,3
1,https://vlr.gg/player/19366/lexa,2024-10-11 12:00:00,1.20,0.75,0.97,175,228,126,30,20,10,35,17,18,5,2,3,-1,+2,-3,66%,83%,50%,116,141,93,26%,27%,24%,3,3,0,4,1,3
2,https://vlr.gg/player/36070/zimo,2024-10-11 12:00:00,1.13,0.79,0.96,174,196,153,26,15,11,33,15,18,20,11,9,+1,+1,0,66%,74%,58%,120,135,107,27%,19%,43%,2,1,1,1,0,1
3,https://vlr.gg/player/24131/lexa,2024-10-11 12:00:00,1.40,0.49,0.94,171,229,115,29,19,10,33,14,19,9,7,2,-2,+2,-4,64%,83%,46%,111,146,77,30%,28%,38%,2,2,0,4,0,4
4,https://vlr.gg/player/11917/exit,2024-10-11 12:00:00,0.39,0.98,0.69,192,134,247,30,11,19,40,20,20,11,5,6,-5,-4,-1,60%,57%,63%,120,75,164,18%,17%,19%,8,4,4,13,8,5
5,https://vlr.gg/player/7987/kovaq,2024-10-11 12:00:00,1.24,1.79,1.51,342,283,408,60,26,34,34,17,17,8,5,3,+2,-1,+3,72%,71%,74%,223,178,269,32%,32%,33%,10,3,7,8,4,4
6,https://vlr.gg/player/37969/ellie,2024-10-11 12:00:00,0.94,1.23,1.08,210,207,210,36,18,18,29,17,12,6,4,2,+6,+4,+2,74%,71%,78%,132,130,135,40%,35%,43%,9,7,2,3,3,0
7,https://vlr.gg/player/20302/jini,2024-10-11 12:00:00,1.48,0.66,1.08,190,244,135,31,22,9,27,10,17,17,7,10,0,+3,-3,77%,75%,78%,123,144,101,15%,19%,12%,4,3,1,4,0,4
8,https://vlr.gg/player/7968/stavinci,2024-10-11 12:00:00,1.34,0.55,0.96,187,241,132,31,21,10,30,13,17,21,9,12,-2,+2,-4,70%,75%,65%,120,153,86,44%,41%,48%,2,2,0,4,0,4
9,https://vlr.gg/player/30042/harmonee,2024-10-11 12:00:00,0.88,0.79,0.83,148,119,178,21,9,12,29,11,18,12,4,8,-1,0,-1,77%,79%,74%,99,74,126,24%,22%,26%,1,1,0,2,1,1
10,https://vlr.gg/player/45138/aster,2024-10-11 11:00:00,0.78,1.16,0.98,234,190,274,35,14,21,36,17,19,14,5,9,-1,0,-1,64%,55%,73%,152,118,183,30%,41%,25%,4,3,1,5,3,2
11,https://vlr.gg/player/46181/nade,2024-10-11 11:00:00,0.71,1.09,0.91,185,146,218,29,11,18,35,17,18,2,0,2,-5,-4,-1,60%,50%,68%,118,90,143,30%,37%,26%,5,1,4,10,5,5
12,https://vlr.gg/player/5834/mikelelle,2024-10-11 11:00:00,1.10,0.61,0.84,172,224,125,25,15,10,36,17,19,21,12,9,-4,-1,-3,62%,75%,50%,111,137,87,28%,25%,32%,0,0,0,4,1,3
13,https://vlr.gg/player/6117/kayn,2024-10-11 11:00:00,0.79,0.71,0.75,168,198,146,23,13,10,37,18,19,16,7,9,-2,-1,-1,67%,60%,73%,109,127,93,21%,23%,18%,3,2,1,5,3,2
14,https://vlr.gg/player/3372/ori4k,2024-10-11 11:00:00,0.53,0.90,0.72,153,102,198,22,6,16,34,17,17,10,6,4,0,-2,+2,64%,60%,68%,99,73,121,31%,25%,34%,3,0,3,3,2,1
15,https://vlr.gg/player/2884/daniel0,2024-10-11 11:00:00,1.32,1.45,1.38,278,268,277,42,22,20,25,15,10,10,5,5,+8,+5,+3,81%,82%,80%,175,168,183,40%,42%,39%,12,6,6,4,1,3
16,https://vlr.gg/player/19588/neptuno,2024-10-11 11:00:00,1.25,1.38,1.31,264,260,274,39,20,19,27,14,13,13,6,7,+1,-1,+2,83%,77%,90%,188,167,210,27%,16%,40%,4,2,2,3,3,0
17,https://vlr.gg/player/17861/blastinho,2024-10-11 11:00:00,1.40,1.21,1.31,265,309,224,40,23,17,29,17,12,9,6,3,+3,+2,+1,79%,82%,75%,176,201,149,28%,39%,14%,6,5,1,3,3,0
18,https://vlr.gg/player/13430/krysys,2024-10-11 11:00:00,0.90,1.31,1.10,200,189,211,33,17,16,25,15,10,17,7,10,-1,-1,0,67%,59%,75%,127,131,122,27%,30%,23%,2,0,2,3,1,2
19,https://vlr.gg/player/8811/humanz,2024-10-11 11:00:00,0.73,0.76,0.74,143,120,171,24,10,14,28,14,14,9,6,3,+1,-1,+2,74%,64%,85%,99,94,105,34%,40%,29%,3,0,3,2,1,1
20,https://vlr.gg/player/31549/pando,2024-10-11 09:50:00,2.40,0.88,1.44,241,361,171,16,10,6,10,1,9,4,2,2,+4,+1,+3,68%,86%,58%,170,239,129,19%,18%,22%,4,1,3,0,0,0
21,https://vlr.gg/player/36645/tomatte,2024-10-11 09:50:00,1.03,1.31,1.21,191,182,196,14,5,9,10,4,6,3,1,2,-1,0,-1,68%,57%,75%,125,110,134,29%,23%,32%,1,1,0,2,1,1
22,https://vlr.gg/player/22314/mober,2024-10-11 09:50:00,0.99,1.28,1.17,191,174,201,14,5,9,10,3,7,4,0,4,+1,0,+1,84%,86%,83%,134,128,138,40%,33%,44%,2,0,2,1,0,1
23,https://vlr.gg/player/15473/yuno,2024-10-11 09:50:00,1.06,0.92,0.97,144,120,159,10,3,7,11,3,8,4,2,2,+3,+2,+1,79%,86%,75%,87,80,92,41%,50%,36%,3,2,1,0,0,0
24,https://vlr.gg/player/29958/ximy,2024-10-11 09:50:00,1.01,0.82,0.89,188,188,189,12,4,8,14,4,10,5,2,3,0,0,0,58%,71%,50%,128,123,131,18%,11%,25%,3,1,2,3,1,2
25,https://vlr.gg/player/32300/varuxx,2024-10-11 09:50:00,1.30,1.06,1.21,237,225,260,16,10,6,10,5,5,3,1,2,+2,0,+2,84%,75%,100%,139,133,151,43%,47%,38%,3,1,2,1,1,0
26,https://vlr.gg/player/46233/kz,2024-10-11 09:50:00,1.19,0.48,0.93,202,270,86,13,11,2,14,9,5,5,4,1,+1,+1,0,58%,58%,57%,124,162,58,15%,19%,6%,3,3,0,2,2,0
27,https://vlr.gg/player/36637/xpatrycksio,2024-10-11 09:50:00,0.92,0.89,0.91,186,186,186,13,8,5,13,8,5,4,4,0,-2,-1,-1,68%,75%,57%,122,122,124,26%,23%,33%,0,0,0,2,1,1
28,https://vlr.gg/player/33833/pepecho,2024-10-11 09:50:00,1.01,0.02,0.60,118,158,50,7,7,0,14,7,7,9,8,1,-3,-1,-2,58%,83%,14%,78,95,50,24%,22%,27%,0,0,0,3,1,2
29,https://vlr.gg/player/44130/bern1,2024-10-11 09:50:00,0.23,0.39,0.29,99,84,126,6,4,2,15,10,5,3,1,2,-5,-3,-2,47%,50%,43%,65,52,86,37%,50%,22%,0,0,0,5,3,2
30,https://vlr.gg/player/13221/azys,2024-10-11 09:15:00,1.27,1.64,1.49,287,262,303,45,17,28,24,12,12,12,3,9,+10,+4,+6,78%,76%,79%,171,152,185,34%,23%,44%,11,5,6,1,1,0
31,https://vlr.gg/player/12947/rawfiul,2024-10-11 09:15:00,1.39,1.26,1.32,249,267,238,39,17,22,23,9,14,8,2,6,+3,+2,+1,80%,82%,79%,153,162,147,35%,33%,37%,9,5,4,6,3,3
32,https://vlr.gg/player/3269/antidote,2024-10-11 09:15:00,1.04,1.16,1.11,208,205,211,30,12,18,25,10,15,16,7,9,0,0,0,80%,82%,79%,135,117,149,37%,41%,35%,3,1,2,3,1,2
33,https://vlr.gg/player/18704/levi,2024-10-11 09:15:00,1.29,0.96,1.10,158,160,157,22,11,11,21,7,14,17,4,13,-1,-1,0,90%,100%,83%,111,107,113,25%,40%,19%,1,0,1,2,1,1
34,https://vlr.gg/player/3628/deathmaker,2024-10-11 09:15:00,1.21,0.99,1.08,214,201,222,33,13,20,28,9,19,8,2,6,-1,0,-1,76%,71%,79%,146,135,154,36%,34%,37%,2,0,2,3,0,3
35,https://vlr.gg/player/14208/kishi,2024-10-11 09:15:00,1.23,0.81,1.05,184,221,132,27,19,8,30,18,12,14,10,4,-4,-2,-2,66%,71%,59%,113,131,87,30%,36%,21%,0,0,0,4,2,2
36,https://vlr.gg/player/30286/karam1l,2024-10-11 09:15:00,0.85,1.07,0.94,243,205,295,35,18,17,36,20,16,4,2,2,+2,+1,+1,68%,58%,82%,158,130,198,31%,30%,31%,8,4,4,6,3,3
37,https://vlr.gg/player/41834/panda,2024-10-11 09:15:00,0.79,0.69,0.75,156,163,146,23,13,10,33,19,14,10,5,5,-3,-1,-2,61%,54%,71%,107,112,100,43%,45%,40%,1,1,0,4,2,2
38,https://vlr.gg/player/23931/kata,2024-10-11 09:15:00,0.65,0.64,0.65,166,183,145,22,13,9,35,21,14,5,3,2,-1,0,-1,56%,58%,53%,115,128,96,33%,36%,29%,6,4,2,7,4,3
39,https://vlr.gg/player/4089/doxz3r,2024-10-11 09:15:00,0.59,0.36,0.50,124,152,85,14,11,3,35,21,14,12,6,6,-5,-4,-1,59%,54%,65%,101,117,78,26%,22%,31%,0,0,0,5,4,1
40,https://vlr.gg/player/48444/gonzalitos,2024-10-11 09:00:00,0.99,0.38,0.87,190,208,121,10,9,1,14,11,3,3,1,2,-1,-1,0,60%,58%,67%,124,137,74,26%,27%,20%,0,0,0,1,1,0
41,https://vlr.gg/player/22952/caim,2024-10-11 09:00:00,0.27,1.49,0.52,122,63,362,6,2,4,14,11,3,0,0,0,-2,-2,0,33%,25%,67%,87,53,222,23%,15%,33%,0,0,0,2,2,0
42,https://vlr.gg/player/41778/nexy,2024-10-11 09:00:00,0.39,0.51,0.41,114,103,158,5,3,2,14,12,2,3,3,0,-3,-1,-2,33%,33%,33%,88,84,105,19%,17%,25%,0,0,0,3,1,2
43,https://vlr.gg/player/3158/theozy,2024-10-11 09:00:00,0.45,0.02,0.32,92,110,25,4,4,0,14,11,3,2,1,1,+1,+1,0,33%,42%,,73,86,25,14%,15%,0%,1,1,0,0,0,0
44,https://vlr.gg/player/26792/hax,2024-10-11 09:00:00,0.06,0.39,0.13,83,79,102,4,3,1,15,12,3,1,0,1,-4,-5,+1,27%,17%,67%,46,40,71,67%,75%,50%,2,1,1,6,6,0
45,https://vlr.gg/player/29553/dagg3r,2024-10-11 09:00:00,1.57,2.50,2.31,375,211,417,23,3,20,1,0,1,7,0,7,+3,0,+3,93%,100%,92%,233,141,256,31%,25%,33%,3,0,3,0,0,0
46,https://vlr.gg/player/3784/katu,2024-10-11 09:00:00,0.52,1.63,1.41,228,162,246,14,2,12,7,3,4,3,0,3,+3,+1,+2,80%,67%,83%,161,102,176,32%,67%,25%,4,1,3,1,0,1
47,https://vlr.gg/player/2313/feqew,2024-10-11 09:00:00,0.45,1.62,1.38,237,96,273,12,1,11,7,2,5,4,1,3,0,-1,+1,100%,100%,100%,176,78,201,29%,20%,30%,2,0,2,2,1,1
48,https://vlr.gg/player/173/l0udly,2024-10-11 09:00:00,2.24,1.02,1.26,190,441,128,10,5,5,6,2,4,7,1,6,+1,+1,0,80%,100%,75%,144,295,106,36%,71%,24%,1,1,0,0,0,0
49,https://vlr.gg/player/5854/z3ro,2024-10-11 09:00:00,1.64,1.07,1.18,204,218,201,12,3,9,8,1,7,10,2,8,+2,0,+2,93%,100%,92%,152,206,139,26%,38%,23%,2,0,2,0,0,0
50,https://vlr.gg/player/48159/yyni,2024-10-11 07:15:00,,,,310,,,40,,,16,,,20,,,,,,,,,,,,,,,,,,,,
51,https://vlr.gg/player/48156/yumiiurx,2024-10-11 07:15:00,,,,261,,,36,,,30,,,4,,,,,,,,,,,,,,,,,,,,
52,https://vlr.gg/player/48158/xkb,2024-10-11 07:15:00,,,,251,,,35,,,21,,,19,,,,,,,,,,,,,,,,,,,,
53,https://vlr.gg/player/48157/kiaki,2024-10-11 07:15:00,,,,196,,,29,,,18,,,8,,,,,,,,,,,,,,,,,,,,
54,https://vlr.gg/player/39397/7wyy,2024-10-11 07:15:00,,,,168,,,20,,,21,,,26,,,,,,,,,,,,,,,,,,,,
55,https://vlr.gg/player/48139/amei,2024-10-11 07:15:00,,,,201,,,22,,,34,,,7,,,,,,,,,,,,,,,,,,,,
56,https://vlr.gg/player/17523/yue,2024-10-11 07:15:00,,,,198,,,27,,,30,,,2,,,,,,,,,,,,,,,,,,,,
57,https://vlr.gg/player/41210/yc33,2024-10-11 07:15:00,,,,166,,,21,,,30,,,7,,,,,,,,,,,,,,,,,,,,
58,https://vlr.gg/player/48140/yzy,2024-10-11 07:15:00,,,,144,,,22,,,32,,,6,,,,,,,,,,,,,,,,,,,,
59,https://vlr.gg/player/48473/xiaop,2024-10-11 07:15:00,,,,132,,,8,,,20,,,10,,,,,,,,,,,,,,,,,,,,
60,https://vlr.gg/player/41209/jacketzz,2024-10-11 07:15:00,,,,116,,,6,,,14,,,1,,,,,,,,,,,,,,,,,,,,
61,https://vlr.gg/player/27775/techno,2024-10-11 05:30:00,1.47,0.96,1.20,257,304,214,58,33,25,50,20,30,21,9,12,0,+2,-2,73%,84%,64%,169,203,140,29%,28%,30%,7,3,4,7,1,6
62,https://vlr.gg/player/3639/hoax,2024-10-11 05:30:00,1.07,1.13,1.10,191,179,207,44,18,26,44,19,25,26,15,11,-1,+1,-2,75%,74%,75%,121,111,130,27%,23%,30%,3,2,1,4,1,3
63,https://vlr.gg/player/3627/hellff,2024-10-11 05:30:00,0.95,1.01,0.98,193,195,188,45,22,23,45,21,24,18,7,11,-5,0,-5,75%,84%,67%,133,126,139,25%,29%,23%,4,4,0,9,4,5
64,https://vlr.gg/player/30693/makaveli,2024-10-11 05:30:00,0.94,0.92,0.93,191,187,199,46,22,24,51,21,30,21,8,13,-4,0,-4,70%,68%,72%,125,127,124,29%,30%,27%,8,4,4,12,4,8
65,https://vlr.gg/player/26376/deecee,2024-10-11 05:30:00,0.60,0.80,0.71,163,135,187,36,15,21,51,22,29,7,2,5,-1,0,-1,55%,58%,53%,117,96,135,32%,33%,31%,6,4,2,7,4,3
66,https://vlr.gg/player/44919/aplycs,2024-10-11 05:30:00,1.39,1.31,1.36,236,225,255,58,30,28,41,18,23,11,6,5,+1,+1,0,73%,72%,74%,163,166,158,34%,33%,36%,5,3,2,4,2,2
67,https://vlr.gg/player/18702/deadly10,2024-10-11 05:30:00,1.37,0.86,1.13,255,320,181,60,42,18,48,26,22,13,8,5,+2,+4,-2,61%,67%,55%,158,193,117,22%,23%,22%,14,9,5,12,5,7
68,https://vlr.gg/player/8156/mojo,2024-10-11 05:30:00,0.80,1.07,0.93,160,132,185,38,18,20,42,22,20,23,12,11,0,+1,-1,72%,75%,68%,105,92,121,24%,25%,22%,2,1,1,2,0,2
69,https://vlr.gg/player/43408/garv,2024-10-11 05:30:00,0.80,0.95,0.87,189,200,172,44,26,18,49,28,21,14,6,8,+4,+3,+1,69%,75%,61%,121,126,114,27%,23%,33%,10,6,4,6,3,3
70,https://vlr.gg/player/48426/ghostxd,2024-10-11 05:30:00,0.86,0.71,0.79,166,178,151,41,22,19,49,25,24,19,13,6,+4,+5,-1,69%,69%,68%,102,107,97,32%,31%,34%,8,6,2,4,1,3
71,https://vlr.gg/player/41175/m77,2024-10-11 05:00:00,,,,278,,,42,,,35,,,13,,,,,,,,,,,,,,,,,,,,
72,https://vlr.gg/player/30321/pochacco,2024-10-11 05:00:00,,,,252,,,41,,,31,,,14,,,,,,,,,,,,,,,,,,,,
73,https://vlr.gg/player/48138/end3,2024-10-11 05:00:00,,,,190,,,31,,,33,,,11,,,,,,,,,,,,,,,,,,,,
74,https://vlr.gg/player/41173/jianbao,2024-10-11 05:00:00,,,,176,,,29,,,26,,,22,,,,,,,,,,,,,,,,,,,,
75,https://vlr.gg/player/41171/qbb,2024-10-11 05:00:00,,,,152,,,25,,,30,,,15,,,,,,,,,,,,,,,,,,,,
76,https://vlr.gg/player/48223/xmeinn,2024-10-11 05:00:00,,,,236,,,43,,,31,,,7,,,,,,,,,,,,,,,,,,,,
77,https://vlr.gg/player/48224/peterpan,2024-10-11 05:00:00,,,,204,,,33,,,33,,,8,,,,,,,,,,,,,,,,,,,,
78,https://vlr.gg/player/48225/147,2024-10-11 05:00:00,,,,193,,,29,,,35,,,13,,,,,,,,,,,,,,,,,,,,
79,https://vlr.gg/player/48226/ayu,2024-10-11 05:00:00,,,,181,,,28,,,34,,,16,,,,,,,,,,,,,,,,,,,,
80,https://vlr.gg/player/41218/s1eeepy,2024-10-11 05:00:00,,,,165,,,22,,,35,,,22,,,,,,,,,,,,,,,,,,,,
81,https://vlr.gg/player/3784/katu,2024-10-10 15:00:00,1.13,1.21,1.14,241,227,328,11,9,2,12,10,2,1,1,0,+1,+1,0,57%,58%,50%,159,147,234,52%,48%,75%,3,3,0,2,2,0
82,https://vlr.gg/player/173/l0udly,2024-10-10 15:00:00,0.64,1.02,0.69,143,124,260,5,4,1,12,10,2,4,3,1,-2,-2,0,50%,50%,50%,102,81,228,36%,38%,33%,0,0,0,2,2,0
83,https://vlr.gg/player/2313/feqew,2024-10-10 15:00:00,0.58,0.24,0.53,133,134,131,6,5,1,13,11,2,1,1,0,0,0,0,43%,42%,50%,90,95,61,41%,38%,50%,2,1,1,2,1,1
84,https://vlr.gg/player/29553/dagg3r,2024-10-10 15:00:00,0.28,0.02,0.23,57,64,15,2,2,0,13,11,2,1,1,0,0,0,0,29%,33%,,40,44,15,60%,75%,0%,0,0,0,0,0,0
85,https://vlr.gg/player/5854/z3ro,2024-10-10 15:00:00,0.03,0.02,0.03,18,18,19,0,0,0,13,11,2,2,2,0,-3,-3,0,29%,33%,,17,16,19,25%,50%,0%,0,0,0,3,3,0
86,https://vlr.gg/player/1524/h1ber,2024-10-10 15:00:00,3.11,2.05,2.21,357,444,343,19,4,15,4,0,4,7,0,7,+3,0,+3,100%,100%,100%,223,222,223,26%,18%,28%,3,0,3,0,0,0
87,https://vlr.gg/player/402/insider,2024-10-10 15:00:00,1.62,1.70,1.69,297,321,293,17,3,14,5,1,4,3,0,3,+2,+1,+1,86%,100%,83%,181,160,185,53%,75%,50%,3,1,2,1,0,1
88,https://vlr.gg/player/1615/destrian,2024-10-10 15:00:00,1.84,1.24,1.33,194,176,198,9,1,8,4,0,4,7,2,5,0,0,0,93%,100%,92%,129,128,129,16%,0%,22%,1,0,1,1,0,1
89,https://vlr.gg/player/443/zeddy,2024-10-10 15:00:00,0.01,1.50,1.24,197,26,226,9,0,9,6,2,4,10,1,9,0,-1,+1,93%,50%,100%,133,26,151,24%,0%,25%,1,0,1,1,1,0
90,https://vlr.gg/player/252/d3ffo,2024-10-10 15:00:00,1.07,0.93,0.95,158,246,144,9,2,7,5,1,4,1,0,1,-1,0,-1,86%,100%,83%,104,148,97,19%,25%,17%,1,0,1,2,0,2
91,https://vlr.gg/player/21216/f4ngeer,2024-10-10 15:00:00,1.26,1.84,1.58,256,218,298,38,13,25,18,9,9,16,8,8,+5,0,+5,85%,83%,87%,167,152,178,31%,24%,37%,6,1,5,1,1,0
92,https://vlr.gg/player/24439/yohpa,2024-10-10 15:00:00,1.22,1.59,1.40,264,260,269,21,10,11,14,9,5,10,3,7,+1,0,+1,87%,92%,82%,165,166,164,40%,63%,28%,1,0,1,0,0,0
93,https://vlr.gg/player/10307/marteen,2024-10-10 15:00:00,1.00,1.61,1.34,293,215,334,42,15,27,29,13,16,8,2,6,-5,-4,-1,73%,67%,78%,178,133,214,24%,26%,24%,4,2,2,9,6,3
94,https://vlr.gg/player/21153/matrix,2024-10-10 15:00:00,1.76,0.60,0.99,210,353,139,14,8,6,13,3,10,1,1,0,+2,+2,0,72%,83%,67%,132,208,94,37%,31%,43%,4,3,1,2,1,1
95,https://vlr.gg/player/16321/nelo,2024-10-10 15:00:00,1.32,0.64,0.94,179,206,151,27,15,12,26,9,17,15,7,8,-5,-1,-4,71%,83%,61%,117,128,108,38%,52%,29%,2,0,2,7,1,6
96,https://vlr.gg/player/11183/glance,2024-10-10 15:00:00,0.92,0.92,0.92,135,173,114,18,10,8,23,12,11,23,10,13,+1,+1,0,85%,89%,83%,91,110,77,30%,33%,27%,3,2,1,2,1,1
97,https://vlr.gg/player/24424/pa1ze,2024-10-10 15:00:00,0.83,1.12,0.96,217,212,224,32,18,14,31,18,13,2,0,2,+5,+1,+4,59%,48%,72%,140,130,154,37%,39%,34%,11,7,4,6,6,0
98,https://vlr.gg/player/28024/thander,2024-10-10 15:00:00,1.02,0.80,0.92,198,204,211,29,16,13,33,17,16,8,4,4,+3,+1,+2,68%,74%,61%,136,129,145,39%,34%,47%,5,2,3,2,1,1
99,https://vlr.gg/player/16417/klaudia,2024-10-10 15:00:00,0.85,0.92,0.88,181,166,199,26,14,12,32,17,15,10,5,5,-1,0,-1,71%,74%,67%,126,106,152,33%,34%,31%,2,0,2,3,0,3
100,https://vlr.gg/player/2570/roxie,2024-10-10 15:00:00,0.73,0.69,0.71,157,166,144,23,13,10,33,18,15,9,7,2,-3,-2,-1,56%,61%,50%,105,112,95,31%,26%,39%,3,2,1,6,4,2
101,https://vlr.gg/player/7460/6sonya,2024-10-10 15:00:00,0.43,0.59,0.50,106,106,101,13,7,6,31,19,12,9,7,2,-3,-1,-2,63%,61%,67%,72,72,72,26%,35%,17%,0,0,0,3,1,2
102,https://vlr.gg/player/23049/alkyia,2024-10-10 14:15:00,1.72,1.34,1.48,299,367,243,42,20,22,27,12,15,4,3,1,+6,+1,+5,85%,87%,83%,207,271,167,35%,34%,36%,9,4,5,3,3,0
103,https://vlr.gg/player/20144/lewn,2024-10-10 14:15:00,1.19,1.43,1.32,286,236,318,60,23,37,44,20,24,10,3,7,+6,+2,+4,67%,67%,68%,197,160,226,40%,45%,37%,16,6,10,10,4,6
104,https://vlr.gg/player/19363/proxima,2024-10-10 14:15:00,1.11,1.10,1.10,183,182,182,29,15,14,30,16,14,18,12,6,+1,-1,+2,71%,65%,77%,126,133,119,36%,37%,36%,2,0,2,1,1,0
105,https://vlr.gg/player/29442/wens,2024-10-10 14:15:00,1.06,1.06,1.06,189,190,191,43,19,24,37,17,20,5,4,1,-1,+1,-2,64%,59%,68%,130,131,130,36%,32%,39%,5,3,2,6,2,4
106,https://vlr.gg/player/47911/berryx,2024-10-10 14:15:00,0.93,0.85,0.88,141,140,141,31,14,17,40,18,22,16,7,9,0,+1,-1,74%,70%,76%,98,102,94,36%,38%,35%,2,1,1,2,0,2
107,https://vlr.gg/player/17332/jduh,2024-10-10 14:15:00,0.56,0.82,0.71,130,119,133,17,7,10,26,13,13,7,3,4,-3,-1,-2,55%,50%,59%,92,83,97,50%,50%,50%,1,1,0,4,2,2
108,https://vlr.gg/player/5292/al0rante,2024-10-10 14:15:00,1.22,1.38,1.29,284,270,305,61,32,29,44,26,18,18,10,8,+3,+1,+2,66%,62%,70%,178,171,188,52%,53%,51%,7,4,3,4,3,1
109,https://vlr.gg/player/4244/yaboilewis,2024-10-10 14:15:00,1.00,1.08,1.03,244,228,267,53,27,26,46,26,20,7,6,1,+1,-2,+3,67%,62%,74%,155,144,169,41%,36%,49%,9,3,6,8,5,3
110,https://vlr.gg/player/20730/karina,2024-10-10 14:15:00,0.70,0.79,0.73,129,108,171,30,13,17,41,22,19,4,2,2,-1,+2,-3,59%,56%,63%,99,83,119,32%,25%,40%,2,2,0,3,0,3
111,https://vlr.gg/player/40177/leeni,2024-10-10 14:15:00,0.67,0.70,0.68,150,155,147,32,20,12,45,26,19,5,0,5,-6,-4,-2,59%,53%,67%,106,100,113,18%,17%,19%,6,4,2,12,8,4
112,https://vlr.gg/player/2052/kuba,2024-10-10 14:15:00,0.71,0.57,0.65,139,149,130,28,16,12,46,24,22,18,11,7,-6,-3,-3,61%,56%,67%,101,108,93,26%,24%,30%,2,1,1,8,4,4
113,https://vlr.gg/player/122/luckerrr,2024-10-10 14:15:00,0.98,1.16,1.06,219,206,240,32,15,17,32,17,15,10,6,4,+1,-3,+4,63%,58%,68%,137,138,136,32%,31%,32%,6,2,4,5,5,0
114,https://vlr.gg/player/7968/stavinci,2024-10-10 14:15:00,0.77,1.34,1.02,195,158,239,29,12,17,33,20,13,21,14,7,-4,-3,-1,65%,67%,63%,121,97,151,51%,48%,53%,3,2,1,7,5,2
115,https://vlr.gg/player/19373/ginger,2024-10-10 14:15:00,1.00,0.75,0.89,161,173,147,24,15,9,32,17,15,9,5,4,+1,+1,0,60%,63%,58%,105,113,96,24%,27%,21%,3,2,1,2,1,1
116,https://vlr.gg/player/7987/kovaq,2024-10-10 14:15:00,0.80,0.86,0.83,179,197,166,29,17,12,33,20,13,7,5,2,-2,-1,-1,56%,54%,58%,120,125,114,30%,27%,38%,5,2,3,7,3,4
117,https://vlr.gg/player/17318/blossi,2024-10-10 14:15:00,0.74,0.31,0.55,134,169,94,17,13,4,35,19,16,15,8,7,-5,-2,-3,63%,71%,53%,94,120,62,25%,27%,19%,0,0,0,5,2,3
118,https://vlr.gg/player/7866/click,2024-10-10 14:15:00,1.96,1.19,1.53,341,402,288,52,28,24,27,10,17,11,3,8,+2,+1,+1,72%,74%,71%,206,252,169,34%,44%,25%,11,5,6,9,4,5
119,https://vlr.gg/player/7105/qpert,2024-10-10 14:15:00,1.48,1.30,1.38,267,307,242,41,19,22,26,11,15,15,5,10,+3,0,+3,86%,95%,79%,168,195,146,32%,32%,33%,5,1,4,2,1,1
120,https://vlr.gg/player/45174/purity,2024-10-10 14:15:00,0.55,1.68,1.18,204,115,277,31,7,24,25,14,11,15,5,10,+2,+1,+1,74%,63%,83%,140,76,190,22%,16%,24%,6,4,2,4,3,1
121,https://vlr.gg/player/448/meddo,2024-10-10 14:15:00,0.73,1.26,1.03,180,130,207,28,9,19,24,12,12,12,7,5,+3,0,+3,74%,68%,79%,122,85,151,41%,56%,35%,3,0,3,0,0,0
122,https://vlr.gg/player/30241/majusia,2024-10-10 14:15:00,0.74,0.48,0.61,103,118,90,10,6,4,16,7,9,0,0,0,-1,-1,0,54%,50%,58%,69,82,55,26%,42%,13%,1,0,1,2,1,1
123,https://vlr.gg/player/9434/samsi,2024-10-10 14:15:00,0.69,0.34,0.47,67,115,40,3,3,0,13,5,8,4,1,3,0,0,0,74%,100%,58%,61,101,38,32%,63%,9%,0,0,0,0,0,0
124,https://vlr.gg/player/13430/krysys,2024-10-10 14:00:00,0.80,0.82,0.80,173,193,54,9,8,1,12,11,1,3,2,1,0,0,0,64%,67%,50%,107,117,44,40%,37%,100%,2,2,0,2,2,0
125,https://vlr.gg/player/17861/blastinho,2024-10-10 14:00:00,0.68,0.91,0.71,177,165,257,8,6,2,13,11,2,2,2,0,-2,-2,0,57%,58%,50%,114,107,158,35%,37%,25%,1,1,0,3,3,0
126,https://vlr.gg/player/2884/daniel0,2024-10-10 14:00:00,0.47,1.13,0.56,154,133,287,7,5,2,14,12,2,3,2,1,0,-1,+1,64%,58%,100%,107,96,174,31%,20%,67%,1,0,1,1,1,0
127,https://vlr.gg/player/8811/humanz,2024-10-10 14:00:00,0.28,0.85,0.36,148,128,271,6,4,2,14,12,2,1,1,0,0,0,0,50%,42%,100%,92,87,123,16%,20%,10%,0,0,0,0,0,0
128,https://vlr.gg/player/19588/neptuno,2024-10-10 14:00:00,0.12,0.01,0.04,46,52,15,1,1,0,13,11,2,2,2,0,-4,-3,-1,29%,33%,,40,44,15,14%,17%,0%,0,0,0,4,3,1
129,https://vlr.gg/player/42557/6ankai,2024-10-10 14:00:00,2.57,2.14,2.20,351,434,337,21,4,17,3,1,2,1,0,1,+4,0,+4,93%,100%,92%,222,263,216,16%,27%,14%,4,0,4,0,0,0
130,https://vlr.gg/player/33517/tripsy,2024-10-10 14:00:00,0.02,2.08,1.75,320,49,366,18,0,18,8,2,6,3,1,2,0,0,0,93%,50%,100%,211,49,238,57%,0%,65%,0,0,0,0,0,0
131,https://vlr.gg/player/10448/kozok,2024-10-10 14:00:00,1.30,1.40,1.39,200,150,209,10,1,9,6,1,5,12,1,11,+1,+1,0,93%,50%,100%,135,105,140,38%,100%,32%,2,1,1,1,0,1
132,https://vlr.gg/player/26789/pdr,2024-10-10 14:00:00,1.05,1.11,1.11,154,130,159,7,1,6,6,1,5,9,0,9,0,-1,+1,86%,50%,92%,106,104,106,29%,50%,25%,2,0,2,2,1,1
133,https://vlr.gg/player/16012/akira,2024-10-10 14:00:00,1.53,1.03,1.10,205,413,171,10,3,7,8,2,6,3,0,3,+1,0,+1,86%,100%,83%,151,245,136,24%,15%,31%,2,0,2,1,0,1
134,https://vlr.gg/player/29638/kotaro,2024-10-10 13:00:00,1.67,1.20,1.43,224,236,213,21,11,10,13,5,8,18,13,5,-1,-1,0,88%,92%,83%,141,151,132,32%,31%,33%,1,0,1,2,1,1
135,https://vlr.gg/player/31569/cyan,2024-10-10 13:00:00,1.33,1.23,1.28,278,257,300,22,11,11,18,8,10,9,3,6,0,-1,+1,79%,75%,83%,189,182,195,25%,14%,39%,2,0,2,2,1,1
136,https://vlr.gg/player/41846/shiro,2024-10-10 13:00:00,1.61,0.79,1.20,222,276,170,19,13,6,16,7,9,9,4,5,-3,-1,-2,75%,83%,67%,156,189,124,21%,20%,24%,1,1,0,4,2,2
137,https://vlr.gg/player/29994/xini,2024-10-10 13:00:00,0.97,0.67,0.82,216,221,212,18,10,8,20,9,11,6,3,3,+2,+2,0,67%,75%,58%,132,128,136,28%,28%,29%,6,4,2,4,2,2
138,https://vlr.gg/player/29827/repteyy,2024-10-10 13:00:00,0.66,0.76,0.71,125,121,130,11,5,6,17,9,8,11,7,4,+2,+1,+1,71%,75%,67%,75,61,88,32%,27%,36%,2,1,1,0,0,0
139,https://vlr.gg/player/22188/jimbk,2024-10-10 13:00:00,1.84,0.67,1.25,249,349,149,22,15,7,18,8,10,8,5,3,+1,+1,0,75%,75%,75%,167,227,106,38%,41%,31%,2,2,0,1,1,0
140,https://vlr.gg/player/16139/enrik,2024-10-10 13:00:00,1.23,0.98,1.11,183,155,212,16,7,9,17,7,10,10,7,3,0,0,0,79%,83%,75%,117,91,143,24%,28%,22%,1,0,1,1,0,1
141,https://vlr.gg/player/45143/francybald,2024-10-10 13:00:00,0.92,1.24,1.08,229,180,280,18,7,11,19,9,10,11,7,4,0,0,0,75%,83%,67%,146,118,174,39%,44%,36%,2,1,1,2,1,1
142,https://vlr.gg/player/33513/sihw,2024-10-10 13:00:00,0.84,0.65,0.74,152,149,157,12,7,5,18,8,10,6,1,5,+1,0,+1,79%,83%,75%,117,119,116,31%,44%,23%,2,1,1,1,1,0
143,https://vlr.gg/player/22291/razziss,2024-10-10 13:00:00,0.81,0.52,0.67,178,215,141,16,10,6,19,9,10,2,1,1,-2,-1,-1,54%,58%,50%,104,121,87,45%,38%,63%,5,2,3,7,3,4
144,https://vlr.gg/player/33731/stonezy,2024-10-10 12:00:00,0.95,0.96,0.96,241,259,231,17,7,10,16,5,11,0,0,0,-1,0,-1,63%,71%,58%,125,136,119,37%,46%,32%,3,2,1,4,2,2
145,https://vlr.gg/player/6547/1ce2k,2024-10-10 12:00:00,1.32,0.67,0.91,171,195,158,11,5,6,13,4,9,3,1,2,-1,0,-1,63%,57%,67%,124,150,110,42%,45%,38%,1,0,1,2,0,2
146,https://vlr.gg/player/2431/basya,2024-10-10 12:00:00,1.05,0.67,0.81,157,205,130,9,4,5,15,5,10,3,2,1,+1,0,+1,68%,71%,67%,109,140,90,38%,37%,38%,3,1,2,2,1,1
147,https://vlr.gg/player/4201/m4xikk,2024-10-10 12:00:00,0.45,0.88,0.72,140,91,170,9,2,7,13,5,8,7,1,6,-1,-1,0,53%,29%,67%,94,64,111,35%,14%,44%,1,0,1,2,1,1
148,https://vlr.gg/player/1347/ivan4ezz,2024-10-10 12:00:00,0.42,0.78,0.65,117,67,148,7,1,6,13,4,9,6,0,6,+1,0,+1,53%,43%,58%,83,58,98,33%,50%,29%,1,0,1,0,0,0
149,https://vlr.gg/player/15473/yuno,2024-10-10 12:00:00,1.71,1.66,1.69,218,226,206,17,11,6,6,4,2,7,3,4,+1,0,+1,89%,100%,71%,142,152,126,48%,63%,22%,1,0,1,0,0,0
150,https://vlr.gg/player/29958/ximy,2024-10-10 12:00:00,1.63,1.24,1.49,294,343,211,21,15,6,10,6,4,1,1,0,-1,-1,0,63%,67%,57%,202,233,148,45%,37%,75%,2,2,0,3,3,0
151,https://vlr.gg/player/22314/mober,2024-10-10 12:00:00,1.06,0.72,0.94,188,218,138,11,9,2,13,8,5,7,4,3,+1,+1,0,89%,92%,86%,135,156,98,34%,43%,18%,3,1,2,2,0,2
152,https://vlr.gg/player/36645/tomatte,2024-10-10 12:00:00,0.72,1.23,0.90,198,161,262,13,7,6,14,10,4,3,1,2,+1,0,+1,74%,67%,86%,118,97,154,45%,50%,41%,4,3,1,3,3,0
153,https://vlr.gg/player/31549/pando,2024-10-10 12:00:00,0.81,0.54,0.71,104,109,97,8,5,3,10,6,4,4,4,0,-1,0,-1,63%,75%,43%,81,87,71,43%,30%,75%,0,0,0,1,0,1
154,https://vlr.gg/player/14612/lux9,2024-10-10 12:00:00,1.25,1.68,1.41,335,287,381,66,36,30,42,26,16,9,4,5,+3,+3,0,74%,72%,77%,200,185,224,39%,37%,42%,13,10,3,10,7,3
155,https://vlr.gg/player/11322/sevire,2024-10-10 12:00:00,1.43,1.10,1.31,252,262,219,52,36,16,35,21,14,22,12,10,+5,+3,+2,86%,89%,82%,154,160,145,21%,18%,27%,9,4,5,4,1,3
156,https://vlr.gg/player/29873/benjyfishy,2024-10-10 12:00:00,1.21,1.18,1.20,198,202,202,45,29,16,34,21,13,13,11,2,0,-2,+2,84%,86%,82%,133,129,140,43%,41%,45%,5,2,3,5,4,1
157,https://vlr.gg/player/43744/akita,2024-10-10 12:00:00,0.98,1.10,1.03,177,201,150,37,23,14,35,24,11,20,13,7,+3,+3,0,78%,81%,73%,120,131,104,32%,30%,37%,5,4,1,2,1,1
158,https://vlr.gg/player/16078/loupiote,2024-10-10 12:00:00,0.91,0.81,0.87,135,150,108,27,18,9,32,21,11,18,14,4,-1,-3,+2,79%,81%,77%,98,112,77,29%,36%,15%,2,0,2,3,3,0
159,https://vlr.gg/player/1428/sheydos,2024-10-10 12:00:00,0.67,1.23,1.02,188,141,235,39,8,31,41,17,24,16,8,8,+1,-1,+2,74%,64%,81%,133,109,148,28%,16%,37%,6,1,5,5,2,3
160,https://vlr.gg/player/5550/grubinho,2024-10-10 12:00:00,1.08,1.02,1.02,216,193,234,44,16,28,46,16,30,12,3,9,+1,0,+1,71%,59%,78%,148,111,170,36%,34%,36%,5,1,4,4,1,3
161,https://vlr.gg/player/26698/lil-bob,2024-10-10 12:00:00,1.24,0.73,0.93,207,243,185,44,21,23,45,14,31,14,4,10,-5,-1,-4,64%,64%,64%,129,139,122,30%,38%,26%,1,0,1,6,1,5
162,https://vlr.gg/player/30105/ikyoo,2024-10-10 12:00:00,0.34,0.79,0.60,142,130,159,28,9,19,47,21,26,5,2,3,-6,-4,-2,64%,55%,69%,99,90,105,21%,28%,17%,8,4,4,14,8,6
163,https://vlr.gg/player/30060/alessia,2024-10-10 12:00:00,0.64,0.35,0.46,110,133,97,23,11,12,48,17,31,7,1,6,-1,0,-1,50%,55%,47%,75,82,71,25%,29%,22%,4,2,2,5,2,3
164,https://vlr.gg/player/12928/veqaj,2024-10-10 12:00:00,1.52,1.81,1.68,333,364,297,42,19,23,17,9,8,12,6,6,+4,+2,+2,79%,73%,84%,209,232,190,22%,22%,22%,8,3,5,4,1,3
165,https://vlr.gg/player/6889/neskaas,2024-10-10 12:00:00,1.92,1.45,1.66,308,289,319,38,18,20,17,5,12,11,5,6,+3,+2,+1,91%,100%,84%,196,191,200,21%,23%,19%,4,2,2,1,0,1
166,https://vlr.gg/player/11/zyppan,2024-10-10 12:00:00,1.57,0.91,1.20,242,307,204,28,16,12,22,8,14,17,8,9,+5,+4,+1,74%,73%,74%,183,222,152,32%,40%,25%,7,4,3,2,0,2
167,https://vlr.gg/player/38011/misa,2024-10-10 12:00:00,1.15,1.12,1.13,158,181,137,22,11,11,14,7,7,4,2,2,0,0,0,68%,60%,74%,96,104,89,34%,32%,36%,3,2,1,3,2,1
168,https://vlr.gg/player/38142/dream,2024-10-10 12:00:00,0.59,1.07,0.85,163,99,205,20,6,14,22,9,13,17,5,12,+2,+1,+1,79%,80%,79%,93,63,116,33%,25%,36%,2,1,1,0,0,0
169,https://vlr.gg/player/4277/n-a-i-s,2024-10-10 12:00:00,0.97,0.80,0.89,198,208,197,20,12,8,29,16,13,12,8,4,-5,-2,-3,65%,74%,53%,150,157,140,40%,43%,36%,0,0,0,5,2,3
170,https://vlr.gg/player/46436/sucette,2024-10-10 12:00:00,0.74,1.04,0.87,188,190,203,24,13,11,30,17,13,5,3,2,-4,-2,-2,59%,68%,47%,133,126,141,33%,34%,30%,2,1,1,6,3,3
171,https://vlr.gg/player/24069/mochi,2024-10-10 12:00:00,0.96,0.61,0.80,155,191,112,18,12,6,29,15,14,4,3,1,-1,0,-1,41%,53%,27%,95,118,65,19%,21%,15%,1,1,0,2,1,1
172,https://vlr.gg/player/1493/starkk,2024-10-10 12:00:00,0.62,0.27,0.47,116,121,114,14,9,5,31,16,15,10,7,3,-1,+1,-2,59%,68%,47%,71,68,75,17%,18%,16%,2,1,1,3,0,3
173,https://vlr.gg/player/23347/alannn,2024-10-10 12:00:00,0.50,0.41,0.45,139,136,148,16,8,8,31,16,15,7,6,1,-3,-2,-1,59%,63%,53%,86,88,83,35%,53%,20%,5,4,1,8,6,2
174,https://vlr.gg/player/6126/sibeastw0w,2024-10-10 12:00:00,1.68,1.78,1.73,353,362,341,56,25,31,26,14,12,6,3,3,+12,+5,+7,84%,80%,88%,215,215,214,27%,26%,28%,13,6,7,1,1,0
175,https://vlr.gg/player/21158/marti,2024-10-10 12:00:00,0.98,1.38,1.20,215,173,239,33,12,21,26,13,13,26,9,17,0,-3,+3,76%,70%,80%,134,109,154,35%,38%,33%,4,0,4,4,3,1
176,https://vlr.gg/player/20761/looxie,2024-10-10 12:00:00,0.94,1.15,1.06,197,184,212,32,13,19,31,16,15,13,4,9,+1,+1,0,76%,75%,76%,138,123,150,36%,33%,39%,5,2,3,4,1,3
177,https://vlr.gg/player/30186/nami,2024-10-10 12:00:00,1.08,0.93,1.00,189,158,206,29,11,18,29,12,17,21,13,8,-2,0,-2,76%,75%,76%,121,102,136,40%,61%,34%,3,1,2,5,1,4
178,https://vlr.gg/player/15188/a1mly,2024-10-10 12:00:00,0.78,1.04,0.92,178,164,190,28,12,16,31,15,16,14,2,12,0,-1,+1,67%,60%,72%,119,106,130,31%,22%,40%,3,2,1,3,3,0
179,https://vlr.gg/player/19366/lexa,2024-10-10 12:00:00,0.98,1.17,1.07,197,195,190,32,17,15,31,19,12,7,2,5,-2,-1,-1,60%,56%,65%,130,135,124,24%,27%,21%,0,0,0,2,1,1
180,https://vlr.gg/player/36070/zimo,2024-10-10 12:00:00,0.60,1.39,0.95,193,121,304,33,11,22,35,21,14,10,6,4,-3,-5,+2,76%,72%,80%,126,74,192,42%,35%,46%,2,0,2,5,5,0
181,https://vlr.gg/player/21302/dane,2024-10-10 12:00:00,0.86,0.72,0.80,208,201,207,28,15,13,37,21,16,18,12,6,-3,-3,0,60%,60%,60%,134,139,127,52%,61%,42%,5,2,3,8,5,3
182,https://vlr.gg/player/24131/lexa,2024-10-10 12:00:00,0.84,0.57,0.72,151,168,137,25,16,9,34,20,14,6,2,4,+1,-1,+2,60%,60%,60%,97,108,83,40%,34%,53%,4,1,3,3,2,1
183,https://vlr.gg/player/7285/rizon,2024-10-10 12:00:00,0.59,0.64,0.61,168,178,166,25,14,11,41,24,17,11,7,4,-4,+1,-5,58%,60%,55%,114,112,117,31%,29%,36%,6,5,1,10,4,6
184,https://vlr.gg/player/15304/xixi,2024-10-10 08:00:00,,,,300,,,35,,,19,,,8,,,,,,,,,,,,,,,,,,,,
185,https://vlr.gg/player/17526/clem,2024-10-10 08:00:00,,,,277,,,36,,,20,,,11,,,,,,,,,,,,,,,,,,,,
186,https://vlr.gg/player/15307/jue,2024-10-10 08:00:00,,,,227,,,26,,,18,,,19,,,,,,,,,,,,,,,,,,,,
187,https://vlr.gg/player/25489/chloe,2024-10-10 08:00:00,,,,192,,,22,,,17,,,14,,,,,,,,,,,,,,,,,,,,
188,https://vlr.gg/player/41164/ysy,2024-10-10 08:00:00,,,,188,,,25,,,14,,,5,,,,,,,,,,,,,,,,,,,,
189,https://vlr.gg/player/41209/jacketzz,2024-10-10 08:00:00,,,,252,,,18,,,15,,,2,,,,,,,,,,,,,,,,,,,,
190,https://vlr.gg/player/48139/amei,2024-10-10 08:00:00,,,,173,,,19,,,30,,,5,,,,,,,,,,,,,,,,,,,,
191,https://vlr.gg/player/17523/yue,2024-10-10 08:00:00,,,,170,,,18,,,27,,,2,,,,,,,,,,,,,,,,,,,,
192,https://vlr.gg/player/41210/yc33,2024-10-10 08:00:00,,,,125,,,12,,,27,,,12,,,,,,,,,,,,,,,,,,,,
193,https://vlr.gg/player/48140/yzy,2024-10-10 08:00:00,,,,124,,,15,,,31,,,8,,,,,,,,,,,,,,,,,,,,
194,https://vlr.gg/player/48473/xiaop,2024-10-10 08:00:00,,,,111,,,6,,,14,,,2,,,,,,,,,,,,,,,,,,,,
195,https://vlr.gg/player/22054/wave,2024-10-10 06:00:00,1.46,0.92,1.19,230,245,215,55,31,24,53,22,31,23,14,9,+1,-2,+3,66%,69%,63%,150,163,136,32%,41%,24%,5,1,4,4,3,1
196,https://vlr.gg/player/30575/r1sen,2024-10-10 06:00:00,1.01,0.95,0.98,192,208,178,46,24,22,50,26,24,21,13,8,-8,-4,-4,69%,71%,66%,132,139,126,40%,47%,34%,1,0,1,9,4,5
197,https://vlr.gg/player/43389/yash,2024-10-10 06:00:00,0.98,0.68,0.83,208,238,178,47,28,19,62,30,32,11,5,6,+2,+2,0,66%,66%,66%,134,145,123,34%,30%,40%,16,9,7,14,7,7
198,https://vlr.gg/player/27755/icarus,2024-10-10 06:00:00,0.95,0.71,0.83,154,174,137,40,22,18,49,23,26,8,4,4,-3,-3,0,60%,60%,60%,120,146,94,32%,32%,32%,3,2,1,6,5,1
199,https://vlr.gg/player/4085/near,2024-10-10 06:00:00,0.57,1.05,0.81,161,113,211,39,13,26,54,26,28,18,8,10,0,-2,+2,56%,49%,63%,112,78,147,29%,25%,32%,6,1,5,6,3,3
200,https://vlr.gg/player/44919/aplycs,2024-10-10 06:00:00,1.51,1.09,1.30,265,299,235,64,37,27,42,20,22,12,6,6,+2,-2,+4,74%,83%,66%,187,212,162,29%,33%,24%,6,2,4,4,4,0
201,https://vlr.gg/player/43408/garv,2024-10-10 06:00:00,1.11,1.12,1.11,210,215,207,55,29,26,45,23,22,19,8,11,0,0,0,77%,74%,80%,141,142,139,24%,24%,25%,4,2,2,4,2,2
202,https://vlr.gg/player/48426/ghostxd,2024-10-10 06:00:00,1.31,0.73,1.02,183,208,161,47,27,20,41,17,24,25,17,8,-3,-1,-2,74%,74%,74%,112,126,98,28%,28%,28%,6,1,5,9,2,7
203,https://vlr.gg/player/8156/mojo,2024-10-10 06:00:00,1.09,0.92,1.01,171,157,184,42,21,21,46,20,26,39,21,18,+2,-2,+4,80%,83%,77%,102,91,113,19%,25%,15%,5,1,4,3,3,0
204,https://vlr.gg/player/18702/deadly10,2024-10-10 06:00:00,0.76,1.27,1.01,251,230,271,60,27,33,53,29,24,18,9,9,+7,+4,+3,79%,77%,80%,159,144,173,18%,16%,22%,18,11,7,11,7,4
205,https://vlr.gg/player/48207/elina,2024-10-10 05:00:00,,,,261,,,54,,,44,,,14,,,,,,,,,,,,,,,,,,,,
206,https://vlr.gg/player/48205/x1aowen,2024-10-10 05:00:00,,,,227,,,46,,,43,,,16,,,,,,,,,,,,,,,,,,,,
207,https://vlr.gg/player/25443/bambi,2024-10-10 05:00:00,,,,213,,,39,,,45,,,24,,,,,,,,,,,,,,,,,,,,
208,https://vlr.gg/player/48206/7er,2024-10-10 05:00:00,,,,191,,,41,,,38,,,16,,,,,,,,,,,,,,,,,,,,
209,https://vlr.gg/player/17447/alyssa,2024-10-10 05:00:00,,,,172,,,38,,,36,,,13,,,,,,,,,,,,,,,,,,,,
210,https://vlr.gg/player/48158/xkb,2024-10-10 05:00:00,,,,238,,,50,,,40,,,19,,,,,,,,,,,,,,,,,,,,
211,https://vlr.gg/player/48156/yumiiurx,2024-10-10 05:00:00,,,,214,,,43,,,48,,,10,,,,,,,,,,,,,,,,,,,,
212,https://vlr.gg/player/48159/yyni,2024-10-10 05:00:00,,,,205,,,46,,,41,,,19,,,,,,,,,,,,,,,,,,,,
213,https://vlr.gg/player/39397/7wyy,2024-10-10 05:00:00,,,,177,,,38,,,43,,,33,,,,,,,,,,,,,,,,,,,,
214,https://vlr.gg/player/48157/kiaki,2024-10-10 05:00:00,,,,145,,,29,,,46,,,12,,,,,,,,,,,,,,,,,,,,
215,https://vlr.gg/player/4004/zekken,2024-10-09 20:30:00,1.51,1.40,1.46,289,312,264,62,32,30,35,19,16,18,12,6,+10,+8,+2,88%,96%,79%,183,186,180,31%,24%,42%,15,9,6,5,1,4
216,https://vlr.gg/player/3880/bang,2024-10-09 20:30:00,1.24,1.34,1.29,224,217,227,47,25,22,31,15,16,24,6,18,+6,+3,+3,82%,79%,86%,146,146,146,33%,40%,26%,7,4,3,1,1,0
217,https://vlr.gg/player/36245/n4rrate,2024-10-09 20:30:00,1.39,1.19,1.29,260,295,230,53,30,23,37,18,19,18,8,10,+5,+2,+3,77%,79%,76%,172,190,155,22%,19%,26%,11,5,6,6,3,3
218,https://vlr.gg/player/1265/johnqt,2024-10-09 20:30:00,1.13,1.29,1.21,201,196,204,39,18,21,26,14,12,23,13,10,-1,0,-1,81%,82%,79%,142,135,149,28%,33%,24%,2,1,1,3,1,2
219,https://vlr.gg/player/729/zellsis,2024-10-09 20:30:00,0.87,1.16,1.02,182,140,218,36,14,22,35,17,18,34,18,16,-1,-1,0,81%,82%,79%,115,81,149,17%,15%,19%,3,1,2,4,2,2
220,https://vlr.gg/player/9/tenz,2024-10-09 20:30:00,0.79,1.21,0.99,197,153,255,39,14,25,46,23,23,18,11,7,+2,+1,+1,58%,52%,64%,146,115,177,36%,27%,43%,4,3,1,2,2,0
221,https://vlr.gg/player/26171/demon1,2024-10-09 20:30:00,1.14,0.78,0.96,208,231,184,43,25,18,50,24,26,16,6,10,-3,-2,-1,72%,66%,79%,139,149,128,37%,40%,35%,3,1,2,6,3,3
222,https://vlr.gg/player/619/c0m,2024-10-09 20:30:00,0.88,0.72,0.80,169,175,158,33,18,15,46,22,24,7,4,3,-2,+1,-3,54%,59%,50%,118,124,112,29%,22%,37%,2,2,0,4,1,3
223,https://vlr.gg/player/31376/tarik,2024-10-09 20:30:00,0.40,0.79,0.59,156,130,185,29,13,16,50,26,24,9,4,5,-11,-4,-7,49%,55%,43%,106,93,119,26%,26%,26%,5,2,3,16,6,10
224,https://vlr.gg/player/604/boostio,2024-10-09 20:30:00,0.50,0.39,0.45,112,129,96,20,11,9,45,23,22,6,3,3,-5,-3,-2,51%,52%,50%,70,85,55,22%,26%,17%,5,3,2,10,6,4
225,https://vlr.gg/player/2879/dimaxx,2024-10-09 15:00:00,1.40,1.14,1.28,233,269,194,21,12,9,15,8,7,7,2,5,+2,+2,0,83%,75%,91%,138,155,120,39%,68%,16%,2,2,0,0,0,0
226,https://vlr.gg/player/7258/nask,2024-10-09 15:00:00,1.43,1.06,1.25,246,238,255,19,10,9,17,7,10,6,2,4,+2,+1,+1,70%,67%,73%,164,157,171,37%,53%,25%,3,1,2,1,0,1
227,https://vlr.gg/player/29996/stepa,2024-10-09 15:00:00,0.24,1.31,0.75,210,115,315,15,4,11,21,11,10,6,2,4,-1,-3,+2,78%,58%,100%,140,80,205,26%,36%,23%,4,1,3,5,4,1
228,https://vlr.gg/player/2880/rlzy,2024-10-09 15:00:00,0.65,0.83,0.74,128,108,151,10,4,6,17,9,8,12,7,5,-3,-2,-1,70%,75%,64%,84,67,104,48%,56%,43%,0,0,0,3,2,1
229,https://vlr.gg/player/39564/slaxx,2024-10-09 15:00:00,0.33,0.71,0.51,106,74,141,9,3,6,18,9,9,3,0,3,-3,-2,-1,61%,50%,73%,75,48,104,27%,8%,41%,1,0,1,4,2,2
230,https://vlr.gg/player/41846/shiro,2024-10-09 15:00:00,1.69,1.12,1.39,262,297,231,23,13,10,14,7,7,6,5,1,+3,0,+3,78%,73%,83%,190,238,147,43%,30%,68%,4,1,3,1,1,0
231,https://vlr.gg/player/29638/kotaro,2024-10-09 15:00:00,0.96,1.54,1.27,244,216,270,21,8,13,16,9,7,8,6,2,-1,-1,0,78%,82%,75%,168,139,194,42%,44%,41%,1,0,1,2,1,1
232,https://vlr.gg/player/16141/sora,2024-10-09 15:00:00,1.02,0.98,1.00,208,263,159,17,10,7,15,9,6,2,2,0,-1,0,-1,65%,64%,67%,122,167,80,26%,29%,21%,5,3,2,6,3,3
233,https://vlr.gg/player/31569/cyan,2024-10-09 15:00:00,0.72,1.24,0.99,165,129,199,15,6,9,13,8,5,7,2,5,+1,0,+1,74%,55%,92%,114,82,144,28%,29%,27%,2,1,1,1,1,0
234,https://vlr.gg/player/29827/repteyy,2024-10-09 15:00:00,0.88,0.89,0.89,156,156,158,12,7,5,16,8,8,11,4,7,+1,0,+1,87%,82%,92%,104,114,94,24%,25%,22%,1,0,1,0,0,0
235,https://vlr.gg/player/3784/katu,2024-10-09 14:00:00,1.35,1.82,1.68,298,156,358,20,4,16,7,2,5,0,0,0,+5,-1,+6,88%,80%,92%,184,142,202,38%,57%,29%,6,0,6,1,1,0
236,https://vlr.gg/player/5854/z3ro,2024-10-09 14:00:00,1.40,1.76,1.65,293,247,313,19,4,15,10,3,7,9,2,7,+5,+2,+3,94%,80%,100%,170,139,183,27%,57%,21%,5,2,3,0,0,0
237,https://vlr.gg/player/2313/feqew,2024-10-09 14:00:00,1.42,1.06,1.17,197,282,163,11,5,6,9,3,6,4,1,3,0,+1,-1,88%,100%,83%,154,186,140,24%,36%,19%,1,1,0,1,0,1
238,https://vlr.gg/player/29553/dagg3r,2024-10-09 14:00:00,1.44,1.02,1.15,192,291,152,12,6,6,9,3,6,10,0,10,0,+1,-1,71%,60%,75%,130,158,119,38%,50%,31%,1,1,0,1,0,1
239,https://vlr.gg/player/173/l0udly,2024-10-09 14:00:00,0.50,1.27,1.05,192,71,243,11,1,10,9,3,6,6,2,4,-1,0,-1,71%,60%,75%,132,46,168,25%,0%,32%,0,0,0,1,0,1
240,https://vlr.gg/player/6117/kayn,2024-10-09 14:00:00,1.23,0.31,0.96,167,205,78,10,9,1,13,9,4,3,2,1,-2,-1,-1,47%,50%,40%,123,142,77,26%,32%,10%,0,0,0,2,1,1
241,https://vlr.gg/player/46181/nade,2024-10-09 14:00:00,0.97,0.41,0.80,198,223,140,12,9,3,15,11,4,2,1,1,-1,+1,-2,76%,75%,80%,135,138,129,42%,45%,33%,2,2,0,3,1,2
242,https://vlr.gg/player/45138/aster,2024-10-09 14:00:00,0.49,0.98,0.64,144,126,188,9,5,4,15,11,4,2,2,0,0,0,0,35%,33%,40%,87,86,90,35%,42%,25%,2,1,1,2,1,1
243,https://vlr.gg/player/3372/ori4k,2024-10-09 14:00:00,0.46,0.79,0.56,146,108,237,9,5,4,13,10,3,2,1,1,-2,-2,0,59%,50%,80%,98,79,142,38%,64%,15%,0,0,0,2,2,0
244,https://vlr.gg/player/5834/mikelelle,2024-10-09 14:00:00,0.03,0.36,0.09,77,55,130,4,2,2,17,12,5,5,4,1,-4,-4,0,53%,50%,60%,53,41,84,38%,29%,50%,0,0,0,4,4,0
245,https://vlr.gg/player/36645/tomatte,2024-10-09 12:55:00,0.90,1.38,1.16,183,177,188,15,7,8,12,8,4,7,1,6,-1,-1,0,77%,60%,92%,131,130,131,36%,31%,40%,2,1,1,3,2,1
246,https://vlr.gg/player/15473/yuno,2024-10-09 12:55:00,0.94,1.08,1.02,217,236,201,16,8,8,15,9,6,7,3,4,0,+1,-1,77%,70%,83%,144,154,135,28%,39%,21%,2,1,1,2,0,2
247,https://vlr.gg/player/29958/ximy,2024-10-09 12:55:00,0.57,1.33,0.99,238,206,266,18,7,11,18,10,8,4,0,4,-1,-2,+1,64%,50%,75%,168,144,188,26%,35%,21%,2,0,2,3,2,1
248,https://vlr.gg/player/22314/mober,2024-10-09 12:55:00,0.45,1.22,0.87,182,108,244,13,3,10,15,8,7,7,4,3,+1,-1,+2,64%,80%,50%,121,71,163,43%,27%,53%,3,0,3,2,1,1
249,https://vlr.gg/player/31549/pando,2024-10-09 12:55:00,0.21,1.16,0.73,146,100,185,11,4,7,16,10,6,3,0,3,-1,-1,0,68%,40%,92%,109,79,135,31%,44%,25%,1,1,0,2,2,0
250,https://vlr.gg/player/22291/razziss,2024-10-09 12:55:00,1.10,1.99,1.50,286,222,364,23,9,14,13,8,5,2,0,2,+3,0,+3,77%,67%,90%,175,137,220,26%,36%,15%,7,3,4,4,3,1
251,https://vlr.gg/player/16139/enrik,2024-10-09 12:55:00,0.62,1.68,1.10,205,140,284,15,5,10,15,10,5,8,2,6,0,0,0,68%,50%,90%,140,96,193,30%,26%,33%,1,1,0,1,1,0
252,https://vlr.gg/player/45143/francybald,2024-10-09 12:55:00,0.55,1.40,0.94,170,144,202,13,5,8,15,9,6,7,4,3,0,-1,+1,73%,58%,90%,121,102,143,37%,32%,44%,2,0,2,2,1,1
253,https://vlr.gg/player/22188/jimbk,2024-10-09 12:55:00,0.65,1.15,0.87,153,111,206,13,5,8,15,9,6,6,2,4,0,0,0,59%,42%,80%,111,90,136,32%,25%,44%,1,0,1,1,0,1
254,https://vlr.gg/player/33513/sihw,2024-10-09 12:55:00,0.77,0.70,0.74,150,168,129,12,7,5,15,8,7,3,1,2,-1,-1,0,68%,58%,80%,98,98,97,64%,64%,64%,1,1,0,2,2,0
255,https://vlr.gg/player/42521/jahbu,2024-10-09 12:00:00,1.40,1.55,1.50,292,269,304,20,6,14,11,3,8,3,1,2,+5,0,+5,89%,67%,100%,191,191,191,33%,50%,28%,6,1,5,1,1,0
256,https://vlr.gg/player/15383/khorror,2024-10-09 12:00:00,0.71,1.84,1.46,242,79,323,17,2,15,9,3,6,6,1,5,0,-1,+1,83%,67%,92%,154,48,207,29%,20%,31%,1,0,1,1,1,0
257,https://vlr.gg/player/4951/hardy,2024-10-09 12:00:00,0.90,1.52,1.31,249,179,284,14,3,11,12,5,7,13,2,11,+2,0,+2,83%,67%,92%,186,176,190,26%,14%,38%,2,0,2,0,0,0
258,https://vlr.gg/player/23090/krystal,2024-10-09 12:00:00,2.02,0.44,0.97,198,365,115,12,8,4,12,3,9,4,1,3,-2,+1,-3,67%,67%,67%,127,194,94,23%,21%,27%,1,1,0,3,0,3
259,https://vlr.gg/player/29974/erizillo,2024-10-09 12:00:00,0.52,1.03,0.86,157,156,158,11,3,8,12,6,6,8,3,5,+3,+2,+1,78%,67%,83%,94,79,102,31%,38%,28%,3,2,1,0,0,0
260,https://vlr.gg/player/32300/varuxx,2024-10-09 12:00:00,0.96,1.39,1.10,228,201,284,14,8,6,14,10,4,4,2,2,-2,-1,-1,89%,92%,83%,158,156,163,35%,36%,33%,0,0,0,2,1,1
261,https://vlr.gg/player/33833/pepecho,2024-10-09 12:00:00,1.21,0.80,1.07,217,231,190,15,10,5,13,9,4,2,2,0,-1,0,-1,72%,75%,67%,148,151,143,63%,56%,75%,1,1,0,2,1,1
262,https://vlr.gg/player/46233/kz,2024-10-09 12:00:00,0.76,0.82,0.78,197,208,178,12,9,3,15,11,4,3,3,0,-3,-3,0,56%,50%,67%,114,108,124,14%,13%,15%,2,1,1,5,4,1
263,https://vlr.gg/player/36637/xpatrycksio,2024-10-09 12:00:00,0.49,1.02,0.67,159,136,209,8,4,4,17,12,5,12,6,6,-3,-2,-1,83%,75%,100%,105,89,137,23%,24%,21%,1,1,0,4,3,1
264,https://vlr.gg/player/44130/bern1,2024-10-09 12:00:00,0.48,0.63,0.53,130,128,136,7,5,2,15,10,5,5,3,2,+1,0,+1,72%,67%,83%,93,87,106,32%,38%,25%,1,0,1,0,0,0
265,https://vlr.gg/player/13232/muffyn,2024-10-09 08:00:00,,,,283,,,38,,,27,,,12,,,,,,,,,,,,,,,,,,,,
266,https://vlr.gg/player/25415/yusin,2024-10-09 08:00:00,,,,274,,,40,,,22,,,19,,,,,,,,,,,,,,,,,,,,
267,https://vlr.gg/player/48160/laiyin,2024-10-09 08:00:00,,,,247,,,35,,,26,,,16,,,,,,,,,,,,,,,,,,,,
268,https://vlr.gg/player/48161/1hp,2024-10-09 08:00:00,,,,171,,,22,,,29,,,17,,,,,,,,,,,,,,,,,,,,
269,https://vlr.gg/player/1909/jinny,2024-10-09 08:00:00,,,,160,,,23,,,20,,,27,,,,,,,,,,,,,,,,,,,,
270,https://vlr.gg/player/41218/s1eeepy,2024-10-09 08:00:00,,,,258,,,35,,,29,,,17,,,,,,,,,,,,,,,,,,,,
271,https://vlr.gg/player/48226/ayu,2024-10-09 08:00:00,,,,240,,,34,,,28,,,4,,,,,,,,,,,,,,,,,,,,
272,https://vlr.gg/player/48224/peterpan,2024-10-09 08:00:00,,,,202,,,27,,,34,,,5,,,,,,,,,,,,,,,,,,,,
273,https://vlr.gg/player/48223/xmeinn,2024-10-09 08:00:00,,,,156,,,18,,,34,,,13,,,,,,,,,,,,,,,,,,,,
274,https://vlr.gg/player/48225/147,2024-10-09 08:00:00,,,,93,,,10,,,33,,,18,,,,,,,,,,,,,,,,,,,,
275,https://vlr.gg/player/5009/wstvirginia,2024-10-09 06:00:00,0.87,1.34,1.08,235,202,278,59,27,32,55,31,24,16,7,9,+3,+3,0,73%,68%,78%,156,139,177,42%,36%,48%,7,5,2,4,2,2
276,https://vlr.gg/player/31355/acestarrrrr,2024-10-09 06:00:00,1.13,0.73,0.95,204,225,173,50,32,18,53,28,25,20,13,7,-6,-3,-3,67%,76%,56%,131,141,119,38%,39%,38%,3,1,2,9,4,5
277,https://vlr.gg/player/45484/max,2024-10-09 06:00:00,0.75,1.07,0.90,164,152,188,40,19,21,48,27,21,16,8,8,-1,-2,+1,71%,74%,69%,114,108,123,28%,20%,40%,4,1,3,5,3,2
278,https://vlr.gg/player/43390/d1sease,2024-10-09 06:00:00,0.96,0.51,0.75,129,173,82,34,25,9,50,27,23,23,15,8,-6,-4,-2,64%,71%,56%,83,111,50,20%,18%,26%,2,1,1,8,5,3
279,https://vlr.gg/player/46104/envy2k,2024-10-09 06:00:00,0.69,0.72,0.70,193,197,185,44,25,19,58,32,26,10,7,3,-4,-6,+2,57%,61%,53%,121,127,115,19%,18%,21%,12,5,7,16,11,5
280,https://vlr.gg/player/30286/karam1l,2024-10-09 06:00:00,1.13,1.46,1.31,247,188,304,64,23,41,44,17,27,14,8,6,+6,+1,+5,67%,59%,74%,168,124,205,41%,33%,45%,10,3,7,4,2,2
281,https://vlr.gg/player/14208/kishi,2024-10-09 06:00:00,1.39,1.21,1.29,212,201,215,53,25,28,43,18,25,40,16,24,0,+2,-2,81%,78%,84%,135,143,129,38%,41%,35%,6,4,2,6,2,4
282,https://vlr.gg/player/23931/kata,2024-10-09 06:00:00,1.18,1.34,1.27,272,285,273,66,30,36,50,24,26,21,11,10,+7,+2,+5,79%,78%,79%,177,175,179,30%,31%,30%,18,8,10,11,6,5
283,https://vlr.gg/player/4089/doxz3r,2024-10-09 06:00:00,1.33,0.91,1.10,189,247,142,45,26,19,40,19,21,27,15,12,0,0,0,69%,69%,68%,134,167,107,32%,32%,33%,3,2,1,3,2,1
284,https://vlr.gg/player/41834/panda,2024-10-09 06:00:00,0.64,0.75,0.70,135,118,151,36,15,21,50,21,29,21,7,14,+1,-3,+4,67%,69%,66%,79,74,84,46%,39%,51%,5,0,5,4,3,1
285,https://vlr.gg/player/41175/m77,2024-10-09 05:00:00,,,,282,,,57,,,45,,,11,,,,,,,,,,,,,,,,,,,,
286,https://vlr.gg/player/41171/qbb,2024-10-09 05:00:00,,,,208,,,45,,,41,,,19,,,,,,,,,,,,,,,,,,,,
287,https://vlr.gg/player/48138/end3,2024-10-09 05:00:00,,,,195,,,39,,,42,,,31,,,,,,,,,,,,,,,,,,,,
288,https://vlr.gg/player/30321/pochacco,2024-10-09 05:00:00,,,,187,,,39,,,42,,,23,,,,,,,,,,,,,,,,,,,,
289,https://vlr.gg/player/41173/jianbao,2024-10-09 05:00:00,,,,169,,,36,,,37,,,19,,,,,,,,,,,,,,,,,,,,
290,https://vlr.gg/player/48167/xiaolan,2024-10-09 05:00:00,,,,287,,,60,,,49,,,15,,,,,,,,,,,,,,,,,,,,
291,https://vlr.gg/player/30334/yang,2024-10-09 05:00:00,,,,216,,,47,,,39,,,18,,,,,,,,,,,,,,,,,,,,
292,https://vlr.gg/player/48168/zora,2024-10-09 05:00:00,,,,159,,,32,,,40,,,16,,,,,,,,,,,,,,,,,,,,
293,https://vlr.gg/player/48170/anan,2024-10-09 05:00:00,,,,155,,,35,,,41,,,25,,,,,,,,,,,,,,,,,,,,
294,https://vlr.gg/player/48169/jennie,2024-10-09 05:00:00,,,,146,,,32,,,47,,,12,,,,,,,,,,,,,,,,,,,,
295,https://vlr.gg/player/23971/ask,2024-10-09 03:10:00,1.12,0.99,1.05,207,230,188,67,36,31,69,32,37,30,14,16,-2,0,-2,69%,70%,68%,143,160,128,28%,25%,34%,5,2,3,7,2,5
296,https://vlr.gg/player/10642/jan,2024-10-09 03:10:00,1.03,1.03,1.03,191,199,186,62,30,32,65,30,35,34,17,17,0,+5,-5,73%,74%,72%,130,128,131,32%,36%,29%,7,5,2,7,0,7
297,https://vlr.gg/player/34785/yowamu,2024-10-09 03:10:00,1.01,0.92,0.96,216,223,211,69,32,37,71,31,40,19,10,9,-15,-10,-5,66%,63%,68%,146,152,141,26%,29%,23%,9,4,5,24,14,10
298,https://vlr.gg/player/17111/allen,2024-10-09 03:10:00,0.97,0.83,0.89,188,196,181,64,29,35,69,31,38,24,18,6,+6,+4,+2,71%,79%,64%,113,126,102,22%,24%,21%,8,5,3,2,1,1
299,https://vlr.gg/player/25279/sakura,2024-10-09 03:10:00,0.65,0.92,0.79,197,154,232,63,24,39,75,34,41,10,4,6,+2,-2,+4,65%,58%,70%,127,101,148,35%,31%,37%,13,4,9,11,6,5
300,https://vlr.gg/player/45962/ken,2024-10-09 03:10:00,1.29,1.20,1.25,258,280,234,84,49,35,64,35,29,23,15,8,+7,+3,+4,80%,84%,74%,176,200,149,27%,31%,22%,14,7,7,7,4,3
301,https://vlr.gg/player/2400/brofeld,2024-10-09 03:10:00,0.96,1.17,1.06,211,198,228,71,35,36,65,36,29,23,13,10,+1,+1,0,74%,72%,77%,139,137,140,26%,32%,21%,8,4,4,7,3,4
302,https://vlr.gg/player/6702/bazz,2024-10-09 03:10:00,1.12,0.86,1.00,212,225,191,68,39,29,68,35,33,44,29,15,-1,-2,+1,72%,76%,67%,127,140,112,27%,25%,29%,12,6,6,13,8,5
303,https://vlr.gg/player/40736/kapi,2024-10-09 03:10:00,0.89,1.00,0.94,176,158,200,59,29,30,63,32,31,24,10,14,+1,+4,-3,73%,76%,70%,117,107,129,28%,26%,30%,6,4,2,5,0,5
304,https://vlr.gg/player/1009/sakurai,2024-10-09 03:10:00,0.95,0.93,0.94,193,205,184,67,39,28,65,36,29,21,10,11,+1,0,+1,75%,78%,72%,116,117,114,28%,25%,33%,11,7,4,10,7,3
305,https://vlr.gg/player/30575/r1sen,2024-10-08 08:00:00,1.00,1.46,1.22,213,167,273,55,21,34,44,22,22,20,8,12,-2,-1,-1,77%,68%,86%,144,118,173,35%,26%,41%,1,0,1,3,1,2
306,https://vlr.gg/player/27755/icarus,2024-10-08 08:00:00,1.08,1.20,1.13,223,221,224,55,27,28,48,25,23,13,6,7,+8,+6,+2,71%,71%,71%,148,146,151,28%,25%,32%,9,7,2,1,1,0
307,https://vlr.gg/player/22054/wave,2024-10-08 08:00:00,0.95,0.53,0.75,160,180,134,40,24,16,56,27,29,25,15,10,-7,-1,-6,63%,71%,54%,105,118,90,35%,33%,38%,3,1,2,10,2,8
308,https://vlr.gg/player/4085/near,2024-10-08 08:00:00,0.78,0.62,0.71,149,168,129,38,25,13,57,30,27,17,6,11,-1,-2,+1,58%,58%,57%,101,115,86,38%,36%,41%,5,2,3,6,4,2
309,https://vlr.gg/player/43389/yash,2024-10-08 08:00:00,0.43,0.96,0.68,193,153,226,46,20,26,61,33,28,12,6,6,-9,-8,-1,63%,55%,71%,127,109,146,29%,26%,32%,13,6,7,22,14,8
310,https://vlr.gg/player/13221/azys,2024-10-08 08:00:00,1.64,1.11,1.36,325,389,257,82,49,33,53,25,28,16,7,9,+8,+6,+2,70%,74%,66%,204,243,168,34%,38%,30%,17,9,8,9,3,6
311,https://vlr.gg/player/12947/rawfiul,2024-10-08 08:00:00,0.96,1.37,1.17,218,216,227,55,25,30,46,27,19,18,9,9,+4,+1,+3,78%,71%,84%,158,152,164,37%,37%,38%,10,4,6,6,3,3
312,https://vlr.gg/player/3628/deathmaker,2024-10-08 08:00:00,0.81,1.18,1.00,195,159,229,49,20,29,48,26,22,13,5,8,-2,-2,0,73%,69%,76%,142,118,165,32%,34%,31%,4,3,1,6,5,1
313,https://vlr.gg/player/3269/antidote,2024-10-08 08:00:00,0.87,1.01,0.94,145,130,155,39,17,22,43,20,23,27,16,11,0,+1,-1,68%,69%,68%,96,86,106,29%,27%,31%,5,3,2,5,2,3
314,https://vlr.gg/player/18704/levi,2024-10-08 08:00:00,0.94,0.87,0.90,150,144,161,41,19,22,46,20,26,18,8,10,+1,-1,+2,66%,69%,63%,104,99,109,31%,39%,25%,6,1,5,5,2,3
315,https://vlr.gg/player/46104/envy2k,2024-10-08 06:00:00,0.76,1.32,1.06,261,202,315,32,12,20,30,15,15,3,1,2,+5,-1,+6,50%,35%,63%,157,110,199,40%,44%,38%,10,3,7,5,4,1
316,https://vlr.gg/player/5009/wstvirginia,2024-10-08 06:00:00,1.12,0.71,0.90,166,189,154,22,12,10,27,12,15,7,1,6,+2,+1,+1,69%,71%,68%,106,115,98,42%,43%,41%,3,1,2,1,0,1
317,https://vlr.gg/player/31355/acestarrrrr,2024-10-08 06:00:00,0.34,0.94,0.66,138,77,192,18,4,14,30,15,15,7,4,3,0,-1,+1,61%,53%,68%,92,57,122,19%,10%,24%,2,1,1,2,2,0
318,https://vlr.gg/player/43390/d1sease,2024-10-08 06:00:00,0.85,0.47,0.65,147,174,120,14,9,5,31,14,17,20,9,11,-2,0,-2,61%,65%,58%,94,101,89,17%,17%,17%,1,1,0,3,1,2
319,https://vlr.gg/player/45484/max,2024-10-08 06:00:00,0.68,0.60,0.64,142,154,128,16,9,7,32,17,15,4,2,2,+1,0,+1,67%,65%,68%,98,114,83,27%,24%,33%,5,2,3,4,2,2
320,https://vlr.gg/player/3639/hoax,2024-10-08 06:00:00,1.60,1.32,1.47,287,306,266,38,23,15,21,11,10,11,2,9,0,0,0,75%,68%,82%,183,185,180,25%,29%,21%,3,1,2,3,1,2
321,https://vlr.gg/player/30693/makaveli,2024-10-08 06:00:00,1.36,1.37,1.36,254,223,292,34,16,18,20,10,10,4,2,2,0,0,0,78%,84%,71%,165,144,188,32%,50%,21%,2,1,1,2,1,1
322,https://vlr.gg/player/26376/deecee,2024-10-08 06:00:00,1.00,1.46,1.22,253,227,277,36,17,19,21,12,9,7,2,5,-3,-5,+2,75%,58%,94%,152,137,168,24%,16%,33%,5,2,3,8,7,1
323,https://vlr.gg/player/3627/hellff,2024-10-08 06:00:00,1.03,1.39,1.20,228,170,296,29,12,17,21,11,10,12,4,8,-1,0,-1,83%,79%,88%,146,109,188,23%,31%,20%,2,0,2,3,0,3
324,https://vlr.gg/player/27775/techno,2024-10-08 06:00:00,0.74,0.82,0.77,110,137,80,13,9,4,19,12,7,20,7,13,-2,-2,0,75%,68%,82%,76,91,60,39%,38%,43%,3,2,1,5,4,1
325,https://vlr.gg/player/2671/popogachi,2024-10-08 04:40:00,1.37,1.26,1.31,275,262,286,54,22,32,44,15,29,17,9,8,+2,-1,+3,73%,78%,69%,181,160,194,25%,25%,25%,6,2,4,4,3,1
326,https://vlr.gg/player/44613/yamada,2024-10-08 04:40:00,1.21,0.76,0.93,199,223,184,40,18,22,45,17,28,22,10,12,0,+2,-2,69%,74%,67%,130,145,121,25%,33%,20%,6,3,3,6,1,5
327,https://vlr.gg/player/1971/oitan,2024-10-08 04:40:00,0.79,1.01,0.93,187,173,196,37,15,22,44,17,27,9,0,9,-1,-2,+1,59%,57%,61%,129,115,138,31%,38%,28%,3,0,3,4,2,2
328,https://vlr.gg/player/1973/ripablo,2024-10-08 04:40:00,0.72,0.98,0.88,147,93,181,31,8,23,42,15,27,25,11,14,-2,0,-2,78%,78%,78%,90,52,115,24%,24%,24%,2,1,1,4,1,3
329,https://vlr.gg/player/47481/frxeez,2024-10-08 04:40:00,0.83,0.51,0.62,172,214,148,31,15,16,49,19,30,14,9,5,-8,0,-8,59%,74%,50%,111,131,99,18%,20%,18%,8,5,3,16,5,11
330,https://vlr.gg/player/2400/brofeld,2024-10-08 04:40:00,1.44,0.77,1.18,217,230,198,50,33,17,34,16,18,10,7,3,+4,+4,0,73%,81%,61%,144,158,121,25%,26%,23%,6,5,1,2,1,1
331,https://vlr.gg/player/6702/bazz,2024-10-08 04:40:00,1.10,1.21,1.14,238,237,238,54,31,23,42,27,15,14,10,4,-1,-3,+2,76%,72%,83%,160,163,155,41%,48%,33%,6,3,3,7,6,1
332,https://vlr.gg/player/45962/ken,2024-10-08 04:40:00,1.11,1.03,1.08,227,252,187,43,30,13,43,27,16,25,15,10,-2,-1,-1,73%,72%,74%,153,168,130,18%,21%,14%,8,4,4,10,5,5
333,https://vlr.gg/player/40736/kapi,2024-10-08 04:40:00,1.01,1.03,1.02,169,156,190,38,23,15,35,20,15,18,11,7,+1,+2,-1,71%,69%,74%,117,108,131,27%,33%,21%,5,4,1,4,2,2
334,https://vlr.gg/player/1009/sakurai,2024-10-08 04:40:00,0.99,0.92,0.96,196,212,174,39,25,14,40,25,15,20,16,4,+7,+6,+1,85%,83%,87%,129,139,114,31%,28%,38%,9,6,3,2,0,2
335,https://vlr.gg/player/1027/marin,2024-10-08 02:10:00,1.00,1.33,1.14,230,181,261,41,19,22,37,22,15,21,10,11,+1,-2,+3,75%,69%,83%,141,122,165,31%,27%,35%,4,0,4,3,2,1
336,https://vlr.gg/player/1952/esperanza,2024-10-08 02:10:00,0.87,1.11,0.97,206,206,247,41,21,20,41,25,16,7,6,1,+2,-2,+4,63%,59%,70%,138,126,152,40%,33%,49%,6,1,5,4,3,1
337,https://vlr.gg/player/7888/blackwiz,2024-10-08 02:10:00,1.01,0.93,0.97,181,208,196,35,19,16,40,23,17,19,11,8,-2,-3,+1,75%,66%,87%,140,143,137,25%,22%,30%,2,1,1,4,4,0
338,https://vlr.gg/player/1960/eko,2024-10-08 02:10:00,0.63,1.19,0.88,207,162,258,35,14,21,40,25,15,10,6,4,-1,-3,+2,62%,52%,74%,141,120,168,24%,25%,22%,5,2,3,6,5,1
339,https://vlr.gg/player/6676/thiefy,2024-10-08 02:10:00,0.44,0.82,0.61,145,140,170,26,14,12,42,26,16,7,1,6,-8,-9,+1,58%,41%,78%,98,89,109,17%,14%,20%,5,1,4,13,10,3
340,https://vlr.gg/player/10642/jan,2024-10-08 02:10:00,1.41,1.55,1.49,290,309,297,54,24,30,36,20,16,24,12,12,+6,0,+6,83%,83%,83%,188,198,180,30%,35%,26%,8,1,7,2,1,1
341,https://vlr.gg/player/17111/allen,2024-10-08 02:10:00,1.22,0.95,1.07,174,219,149,34,18,16,33,16,17,22,7,15,-2,-1,-1,77%,65%,86%,125,158,99,22%,25%,20%,1,0,1,3,1,2
342,https://vlr.gg/player/34785/yowamu,2024-10-08 02:10:00,0.95,1.11,1.04,247,208,252,40,15,25,37,18,19,14,6,8,+9,-1,+10,69%,52%,83%,149,138,157,26%,25%,26%,14,4,10,5,5,0
343,https://vlr.gg/player/23971/ask,2024-10-08 02:10:00,0.49,1.32,0.95,184,96,234,33,9,24,33,17,16,11,2,9,-5,-6,+1,69%,61%,76%,115,60,158,32%,44%,29%,3,0,3,8,6,2
344,https://vlr.gg/player/25279/sakura,2024-10-08 02:10:00,0.58,1.21,0.94,195,154,233,39,13,26,39,20,19,8,5,3,0,-3,+3,79%,74%,83%,138,111,159,27%,28%,27%,4,1,3,4,4,0
345,https://vlr.gg/player/30750/enes,2024-10-07 15:30:00,1.62,0.88,1.28,183,251,121,34,25,9,25,12,13,23,11,12,+1,+2,-1,81%,88%,73%,128,170,78,36%,34%,38%,5,4,1,4,2,2
346,https://vlr.gg/player/9508/leosen,2024-10-07 15:30:00,1.44,0.96,1.22,227,239,215,38,22,16,28,15,13,27,16,11,-1,-1,0,71%,77%,64%,151,164,136,49%,43%,61%,2,0,2,3,1,2
347,https://vlr.gg/player/12528/disisjohn,2024-10-07 15:30:00,0.72,1.31,0.99,257,206,297,41,18,23,39,22,17,5,3,2,-3,0,-3,63%,58%,68%,159,138,184,32%,36%,29%,10,7,3,13,7,6
348,https://vlr.gg/player/7865/xanarchy,2024-10-07 15:30:00,0.77,1.22,0.98,179,138,219,29,12,17,30,16,14,13,10,3,-1,0,-1,81%,81%,82%,111,91,135,44%,32%,58%,2,1,1,3,1,2
349,https://vlr.gg/player/4969/shazeon,2024-10-07 15:30:00,0.96,0.78,0.87,197,240,148,34,23,11,35,20,15,9,4,5,0,-1,+1,67%,62%,73%,125,155,90,41%,40%,43%,3,1,2,3,2,1
350,https://vlr.gg/player/9540/rxyal,2024-10-07 15:30:00,1.04,1.52,1.30,226,155,295,43,13,30,30,13,17,6,3,3,0,+1,-1,69%,64%,73%,154,107,194,27%,29%,25%,5,1,4,5,0,5
351,https://vlr.gg/player/16278/oli,2024-10-07 15:30:00,1.43,0.71,1.04,210,306,147,38,25,13,34,14,20,14,7,7,+3,+2,+1,67%,77%,58%,138,183,101,40%,41%,40%,7,4,3,4,2,2
352,https://vlr.gg/player/7267/nex,2024-10-07 15:30:00,0.55,1.08,0.81,176,127,222,26,9,17,38,19,19,14,6,8,+1,0,+1,58%,45%,69%,118,76,154,27%,39%,21%,6,3,3,5,3,2
353,https://vlr.gg/player/48432/nikolaslo,2024-10-07 15:30:00,0.79,0.78,0.78,158,139,165,22,10,12,35,15,20,11,7,4,+2,+1,+1,71%,82%,62%,115,99,128,23%,23%,22%,3,2,1,1,1,0
354,https://vlr.gg/player/10301/wheelzonfire,2024-10-07 15:30:00,1.08,0.47,0.75,158,197,128,28,15,13,39,15,24,13,9,4,-2,0,-2,54%,59%,50%,101,127,79,19%,12%,30%,5,3,2,7,3,4
355,https://vlr.gg/player/33392/zeikosha,2024-10-07 12:00:00,1.42,0.91,1.20,229,258,183,56,35,21,42,22,20,12,7,5,+2,+1,+1,71%,73%,68%,151,173,122,36%,37%,33%,6,4,2,4,3,1
356,https://vlr.gg/player/45834/aidan,2024-10-07 12:00:00,0.77,1.76,1.20,256,177,356,60,23,37,47,30,17,14,9,5,+3,-3,+6,69%,65%,75%,156,114,212,26%,18%,35%,12,4,8,9,7,2
357,https://vlr.gg/player/44548/nomiss,2024-10-07 12:00:00,0.96,1.08,1.01,168,153,190,37,20,17,41,24,17,32,18,14,0,-2,+2,74%,70%,79%,110,99,125,28%,30%,25%,9,4,5,9,6,3
358,https://vlr.gg/player/4361/radenz,2024-10-07 12:00:00,1.03,0.96,1.00,155,161,154,37,22,15,41,24,17,21,8,13,-2,-2,0,69%,68%,71%,104,110,97,26%,28%,23%,3,1,2,5,3,2
359,https://vlr.gg/player/24831/complexit,2024-10-07 12:00:00,0.85,1.16,0.98,202,188,215,40,21,19,47,29,18,34,17,17,-2,-1,-1,68%,68%,68%,135,127,144,17%,14%,20%,3,2,1,5,3,2
360,https://vlr.gg/player/40587/nyshaa,2024-10-07 12:00:00,0.80,1.45,1.17,199,137,245,43,11,32,39,20,19,44,19,25,-1,-1,0,83%,75%,89%,125,94,148,21%,24%,19%,1,0,1,2,1,1
361,https://vlr.gg/player/27957/ike,2024-10-07 12:00:00,0.81,1.35,1.12,216,187,250,53,18,35,46,23,23,26,12,14,+4,-1,+5,72%,61%,81%,140,128,148,28%,33%,24%,10,3,7,6,4,2
362,https://vlr.gg/player/28102/snabbi3,2024-10-07 12:00:00,1.01,0.80,0.89,210,257,178,47,27,20,52,24,28,15,3,12,+4,+1,+3,66%,64%,68%,131,136,128,17%,14%,19%,10,3,7,6,2,4
363,https://vlr.gg/player/28344/spitzer,2024-10-07 12:00:00,0.81,0.88,0.85,174,169,178,35,16,19,46,21,25,23,7,16,-3,-4,+1,71%,68%,73%,118,106,128,14%,31%,6%,3,1,2,6,5,1
364,https://vlr.gg/player/28346/stolen,2024-10-07 12:00:00,0.90,0.82,0.85,180,180,177,40,17,23,47,21,26,17,7,10,-5,-3,-2,69%,68%,70%,117,119,117,33%,32%,34%,8,3,5,13,6,7
365,https://vlr.gg/player/3281/psy,2024-10-07 08:15:00,1.34,1.05,1.16,255,251,250,47,19,28,44,18,26,17,8,9,0,0,0,64%,61%,66%,176,189,167,25%,31%,21%,8,3,5,8,3,5
366,https://vlr.gg/player/5541/tryst,2024-10-07 08:15:00,0.83,1.17,1.04,153,142,154,32,12,20,34,17,17,5,1,4,-5,-1,-4,64%,61%,66%,107,104,108,28%,36%,24%,2,2,0,7,3,4
367,https://vlr.gg/player/19231/kibojn,2024-10-07 08:15:00,0.99,1.06,1.03,189,195,185,38,15,23,42,19,23,27,10,17,+3,-2,+5,74%,74%,74%,121,128,116,47%,49%,45%,5,0,5,2,2,0
368,https://vlr.gg/player/30877/lilboii,2024-10-07 08:15:00,0.81,0.89,0.84,166,167,168,32,11,21,41,18,23,25,14,11,-2,-2,0,74%,70%,77%,104,100,107,30%,27%,33%,2,0,2,4,2,2
369,https://vlr.gg/player/3271/excali,2024-10-07 08:15:00,0.72,0.92,0.83,198,169,220,39,13,26,46,19,27,11,5,6,-8,-4,-4,59%,52%,63%,132,106,149,33%,35%,32%,6,2,4,14,6,8
370,https://vlr.gg/player/8156/mojo,2024-10-07 08:15:00,1.24,1.35,1.28,201,202,220,44,24,20,31,20,11,21,15,6,0,0,0,72%,69%,78%,138,132,147,31%,28%,35%,3,2,1,3,2,1
371,https://vlr.gg/player/18702/deadly10,2024-10-07 08:15:00,1.06,1.45,1.21,296,275,340,63,33,30,44,27,17,10,7,3,+8,+1,+7,71%,63%,83%,185,176,199,22%,22%,22%,15,6,9,7,5,2
372,https://vlr.gg/player/48426/ghostxd,2024-10-07 08:15:00,0.91,1.10,0.99,191,170,219,40,20,20,38,24,14,26,16,10,+3,+1,+2,84%,80%,91%,121,115,129,32%,30%,34%,5,2,3,2,1,1
373,https://vlr.gg/player/44919/aplycs,2024-10-07 08:15:00,1.01,0.82,0.93,167,187,127,33,23,10,34,22,12,12,7,5,+3,+2,+1,74%,74%,74%,109,125,84,20%,24%,13%,7,5,2,4,3,1
374,https://vlr.gg/player/43408/garv,2024-10-07 08:15:00,0.82,0.75,0.79,146,134,166,27,16,11,41,25,16,20,12,8,-2,-1,-1,69%,69%,70%,102,88,122,22%,19%,26%,5,4,1,7,5,2
375,https://vlr.gg/player/12323/rvk,2024-10-07 06:00:00,1.06,1.19,1.13,209,222,197,33,15,18,29,17,12,2,1,1,+1,+1,0,65%,52%,77%,135,140,130,34%,32%,37%,3,2,1,2,1,1
376,https://vlr.gg/player/1770/wat,2024-10-07 06:00:00,0.80,1.03,0.91,218,203,232,32,14,18,34,20,14,10,3,7,-3,-1,-2,63%,52%,73%,143,139,148,35%,42%,29%,5,3,2,8,4,4
377,https://vlr.gg/player/46121/marcai,2024-10-07 06:00:00,0.57,1.19,0.89,229,160,297,31,10,21,35,19,16,7,3,4,+5,0,+5,72%,62%,82%,150,108,191,29%,34%,27%,9,2,7,4,2,2
378,https://vlr.gg/player/3502/ri0,2024-10-07 06:00:00,0.35,1.13,0.75,126,89,160,20,6,14,29,19,10,10,4,6,-5,-4,-1,58%,43%,73%,81,53,108,35%,40%,33%,1,0,1,6,4,2
379,https://vlr.gg/player/40057/batman,2024-10-07 06:00:00,0.27,0.95,0.59,101,88,116,15,5,10,30,19,11,13,5,8,-1,-3,+2,67%,52%,82%,69,63,74,32%,26%,36%,2,0,2,3,3,0
380,https://vlr.gg/player/23931/kata,2024-10-07 06:00:00,0.87,2.01,1.43,341,217,468,50,15,35,32,19,13,10,5,5,+5,0,+5,67%,59%,76%,210,137,287,34%,27%,38%,12,4,8,7,4,3
381,https://vlr.gg/player/4089/doxz3r,2024-10-07 06:00:00,1.34,1.19,1.27,228,266,188,33,20,13,26,15,11,16,5,11,+2,+2,0,77%,68%,86%,157,159,155,27%,30%,24%,3,2,1,1,0,1
382,https://vlr.gg/player/30286/karam1l,2024-10-07 06:00:00,0.87,1.40,1.13,198,160,241,31,13,18,24,16,8,7,3,4,+5,+3,+2,77%,68%,86%,133,101,166,32%,28%,35%,5,3,2,0,0,0
383,https://vlr.gg/player/14208/kishi,2024-10-07 06:00:00,0.61,1.53,1.06,155,111,199,25,8,17,24,16,8,23,10,13,-5,-5,0,72%,64%,81%,94,64,125,43%,45%,42%,1,0,1,6,5,1
384,https://vlr.gg/player/41834/panda,2024-10-07 06:00:00,0.58,1.02,0.80,116,96,137,17,7,10,25,15,10,12,2,10,-4,-4,0,65%,55%,76%,85,74,97,34%,30%,39%,2,0,2,6,4,2
385,https://vlr.gg/player/27384/jaxe,2024-10-07 04:50:00,1.02,1.40,1.22,234,215,259,86,36,50,75,40,35,30,10,20,+1,-4,+5,79%,65%,91%,159,142,175,28%,28%,27%,7,1,6,6,5,1
386,https://vlr.gg/player/17169/muto,2024-10-07 04:50:00,0.73,1.43,1.10,209,162,261,69,22,47,69,39,30,44,17,27,+5,+1,+4,67%,57%,76%,151,119,179,20%,19%,21%,12,3,9,7,2,5
387,https://vlr.gg/player/37390/bnn,2024-10-07 04:50:00,0.67,1.16,0.93,178,159,206,67,27,40,74,41,33,35,13,22,-4,-4,0,76%,71%,80%,121,107,134,35%,38%,33%,5,2,3,9,6,3
388,https://vlr.gg/player/31841/take,2024-10-07 04:50:00,0.74,0.92,0.84,177,189,176,66,32,34,80,44,36,26,7,19,-9,-10,+1,61%,49%,72%,118,120,117,31%,31%,31%,3,1,2,12,11,1
389,https://vlr.gg/player/25915/brian,2024-10-07 04:50:00,0.46,1.12,0.80,195,161,252,73,24,49,88,47,41,16,8,8,-2,-12,+10,61%,45%,76%,135,113,156,23%,21%,24%,20,3,17,22,15,7
390,https://vlr.gg/player/6702/bazz,2024-10-07 04:50:00,0.87,1.60,1.22,248,197,307,90,36,54,74,46,28,39,20,19,+6,-5,+11,77%,69%,86%,164,130,201,27%,25%,29%,13,1,12,7,6,1
391,https://vlr.gg/player/45962/ken,2024-10-07 04:50:00,1.09,1.32,1.20,285,265,276,89,44,45,76,44,32,40,18,22,+6,-3,+9,82%,76%,88%,175,180,170,22%,21%,22%,19,8,11,13,11,2
392,https://vlr.gg/player/1009/sakurai,2024-10-07 04:50:00,0.85,1.10,0.97,187,194,191,70,34,36,72,44,28,40,24,16,-4,-6,+2,77%,70%,84%,129,127,132,41%,44%,37%,6,2,4,10,8,2
393,https://vlr.gg/player/2400/brofeld,2024-10-07 04:50:00,0.61,1.37,0.97,183,145,250,72,27,45,71,43,28,17,4,13,0,-4,+4,72%,54%,92%,137,100,177,31%,32%,30%,6,1,5,6,5,1
394,https://vlr.gg/player/40736/kapi,2024-10-07 04:50:00,0.67,1.12,0.89,185,174,181,65,34,31,68,43,25,19,8,11,+1,-2,+3,72%,65%,80%,115,110,120,30%,30%,30%,12,5,7,11,7,4
395,https://vlr.gg/player/1003/reita,2024-10-07 02:20:00,0.76,1.45,1.16,180,131,228,28,9,19,29,13,16,13,2,11,+2,-1,+3,71%,58%,81%,127,83,160,23%,25%,22%,4,0,4,2,1,1
396,https://vlr.gg/player/34776/absol,2024-10-07 02:20:00,0.82,1.03,0.94,238,219,231,33,15,18,38,17,21,9,0,9,+3,+1,+2,67%,53%,77%,151,135,163,21%,26%,19%,10,4,6,7,3,4
397,https://vlr.gg/player/20465/biju,2024-10-07 02:20:00,0.97,0.88,0.92,171,167,181,29,11,18,31,12,19,9,5,4,-1,-1,0,71%,63%,77%,113,108,116,38%,42%,37%,2,1,1,3,2,1
398,https://vlr.gg/player/686/tonbo,2024-10-07 02:20:00,0.91,0.68,0.78,174,162,193,29,11,18,37,13,24,7,2,5,+2,0,+2,53%,58%,50%,113,105,119,33%,27%,39%,4,1,3,2,1,1
399,https://vlr.gg/player/700/million,2024-10-07 02:20:00,0.36,0.73,0.57,144,133,159,21,6,15,38,17,21,15,5,10,-5,-4,-1,60%,63%,58%,100,97,102,16%,16%,17%,3,1,2,8,5,3
400,https://vlr.gg/player/1971/oitan,2024-10-07 02:20:00,1.32,1.98,1.59,276,261,320,47,25,22,20,15,5,8,3,5,0,-3,+3,73%,65%,84%,200,182,225,37%,39%,35%,5,2,3,5,5,0
401,https://vlr.gg/player/2671/popogachi,2024-10-07 02:20:00,1.18,1.41,1.28,246,259,236,42,24,18,29,19,10,12,5,7,+3,+3,0,69%,69%,68%,159,168,145,22%,20%,24%,4,3,1,1,0,1
402,https://vlr.gg/player/44613/yamada,2024-10-07 02:20:00,0.96,1.24,1.08,210,184,242,32,16,16,33,20,13,31,18,13,0,0,0,87%,88%,84%,135,120,155,24%,28%,20%,6,2,4,6,2,4
403,https://vlr.gg/player/47481/frxeez,2024-10-07 02:20:00,1.12,0.85,1.00,242,251,172,32,23,9,29,17,12,11,5,6,-3,-4,+1,73%,73%,74%,137,159,108,17%,26%,6%,5,2,3,8,6,2
404,https://vlr.gg/player/1973/ripablo,2024-10-07 02:20:00,0.75,0.72,0.74,141,150,117,20,13,7,29,17,12,19,9,10,-1,-2,+1,69%,69%,68%,88,99,71,22%,26%,15%,2,1,1,3,3,0
405,https://vlr.gg/player/48431/kippei,2024-10-07 00:00:00,0.74,1.35,1.04,167,136,200,26,10,16,28,17,11,21,11,10,-2,-2,0,69%,65%,73%,102,83,122,25%,24%,26%,2,1,1,4,3,1
406,https://vlr.gg/player/27442/impact,2024-10-07 00:00:00,0.96,0.97,0.97,240,252,227,37,20,17,37,20,17,12,5,7,+6,+3,+3,69%,74%,64%,152,158,146,37%,39%,35%,11,5,6,5,2,3
407,https://vlr.gg/player/40726/gwangboong,2024-10-07 00:00:00,0.84,0.95,0.89,168,186,151,29,15,14,30,18,12,9,5,4,-4,-2,-2,67%,70%,64%,106,120,90,21%,25%,15%,2,1,1,6,3,3
408,https://vlr.gg/player/10769/nobita,2024-10-07 00:00:00,0.77,1.02,0.89,195,194,196,30,16,14,37,22,15,11,6,5,0,-1,+1,71%,74%,68%,133,126,141,32%,33%,30%,3,2,1,3,3,0
409,https://vlr.gg/player/10628/misaya,2024-10-07 00:00:00,0.66,1.01,0.83,175,137,213,25,10,15,34,18,16,16,8,8,-3,-3,0,80%,83%,77%,106,92,120,16%,17%,16%,3,0,3,6,3,3
410,https://vlr.gg/player/23971/ask,2024-10-07 00:00:00,1.39,1.36,1.37,255,260,251,41,21,20,28,13,15,10,4,6,+2,0,+2,80%,77%,83%,181,174,186,24%,21%,27%,4,1,3,2,1,1
411,https://vlr.gg/player/10642/jan,2024-10-07 00:00:00,1.36,1.36,1.36,230,240,218,38,19,19,28,15,13,23,11,12,-1,+1,-2,78%,82%,74%,160,169,152,35%,38%,33%,3,3,0,4,2,2
412,https://vlr.gg/player/25279/sakura,2024-10-07 00:00:00,0.57,1.34,0.97,191,103,277,30,7,23,29,15,14,9,4,5,+2,-2,+4,67%,59%,74%,128,76,178,27%,23%,28%,5,1,4,3,3,0
413,https://vlr.gg/player/17111/allen,2024-10-07 00:00:00,0.74,1.14,0.94,150,128,170,22,8,14,28,15,13,18,8,10,+2,+2,0,73%,68%,78%,105,84,125,24%,22%,26%,4,2,2,2,0,2
414,https://vlr.gg/player/34785/yowamu,2024-10-07 00:00:00,0.73,1.02,0.88,220,221,220,35,16,19,34,18,16,9,4,5,-2,-3,+1,58%,41%,74%,137,142,133,31%,29%,33%,8,3,5,10,6,4
415,https://vlr.gg/player/40734/hands,2024-10-06 21:10:00,1.01,1.30,1.16,196,186,207,31,14,17,30,16,14,13,6,7,0,+2,-2,67%,59%,75%,138,138,139,28%,37%,24%,2,2,0,2,0,2
416,https://vlr.gg/player/17099/bom-alpha,2024-10-06 21:10:00,1.07,0.88,0.97,157,167,148,25,13,12,30,14,16,20,11,9,-5,-1,-4,70%,73%,67%,105,102,109,39%,54%,30%,0,0,0,5,1,4
417,https://vlr.gg/player/10661/phantom,2024-10-06 21:10:00,0.62,1.25,0.95,208,133,278,34,11,23,37,16,21,7,2,5,0,-2,+2,59%,50%,67%,144,90,194,22%,29%,18%,5,1,4,5,3,2
418,https://vlr.gg/player/33417/fukuken,2024-10-06 21:10:00,1.16,0.70,0.92,200,242,163,31,18,13,36,17,19,21,13,8,0,+2,-2,70%,82%,58%,128,149,109,30%,26%,35%,3,2,1,3,0,3
419,https://vlr.gg/player/48430/rui,2024-10-06 21:10:00,0.14,0.94,0.55,145,81,204,24,6,18,37,19,18,8,5,3,-5,-5,0,57%,45%,67%,90,41,135,28%,13%,36%,8,4,4,13,9,4
420,https://vlr.gg/player/1027/marin,2024-10-06 21:10:00,1.17,1.36,1.26,242,216,271,39,17,22,29,16,13,21,14,7,+2,+2,0,78%,83%,73%,159,137,184,27%,23%,29%,4,2,2,2,0,2
421,https://vlr.gg/player/1960/eko,2024-10-06 21:10:00,1.30,1.16,1.23,231,272,187,35,23,12,28,16,12,22,8,14,0,+1,-1,76%,71%,82%,155,175,134,28%,33%,21%,4,2,2,4,1,3
422,https://vlr.gg/player/7888/blackwiz,2024-10-06 21:10:00,0.91,1.39,1.14,196,172,222,31,15,16,26,15,11,21,8,13,-2,0,-2,80%,75%,86%,125,98,154,28%,29%,27%,3,2,1,5,2,3
423,https://vlr.gg/player/1952/esperanza,2024-10-06 21:10:00,0.78,1.19,0.97,171,149,195,30,14,16,28,16,12,2,1,1,+3,0,+3,72%,67%,77%,116,109,124,31%,41%,24%,5,2,3,2,2,0
424,https://vlr.gg/player/6676/thiefy,2024-10-06 21:10:00,0.81,1.06,0.93,199,207,191,35,19,16,34,20,14,6,3,3,+7,+3,+4,72%,75%,68%,123,116,131,33%,35%,29%,12,7,5,5,4,1
425,https://vlr.gg/player/3674/iluri,2024-10-06 13:00:00,1.01,1.44,1.21,195,156,242,51,21,30,39,22,17,27,13,14,+2,+1,+1,77%,70%,85%,138,117,161,42%,40%,44%,5,2,3,3,1,2
426,https://vlr.gg/player/8502/olizera,2024-10-06 13:00:00,1.02,1.39,1.19,226,190,263,56,24,32,45,25,20,28,17,11,+3,+1,+2,83%,76%,91%,135,121,151,24%,23%,26%,10,5,5,7,4,3
427,https://vlr.gg/player/17644/matrixx,2024-10-06 13:00:00,1.14,1.10,1.12,215,208,216,55,28,27,43,24,19,27,13,14,0,0,0,82%,84%,79%,142,147,137,32%,34%,30%,6,2,4,6,2,4
428,https://vlr.gg/player/3753/obnoks,2024-10-06 13:00:00,1.01,1.14,1.07,196,191,207,48,24,24,44,25,19,29,16,13,+4,+1,+3,77%,78%,76%,132,127,136,13%,14%,11%,6,3,3,2,2,0
429,https://vlr.gg/player/8808/pyrolll,2024-10-06 13:00:00,1.01,1.03,1.02,211,229,189,55,31,24,46,25,21,11,4,7,-4,-2,-2,69%,62%,76%,148,154,141,32%,30%,36%,11,7,4,15,9,6
430,https://vlr.gg/player/36403/tenji,2024-10-06 13:00:00,0.73,1.21,0.98,185,147,214,45,17,28,51,28,23,29,17,12,+2,0,+2,70%,68%,73%,112,85,137,42%,43%,41%,6,3,3,4,3,1
431,https://vlr.gg/player/18192/ryn,2024-10-06 13:00:00,0.96,0.99,0.97,175,170,186,48,22,26,49,25,24,19,9,10,-2,-1,-1,63%,65%,62%,112,109,116,36%,38%,35%,6,2,4,8,3,5
432,https://vlr.gg/player/23174/snowi,2024-10-06 13:00:00,1.01,0.93,0.97,200,190,217,45,21,24,53,25,28,19,7,12,+7,+5,+2,69%,65%,73%,139,122,154,27%,25%,28%,10,5,5,3,0,3
433,https://vlr.gg/player/42696/yorkings,2024-10-06 13:00:00,0.68,0.92,0.81,164,153,180,45,20,25,54,28,26,2,0,2,-3,-2,-1,49%,47%,51%,104,94,112,45%,65%,35%,2,0,2,5,2,3
434,https://vlr.gg/player/29951/ziad,2024-10-06 13:00:00,0.40,0.72,0.55,140,138,145,33,16,17,58,31,27,10,3,7,-9,-6,-3,54%,50%,57%,96,82,108,24%,26%,23%,9,5,4,18,11,7
435,https://vlr.gg/player/39664/insanedini,2024-10-06 11:00:00,0.93,1.45,1.10,275,247,326,29,16,13,32,23,9,14,11,3,-1,-5,+4,72%,71%,75%,178,167,200,14%,18%,8%,8,3,5,9,8,1
436,https://vlr.gg/player/33398/miyamura,2024-10-06 11:00:00,0.91,1.12,0.98,212,200,249,27,16,11,31,22,9,7,5,2,-1,-3,+2,64%,63%,67%,141,143,137,19%,20%,18%,3,1,2,4,4,0
437,https://vlr.gg/player/46466/frazune,2024-10-06 11:00:00,0.59,1.19,0.79,140,108,208,18,9,9,28,20,8,12,5,7,-2,-2,0,69%,58%,92%,92,74,129,27%,28%,27%,0,0,0,2,2,0
438,https://vlr.gg/player/46468/dokusei,2024-10-06 11:00:00,0.61,0.86,0.70,169,143,221,23,13,10,31,21,10,4,4,0,0,-3,+3,53%,46%,67%,103,89,130,39%,48%,30%,3,0,3,3,3,0
439,https://vlr.gg/player/30292/bruhbruhfish,2024-10-06 11:00:00,0.38,0.03,0.25,86,97,60,11,9,2,32,21,11,1,0,1,-2,-3,+1,42%,42%,42%,57,67,37,35%,35%,33%,1,0,1,3,3,0
440,https://vlr.gg/player/30754/karma,2024-10-06 11:00:00,1.82,1.57,1.66,308,358,282,43,16,27,21,8,13,18,5,13,+1,-1,+2,89%,83%,92%,190,210,180,36%,35%,36%,4,0,4,3,1,2
441,https://vlr.gg/player/5477/leon,2024-10-06 11:00:00,1.45,1.22,1.30,239,285,216,32,14,18,22,9,13,8,2,6,+1,-1,+2,89%,100%,83%,162,183,152,22%,28%,18%,2,0,2,1,1,0
442,https://vlr.gg/player/15178/canefis,2024-10-06 11:00:00,1.08,1.19,1.16,170,197,155,21,6,15,18,8,10,22,12,10,+2,0,+2,75%,83%,71%,112,125,106,36%,38%,35%,3,1,2,1,1,0
443,https://vlr.gg/player/45490/ico,2024-10-06 11:00:00,0.74,1.35,1.15,245,158,290,34,7,27,24,9,15,9,4,5,+1,-4,+5,64%,33%,79%,166,104,197,39%,29%,42%,5,0,5,4,4,0
444,https://vlr.gg/player/22180/spmak,2024-10-06 11:00:00,0.36,1.34,1.00,202,114,246,24,4,20,23,11,12,13,2,11,+1,-4,+5,78%,42%,96%,129,80,153,17%,31%,14%,7,0,7,6,4,2
445,https://vlr.gg/player/20064/vania,2024-10-06 10:30:00,1.24,1.43,1.34,227,174,276,68,28,40,48,22,26,51,23,28,+4,0,+4,85%,85%,84%,149,119,177,38%,49%,33%,7,2,5,3,2,1
446,https://vlr.gg/player/36175/rezq,2024-10-06 10:30:00,1.22,1.27,1.25,297,319,280,87,45,42,62,34,28,16,10,6,0,-3,+3,75%,78%,73%,188,193,183,26%,28%,25%,22,10,12,22,13,9
447,https://vlr.gg/player/24149/amy,2024-10-06 10:30:00,1.09,1.06,1.07,196,169,219,57,25,32,52,23,29,28,13,15,-3,+1,-4,73%,71%,75%,130,111,146,32%,29%,35%,3,3,0,6,2,4
448,https://vlr.gg/player/17320/petra,2024-10-06 10:30:00,1.08,0.91,0.99,193,198,190,57,29,28,57,27,30,25,13,12,+5,0,+5,75%,76%,75%,129,128,129,31%,26%,36%,9,3,6,4,3,1
449,https://vlr.gg/player/17323/mimi,2024-10-06 10:30:00,1.08,0.74,0.90,152,183,126,46,26,20,54,25,29,33,15,18,-2,0,-2,78%,83%,73%,103,126,82,31%,31%,32%,4,2,2,6,2,4
450,https://vlr.gg/player/16418/smurfette,2024-10-06 10:30:00,0.94,1.24,1.08,252,235,271,73,35,38,63,34,29,12,4,8,+7,+4,+3,71%,70%,71%,164,154,175,29%,30%,29%,21,10,11,14,6,8
451,https://vlr.gg/player/17343/ness,2024-10-06 10:30:00,0.94,0.99,0.97,170,149,191,51,24,27,57,29,28,23,11,12,-4,-3,-1,72%,73%,71%,120,102,139,29%,25%,32%,1,0,1,5,3,2
452,https://vlr.gg/player/26632/joliinaa,2024-10-06 10:30:00,1.06,0.67,0.87,186,204,170,55,32,23,64,31,33,29,18,11,+1,-1,+2,69%,77%,61%,121,132,109,33%,41%,24%,7,2,5,6,3,3
453,https://vlr.gg/player/24107/sarah,2024-10-06 10:30:00,0.95,0.73,0.85,155,166,144,45,25,20,64,32,32,30,24,6,-5,-4,-1,68%,77%,59%,96,105,85,31%,32%,28%,3,1,2,8,5,3
454,https://vlr.gg/player/24101/miyori,2024-10-06 10:30:00,0.74,0.68,0.71,158,184,128,44,26,18,67,36,31,8,2,6,-3,-1,-2,58%,59%,56%,112,126,97,32%,31%,34%,8,6,2,11,7,4
455,https://vlr.gg/player/8156/mojo,2024-10-06 09:50:00,1.52,0.39,1.02,202,274,113,30,24,6,32,15,17,10,5,5,-2,0,-2,60%,79%,37%,135,175,84,22%,24%,17%,5,4,1,7,4,3
456,https://vlr.gg/player/43408/garv,2024-10-06 09:50:00,1.16,0.77,0.99,214,225,187,30,19,11,32,15,17,14,8,6,+4,+2,+2,70%,83%,53%,127,140,111,48%,36%,74%,6,2,4,2,0,2
457,https://vlr.gg/player/18702/deadly10,2024-10-06 09:50:00,0.99,0.89,0.94,206,207,205,32,18,14,35,17,18,3,2,1,-3,-2,-1,70%,75%,63%,139,131,150,36%,37%,35%,6,5,1,9,7,2
458,https://vlr.gg/player/48426/ghostxd,2024-10-06 09:50:00,1.12,0.23,0.73,175,238,94,23,18,5,36,18,18,18,15,3,-2,0,-2,70%,88%,47%,110,146,64,28%,40%,11%,1,0,1,3,0,3
459,https://vlr.gg/player/44919/aplycs,2024-10-06 09:50:00,0.65,0.69,0.66,156,138,187,23,12,11,37,18,19,9,5,4,-2,-2,0,70%,79%,58%,104,95,115,40%,39%,41%,1,0,1,3,2,1
460,https://vlr.gg/player/3628/deathmaker,2024-10-06 09:50:00,1.46,1.14,1.28,229,257,204,37,19,18,23,8,15,8,4,4,0,-1,+1,72%,74%,71%,160,176,148,29%,26%,31%,4,1,3,4,2,2
461,https://vlr.gg/player/13221/azys,2024-10-06 09:50:00,1.22,1.14,1.18,260,265,249,41,19,22,30,13,17,7,4,3,+4,+3,+1,79%,89%,71%,161,174,151,33%,37%,30%,6,4,2,2,1,1
462,https://vlr.gg/player/3269/antidote,2024-10-06 09:50:00,1.36,0.86,1.08,175,146,200,27,10,17,24,5,19,20,12,8,+1,0,+1,84%,95%,75%,107,83,127,25%,13%,35%,4,1,3,3,1,2
463,https://vlr.gg/player/18704/levi,2024-10-06 09:50:00,1.44,0.76,1.06,226,249,204,32,18,14,30,10,20,14,5,9,0,+2,-2,72%,89%,58%,151,166,140,33%,42%,27%,4,2,2,4,0,4
464,https://vlr.gg/player/12947/rawfiul,2024-10-06 09:50:00,1.57,0.45,0.94,215,314,144,35,23,12,31,11,20,9,5,4,0,-1,+1,70%,95%,50%,146,217,90,29%,46%,11%,6,3,3,6,4,2
465,https://vlr.gg/player/27775/techno,2024-10-06 07:30:00,1.88,1.40,1.62,322,370,289,51,28,23,29,12,17,11,2,9,+5,+3,+2,82%,90%,75%,201,231,175,37%,36%,39%,10,4,6,5,1,4
466,https://vlr.gg/player/30693/makaveli,2024-10-06 07:30:00,0.94,1.03,0.99,178,181,170,28,13,15,28,13,15,9,4,5,-1,-2,+1,80%,80%,79%,132,140,125,25%,22%,28%,3,1,2,4,3,1
467,https://vlr.gg/player/3639/hoax,2024-10-06 07:30:00,0.96,0.88,0.92,165,161,163,27,12,15,29,12,17,11,7,4,-1,-1,0,68%,70%,67%,115,110,120,32%,31%,33%,0,0,0,1,1,0
468,https://vlr.gg/player/26376/deecee,2024-10-06 07:30:00,0.87,0.82,0.85,177,177,182,27,12,15,31,13,18,10,5,5,0,0,0,61%,65%,58%,119,116,121,33%,31%,34%,8,4,4,8,4,4
469,https://vlr.gg/player/3627/hellff,2024-10-06 07:30:00,0.79,0.87,0.84,154,120,180,22,8,14,30,13,17,14,6,8,+1,+2,-1,70%,85%,58%,106,89,121,31%,45%,24%,3,2,1,2,0,2
470,https://vlr.gg/player/30286/karam1l,2024-10-06 07:30:00,1.65,1.38,1.53,287,293,285,47,28,19,29,14,15,6,2,4,+5,+2,+3,75%,75%,75%,197,200,193,36%,37%,36%,8,4,4,3,2,1
471,https://vlr.gg/player/14208/kishi,2024-10-06 07:30:00,1.10,0.99,1.05,187,178,205,31,15,16,30,15,15,10,8,2,0,+2,-2,70%,79%,60%,130,120,142,36%,31%,44%,2,2,0,2,0,2
472,https://vlr.gg/player/23931/kata,2024-10-06 07:30:00,0.81,0.72,0.76,183,219,141,28,18,10,35,20,15,5,4,1,-2,-2,0,59%,67%,50%,119,146,87,28%,27%,31%,8,4,4,10,6,4
473,https://vlr.gg/player/41834/panda,2024-10-06 07:30:00,0.76,0.69,0.73,137,139,126,21,12,9,28,16,12,10,6,4,-4,-2,-2,66%,75%,55%,94,100,86,41%,50%,30%,0,0,0,4,2,2
474,https://vlr.gg/player/4089/doxz3r,2024-10-06 07:30:00,0.73,0.71,0.72,172,168,172,20,11,9,33,17,16,16,9,7,-3,-2,-1,66%,63%,70%,123,128,116,28%,26%,30%,2,1,1,5,3,2
475,https://vlr.gg/player/48223/xmeinn,2024-10-06 07:00:00,,,,288,,,36,,,17,,,14,,,,,,,,,,,,,,,,,,,,
476,https://vlr.gg/player/48226/ayu,2024-10-06 07:00:00,,,,250,,,34,,,18,,,7,,,,,,,,,,,,,,,,,,,,
477,https://vlr.gg/player/48225/147,2024-10-06 07:00:00,,,,229,,,31,,,17,,,21,,,,,,,,,,,,,,,,,,,,
478,https://vlr.gg/player/41218/s1eeepy,2024-10-06 07:00:00,,,,225,,,25,,,20,,,26,,,,,,,,,,,,,,,,,,,,
479,https://vlr.gg/player/48224/peterpan,2024-10-06 07:00:00,,,,225,,,25,,,22,,,10,,,,,,,,,,,,,,,,,,,,
480,https://vlr.gg/player/48229/we1v,2024-10-06 07:00:00,,,,205,,,25,,,29,,,7,,,,,,,,,,,,,,,,,,,,
481,https://vlr.gg/player/48227/p1katong,2024-10-06 07:00:00,,,,203,,,21,,,32,,,5,,,,,,,,,,,,,,,,,,,,
482,https://vlr.gg/player/48228/caktttly,2024-10-06 07:00:00,,,,185,,,22,,,29,,,2,,,,,,,,,,,,,,,,,,,,
483,https://vlr.gg/player/48231/3one,2024-10-06 07:00:00,,,,140,,,16,,,30,,,12,,,,,,,,,,,,,,,,,,,,
484,https://vlr.gg/player/48230/hearing,2024-10-06 07:00:00,,,,106,,,10,,,32,,,9,,,,,,,,,,,,,,,,,,,,
485,https://vlr.gg/player/48167/xiaolan,2024-10-06 05:00:00,,,,380,,,51,,,35,,,9,,,,,,,,,,,,,,,,,,,,
486,https://vlr.gg/player/30334/yang,2024-10-06 05:00:00,,,,272,,,39,,,24,,,23,,,,,,,,,,,,,,,,,,,,
487,https://vlr.gg/player/48168/zora,2024-10-06 05:00:00,,,,203,,,33,,,23,,,4,,,,,,,,,,,,,,,,,,,,
488,https://vlr.gg/player/48170/anan,2024-10-06 05:00:00,,,,168,,,25,,,21,,,23,,,,,,,,,,,,,,,,,,,,
489,https://vlr.gg/player/48169/jennie,2024-10-06 05:00:00,,,,122,,,19,,,26,,,8,,,,,,,,,,,,,,,,,,,,
490,https://vlr.gg/player/48164/tulip,2024-10-06 05:00:00,,,,199,,,29,,,36,,,12,,,,,,,,,,,,,,,,,,,,
491,https://vlr.gg/player/48163/wene,2024-10-06 05:00:00,,,,188,,,27,,,28,,,12,,,,,,,,,,,,,,,,,,,,
492,https://vlr.gg/player/48165/leilei,2024-10-06 05:00:00,,,,173,,,22,,,37,,,11,,,,,,,,,,,,,,,,,,,,
493,https://vlr.gg/player/48162/k1ssme,2024-10-06 05:00:00,,,,172,,,27,,,34,,,7,,,,,,,,,,,,,,,,,,,,
494,https://vlr.gg/player/48166/yaya,2024-10-06 05:00:00,,,,134,,,23,,,32,,,16,,,,,,,,,,,,,,,,,,,,
495,https://vlr.gg/player/16621/alexy,2024-10-06 02:00:00,1.49,2.02,1.75,311,243,381,62,23,39,21,12,9,22,14,8,+3,+1,+2,91%,89%,93%,208,161,255,27%,23%,30%,8,4,4,5,3,2
496,https://vlr.gg/player/18091/shirazi,2024-10-06 02:00:00,1.30,1.40,1.35,230,207,240,46,21,25,22,11,11,19,10,9,0,-3,+3,85%,78%,93%,137,127,148,15%,9%,23%,3,0,3,3,3,0
497,https://vlr.gg/player/18093/kamiyu,2024-10-06 02:00:00,1.34,1.08,1.21,223,249,191,39,23,16,30,15,15,35,18,17,+1,-1,+2,81%,85%,78%,142,157,127,29%,36%,22%,6,2,4,5,3,2
498,https://vlr.gg/player/8492/tara,2024-10-06 02:00:00,1.23,1.09,1.16,186,227,151,40,24,16,25,14,11,16,10,6,+3,+1,+2,81%,81%,81%,127,158,95,26%,24%,28%,4,1,3,1,0,1
499,https://vlr.gg/player/8176/enerii,2024-10-06 02:00:00,1.10,1.06,1.08,210,246,171,39,23,16,30,17,13,14,6,8,-1,-1,0,76%,70%,81%,131,156,105,24%,28%,18%,9,5,4,10,6,4
500,https://vlr.gg/player/29314/moco,2024-10-06 02:00:00,1.02,0.88,0.95,188,211,163,32,19,13,41,21,20,16,8,8,-1,-1,0,57%,56%,59%,123,134,112,22%,21%,22%,6,2,4,7,3,4
501,https://vlr.gg/player/10653/suzu,2024-10-06 02:00:00,0.79,0.96,0.87,192,183,218,35,16,19,47,23,24,12,6,6,-1,-7,+6,59%,48%,70%,136,125,147,21%,25%,17%,9,2,7,10,9,1
502,https://vlr.gg/player/39902/ur,2024-10-06 02:00:00,0.56,0.93,0.75,153,110,207,26,9,17,46,23,23,14,4,10,-2,0,-2,48%,41%,56%,116,85,147,19%,14%,23%,3,2,1,5,2,3
503,https://vlr.gg/player/29316/aco,2024-10-06 02:00:00,0.45,0.55,0.49,89,77,112,17,6,11,46,22,24,17,7,10,-3,-3,0,57%,48%,67%,59,53,65,17%,10%,23%,1,0,1,4,3,1
504,https://vlr.gg/player/39904/serena,2024-10-06 02:00:00,0.57,0.39,0.48,101,121,93,18,9,9,46,23,23,5,3,2,+1,+2,-1,50%,56%,44%,69,80,57,26%,34%,16%,5,3,2,4,1,3
0,https://vlr.gg/player/12593/felix,2024-10-05 13:00:00,1.39,1.46,1.42,258,257,268,61,30,31,44,25,19,32,17,15,+5,+3,+2,83%,78%,88%,177,170,184,25%,26%,23%,7,4,3,2,1,1
1,https://vlr.gg/player/122/luckerrr,2024-10-05 13:00:00,1.01,1.24,1.12,219,200,232,54,26,28,44,24,20,10,6,4,+2,-1,+3,77%,81%,73%,155,145,166,22%,21%,24%,6,2,4,4,3,1
2,https://vlr.gg/player/20302/jini,2024-10-05 13:00:00,0.99,0.92,0.95,168,172,165,41,22,19,45,23,22,29,17,12,-2,-1,-1,72%,72%,73%,116,120,112,21%,22%,20%,3,1,2,5,2,3
3,https://vlr.gg/player/7968/stavinci,2024-10-05 13:00:00,0.84,1.00,0.92,158,152,157,39,22,17,49,27,22,46,20,26,-3,-2,-1,72%,67%,79%,101,101,101,30%,35%,26%,3,1,2,6,3,3
4,https://vlr.gg/player/7987/kovaq,2024-10-05 13:00:00,0.96,0.67,0.82,206,237,173,50,30,20,56,28,28,9,4,5,+3,+1,+2,65%,67%,64%,132,150,112,25%,24%,26%,18,10,8,15,9,6
5,https://vlr.gg/player/27954/movi,2024-10-05 13:00:00,1.58,1.06,1.31,241,269,219,61,32,29,47,19,28,29,18,11,+4,+2,+2,84%,91%,78%,158,172,146,27%,24%,31%,6,2,4,2,0,2
6,https://vlr.gg/player/12514/spocki,2024-10-05 13:00:00,0.75,1.33,1.06,185,130,243,47,15,32,47,24,23,32,21,11,-3,-3,0,74%,73%,75%,120,81,156,33%,26%,38%,4,1,3,7,4,3
7,https://vlr.gg/player/39062/terrox,2024-10-05 13:00:00,1.02,0.90,0.96,172,149,182,40,19,21,45,20,25,17,7,10,-1,0,-1,70%,73%,67%,120,106,133,28%,30%,27%,3,1,2,4,1,3
8,https://vlr.gg/player/15382/kongi,2024-10-05 13:00:00,1.15,0.74,0.94,188,220,172,44,24,20,49,21,28,19,14,5,+1,-2,+3,70%,82%,58%,129,151,109,31%,28%,35%,8,2,6,7,4,3
9,https://vlr.gg/player/27813/zery,2024-10-05 13:00:00,0.64,0.90,0.77,194,204,195,46,21,25,57,31,26,16,7,9,-6,-2,-4,59%,58%,61%,136,141,132,25%,25%,24%,11,8,3,17,10,7
10,https://vlr.gg/player/30877/lilboii,2024-10-05 11:10:00,0.94,0.77,0.85,172,183,165,21,11,10,28,13,15,13,7,6,-1,-1,0,57%,56%,58%,119,116,123,26%,31%,22%,2,0,2,3,1,2
11,https://vlr.gg/player/19231/kibojn,2024-10-05 11:10:00,0.83,0.77,0.80,167,199,137,20,12,8,31,15,16,11,3,8,-1,-1,0,51%,61%,42%,110,117,103,39%,46%,33%,1,0,1,2,1,1
12,https://vlr.gg/player/3271/excali,2024-10-05 11:10:00,0.91,0.66,0.78,184,193,177,23,12,11,29,13,16,2,0,2,+1,+1,0,49%,50%,47%,109,108,111,28%,13%,46%,8,4,4,7,3,4
13,https://vlr.gg/player/3281/psy,2024-10-05 11:10:00,0.56,0.90,0.74,175,135,213,21,7,14,28,13,15,9,6,3,-3,-4,+1,62%,56%,68%,107,86,126,20%,17%,23%,2,0,2,5,4,1
14,https://vlr.gg/player/5541/tryst,2024-10-05 11:10:00,0.58,0.61,0.60,121,93,149,16,6,10,29,13,16,6,4,2,-3,-1,-2,51%,50%,53%,87,73,100,43%,32%,52%,2,2,0,5,3,2
15,https://vlr.gg/player/30575/r1sen,2024-10-05 11:10:00,1.64,1.31,1.48,239,275,200,35,20,15,16,8,8,11,9,2,+4,+4,0,84%,89%,78%,145,151,139,31%,30%,32%,4,4,0,0,0,0
16,https://vlr.gg/player/43389/yash,2024-10-05 11:10:00,1.21,1.62,1.41,298,254,348,39,18,21,23,11,12,9,4,5,+4,-1,+5,81%,79%,83%,203,168,239,29%,26%,31%,7,1,6,3,2,1
17,https://vlr.gg/player/22054/wave,2024-10-05 11:10:00,1.11,1.27,1.19,181,166,199,27,13,14,19,10,9,9,3,6,0,-1,+1,73%,74%,72%,114,111,118,47%,48%,45%,4,1,3,4,2,2
18,https://vlr.gg/player/27755/icarus,2024-10-05 11:10:00,1.18,0.85,1.02,188,249,127,23,16,7,20,11,9,11,5,6,0,+1,-1,76%,89%,61%,134,170,96,26%,27%,23%,3,3,0,3,2,1
19,https://vlr.gg/player/4085/near,2024-10-05 11:10:00,0.84,1.00,0.92,153,159,145,21,11,10,23,13,10,7,5,2,-1,-2,+1,59%,58%,61%,101,97,106,32%,25%,41%,4,1,3,5,3,2
20,https://vlr.gg/player/13238/shiio,2024-10-05 11:00:00,1.29,1.81,1.58,245,206,286,38,15,23,17,10,7,11,3,8,+4,0,+4,87%,76%,95%,176,149,198,23%,27%,20%,5,1,4,1,1,0
21,https://vlr.gg/player/47270/darkwinjett,2024-10-05 11:00:00,1.45,1.15,1.28,268,343,216,37,20,17,25,13,12,9,2,7,-1,-2,+1,77%,59%,91%,181,229,145,24%,30%,18%,6,3,3,7,5,2
22,https://vlr.gg/player/20032/treelover,2024-10-05 11:00:00,0.78,1.67,1.28,233,165,286,34,10,24,23,12,11,19,6,13,+1,-1,+2,82%,65%,95%,146,100,182,29%,31%,28%,5,2,3,4,3,1
23,https://vlr.gg/player/2540/happen,2024-10-05 11:00:00,1.09,1.31,1.21,203,170,226,28,11,17,18,9,9,16,5,11,+1,0,+1,82%,71%,91%,137,120,151,16%,14%,17%,2,0,2,1,0,1
24,https://vlr.gg/player/3649/litshii,2024-10-05 11:00:00,0.72,1.45,1.13,211,140,254,28,7,21,24,14,10,29,10,19,0,-2,+2,90%,82%,95%,132,93,162,16%,18%,16%,4,0,4,4,2,2
25,https://vlr.gg/player/5810/kryo,2024-10-05 11:00:00,0.73,1.96,1.27,207,116,339,31,9,22,27,18,9,10,5,5,+1,-2,+3,64%,45%,88%,143,85,218,35%,28%,40%,5,1,4,4,3,1
26,https://vlr.gg/player/31377/allthewaypat,2024-10-05 11:00:00,0.80,0.75,0.78,165,164,185,22,12,10,35,20,15,12,5,7,-2,-1,-1,67%,64%,71%,114,105,125,31%,35%,26%,0,0,0,2,1,1
27,https://vlr.gg/player/9143/darkosek,2024-10-05 11:00:00,0.41,0.88,0.62,145,101,212,18,7,11,34,20,14,12,4,8,+1,-1,+2,59%,50%,71%,105,70,151,21%,18%,22%,2,0,2,1,1,0
28,https://vlr.gg/player/31313/geneticzz,2024-10-05 11:00:00,0.58,0.63,0.60,153,176,125,20,13,7,33,22,11,4,2,2,-2,-3,+1,56%,50%,65%,95,109,76,47%,48%,44%,2,1,1,4,4,0
29,https://vlr.gg/player/19505/szalony,2024-10-05 11:00:00,0.28,0.45,0.35,128,117,144,16,8,8,36,22,14,3,1,2,-3,-3,0,49%,41%,59%,81,67,98,25%,24%,27%,8,4,4,11,7,4
30,https://vlr.gg/player/1770/wat,2024-10-05 07:30:00,1.19,1.37,1.27,238,216,266,57,26,31,48,27,21,31,14,17,+5,+1,+4,78%,69%,88%,153,149,158,25%,29%,21%,9,3,6,4,2,2
31,https://vlr.gg/player/12323/rvk,2024-10-05 07:30:00,0.78,1.24,1.00,176,160,202,45,19,26,46,28,18,16,4,12,-3,-2,-1,65%,58%,72%,120,108,134,28%,31%,24%,2,2,0,5,4,1
32,https://vlr.gg/player/3502/ri0,2024-10-05 07:30:00,0.66,1.35,0.99,197,156,247,43,20,23,50,32,18,23,4,19,+4,+2,+2,74%,64%,84%,130,92,173,24%,27%,23%,7,3,4,3,1,2
33,https://vlr.gg/player/46121/marcai,2024-10-05 07:30:00,0.57,1.19,0.86,212,178,249,52,22,30,54,32,22,12,3,9,-3,-5,+2,65%,53%,78%,140,121,161,23%,23%,23%,15,7,8,18,12,6
34,https://vlr.gg/player/40057/batman,2024-10-05 07:30:00,0.55,0.91,0.72,127,132,119,33,16,17,51,32,19,18,10,8,-5,-2,-3,66%,58%,75%,86,88,84,31%,23%,42%,0,0,0,5,2,3
35,https://vlr.gg/player/46104/envy2k,2024-10-05 07:30:00,0.78,1.72,1.28,302,240,352,69,24,45,51,28,23,17,7,10,0,-4,+4,69%,56%,81%,192,151,229,18%,21%,16%,16,7,9,16,11,5
36,https://vlr.gg/player/5009/wstvirginia,2024-10-05 07:30:00,1.19,1.37,1.28,249,256,248,61,28,33,45,25,20,19,7,12,+5,+2,+3,75%,72%,78%,164,175,154,36%,36%,36%,10,4,6,5,2,3
37,https://vlr.gg/player/31355/acestarrrrr,2024-10-05 07:30:00,0.94,1.21,1.08,202,175,225,48,18,30,44,24,20,32,15,17,+3,0,+3,78%,75%,81%,130,121,137,23%,20%,25%,5,1,4,2,1,1
38,https://vlr.gg/player/17294/hybr1d,2024-10-05 07:30:00,0.70,1.03,0.87,160,155,170,40,17,23,46,26,20,23,10,13,-7,-4,-3,72%,66%,78%,110,106,114,25%,25%,26%,1,0,1,8,4,4
39,https://vlr.gg/player/45484/max,2024-10-05 07:30:00,0.58,0.99,0.80,146,108,179,31,11,20,44,24,20,22,6,16,+1,+2,-1,72%,59%,83%,102,79,122,28%,34%,25%,3,2,1,2,0,2
40,https://vlr.gg/player/48150/yuyoo,2024-10-05 07:25:00,,,,169,,,18,,,27,,,2,,,,,,,,,,,,,,,,,,,,
41,https://vlr.gg/player/48146/ko,2024-10-05 07:25:00,,,,133,,,14,,,28,,,5,,,,,,,,,,,,,,,,,,,,
42,https://vlr.gg/player/48148/kihane,2024-10-05 07:25:00,,,,117,,,13,,,30,,,6,,,,,,,,,,,,,,,,,,,,
43,https://vlr.gg/player/48149/rain,2024-10-05 07:25:00,,,,112,,,12,,,29,,,2,,,,,,,,,,,,,,,,,,,,
44,https://vlr.gg/player/48147/kotoza,2024-10-05 07:25:00,,,,95,,,8,,,28,,,7,,,,,,,,,,,,,,,,,,,,
45,https://vlr.gg/player/48156/yumiiurx,2024-10-05 07:25:00,,,,287,,,36,,,15,,,5,,,,,,,,,,,,,,,,,,,,
46,https://vlr.gg/player/39397/7wyy,2024-10-05 07:25:00,,,,281,,,32,,,15,,,15,,,,,,,,,,,,,,,,,,,,
47,https://vlr.gg/player/48159/yyni,2024-10-05 07:25:00,,,,237,,,29,,,11,,,9,,,,,,,,,,,,,,,,,,,,
48,https://vlr.gg/player/48157/kiaki,2024-10-05 07:25:00,,,,207,,,27,,,12,,,7,,,,,,,,,,,,,,,,,,,,
49,https://vlr.gg/player/48158/xkb,2024-10-05 07:25:00,,,,164,,,18,,,13,,,20,,,,,,,,,,,,,,,,,,,,
50,https://vlr.gg/player/40423/bibi,2024-10-05 05:40:00,1.12,1.22,1.18,239,220,255,50,21,29,46,19,27,24,2,22,-3,-4,+1,80%,65%,91%,153,142,162,24%,28%,21%,5,1,4,8,5,3
51,https://vlr.gg/player/46170/dorothy,2024-10-05 05:40:00,0.94,1.16,1.07,203,204,208,42,17,25,42,20,22,17,7,10,-4,-3,-1,79%,77%,80%,144,144,144,23%,21%,24%,5,1,4,9,4,5
52,https://vlr.gg/player/40151/h4ste,2024-10-05 05:40:00,0.52,1.35,1.00,209,125,273,44,10,34,44,22,22,30,13,17,0,-3,+3,85%,77%,91%,134,86,170,26%,29%,25%,8,3,5,8,6,2
53,https://vlr.gg/player/40410/332,2024-10-05 05:40:00,1.01,0.92,0.96,205,244,188,47,23,24,47,23,24,5,1,4,+2,-1,+3,70%,65%,74%,132,151,117,27%,28%,27%,6,1,5,4,2,2
54,https://vlr.gg/player/40556/f1yk,2024-10-05 05:40:00,0.50,0.70,0.62,131,112,144,27,9,18,46,21,25,15,7,8,-4,-3,-1,62%,62%,63%,91,87,95,30%,31%,29%,2,0,2,6,3,3
55,https://vlr.gg/player/29314/moco,2024-10-05 05:40:00,1.24,1.52,1.36,245,245,250,53,29,24,37,23,14,18,14,4,0,-4,+4,74%,66%,85%,149,143,156,17%,15%,21%,4,0,4,4,4,0
56,https://vlr.gg/player/39902/ur,2024-10-05 05:40:00,1.22,1.33,1.27,239,226,242,52,29,23,39,25,14,19,12,7,+7,+1,+6,67%,66%,69%,156,159,151,24%,27%,21%,8,2,6,1,1,0
57,https://vlr.gg/player/39904/serena,2024-10-05 05:40:00,1.05,1.14,1.09,220,204,236,51,28,23,42,25,17,10,6,4,+2,0,+2,70%,71%,69%,140,129,155,25%,24%,26%,6,2,4,4,2,2
58,https://vlr.gg/player/10653/suzu,2024-10-05 05:40:00,0.63,1.03,0.80,197,189,206,37,19,18,47,31,16,15,5,10,-1,-1,0,72%,66%,81%,139,130,151,24%,28%,20%,11,8,3,12,9,3
59,https://vlr.gg/player/29316/aco,2024-10-05 05:40:00,0.65,0.97,0.79,153,124,196,32,15,17,45,26,19,35,17,18,+1,-1,+2,77%,66%,92%,94,77,116,21%,16%,26%,6,3,3,5,4,1
60,https://vlr.gg/player/17523/yue,2024-10-05 05:00:00,,,,309,,,48,,,33,,,10,,,,,,,,,,,,,,,,,,,,
61,https://vlr.gg/player/48139/amei,2024-10-05 05:00:00,,,,257,,,40,,,30,,,22,,,,,,,,,,,,,,,,,,,,
62,https://vlr.gg/player/48140/yzy,2024-10-05 05:00:00,,,,205,,,32,,,31,,,18,,,,,,,,,,,,,,,,,,,,
63,https://vlr.gg/player/41209/jacketzz,2024-10-05 05:00:00,,,,202,,,34,,,23,,,12,,,,,,,,,,,,,,,,,,,,
64,https://vlr.gg/player/41210/yc33,2024-10-05 05:00:00,,,,153,,,27,,,23,,,18,,,,,,,,,,,,,,,,,,,,
65,https://vlr.gg/player/8129/chloettw,2024-10-05 05:00:00,,,,270,,,21,,,16,,,2,,,,,,,,,,,,,,,,,,,,
66,https://vlr.gg/player/48143/candice,2024-10-05 05:00:00,,,,210,,,32,,,36,,,19,,,,,,,,,,,,,,,,,,,,
67,https://vlr.gg/player/48141/seaweed,2024-10-05 05:00:00,,,,187,,,28,,,36,,,8,,,,,,,,,,,,,,,,,,,,
68,https://vlr.gg/player/48145/q1ngy,2024-10-05 05:00:00,,,,167,,,21,,,40,,,19,,,,,,,,,,,,,,,,,,,,
69,https://vlr.gg/player/48144/huanki,2024-10-05 05:00:00,,,,155,,,26,,,35,,,8,,,,,,,,,,,,,,,,,,,,
70,https://vlr.gg/player/48388/celeste,2024-10-05 05:00:00,,,,147,,,12,,,18,,,2,,,,,,,,,,,,,,,,,,,,
71,https://vlr.gg/player/16621/alexy,2024-10-05 02:00:00,1.28,1.45,1.35,241,219,266,64,33,31,41,23,18,18,8,10,+4,+1,+3,82%,78%,88%,162,152,175,37%,35%,39%,8,3,5,4,2,2
72,https://vlr.gg/player/8176/enerii,2024-10-05 02:00:00,1.08,1.29,1.18,300,305,276,73,41,32,60,38,22,18,9,9,+4,-1,+5,74%,68%,81%,183,185,181,31%,36%,25%,20,11,9,16,12,4
73,https://vlr.gg/player/18091/shirazi,2024-10-05 02:00:00,1.10,1.22,1.15,194,188,206,46,21,25,37,22,15,31,19,12,+1,0,+1,82%,80%,84%,143,144,142,24%,30%,18%,4,2,2,3,2,1
74,https://vlr.gg/player/18093/kamiyu,2024-10-05 02:00:00,1.05,1.11,1.07,216,200,213,54,30,24,49,27,22,35,16,19,-3,-2,-1,74%,65%,84%,137,129,147,31%,25%,38%,4,2,2,7,4,3
75,https://vlr.gg/player/8492/tara,2024-10-05 02:00:00,0.84,0.62,0.74,131,132,140,31,17,14,51,26,25,39,25,14,-4,-2,-2,78%,88%,66%,96,97,96,26%,27%,25%,1,0,1,5,2,3
76,https://vlr.gg/player/25388/kon,2024-10-05 02:00:00,1.16,1.09,1.12,219,244,208,56,26,30,53,25,28,12,3,9,-2,-2,0,76%,75%,78%,157,185,135,35%,35%,34%,5,1,4,7,3,4
77,https://vlr.gg/player/45029/grahams,2024-10-05 02:00:00,0.98,1.12,1.06,206,194,226,53,22,31,52,24,28,19,6,13,+2,0,+2,68%,63%,73%,135,125,142,32%,35%,29%,8,4,4,6,4,2
78,https://vlr.gg/player/26069/piety,2024-10-05 02:00:00,0.64,1.10,0.90,192,147,232,45,15,30,55,26,29,19,7,12,+7,0,+7,63%,59%,65%,127,100,149,28%,30%,28%,13,3,10,6,3,3
79,https://vlr.gg/player/16635/poly,2024-10-05 02:00:00,0.82,0.85,0.84,170,167,180,45,20,25,54,25,29,13,9,4,-4,-1,-3,64%,66%,63%,116,108,122,29%,21%,35%,4,2,2,8,3,5
80,https://vlr.gg/player/18062/capricious,2024-10-05 02:00:00,0.84,0.73,0.77,146,171,139,39,20,19,55,26,29,16,5,11,-5,-3,-2,61%,47%,73%,97,112,85,29%,33%,25%,5,3,2,10,6,4
81,https://vlr.gg/player/8834/bucher,2024-10-04 14:30:00,1.22,1.27,1.24,219,220,190,45,27,18,34,24,10,24,17,7,-1,+1,-2,75%,73%,78%,138,150,119,41%,36%,52%,6,3,3,7,2,5
82,https://vlr.gg/player/2052/kuba,2024-10-04 14:30:00,1.22,1.28,1.24,212,210,207,46,29,17,37,24,13,18,10,8,+2,-1,+3,78%,73%,87%,135,134,137,40%,33%,51%,5,1,4,3,2,1
83,https://vlr.gg/player/5292/al0rante,2024-10-04 14:30:00,0.99,1.14,1.05,224,209,221,47,28,19,41,26,15,9,3,6,-1,+1,-2,68%,59%,83%,137,132,145,52%,57%,45%,6,6,0,7,5,2
84,https://vlr.gg/player/4244/yaboilewis,2024-10-04 14:30:00,0.65,1.63,1.02,199,168,287,46,22,24,41,29,12,13,7,6,-9,-8,-1,70%,59%,87%,140,108,193,44%,42%,47%,3,2,1,12,10,2
85,https://vlr.gg/player/23237/unfair,2024-10-04 14:30:00,0.90,1.23,1.02,221,194,246,43,24,19,41,27,14,13,7,6,-1,-2,+1,72%,65%,83%,142,128,165,33%,37%,29%,5,2,3,6,4,2
86,https://vlr.gg/player/35513/samed,2024-10-04 14:30:00,1.17,0.90,0.99,215,241,225,45,20,25,48,19,29,19,5,14,+5,+2,+3,68%,70%,68%,145,146,145,22%,27%,19%,13,5,8,8,3,5
87,https://vlr.gg/player/7231/kya,2024-10-04 14:30:00,0.52,1.23,0.96,175,105,225,38,8,30,42,19,23,20,8,12,+2,-1,+3,72%,61%,78%,127,80,157,28%,24%,30%,4,0,4,2,1,1
88,https://vlr.gg/player/2832/patix,2024-10-04 14:30:00,0.21,1.31,0.87,192,71,255,44,6,38,45,19,26,9,3,6,+3,-2,+5,67%,43%,81%,116,41,162,61%,33%,67%,6,0,6,3,2,1
89,https://vlr.gg/player/12381/wanted,2024-10-04 14:30:00,1.05,0.58,0.76,154,223,128,35,18,17,47,19,28,16,9,7,+2,+3,-1,63%,78%,54%,108,148,83,28%,26%,31%,7,4,3,5,1,4
90,https://vlr.gg/player/18374/sevkaan,2024-10-04 14:30:00,0.59,0.85,0.74,143,162,149,32,12,20,45,21,24,8,3,5,-2,-1,-1,62%,65%,59%,109,113,107,20%,20%,20%,5,3,2,7,4,3
91,https://vlr.gg/player/27789/deyten,2024-10-04 12:00:00,1.42,1.18,1.31,210,228,187,35,21,14,24,13,11,9,4,5,+1,-1,+2,80%,77%,84%,154,159,149,36%,31%,44%,3,1,2,2,2,0
92,https://vlr.gg/player/7991/hyperr,2024-10-04 12:00:00,1.19,1.12,1.16,209,213,202,29,17,12,27,16,11,22,10,12,0,-1,+1,80%,77%,84%,134,133,135,16%,15%,16%,5,2,3,5,3,2
93,https://vlr.gg/player/45494/proxh,2024-10-04 12:00:00,0.59,1.80,1.15,238,164,318,33,10,23,28,19,9,13,8,5,+1,0,+1,71%,59%,84%,163,112,223,21%,15%,26%,6,3,3,5,3,2
94,https://vlr.gg/player/22518/mimori,2024-10-04 12:00:00,1.00,1.22,1.10,211,195,235,31,15,16,28,16,12,14,8,6,+5,+1,+4,71%,59%,84%,151,150,153,38%,44%,32%,5,1,4,0,0,0
95,https://vlr.gg/player/33974/appa,2024-10-04 12:00:00,1.00,0.93,0.97,198,220,170,31,18,13,28,17,11,9,6,3,-2,-1,-1,76%,77%,74%,135,146,123,25%,34%,17%,4,3,1,6,4,2
96,https://vlr.gg/player/30764/serenity,2024-10-04 12:00:00,1.38,1.00,1.18,251,285,232,39,20,19,32,14,18,2,0,2,+6,+2,+4,59%,58%,59%,168,192,147,25%,40%,14%,12,5,7,6,3,3
97,https://vlr.gg/player/22381/s-mplex,2024-10-04 12:00:00,1.28,0.98,1.12,229,241,213,32,16,16,32,14,18,13,4,9,0,-1,+1,78%,79%,77%,145,151,140,26%,36%,18%,2,0,2,2,1,1
98,https://vlr.gg/player/3924/sh0utyy,2024-10-04 12:00:00,0.56,1.19,0.90,163,99,214,23,6,17,30,16,14,16,7,9,-1,-1,0,73%,74%,73%,98,66,125,26%,32%,24%,1,0,1,2,1,1
99,https://vlr.gg/player/33732/nunmeister,2024-10-04 12:00:00,0.60,1.07,0.85,212,162,256,28,10,18,31,16,15,11,5,6,-6,-4,-2,61%,53%,68%,137,101,168,31%,27%,34%,3,1,2,9,5,4
100,https://vlr.gg/player/33875/spexleon,2024-10-04 12:00:00,0.08,0.82,0.46,112,51,164,13,2,11,34,18,16,14,5,9,-4,-3,-1,56%,47%,64%,88,41,129,39%,23%,44%,0,0,0,4,3,1
101,https://vlr.gg/player/48171/nana,2024-10-04 07:00:00,,,,334,,,85,,,55,,,11,,,,,,,,,,,,,,,,,,,,
102,https://vlr.gg/player/48172/nio,2024-10-04 07:00:00,,,,242,,,61,,,46,,,41,,,,,,,,,,,,,,,,,,,,
103,https://vlr.gg/player/48173/elf,2024-10-04 07:00:00,,,,207,,,53,,,54,,,24,,,,,,,,,,,,,,,,,,,,
104,https://vlr.gg/player/48175/bot,2024-10-04 07:00:00,,,,175,,,43,,,50,,,20,,,,,,,,,,,,,,,,,,,,
105,https://vlr.gg/player/48174/sa1t,2024-10-04 07:00:00,,,,131,,,30,,,53,,,32,,,,,,,,,,,,,,,,,,,,
106,https://vlr.gg/player/48228/caktttly,2024-10-04 07:00:00,,,,233,,,64,,,48,,,17,,,,,,,,,,,,,,,,,,,,
107,https://vlr.gg/player/48227/p1katong,2024-10-04 07:00:00,,,,220,,,54,,,60,,,16,,,,,,,,,,,,,,,,,,,,
108,https://vlr.gg/player/48229/we1v,2024-10-04 07:00:00,,,,220,,,53,,,54,,,33,,,,,,,,,,,,,,,,,,,,
109,https://vlr.gg/player/48231/3one,2024-10-04 07:00:00,,,,191,,,46,,,52,,,31,,,,,,,,,,,,,,,,,,,,
110,https://vlr.gg/player/48230/hearing,2024-10-04 07:00:00,,,,180,,,40,,,58,,,30,,,,,,,,,,,,,,,,,,,,
111,https://vlr.gg/player/39902/ur,2024-10-04 04:00:00,1.17,1.70,1.44,273,237,313,48,21,27,35,20,15,25,10,15,+2,+1,+1,77%,73%,81%,182,163,200,29%,27%,31%,4,1,3,2,0,2
112,https://vlr.gg/player/10653/suzu,2024-10-04 04:00:00,0.96,1.64,1.30,312,258,363,56,23,33,39,21,18,12,5,7,-1,0,-1,81%,73%,88%,192,152,231,28%,27%,30%,10,6,4,11,6,5
113,https://vlr.gg/player/29316/aco,2024-10-04 04:00:00,0.82,1.06,0.94,162,128,191,30,12,18,37,18,19,29,11,18,+3,+3,0,81%,69%,92%,97,84,110,22%,22%,22%,5,4,1,2,1,1
114,https://vlr.gg/player/39904/serena,2024-10-04 04:00:00,1.41,0.46,0.93,187,259,113,33,23,10,35,14,21,10,7,3,-4,-4,0,67%,69%,65%,127,181,72,21%,22%,19%,4,1,3,8,5,3
115,https://vlr.gg/player/29314/moco,2024-10-04 04:00:00,0.79,0.89,0.84,146,151,147,25,13,12,36,19,17,27,13,14,-6,-2,-4,71%,69%,73%,102,107,97,17%,26%,10%,0,0,0,6,2,4
116,https://vlr.gg/player/8175/ayumiii,2024-10-04 04:00:00,1.04,1.45,1.24,259,245,282,49,22,27,36,19,17,18,10,8,+8,+3,+5,75%,73%,77%,172,164,180,27%,28%,26%,14,6,8,6,3,3
117,https://vlr.gg/player/16641/alluka,2024-10-04 04:00:00,0.97,1.12,1.05,204,176,241,38,18,20,39,18,21,26,9,17,+5,+2,+3,75%,69%,81%,127,114,140,24%,38%,16%,8,4,4,3,2,1
118,https://vlr.gg/player/9175/kohaibi,2024-10-04 04:00:00,0.80,0.93,0.87,184,180,183,31,16,15,39,21,18,14,7,7,-2,+1,-3,65%,58%,73%,131,127,136,25%,26%,25%,5,3,2,7,2,5
119,https://vlr.gg/player/17503/delbisky,2024-10-04 04:00:00,0.66,1.01,0.84,172,146,197,33,13,20,39,21,18,16,9,7,-1,0,-1,60%,58%,62%,114,99,128,29%,30%,28%,1,1,0,2,1,1
120,https://vlr.gg/player/16018/babytz,2024-10-04 04:00:00,0.91,0.68,0.80,185,234,134,31,21,10,39,21,18,10,2,8,-4,-2,-2,69%,69%,69%,118,138,97,30%,34%,24%,1,1,0,5,3,2
121,https://vlr.gg/player/26069/piety,2024-10-04 01:00:00,1.47,1.18,1.33,241,264,203,50,31,19,33,17,16,15,5,10,-2,+2,-4,76%,76%,77%,166,187,142,29%,33%,23%,4,3,1,6,1,5
122,https://vlr.gg/player/25388/kon,2024-10-04 01:00:00,1.32,1.18,1.25,237,239,237,46,23,23,36,16,20,17,13,4,+2,+1,+1,82%,97%,65%,157,158,155,42%,47%,37%,3,1,2,1,0,1
123,https://vlr.gg/player/45029/grahams,2024-10-04 01:00:00,0.67,1.52,1.05,262,194,312,46,19,27,41,23,18,18,9,9,+2,0,+2,75%,69%,81%,157,124,193,36%,34%,38%,11,6,5,9,6,3
124,https://vlr.gg/player/18062/capricious,2024-10-04 01:00:00,0.94,1.00,0.97,172,152,210,35,17,18,37,17,20,12,5,7,0,0,0,67%,76%,58%,129,109,150,44%,47%,42%,5,2,3,5,2,3
125,https://vlr.gg/player/16635/poly,2024-10-04 01:00:00,1.30,0.34,0.82,175,250,81,31,26,5,36,16,20,18,11,7,+1,+4,-3,67%,79%,54%,104,144,60,34%,43%,18%,6,6,0,5,2,3
126,https://vlr.gg/player/26102/bethany,2024-10-04 01:00:00,1.29,1.19,1.24,241,230,261,48,21,27,40,16,24,22,13,9,+2,+3,-1,78%,81%,76%,150,156,144,24%,29%,20%,5,4,1,3,1,2
127,https://vlr.gg/player/31579/emi,2024-10-04 01:00:00,1.31,1.04,1.16,217,241,217,46,25,21,37,16,21,12,6,6,+4,0,+4,67%,62%,72%,140,153,129,26%,26%,26%,9,3,6,5,3,2
128,https://vlr.gg/player/32533/alannah,2024-10-04 01:00:00,0.99,0.83,0.91,186,188,196,34,17,17,42,19,23,20,10,10,+2,+1,+1,65%,73%,59%,131,124,137,18%,22%,16%,4,3,1,2,2,0
129,https://vlr.gg/player/36897/ferret,2024-10-04 01:00:00,0.71,0.61,0.66,147,174,141,28,15,13,45,20,25,14,6,8,-4,0,-4,62%,69%,55%,105,114,97,32%,44%,22%,4,2,2,8,2,6
130,https://vlr.gg/player/26100/rosa,2024-10-04 01:00:00,0.73,0.56,0.63,154,185,120,27,16,11,44,21,23,11,6,5,-7,0,-7,64%,65%,62%,94,112,77,9%,9%,8%,4,3,1,11,3,8
131,https://vlr.gg/player/16018/babytz,2024-10-03 07:15:00,1.64,1.99,1.83,330,311,347,51,21,30,22,13,9,19,8,11,+4,0,+4,88%,89%,88%,228,225,231,41%,40%,43%,5,0,5,1,0,1
132,https://vlr.gg/player/16641/alluka,2024-10-03 07:15:00,1.21,1.18,1.19,248,283,223,38,19,19,31,17,14,24,9,15,-2,0,-2,88%,84%,92%,145,154,137,22%,28%,17%,5,4,1,7,4,3
133,https://vlr.gg/player/17503/delbisky,2024-10-03 07:15:00,1.23,0.94,1.07,201,253,160,33,18,15,27,14,13,9,6,3,+7,+2,+5,74%,79%,71%,125,164,94,29%,28%,30%,8,3,5,1,1,0
134,https://vlr.gg/player/9175/kohaibi,2024-10-03 07:15:00,0.81,1.22,1.04,211,146,257,32,10,22,30,13,17,14,4,10,+2,0,+2,74%,74%,75%,153,113,185,22%,27%,19%,5,2,3,3,2,1
135,https://vlr.gg/player/8175/ayumiii,2024-10-03 07:15:00,0.50,0.91,0.72,142,108,165,21,7,14,30,14,16,21,8,13,-4,-3,-1,77%,68%,83%,93,69,112,22%,39%,14%,2,0,2,6,3,3
136,https://vlr.gg/player/29315/romia,2024-10-03 07:15:00,0.92,1.27,1.07,194,172,219,31,14,17,34,20,14,10,8,2,-1,-2,+1,70%,67%,74%,132,126,139,27%,25%,30%,2,0,2,3,2,1
137,https://vlr.gg/player/25000/yamzzi,2024-10-03 07:15:00,1.06,0.90,0.99,194,195,197,32,18,14,32,17,15,12,8,4,-1,-1,0,65%,71%,58%,131,123,142,40%,41%,38%,4,2,2,5,3,2
138,https://vlr.gg/player/37521/mint,2024-10-03 07:15:00,0.83,1.13,0.96,249,241,260,37,20,17,38,23,15,5,3,2,+2,+1,+1,65%,63%,68%,156,152,161,36%,37%,34%,7,4,3,5,3,2
139,https://vlr.gg/player/29290/pingsong,2024-10-03 07:15:00,0.86,0.91,0.88,172,155,202,24,12,12,32,18,14,14,5,9,0,+1,-1,60%,63%,58%,120,102,142,30%,33%,26%,3,2,1,3,1,2
140,https://vlr.gg/player/29274/curumi,2024-10-03 07:15:00,0.32,0.49,0.39,126,91,166,16,6,10,40,22,18,25,11,14,-7,-7,0,60%,50%,74%,75,64,89,17%,19%,15%,2,0,2,9,7,2
141,https://vlr.gg/player/48155/says0,2024-10-03 06:50:00,,,,248,,,29,,,27,,,4,,,,,,,,,,,,,,,,,,,,
142,https://vlr.gg/player/48345/dumplings,2024-10-03 06:50:00,,,,177,,,17,,,30,,,4,,,,,,,,,,,,,,,,,,,,
143,https://vlr.gg/player/48153/rua,2024-10-03 06:50:00,,,,169,,,20,,,28,,,3,,,,,,,,,,,,,,,,,,,,
144,https://vlr.gg/player/48152/1ball,2024-10-03 06:50:00,,,,135,,,14,,,29,,,9,,,,,,,,,,,,,,,,,,,,
145,https://vlr.gg/player/48151/fancy,2024-10-03 06:50:00,,,,82,,,8,,,29,,,7,,,,,,,,,,,,,,,,,,,,
146,https://vlr.gg/player/48159/yyni,2024-10-03 06:50:00,,,,296,,,36,,,18,,,16,,,,,,,,,,,,,,,,,,,,
147,https://vlr.gg/player/48157/kiaki,2024-10-03 06:50:00,,,,274,,,35,,,16,,,6,,,,,,,,,,,,,,,,,,,,
148,https://vlr.gg/player/48158/xkb,2024-10-03 06:50:00,,,,240,,,30,,,14,,,21,,,,,,,,,,,,,,,,,,,,
149,https://vlr.gg/player/39397/7wyy,2024-10-03 06:50:00,,,,212,,,25,,,18,,,18,,,,,,,,,,,,,,,,,,,,
150,https://vlr.gg/player/48156/yumiiurx,2024-10-03 06:50:00,,,,160,,,17,,,22,,,8,,,,,,,,,,,,,,,,,,,,
151,https://vlr.gg/player/48134/aqi,2024-10-03 05:00:00,,,,177,,,15,,,29,,,3,,,,,,,,,,,,,,,,,,,,
152,https://vlr.gg/player/48133/cream,2024-10-03 05:00:00,,,,149,,,14,,,26,,,7,,,,,,,,,,,,,,,,,,,,
153,https://vlr.gg/player/48135/ann,2024-10-03 05:00:00,,,,141,,,15,,,28,,,6,,,,,,,,,,,,,,,,,,,,
154,https://vlr.gg/player/48137/nvmow,2024-10-03 05:00:00,,,,134,,,10,,,29,,,12,,,,,,,,,,,,,,,,,,,,
155,https://vlr.gg/player/48136/coco,2024-10-03 05:00:00,,,,97,,,8,,,27,,,5,,,,,,,,,,,,,,,,,,,,
156,https://vlr.gg/player/48141/seaweed,2024-10-03 05:00:00,,,,317,,,36,,,12,,,16,,,,,,,,,,,,,,,,,,,,
157,https://vlr.gg/player/8129/chloettw,2024-10-03 05:00:00,,,,297,,,33,,,15,,,6,,,,,,,,,,,,,,,,,,,,
158,https://vlr.gg/player/48145/q1ngy,2024-10-03 05:00:00,,,,273,,,30,,,17,,,5,,,,,,,,,,,,,,,,,,,,
159,https://vlr.gg/player/48143/candice,2024-10-03 05:00:00,,,,189,,,20,,,9,,,19,,,,,,,,,,,,,,,,,,,,
160,https://vlr.gg/player/48144/huanki,2024-10-03 05:00:00,,,,172,,,20,,,9,,,11,,,,,,,,,,,,,,,,,,,,
161,https://vlr.gg/player/15712/lunah,2024-10-03 03:30:00,1.07,1.14,1.10,234,226,261,56,31,25,46,25,21,11,6,5,-2,+1,-3,73%,70%,78%,173,166,183,36%,30%,48%,6,3,3,8,2,6
162,https://vlr.gg/player/16642/casper,2024-10-03 03:30:00,1.10,0.87,0.99,194,225,169,45,30,15,46,26,20,19,10,9,-4,-2,-2,61%,68%,52%,138,152,119,43%,48%,36%,2,2,0,6,4,2
163,https://vlr.gg/player/19938/twirly,2024-10-03 03:30:00,0.81,1.13,0.94,189,175,238,44,23,21,48,28,20,12,5,7,-4,-5,+1,59%,62%,56%,137,122,157,23%,29%,17%,5,2,3,9,7,2
164,https://vlr.gg/player/19962/eluwu,2024-10-03 03:30:00,1.03,0.67,0.88,203,233,171,41,28,13,49,26,23,13,7,6,-2,+2,-4,69%,73%,63%,136,145,123,22%,19%,29%,9,7,2,11,5,6
165,https://vlr.gg/player/19492/amy,2024-10-03 03:30:00,0.86,0.63,0.76,153,160,135,35,22,13,44,23,21,16,9,7,-6,-5,-1,70%,76%,63%,93,100,84,20%,20%,18%,1,0,1,7,5,2
166,https://vlr.gg/player/26100/rosa,2024-10-03 03:30:00,1.23,1.37,1.31,291,266,305,63,25,38,46,18,28,15,8,7,+9,+5,+4,78%,78%,78%,188,171,200,23%,26%,22%,15,7,8,6,2,4
167,https://vlr.gg/player/31579/emi,2024-10-03 03:30:00,1.18,1.09,1.13,225,236,199,46,21,25,41,19,22,20,7,13,+6,+3,+3,78%,78%,78%,142,159,129,20%,18%,22%,10,3,7,4,0,4
168,https://vlr.gg/player/36897/ferret,2024-10-03 03:30:00,1.37,0.93,1.12,215,277,184,55,29,26,44,16,28,15,8,7,+4,-1,+5,70%,70%,70%,150,196,116,25%,36%,15%,8,3,5,4,4,0
169,https://vlr.gg/player/26102/bethany,2024-10-03 03:30:00,0.83,0.91,0.88,157,142,149,30,12,18,43,17,26,40,15,25,+3,+4,-1,73%,74%,73%,101,94,106,27%,36%,23%,5,4,1,2,0,2
170,https://vlr.gg/player/32533/alannah,2024-10-03 03:30:00,0.97,0.80,0.87,176,173,178,39,18,21,47,17,30,23,7,16,-4,-2,-2,75%,89%,65%,120,122,118,34%,38%,31%,3,1,2,7,3,4
171,https://vlr.gg/player/10653/suzu,2024-10-03 01:00:00,0.79,0.91,0.85,229,230,234,27,14,13,34,17,17,7,5,2,-9,-5,-4,54%,53%,56%,150,144,156,22%,26%,19%,4,3,1,13,8,5
172,https://vlr.gg/player/39902/ur,2024-10-03 01:00:00,0.78,0.92,0.85,183,170,195,22,11,11,30,15,15,9,5,4,-4,-5,+1,59%,63%,56%,124,113,136,31%,25%,36%,1,0,1,5,5,0
173,https://vlr.gg/player/39904/serena,2024-10-03 01:00:00,1.15,0.46,0.81,173,238,100,19,15,4,31,15,16,11,5,6,-1,0,-1,59%,63%,56%,124,175,72,16%,21%,6%,2,1,1,3,1,2
174,https://vlr.gg/player/29314/moco,2024-10-03 01:00:00,0.68,0.50,0.59,148,163,134,17,10,7,32,16,16,13,8,5,+1,+1,0,68%,84%,50%,105,113,97,22%,22%,23%,2,1,1,1,0,1
175,https://vlr.gg/player/29316/aco,2024-10-03 01:00:00,0.64,0.38,0.51,122,140,103,12,7,5,33,17,16,16,10,6,-4,0,-4,54%,58%,50%,83,98,67,25%,24%,26%,1,0,1,5,0,5
176,https://vlr.gg/player/18093/kamiyu,2024-10-03 01:00:00,1.67,1.19,1.43,247,238,255,34,17,17,18,5,13,16,7,9,+1,0,+1,86%,83%,89%,170,161,179,39%,53%,29%,2,1,1,1,1,0
177,https://vlr.gg/player/8176/enerii,2024-10-03 01:00:00,1.30,1.54,1.42,297,312,285,40,21,19,22,12,10,10,3,7,+10,+5,+5,84%,83%,84%,178,174,180,20%,24%,16%,13,7,6,3,2,1
178,https://vlr.gg/player/18091/shirazi,2024-10-03 01:00:00,1.44,1.20,1.32,229,241,216,28,15,13,18,8,10,14,6,8,+3,+2,+1,81%,83%,79%,146,151,142,14%,14%,14%,5,3,2,2,1,1
179,https://vlr.gg/player/8492/tara,2024-10-03 01:00:00,1.23,1.29,1.26,200,169,233,29,11,18,20,7,13,27,15,12,+4,+1,+3,89%,94%,84%,132,111,152,24%,18%,28%,5,2,3,1,1,0
180,https://vlr.gg/player/16621/alexy,2024-10-03 01:00:00,1.37,1.06,1.21,215,235,195,29,16,13,19,8,11,15,7,8,-1,0,-1,84%,94%,74%,136,148,125,32%,39%,25%,2,0,2,3,0,3
181,https://vlr.gg/player/17447/alyssa,2024-10-02 07:00:00,,,,272,,,36,,,26,,,10,,,,,,,,,,,,,,,,,,,,
182,https://vlr.gg/player/25443/bambi,2024-10-02 07:00:00,,,,250,,,31,,,23,,,19,,,,,,,,,,,,,,,,,,,,
183,https://vlr.gg/player/48206/7er,2024-10-02 07:00:00,,,,236,,,34,,,23,,,8,,,,,,,,,,,,,,,,,,,,
184,https://vlr.gg/player/48205/x1aowen,2024-10-02 07:00:00,,,,232,,,28,,,25,,,20,,,,,,,,,,,,,,,,,,,,
185,https://vlr.gg/player/48207/elina,2024-10-02 07:00:00,,,,178,,,23,,,26,,,10,,,,,,,,,,,,,,,,,,,,
186,https://vlr.gg/player/41218/s1eeepy,2024-10-02 07:00:00,,,,257,,,34,,,26,,,15,,,,,,,,,,,,,,,,,,,,
187,https://vlr.gg/player/48223/xmeinn,2024-10-02 07:00:00,,,,252,,,32,,,31,,,9,,,,,,,,,,,,,,,,,,,,
188,https://vlr.gg/player/48224/peterpan,2024-10-02 07:00:00,,,,212,,,25,,,33,,,6,,,,,,,,,,,,,,,,,,,,
189,https://vlr.gg/player/48226/ayu,2024-10-02 07:00:00,,,,165,,,18,,,31,,,16,,,,,,,,,,,,,,,,,,,,
190,https://vlr.gg/player/48225/147,2024-10-02 07:00:00,,,,125,,,13,,,31,,,18,,,,,,,,,,,,,,,,,,,,
191,https://vlr.gg/player/46170/dorothy,2024-10-02 06:35:00,1.18,1.69,1.45,324,253,370,81,30,51,49,24,25,14,7,7,+14,+2,+12,82%,79%,85%,201,169,229,27%,29%,25%,19,6,13,5,4,1
192,https://vlr.gg/player/40410/332,2024-10-02 06:35:00,0.70,1.20,0.97,202,173,220,53,20,33,46,25,21,6,3,3,-5,-4,-1,67%,62%,72%,137,113,158,25%,20%,29%,5,2,3,10,6,4
193,https://vlr.gg/player/40423/bibi,2024-10-02 06:35:00,0.94,0.94,0.94,203,209,199,49,25,24,54,25,29,24,4,20,+1,+1,0,82%,82%,82%,138,138,139,25%,26%,23%,7,4,3,6,3,3
194,https://vlr.gg/player/40151/h4ste,2024-10-02 06:35:00,0.88,0.84,0.86,180,197,172,48,24,24,55,28,27,21,8,13,+2,+1,+1,74%,76%,72%,111,117,106,29%,31%,27%,10,5,5,8,4,4
195,https://vlr.gg/player/40556/f1yk,2024-10-02 06:35:00,0.98,0.50,0.72,132,152,121,37,21,16,53,21,32,17,7,10,-1,0,-1,66%,71%,62%,99,110,89,38%,43%,33%,1,0,1,2,0,2
196,https://vlr.gg/player/16635/poly,2024-10-02 06:35:00,1.30,0.98,1.15,196,227,168,54,35,19,46,25,21,22,8,14,-3,-5,+2,77%,77%,76%,137,154,118,41%,41%,40%,3,0,3,6,5,1
197,https://vlr.gg/player/25388/kon,2024-10-02 06:35:00,1.14,1.09,1.11,233,233,248,59,31,28,56,30,26,14,8,6,-1,-1,0,68%,67%,71%,162,160,163,35%,43%,28%,7,3,4,8,4,4
198,https://vlr.gg/player/45029/grahams,2024-10-02 06:35:00,1.04,0.94,0.99,207,231,180,56,32,24,57,32,25,18,7,11,-1,+1,-2,77%,74%,79%,125,137,111,37%,38%,35%,6,4,2,7,3,4
199,https://vlr.gg/player/18062/capricious,2024-10-02 06:35:00,0.54,1.26,0.88,186,144,244,50,20,30,56,33,23,13,8,5,-2,-6,+4,73%,64%,82%,121,90,157,45%,46%,44%,11,5,6,13,11,2
200,https://vlr.gg/player/26069/piety,2024-10-02 06:35:00,0.75,0.87,0.81,164,133,195,38,16,22,53,28,25,21,10,11,-4,0,-4,67%,54%,82%,110,94,128,27%,29%,26%,4,2,2,8,2,6
201,https://vlr.gg/player/17526/clem,2024-10-02 05:00:00,,,,383,,,45,,,16,,,11,,,,,,,,,,,,,,,,,,,,
202,https://vlr.gg/player/25489/chloe,2024-10-02 05:00:00,,,,228,,,32,,,19,,,9,,,,,,,,,,,,,,,,,,,,
203,https://vlr.gg/player/15304/xixi,2024-10-02 05:00:00,,,,218,,,26,,,25,,,10,,,,,,,,,,,,,,,,,,,,
204,https://vlr.gg/player/41164/ysy,2024-10-02 05:00:00,,,,192,,,29,,,17,,,8,,,,,,,,,,,,,,,,,,,,
205,https://vlr.gg/player/15307/jue,2024-10-02 05:00:00,,,,124,,,16,,,18,,,10,,,,,,,,,,,,,,,,,,,,
206,https://vlr.gg/player/48167/xiaolan,2024-10-02 05:00:00,,,,222,,,24,,,33,,,7,,,,,,,,,,,,,,,,,,,,
207,https://vlr.gg/player/30334/yang,2024-10-02 05:00:00,,,,164,,,20,,,26,,,6,,,,,,,,,,,,,,,,,,,,
208,https://vlr.gg/player/48168/zora,2024-10-02 05:00:00,,,,152,,,18,,,31,,,11,,,,,,,,,,,,,,,,,,,,
209,https://vlr.gg/player/48170/anan,2024-10-02 05:00:00,,,,145,,,19,,,30,,,7,,,,,,,,,,,,,,,,,,,,
210,https://vlr.gg/player/48169/jennie,2024-10-02 05:00:00,,,,132,,,14,,,28,,,2,,,,,,,,,,,,,,,,,,,,
211,https://vlr.gg/player/8176/enerii,2024-10-02 04:20:00,1.11,1.78,1.39,303,263,356,39,20,19,28,18,10,12,5,7,+2,+1,+1,82%,73%,94%,194,160,240,8%,7%,9%,9,5,4,7,4,3
212,https://vlr.gg/player/16621/alexy,2024-10-02 04:20:00,0.93,1.75,1.27,208,174,264,29,15,14,21,15,6,18,8,10,-2,-2,0,71%,55%,94%,134,109,168,30%,26%,34%,2,1,1,4,3,1
213,https://vlr.gg/player/18093/kamiyu,2024-10-02 04:20:00,1.33,1.17,1.26,224,252,182,31,20,11,24,15,9,20,10,10,+2,+3,-1,76%,73%,81%,152,173,123,31%,31%,30%,4,4,0,2,1,1
214,https://vlr.gg/player/8492/tara,2024-10-02 04:20:00,1.03,0.96,1.00,182,194,159,28,18,10,23,14,9,6,3,3,-3,0,-3,74%,73%,75%,105,118,87,24%,28%,19%,2,2,0,5,2,3
215,https://vlr.gg/player/18091/shirazi,2024-10-02 04:20:00,0.73,1.36,1.00,186,163,198,23,10,13,24,17,7,14,11,3,-1,0,-1,76%,68%,88%,125,124,128,15%,11%,23%,1,0,1,2,0,2
216,https://vlr.gg/player/37521/mint,2024-10-02 04:20:00,0.94,1.50,1.26,309,298,335,41,16,25,32,15,17,5,2,3,+4,+5,-1,79%,75%,82%,203,180,220,37%,33%,39%,10,6,4,6,1,5
217,https://vlr.gg/player/29290/pingsong,2024-10-02 04:20:00,0.63,1.12,0.92,182,135,211,24,8,16,28,13,15,8,3,5,0,0,0,79%,69%,86%,117,91,136,32%,33%,32%,2,1,1,2,1,1
218,https://vlr.gg/player/29315/romia,2024-10-02 04:20:00,0.59,0.86,0.75,196,156,215,22,7,15,31,13,18,8,2,6,0,0,0,58%,44%,68%,123,112,132,19%,21%,18%,3,1,2,3,1,2
219,https://vlr.gg/player/25000/yamzzi,2024-10-02 04:20:00,0.77,0.58,0.66,130,145,117,16,8,8,27,12,15,11,5,6,0,+1,-1,61%,63%,59%,82,93,74,30%,26%,33%,3,2,1,3,1,2
220,https://vlr.gg/player/29274/curumi,2024-10-02 04:20:00,0.16,0.94,0.60,121,54,184,17,2,15,32,14,18,16,5,11,-2,-2,0,68%,44%,86%,82,34,116,18%,0%,25%,2,0,2,4,2,2
221,https://vlr.gg/player/39902/ur,2024-10-02 01:00:00,1.46,1.01,1.25,235,265,207,52,33,19,44,21,23,30,13,17,+5,+1,+4,78%,77%,78%,158,175,139,28%,31%,24%,10,3,7,5,2,3
222,https://vlr.gg/player/29314/moco,2024-10-02 01:00:00,1.49,0.93,1.22,225,256,185,53,33,20,44,19,25,28,13,15,-5,-1,-4,79%,86%,72%,143,166,119,27%,32%,21%,3,1,2,8,2,6
223,https://vlr.gg/player/29316/aco,2024-10-02 01:00:00,1.26,0.91,1.09,208,210,211,48,26,22,47,20,27,47,28,19,-1,-3,+2,76%,80%,72%,126,117,135,18%,16%,19%,5,1,4,6,4,2
224,https://vlr.gg/player/39904/serena,2024-10-02 01:00:00,0.89,0.93,0.91,162,172,157,40,22,18,45,23,22,13,8,5,-1,-1,0,69%,71%,66%,116,123,108,23%,22%,24%,2,2,0,3,3,0
225,https://vlr.gg/player/10653/suzu,2024-10-02 01:00:00,0.71,0.96,0.83,202,195,213,49,24,25,52,27,25,13,7,6,-3,-3,0,61%,57%,66%,129,116,144,25%,21%,32%,11,7,4,14,10,4
226,https://vlr.gg/player/16018/babytz,2024-10-02 01:00:00,1.03,1.29,1.16,248,228,263,55,24,31,49,22,27,17,11,6,+6,+2,+4,79%,88%,71%,174,163,183,31%,28%,34%,9,4,5,3,2,1
227,https://vlr.gg/player/8175/ayumiii,2024-10-02 01:00:00,1.09,1.01,1.05,210,196,222,48,23,25,46,18,28,19,8,11,0,-6,+6,69%,72%,66%,141,141,141,21%,25%,18%,12,3,9,12,9,3
228,https://vlr.gg/player/17503/delbisky,2024-10-02 01:00:00,1.12,0.82,0.97,214,245,188,50,29,21,52,24,28,22,7,15,+1,+2,-1,72%,75%,69%,137,153,123,23%,22%,24%,7,4,3,6,2,4
229,https://vlr.gg/player/9175/kohaibi,2024-10-02 01:00:00,1.04,0.77,0.90,172,180,160,40,20,20,49,20,29,16,5,11,-1,-1,0,66%,72%,60%,115,123,107,29%,32%,25%,6,2,4,7,3,4
230,https://vlr.gg/player/16641/alluka,2024-10-02 01:00:00,1.17,0.50,0.82,159,209,113,39,27,12,47,20,27,24,11,13,-1,+1,-2,69%,81%,57%,101,128,77,20%,29%,10%,2,2,0,3,1,2
231,https://vlr.gg/player/12055/mmonch,2024-10-01 18:00:00,1.18,1.65,1.38,233,187,254,70,28,42,36,17,19,12,6,6,+8,+4,+4,88%,88%,88%,143,115,178,33%,34%,32%,10,6,4,2,2,0
232,https://vlr.gg/player/20491/ivy,2024-10-01 18:00:00,1.22,1.26,1.23,217,178,234,59,27,32,47,17,30,9,5,4,+7,+4,+3,82%,85%,78%,145,127,168,35%,43%,29%,10,5,5,3,1,2
233,https://vlr.gg/player/20539/juw,2024-10-01 18:00:00,1.15,0.89,1.03,186,168,174,58,24,34,43,17,26,15,6,9,+4,+5,-1,77%,80%,72%,111,113,110,23%,22%,26%,10,6,4,6,1,5
234,https://vlr.gg/player/20537/andrehs,2024-10-01 18:00:00,0.87,1.22,1.02,166,131,187,46,19,27,43,18,25,26,7,19,-1,-1,0,84%,80%,88%,102,85,124,37%,44%,31%,4,2,2,5,3,2
235,https://vlr.gg/player/20538/linlin,2024-10-01 18:00:00,0.94,0.87,0.91,142,114,163,49,18,31,47,18,29,21,7,14,+3,+1,+2,81%,80%,81%,105,96,116,37%,28%,49%,5,2,3,2,1,1
236,https://vlr.gg/player/25741/lied,2024-10-01 18:00:00,1.34,1.04,1.18,234,276,197,73,30,43,59,22,37,17,5,12,-3,-2,-1,75%,66%,83%,152,175,134,31%,32%,30%,7,3,4,10,5,5
237,https://vlr.gg/player/35927/dano,2024-10-01 18:00:00,0.70,0.77,0.73,138,141,125,45,14,31,55,26,29,13,9,4,-4,+1,-5,63%,53%,71%,84,90,79,31%,31%,30%,3,2,1,7,1,6
238,https://vlr.gg/player/44481/melsm,2024-10-01 18:00:00,0.54,0.90,0.72,109,79,134,32,7,25,43,21,22,7,3,4,-2,0,-2,64%,50%,79%,63,52,74,18%,15%,21%,3,2,1,5,2,3
239,https://vlr.gg/player/35547/raquinuki,2024-10-01 18:00:00,0.62,0.68,0.65,98,108,86,31,10,21,54,23,31,18,9,9,-7,-5,-2,63%,59%,66%,68,79,59,22%,21%,23%,2,1,1,9,6,3
240,https://vlr.gg/player/29223/tura,2024-10-01 18:00:00,0.53,0.70,0.62,122,109,117,31,11,20,59,27,32,28,7,21,-4,-2,-2,67%,63%,71%,79,71,85,27%,27%,27%,3,2,1,7,4,3
241,https://vlr.gg/player/40338/natas,2024-10-01 18:00:00,0.39,0.18,0.21,81,154,69,4,1,3,13,2,11,0,0,0,-1,0,-1,43%,50%,42%,50,83,45,21%,20%,22%,0,0,0,1,0,1
242,https://vlr.gg/player/25388/kon,2024-10-01 05:00:00,1.24,1.42,1.35,265,274,282,41,16,25,25,10,15,8,3,5,+2,0,+2,75%,69%,79%,187,194,183,43%,47%,39%,5,2,3,3,2,1
243,https://vlr.gg/player/26069/piety,2024-10-01 05:00:00,1.40,1.14,1.24,257,294,222,35,17,18,24,9,15,7,3,4,0,0,0,80%,81%,79%,161,181,148,27%,21%,33%,5,2,3,5,2,3
244,https://vlr.gg/player/18062/capricious,2024-10-01 05:00:00,0.96,1.24,1.13,192,156,220,31,10,21,24,9,15,4,0,4,+4,+2,+2,75%,81%,71%,125,105,139,55%,56%,54%,6,2,4,2,0,2
245,https://vlr.gg/player/45029/grahams,2024-10-01 05:00:00,1.57,0.82,1.12,198,259,159,29,16,13,25,8,17,18,5,13,-2,-1,-1,88%,88%,88%,127,156,107,36%,41%,32%,2,2,0,4,3,1
246,https://vlr.gg/player/16635/poly,2024-10-01 05:00:00,1.33,0.91,1.08,215,184,203,24,10,14,24,7,17,17,5,12,0,-1,+1,75%,75%,75%,130,120,137,31%,39%,27%,4,0,4,4,1,3
247,https://vlr.gg/player/26102/bethany,2024-10-01 05:00:00,1.14,0.75,0.98,165,164,171,24,14,10,28,14,14,13,8,5,+2,+2,0,75%,79%,69%,109,104,117,30%,26%,36%,3,2,1,1,0,1
248,https://vlr.gg/player/31579/emi,2024-10-01 05:00:00,0.85,0.97,0.90,188,187,202,25,15,10,29,18,11,6,5,1,+1,+1,0,63%,67%,56%,140,134,150,20%,17%,25%,4,2,2,3,1,2
249,https://vlr.gg/player/32533/alannah,2024-10-01 05:00:00,0.88,0.63,0.78,172,190,143,24,17,7,33,19,14,8,5,3,-1,-1,0,58%,58%,56%,114,127,94,32%,30%,35%,1,1,0,2,2,0
250,https://vlr.gg/player/36897/ferret,2024-10-01 05:00:00,0.90,0.45,0.72,198,209,174,28,19,9,35,20,15,4,3,1,-4,-3,-1,65%,71%,56%,119,134,97,26%,24%,30%,4,1,3,8,4,4
251,https://vlr.gg/player/26100/rosa,2024-10-01 05:00:00,0.63,0.50,0.54,141,164,124,21,14,7,35,20,15,6,5,1,-2,-3,+1,63%,79%,38%,95,103,84,17%,14%,26%,6,4,2,8,7,1
252,https://vlr.gg/player/40410/332,2024-10-01 01:00:00,1.15,1.23,1.19,237,228,240,55,23,32,46,18,28,13,7,6,+2,0,+2,71%,67%,75%,170,172,167,27%,26%,28%,8,3,5,6,3,3
253,https://vlr.gg/player/46170/dorothy,2024-10-01 01:00:00,1.02,1.27,1.16,245,238,259,58,25,33,47,21,26,11,4,7,+3,-1,+4,76%,73%,78%,156,155,158,26%,28%,24%,10,3,7,7,4,3
254,https://vlr.gg/player/40423/bibi,2024-10-01 01:00:00,1.17,0.86,1.00,202,216,191,47,24,23,46,18,28,20,10,10,-2,0,-2,71%,80%,64%,133,141,127,30%,27%,34%,4,3,1,6,3,3
255,https://vlr.gg/player/40556/f1yk,2024-10-01 01:00:00,1.24,0.64,0.91,179,233,136,45,28,17,48,19,29,11,2,9,0,+2,-2,70%,83%,58%,116,151,86,39%,34%,47%,4,2,2,4,0,4
256,https://vlr.gg/player/40151/h4ste,2024-10-01 01:00:00,0.77,0.75,0.76,167,169,172,38,18,20,53,23,30,23,9,14,+1,-1,+2,71%,80%,64%,114,117,112,33%,40%,29%,9,4,5,8,5,3
257,https://vlr.gg/player/16642/casper,2024-10-01 01:00:00,0.95,1.16,1.04,186,180,198,43,22,21,46,25,21,35,21,14,+2,-1,+3,82%,86%,77%,121,119,124,22%,21%,22%,6,1,5,4,2,2
258,https://vlr.gg/player/19962/eluwu,2024-10-01 01:00:00,1.08,0.95,1.02,225,246,199,56,35,21,51,27,24,8,2,6,-4,-3,-1,64%,67%,60%,142,154,128,34%,37%,30%,12,6,6,16,9,7
259,https://vlr.gg/player/19938/twirly,2024-10-01 01:00:00,0.89,1.09,0.98,211,212,214,48,26,22,49,27,22,16,7,9,0,0,0,67%,69%,63%,145,143,148,30%,36%,25%,5,4,1,5,4,1
260,https://vlr.gg/player/15712/lunah,2024-10-01 01:00:00,1.04,0.84,0.95,232,264,196,54,35,19,55,28,27,18,7,11,+1,0,+1,70%,72%,67%,151,170,128,32%,36%,25%,7,4,3,6,4,2
261,https://vlr.gg/player/19492/amy,2024-10-01 01:00:00,1.21,0.63,0.95,169,181,148,39,24,15,43,18,25,17,11,6,-3,0,-3,65%,69%,60%,106,114,96,27%,26%,27%,1,1,0,4,1,3
262,https://vlr.gg/player/11259/conir,2024-09-30 18:00:00,1.46,1.44,1.45,258,277,222,57,36,21,31,22,9,23,15,8,+2,+1,+1,85%,86%,83%,162,180,134,27%,24%,35%,4,3,1,2,2,0
263,https://vlr.gg/player/25663/dods,2024-09-30 18:00:00,0.69,2.50,1.40,305,182,516,70,25,45,41,29,12,13,7,6,+6,-1,+7,76%,61%,100%,210,124,345,37%,35%,38%,14,6,8,8,7,1
264,https://vlr.gg/player/18982/romily,2024-09-30 18:00:00,1.16,1.02,1.10,192,195,177,42,28,14,31,19,12,20,8,12,+3,+3,0,73%,72%,74%,113,124,96,33%,38%,26%,5,4,1,2,1,1
265,https://vlr.gg/player/11235/biazik,2024-09-30 18:00:00,1.13,0.99,1.07,183,194,161,37,25,12,35,21,14,25,12,13,+5,+5,0,81%,78%,87%,122,133,105,25%,26%,24%,9,6,3,4,1,3
266,https://vlr.gg/player/21558/micaela,2024-09-30 18:00:00,1.06,0.99,1.03,165,178,145,36,24,12,31,21,10,20,12,8,+1,0,+1,78%,75%,83%,106,115,91,43%,47%,35%,6,3,3,5,3,2
267,https://vlr.gg/player/33177/none,2024-09-30 18:00:00,0.70,1.06,0.92,229,201,247,42,15,27,48,21,27,11,1,10,-10,-6,-4,53%,43%,58%,161,133,178,24%,24%,24%,7,4,3,17,10,7
268,https://vlr.gg/player/21108/ponix,2024-09-30 18:00:00,0.61,1.09,0.90,167,128,193,33,10,23,47,21,26,21,6,15,0,-2,+2,68%,61%,72%,114,77,137,31%,36%,29%,4,1,3,4,3,1
269,https://vlr.gg/player/42378/nicky,2024-09-30 18:00:00,0.49,0.97,0.78,161,150,173,31,10,21,48,22,26,20,9,11,-3,-1,-2,61%,61%,61%,106,94,113,38%,28%,44%,3,0,3,6,1,5
270,https://vlr.gg/player/21548/adenina,2024-09-30 18:00:00,0.64,0.74,0.70,141,123,151,29,11,18,47,18,29,12,3,9,-3,0,-3,58%,61%,56%,83,68,92,16%,22%,14%,2,1,1,5,1,4
271,https://vlr.gg/player/24770/babzzz,2024-09-30 18:00:00,0.49,0.70,0.61,167,145,183,34,11,23,53,23,30,9,3,6,-1,0,-1,59%,48%,67%,106,98,111,22%,23%,22%,5,1,4,6,1,5
272,https://vlr.gg/player/46104/envy2k,2024-09-30 06:20:00,1.52,1.11,1.32,293,345,240,45,28,17,33,18,15,11,7,4,+1,+2,-1,69%,78%,59%,181,218,143,22%,27%,14%,8,4,4,7,2,5
273,https://vlr.gg/player/43390/d1sease,2024-09-30 06:20:00,1.14,1.24,1.19,213,191,239,38,18,20,32,16,16,23,14,9,-1,-2,+1,71%,78%,64%,128,110,147,31%,35%,29%,3,2,1,4,4,0
274,https://vlr.gg/player/45484/max,2024-09-30 06:20:00,0.72,1.04,0.87,158,142,175,25,10,15,32,18,14,15,10,5,-1,-2,+1,73%,70%,77%,102,100,104,26%,25%,27%,4,1,3,5,3,2
275,https://vlr.gg/player/31355/acestarrrrr,2024-09-30 06:20:00,0.97,0.66,0.82,177,222,126,27,18,9,36,20,16,19,12,7,0,+1,-1,67%,74%,59%,114,138,88,19%,18%,20%,3,2,1,3,1,2
276,https://vlr.gg/player/5009/wstvirginia,2024-09-30 06:20:00,0.69,0.86,0.77,169,157,181,26,13,13,35,19,16,15,8,7,0,0,0,78%,70%,86%,110,99,121,39%,31%,45%,4,2,2,4,2,2
277,https://vlr.gg/player/30286/karam1l,2024-09-30 06:20:00,1.20,1.46,1.33,264,264,264,42,19,23,30,16,14,12,8,4,+1,-1,+2,78%,77%,78%,189,177,200,38%,42%,35%,3,0,3,2,1,1
278,https://vlr.gg/player/14208/kishi,2024-09-30 06:20:00,1.19,1.00,1.09,226,228,223,36,19,17,36,15,21,30,15,15,0,0,0,89%,91%,87%,137,129,144,31%,23%,41%,3,2,1,3,2,1
279,https://vlr.gg/player/4089/doxz3r,2024-09-30 06:20:00,0.91,1.15,1.03,174,157,192,28,12,16,28,14,14,13,6,7,+2,0,+2,71%,68%,74%,121,107,134,24%,21%,27%,3,1,2,1,1,0
280,https://vlr.gg/player/23931/kata,2024-09-30 06:20:00,0.92,0.98,0.95,244,236,254,36,16,20,37,18,19,8,4,4,-3,+1,-4,71%,73%,70%,165,152,177,25%,30%,21%,11,8,3,14,7,7
281,https://vlr.gg/player/41834/panda,2024-09-30 06:20:00,0.96,0.78,0.87,155,126,180,26,11,15,30,11,19,21,12,9,+1,0,+1,69%,73%,65%,103,83,121,34%,26%,42%,3,0,3,2,0,2
282,https://vlr.gg/player/729/zellsis,2024-09-29 21:40:00,0.93,1.46,1.20,245,196,295,39,15,24,30,17,13,21,8,13,+5,+2,+3,78%,73%,83%,146,121,169,25%,20%,29%,9,4,5,4,2,2
283,https://vlr.gg/player/4004/zekken,2024-09-29 21:40:00,0.92,1.44,1.19,271,215,323,45,18,27,36,20,16,8,3,5,+2,-1,+3,71%,64%,78%,164,122,203,21%,17%,24%,7,2,5,5,3,2
284,https://vlr.gg/player/8419/reduxx,2024-09-29 21:40:00,0.92,1.37,1.15,211,211,214,36,15,21,31,19,12,20,6,14,-1,+2,-3,82%,73%,91%,139,135,142,37%,36%,38%,4,4,0,5,2,3
285,https://vlr.gg/player/1265/johnqt,2024-09-29 21:40:00,0.28,1.38,0.84,163,112,211,25,8,17,30,20,10,17,2,15,-2,-2,0,64%,50%,78%,113,81,143,32%,33%,31%,1,0,1,3,2,1
286,https://vlr.gg/player/6584/curry,2024-09-29 21:40:00,0.32,0.86,0.60,120,82,156,16,5,11,35,20,15,28,9,19,-5,-3,-2,80%,73%,87%,80,56,103,13%,13%,13%,1,0,1,6,3,3
287,https://vlr.gg/player/17433/v1c,2024-09-29 21:40:00,0.54,1.79,1.15,224,136,318,35,9,26,32,20,12,16,8,8,0,-1,+1,67%,48%,86%,151,102,202,24%,16%,30%,2,0,2,2,1,1
288,https://vlr.gg/player/7871/xeppaa,2024-09-29 21:40:00,1.08,1.22,1.15,223,234,211,34,19,15,30,19,11,14,6,8,0,0,0,80%,78%,82%,150,155,145,21%,19%,22%,4,3,1,4,3,1
289,https://vlr.gg/player/7458/moose,2024-09-29 21:40:00,0.64,1.60,1.11,177,120,238,32,9,23,24,17,7,5,1,4,-5,-4,-1,76%,57%,95%,105,82,130,15%,17%,14%,1,0,1,6,4,2
290,https://vlr.gg/player/612/mitch,2024-09-29 21:40:00,0.81,0.95,0.88,168,195,140,26,15,11,34,21,13,23,9,14,+1,+1,0,76%,74%,77%,108,127,87,19%,21%,16%,5,3,2,4,2,2
291,https://vlr.gg/player/18796/oxy,2024-09-29 21:40:00,0.66,1.02,0.84,232,183,281,35,15,20,42,23,19,10,2,8,+5,+3,+2,71%,61%,82%,150,115,187,20%,19%,20%,11,5,6,6,2,4
292,https://vlr.gg/player/24764/akame,2024-09-29 18:25:00,1.83,1.09,1.49,295,357,222,44,29,15,29,15,14,25,16,9,+4,+2,+2,75%,83%,65%,190,235,137,33%,30%,38%,7,3,4,3,1,2
293,https://vlr.gg/player/29179/vii,2024-09-29 18:25:00,1.57,0.58,1.12,243,327,143,38,29,9,29,14,15,9,5,4,-4,-3,-1,77%,79%,75%,161,207,107,23%,24%,19%,3,3,0,7,6,1
294,https://vlr.gg/player/6994/shyz,2024-09-29 18:25:00,1.07,1.07,1.07,187,160,220,30,15,15,28,14,14,8,4,4,+3,+1,+2,73%,67%,80%,121,108,137,28%,35%,23%,4,2,2,1,1,0
295,https://vlr.gg/player/24763/speedy,2024-09-29 18:25:00,0.72,1.31,0.99,222,164,291,32,12,20,33,18,15,13,8,5,+1,-1,+2,70%,67%,75%,162,128,203,36%,23%,47%,4,1,3,3,2,1
296,https://vlr.gg/player/14690/lissa,2024-09-29 18:25:00,0.57,1.07,0.79,165,122,217,27,11,16,33,19,14,11,7,4,0,+1,-1,64%,63%,65%,105,80,134,51%,31%,80%,6,3,3,6,2,4
297,https://vlr.gg/player/3444/phobia,2024-09-29 18:25:00,1.24,0.88,1.04,221,260,188,30,18,12,33,16,17,17,5,12,0,+2,-2,68%,70%,67%,154,165,145,23%,34%,17%,6,3,3,6,1,5
298,https://vlr.gg/player/35019/gabe,2024-09-29 18:25:00,0.93,1.11,1.03,209,170,243,34,13,21,33,14,19,9,2,7,+3,0,+3,77%,80%,75%,140,127,151,19%,20%,19%,4,1,3,1,1,0
299,https://vlr.gg/player/21935/flor,2024-09-29 18:25:00,1.24,0.70,0.94,239,300,189,36,20,16,38,16,22,9,7,2,-2,-1,-1,59%,70%,50%,148,189,114,19%,21%,16%,8,4,4,10,5,5
300,https://vlr.gg/player/30374/lua-c,2024-09-29 18:25:00,0.95,0.73,0.83,149,155,144,23,11,12,32,14,18,15,9,6,-1,-1,0,68%,60%,75%,99,98,100,33%,36%,31%,1,0,1,2,1,1
301,https://vlr.gg/player/40456/aura,2024-09-29 18:25:00,0.60,0.98,0.80,190,139,233,29,10,19,35,15,20,15,8,7,-4,-4,0,64%,65%,63%,120,83,150,32%,30%,33%,1,0,1,5,4,1
302,https://vlr.gg/player/4004/zekken,2024-09-29 18:00:00,1.06,1.30,1.18,239,224,253,59,27,32,47,25,22,16,11,5,0,-5,+5,73%,69%,77%,148,151,146,27%,31%,23%,7,1,6,7,6,1
303,https://vlr.gg/player/729/zellsis,2024-09-29 18:00:00,1.22,1.06,1.14,229,238,219,56,31,25,48,26,22,23,8,15,-3,+1,-4,76%,71%,80%,145,144,145,20%,22%,18%,5,3,2,8,2,6
304,https://vlr.gg/player/8419/reduxx,2024-09-29 18:00:00,0.80,1.40,1.10,239,173,306,56,20,36,50,28,22,17,5,12,+5,0,+5,70%,60%,80%,158,120,196,38%,46%,34%,17,7,10,12,7,5
305,https://vlr.gg/player/1265/johnqt,2024-09-29 18:00:00,0.96,1.19,1.08,165,174,158,43,21,22,39,25,14,35,19,16,-2,-1,-1,79%,74%,83%,106,111,101,24%,19%,31%,3,2,1,5,3,2
306,https://vlr.gg/player/6584/curry,2024-09-29 18:00:00,0.83,0.92,0.88,183,194,175,42,21,21,51,28,23,27,13,14,-2,-2,0,76%,66%,86%,123,127,118,31%,35%,28%,2,1,1,4,3,1
307,https://vlr.gg/player/8742/jakee,2024-09-29 18:00:00,1.29,0.94,1.12,212,250,182,57,33,24,49,26,23,21,9,12,+1,+1,0,70%,69%,71%,135,157,113,21%,24%,19%,8,4,4,7,3,4
308,https://vlr.gg/player/844/bdog,2024-09-29 18:00:00,0.73,1.18,0.95,175,126,230,43,15,28,51,25,26,27,11,16,0,+1,-1,71%,66%,77%,115,73,156,33%,29%,36%,2,1,1,2,0,2
309,https://vlr.gg/player/7716/penny,2024-09-29 18:00:00,0.99,0.85,0.92,214,239,183,48,26,22,53,29,24,14,6,8,+4,+2,+2,63%,60%,66%,143,159,126,17%,20%,13%,12,7,5,8,5,3
310,https://vlr.gg/player/69/thief,2024-09-29 18:00:00,0.44,1.31,0.87,173,114,231,46,15,31,52,30,22,12,5,7,-1,-6,+5,57%,40%,74%,120,82,157,34%,22%,41%,8,1,7,9,7,2
311,https://vlr.gg/player/739/fiziq,2024-09-29 18:00:00,0.73,0.92,0.82,176,130,219,41,14,27,51,26,25,19,12,7,-2,-3,+1,59%,60%,57%,119,95,143,24%,26%,23%,6,2,4,8,5,3
312,https://vlr.gg/player/11242/blu,2024-09-29 16:00:00,0.98,1.89,1.26,208,159,329,42,22,20,29,20,9,17,11,6,+7,+3,+4,83%,75%,100%,129,100,193,26%,18%,38%,7,3,4,0,0,0
313,https://vlr.gg/player/9821/m4ndzin,2024-09-29 16:00:00,1.17,1.42,1.25,231,215,270,39,25,14,34,23,11,39,26,13,0,-1,+1,79%,78%,81%,144,135,165,18%,15%,22%,4,2,2,4,3,1
314,https://vlr.gg/player/22997/waved,2024-09-29 16:00:00,1.33,0.79,1.16,251,292,160,44,35,9,36,24,12,18,12,6,+3,+4,-1,75%,81%,63%,169,190,121,25%,26%,21%,12,10,2,9,6,3
315,https://vlr.gg/player/27724/natasha,2024-09-29 16:00:00,1.12,0.92,1.06,194,202,169,37,28,9,35,22,13,16,9,7,+5,+4,+1,73%,69%,81%,130,137,113,32%,31%,36%,7,6,1,2,2,0
316,https://vlr.gg/player/11236/antg,2024-09-29 16:00:00,1.06,0.70,0.95,173,196,114,34,27,7,35,23,12,17,10,7,-1,+2,-3,77%,78%,75%,124,140,87,24%,25%,22%,3,3,0,4,1,3
317,https://vlr.gg/player/29169/erin,2024-09-29 16:00:00,0.85,1.27,1.14,237,194,255,42,11,31,38,11,27,13,5,8,0,-2,+2,63%,69%,61%,149,116,163,37%,31%,39%,3,0,3,3,2,1
318,https://vlr.gg/player/2245/krysme,2024-09-29 16:00:00,1.38,0.99,1.11,246,322,217,46,20,26,39,11,28,6,3,3,+2,0,+2,65%,69%,64%,160,188,148,38%,35%,41%,6,2,4,4,2,2
319,https://vlr.gg/player/12126/kaah,2024-09-29 16:00:00,1.12,0.99,1.03,198,207,199,40,13,27,37,11,26,12,4,8,-4,+2,-6,75%,81%,72%,127,118,131,39%,38%,40%,2,2,0,6,0,6
320,https://vlr.gg/player/25580/jenny,2024-09-29 16:00:00,0.61,0.63,0.61,139,120,145,21,7,14,40,11,29,15,2,13,-9,-1,-8,65%,75%,61%,94,75,102,14%,18%,13%,5,2,3,14,3,11
321,https://vlr.gg/player/20222/crona,2024-09-29 16:00:00,0.47,0.64,0.56,111,115,109,20,6,14,42,15,27,19,4,15,-3,-1,-2,58%,50%,61%,77,83,74,28%,25%,29%,3,1,2,6,2,4
322,https://vlr.gg/player/16141/sora,2024-09-29 15:30:00,1.24,1.10,1.19,254,270,228,15,10,5,17,10,7,4,1,3,-2,-1,-1,63%,50%,86%,163,162,165,27%,30%,22%,1,1,0,3,2,1
323,https://vlr.gg/player/11330/mcd,2024-09-29 15:30:00,1.09,1.33,1.18,212,191,248,15,9,6,14,9,5,8,5,3,+2,+1,+1,79%,75%,86%,137,122,163,33%,44%,22%,3,1,2,1,0,1
324,https://vlr.gg/player/29827/repteyy,2024-09-29 15:30:00,0.26,1.35,0.66,168,121,249,10,5,5,17,12,5,7,4,3,-1,-1,0,68%,50%,100%,115,76,181,41%,42%,40%,0,0,0,1,1,0
325,https://vlr.gg/player/29638/kotaro,2024-09-29 15:30:00,0.48,0.91,0.64,159,124,221,11,5,6,18,12,6,3,1,2,-3,-1,-2,74%,67%,86%,104,92,124,33%,33%,33%,1,1,0,4,2,2
326,https://vlr.gg/player/29994/xini,2024-09-29 15:30:00,0.20,0.22,0.21,75,78,72,5,3,2,17,11,6,0,0,0,-3,-2,-1,42%,33%,57%,56,59,51,29%,33%,20%,1,1,0,4,3,1
327,https://vlr.gg/player/2835/kyrrz,2024-09-29 15:30:00,1.46,1.73,1.63,247,212,268,17,6,11,7,3,4,12,4,8,-1,-1,0,89%,86%,92%,166,136,183,55%,38%,65%,1,0,1,2,1,1
328,https://vlr.gg/player/29972/michel,2024-09-29 15:30:00,1.46,1.38,1.41,337,374,317,23,9,14,13,6,7,3,1,2,+5,+2,+3,79%,71%,83%,207,225,196,31%,67%,17%,8,3,5,3,1,2
329,https://vlr.gg/player/24359/faska,2024-09-29 15:30:00,1.13,1.20,1.17,203,191,211,13,5,8,10,4,6,8,2,6,+2,0,+2,79%,71%,83%,139,133,142,16%,25%,13%,2,0,2,0,0,0
330,https://vlr.gg/player/4851/rexs,2024-09-29 15:30:00,0.44,1.16,0.90,191,147,217,14,4,10,13,7,6,4,1,3,0,+1,-1,84%,71%,92%,131,125,134,40%,50%,36%,1,1,0,1,0,1
331,https://vlr.gg/player/31553/pukytoo,2024-09-29 15:30:00,0.76,0.89,0.85,171,156,181,15,4,11,13,5,8,3,2,1,+1,+1,0,84%,86%,83%,109,95,118,30%,43%,25%,1,1,0,0,0,0
332,https://vlr.gg/player/7871/xeppaa,2024-09-29 15:00:00,1.63,1.32,1.47,270,292,260,53,27,26,29,12,17,23,12,11,-1,+2,-3,85%,92%,79%,174,175,174,23%,26%,20%,3,3,0,4,1,3
333,https://vlr.gg/player/17433/v1c,2024-09-29 15:00:00,1.06,1.37,1.22,190,160,211,35,14,21,29,14,15,32,21,11,-1,-1,0,77%,76%,79%,125,95,152,19%,17%,21%,2,1,1,3,2,1
334,https://vlr.gg/player/18796/oxy,2024-09-29 15:00:00,1.37,1.08,1.21,291,292,261,56,29,27,37,15,22,5,1,4,+6,+6,0,72%,72%,71%,172,180,165,23%,25%,19%,17,10,7,11,4,7
335,https://vlr.gg/player/612/mitch,2024-09-29 15:00:00,1.08,0.98,1.03,189,173,204,31,13,18,34,14,20,28,16,12,-2,-1,-1,79%,88%,71%,133,121,144,28%,25%,31%,2,0,2,4,1,3
336,https://vlr.gg/player/7458/moose,2024-09-29 15:00:00,1.09,0.77,0.92,161,189,135,32,17,15,29,13,16,5,4,1,-1,-1,0,66%,68%,64%,103,127,83,24%,34%,16%,3,1,2,4,2,2
337,https://vlr.gg/player/3685/flyuh,2024-09-29 15:00:00,1.04,0.90,0.98,173,171,178,33,18,15,38,19,19,26,14,12,0,+1,-1,66%,71%,60%,110,105,114,24%,25%,23%,2,2,0,2,1,1
338,https://vlr.gg/player/2172/brawk,2024-09-29 15:00:00,0.76,1.18,0.95,202,159,240,33,15,18,43,24,19,15,9,6,+2,-1,+3,68%,64%,72%,129,106,155,13%,13%,13%,4,1,3,2,2,0
339,https://vlr.gg/player/5132/mada,2024-09-29 15:00:00,1.01,0.75,0.89,212,247,183,38,23,15,44,23,21,11,7,4,+3,+3,0,68%,71%,64%,139,156,121,28%,28%,28%,11,7,4,8,4,4
340,https://vlr.gg/player/1851/oderus,2024-09-29 15:00:00,0.99,0.63,0.80,177,228,139,32,21,11,44,23,21,15,6,9,-4,+1,-5,60%,64%,56%,129,168,86,32%,27%,44%,8,5,3,12,4,8
341,https://vlr.gg/player/4373/wippie,2024-09-29 15:00:00,0.93,0.55,0.75,118,130,114,22,13,9,38,18,20,24,17,7,-2,0,-2,66%,75%,56%,83,88,77,28%,27%,30%,1,1,0,3,1,2
342,https://vlr.gg/player/17861/blastinho,2024-09-29 14:35:00,0.90,1.39,1.15,234,217,253,20,10,10,18,10,8,4,0,4,-1,-3,+2,58%,50%,67%,162,151,174,24%,25%,24%,2,0,2,3,3,0
343,https://vlr.gg/player/19588/neptuno,2024-09-29 14:35:00,1.36,0.93,1.14,257,305,209,22,12,10,17,8,9,5,2,3,+3,+3,0,79%,75%,83%,155,191,120,30%,44%,16%,4,3,1,1,0,1
344,https://vlr.gg/player/41847/negradas,2024-09-29 14:35:00,1.05,1.18,1.12,184,198,170,14,8,6,14,8,6,6,2,4,+2,0,+2,75%,58%,92%,130,125,136,33%,25%,50%,2,0,2,0,0,0
345,https://vlr.gg/player/2884/daniel0,2024-09-29 14:35:00,0.17,1.51,0.84,159,64,255,13,2,11,16,10,6,6,3,3,-2,-2,0,58%,50%,67%,101,53,148,20%,15%,21%,3,1,2,5,3,2
346,https://vlr.gg/player/8811/humanz,2024-09-29 14:35:00,0.18,1.14,0.66,87,43,132,9,2,7,15,9,6,7,1,6,-4,-2,-2,58%,42%,75%,66,27,106,25%,50%,20%,0,0,0,4,2,2
347,https://vlr.gg/player/22188/jimbk,2024-09-29 14:35:00,1.48,1.20,1.34,216,240,194,19,11,8,14,7,7,3,1,2,+2,0,+2,71%,75%,67%,146,178,114,30%,30%,31%,2,0,2,0,0,0
348,https://vlr.gg/player/33513/sihw,2024-09-29 14:35:00,0.49,1.92,1.21,220,136,306,20,6,14,14,9,5,3,0,3,-2,-2,0,58%,50%,67%,150,99,202,44%,46%,43%,2,1,1,4,3,1
349,https://vlr.gg/player/22291/razziss,2024-09-29 14:35:00,1.21,1.19,1.20,299,336,263,26,15,11,17,10,7,1,0,1,+6,+3,+3,75%,83%,67%,174,196,153,29%,35%,22%,7,4,3,1,1,0
350,https://vlr.gg/player/16139/enrik,2024-09-29 14:35:00,0.15,1.15,0.65,103,23,184,8,0,8,16,9,7,13,6,7,-1,-2,+1,58%,42%,75%,63,15,111,35%,0%,46%,2,0,2,3,2,1
351,https://vlr.gg/player/45143/francybald,2024-09-29 14:35:00,0.46,0.65,0.56,95,77,113,7,3,4,17,9,8,7,4,3,-3,-1,-2,58%,50%,67%,74,59,89,42%,43%,42%,0,0,0,3,1,2
352,https://vlr.gg/player/45145/costaa,2024-09-29 13:30:00,1.39,1.70,1.56,270,219,317,21,9,12,12,6,6,12,5,7,+2,-1,+3,83%,82%,83%,171,128,211,12%,5%,17%,3,0,3,1,1,0
353,https://vlr.gg/player/45144/sulkingg,2024-09-29 13:30:00,1.19,1.59,1.40,259,217,299,22,8,14,15,7,8,13,4,9,+2,0,+2,78%,73%,83%,150,132,166,27%,28%,25%,2,0,2,0,0,0
354,https://vlr.gg/player/48127/riasu,2024-09-29 13:30:00,0.84,0.53,0.68,153,213,99,12,8,4,19,11,8,4,3,1,0,+2,-2,74%,73%,75%,105,126,86,22%,22%,23%,2,2,0,2,0,2
355,https://vlr.gg/player/46683/esc,2024-09-29 13:30:00,0.64,0.64,0.64,97,85,109,7,3,4,16,7,9,7,3,4,-2,-2,0,74%,55%,92%,74,70,77,13%,15%,11%,0,0,0,2,2,0
356,https://vlr.gg/player/48176/kygle,2024-09-29 13:30:00,0.30,0.88,0.60,159,91,223,14,4,10,17,9,8,0,0,0,-3,-4,+1,52%,45%,58%,90,58,119,26%,38%,21%,4,1,3,7,5,2
357,https://vlr.gg/player/46233/kz,2024-09-29 13:30:00,0.93,1.33,1.12,276,243,312,20,9,11,18,9,9,5,2,3,+1,0,+1,78%,67%,91%,168,139,201,22%,16%,32%,5,3,2,4,3,1
358,https://vlr.gg/player/32300/varuxx,2024-09-29 13:30:00,1.22,1.00,1.11,251,265,236,19,12,7,15,7,8,4,2,2,+2,0,+2,74%,75%,73%,168,184,151,36%,28%,50%,2,0,2,0,0,0
359,https://vlr.gg/player/36637/xpatrycksio,2024-09-29 13:30:00,0.72,1.48,1.08,171,158,187,15,7,8,13,9,4,12,5,7,-3,-3,0,74%,67%,82%,103,82,125,16%,10%,24%,1,0,1,4,3,1
360,https://vlr.gg/player/44130/bern1,2024-09-29 13:30:00,0.58,1.07,0.82,164,145,186,13,7,6,15,9,6,2,0,2,+2,+1,+1,74%,67%,82%,113,93,134,38%,36%,39%,2,1,1,0,0,0
361,https://vlr.gg/player/33833/pepecho,2024-09-29 13:30:00,0.70,0.85,0.77,159,154,166,12,6,6,17,10,7,8,5,3,-1,-2,+1,61%,50%,73%,94,90,99,24%,60%,15%,2,0,2,3,2,1
362,https://vlr.gg/player/10448/kozok,2024-09-29 12:40:00,1.86,1.44,1.72,247,245,253,16,10,6,6,2,4,15,11,4,-1,0,-1,100%,100%,100%,158,169,136,23%,21%,31%,0,0,0,1,0,1
363,https://vlr.gg/player/42557/6ankai,2024-09-29 12:40:00,1.62,1.65,1.63,274,264,296,19,12,7,10,5,5,10,8,2,+3,+3,0,94%,100%,83%,182,168,209,36%,26%,56%,4,3,1,1,0,1
364,https://vlr.gg/player/16012/akira,2024-09-29 12:40:00,1.59,1.26,1.48,262,240,307,18,12,6,10,4,6,4,1,3,+4,+3,+1,89%,92%,83%,178,164,206,39%,41%,36%,4,3,1,0,0,0
365,https://vlr.gg/player/33517/tripsy,2024-09-29 12:40:00,1.49,0.49,1.15,238,299,118,15,13,2,13,8,5,5,3,2,+3,+2,+1,89%,100%,67%,159,194,87,33%,28%,75%,4,3,1,1,1,0
366,https://vlr.gg/player/26789/pdr,2024-09-29 12:40:00,1.12,1.15,1.13,184,182,190,13,9,4,10,6,4,8,5,3,-1,0,-1,83%,92%,67%,116,113,121,14%,9%,23%,1,1,0,2,1,1
367,https://vlr.gg/player/4951/hardy,2024-09-29 12:40:00,1.87,0.75,1.12,204,290,162,13,8,5,13,3,10,6,2,4,-2,0,-2,67%,83%,58%,147,181,130,32%,31%,33%,2,1,1,4,1,3
368,https://vlr.gg/player/15383/khorror,2024-09-29 12:40:00,0.76,0.63,0.67,213,230,205,13,6,7,17,6,11,4,2,2,-1,0,-1,61%,100%,42%,137,120,145,26%,12%,36%,0,0,0,1,0,1
369,https://vlr.gg/player/41804/kalvo,2024-09-29 12:40:00,0.56,0.61,0.59,185,210,173,11,4,7,18,6,12,4,2,2,0,+2,-2,61%,67%,58%,112,131,102,38%,27%,47%,3,2,1,3,0,3
370,https://vlr.gg/player/29974/erizillo,2024-09-29 12:40:00,0.80,0.45,0.57,124,156,109,8,3,5,16,4,12,3,3,0,-1,0,-1,44%,67%,33%,86,111,74,43%,55%,33%,0,0,0,1,0,1
371,https://vlr.gg/player/42521/jahbu,2024-09-29 12:40:00,0.31,0.05,0.13,82,164,42,4,3,1,17,6,11,3,2,1,-4,-2,-2,39%,67%,25%,58,111,31,18%,21%,13%,0,0,0,4,2,2
372,https://vlr.gg/player/48123/zipix,2024-09-29 11:50:00,0.84,2.26,1.65,302,185,390,24,6,18,11,6,5,2,1,1,+1,-2,+3,71%,67%,75%,200,127,256,38%,50%,34%,3,0,3,2,2,0
373,https://vlr.gg/player/19874/mrpenguin,2024-09-29 11:50:00,1.45,1.13,1.26,199,249,162,16,10,6,10,5,5,4,2,2,0,0,0,71%,67%,75%,124,153,103,17%,11%,24%,2,1,1,2,1,1
374,https://vlr.gg/player/12430/skypzz,2024-09-29 11:50:00,0.93,0.87,0.90,236,242,233,18,8,10,17,8,9,3,0,3,0,0,0,76%,78%,75%,145,138,150,41%,40%,41%,3,1,2,3,1,2
375,https://vlr.gg/player/11830/mortyyyy,2024-09-29 11:50:00,0.04,1.41,0.81,186,65,278,12,1,11,17,9,8,9,3,6,0,-2,+2,67%,56%,75%,145,63,207,16%,7%,21%,2,0,2,2,2,0
376,https://vlr.gg/player/29989/stryder,2024-09-29 11:50:00,1.15,0.16,0.58,102,163,58,8,6,2,16,5,11,6,3,3,-2,-1,-1,67%,78%,58%,75,128,36,29%,33%,17%,0,0,0,2,1,1
377,https://vlr.gg/player/46181/nade,2024-09-29 11:50:00,1.51,1.93,1.69,333,289,394,24,13,11,14,9,5,6,2,4,+3,0,+3,71%,67%,78%,213,192,241,43%,47%,39%,6,2,4,3,2,1
378,https://vlr.gg/player/6117/kayn,2024-09-29 11:50:00,0.74,0.93,0.82,150,147,156,10,5,5,14,9,5,10,6,4,-1,-2,+1,67%,58%,78%,89,81,99,12%,12%,12%,1,0,1,2,2,0
379,https://vlr.gg/player/5834/mikelelle,2024-09-29 11:50:00,0.90,0.63,0.79,174,203,137,12,8,4,17,10,7,9,3,6,+1,+1,0,52%,42%,67%,127,147,99,35%,35%,36%,1,1,0,0,0,0
380,https://vlr.gg/player/45138/aster,2024-09-29 11:50:00,0.51,1.10,0.76,167,137,208,11,4,7,17,10,7,4,3,1,+1,-1,+2,67%,50%,89%,114,99,134,15%,8%,27%,2,0,2,1,1,0
381,https://vlr.gg/player/3372/ori4k,2024-09-29 11:50:00,0.64,0.82,0.72,162,172,151,13,7,6,16,10,6,2,1,1,-3,-2,-1,76%,75%,78%,107,118,91,46%,47%,44%,1,1,0,4,3,1
382,https://vlr.gg/player/21158/marti,2024-09-29 11:00:00,0.80,1.43,1.05,228,197,283,66,31,35,60,40,20,16,9,7,-7,-7,0,65%,63%,69%,149,128,180,29%,28%,31%,9,5,4,16,12,4
383,https://vlr.gg/player/39057/safiaa,2024-09-29 11:00:00,0.97,1.13,1.03,207,205,228,58,35,23,62,36,26,17,6,11,+3,+1,+2,71%,69%,75%,141,136,148,35%,36%,33%,10,4,6,7,3,4
384,https://vlr.gg/player/24058/tokameite,2024-09-29 11:00:00,0.94,0.93,0.94,164,181,151,45,30,15,59,39,20,32,16,16,-1,0,-1,76%,77%,75%,108,115,98,29%,30%,28%,0,0,0,1,0,1
385,https://vlr.gg/player/20761/looxie,2024-09-29 11:00:00,0.61,1.04,0.78,152,142,176,43,23,20,61,41,20,23,13,10,-8,-8,0,68%,60%,78%,97,86,112,31%,32%,31%,6,3,3,14,11,3
386,https://vlr.gg/player/30186/nami,2024-09-29 11:00:00,0.73,0.79,0.75,168,164,159,48,29,19,62,39,23,16,7,9,-5,-6,+1,66%,67%,66%,94,96,92,33%,39%,26%,6,2,4,11,8,3
387,https://vlr.gg/player/17343/ness,2024-09-29 11:00:00,1.03,1.35,1.22,220,172,252,60,18,42,47,20,27,32,11,21,+3,-1,+4,76%,69%,81%,153,121,175,24%,27%,23%,4,0,4,1,1,0
388,https://vlr.gg/player/26632/joliinaa,2024-09-29 11:00:00,0.89,1.39,1.19,239,185,268,68,22,46,50,23,27,29,12,17,+5,-1,+6,76%,63%,85%,156,123,178,29%,28%,29%,10,3,7,5,4,1
389,https://vlr.gg/player/24107/sarah,2024-09-29 11:00:00,1.00,1.01,1.01,189,165,200,53,20,33,49,18,31,25,8,17,-1,-2,+1,75%,78%,73%,124,117,129,26%,26%,26%,6,0,6,7,2,5
390,https://vlr.gg/player/16418/smurfette,2024-09-29 11:00:00,0.98,1.02,0.99,226,252,211,63,26,37,59,27,32,14,7,7,+7,-1,+8,71%,63%,77%,145,157,136,21%,21%,21%,18,7,11,11,8,3
391,https://vlr.gg/player/24101/miyori,2024-09-29 11:00:00,0.81,1.09,0.98,210,199,206,59,22,37,55,25,30,9,3,6,+4,+3,+1,73%,66%,77%,134,129,137,16%,17%,15%,11,5,6,7,2,5
392,https://vlr.gg/player/13024/vuubit,2024-09-29 11:00:00,1.86,1.53,1.66,335,344,330,22,9,13,11,4,7,11,3,8,+2,+3,-1,74%,57%,83%,208,218,201,32%,32%,31%,4,3,1,2,0,2
393,https://vlr.gg/player/46179/davia,2024-09-29 11:00:00,1.01,1.67,1.43,272,195,318,21,5,16,10,4,6,2,1,1,0,0,0,79%,86%,75%,181,146,202,31%,38%,29%,2,1,1,2,1,1
394,https://vlr.gg/player/4214/eso177,2024-09-29 11:00:00,0.97,1.56,1.34,235,171,273,16,4,12,10,4,6,4,0,4,+2,0,+2,79%,57%,92%,170,131,192,23%,27%,21%,2,0,2,0,0,0
395,https://vlr.gg/player/29998/drastz,2024-09-29 11:00:00,0.67,1.01,0.88,132,78,164,8,1,7,10,4,6,6,3,3,0,0,0,74%,71%,75%,95,61,115,13%,20%,11%,1,0,1,1,0,1
396,https://vlr.gg/player/8590/killdream,2024-09-29 11:00:00,1.09,0.74,0.87,129,167,107,10,5,5,9,3,6,4,1,3,-1,0,-1,74%,86%,67%,80,92,72,29%,30%,27%,2,1,1,3,1,2
397,https://vlr.gg/player/22154/pika,2024-09-29 11:00:00,0.80,1.76,1.16,236,169,352,18,8,10,15,11,4,4,4,0,-1,-2,+1,63%,50%,86%,130,84,210,41%,47%,36%,1,0,1,2,2,0
398,https://vlr.gg/player/2893/hastack,2024-09-29 11:00:00,0.66,1.42,0.94,205,166,272,11,5,6,14,10,4,1,1,0,0,0,0,58%,50%,71%,153,143,171,19%,19%,18%,0,0,0,0,0,0
399,https://vlr.gg/player/14894/facepalm,2024-09-29 11:00:00,0.54,0.84,0.65,147,165,118,9,6,3,15,11,4,3,2,1,+1,+1,0,53%,50%,57%,92,107,65,33%,46%,13%,6,5,1,5,4,1
400,https://vlr.gg/player/2996/neiker,2024-09-29 11:00:00,0.93,0.14,0.64,134,189,39,7,7,0,16,10,6,8,5,3,-2,0,-2,58%,67%,43%,91,124,36,31%,47%,0%,0,0,0,2,0,2
401,https://vlr.gg/player/44963/desire,2024-09-29 11:00:00,0.64,0.03,0.39,90,128,27,5,5,0,17,11,6,3,2,1,-1,+1,-2,42%,50%,29%,66,88,27,29%,33%,17%,1,1,0,2,0,2
402,https://vlr.gg/player/48146/ko,2024-09-29 07:00:00,,,,,,,,,,,,,,,,,,,,,,,,,,,,,,,,,
403,https://vlr.gg/player/48147/kotoza,2024-09-29 07:00:00,,,,,,,,,,,,,,,,,,,,,,,,,,,,,,,,,
404,https://vlr.gg/player/48148/kihane,2024-09-29 07:00:00,,,,,,,,,,,,,,,,,,,,,,,,,,,,,,,,,
405,https://vlr.gg/player/48149/rain,2024-09-29 07:00:00,,,,,,,,,,,,,,,,,,,,,,,,,,,,,,,,,
406,https://vlr.gg/player/48150/yuyoo,2024-09-29 07:00:00,,,,,,,,,,,,,,,,,,,,,,,,,,,,,,,,,
407,https://vlr.gg/player/25415/yusin,2024-09-29 07:00:00,,,,,,,,,,,,,,,,,,,,,,,,,,,,,,,,,
408,https://vlr.gg/player/1909/jinny,2024-09-29 07:00:00,,,,,,,,,,,,,,,,,,,,,,,,,,,,,,,,,
409,https://vlr.gg/player/13232/muffyn,2024-09-29 07:00:00,,,,,,,,,,,,,,,,,,,,,,,,,,,,,,,,,
410,https://vlr.gg/player/48160/laiyin,2024-09-29 07:00:00,,,,,,,,,,,,,,,,,,,,,,,,,,,,,,,,,
411,https://vlr.gg/player/48161/1hp,2024-09-29 07:00:00,,,,,,,,,,,,,,,,,,,,,,,,,,,,,,,,,
412,https://vlr.gg/player/41173/jianbao,2024-09-29 05:00:00,,,,,,,,,,,,,,,,,,,,,,,,,,,,,,,,,
413,https://vlr.gg/player/41171/qbb,2024-09-29 05:00:00,,,,,,,,,,,,,,,,,,,,,,,,,,,,,,,,,
414,https://vlr.gg/player/41175/m77,2024-09-29 05:00:00,,,,,,,,,,,,,,,,,,,,,,,,,,,,,,,,,
415,https://vlr.gg/player/30321/pochacco,2024-09-29 05:00:00,,,,,,,,,,,,,,,,,,,,,,,,,,,,,,,,,
416,https://vlr.gg/player/48138/end3,2024-09-29 05:00:00,,,,,,,,,,,,,,,,,,,,,,,,,,,,,,,,,
417,https://vlr.gg/player/17523/yue,2024-09-29 05:00:00,,,,,,,,,,,,,,,,,,,,,,,,,,,,,,,,,
418,https://vlr.gg/player/41210/yc33,2024-09-29 05:00:00,,,,,,,,,,,,,,,,,,,,,,,,,,,,,,,,,
419,https://vlr.gg/player/41209/jacketzz,2024-09-29 05:00:00,,,,,,,,,,,,,,,,,,,,,,,,,,,,,,,,,
420,https://vlr.gg/player/48139/amei,2024-09-29 05:00:00,,,,,,,,,,,,,,,,,,,,,,,,,,,,,,,,,
421,https://vlr.gg/player/48140/yzy,2024-09-29 05:00:00,,,,,,,,,,,,,,,,,,,,,,,,,,,,,,,,,
422,https://vlr.gg/player/31829/ivy,2024-09-29 03:45:00,1.17,1.16,1.17,209,200,228,92,46,46,76,37,39,38,20,18,-2,+1,-3,72%,72%,71%,141,140,142,33%,35%,30%,5,3,2,7,2,5
423,https://vlr.gg/player/4122/persia,2024-09-29 03:45:00,1.24,1.10,1.17,231,237,219,95,54,41,82,41,41,43,27,16,-5,0,-5,75%,78%,71%,152,158,145,37%,46%,29%,12,7,5,17,7,10
424,https://vlr.gg/player/31828/francis,2024-09-29 03:45:00,1.10,0.98,1.04,199,205,211,92,50,42,83,42,41,42,23,19,0,-3,+3,66%,68%,64%,133,131,135,29%,26%,33%,7,1,6,7,4,3
425,https://vlr.gg/player/31827/dambi,2024-09-29 03:45:00,0.79,1.06,0.92,220,209,223,90,45,45,96,54,42,39,22,17,-5,-9,+4,71%,69%,72%,135,131,140,19%,19%,19%,23,12,11,28,21,7
426,https://vlr.gg/player/33576/margaret,2024-09-29 03:45:00,0.92,0.75,0.84,161,195,118,68,44,24,85,47,38,33,15,18,-3,-2,-1,63%,63%,62%,107,134,78,30%,33%,24%,7,3,4,10,5,5
427,https://vlr.gg/player/2348/famouz,2024-09-29 03:45:00,1.19,1.06,1.12,236,238,228,103,51,52,90,41,49,25,11,14,+6,+3,+3,73%,76%,71%,143,144,142,14%,16%,13%,24,12,12,18,9,9
428,https://vlr.gg/player/4874/berserx,2024-09-29 03:45:00,1.31,0.84,1.06,209,266,167,91,54,37,86,38,48,28,16,12,+1,0,+1,66%,71%,62%,144,174,118,27%,33%,20%,10,6,4,9,6,3
429,https://vlr.gg/player/7043/ncslasher,2024-09-29 03:45:00,0.94,1.05,1.00,201,180,214,88,39,49,88,40,48,32,20,12,+7,+1,+6,74%,78%,71%,126,110,141,29%,36%,24%,16,7,9,9,6,3
430,https://vlr.gg/player/10739/shiro,2024-09-29 03:45:00,0.85,0.94,0.90,165,148,193,67,28,39,88,39,49,57,26,31,0,-3,+3,71%,69%,72%,118,103,131,19%,16%,22%,8,2,6,8,5,3
431,https://vlr.gg/player/2380/zesbeew,2024-09-29 03:45:00,0.78,0.98,0.89,170,145,193,72,28,44,85,41,44,50,28,22,+1,+1,0,69%,67%,71%,107,92,122,19%,15%,21%,11,3,8,10,2,8
432,https://vlr.gg/player/4871/xffero,2024-09-29 01:30:00,2.11,1.81,1.90,302,292,307,20,5,15,9,2,7,6,4,2,+2,+1,+1,94%,100%,92%,209,163,228,40%,33%,42%,3,1,2,1,0,1
433,https://vlr.gg/player/8497/monyet,2024-09-29 01:30:00,1.67,1.60,1.62,349,408,325,21,7,14,11,3,8,5,2,3,+1,-1,+2,88%,80%,92%,235,249,229,30%,21%,35%,2,0,2,1,1,0
434,https://vlr.gg/player/9801/f0rsaken,2024-09-29 01:30:00,0.99,1.58,1.41,317,312,320,20,7,13,11,3,8,8,0,8,+2,+1,+1,88%,100%,83%,195,191,196,30%,33%,29%,3,1,2,1,0,1
435,https://vlr.gg/player/2346/cud,2024-09-29 01:30:00,0.02,1.02,0.68,161,201,145,8,3,5,10,4,6,7,2,5,-1,-1,0,88%,80%,92%,118,135,112,35%,31%,38%,1,0,1,2,1,1
436,https://vlr.gg/player/7045/fl1pzjder,2024-09-29 01:30:00,0.00,0.90,0.34,107,42,135,7,1,6,9,3,6,3,0,3,+1,+1,0,76%,80%,75%,63,15,83,40%,0%,50%,2,1,1,1,0,1
437,https://vlr.gg/player/9800/mindfreak,2024-09-29 01:30:00,0.66,2.81,1.29,193,222,126,11,9,2,18,13,5,2,1,1,-1,-1,0,53%,58%,40%,127,149,74,46%,41%,75%,0,0,0,1,1,0
438,https://vlr.gg/player/7764/lmemore,2024-09-29 01:30:00,1.14,0.01,0.74,237,265,172,14,11,3,15,10,5,1,1,0,+3,+2,+1,65%,75%,40%,157,184,95,34%,34%,33%,3,2,1,0,0,0
439,https://vlr.gg/player/11666/ray4c,2024-09-29 01:30:00,0.47,1.05,0.64,119,130,94,7,5,2,15,10,5,4,4,0,-6,-4,-2,53%,67%,20%,68,82,36,14%,17%,0%,2,1,1,8,5,3
440,https://vlr.gg/player/10816/xccurate,2024-09-29 01:30:00,0.27,1.48,0.63,159,104,294,9,4,5,15,11,4,2,1,1,0,0,0,47%,50%,40%,117,76,215,27%,27%,27%,1,1,0,1,1,0
441,https://vlr.gg/player/1743/blazek1ng,2024-09-29 01:30:00,0.70,0.01,0.41,141,128,174,9,6,3,13,9,4,2,2,0,-1,-1,0,53%,58%,40%,100,95,111,33%,22%,100%,0,0,0,1,1,0
442,https://vlr.gg/player/25741/lied,2024-09-28 18:00:00,1.60,1.41,1.47,311,324,310,102,36,66,65,24,41,21,10,11,+13,+4,+9,68%,65%,70%,202,223,190,26%,30%,24%,27,9,18,14,5,9
443,https://vlr.gg/player/35927/dano,2024-09-28 18:00:00,0.84,1.27,1.11,182,132,214,66,16,50,57,23,34,25,8,17,+1,-1,+2,64%,59%,67%,127,103,141,32%,29%,33%,4,1,3,3,2,1
444,https://vlr.gg/player/35547/raquinuki,2024-09-28 18:00:00,0.93,0.91,0.92,178,161,191,58,18,40,67,24,43,23,8,15,+8,+4,+4,65%,62%,67%,123,119,124,30%,43%,25%,12,6,6,4,2,2
445,https://vlr.gg/player/29223/tura,2024-09-28 18:00:00,0.63,1.07,0.91,200,137,242,66,17,49,75,28,47,40,15,25,-5,-5,0,73%,68%,77%,136,97,157,32%,27%,34%,6,0,6,11,5,6
446,https://vlr.gg/player/44481/melsm,2024-09-28 18:00:00,0.72,0.69,0.70,121,109,130,35,13,22,51,19,32,15,5,10,-6,-2,-4,67%,61%,71%,88,74,97,22%,31%,18%,3,1,2,9,3,6
447,https://vlr.gg/player/40338/natas,2024-09-28 18:00:00,0.23,0.24,0.24,75,51,82,4,1,3,14,3,11,2,0,2,-1,0,-1,40%,33%,42%,54,53,54,31%,100%,25%,0,0,0,1,0,1
448,https://vlr.gg/player/44501/lauguz,2024-09-28 18:00:00,0.81,1.52,1.07,218,184,273,72,39,33,65,48,17,20,9,11,+2,0,+2,71%,72%,71%,148,126,185,28%,27%,30%,12,7,5,10,7,3
449,https://vlr.gg/player/21476/cami,2024-09-28 18:00:00,1.21,0.84,1.06,213,240,152,65,49,16,64,44,20,45,25,20,-2,+1,-3,72%,68%,79%,138,160,97,45%,47%,40%,8,5,3,10,4,6
450,https://vlr.gg/player/15592/angel,2024-09-28 18:00:00,0.99,0.93,0.97,169,181,156,57,39,18,61,42,19,23,12,11,-1,-3,+2,73%,73%,74%,118,124,106,49%,55%,40%,4,1,3,5,4,1
451,https://vlr.gg/player/28598/chloe,2024-09-28 18:00:00,0.79,1.24,0.95,200,180,228,69,36,33,69,48,21,23,14,9,-5,-5,0,69%,63%,79%,125,117,140,24%,24%,23%,10,6,4,15,11,4
452,https://vlr.gg/player/35839/vefa,2024-09-28 18:00:00,0.94,0.83,0.90,200,213,166,63,44,19,72,49,23,21,14,7,-4,-3,-1,68%,67%,71%,128,138,110,20%,20%,19%,8,6,2,12,9,3
453,https://vlr.gg/player/11236/antg,2024-09-28 18:00:00,1.04,1.46,1.24,224,192,265,34,15,19,30,17,13,23,11,12,0,0,0,80%,75%,86%,140,123,159,23%,22%,24%,3,1,2,3,1,2
454,https://vlr.gg/player/27724/natasha,2024-09-28 18:00:00,0.92,1.32,1.11,215,182,256,38,17,21,34,18,16,7,1,6,+6,+1,+5,82%,71%,95%,133,115,155,29%,21%,36%,7,2,5,1,1,0
455,https://vlr.gg/player/9821/m4ndzin,2024-09-28 18:00:00,1.31,0.46,0.92,191,258,114,27,20,7,34,18,16,25,16,9,+2,+2,0,67%,71%,62%,130,164,91,19%,22%,14%,3,2,1,1,0,1
456,https://vlr.gg/player/22997/waved,2024-09-28 18:00:00,0.71,0.97,0.83,228,225,231,37,20,17,36,20,16,6,1,5,+4,-4,+8,64%,46%,86%,150,142,158,25%,24%,27%,12,4,8,8,8,0
457,https://vlr.gg/player/11242/blu,2024-09-28 18:00:00,0.60,0.74,0.66,152,146,160,25,13,12,33,19,14,12,4,8,-3,-1,-2,78%,79%,76%,107,99,115,23%,26%,20%,2,2,0,5,3,2
458,https://vlr.gg/player/12143/bizerra,2024-09-28 18:00:00,1.60,1.68,1.64,308,298,318,47,20,27,31,15,16,28,14,14,+1,-2,+3,80%,90%,71%,202,218,188,26%,33%,20%,6,1,5,5,3,2
459,https://vlr.gg/player/11232/daiki,2024-09-28 18:00:00,1.23,1.06,1.14,216,217,215,33,15,18,30,13,17,24,13,11,-4,-3,-1,73%,76%,71%,148,138,157,33%,28%,37%,0,0,0,4,3,1
460,https://vlr.gg/player/4807/bstrdd,2024-09-28 18:00:00,0.83,1.18,1.02,224,204,244,36,17,19,36,18,18,11,2,9,-5,-3,-2,69%,67%,71%,149,137,160,35%,38%,33%,6,3,3,11,6,5
461,https://vlr.gg/player/15297/joojina,2024-09-28 18:00:00,0.93,0.83,0.88,178,171,186,27,12,15,33,14,19,15,8,7,0,-2,+2,69%,71%,67%,123,116,129,19%,17%,21%,4,0,4,4,2,2
462,https://vlr.gg/player/14386/isaa,2024-09-28 18:00:00,0.78,0.82,0.80,149,147,149,24,11,13,31,16,15,12,6,6,-1,-1,0,62%,57%,67%,105,111,100,22%,18%,27%,2,1,1,3,2,1
463,https://vlr.gg/player/21435/jelly,2024-09-28 16:00:00,1.50,1.52,1.51,255,245,275,38,20,18,20,10,10,11,7,4,+2,+2,0,76%,90%,59%,168,150,190,36%,40%,33%,4,2,2,2,0,2
464,https://vlr.gg/player/11239/sayuri,2024-09-28 16:00:00,1.19,1.84,1.49,245,188,318,36,16,20,17,9,8,23,10,13,+6,+2,+4,92%,90%,94%,148,112,191,16%,17%,15%,6,2,4,0,0,0
465,https://vlr.gg/player/31574/srn,2024-09-28 16:00:00,1.49,1.08,1.30,305,358,234,36,25,11,24,14,10,11,5,6,+2,+3,-1,81%,90%,71%,204,235,166,19%,25%,11%,9,7,2,7,4,3
466,https://vlr.gg/player/14685/jubs,2024-09-28 16:00:00,1.16,1.31,1.23,208,208,205,28,15,13,17,9,8,9,4,5,+2,0,+2,81%,80%,82%,128,124,132,19%,16%,23%,4,2,2,2,2,0
467,https://vlr.gg/player/19791/mel,2024-09-28 16:00:00,1.02,0.64,0.85,139,173,97,16,12,4,22,12,10,17,11,6,-1,-1,0,78%,80%,76%,89,113,61,24%,32%,9%,1,0,1,2,1,1
468,https://vlr.gg/player/29179/vii,2024-09-28 16:00:00,1.37,0.87,1.10,257,298,215,31,17,14,31,13,18,6,4,2,-1,+2,-3,62%,71%,55%,155,183,131,22%,23%,21%,4,4,0,5,2,3
469,https://vlr.gg/player/24764/akame,2024-09-28 16:00:00,0.55,1.19,0.89,166,118,209,21,6,15,29,14,15,11,7,4,0,-2,+2,62%,59%,65%,110,96,122,26%,17%,34%,4,1,3,4,3,1
470,https://vlr.gg/player/24763/speedy,2024-09-28 16:00:00,0.66,0.57,0.61,135,112,159,16,6,10,31,12,19,8,5,3,-1,-2,+1,59%,65%,55%,99,78,117,32%,24%,38%,1,0,1,2,2,0
471,https://vlr.gg/player/6994/shyz,2024-09-28 16:00:00,0.54,0.58,0.56,102,71,126,13,5,8,30,12,18,7,5,2,-2,-1,-1,49%,53%,45%,74,52,93,25%,11%,33%,1,0,1,3,1,2
472,https://vlr.gg/player/14690/lissa,2024-09-28 16:00:00,0.78,0.26,0.50,146,204,98,19,12,7,33,15,18,4,3,1,-7,-2,-5,57%,59%,55%,98,136,66,36%,40%,29%,3,1,2,10,3,7
473,https://vlr.gg/player/11336/xkyjote,2024-09-28 15:25:00,1.65,0.55,0.99,219,275,183,14,8,6,16,4,12,3,0,3,-2,-1,-1,60%,63%,58%,152,163,144,30%,39%,23%,0,0,0,2,1,1
474,https://vlr.gg/player/2893/hastack,2024-09-28 15:25:00,0.73,1.08,0.94,217,206,225,14,5,9,14,5,9,6,1,5,-3,-3,0,65%,63%,67%,132,118,142,21%,16%,24%,3,0,3,6,3,3
475,https://vlr.gg/player/2996/neiker,2024-09-28 15:25:00,1.03,0.68,0.82,191,225,169,15,7,8,17,6,11,3,2,1,+1,+1,0,65%,75%,58%,138,167,119,38%,37%,38%,2,1,1,1,0,1
476,https://vlr.gg/player/44963/desire,2024-09-28 15:25:00,0.34,1.09,0.79,174,94,228,12,2,10,16,6,10,7,5,2,-2,-2,0,65%,63%,67%,117,72,148,45%,17%,65%,1,0,1,3,2,1
477,https://vlr.gg/player/22154/pika,2024-09-28 15:25:00,1.01,0.41,0.65,132,134,131,8,4,4,16,5,11,7,4,3,0,+1,-1,65%,75%,58%,96,88,100,32%,23%,40%,1,1,0,1,0,1
478,https://vlr.gg/player/22291/razziss,2024-09-28 15:25:00,1.99,1.86,1.94,379,392,359,27,17,10,11,7,4,4,2,2,+4,+2,+2,85%,83%,88%,242,243,242,40%,47%,30%,6,4,2,2,2,0
479,https://vlr.gg/player/22188/jimbk,2024-09-28 15:25:00,1.69,1.03,1.43,248,284,196,18,14,4,11,6,5,6,3,3,+1,0,+1,75%,83%,63%,166,181,143,23%,21%,30%,2,0,2,1,0,1
480,https://vlr.gg/player/33513/sihw,2024-09-28 15:25:00,1.06,1.39,1.19,248,236,268,18,10,8,13,8,5,2,2,0,+2,0,+2,70%,83%,50%,165,165,166,51%,40%,89%,2,0,2,0,0,0
481,https://vlr.gg/player/16139/enrik,2024-09-28 15:25:00,1.11,0.59,0.91,149,177,109,12,9,3,11,6,5,5,4,1,-2,-2,0,75%,75%,75%,99,125,60,21%,27%,8%,0,0,0,2,2,0
482,https://vlr.gg/player/45143/francybald,2024-09-28 15:25:00,0.20,0.06,0.15,60,82,28,4,3,1,17,10,7,2,1,1,+1,+2,-1,45%,58%,25%,42,50,31,25%,20%,50%,3,3,0,2,1,1
483,https://vlr.gg/player/29972/michel,2024-09-28 14:25:00,1.96,1.00,1.50,325,442,198,27,19,8,16,8,8,2,1,1,+4,+4,0,65%,75%,55%,216,280,146,41%,40%,44%,5,4,1,1,0,1
484,https://vlr.gg/player/2835/kyrrz,2024-09-28 14:25:00,1.16,1.20,1.18,177,150,207,15,7,8,12,6,6,10,6,4,-2,-2,0,74%,75%,73%,115,92,139,38%,64%,26%,1,0,1,3,2,1
485,https://vlr.gg/player/24359/faska,2024-09-28 14:25:00,0.95,1.24,1.09,197,138,261,15,7,8,14,6,8,7,3,4,0,-1,+1,65%,58%,73%,136,99,177,13%,12%,14%,2,0,2,2,1,1
486,https://vlr.gg/player/4851/rexs,2024-09-28 14:25:00,1.12,0.78,0.96,183,210,153,15,9,6,16,7,9,8,4,4,-1,0,-1,61%,58%,64%,122,118,127,29%,28%,30%,1,1,0,2,1,1
487,https://vlr.gg/player/31553/pukytoo,2024-09-28 14:25:00,0.59,0.99,0.78,136,98,179,11,3,8,14,7,7,3,3,0,0,-3,+3,70%,67%,73%,95,75,118,25%,31%,21%,3,0,3,3,3,0
488,https://vlr.gg/player/46181/nade,2024-09-28 14:25:00,0.99,1.21,1.11,257,223,290,21,9,12,18,9,9,1,1,0,+3,0,+3,61%,55%,67%,147,117,174,23%,22%,24%,6,2,4,3,2,1
489,https://vlr.gg/player/5834/mikelelle,2024-09-28 14:25:00,1.33,0.67,0.98,155,226,90,13,9,4,13,5,8,7,5,2,0,-1,+1,65%,73%,58%,95,135,59,39%,44%,30%,2,1,1,2,2,0
490,https://vlr.gg/player/3372/ori4k,2024-09-28 14:25:00,0.78,1.01,0.90,219,200,237,16,7,9,18,8,10,2,1,1,-2,-2,0,61%,55%,67%,145,127,162,37%,53%,29%,3,1,2,5,3,2
491,https://vlr.gg/player/45138/aster,2024-09-28 14:25:00,1.18,0.61,0.88,187,257,124,15,10,5,17,8,9,5,1,4,-1,0,-1,57%,64%,50%,140,209,76,36%,42%,25%,0,0,0,1,0,1
492,https://vlr.gg/player/6117/kayn,2024-09-28 14:25:00,0.54,0.63,0.59,99,77,121,7,3,4,17,8,9,10,5,5,-1,0,-1,70%,64%,75%,67,48,84,27%,22%,29%,0,0,0,1,0,1
493,https://vlr.gg/player/29903/madv,2024-09-28 14:15:00,0.90,1.32,1.08,221,199,279,46,21,25,45,29,16,22,16,6,+2,+1,+1,72%,67%,79%,161,138,192,34%,29%,39%,6,2,4,4,1,3
494,https://vlr.gg/player/20055/toki,2024-09-28 14:15:00,1.07,0.88,0.99,164,178,148,34,20,14,36,22,14,21,11,10,-1,0,-1,77%,73%,83%,114,125,99,38%,40%,34%,2,2,0,3,2,1
495,https://vlr.gg/player/19371/eva,2024-09-28 14:15:00,0.64,1.28,0.91,204,149,272,36,16,20,44,28,16,19,9,10,+1,-1,+2,70%,55%,92%,125,93,169,18%,22%,15%,4,1,3,3,2,1
496,https://vlr.gg/player/29900/sandra,2024-09-28 14:15:00,0.72,0.95,0.82,177,150,222,38,19,19,46,27,19,12,4,8,-1,-1,0,67%,55%,83%,120,101,146,38%,42%,35%,5,2,3,6,3,3
497,https://vlr.gg/player/17333/mary,2024-09-28 14:15:00,0.51,0.83,0.64,174,185,166,36,20,16,49,31,18,11,5,6,-14,-8,-6,61%,58%,67%,117,120,113,24%,26%,22%,5,5,0,19,13,6
498,https://vlr.gg/player/24107/sarah,2024-09-28 14:15:00,1.09,1.43,1.29,259,231,278,53,19,34,39,19,20,22,10,12,+4,+1,+3,82%,79%,85%,158,141,170,33%,25%,38%,5,1,4,1,0,1
499,https://vlr.gg/player/24101/miyori,2024-09-28 14:15:00,1.48,1.00,1.20,229,270,186,48,24,24,36,17,19,9,6,3,+2,+1,+1,75%,75%,76%,146,169,129,28%,31%,26%,8,4,4,6,3,3
500,https://vlr.gg/player/17343/ness,2024-09-28 14:15:00,0.81,1.46,1.18,182,142,218,37,12,25,33,19,14,23,8,15,+2,0,+2,84%,79%,88%,134,109,153,21%,31%,17%,3,1,2,1,1,0
501,https://vlr.gg/player/16418/smurfette,2024-09-28 14:15:00,0.46,1.40,1.00,243,150,297,47,12,35,44,22,22,11,3,8,+6,+1,+5,65%,58%,70%,147,94,186,19%,22%,16%,14,6,8,8,5,3
502,https://vlr.gg/player/26632/joliinaa,2024-09-28 14:15:00,1.12,0.88,0.98,191,203,180,35,16,19,38,17,21,25,15,10,-1,+1,-2,75%,79%,73%,123,125,122,27%,27%,28%,5,2,3,6,1,5
0,https://vlr.gg/player/33517/tripsy,2024-09-28 13:35:00,1.32,0.74,0.91,202,254,181,13,5,8,15,4,11,1,0,1,0,0,0,41%,40%,42%,114,153,97,48%,86%,33%,1,0,1,1,0,1
1,https://vlr.gg/player/10448/kozok,2024-09-28 13:35:00,0.93,0.89,0.90,191,233,174,11,4,7,15,5,10,4,2,2,-1,0,-1,47%,60%,42%,129,172,112,16%,36%,9%,0,0,0,1,0,1
2,https://vlr.gg/player/16012/akira,2024-09-28 13:35:00,0.42,0.76,0.66,135,142,133,7,2,5,15,5,10,7,2,5,-2,0,-2,53%,60%,50%,104,83,112,19%,13%,22%,1,1,0,3,1,2
3,https://vlr.gg/player/26789/pdr,2024-09-28 13:35:00,0.26,0.61,0.51,86,66,95,4,1,3,15,5,10,11,4,7,-1,0,-1,53%,60%,50%,54,26,65,20%,0%,23%,0,0,0,1,0,1
4,https://vlr.gg/player/42557/6ankai,2024-09-28 13:35:00,0.05,0.62,0.46,162,134,175,8,2,6,16,5,11,3,0,3,-1,+1,-2,47%,60%,42%,109,78,122,16%,0%,21%,4,2,2,5,1,4
5,https://vlr.gg/player/17861/blastinho,2024-09-28 13:35:00,1.57,2.60,1.87,343,290,472,23,14,9,8,6,2,3,2,1,+3,+2,+1,82%,75%,100%,213,185,281,22%,29%,13%,4,2,2,1,0,1
6,https://vlr.gg/player/41847/negradas,2024-09-28 13:35:00,1.37,1.48,1.41,210,222,185,13,10,3,7,5,2,13,8,5,0,+1,-1,94%,92%,100%,136,145,113,19%,19%,20%,1,1,0,1,0,1
7,https://vlr.gg/player/2884/daniel0,2024-09-28 13:35:00,1.41,0.64,1.18,233,277,128,14,12,2,8,5,3,3,2,1,+1,+1,0,76%,83%,60%,157,182,95,30%,31%,25%,2,2,0,1,1,0
8,https://vlr.gg/player/8811/humanz,2024-09-28 13:35:00,0.84,1.86,1.14,220,159,369,14,7,7,10,7,3,4,2,2,-1,0,-1,88%,83%,100%,149,115,231,38%,33%,42%,1,1,0,2,1,1
9,https://vlr.gg/player/19588/neptuno,2024-09-28 13:35:00,1.27,0.63,1.09,192,210,149,12,9,3,10,6,4,8,5,3,+2,+2,0,88%,83%,100%,107,120,76,34%,35%,33%,3,3,0,1,1,0
10,https://vlr.gg/player/41846/shiro,2024-09-28 12:35:00,1.14,1.12,1.13,233,238,230,20,10,10,17,7,10,4,1,3,-3,-2,-1,57%,55%,58%,146,146,145,33%,27%,40%,2,1,1,5,3,2
11,https://vlr.gg/player/29827/repteyy,2024-09-28 12:35:00,1.23,0.97,1.09,199,202,197,17,9,8,16,6,10,9,6,3,-1,0,-1,70%,64%,75%,118,117,120,32%,15%,64%,0,0,0,1,0,1
12,https://vlr.gg/player/16141/sora,2024-09-28 12:35:00,0.38,1.43,0.93,196,125,261,14,4,10,16,9,7,4,1,3,0,0,0,65%,64%,67%,119,85,150,26%,45%,17%,4,2,2,4,2,2
13,https://vlr.gg/player/29638/kotaro,2024-09-28 12:35:00,1.32,0.54,0.91,154,226,88,12,8,4,15,6,9,7,4,3,-1,0,-1,57%,64%,50%,109,154,68,34%,30%,42%,0,0,0,1,0,1
14,https://vlr.gg/player/29994/xini,2024-09-28 12:35:00,0.66,0.59,0.62,157,130,184,13,5,8,19,7,12,5,2,3,-2,+1,-3,74%,64%,83%,114,84,141,27%,17%,40%,2,2,0,4,1,3
15,https://vlr.gg/player/32300/varuxx,2024-09-28 12:35:00,1.49,1.13,1.32,246,271,220,20,13,7,15,7,8,6,2,4,+1,0,+1,83%,83%,82%,175,196,152,53%,60%,44%,2,1,1,1,1,0
16,https://vlr.gg/player/44130/bern1,2024-09-28 12:35:00,1.26,1.23,1.25,209,225,192,17,10,7,13,7,6,3,2,1,+3,+1,+2,74%,83%,64%,143,166,119,28%,26%,32%,3,1,2,0,0,0
17,https://vlr.gg/player/33833/pepecho,2024-09-28 12:35:00,1.06,1.10,1.08,199,206,192,16,9,7,15,8,7,8,4,4,+2,+3,-1,83%,92%,73%,128,124,133,29%,27%,32%,4,3,1,2,0,2
18,https://vlr.gg/player/46233/kz,2024-09-28 12:35:00,0.77,1.38,1.06,261,226,299,21,9,12,17,10,7,6,3,3,+1,+2,-1,61%,58%,64%,165,139,194,20%,9%,32%,4,3,1,3,1,2
19,https://vlr.gg/player/36637/xpatrycksio,2024-09-28 12:35:00,0.86,0.56,0.71,136,184,85,9,7,2,16,8,8,15,7,8,0,0,0,74%,92%,55%,91,127,52,19%,26%,6%,2,1,1,2,1,1
20,https://vlr.gg/player/4214/eso177,2024-09-28 11:40:00,1.16,2.09,1.47,330,252,488,21,11,10,12,8,4,1,1,0,+2,+3,-1,78%,75%,83%,213,165,308,46%,38%,55%,3,3,0,1,0,1
21,https://vlr.gg/player/46179/davia,2024-09-28 11:40:00,1.41,1.38,1.40,283,312,226,19,14,5,12,9,3,2,1,1,+4,+2,+2,78%,83%,67%,205,218,178,56%,52%,71%,6,3,3,2,1,1
22,https://vlr.gg/player/13024/vuubit,2024-09-28 11:40:00,1.07,1.43,1.19,179,140,257,12,6,6,9,6,3,6,6,0,+1,0,+1,78%,75%,83%,122,97,172,42%,38%,46%,1,0,1,0,0,0
23,https://vlr.gg/player/8590/killdream,2024-09-28 11:40:00,1.13,0.62,0.96,160,205,72,12,10,2,11,7,4,8,5,3,-2,-2,0,72%,75%,67%,119,152,55,19%,16%,33%,0,0,0,2,2,0
24,https://vlr.gg/player/29998/drastz,2024-09-28 11:40:00,0.75,1.12,0.87,135,141,126,9,6,3,10,8,2,6,3,3,-1,-1,0,78%,67%,100%,95,95,94,18%,20%,14%,1,1,0,2,2,0
25,https://vlr.gg/player/29974/erizillo,2024-09-28 11:40:00,0.26,1.81,1.29,214,42,301,14,0,14,12,5,7,6,5,1,-1,-1,0,72%,67%,75%,140,29,196,28%,0%,31%,1,0,1,2,1,1
26,https://vlr.gg/player/4951/hardy,2024-09-28 11:40:00,1.36,0.99,1.11,259,362,209,16,8,8,15,6,9,5,2,3,-1,0,-1,78%,83%,75%,169,213,146,28%,24%,32%,0,0,0,1,0,1
27,https://vlr.gg/player/41804/kalvo,2024-09-28 11:40:00,1.34,0.92,1.06,238,271,222,16,6,10,15,5,10,2,1,1,+2,+2,0,67%,83%,58%,139,167,124,31%,18%,47%,5,2,3,3,0,3
28,https://vlr.gg/player/42521/jahbu,2024-09-28 11:40:00,0.33,0.58,0.49,114,79,132,6,2,4,15,5,10,5,0,5,-2,-2,0,56%,50%,58%,73,49,85,37%,67%,31%,1,0,1,3,2,1
29,https://vlr.gg/player/15383/khorror,2024-09-28 11:40:00,0.30,0.29,0.29,79,61,89,2,0,2,16,5,11,13,5,8,-2,-1,-1,67%,83%,58%,60,57,62,8%,0%,14%,0,0,0,2,1,1
30,https://vlr.gg/player/20064/vania,2024-09-28 11:00:00,1.75,1.22,1.49,269,331,202,55,36,19,28,15,13,13,7,6,+4,+3,+1,80%,79%,81%,170,211,127,43%,43%,43%,5,3,2,1,0,1
31,https://vlr.gg/player/17323/mimi,2024-09-28 11:00:00,0.87,1.10,0.98,197,181,206,36,19,17,38,20,18,21,9,12,-2,-1,-1,75%,79%,70%,122,113,132,37%,33%,40%,3,2,1,5,3,2
32,https://vlr.gg/player/36175/rezq,2024-09-28 11:00:00,1.00,0.83,0.92,234,274,207,44,26,18,43,24,19,12,7,5,+4,+4,0,73%,79%,67%,153,171,133,24%,19%,35%,13,9,4,9,5,4
33,https://vlr.gg/player/24149/amy,2024-09-28 11:00:00,1.06,0.56,0.82,152,179,135,33,20,13,34,16,18,7,4,3,+1,0,+1,61%,66%,56%,107,123,89,34%,32%,37%,5,2,3,4,2,2
34,https://vlr.gg/player/17320/petra,2024-09-28 11:00:00,0.83,0.56,0.68,127,125,137,24,12,12,37,18,19,17,10,7,-4,-3,-1,70%,69%,70%,96,90,102,20%,18%,23%,3,0,3,7,3,4
35,https://vlr.gg/player/24058/tokameite,2024-09-28 11:00:00,1.00,1.16,1.08,176,142,216,34,13,21,33,13,20,24,10,14,0,-1,+1,75%,70%,79%,119,98,139,28%,33%,24%,1,0,1,1,1,0
36,https://vlr.gg/player/20761/looxie,2024-09-28 11:00:00,1.32,0.79,1.05,198,218,179,40,22,18,37,14,23,6,0,6,0,+1,-1,64%,67%,62%,126,136,117,42%,36%,50%,5,2,3,5,1,4
37,https://vlr.gg/player/30186/nami,2024-09-28 11:00:00,1.05,0.84,0.94,190,185,189,37,18,19,40,17,23,13,5,8,+6,+3,+3,73%,74%,72%,119,123,115,38%,48%,32%,9,4,5,3,1,2
38,https://vlr.gg/player/39057/safiaa,2024-09-28 11:00:00,1.06,0.80,0.92,184,183,176,35,18,17,40,16,24,14,4,10,-1,+1,-2,68%,78%,59%,123,120,126,35%,32%,38%,5,2,3,6,1,5
39,https://vlr.gg/player/21158/marti,2024-09-28 11:00:00,0.77,0.87,0.82,179,170,183,34,16,18,42,19,23,9,4,5,-8,-4,-4,70%,78%,62%,122,114,129,32%,30%,34%,6,5,1,14,9,5
40,https://vlr.gg/player/48127/riasu,2024-09-28 11:00:00,1.87,1.48,1.79,258,259,255,16,13,3,6,3,3,3,2,1,-2,-1,-1,87%,92%,67%,168,168,167,33%,36%,14%,0,0,0,2,1,1
41,https://vlr.gg/player/45145/costaa,2024-09-28 11:00:00,1.99,0.92,1.78,378,425,192,20,19,1,7,5,2,7,6,1,+1,+1,0,100%,100%,100%,220,245,124,20%,21%,14%,1,1,0,0,0,0
42,https://vlr.gg/player/45144/sulkingg,2024-09-28 11:00:00,1.23,1.95,1.38,250,225,354,14,10,4,10,8,2,10,6,4,+3,+3,0,100%,100%,100%,163,152,205,26%,22%,43%,3,3,0,0,0,0
43,https://vlr.gg/player/46683/esc,2024-09-28 11:00:00,0.88,1.97,1.09,160,122,314,10,6,4,7,5,2,8,4,4,-1,-1,0,87%,83%,100%,116,89,224,32%,27%,43%,0,0,0,1,1,0
44,https://vlr.gg/player/48176/kygle,2024-09-28 11:00:00,0.66,0.46,0.62,150,151,148,9,7,2,13,10,3,1,1,0,-2,-2,0,80%,83%,67%,100,103,90,44%,47%,33%,3,2,1,5,4,1
45,https://vlr.gg/player/48123/zipix,2024-09-28 11:00:00,1.51,1.06,1.15,278,356,259,14,4,10,13,3,10,4,1,3,+1,0,+1,67%,100%,58%,162,203,152,26%,22%,28%,3,0,3,2,0,2
46,https://vlr.gg/player/12430/skypzz,2024-09-28 11:00:00,0.91,0.78,0.81,226,243,222,9,2,7,15,3,12,7,2,5,-1,+1,-2,73%,100%,67%,157,165,155,34%,29%,36%,2,1,1,3,0,3
47,https://vlr.gg/player/19874/mrpenguin,2024-09-28 11:00:00,0.79,0.70,0.72,163,170,162,7,2,5,13,3,10,3,1,2,+3,+1,+2,60%,67%,58%,115,112,116,17%,67%,13%,3,1,2,0,0,0
48,https://vlr.gg/player/29989/stryder,2024-09-28 11:00:00,0.22,0.58,0.51,124,95,132,7,1,6,14,3,11,4,1,3,-1,-1,0,67%,67%,67%,85,76,87,69%,25%,89%,0,0,0,1,1,0
49,https://vlr.gg/player/11830/mortyyyy,2024-09-28 11:00:00,0.88,0.20,0.33,111,224,84,5,2,3,14,3,11,6,6,0,-1,0,-1,33%,67%,25%,75,102,69,12%,11%,13%,0,0,0,1,0,1
50,https://vlr.gg/player/48223/xmeinn,2024-09-28 06:35:00,,,,337,,,46,,,25,,,18,,,,,,,,,,,,,,,,,,,,
51,https://vlr.gg/player/41218/s1eeepy,2024-09-28 06:35:00,,,,246,,,33,,,25,,,26,,,,,,,,,,,,,,,,,,,,
52,https://vlr.gg/player/48224/peterpan,2024-09-28 06:35:00,,,,222,,,29,,,26,,,12,,,,,,,,,,,,,,,,,,,,
53,https://vlr.gg/player/48226/ayu,2024-09-28 06:35:00,,,,170,,,25,,,20,,,11,,,,,,,,,,,,,,,,,,,,
54,https://vlr.gg/player/48225/147,2024-09-28 06:35:00,,,,147,,,24,,,18,,,20,,,,,,,,,,,,,,,,,,,,
55,https://vlr.gg/player/48227/p1katong,2024-09-28 06:35:00,,,,209,,,31,,,34,,,6,,,,,,,,,,,,,,,,,,,,
56,https://vlr.gg/player/48231/3one,2024-09-28 06:35:00,,,,168,,,20,,,35,,,13,,,,,,,,,,,,,,,,,,,,
57,https://vlr.gg/player/48228/caktttly,2024-09-28 06:35:00,,,,156,,,23,,,27,,,8,,,,,,,,,,,,,,,,,,,,
58,https://vlr.gg/player/48230/hearing,2024-09-28 06:35:00,,,,142,,,18,,,32,,,12,,,,,,,,,,,,,,,,,,,,
59,https://vlr.gg/player/48229/we1v,2024-09-28 06:35:00,,,,129,,,22,,,29,,,7,,,,,,,,,,,,,,,,,,,,
60,https://vlr.gg/player/48205/x1aowen,2024-09-28 05:00:00,,,,273,,,32,,,21,,,14,,,,,,,,,,,,,,,,,,,,
61,https://vlr.gg/player/25443/bambi,2024-09-28 05:00:00,,,,269,,,33,,,18,,,12,,,,,,,,,,,,,,,,,,,,
62,https://vlr.gg/player/17447/alyssa,2024-09-28 05:00:00,,,,249,,,34,,,12,,,4,,,,,,,,,,,,,,,,,,,,
63,https://vlr.gg/player/48206/7er,2024-09-28 05:00:00,,,,208,,,28,,,17,,,11,,,,,,,,,,,,,,,,,,,,
64,https://vlr.gg/player/48207/elina,2024-09-28 05:00:00,,,,202,,,22,,,20,,,6,,,,,,,,,,,,,,,,,,,,
65,https://vlr.gg/player/48172/nio,2024-09-28 05:00:00,,,,191,,,21,,,29,,,7,,,,,,,,,,,,,,,,,,,,
66,https://vlr.gg/player/48171/nana,2024-09-28 05:00:00,,,,186,,,20,,,32,,,13,,,,,,,,,,,,,,,,,,,,
67,https://vlr.gg/player/48173/elf,2024-09-28 05:00:00,,,,148,,,16,,,29,,,10,,,,,,,,,,,,,,,,,,,,
68,https://vlr.gg/player/48175/bot,2024-09-28 05:00:00,,,,127,,,16,,,29,,,5,,,,,,,,,,,,,,,,,,,,
69,https://vlr.gg/player/48174/sa1t,2024-09-28 05:00:00,,,,120,,,15,,,30,,,5,,,,,,,,,,,,,,,,,,,,
70,https://vlr.gg/player/3342/sushiboys,2024-09-28 03:00:00,1.19,1.05,1.12,240,259,217,74,42,32,64,33,31,16,7,9,+1,+1,0,70%,62%,79%,155,168,142,23%,22%,24%,9,4,5,8,3,5
71,https://vlr.gg/player/3401/ptc,2024-09-28 03:00:00,0.94,1.17,1.05,178,158,206,59,27,32,60,31,29,33,14,19,+2,0,+2,73%,70%,77%,122,100,145,30%,29%,31%,8,3,5,6,3,3
72,https://vlr.gg/player/6723/foxz,2024-09-28 03:00:00,0.68,1.07,0.86,178,124,238,53,20,33,68,34,34,26,9,17,-5,-5,0,67%,57%,77%,122,87,162,30%,26%,33%,3,1,2,8,6,2
73,https://vlr.gg/player/4377/johnolsen,2024-09-28 03:00:00,0.39,1.11,0.74,193,149,243,60,21,39,77,44,33,11,7,4,-8,-9,+1,57%,45%,70%,126,99,156,21%,19%,22%,13,6,7,21,15,6
74,https://vlr.gg/player/27254/leviathan,2024-09-28 03:00:00,0.82,0.47,0.65,130,165,94,42,29,13,67,34,33,26,15,11,0,0,0,66%,70%,60%,87,105,67,28%,27%,29%,7,3,4,7,3,4
75,https://vlr.gg/player/10739/shiro,2024-09-28 03:00:00,1.05,1.42,1.24,244,193,290,74,27,47,59,29,30,44,25,19,+5,-1,+6,77%,72%,81%,166,133,196,23%,18%,28%,15,4,11,10,5,5
76,https://vlr.gg/player/7043/ncslasher,2024-09-28 03:00:00,1.30,1.16,1.23,222,240,208,78,41,37,54,27,27,24,14,10,+2,+1,+1,86%,86%,85%,135,146,126,24%,30%,20%,8,3,5,6,2,4
77,https://vlr.gg/player/2348/famouz,2024-09-28 03:00:00,0.82,1.32,1.08,231,208,249,72,31,41,64,35,29,25,11,14,+7,-1,+8,77%,74%,79%,146,135,157,11%,12%,11%,17,8,9,10,9,1
78,https://vlr.gg/player/4874/berserx,2024-09-28 03:00:00,1.19,0.89,1.04,188,232,147,56,33,23,54,27,27,23,12,11,-1,+1,-2,77%,81%,72%,129,150,109,24%,29%,20%,6,4,2,7,3,4
79,https://vlr.gg/player/2380/zesbeew,2024-09-28 03:00:00,0.96,0.97,0.96,169,185,156,55,28,27,58,32,26,45,26,19,-3,-3,0,81%,74%,87%,103,110,96,22%,24%,19%,4,1,3,7,4,3
80,https://vlr.gg/player/42378/nicky,2024-09-27 18:00:00,1.68,1.31,1.48,259,303,218,83,46,37,48,21,27,27,8,19,+8,+4,+4,84%,87%,80%,170,197,147,40%,44%,37%,12,5,7,4,1,3
81,https://vlr.gg/player/33177/none,2024-09-27 18:00:00,1.08,1.18,1.14,259,265,262,74,34,40,66,32,34,21,7,14,+9,+4,+5,69%,69%,70%,169,174,164,15%,18%,12%,22,11,11,13,7,6
82,https://vlr.gg/player/21548/adenina,2024-09-27 18:00:00,0.87,1.08,0.98,168,152,186,47,19,28,55,25,30,40,18,22,+2,-1,+3,71%,72%,70%,107,98,114,25%,21%,27%,7,1,6,5,2,3
83,https://vlr.gg/player/21108/ponix,2024-09-27 18:00:00,1.00,0.86,0.92,181,207,159,55,30,25,57,27,30,27,11,16,-4,-3,-1,69%,74%,65%,120,140,103,27%,28%,25%,4,2,2,8,5,3
84,https://vlr.gg/player/24770/babzzz,2024-09-27 18:00:00,0.67,1.02,0.86,187,155,209,56,20,36,62,30,32,17,9,8,+2,-1,+3,69%,69%,70%,115,92,135,26%,26%,26%,6,2,4,4,3,1
85,https://vlr.gg/player/35660/tok1o,2024-09-27 18:00:00,1.33,1.21,1.27,270,289,246,82,50,32,60,30,30,22,7,15,-3,0,-3,73%,78%,67%,183,190,175,30%,29%,32%,5,2,3,8,2,6
86,https://vlr.gg/player/40657/ataraxia,2024-09-27 18:00:00,0.78,1.06,0.91,185,168,202,58,28,30,65,36,29,10,6,4,+4,0,+4,71%,70%,72%,122,112,134,33%,27%,38%,6,2,4,2,2,0
87,https://vlr.gg/player/40135/nati,2024-09-27 18:00:00,0.93,0.79,0.86,173,172,169,53,28,25,62,32,30,17,12,5,+1,+2,-1,68%,70%,67%,108,111,104,43%,43%,43%,5,4,1,4,2,2
88,https://vlr.gg/player/35018/allie,2024-09-27 18:00:00,0.87,0.72,0.80,149,154,144,45,25,20,60,29,31,24,12,12,-11,-7,-4,60%,63%,56%,97,100,93,31%,32%,30%,3,1,2,14,8,6
89,https://vlr.gg/player/35869/meleliita,2024-09-27 18:00:00,0.50,0.94,0.70,172,150,206,50,23,27,69,39,30,12,4,8,-8,-9,+1,58%,48%,69%,120,94,150,27%,27%,27%,15,7,8,23,16,7
90,https://vlr.gg/player/11244/gabit,2024-09-27 18:00:00,1.30,1.01,1.17,203,219,194,55,34,21,47,24,23,23,11,12,-1,0,-1,80%,79%,81%,135,143,125,27%,24%,31%,4,2,2,5,2,3
91,https://vlr.gg/player/19255/luiza,2024-09-27 18:00:00,0.90,1.42,1.13,235,203,276,57,26,31,50,29,21,24,14,10,-2,+1,-3,79%,68%,91%,158,134,187,30%,24%,38%,5,3,2,7,2,5
92,https://vlr.gg/player/42397/winter,2024-09-27 18:00:00,1.09,0.99,1.04,243,268,230,60,34,26,57,33,24,22,11,11,+7,+6,+1,74%,74%,75%,161,174,146,24%,22%,28%,17,13,4,10,7,3
93,https://vlr.gg/player/11256/isa1,2024-09-27 18:00:00,0.79,1.15,0.96,205,193,216,49,24,25,53,32,21,20,15,5,-5,-5,0,69%,68%,69%,142,140,144,19%,22%,16%,3,0,3,8,5,3
94,https://vlr.gg/player/14291/mindle,2024-09-27 18:00:00,0.82,0.94,0.88,170,181,165,45,26,19,54,34,20,31,14,17,-5,-2,-3,79%,79%,78%,106,113,99,33%,34%,32%,3,1,2,8,3,5
95,https://vlr.gg/player/30374/lua-c,2024-09-27 18:00:00,1.24,1.00,1.11,214,223,202,55,27,28,51,22,29,20,7,13,-4,0,-4,73%,75%,71%,146,151,142,34%,39%,30%,6,3,3,10,3,7
96,https://vlr.gg/player/21935/flor,2024-09-27 18:00:00,0.65,1.43,1.07,251,184,306,59,18,41,56,27,29,19,12,7,+9,+2,+7,74%,66%,82%,158,121,189,23%,24%,23%,13,5,8,4,3,1
97,https://vlr.gg/player/3444/phobia,2024-09-27 18:00:00,0.98,0.90,0.94,187,204,172,47,23,24,51,23,28,26,8,18,0,+2,-2,69%,69%,68%,117,121,113,25%,25%,24%,7,4,3,7,2,5
98,https://vlr.gg/player/35019/gabe,2024-09-27 18:00:00,0.85,1.01,0.94,193,168,220,47,19,28,52,23,29,18,6,12,+1,0,+1,67%,59%,74%,135,125,143,28%,36%,24%,5,2,3,4,2,2
99,https://vlr.gg/player/40456/aura,2024-09-27 18:00:00,0.81,1.01,0.92,218,202,215,51,22,29,56,27,29,25,12,13,0,+2,-2,71%,69%,74%,136,127,143,20%,25%,16%,7,5,2,7,3,4
100,https://vlr.gg/player/40493/setrexz,2024-09-27 16:00:00,0.74,1.16,0.93,214,198,248,28,14,14,29,17,12,5,3,2,-4,-3,-1,53%,50%,56%,130,107,159,26%,21%,30%,5,3,2,9,6,3
101,https://vlr.gg/player/11247/misty,2024-09-27 16:00:00,0.69,1.21,0.92,194,160,235,28,13,15,31,17,14,3,2,1,+1,-2,+3,61%,50%,75%,126,112,144,36%,34%,37%,3,0,3,2,2,0
102,https://vlr.gg/player/12119/scherbi,2024-09-27 16:00:00,0.77,0.81,0.79,186,199,184,21,12,9,30,17,13,6,2,4,+1,-1,+2,67%,75%,56%,127,132,121,16%,19%,13%,4,2,2,3,3,0
103,https://vlr.gg/player/36649/gigika,2024-09-27 16:00:00,0.63,0.87,0.73,178,162,193,20,10,10,30,18,12,9,4,5,+1,-1,+2,67%,55%,81%,112,106,121,36%,39%,33%,4,1,3,3,2,1
104,https://vlr.gg/player/12225/fer,2024-09-27 16:00:00,0.53,0.40,0.45,107,138,65,10,7,3,31,18,13,17,10,7,-3,-1,-2,56%,60%,50%,81,99,58,26%,30%,19%,0,0,0,3,1,2
105,https://vlr.gg/player/12126/kaah,2024-09-27 16:00:00,1.64,1.55,1.59,267,286,261,39,18,21,20,9,11,12,5,7,+4,+2,+2,86%,88%,85%,169,178,163,41%,39%,43%,6,3,3,2,1,1
106,https://vlr.gg/player/25580/jenny,2024-09-27 16:00:00,1.38,1.24,1.30,252,280,223,33,18,15,21,9,12,8,2,6,+3,0,+3,75%,63%,85%,171,197,151,26%,32%,20%,6,2,4,3,2,1
107,https://vlr.gg/player/2245/krysme,2024-09-27 16:00:00,1.19,1.18,1.18,256,296,230,34,17,17,25,12,13,4,1,3,+1,-1,+2,69%,63%,75%,174,192,160,25%,26%,25%,4,1,3,3,2,1
108,https://vlr.gg/player/20222/crona,2024-09-27 16:00:00,0.81,1.30,1.08,155,139,166,20,8,12,17,10,7,17,6,11,-5,-3,-2,75%,63%,85%,100,91,108,33%,24%,43%,0,0,0,5,3,2
109,https://vlr.gg/player/29169/erin,2024-09-27 16:00:00,0.47,1.48,1.03,216,69,320,25,3,22,24,11,13,17,9,8,+1,-2,+3,83%,75%,90%,139,50,210,34%,21%,38%,4,0,4,3,2,1
110,https://vlr.gg/player/45145/costaa,2024-09-27 15:40:00,1.44,1.41,1.42,246,240,252,21,10,11,14,6,8,10,5,5,0,0,0,81%,77%,85%,170,162,178,23%,18%,30%,1,0,1,1,0,1
111,https://vlr.gg/player/48127/riasu,2024-09-27 15:40:00,1.02,1.20,1.11,198,169,227,18,7,11,17,8,9,6,3,3,+1,0,+1,65%,69%,62%,141,124,157,35%,28%,40%,3,1,2,2,1,1
112,https://vlr.gg/player/46683/esc,2024-09-27 15:40:00,0.68,1.33,1.00,185,104,266,15,4,11,18,9,9,15,11,4,0,-1,+1,73%,69%,77%,121,68,175,28%,29%,28%,1,0,1,1,1,0
113,https://vlr.gg/player/48176/kygle,2024-09-27 15:40:00,1.10,0.64,0.87,188,216,160,19,12,7,21,10,11,4,1,3,-5,-2,-3,69%,69%,69%,139,168,109,33%,41%,22%,3,2,1,8,4,4
114,https://vlr.gg/player/45144/sulkingg,2024-09-27 15:40:00,1.14,0.44,0.79,170,220,120,16,11,5,20,9,11,7,4,3,0,0,0,62%,69%,54%,107,144,70,28%,21%,45%,3,2,1,3,2,1
115,https://vlr.gg/player/16141/sora,2024-09-27 15:40:00,1.38,1.48,1.43,286,297,276,28,15,13,18,9,9,2,1,1,+3,+2,+1,69%,69%,69%,185,189,180,33%,29%,39%,5,3,2,2,1,1
116,https://vlr.gg/player/29638/kotaro,2024-09-27 15:40:00,1.03,1.33,1.18,198,176,221,18,7,11,15,8,7,15,9,6,+2,+1,+1,69%,62%,77%,122,123,121,30%,25%,36%,3,1,2,1,0,1
117,https://vlr.gg/player/29827/repteyy,2024-09-27 15:40:00,1.55,0.76,1.16,210,271,150,18,12,6,15,6,9,10,7,3,0,0,0,81%,92%,69%,143,165,122,20%,14%,30%,2,1,1,2,1,1
118,https://vlr.gg/player/29994/xini,2024-09-27 15:40:00,0.07,1.21,0.65,191,99,283,16,5,11,22,13,9,4,0,4,-1,-2,+1,65%,46%,85%,129,59,198,24%,44%,21%,5,2,3,6,4,2
119,https://vlr.gg/player/41846/shiro,2024-09-27 15:40:00,1.05,0.18,0.61,125,183,69,10,9,1,19,9,10,5,2,3,0,0,0,58%,77%,38%,94,129,59,22%,22%,21%,0,0,0,0,0,0
120,https://vlr.gg/player/16012/akira,2024-09-27 14:45:00,1.31,0.10,0.86,134,193,34,11,10,1,12,7,5,0,0,0,-1,-1,0,63%,67%,57%,77,112,17,29%,33%,0%,0,0,0,1,1,0
121,https://vlr.gg/player/10448/kozok,2024-09-27 14:45:00,0.98,0.54,0.82,174,172,179,11,7,4,16,9,7,4,3,1,+1,+1,0,58%,67%,43%,105,110,97,20%,24%,14%,2,1,1,1,0,1
122,https://vlr.gg/player/26789/pdr,2024-09-27 14:45:00,0.70,0.89,0.77,171,159,193,9,5,4,16,10,6,12,9,3,-2,-2,0,63%,67%,57%,119,104,144,19%,24%,14%,1,0,1,3,2,1
123,https://vlr.gg/player/33517/tripsy,2024-09-27 14:45:00,0.82,0.54,0.71,194,214,161,13,9,4,17,10,7,2,2,0,-2,-2,0,42%,42%,43%,119,128,103,24%,18%,45%,1,1,0,3,3,0
124,https://vlr.gg/player/42557/6ankai,2024-09-27 14:45:00,0.67,0.47,0.60,171,190,141,11,8,3,17,11,6,4,2,2,-3,-4,+1,53%,50%,57%,108,115,95,30%,41%,15%,2,0,2,5,4,1
125,https://vlr.gg/player/46179/davia,2024-09-27 14:45:00,1.91,1.42,1.60,347,397,318,25,11,14,12,4,8,0,0,0,+6,-1,+7,89%,100%,83%,198,221,185,37%,60%,28%,8,1,7,2,2,0
126,https://vlr.gg/player/13024/vuubit,2024-09-27 14:45:00,1.61,1.44,1.50,226,159,266,15,3,12,8,1,7,14,10,4,+1,+1,0,74%,86%,67%,154,105,183,46%,56%,42%,2,1,1,1,0,1
127,https://vlr.gg/player/8590/killdream,2024-09-27 14:45:00,1.87,1.24,1.47,248,314,210,18,9,9,10,3,7,5,0,5,+1,0,+1,89%,100%,83%,155,189,135,39%,50%,32%,2,1,1,1,1,0
128,https://vlr.gg/player/29998/drastz,2024-09-27 14:45:00,0.92,0.70,0.78,135,151,126,10,4,6,12,3,9,8,3,5,-2,-1,-1,74%,86%,67%,78,84,74,9%,18%,4%,0,0,0,2,1,1
129,https://vlr.gg/player/4214/eso177,2024-09-27 14:45:00,0.63,0.61,0.62,154,160,151,10,4,6,13,5,8,1,0,1,+1,0,+1,53%,43%,58%,119,99,131,28%,33%,25%,1,0,1,0,0,0
130,https://vlr.gg/player/3372/ori4k,2024-09-27 13:45:00,2.52,1.21,1.93,383,441,315,30,20,10,13,4,9,4,2,2,+2,+1,+1,73%,83%,60%,241,288,186,49%,45%,59%,3,2,1,1,1,0
131,https://vlr.gg/player/45138/aster,2024-09-27 13:45:00,1.22,0.83,1.04,181,198,160,13,8,5,14,6,8,6,5,1,0,0,0,64%,75%,50%,133,151,113,24%,25%,21%,0,0,0,0,0,0
132,https://vlr.gg/player/5834/mikelelle,2024-09-27 13:45:00,0.96,0.75,0.87,158,176,137,11,7,4,15,8,7,5,3,2,0,0,0,59%,75%,40%,115,122,106,35%,44%,27%,1,1,0,1,1,0
133,https://vlr.gg/player/46181/nade,2024-09-27 13:45:00,0.95,0.74,0.86,185,192,178,15,9,6,18,9,9,3,0,3,-6,-2,-4,59%,50%,70%,118,130,105,35%,30%,43%,3,2,1,9,4,5
134,https://vlr.gg/player/6117/kayn,2024-09-27 13:45:00,0.77,0.72,0.75,142,121,169,11,5,6,16,8,8,4,4,0,-2,+1,-3,64%,67%,60%,94,79,112,28%,50%,18%,1,1,0,3,0,3
135,https://vlr.gg/player/46233/kz,2024-09-27 13:45:00,1.48,1.44,1.46,309,292,325,26,11,15,15,6,9,6,5,1,+4,+3,+1,73%,90%,58%,200,199,200,36%,38%,34%,5,3,2,1,0,1
136,https://vlr.gg/player/36637/xpatrycksio,2024-09-27 13:45:00,1.11,1.09,1.10,240,216,261,18,8,10,18,8,10,13,10,3,+2,+2,0,73%,80%,67%,148,124,168,24%,13%,33%,4,3,1,2,1,1
137,https://vlr.gg/player/32300/varuxx,2024-09-27 13:45:00,1.49,0.51,0.96,195,238,160,15,10,5,16,6,10,8,5,3,+2,+1,+1,73%,80%,67%,120,141,102,22%,33%,14%,3,1,2,1,0,1
138,https://vlr.gg/player/33833/pepecho,2024-09-27 13:45:00,1.45,0.30,0.82,139,215,76,11,8,3,14,4,10,5,5,0,-1,0,-1,68%,100%,42%,102,172,45,33%,29%,44%,0,0,0,1,0,1
139,https://vlr.gg/player/44130/bern1,2024-09-27 13:45:00,0.54,0.05,0.27,81,128,42,6,4,2,17,7,10,4,3,1,-1,0,-1,55%,70%,42%,63,112,22,39%,43%,25%,2,1,1,3,1,2
140,https://vlr.gg/player/30107/fluxxy,2024-09-27 13:00:00,0.83,0.97,0.89,184,187,171,23,12,11,29,18,11,11,6,5,0,0,0,68%,71%,63%,113,120,105,38%,36%,40%,3,2,1,3,2,1
141,https://vlr.gg/player/9431/cille,2024-09-27 13:00:00,0.64,1.08,0.83,163,131,215,20,9,11,29,17,12,7,3,4,+3,+1,+2,59%,52%,69%,123,101,153,34%,31%,38%,3,1,2,0,0,0
142,https://vlr.gg/player/19362/lyda,2024-09-27 13:00:00,0.63,1.07,0.82,152,144,166,20,11,9,27,18,9,5,0,5,0,-2,+2,65%,52%,81%,90,82,99,24%,31%,16%,4,1,3,4,3,1
143,https://vlr.gg/player/37990/adora,2024-09-27 13:00:00,0.64,1.04,0.81,205,154,267,24,11,13,33,19,14,9,3,6,-4,-4,0,54%,48%,63%,136,118,160,30%,26%,34%,6,2,4,10,6,4
144,https://vlr.gg/player/24140/superphrog,2024-09-27 13:00:00,0.49,0.92,0.67,134,110,188,18,7,11,30,19,11,10,5,5,-2,-2,0,51%,43%,63%,97,80,120,19%,21%,17%,1,1,0,3,3,0
145,https://vlr.gg/player/26632/joliinaa,2024-09-27 13:00:00,1.37,1.49,1.44,281,270,277,39,17,22,19,10,9,9,1,8,+1,+1,0,84%,81%,86%,171,164,176,32%,29%,33%,4,2,2,3,1,2
146,https://vlr.gg/player/24101/miyori,2024-09-27 13:00:00,1.14,1.43,1.30,254,239,269,34,13,21,23,12,11,8,6,2,+1,-1,+2,81%,81%,81%,170,164,175,26%,25%,26%,5,1,4,4,2,2
147,https://vlr.gg/player/17343/ness,2024-09-27 13:00:00,0.91,1.51,1.25,185,157,205,27,9,18,17,10,7,13,4,9,-1,0,-1,76%,63%,86%,122,104,136,32%,40%,29%,1,1,0,2,1,1
148,https://vlr.gg/player/16418/smurfette,2024-09-27 13:00:00,0.82,1.20,1.03,199,195,201,26,11,15,23,12,11,6,2,4,+3,-2,+5,78%,69%,86%,134,131,137,24%,19%,29%,7,2,5,4,4,0
149,https://vlr.gg/player/24107/sarah,2024-09-27 13:00:00,0.67,1.02,0.87,165,121,203,22,7,15,23,11,12,9,5,4,-1,-2,+1,70%,56%,81%,115,80,143,23%,19%,24%,3,0,3,4,2,2
150,https://vlr.gg/player/22291/razziss,2024-09-27 12:50:00,1.64,1.17,1.43,320,357,276,24,15,9,19,9,10,3,2,1,0,-2,+2,64%,75%,50%,219,246,187,32%,30%,36%,5,2,3,5,4,1
151,https://vlr.gg/player/22188/jimbk,2024-09-27 12:50:00,1.87,0.55,1.27,222,306,122,16,12,4,14,5,9,7,6,1,-1,-1,0,64%,83%,40%,166,230,89,33%,41%,20%,0,0,0,1,1,0
152,https://vlr.gg/player/33513/sihw,2024-09-27 12:50:00,0.98,0.57,0.80,155,190,113,14,10,4,17,8,9,6,2,4,0,-1,+1,68%,75%,60%,98,105,90,42%,39%,46%,2,1,1,2,2,0
153,https://vlr.gg/player/45143/francybald,2024-09-27 12:50:00,0.66,0.38,0.53,126,103,156,9,5,4,19,9,10,8,6,2,-1,-2,+1,55%,67%,40%,101,85,119,28%,42%,20%,1,0,1,2,2,0
154,https://vlr.gg/player/16139/enrik,2024-09-27 12:50:00,0.41,0.54,0.47,121,108,137,7,4,3,20,11,9,12,6,6,0,0,0,64%,67%,60%,78,66,92,37%,46%,29%,2,0,2,2,0,2
155,https://vlr.gg/player/15383/khorror,2024-09-27 12:50:00,1.92,1.15,1.50,258,314,212,21,13,8,13,4,9,12,3,9,+1,-1,+2,86%,90%,83%,179,217,147,32%,34%,29%,2,0,2,1,1,0
156,https://vlr.gg/player/4951/hardy,2024-09-27 12:50:00,1.17,1.68,1.45,281,185,362,23,7,16,14,5,9,4,2,2,0,-1,+1,86%,80%,92%,184,135,224,38%,40%,37%,2,0,2,2,1,1
157,https://vlr.gg/player/41804/kalvo,2024-09-27 12:50:00,1.28,1.17,1.22,237,242,234,19,9,10,14,5,9,6,3,3,+2,-1,+3,82%,90%,75%,165,169,162,24%,14%,38%,3,0,3,1,1,0
158,https://vlr.gg/player/29974/erizillo,2024-09-27 12:50:00,1.06,0.69,0.86,136,137,136,10,5,5,14,5,9,14,6,8,0,0,0,91%,90%,92%,96,105,89,39%,38%,40%,1,0,1,1,0,1
159,https://vlr.gg/player/42521/jahbu,2024-09-27 12:50:00,1.62,0.18,0.83,196,331,84,16,13,3,15,5,10,4,1,3,-1,-1,0,50%,70%,33%,117,205,44,36%,34%,43%,4,3,1,5,4,1
160,https://vlr.gg/player/17911/duss,2024-09-27 12:00:00,0.93,1.07,1.03,211,115,244,11,2,9,13,2,11,4,2,2,-1,-1,0,75%,75%,75%,135,68,158,32%,0%,41%,0,0,0,1,1,0
161,https://vlr.gg/player/11830/mortyyyy,2024-09-27 12:00:00,1.29,0.41,0.63,156,241,128,9,4,5,13,3,10,5,3,2,+1,+1,0,63%,100%,50%,81,100,75,38%,25%,46%,2,1,1,1,0,1
162,https://vlr.gg/player/19874/mrpenguin,2024-09-27 12:00:00,0.79,0.54,0.60,135,179,121,7,2,5,14,3,11,6,3,3,+2,0,+2,69%,100%,58%,89,128,76,21%,18%,23%,3,0,3,1,0,1
163,https://vlr.gg/player/12430/skypzz,2024-09-27 12:00:00,0.38,0.64,0.57,154,118,167,8,2,6,13,3,10,1,0,1,-1,-1,0,56%,25%,67%,116,118,116,28%,50%,24%,1,0,1,2,1,1
164,https://vlr.gg/player/48123/zipix,2024-09-27 12:00:00,1.07,0.11,0.35,114,194,87,6,3,3,15,3,12,2,1,1,-5,-1,-4,44%,75%,33%,71,89,65,30%,75%,19%,0,0,0,5,1,4
165,https://vlr.gg/player/2835/kyrrz,2024-09-27 12:00:00,1.67,1.45,1.62,231,229,240,15,11,4,5,3,2,8,7,1,0,0,0,81%,83%,75%,165,165,168,46%,43%,57%,0,0,0,0,0,0
166,https://vlr.gg/player/29972/michel,2024-09-27 12:00:00,1.39,1.73,1.47,277,244,376,15,10,5,10,7,3,5,5,0,+4,+2,+2,88%,92%,75%,175,170,191,32%,32%,31%,6,4,2,2,2,0
167,https://vlr.gg/player/4851/rexs,2024-09-27 12:00:00,1.35,0.93,1.24,208,227,154,13,11,2,8,6,2,5,4,1,-2,-1,-1,81%,92%,50%,137,146,113,57%,53%,75%,1,1,0,3,2,1
168,https://vlr.gg/player/24359/faska,2024-09-27 12:00:00,1.28,0.78,1.16,174,180,158,10,8,2,7,4,3,4,4,0,+2,+1,+1,81%,92%,50%,117,120,108,27%,24%,40%,2,1,1,0,0,0
169,https://vlr.gg/player/31553/pukytoo,2024-09-27 12:00:00,1.30,0.60,1.12,261,317,95,15,14,1,11,8,3,3,2,1,0,0,0,81%,83%,75%,164,182,112,50%,55%,33%,1,1,0,1,1,0
170,https://vlr.gg/player/20055/toki,2024-09-27 11:00:00,1.38,1.89,1.63,317,315,317,34,17,17,16,10,6,13,4,9,+3,+1,+2,79%,73%,86%,198,197,199,31%,32%,30%,7,4,3,4,3,1
171,https://vlr.gg/player/29903/madv,2024-09-27 11:00:00,1.02,1.76,1.38,260,181,347,29,10,19,18,10,8,8,5,3,+3,0,+3,90%,87%,93%,195,142,252,53%,57%,51%,6,2,4,3,2,1
172,https://vlr.gg/player/17333/mary,2024-09-27 11:00:00,1.26,1.09,1.15,246,254,236,26,15,11,20,11,9,6,1,5,+2,0,+2,76%,67%,86%,163,174,151,26%,34%,19%,4,2,2,2,2,0
173,https://vlr.gg/player/19371/eva,2024-09-27 11:00:00,0.86,1.38,1.11,158,161,152,21,10,11,12,8,4,5,5,0,0,0,0,86%,80%,93%,101,94,109,30%,24%,36%,0,0,0,0,0,0
174,https://vlr.gg/player/29900/sandra,2024-09-27 11:00:00,1.04,0.91,0.97,186,196,176,20,12,8,16,8,8,8,1,7,-1,0,-1,93%,93%,93%,118,120,117,34%,43%,27%,1,0,1,2,0,2
175,https://vlr.gg/player/38142/dream,2024-09-27 11:00:00,1.02,1.22,1.13,223,196,245,21,9,12,23,11,12,8,4,4,+1,0,+1,79%,79%,80%,133,121,144,21%,18%,23%,1,0,1,0,0,0
176,https://vlr.gg/player/20098/mel,2024-09-27 11:00:00,0.81,1.04,0.93,185,175,199,21,9,12,25,13,12,7,4,3,-4,-3,-1,55%,43%,67%,118,106,130,33%,30%,36%,2,1,1,6,4,2
177,https://vlr.gg/player/24071/liza,2024-09-27 11:00:00,0.52,0.85,0.69,193,153,232,19,7,12,27,14,13,2,1,1,-2,-2,0,59%,57%,60%,131,107,154,33%,25%,45%,7,3,4,9,5,4
178,https://vlr.gg/player/17394/ninou,2024-09-27 11:00:00,0.47,0.69,0.58,156,137,171,12,5,7,27,14,13,17,7,10,-1,0,-1,83%,71%,93%,108,105,110,33%,36%,31%,0,0,0,1,0,1
179,https://vlr.gg/player/22792/jiex,2024-09-27 11:00:00,0.33,0.40,0.34,109,111,109,9,5,4,28,14,14,9,3,6,-1,-1,0,48%,50%,47%,81,69,93,34%,36%,33%,1,0,1,2,1,1
180,https://vlr.gg/player/22154/pika,2024-09-27 11:00:00,0.80,1.77,1.24,204,106,321,16,4,12,13,7,6,9,4,5,+1,-1,+2,68%,58%,80%,130,65,207,42%,27%,52%,2,0,2,1,1,0
181,https://vlr.gg/player/2996/neiker,2024-09-27 11:00:00,1.67,0.66,1.21,231,325,119,17,13,4,14,7,7,11,8,3,+2,+3,-1,86%,92%,80%,151,202,90,31%,36%,21%,3,3,0,1,0,1
182,https://vlr.gg/player/2893/hastack,2024-09-27 11:00:00,1.12,1.21,1.16,260,240,286,21,11,10,16,9,7,1,1,0,-1,0,-1,73%,67%,80%,181,177,187,19%,23%,16%,1,0,1,2,0,2
183,https://vlr.gg/player/14894/facepalm,2024-09-27 11:00:00,0.97,1.28,1.11,193,200,185,17,9,8,12,8,4,3,3,0,-1,-2,+1,73%,67%,80%,132,142,121,42%,44%,40%,3,2,1,4,4,0
184,https://vlr.gg/player/44963/desire,2024-09-27 11:00:00,0.81,0.69,0.76,172,145,206,13,6,7,15,7,8,4,2,2,+1,0,+1,64%,67%,60%,111,98,127,32%,50%,20%,3,1,2,2,1,1
185,https://vlr.gg/player/19588/neptuno,2024-09-27 11:00:00,1.63,0.99,1.28,228,277,188,18,11,7,16,7,9,13,5,8,+1,+1,0,82%,90%,75%,132,161,108,38%,40%,35%,1,1,0,0,0,0
186,https://vlr.gg/player/41847/negradas,2024-09-27 11:00:00,1.55,1.03,1.27,242,300,194,18,10,8,16,7,9,8,5,3,+1,+1,0,68%,70%,67%,169,189,153,24%,28%,19%,2,1,1,1,0,1
187,https://vlr.gg/player/17861/blastinho,2024-09-27 11:00:00,0.25,1.65,1.01,196,98,278,16,3,13,16,9,7,3,2,1,-1,-1,0,64%,50%,75%,146,73,207,35%,27%,40%,4,2,2,5,3,2
188,https://vlr.gg/player/2884/daniel0,2024-09-27 11:00:00,0.68,0.88,0.79,177,160,192,14,6,8,18,9,9,7,4,3,-1,-2,+1,82%,90%,75%,108,102,114,48%,44%,50%,2,0,2,3,2,1
189,https://vlr.gg/player/8811/humanz,2024-09-27 11:00:00,0.20,0.17,0.19,54,59,51,4,2,2,18,9,9,1,1,0,-2,-1,-1,41%,50%,33%,39,46,32,33%,60%,14%,1,0,1,3,1,2
190,https://vlr.gg/player/48163/wene,2024-09-27 07:00:00,,,,209,,,30,,,32,,,4,,,,,,,,,,,,,,,,,,,,
191,https://vlr.gg/player/48162/k1ssme,2024-09-27 07:00:00,,,,207,,,30,,,28,,,14,,,,,,,,,,,,,,,,,,,,
192,https://vlr.gg/player/48164/tulip,2024-09-27 07:00:00,,,,193,,,26,,,35,,,8,,,,,,,,,,,,,,,,,,,,
193,https://vlr.gg/player/48165/leilei,2024-09-27 07:00:00,,,,193,,,22,,,30,,,9,,,,,,,,,,,,,,,,,,,,
194,https://vlr.gg/player/48166/yaya,2024-09-27 07:00:00,,,,125,,,15,,,32,,,19,,,,,,,,,,,,,,,,,,,,
195,https://vlr.gg/player/48167/xiaolan,2024-09-27 07:00:00,,,,266,,,39,,,31,,,7,,,,,,,,,,,,,,,,,,,,
196,https://vlr.gg/player/48168/zora,2024-09-27 07:00:00,,,,255,,,35,,,22,,,8,,,,,,,,,,,,,,,,,,,,
197,https://vlr.gg/player/48170/anan,2024-09-27 07:00:00,,,,222,,,30,,,24,,,21,,,,,,,,,,,,,,,,,,,,
198,https://vlr.gg/player/48169/jennie,2024-09-27 07:00:00,,,,208,,,28,,,23,,,17,,,,,,,,,,,,,,,,,,,,
199,https://vlr.gg/player/30334/yang,2024-09-27 07:00:00,,,,163,,,25,,,23,,,24,,,,,,,,,,,,,,,,,,,,
200,https://vlr.gg/player/43064/aace,2024-09-27 04:50:00,1.49,0.84,1.11,206,324,173,42,25,17,36,14,22,5,2,3,+4,+1,+3,63%,75%,54%,166,225,125,40%,56%,27%,5,1,4,1,0,1
201,https://vlr.gg/player/10584/seoldam,2024-09-27 04:50:00,0.88,0.88,0.88,212,196,237,32,13,19,40,15,25,16,7,9,-1,-4,+3,73%,75%,71%,143,137,147,16%,15%,16%,11,3,8,12,7,5
202,https://vlr.gg/player/4663/joxjo,2024-09-27 04:50:00,0.60,0.85,0.74,155,130,208,28,8,20,40,15,25,13,6,7,-3,-1,-2,65%,65%,64%,118,88,140,35%,27%,39%,2,1,1,5,2,3
203,https://vlr.gg/player/29841/caedye,2024-09-27 04:50:00,0.71,0.68,0.69,164,177,185,29,12,17,44,17,27,18,9,9,-3,+1,-4,58%,60%,57%,109,102,114,29%,27%,30%,4,3,1,7,2,5
204,https://vlr.gg/player/29843/yatsuka,2024-09-27 04:50:00,0.58,0.65,0.62,136,111,151,23,8,15,40,15,25,16,6,10,-1,-1,0,58%,55%,61%,82,75,87,25%,26%,24%,0,0,0,1,1,0
205,https://vlr.gg/player/2380/zesbeew,2024-09-27 04:50:00,1.37,1.46,1.41,244,225,262,43,25,18,27,14,13,20,12,8,+1,-1,+2,81%,86%,75%,163,161,166,21%,18%,28%,5,2,3,4,3,1
206,https://vlr.gg/player/4874/berserx,2024-09-27 04:50:00,1.51,1.12,1.35,245,291,182,43,30,13,29,17,12,12,7,5,+6,+4,+2,85%,89%,80%,163,184,134,24%,21%,30%,7,5,2,1,1,0
207,https://vlr.gg/player/2348/famouz,2024-09-27 04:50:00,1.44,0.90,1.21,271,315,176,44,34,10,35,20,15,9,7,2,+3,+2,+1,71%,79%,60%,158,193,109,16%,17%,13%,7,4,3,4,2,2
208,https://vlr.gg/player/10739/shiro,2024-09-27 04:50:00,0.87,1.43,1.10,210,169,287,37,17,20,31,18,13,18,11,7,-3,-2,-1,81%,82%,80%,150,116,199,26%,23%,28%,5,3,2,8,5,3
209,https://vlr.gg/player/7043/ncslasher,2024-09-27 04:50:00,0.94,0.94,0.94,194,189,199,33,19,14,33,19,14,21,15,6,-3,-3,0,83%,86%,80%,115,106,128,15%,13%,18%,2,0,2,5,3,2
210,https://vlr.gg/player/4122/persia,2024-09-27 03:00:00,1.52,1.60,1.54,186,157,274,22,15,7,10,6,4,21,15,6,+1,0,+1,91%,92%,88%,119,101,174,27%,16%,50%,2,1,1,1,1,0
211,https://vlr.gg/player/31827/dambi,2024-09-27 03:00:00,1.58,1.36,1.53,317,350,282,37,30,7,21,15,6,9,6,3,+6,+3,+3,84%,83%,88%,196,198,191,18%,16%,24%,11,8,3,5,5,0
212,https://vlr.gg/player/31829/ivy,2024-09-27 03:00:00,1.47,1.03,1.36,271,277,151,31,25,6,18,13,5,10,9,1,0,0,0,81%,88%,63%,176,201,103,40%,41%,38%,1,1,0,1,1,0
213,https://vlr.gg/player/33576/margaret,2024-09-27 03:00:00,1.38,0.41,1.14,253,295,78,27,25,2,21,15,6,11,10,1,0,+1,-1,81%,88%,63%,149,178,64,42%,45%,27%,3,3,0,3,2,1
214,https://vlr.gg/player/31828/francis,2024-09-27 03:00:00,1.03,1.43,1.13,195,186,237,24,17,7,18,14,4,15,12,3,+1,0,+1,81%,83%,75%,134,133,136,30%,38%,19%,3,1,2,2,1,1
215,https://vlr.gg/player/27254/leviathan,2024-09-27 03:00:00,1.46,0.71,0.90,186,262,161,20,7,13,27,4,23,11,3,8,0,+1,-1,66%,88%,58%,112,146,101,43%,78%,32%,2,1,1,2,0,2
216,https://vlr.gg/player/3401/ptc,2024-09-27 03:00:00,0.61,0.92,0.83,163,86,201,16,2,14,26,5,21,13,3,10,+1,-2,+3,69%,50%,75%,111,54,130,30%,29%,30%,4,0,4,3,2,1
217,https://vlr.gg/player/3342/sushiboys,2024-09-27 03:00:00,1.68,0.39,0.71,178,348,141,20,10,10,28,5,23,4,1,3,0,+1,-1,53%,75%,46%,131,219,102,22%,30%,18%,3,1,2,3,0,3
218,https://vlr.gg/player/6723/foxz,2024-09-27 03:00:00,0.15,0.84,0.67,177,81,199,18,2,16,30,8,22,8,2,6,-3,-2,-1,56%,50%,58%,113,52,133,29%,30%,29%,1,0,1,4,2,2
219,https://vlr.gg/player/4377/johnolsen,2024-09-27 03:00:00,0.37,0.44,0.42,146,140,142,14,4,10,30,7,23,5,1,4,-6,-2,-4,53%,63%,50%,101,93,103,23%,20%,24%,2,0,2,8,2,6
220,https://vlr.gg/player/15297/joojina,2024-09-26 18:45:00,1.35,1.55,1.43,225,242,201,31,21,10,18,15,3,22,12,10,+5,+3,+2,79%,75%,87%,145,155,128,30%,35%,24%,6,3,3,1,0,1
221,https://vlr.gg/player/12143/bizerra,2024-09-26 18:45:00,1.04,1.67,1.28,251,204,335,35,15,20,23,16,7,13,10,3,-1,-3,+2,77%,71%,87%,178,160,206,19%,19%,20%,5,2,3,6,5,1
222,https://vlr.gg/player/4807/bstrdd,2024-09-26 18:45:00,1.12,1.50,1.27,264,283,228,37,23,14,24,19,5,12,9,3,+2,+2,0,79%,79%,80%,179,186,167,19%,26%,10%,7,5,2,5,3,2
223,https://vlr.gg/player/14386/isaa,2024-09-26 18:45:00,0.92,1.50,1.14,213,157,292,29,13,16,24,15,9,10,4,6,+4,+1,+3,79%,71%,93%,137,107,185,27%,28%,27%,5,2,3,1,1,0
224,https://vlr.gg/player/11232/daiki,2024-09-26 18:45:00,0.70,1.66,1.07,174,136,232,26,12,14,20,17,3,9,7,2,-3,-3,0,82%,75%,93%,123,95,168,27%,26%,28%,0,0,0,3,3,0
225,https://vlr.gg/player/35019/gabe,2024-09-26 18:45:00,0.89,1.17,1.06,172,180,169,25,9,16,27,14,13,5,1,4,-1,+2,-3,59%,47%,67%,119,114,123,32%,23%,40%,3,3,0,4,1,3
226,https://vlr.gg/player/21935/flor,2024-09-26 18:45:00,0.26,1.46,1.00,246,130,323,32,5,27,32,15,17,6,1,5,+3,-4,+7,62%,40%,75%,155,98,190,24%,27%,23%,9,0,9,6,4,2
227,https://vlr.gg/player/3444/phobia,2024-09-26 18:45:00,0.18,1.11,0.74,156,58,222,17,2,15,33,15,18,16,3,13,0,-2,+2,56%,33%,71%,111,53,148,26%,44%,23%,2,0,2,2,2,0
228,https://vlr.gg/player/30374/lua-c,2024-09-26 18:45:00,0.45,0.85,0.70,143,124,147,19,7,12,32,15,17,13,0,13,-5,-2,-3,54%,40%,63%,85,78,89,36%,50%,30%,0,0,0,5,2,3
229,https://vlr.gg/player/40456/aura,2024-09-26 18:45:00,0.34,0.55,0.47,120,114,129,16,4,12,34,15,19,14,7,7,-4,-1,-3,56%,67%,50%,88,80,93,32%,18%,41%,2,1,1,6,2,4
230,https://vlr.gg/player/9821/m4ndzin,2024-09-26 16:00:00,1.31,1.49,1.38,239,212,283,51,29,22,36,18,18,25,18,7,+1,-1,+2,76%,78%,73%,154,136,184,23%,27%,18%,4,1,3,3,2,1
231,https://vlr.gg/player/11242/blu,2024-09-26 16:00:00,1.51,1.00,1.32,240,249,191,46,32,14,30,14,16,6,2,4,-3,-3,0,86%,92%,77%,151,167,126,31%,31%,30%,5,4,1,8,7,1
232,https://vlr.gg/player/22997/waved,2024-09-26 16:00:00,1.13,0.78,1.00,225,243,210,46,30,16,42,23,19,6,4,2,+3,+1,+2,69%,75%,59%,147,160,127,22%,22%,22%,12,7,5,9,6,3
233,https://vlr.gg/player/11236/antg,2024-09-26 16:00:00,1.24,0.39,0.92,172,205,76,29,26,3,36,19,17,24,15,9,-1,0,-1,67%,75%,55%,110,140,59,17%,18%,14%,1,1,0,2,1,1
234,https://vlr.gg/player/27724/natasha,2024-09-26 16:00:00,0.83,0.81,0.83,152,150,183,31,18,13,38,21,17,9,5,4,-2,+1,-3,64%,78%,41%,112,103,127,25%,31%,19%,6,4,2,8,3,5
235,https://vlr.gg/player/42397/winter,2024-09-26 16:00:00,1.32,1.07,1.16,251,298,243,52,23,29,47,16,31,11,7,4,+2,+2,0,71%,77%,67%,171,199,155,30%,32%,28%,8,4,4,6,2,4
236,https://vlr.gg/player/14291/mindle,2024-09-26 16:00:00,1.19,1.01,1.08,202,200,217,42,17,25,40,13,27,17,8,9,+2,-1,+3,69%,77%,64%,142,135,147,24%,20%,27%,7,1,6,5,2,3
237,https://vlr.gg/player/11244/gabit,2024-09-26 16:00:00,1.20,0.56,0.79,126,211,97,29,18,11,36,13,23,11,6,5,-2,-1,-1,62%,73%,56%,92,137,64,25%,30%,19%,3,1,2,5,2,3
238,https://vlr.gg/player/11256/isa1,2024-09-26 16:00:00,1.24,0.52,0.79,131,204,103,28,18,10,37,12,25,22,8,14,-1,0,-1,66%,77%,58%,96,139,69,19%,21%,17%,4,2,2,5,2,3
239,https://vlr.gg/player/19255/luiza,2024-09-26 16:00:00,0.78,0.72,0.74,160,152,171,31,11,20,44,15,29,20,12,8,+1,0,+1,69%,82%,61%,115,109,118,27%,19%,33%,8,3,5,7,3,4
240,https://vlr.gg/player/22291/razziss,2024-09-26 16:00:00,0.99,0.47,0.84,212,248,127,11,9,2,15,11,4,2,2,0,-3,-2,-1,53%,67%,20%,131,154,73,41%,35%,100%,4,3,1,7,5,2
241,https://vlr.gg/player/45143/francybald,2024-09-26 16:00:00,0.83,0.76,0.81,152,141,179,10,7,3,15,10,5,2,2,0,+1,0,+1,71%,67%,80%,94,90,101,33%,21%,57%,1,0,1,0,0,0
242,https://vlr.gg/player/16139/enrik,2024-09-26 16:00:00,0.92,0.48,0.79,137,156,93,8,6,2,14,9,5,11,10,1,+2,+2,0,71%,75%,60%,70,78,50,35%,56%,13%,2,2,0,0,0,0
243,https://vlr.gg/player/33513/sihw,2024-09-26 16:00:00,0.57,0.92,0.67,143,126,188,9,6,3,14,10,4,4,2,2,-2,-1,-1,59%,58%,60%,103,86,144,53%,70%,33%,0,0,0,2,1,1
244,https://vlr.gg/player/22188/jimbk,2024-09-26 16:00:00,0.57,0.35,0.50,155,184,87,7,6,1,17,12,5,5,4,1,+1,+1,0,59%,67%,40%,113,122,89,25%,23%,33%,1,1,0,0,0,0
245,https://vlr.gg/player/4214/eso177,2024-09-26 16:00:00,1.43,1.71,1.63,290,233,315,19,5,14,7,2,5,5,3,2,+1,0,+1,82%,80%,83%,189,140,210,25%,40%,22%,2,0,2,1,0,1
246,https://vlr.gg/player/13024/vuubit,2024-09-26 16:00:00,2.10,1.41,1.62,284,369,250,17,6,11,8,2,6,5,4,1,0,0,0,82%,100%,75%,207,271,180,63%,73%,58%,0,0,0,0,0,0
247,https://vlr.gg/player/29998/drastz,2024-09-26 16:00:00,1.57,1.24,1.33,254,253,256,16,5,11,10,2,8,13,5,8,+2,+1,+1,94%,100%,92%,162,140,172,27%,23%,28%,2,1,1,0,0,0
248,https://vlr.gg/player/46179/davia,2024-09-26 16:00:00,1.13,0.86,0.94,225,231,223,14,4,10,12,3,9,2,0,2,-1,0,-1,59%,40%,67%,143,190,124,33%,33%,33%,4,1,3,5,1,4
249,https://vlr.gg/player/8590/killdream,2024-09-26 16:00:00,1.18,0.79,0.90,148,162,143,9,3,6,8,2,6,9,4,5,-1,0,-1,82%,80%,83%,96,97,95,25%,50%,18%,1,1,0,2,1,1
250,https://vlr.gg/player/32300/varuxx,2024-09-26 14:50:00,2.14,0.92,1.48,310,406,230,23,15,8,14,4,10,5,3,2,+1,+1,0,68%,80%,58%,205,237,177,29%,22%,38%,3,2,1,2,1,1
251,https://vlr.gg/player/44130/bern1,2024-09-26 14:50:00,1.20,1.39,1.31,218,180,250,19,7,12,14,5,9,5,2,3,+1,0,+1,82%,90%,75%,142,111,168,30%,20%,38%,1,0,1,0,0,0
252,https://vlr.gg/player/36637/xpatrycksio,2024-09-26 14:50:00,1.91,0.30,1.03,190,268,126,16,11,5,16,4,12,8,6,2,+1,0,+1,77%,100%,58%,129,187,81,22%,25%,18%,1,0,1,0,0,0
253,https://vlr.gg/player/46233/kz,2024-09-26 14:50:00,0.66,1.19,0.95,226,184,261,17,6,11,17,8,9,4,1,3,+1,0,+1,77%,90%,67%,138,123,151,24%,29%,22%,6,3,3,5,3,2
254,https://vlr.gg/player/33833/pepecho,2024-09-26 14:50:00,0.71,0.65,0.68,126,74,171,8,2,6,15,5,10,12,8,4,+2,+1,+1,91%,100%,83%,77,34,112,48%,40%,50%,3,1,2,1,0,1
255,https://vlr.gg/player/17911/duss,2024-09-26 14:50:00,1.60,0.54,1.12,240,314,152,18,14,4,18,9,9,18,12,6,-3,-2,-1,86%,100%,70%,150,199,91,27%,23%,38%,0,0,0,3,2,1
256,https://vlr.gg/player/48123/zipix,2024-09-26 14:50:00,1.17,0.81,1.01,236,268,197,19,11,8,18,9,9,2,1,1,-2,-2,0,64%,58%,70%,147,172,118,29%,27%,32%,4,2,2,6,4,2
257,https://vlr.gg/player/19874/mrpenguin,2024-09-26 14:50:00,1.43,0.49,1.00,202,253,142,16,11,5,15,6,9,4,3,1,0,+1,-1,68%,83%,50%,138,172,97,13%,10%,25%,1,1,0,1,0,1
258,https://vlr.gg/player/12430/skypzz,2024-09-26 14:50:00,0.96,0.63,0.81,150,187,106,12,8,4,16,9,7,4,4,0,0,0,0,73%,83%,60%,97,119,71,26%,27%,23%,1,1,0,1,1,0
259,https://vlr.gg/player/11830/mortyyyy,2024-09-26 14:50:00,0.67,0.85,0.75,156,151,163,11,6,5,16,9,7,9,6,3,-1,-1,0,77%,83%,70%,96,92,102,16%,9%,31%,2,0,2,3,1,2
260,https://vlr.gg/player/16012/akira,2024-09-26 13:50:00,1.13,1.63,1.36,263,239,292,20,9,11,13,9,4,9,6,3,+3,0,+3,82%,67%,100%,184,183,185,33%,36%,28%,4,1,3,1,1,0
261,https://vlr.gg/player/33517/tripsy,2024-09-26 13:50:00,1.22,1.49,1.34,319,283,364,24,11,13,17,9,8,3,2,1,+3,+1,+2,77%,83%,70%,222,200,249,50%,48%,52%,3,1,2,0,0,0
262,https://vlr.gg/player/42557/6ankai,2024-09-26 13:50:00,1.11,1.37,1.23,219,215,224,20,11,9,14,8,6,2,1,1,+4,0,+4,68%,58%,80%,139,113,171,21%,25%,16%,6,2,4,2,2,0
263,https://vlr.gg/player/10448/kozok,2024-09-26 13:50:00,0.85,1.05,0.94,174,164,187,14,7,7,15,9,6,6,3,3,0,+1,-1,77%,67%,90%,107,97,121,15%,4%,29%,3,3,0,3,2,1
264,https://vlr.gg/player/26789/pdr,2024-09-26 13:50:00,0.85,0.91,0.88,106,125,84,9,6,3,12,8,4,12,5,7,0,0,0,64%,50%,80%,61,68,53,10%,11%,8%,0,0,0,0,0,0
265,https://vlr.gg/player/2893/hastack,2024-09-26 13:50:00,1.61,0.66,1.09,242,337,165,17,11,6,17,7,10,5,1,4,+1,0,+1,64%,50%,75%,155,212,108,11%,12%,9%,1,0,1,0,0,0
266,https://vlr.gg/player/14894/facepalm,2024-09-26 13:50:00,0.78,1.03,0.92,211,188,232,16,6,10,18,9,9,0,0,0,-1,-2,+1,68%,60%,75%,139,129,147,32%,64%,7%,2,1,1,3,3,0
267,https://vlr.gg/player/44963/desire,2024-09-26 13:50:00,0.51,1.20,0.89,208,143,262,17,5,12,17,9,8,3,1,2,+2,0,+2,68%,60%,75%,124,90,153,22%,38%,17%,2,0,2,0,0,0
268,https://vlr.gg/player/2996/neiker,2024-09-26 13:50:00,0.02,1.30,0.68,146,54,224,12,2,10,17,10,7,5,1,4,-10,-5,-5,55%,40%,67%,96,28,154,37%,67%,33%,0,0,0,10,5,5
269,https://vlr.gg/player/22154/pika,2024-09-26 13:50:00,0.56,0.54,0.55,115,107,122,9,4,5,18,8,10,7,4,3,-2,-1,-1,64%,80%,50%,70,63,77,29%,25%,31%,1,0,1,3,1,2
270,https://vlr.gg/player/19371/eva,2024-09-26 13:00:00,0.52,1.22,0.84,180,120,263,30,10,20,31,19,12,4,3,1,-1,-1,0,74%,65%,84%,126,83,177,34%,25%,42%,0,0,0,1,1,0
271,https://vlr.gg/player/29903/madv,2024-09-26 13:00:00,0.84,0.83,0.84,198,217,169,26,16,10,34,21,13,21,7,14,-3,-2,-1,71%,65%,79%,128,135,119,38%,47%,28%,1,0,1,4,2,2
272,https://vlr.gg/player/17333/mary,2024-09-26 13:00:00,0.82,0.83,0.82,226,211,244,32,16,16,34,21,13,4,1,3,+2,+1,+1,64%,61%,68%,147,140,154,35%,38%,30%,13,7,6,11,6,5
273,https://vlr.gg/player/20055/toki,2024-09-26 13:00:00,0.62,0.84,0.72,172,132,219,23,9,14,33,19,14,11,7,4,0,-2,+2,64%,61%,68%,120,98,146,34%,27%,41%,3,1,2,3,3,0
274,https://vlr.gg/player/29900/sandra,2024-09-26 13:00:00,0.54,0.43,0.49,144,152,134,21,12,9,34,20,14,6,3,3,-2,-3,+1,55%,52%,58%,96,105,85,39%,39%,39%,2,0,2,4,3,1
275,https://vlr.gg/player/20761/looxie,2024-09-26 13:00:00,1.44,1.60,1.53,267,251,277,42,18,24,27,13,14,19,5,14,+3,+2,+1,83%,84%,83%,157,162,153,38%,42%,34%,6,3,3,3,1,2
276,https://vlr.gg/player/39057/safiaa,2024-09-26 13:00:00,1.77,1.06,1.38,202,235,172,31,17,14,23,11,12,15,4,11,0,0,0,81%,74%,87%,146,178,119,37%,45%,29%,2,1,1,2,1,1
277,https://vlr.gg/player/30186/nami,2024-09-26 13:00:00,0.92,1.71,1.35,262,160,329,37,11,26,26,14,12,12,4,8,0,-3,+3,86%,74%,96%,169,105,222,40%,46%,38%,5,0,5,5,3,2
278,https://vlr.gg/player/24058/tokameite,2024-09-26 13:00:00,1.19,1.05,1.11,176,192,170,28,14,14,24,13,11,13,7,6,-1,+1,-2,81%,84%,78%,121,126,117,32%,24%,39%,2,2,0,3,1,2
279,https://vlr.gg/player/21158/marti,2024-09-26 13:00:00,0.53,1.14,0.86,194,124,249,28,6,22,33,19,14,6,4,2,+2,-3,+5,74%,53%,91%,130,94,159,35%,25%,45%,8,2,6,6,5,1
280,https://vlr.gg/player/45145/costaa,2024-09-26 13:00:00,0.06,1.86,1.41,290,13,383,15,0,15,13,4,9,7,1,6,0,0,0,63%,25%,75%,170,13,222,12%,0%,13%,2,0,2,2,0,2
281,https://vlr.gg/player/48127/riasu,2024-09-26 13:00:00,0.31,0.92,0.77,172,89,200,9,1,8,15,4,11,6,1,5,-1,0,-1,50%,25%,58%,116,66,132,30%,40%,27%,1,0,1,2,0,2
282,https://vlr.gg/player/45144/sulkingg,2024-09-26 13:00:00,0.21,0.89,0.72,199,163,211,12,2,10,15,4,11,0,0,0,-3,-1,-2,63%,50%,67%,134,106,143,41%,60%,38%,2,1,1,5,2,3
283,https://vlr.gg/player/46683/esc,2024-09-26 13:00:00,1.26,0.19,0.45,104,228,64,6,4,2,14,3,11,4,0,4,-1,0,-1,50%,25%,58%,58,108,41,50%,50%,50%,0,0,0,1,0,1
284,https://vlr.gg/player/48128/siekk,2024-09-26 13:00:00,0.04,0.19,0.15,25,13,30,0,0,0,14,4,10,4,1,3,-1,-1,0,38%,25%,42%,21,7,26,14%,0%,17%,0,0,0,1,1,0
285,https://vlr.gg/player/29972/michel,2024-09-26 13:00:00,1.62,2.90,1.94,444,421,516,25,17,8,11,10,1,7,5,2,+5,+3,+2,81%,75%,100%,250,240,280,27%,27%,26%,7,5,2,2,2,0
286,https://vlr.gg/player/4851/rexs,2024-09-26 13:00:00,1.75,1.13,1.59,255,280,182,15,13,2,8,6,2,14,10,4,0,+1,-1,94%,92%,100%,182,203,117,24%,26%,18%,1,1,0,1,0,1
287,https://vlr.gg/player/24359/faska,2024-09-26 13:00:00,1.57,1.59,1.58,256,248,284,15,11,4,6,5,1,8,5,3,+1,+1,0,81%,75%,100%,176,170,193,22%,22%,23%,1,1,0,0,0,0
288,https://vlr.gg/player/2835/kyrrz,2024-09-26 13:00:00,1.09,1.35,1.15,145,150,131,8,6,2,7,6,1,14,10,4,0,0,0,75%,75%,75%,86,89,78,56%,50%,100%,0,0,0,0,0,0
289,https://vlr.gg/player/31553/pukytoo,2024-09-26 13:00:00,0.34,1.21,0.56,136,113,209,8,5,3,10,8,2,2,2,0,0,-1,+1,63%,50%,100%,87,77,116,30%,33%,27%,2,1,1,2,2,0
290,https://vlr.gg/player/19588/neptuno,2024-09-26 12:00:00,1.76,1.37,1.57,316,350,280,28,16,12,15,8,7,4,2,2,+1,-1,+2,87%,83%,91%,199,220,176,32%,28%,39%,3,0,3,2,1,1
291,https://vlr.gg/player/17861/blastinho,2024-09-26 12:00:00,1.43,1.46,1.44,291,303,279,23,13,10,16,9,7,6,2,4,+5,+2,+3,87%,83%,91%,180,176,184,16%,16%,16%,8,4,4,3,2,1
292,https://vlr.gg/player/41847/negradas,2024-09-26 12:00:00,1.11,1.04,1.08,202,188,217,16,8,8,16,9,7,12,9,3,-1,-1,0,91%,92%,91%,139,135,143,40%,38%,42%,0,0,0,1,1,0
293,https://vlr.gg/player/2884/daniel0,2024-09-26 12:00:00,0.68,1.38,1.01,200,148,257,16,5,11,15,10,5,6,5,1,-1,0,-1,74%,67%,82%,140,102,181,46%,40%,50%,0,0,0,1,0,1
294,https://vlr.gg/player/8811/humanz,2024-09-26 12:00:00,0.59,0.62,0.61,125,108,145,11,5,6,17,9,8,7,5,2,-1,-2,+1,70%,75%,64%,82,69,95,24%,20%,29%,2,1,1,3,3,0
295,https://vlr.gg/player/29974/erizillo,2024-09-26 12:00:00,0.83,1.60,1.23,282,183,373,24,8,16,19,9,10,4,3,1,-1,-2,+1,61%,55%,67%,178,108,243,41%,26%,52%,2,0,2,3,2,1
296,https://vlr.gg/player/41804/kalvo,2024-09-26 12:00:00,0.73,1.15,0.95,213,190,235,16,7,9,19,10,9,5,1,4,+2,+1,+1,74%,55%,92%,143,129,155,23%,27%,20%,3,1,2,1,0,1
297,https://vlr.gg/player/42521/jahbu,2024-09-26 12:00:00,0.76,0.95,0.86,157,135,179,13,5,8,16,8,8,7,0,7,-4,-3,-1,65%,45%,83%,97,100,94,41%,42%,40%,2,1,1,6,4,2
298,https://vlr.gg/player/4951/hardy,2024-09-26 12:00:00,0.98,0.38,0.66,171,203,142,13,8,5,20,9,11,6,2,4,0,0,0,74%,82%,67%,132,137,128,28%,35%,23%,2,1,1,2,1,1
299,https://vlr.gg/player/15383/khorror,2024-09-26 12:00:00,0.54,0.65,0.60,167,168,168,13,6,7,20,11,9,3,1,2,0,-1,+1,57%,55%,58%,123,133,115,21%,37%,14%,1,0,1,1,1,0
300,https://vlr.gg/player/36175/rezq,2024-09-26 11:00:00,1.33,1.38,1.36,351,305,388,55,22,33,35,13,22,6,2,4,+5,+2,+3,71%,75%,68%,207,182,227,28%,28%,27%,18,7,11,13,5,8
301,https://vlr.gg/player/20064/vania,2024-09-26 11:00:00,1.41,1.03,1.20,195,244,164,35,17,18,26,12,14,25,15,10,-2,0,-2,80%,85%,76%,125,162,95,35%,43%,29%,1,1,0,3,1,2
302,https://vlr.gg/player/17323/mimi,2024-09-26 11:00:00,1.23,1.14,1.18,182,193,164,31,16,15,19,9,10,7,3,4,-1,-1,0,84%,90%,80%,123,124,123,29%,33%,26%,0,0,0,1,1,0
303,https://vlr.gg/player/17320/petra,2024-09-26 11:00:00,0.63,1.29,1.00,194,139,237,31,10,21,29,14,15,14,5,9,-1,-1,0,73%,65%,80%,133,94,163,24%,39%,19%,1,0,1,2,1,1
304,https://vlr.gg/player/24149/amy,2024-09-26 11:00:00,1.05,0.97,1.00,180,187,167,27,13,14,27,12,15,18,9,9,+2,0,+2,73%,70%,76%,115,115,115,36%,30%,41%,4,2,2,2,2,0
305,https://vlr.gg/player/30107/fluxxy,2024-09-26 11:00:00,0.90,1.32,1.09,222,195,263,35,16,19,35,20,15,15,11,4,+3,0,+3,80%,84%,75%,147,132,164,39%,45%,33%,5,2,3,2,2,0
306,https://vlr.gg/player/19362/lyda,2024-09-26 11:00:00,0.99,1.12,1.05,195,195,197,30,16,14,33,19,14,11,7,4,+2,+1,+1,62%,64%,60%,137,126,150,38%,39%,36%,3,2,1,1,1,0
307,https://vlr.gg/player/37990/adora,2024-09-26 11:00:00,1.29,0.64,1.00,203,284,96,32,25,7,34,20,14,3,2,1,+2,+2,0,58%,60%,55%,136,176,87,30%,28%,33%,9,6,3,7,4,3
308,https://vlr.gg/player/24140/superphrog,2024-09-26 11:00:00,0.62,0.89,0.74,163,143,205,27,13,14,37,21,16,3,0,3,-3,-2,-1,56%,52%,60%,114,104,127,35%,31%,39%,4,1,3,7,3,4
309,https://vlr.gg/player/9431/cille,2024-09-26 11:00:00,0.33,0.38,0.33,79,73,96,12,6,6,40,21,19,13,7,6,-7,-4,-3,56%,60%,50%,59,49,73,16%,7%,27%,0,0,0,7,4,3
310,https://vlr.gg/player/3372/ori4k,2024-09-26 11:00:00,1.32,0.60,1.05,230,260,181,15,11,4,15,8,7,1,0,1,-2,0,-2,58%,58%,57%,133,143,117,71%,79%,57%,1,1,0,3,1,2
311,https://vlr.gg/player/5834/mikelelle,2024-09-26 11:00:00,0.98,0.29,0.73,138,174,77,10,8,2,14,8,6,4,2,2,-3,0,-3,58%,58%,57%,94,119,52,42%,53%,14%,1,1,0,4,1,3
312,https://vlr.gg/player/46181/nade,2024-09-26 11:00:00,0.31,1.23,0.65,162,112,249,10,4,6,16,10,6,3,2,1,-2,-1,-1,63%,50%,86%,109,72,173,36%,21%,50%,1,1,0,3,2,1
313,https://vlr.gg/player/45138/aster,2024-09-26 11:00:00,0.65,0.54,0.61,104,72,160,6,2,4,15,8,7,4,4,0,0,0,0,58%,67%,43%,62,46,88,31%,9%,80%,0,0,0,0,0,0
314,https://vlr.gg/player/6117/kayn,2024-09-26 11:00:00,0.55,0.17,0.41,97,132,38,6,5,1,16,10,6,5,4,1,-5,-4,-1,58%,75%,29%,56,79,17,31%,38%,0%,0,0,0,5,4,1
315,https://vlr.gg/player/29994/xini,2024-09-26 11:00:00,1.95,1.25,1.50,353,402,325,23,10,13,11,4,7,3,2,1,+4,+3,+1,89%,100%,83%,256,308,226,30%,33%,28%,7,3,4,3,0,3
316,https://vlr.gg/player/29827/repteyy,2024-09-26 11:00:00,1.12,1.66,1.46,178,93,228,13,2,11,5,2,3,12,6,6,+2,+2,0,89%,86%,92%,106,33,149,22%,75%,14%,2,2,0,0,0,0
317,https://vlr.gg/player/31569/cyan,2024-09-26 11:00:00,1.52,1.38,1.43,234,257,221,15,7,8,8,3,5,12,2,10,+3,+1,+2,84%,86%,83%,141,162,129,23%,17%,29%,3,1,2,0,0,0
318,https://vlr.gg/player/16141/sora,2024-09-26 11:00:00,1.14,0.89,0.98,193,197,191,14,6,8,12,4,8,4,1,3,+3,+1,+2,84%,86%,83%,137,159,124,31%,29%,32%,3,1,2,0,0,0
319,https://vlr.gg/player/41846/shiro,2024-09-26 11:00:00,1.55,0.44,0.85,153,258,92,11,7,4,11,4,7,9,7,2,0,0,0,63%,71%,58%,102,156,71,31%,36%,27%,0,0,0,0,0,0
320,https://vlr.gg/player/48159/yyni,2024-09-26 07:00:00,,,,235,,,32,,,25,,,8,,,,,,,,,,,,,,,,,,,,
321,https://vlr.gg/player/39397/7wyy,2024-09-26 07:00:00,,,,231,,,26,,,27,,,11,,,,,,,,,,,,,,,,,,,,
322,https://vlr.gg/player/48157/kiaki,2024-09-26 07:00:00,,,,203,,,27,,,27,,,5,,,,,,,,,,,,,,,,,,,,
323,https://vlr.gg/player/48156/yumiiurx,2024-09-26 07:00:00,,,,147,,,16,,,30,,,5,,,,,,,,,,,,,,,,,,,,
324,https://vlr.gg/player/48158/xkb,2024-09-26 07:00:00,,,,102,,,10,,,26,,,16,,,,,,,,,,,,,,,,,,,,
325,https://vlr.gg/player/13232/muffyn,2024-09-26 07:00:00,,,,289,,,36,,,25,,,6,,,,,,,,,,,,,,,,,,,,
326,https://vlr.gg/player/25415/yusin,2024-09-26 07:00:00,,,,269,,,34,,,23,,,19,,,,,,,,,,,,,,,,,,,,
327,https://vlr.gg/player/48160/laiyin,2024-09-26 07:00:00,,,,268,,,35,,,18,,,15,,,,,,,,,,,,,,,,,,,,
328,https://vlr.gg/player/1909/jinny,2024-09-26 07:00:00,,,,160,,,21,,,21,,,18,,,,,,,,,,,,,,,,,,,,
329,https://vlr.gg/player/48161/1hp,2024-09-26 07:00:00,,,,84,,,9,,,24,,,12,,,,,,,,,,,,,,,,,,,,
330,https://vlr.gg/player/48150/yuyoo,2024-09-26 05:00:00,,,,339,,,26,,,25,,,8,,,,,,,,,,,,,,,,,,,,
331,https://vlr.gg/player/48148/kihane,2024-09-26 05:00:00,,,,211,,,19,,,17,,,5,,,,,,,,,,,,,,,,,,,,
332,https://vlr.gg/player/48149/rain,2024-09-26 05:00:00,,,,204,,,16,,,12,,,11,,,,,,,,,,,,,,,,,,,,
333,https://vlr.gg/player/48146/ko,2024-09-26 05:00:00,,,,180,,,16,,,14,,,16,,,,,,,,,,,,,,,,,,,,
334,https://vlr.gg/player/48147/kotoza,2024-09-26 05:00:00,,,,141,,,13,,,18,,,4,,,,,,,,,,,,,,,,,,,,
335,https://vlr.gg/player/48153/rua,2024-09-26 05:00:00,,,,247,,,20,,,19,,,6,,,,,,,,,,,,,,,,,,,,
336,https://vlr.gg/player/48151/fancy,2024-09-26 05:00:00,,,,221,,,19,,,16,,,12,,,,,,,,,,,,,,,,,,,,
337,https://vlr.gg/player/48155/says0,2024-09-26 05:00:00,,,,214,,,17,,,19,,,7,,,,,,,,,,,,,,,,,,,,
338,https://vlr.gg/player/48154/7ball,2024-09-26 05:00:00,,,,213,,,18,,,16,,,6,,,,,,,,,,,,,,,,,,,,
339,https://vlr.gg/player/48152/1ball,2024-09-26 05:00:00,,,,110,,,10,,,20,,,5,,,,,,,,,,,,,,,,,,,,
340,https://vlr.gg/player/25737/buffala,2024-09-25 18:00:00,1.19,1.11,1.14,240,245,230,32,13,19,29,15,14,15,12,3,-1,+1,-2,78%,81%,76%,155,171,143,29%,35%,22%,7,3,4,8,2,6
341,https://vlr.gg/player/35951/morgan,2024-09-25 18:00:00,1.09,1.14,1.12,194,196,190,55,28,27,55,28,27,40,15,25,+1,-1,+2,76%,73%,79%,125,123,127,19%,18%,19%,7,2,5,6,3,3
342,https://vlr.gg/player/44462/kyujinn,2024-09-25 18:00:00,0.92,1.02,0.97,193,200,182,59,28,31,57,30,27,15,6,9,-3,+1,-4,68%,65%,70%,133,133,133,33%,44%,26%,3,3,0,6,2,4
343,https://vlr.gg/player/20500/zaki,2024-09-25 18:00:00,0.50,1.17,0.86,192,146,223,50,16,34,63,32,31,20,13,7,-3,-3,0,70%,65%,74%,123,100,143,26%,21%,32%,7,3,4,10,6,4
344,https://vlr.gg/player/28386/junki,2024-09-25 18:00:00,0.95,0.75,0.85,163,213,119,50,29,21,61,31,30,31,13,18,+2,+2,0,79%,68%,88%,107,145,74,24%,29%,16%,4,3,1,2,1,1
345,https://vlr.gg/player/42203/shotoo,2024-09-25 18:00:00,0.75,0.90,0.82,202,197,206,37,15,22,36,18,18,6,4,2,-1,-1,0,74%,71%,77%,124,114,134,33%,23%,41%,7,4,3,8,5,3
346,https://vlr.gg/player/28598/chloe,2024-09-25 18:00:00,0.97,1.49,1.21,243,182,325,72,27,45,58,28,30,33,16,17,+2,+3,-1,79%,74%,84%,163,128,205,30%,38%,25%,7,5,2,5,2,3
347,https://vlr.gg/player/44501/lauguz,2024-09-25 18:00:00,1.10,1.34,1.21,246,230,276,66,32,34,61,31,30,15,7,8,+5,+1,+4,78%,65%,92%,177,170,185,34%,31%,37%,12,7,5,7,6,1
348,https://vlr.gg/player/21476/cami,2024-09-25 18:00:00,0.98,0.95,0.97,181,158,222,62,25,37,58,27,31,22,10,12,+3,+2,+1,71%,72%,70%,117,98,140,41%,41%,41%,11,4,7,8,2,6
349,https://vlr.gg/player/35839/vefa,2024-09-25 18:00:00,0.97,0.92,0.95,175,172,177,51,25,26,57,30,27,28,13,15,-2,0,-2,75%,72%,78%,118,111,126,22%,24%,20%,7,3,4,9,3,6
350,https://vlr.gg/player/15592/angel,2024-09-25 18:00:00,0.79,1.07,0.92,150,130,180,50,20,30,51,26,25,22,6,16,-3,-1,-2,74%,72%,76%,109,94,127,42%,41%,43%,4,3,1,7,4,3
351,https://vlr.gg/player/24764/akame,2024-09-25 17:30:00,0.91,2.02,1.67,335,194,401,47,9,38,22,9,13,10,2,8,+1,-1,+2,83%,73%,88%,204,132,237,46%,41%,47%,6,1,5,5,2,3
352,https://vlr.gg/player/14690/lissa,2024-09-25 17:30:00,1.08,1.47,1.30,233,238,231,28,8,20,21,10,11,13,2,11,-1,-1,0,74%,45%,88%,161,169,157,40%,35%,42%,4,3,1,5,4,1
353,https://vlr.gg/player/29179/vii,2024-09-25 17:30:00,1.14,1.31,1.26,258,222,274,31,8,23,23,7,16,13,5,8,-1,-1,0,83%,82%,83%,173,148,184,29%,19%,33%,3,0,3,4,1,3
354,https://vlr.gg/player/24763/speedy,2024-09-25 17:30:00,1.05,1.18,1.14,201,153,216,27,7,20,21,6,15,11,2,9,0,0,0,80%,64%,88%,126,84,145,26%,12%,35%,3,0,3,3,0,3
355,https://vlr.gg/player/6994/shyz,2024-09-25 17:30:00,1.33,0.78,0.95,128,225,83,16,9,7,18,7,11,11,5,6,0,0,0,83%,82%,83%,95,148,71,30%,29%,32%,1,0,1,1,0,1
356,https://vlr.gg/player/20222/crona,2024-09-25 17:30:00,0.96,1.18,1.03,232,233,224,29,20,9,29,21,8,12,5,7,+2,0,+2,66%,63%,73%,137,133,146,33%,30%,42%,3,1,2,1,1,0
357,https://vlr.gg/player/12126/kaah,2024-09-25 17:30:00,1.00,1.07,1.02,231,224,238,27,18,9,29,21,8,6,5,1,+1,0,+1,71%,67%,82%,148,145,154,33%,33%,32%,4,2,2,3,2,1
358,https://vlr.gg/player/2245/krysme,2024-09-25 17:30:00,0.55,1.00,0.69,153,157,163,20,13,7,27,21,6,6,2,4,-2,-2,0,60%,46%,91%,103,106,99,36%,46%,21%,1,1,0,3,3,0
359,https://vlr.gg/player/25580/jenny,2024-09-25 17:30:00,0.36,1.27,0.65,164,118,287,19,8,11,33,23,10,11,6,5,+5,+3,+2,74%,63%,100%,117,78,203,19%,23%,15%,9,7,2,4,4,0
360,https://vlr.gg/player/29169/erin,2024-09-25 17:30:00,0.45,0.36,0.41,118,126,106,10,7,3,31,22,9,12,9,3,-5,-3,-2,49%,50%,45%,83,84,82,29%,29%,28%,1,0,1,6,3,3
361,https://vlr.gg/player/11239/sayuri,2024-09-25 16:00:00,1.59,1.96,1.76,270,245,296,31,14,17,13,7,6,35,15,20,0,0,0,97%,94%,100%,166,156,176,21%,15%,29%,2,1,1,2,1,1
362,https://vlr.gg/player/21435/jelly,2024-09-25 16:00:00,1.57,1.94,1.75,298,265,337,36,18,18,15,8,7,18,3,15,+2,0,+2,97%,94%,100%,193,180,207,37%,42%,33%,2,0,2,0,0,0
363,https://vlr.gg/player/31574/srn,2024-09-25 16:00:00,1.63,1.17,1.41,289,376,199,34,23,11,22,14,8,8,3,5,+7,+4,+3,91%,88%,93%,185,232,132,26%,33%,10%,12,7,5,5,3,2
364,https://vlr.gg/player/14685/jubs,2024-09-25 16:00:00,0.82,1.62,1.19,199,152,250,24,9,15,14,9,5,8,3,5,+2,+2,0,84%,76%,93%,143,108,182,19%,17%,20%,2,2,0,0,0,0
365,https://vlr.gg/player/19791/mel,2024-09-25 16:00:00,1.11,1.26,1.18,194,158,231,22,11,11,15,7,8,12,4,8,-1,-1,0,88%,88%,87%,130,108,154,26%,50%,16%,3,1,2,4,2,2
366,https://vlr.gg/player/12225/fer,2024-09-25 16:00:00,0.53,0.88,0.72,193,172,211,20,8,12,30,15,15,9,3,6,+3,+1,+2,56%,47%,65%,121,110,130,26%,27%,26%,4,2,2,1,1,0
367,https://vlr.gg/player/11247/misty,2024-09-25 16:00:00,0.70,0.64,0.66,156,143,173,16,6,10,31,14,17,9,7,2,0,+1,-1,53%,53%,53%,102,90,112,39%,47%,35%,2,1,1,2,0,2
368,https://vlr.gg/player/12119/scherbi,2024-09-25 16:00:00,0.91,0.38,0.63,152,230,88,18,12,6,27,14,13,2,2,0,-4,-3,-1,47%,47%,47%,96,145,53,16%,14%,23%,2,0,2,6,3,3
369,https://vlr.gg/player/36649/gigika,2024-09-25 16:00:00,0.16,0.98,0.57,135,53,209,15,2,13,29,14,15,4,3,1,-4,-4,0,50%,40%,59%,89,40,132,28%,18%,31%,1,0,1,5,4,1
370,https://vlr.gg/player/40493/setrexz,2024-09-25 16:00:00,0.31,0.29,0.28,110,117,102,10,6,4,30,15,15,4,0,4,-5,0,-5,50%,47%,53%,79,83,75,35%,44%,29%,2,2,0,7,2,5
371,https://vlr.gg/player/12430/skypzz,2024-09-25 16:00:00,0.86,0.67,0.72,180,206,172,10,3,7,14,4,10,3,0,3,-3,0,-3,56%,75%,50%,128,141,124,42%,25%,50%,1,0,1,4,0,4
372,https://vlr.gg/player/17911/duss,2024-09-25 16:00:00,0.02,0.98,0.69,130,14,169,8,0,8,11,4,7,3,1,2,-2,-1,-1,63%,25%,75%,82,14,105,27%,0%,29%,0,0,0,2,1,1
373,https://vlr.gg/player/11830/mortyyyy,2024-09-25 16:00:00,0.60,0.62,0.61,107,134,99,5,2,3,13,4,9,9,0,9,+2,+1,+1,56%,25%,67%,61,75,57,16%,50%,7%,2,1,1,0,0,0
374,https://vlr.gg/player/19874/mrpenguin,2024-09-25 16:00:00,0.38,0.69,0.61,161,120,175,6,1,5,14,4,10,5,0,5,0,0,0,56%,50%,58%,120,92,129,18%,13%,19%,2,1,1,2,1,1
375,https://vlr.gg/player/48123/zipix,2024-09-25 16:00:00,0.01,0.56,0.37,131,29,165,6,0,6,13,4,9,2,1,1,+1,0,+1,56%,50%,58%,87,29,106,19%,0%,22%,2,0,2,1,0,1
376,https://vlr.gg/player/29994/xini,2024-09-25 16:00:00,1.66,1.10,1.52,242,261,187,15,12,3,7,5,2,2,2,0,+2,+2,0,69%,75%,50%,166,174,143,29%,24%,60%,4,3,1,2,1,1
377,https://vlr.gg/player/16141/sora,2024-09-25 16:00:00,1.46,1.40,1.44,266,282,222,17,13,4,9,7,2,3,1,2,-2,-1,-1,75%,75%,75%,182,190,158,57%,63%,33%,1,1,0,3,2,1
378,https://vlr.gg/player/31569/cyan,2024-09-25 16:00:00,1.32,1.69,1.41,247,242,265,14,10,4,8,7,1,5,4,1,0,0,0,88%,83%,100%,167,169,162,40%,31%,83%,1,1,0,1,1,0
379,https://vlr.gg/player/11330/mcd,2024-09-25 16:00:00,1.15,1.79,1.31,128,122,151,8,5,3,4,4,0,8,7,1,0,0,0,88%,83%,100%,97,100,91,30%,29%,33%,1,1,0,1,1,0
380,https://vlr.gg/player/29827/repteyy,2024-09-25 16:00:00,0.82,2.26,1.18,179,116,368,11,5,6,7,6,1,6,3,3,+2,+1,+1,81%,75%,100%,122,85,234,29%,39%,20%,2,1,1,0,0,0
381,https://vlr.gg/player/19588/neptuno,2024-09-25 15:00:00,2.45,0.90,1.83,295,433,90,21,19,2,8,5,3,7,3,4,0,+1,-1,80%,83%,75%,176,251,63,37%,41%,20%,2,2,0,2,1,1
382,https://vlr.gg/player/8811/humanz,2024-09-25 15:00:00,1.07,2.58,1.67,272,156,447,22,8,14,12,8,4,6,5,1,0,-1,+1,85%,83%,88%,175,96,293,63%,45%,74%,1,0,1,1,1,0
383,https://vlr.gg/player/17861/blastinho,2024-09-25 15:00:00,0.92,1.30,1.07,202,228,164,14,9,5,13,10,3,6,4,2,-1,0,-1,75%,75%,75%,136,137,136,20%,11%,46%,2,2,0,3,2,1
384,https://vlr.gg/player/41847/negradas,2024-09-25 15:00:00,0.82,0.97,0.88,169,157,190,11,6,5,14,8,6,11,8,3,-2,-1,-1,80%,75%,88%,111,120,97,27%,17%,46%,1,0,1,3,1,2
385,https://vlr.gg/player/2884/daniel0,2024-09-25 15:00:00,0.04,0.92,0.38,129,39,266,9,2,7,16,10,6,7,3,4,-3,-3,0,55%,50%,63%,80,26,160,25%,20%,26%,1,0,1,4,3,1
386,https://vlr.gg/player/13024/vuubit,2024-09-25 15:00:00,1.30,1.37,1.34,251,225,270,18,6,12,14,6,8,5,3,2,0,+1,-1,60%,63%,58%,169,175,165,33%,25%,40%,2,1,1,2,0,2
387,https://vlr.gg/player/4214/eso177,2024-09-25 15:00:00,0.40,1.17,0.86,198,119,252,11,2,9,15,6,9,5,1,4,+3,0,+3,60%,50%,67%,134,91,163,24%,18%,27%,3,0,3,0,0,0
388,https://vlr.gg/player/46179/davia,2024-09-25 15:00:00,0.56,0.82,0.72,187,143,217,13,4,9,15,6,9,0,0,0,-1,0,-1,50%,63%,42%,122,95,139,24%,21%,25%,3,2,1,4,2,2
389,https://vlr.gg/player/29998/drastz,2024-09-25 15:00:00,0.80,0.63,0.70,173,226,139,12,7,5,16,7,9,5,1,4,+2,0,+2,65%,63%,67%,105,128,90,12%,25%,6%,2,0,2,0,0,0
390,https://vlr.gg/player/8590/killdream,2024-09-25 15:00:00,0.25,0.75,0.55,113,87,132,9,3,6,17,8,9,6,1,5,+2,+1,+1,70%,50%,83%,65,56,72,13%,29%,6%,3,2,1,1,1,0
391,https://vlr.gg/player/39506/cabbit,2024-09-25 14:00:00,0.84,1.12,1.01,213,157,240,27,8,19,28,12,16,16,7,9,-4,-2,-2,63%,60%,65%,140,121,151,45%,35%,53%,1,1,0,5,3,2
392,https://vlr.gg/player/16196/annie,2024-09-25 14:00:00,0.91,0.86,0.88,205,251,190,28,13,15,33,14,19,5,3,2,0,-1,+1,58%,67%,52%,133,152,120,37%,33%,41%,6,1,5,6,2,4
393,https://vlr.gg/player/20058/devilasxa,2024-09-25 14:00:00,1.18,0.68,0.87,199,210,199,26,12,14,32,12,20,6,2,4,-1,0,-1,63%,67%,61%,138,157,125,26%,29%,23%,3,0,3,4,0,4
394,https://vlr.gg/player/20116/jademwah,2024-09-25 14:00:00,0.56,0.99,0.82,178,152,201,21,6,15,31,14,17,25,12,13,-3,-3,0,63%,67%,61%,110,98,118,16%,15%,17%,3,1,2,6,4,2
395,https://vlr.gg/player/7460/6sonya,2024-09-25 14:00:00,0.45,1.03,0.80,170,130,196,22,7,15,29,13,16,7,0,7,-2,-1,-1,61%,47%,70%,109,86,124,38%,41%,37%,1,1,0,3,2,1
396,https://vlr.gg/player/16418/smurfette,2024-09-25 14:00:00,0.96,2.05,1.39,319,249,393,44,22,22,27,19,8,8,4,4,+4,+2,+2,71%,65%,80%,192,160,241,34%,38%,29%,8,6,2,4,4,0
397,https://vlr.gg/player/17343/ness,2024-09-25 14:00:00,1.40,1.08,1.27,204,208,195,25,17,8,20,12,8,19,9,10,0,0,0,87%,83%,93%,137,144,127,23%,32%,14%,3,1,2,3,1,2
398,https://vlr.gg/player/26632/joliinaa,2024-09-25 14:00:00,1.09,1.41,1.21,198,194,218,30,16,14,24,16,8,21,12,9,+4,0,+4,84%,87%,80%,124,128,118,21%,23%,18%,6,2,4,2,2,0
399,https://vlr.gg/player/24107/sarah,2024-09-25 14:00:00,1.03,1.03,1.03,214,203,222,27,16,11,28,16,12,27,12,15,+1,0,+1,79%,70%,93%,142,141,143,30%,40%,21%,3,1,2,2,1,1
400,https://vlr.gg/player/24101/miyori,2024-09-25 14:00:00,1.04,0.87,0.97,191,202,177,27,17,10,25,15,10,7,5,2,+1,+1,0,76%,74%,80%,141,153,123,19%,20%,19%,4,3,1,3,2,1
401,https://vlr.gg/player/46233/kz,2024-09-25 14:00:00,0.53,0.91,0.83,254,175,275,12,2,10,15,3,12,2,0,2,-2,-1,-1,60%,67%,58%,160,89,177,24%,13%,27%,2,0,2,4,1,3
402,https://vlr.gg/player/33833/pepecho,2024-09-25 14:00:00,0.43,0.80,0.72,171,133,181,9,1,8,14,3,11,3,1,2,0,0,0,60%,67%,58%,104,84,109,33%,20%,37%,1,0,1,1,0,1
403,https://vlr.gg/player/32300/varuxx,2024-09-25 14:00:00,0.04,0.74,0.60,135,44,158,7,0,7,13,3,10,3,0,3,-3,0,-3,47%,33%,50%,114,44,132,20%,0%,25%,0,0,0,3,0,3
404,https://vlr.gg/player/36637/xpatrycksio,2024-09-25 14:00:00,0.04,0.70,0.57,176,27,214,8,0,8,15,3,12,9,2,7,0,-1,+1,73%,67%,75%,113,10,139,31%,0%,32%,1,0,1,1,1,0
405,https://vlr.gg/player/44130/bern1,2024-09-25 14:00:00,0.58,0.23,0.30,86,203,58,4,2,2,12,3,9,0,0,0,-2,-1,-1,40%,67%,33%,50,106,36,57%,100%,40%,0,0,0,2,1,1
406,https://vlr.gg/player/24359/faska,2024-09-25 14:00:00,1.64,2.40,1.80,253,238,313,15,11,4,5,5,0,5,5,0,+2,+1,+1,87%,83%,100%,175,165,214,52%,50%,56%,2,1,1,0,0,0
407,https://vlr.gg/player/2835/kyrrz,2024-09-25 14:00:00,1.88,1.45,1.79,266,276,230,15,13,2,6,5,1,12,8,4,+2,+2,0,100%,100%,100%,184,203,107,58%,54%,100%,2,2,0,0,0,0
408,https://vlr.gg/player/4851/rexs,2024-09-25 14:00:00,1.78,1.83,1.79,320,325,305,17,13,4,8,7,1,6,6,0,+4,+3,+1,93%,92%,100%,212,209,223,41%,45%,30%,5,4,1,1,1,0
409,https://vlr.gg/player/31553/pukytoo,2024-09-25 14:00:00,0.94,1.33,1.02,159,154,180,9,7,2,8,7,1,5,4,1,0,0,0,80%,75%,100%,114,116,105,59%,50%,100%,0,0,0,0,0,0
410,https://vlr.gg/player/29972/michel,2024-09-25 14:00:00,0.63,1.41,0.79,239,223,305,13,10,3,13,11,2,2,0,2,-1,-2,+1,67%,58%,100%,153,143,193,41%,40%,50%,2,1,1,3,3,0
411,https://vlr.gg/player/15383/khorror,2024-09-25 13:00:00,1.48,1.97,1.76,328,274,370,27,10,17,11,5,6,5,3,2,+1,0,+1,86%,78%,92%,209,150,253,35%,32%,38%,2,0,2,1,0,1
412,https://vlr.gg/player/29974/erizillo,2024-09-25 13:00:00,2.07,1.50,1.74,330,452,239,24,14,10,13,7,6,10,2,8,+3,+2,+1,71%,78%,67%,218,278,173,45%,58%,33%,4,2,2,1,0,1
413,https://vlr.gg/player/42521/jahbu,2024-09-25 13:00:00,0.63,0.89,0.78,128,64,177,9,2,7,12,5,7,5,2,3,-2,-2,0,71%,67%,75%,97,56,127,33%,43%,30%,0,0,0,2,2,0
414,https://vlr.gg/player/41804/kalvo,2024-09-25 13:00:00,0.16,0.90,0.58,164,102,211,12,3,9,16,8,8,3,1,2,-4,-4,0,57%,44%,67%,103,64,131,32%,40%,29%,1,0,1,5,4,1
415,https://vlr.gg/player/4951/hardy,2024-09-25 13:00:00,0.37,0.35,0.36,95,67,117,5,1,4,17,7,10,5,3,2,-1,-1,0,52%,56%,50%,72,63,78,24%,22%,25%,2,0,2,3,1,2
416,https://vlr.gg/player/14894/facepalm,2024-09-25 13:00:00,1.28,1.98,1.58,358,296,442,26,12,14,16,9,7,4,2,2,+4,+1,+3,81%,67%,100%,226,191,272,32%,43%,23%,7,3,4,3,2,1
417,https://vlr.gg/player/22154/pika,2024-09-25 13:00:00,0.81,1.08,0.92,142,130,159,10,4,6,14,9,5,13,6,7,-1,-1,0,76%,75%,78%,92,93,90,27%,31%,21%,2,1,1,3,2,1
418,https://vlr.gg/player/2996/neiker,2024-09-25 13:00:00,1.01,0.79,0.91,172,195,143,13,8,5,17,10,7,10,6,4,-1,-1,0,76%,75%,78%,114,124,101,38%,39%,36%,0,0,0,1,1,0
419,https://vlr.gg/player/2893/hastack,2024-09-25 13:00:00,0.99,0.63,0.84,181,226,123,11,8,3,15,9,6,6,2,4,0,-1,+1,52%,42%,67%,124,156,81,21%,22%,19%,2,1,1,2,2,0
420,https://vlr.gg/player/33031/pablosaurio,2024-09-25 13:00:00,0.55,1.11,0.79,138,105,183,9,5,4,15,10,5,7,1,6,+1,0,+1,71%,58%,89%,99,70,137,23%,31%,17%,1,0,1,0,0,0
421,https://vlr.gg/player/24071/liza,2024-09-25 11:00:00,1.73,1.73,1.73,348,348,346,51,25,26,23,10,13,12,5,7,+3,-1,+4,85%,78%,90%,205,206,204,28%,34%,23%,11,4,7,8,5,3
422,https://vlr.gg/player/22792/jiex,2024-09-25 11:00:00,1.41,1.45,1.43,258,225,282,36,16,20,22,9,13,26,12,14,+3,+3,0,82%,89%,76%,162,134,186,40%,62%,31%,5,3,2,2,0,2
423,https://vlr.gg/player/38142/dream,2024-09-25 11:00:00,1.20,1.17,1.18,147,165,135,25,12,13,14,6,8,4,2,2,-1,+1,-2,90%,94%,86%,96,106,88,35%,34%,35%,1,1,0,2,0,2
424,https://vlr.gg/player/17394/ninou,2024-09-25 11:00:00,1.31,0.93,1.10,213,237,192,24,13,11,22,9,13,21,11,10,+3,+1,+2,79%,94%,67%,147,164,132,14%,10%,19%,4,2,2,1,1,0
425,https://vlr.gg/player/20098/mel,2024-09-25 11:00:00,1.07,0.77,0.91,129,146,112,19,9,10,20,9,11,20,12,8,-3,0,-3,79%,89%,71%,90,101,81,38%,38%,39%,1,1,0,4,1,3
426,https://vlr.gg/player/16321/nelo,2024-09-25 11:00:00,1.14,0.95,1.05,214,226,200,28,15,13,30,15,15,17,12,5,0,0,0,72%,76%,67%,141,138,144,30%,28%,33%,1,1,0,1,1,0
427,https://vlr.gg/player/21153/matrix,2024-09-25 11:00:00,0.95,0.90,0.93,212,224,195,27,16,11,32,18,14,5,2,3,-2,-1,-1,64%,67%,61%,136,151,119,33%,36%,31%,10,7,3,12,8,4
428,https://vlr.gg/player/11183/glance,2024-09-25 11:00:00,0.87,0.84,0.84,156,169,146,21,12,9,29,15,14,5,4,1,-1,0,-1,59%,62%,56%,109,116,100,26%,31%,21%,2,0,2,3,0,3
429,https://vlr.gg/player/16419/roxi,2024-09-25 11:00:00,0.60,0.34,0.48,129,106,150,15,8,7,33,15,18,4,2,2,+2,+1,+1,49%,57%,39%,95,87,104,21%,28%,17%,4,2,2,2,1,1
430,https://vlr.gg/player/19356/kuripuuya,2024-09-25 11:00:00,0.57,0.34,0.46,87,112,57,10,7,3,31,17,14,13,6,7,-4,-1,-3,62%,76%,44%,57,74,38,21%,26%,10%,0,0,0,4,1,3
431,https://vlr.gg/player/26789/pdr,2024-09-25 11:00:00,0.73,1.35,1.11,244,204,272,16,6,10,15,7,8,7,0,7,+3,+1,+2,65%,50%,75%,149,111,174,26%,20%,31%,4,2,2,1,1,0
432,https://vlr.gg/player/42557/6ankai,2024-09-25 11:00:00,0.15,1.74,1.10,238,68,352,17,1,16,16,7,9,3,2,1,-4,-2,-2,55%,50%,58%,140,49,201,30%,9%,36%,0,0,0,4,2,2
433,https://vlr.gg/player/16012/akira,2024-09-25 11:00:00,1.43,0.59,0.92,181,336,78,12,10,2,15,7,8,6,1,5,+1,+1,0,75%,75%,75%,122,209,64,30%,29%,33%,2,1,1,1,0,1
434,https://vlr.gg/player/10448/kozok,2024-09-25 11:00:00,0.93,0.84,0.88,140,201,100,9,5,4,13,7,6,11,6,5,-1,0,-1,75%,88%,67%,80,119,54,14%,12%,17%,1,0,1,2,0,2
435,https://vlr.gg/player/33517/tripsy,2024-09-25 11:00:00,0.27,0.40,0.35,103,90,112,7,2,5,17,7,10,2,2,0,-5,-2,-3,55%,50%,58%,63,59,66,24%,22%,25%,0,0,0,5,2,3
436,https://vlr.gg/player/22188/jimbk,2024-09-25 11:00:00,1.28,2.35,1.71,288,198,424,20,8,12,8,5,3,9,5,4,+3,+1,+2,90%,92%,88%,197,136,289,41%,63%,29%,3,1,2,0,0,0
437,https://vlr.gg/player/22291/razziss,2024-09-25 11:00:00,1.69,1.23,1.50,348,416,249,24,17,7,14,9,5,7,2,5,+4,+5,-1,85%,83%,88%,213,241,170,31%,30%,32%,6,6,0,2,1,1
438,https://vlr.gg/player/16139/enrik,2024-09-25 11:00:00,0.96,0.76,0.88,155,179,122,11,8,3,13,8,5,9,6,3,+1,+1,0,85%,100%,63%,126,139,106,46%,53%,33%,2,1,1,1,0,1
439,https://vlr.gg/player/33513/sihw,2024-09-25 11:00:00,0.31,1.52,0.80,149,82,251,12,3,9,14,9,5,5,4,1,-1,-3,+2,75%,67%,88%,114,69,181,46%,20%,77%,2,0,2,3,3,0
440,https://vlr.gg/player/45143/francybald,2024-09-25 11:00:00,0.76,0.72,0.74,112,104,125,9,5,4,12,6,6,4,1,3,-1,0,-1,65%,67%,63%,91,93,89,52%,40%,75%,0,0,0,1,0,1
441,https://vlr.gg/player/17523/yue,2024-09-25 07:00:00,,,,301,,,35,,,26,,,9,,,,,,,,,,,,,,,,,,,,
442,https://vlr.gg/player/41210/yc33,2024-09-25 07:00:00,,,,248,,,32,,,15,,,22,,,,,,,,,,,,,,,,,,,,
443,https://vlr.gg/player/48139/amei,2024-09-25 07:00:00,,,,234,,,32,,,19,,,8,,,,,,,,,,,,,,,,,,,,
444,https://vlr.gg/player/41209/jacketzz,2024-09-25 07:00:00,,,,185,,,23,,,19,,,8,,,,,,,,,,,,,,,,,,,,
445,https://vlr.gg/player/48140/yzy,2024-09-25 07:00:00,,,,165,,,18,,,18,,,16,,,,,,,,,,,,,,,,,,,,
446,https://vlr.gg/player/8129/chloettw,2024-09-25 07:00:00,,,,199,,,24,,,28,,,4,,,,,,,,,,,,,,,,,,,,
447,https://vlr.gg/player/48144/huanki,2024-09-25 07:00:00,,,,178,,,23,,,26,,,13,,,,,,,,,,,,,,,,,,,,
448,https://vlr.gg/player/48141/seaweed,2024-09-25 07:00:00,,,,147,,,19,,,28,,,9,,,,,,,,,,,,,,,,,,,,
449,https://vlr.gg/player/48143/candice,2024-09-25 07:00:00,,,,145,,,20,,,28,,,11,,,,,,,,,,,,,,,,,,,,
450,https://vlr.gg/player/48145/q1ngy,2024-09-25 07:00:00,,,,105,,,11,,,30,,,5,,,,,,,,,,,,,,,,,,,,
451,https://vlr.gg/player/41175/m77,2024-09-25 05:00:00,,,,374,,,36,,,12,,,9,,,,,,,,,,,,,,,,,,,,
452,https://vlr.gg/player/30321/pochacco,2024-09-25 05:00:00,,,,360,,,35,,,9,,,15,,,,,,,,,,,,,,,,,,,,
453,https://vlr.gg/player/41173/jianbao,2024-09-25 05:00:00,,,,216,,,23,,,5,,,15,,,,,,,,,,,,,,,,,,,,
454,https://vlr.gg/player/41171/qbb,2024-09-25 05:00:00,,,,187,,,18,,,9,,,11,,,,,,,,,,,,,,,,,,,,
455,https://vlr.gg/player/48138/end3,2024-09-25 05:00:00,,,,170,,,14,,,12,,,12,,,,,,,,,,,,,,,,,,,,
456,https://vlr.gg/player/48137/nvmow,2024-09-25 05:00:00,,,,155,,,10,,,25,,,8,,,,,,,,,,,,,,,,,,,,
457,https://vlr.gg/player/48134/aqi,2024-09-25 05:00:00,,,,154,,,13,,,26,,,4,,,,,,,,,,,,,,,,,,,,
458,https://vlr.gg/player/48135/ann,2024-09-25 05:00:00,,,,113,,,7,,,25,,,2,,,,,,,,,,,,,,,,,,,,
459,https://vlr.gg/player/48136/coco,2024-09-25 05:00:00,,,,109,,,10,,,26,,,9,,,,,,,,,,,,,,,,,,,,
460,https://vlr.gg/player/48133/cream,2024-09-25 05:00:00,,,,84,,,6,,,24,,,5,,,,,,,,,,,,,,,,,,,,
461,https://vlr.gg/player/20675/flossie,2024-09-24 18:00:00,1.15,0.88,1.02,219,242,204,41,21,20,47,22,25,17,9,8,0,0,0,75%,79%,71%,153,168,138,18%,13%,30%,6,2,4,6,2,4
462,https://vlr.gg/player/37115/lendary,2024-09-24 18:00:00,0.86,0.76,0.81,208,220,200,40,21,19,48,24,24,10,7,3,-5,-3,-2,65%,76%,54%,133,140,124,33%,33%,33%,6,3,3,11,6,5
463,https://vlr.gg/player/19256/frantastic,2024-09-24 18:00:00,0.94,0.65,0.80,173,217,138,35,22,13,49,26,23,20,12,8,-8,-3,-5,68%,76%,61%,112,129,94,20%,19%,22%,1,1,0,9,4,5
464,https://vlr.gg/player/21091/azul,2024-09-24 18:00:00,0.78,0.70,0.74,171,168,165,31,17,14,48,24,24,16,10,6,-1,-2,+1,63%,69%,57%,114,116,113,30%,26%,36%,6,3,3,7,5,2
465,https://vlr.gg/player/25356/reshi,2024-09-24 18:00:00,0.68,0.69,0.69,130,141,123,24,12,12,43,22,21,23,14,9,-3,-1,-2,54%,59%,50%,86,92,80,22%,20%,25%,1,1,0,4,2,2
466,https://vlr.gg/player/35660/tok1o,2024-09-24 18:00:00,1.73,1.85,1.79,323,293,355,67,30,37,28,12,16,25,11,14,+3,+1,+2,88%,93%,83%,216,197,233,20%,20%,20%,4,1,3,1,0,1
467,https://vlr.gg/player/35018/allie,2024-09-24 18:00:00,1.54,1.09,1.31,241,292,192,51,31,20,33,15,18,22,10,12,+9,+6,+3,82%,86%,79%,150,179,123,28%,32%,25%,12,7,5,3,1,2
468,https://vlr.gg/player/40135/nati,2024-09-24 18:00:00,1.46,1.03,1.24,197,215,183,44,24,20,31,12,19,17,7,10,0,0,0,82%,89%,76%,135,151,119,49%,53%,45%,1,1,0,1,1,0
469,https://vlr.gg/player/35869/meleliita,2024-09-24 18:00:00,0.85,0.98,0.91,213,195,230,42,19,23,42,22,20,14,7,7,+4,+2,+2,79%,79%,79%,145,133,157,22%,23%,21%,15,6,9,11,4,7
470,https://vlr.gg/player/40657/ataraxia,2024-09-24 18:00:00,0.72,0.82,0.75,140,125,155,30,13,17,37,17,20,10,5,5,+1,-1,+2,63%,57%,69%,92,83,100,28%,34%,24%,5,3,2,4,4,0
471,https://vlr.gg/player/19362/lyda,2024-09-24 13:00:00,1.45,1.29,1.38,255,264,220,43,26,17,28,15,13,11,7,4,+6,+1,+5,76%,73%,80%,163,195,121,34%,41%,23%,9,4,5,3,3,0
472,https://vlr.gg/player/37990/adora,2024-09-24 13:00:00,1.02,1.55,1.25,246,241,262,41,21,20,30,19,11,13,3,10,0,+1,-1,70%,58%,85%,169,167,171,30%,30%,30%,8,6,2,8,5,3
473,https://vlr.gg/player/30107/fluxxy,2024-09-24 13:00:00,1.06,1.43,1.22,209,189,236,36,18,18,26,14,12,12,2,10,+2,+1,+1,87%,85%,90%,142,127,162,34%,37%,31%,3,2,1,1,1,0
474,https://vlr.gg/player/9431/cille,2024-09-24 13:00:00,0.76,1.26,0.98,187,152,237,30,12,18,30,17,13,15,10,5,+1,-2,+3,76%,69%,85%,119,100,145,32%,23%,41%,4,0,4,3,2,1
475,https://vlr.gg/player/24140/superphrog,2024-09-24 13:00:00,0.86,0.93,0.89,201,163,232,32,16,16,33,18,15,10,6,4,+1,+1,0,74%,69%,80%,141,119,170,26%,39%,20%,4,2,2,3,1,2
476,https://vlr.gg/player/16321/nelo,2024-09-24 13:00:00,1.26,0.81,1.00,182,250,165,32,19,13,35,16,19,22,8,14,0,0,0,61%,55%,65%,128,152,110,45%,63%,32%,3,2,1,3,2,1
477,https://vlr.gg/player/21153/matrix,2024-09-24 13:00:00,0.55,1.13,0.88,229,202,237,36,14,22,40,19,21,4,1,3,-4,-3,-1,54%,50%,58%,140,114,159,40%,31%,47%,6,3,3,10,6,4
478,https://vlr.gg/player/11183/glance,2024-09-24 13:00:00,0.75,0.89,0.83,161,178,143,25,13,12,34,17,17,10,5,5,+1,0,+1,59%,65%,54%,106,112,102,21%,14%,29%,3,1,2,2,1,1
479,https://vlr.gg/player/19356/kuripuuya,2024-09-24 13:00:00,0.56,1.00,0.81,158,137,176,26,10,16,35,18,17,17,6,11,-7,-3,-4,67%,75%,62%,113,95,126,33%,41%,29%,1,0,1,8,3,5
480,https://vlr.gg/player/16419/roxi,2024-09-24 13:00:00,0.40,1.01,0.75,205,157,224,28,8,20,38,19,19,4,4,0,0,-2,+2,63%,65%,62%,129,112,142,31%,21%,40%,5,0,5,5,2,3
0,https://vlr.gg/player/20064/vania,2024-09-24 11:00:00,1.90,1.64,1.74,254,240,248,34,11,23,14,4,10,22,12,10,+2,+1,+1,87%,86%,88%,154,148,157,40%,29%,48%,3,1,2,1,0,1
1,https://vlr.gg/player/24149/amy,2024-09-24 11:00:00,1.20,1.87,1.63,294,208,351,43,11,32,18,7,11,9,4,5,-1,-1,0,84%,79%,88%,198,152,225,42%,26%,51%,2,0,2,3,1,2
2,https://vlr.gg/player/36175/rezq,2024-09-24 11:00:00,1.18,1.39,1.31,308,339,296,42,17,25,26,12,14,7,1,6,+8,+6,+2,82%,79%,83%,194,201,191,24%,33%,19%,14,8,6,6,2,4
3,https://vlr.gg/player/17323/mimi,2024-09-24 11:00:00,1.38,0.85,1.04,143,204,106,18,11,7,16,6,10,15,5,10,+1,0,+1,82%,93%,75%,95,139,70,31%,39%,22%,2,0,2,1,0,1
4,https://vlr.gg/player/17320/petra,2024-09-24 11:00:00,0.69,1.00,0.88,181,119,211,25,8,17,24,9,15,8,1,7,-2,0,-2,66%,64%,67%,129,89,152,19%,20%,18%,2,1,1,4,1,3
5,https://vlr.gg/player/24071/liza,2024-09-24 11:00:00,1.29,0.93,1.16,283,322,228,37,27,10,33,22,11,8,4,4,+1,+5,-4,66%,67%,64%,184,201,156,37%,40%,30%,8,7,1,7,2,5
6,https://vlr.gg/player/20098/mel,2024-09-24 11:00:00,0.39,1.07,0.64,137,88,220,17,5,12,34,22,12,11,10,1,0,-1,+1,61%,50%,79%,98,67,151,33%,21%,46%,1,0,1,1,1,0
7,https://vlr.gg/player/38142/dream,2024-09-24 11:00:00,0.52,0.80,0.62,137,116,171,16,8,8,32,20,12,8,4,4,-5,-3,-2,45%,42%,50%,94,79,119,17%,9%,26%,0,0,0,5,3,2
8,https://vlr.gg/player/22792/jiex,2024-09-24 11:00:00,0.57,0.61,0.58,145,141,140,16,12,4,32,21,11,14,8,6,-2,-1,-1,68%,63%,79%,94,86,109,38%,38%,36%,4,3,1,6,4,2
9,https://vlr.gg/player/17394/ninou,2024-09-24 11:00:00,0.68,0.39,0.57,112,123,85,12,8,4,31,19,12,11,8,3,-2,-2,0,63%,58%,71%,87,104,56,17%,19%,12%,2,1,1,4,3,1
10,https://vlr.gg/player/10739/shiro,2024-09-24 01:50:00,0.88,1.37,1.14,226,191,266,55,20,35,54,29,25,37,14,23,-1,-4,+3,76%,73%,79%,152,126,175,21%,19%,23%,7,2,5,8,6,2
11,https://vlr.gg/player/2380/zesbeew,2024-09-24 01:50:00,0.64,1.48,1.09,193,148,235,51,17,34,48,28,20,34,11,23,+1,-2,+3,77%,67%,87%,123,97,145,21%,24%,19%,5,0,5,4,2,2
12,https://vlr.gg/player/4874/berserx,2024-09-24 01:50:00,1.00,1.10,1.05,191,230,172,48,25,23,47,27,20,12,5,7,-1,-2,+1,70%,64%,76%,133,147,121,25%,28%,21%,3,1,2,4,3,1
13,https://vlr.gg/player/7043/ncslasher,2024-09-24 01:50:00,0.71,1.19,0.97,190,173,212,50,20,30,50,28,22,27,12,15,0,-2,+2,77%,70%,84%,119,100,136,29%,29%,29%,7,3,4,7,5,2
14,https://vlr.gg/player/2348/famouz,2024-09-24 01:50:00,0.76,0.93,0.85,219,186,239,48,20,28,60,29,31,13,4,9,0,-3,+3,73%,73%,74%,145,123,165,20%,20%,20%,13,4,9,13,7,6
15,https://vlr.gg/player/7426/juicy,2024-09-24 01:50:00,1.05,1.51,1.26,262,231,283,64,31,33,46,29,17,21,8,13,+3,-1,+4,79%,71%,88%,168,153,186,20%,18%,21%,11,5,6,8,6,2
16,https://vlr.gg/player/34032/grumble,2024-09-24 01:50:00,0.71,1.53,1.09,211,156,283,57,22,35,50,29,21,23,3,20,+1,-2,+3,77%,66%,91%,153,112,200,38%,41%,35%,7,2,5,6,4,2
17,https://vlr.gg/player/24628/wayne,2024-09-24 01:50:00,0.87,1.06,0.96,227,187,260,52,22,30,57,32,25,36,18,18,+1,0,+1,80%,74%,88%,145,128,165,26%,17%,35%,5,2,3,4,2,2
18,https://vlr.gg/player/11704/styron,2024-09-24 01:50:00,0.88,0.89,0.89,148,147,150,39,21,18,47,27,20,13,5,8,-2,-5,+3,63%,53%,76%,94,92,97,19%,18%,20%,4,1,3,6,6,0
19,https://vlr.gg/player/24653/vera,2024-09-24 01:50:00,0.66,1.12,0.88,195,190,198,47,22,25,52,33,19,19,11,8,-2,-4,+2,66%,55%,79%,129,129,129,18%,20%,15%,9,3,6,11,7,4
20,https://vlr.gg/player/31589/murza,2024-09-24 00:00:00,1.05,0.95,0.98,227,239,205,27,12,15,28,11,17,11,4,7,+1,+1,0,69%,71%,68%,142,147,139,19%,19%,19%,2,1,1,1,0,1
21,https://vlr.gg/player/31593/kiss,2024-09-24 00:00:00,1.06,0.78,0.89,178,234,161,25,12,13,30,11,19,10,5,5,+2,0,+2,72%,86%,64%,117,140,102,29%,22%,37%,5,1,4,3,1,2
22,https://vlr.gg/player/26310/ikana,2024-09-24 00:00:00,0.63,1.03,0.86,154,108,191,19,5,14,27,10,17,11,2,9,-2,-2,0,50%,36%,59%,110,82,128,28%,40%,25%,1,0,1,3,2,1
23,https://vlr.gg/player/10089/andy,2024-09-24 00:00:00,0.63,0.69,0.66,166,192,186,21,7,14,32,13,19,8,6,2,-3,-1,-2,56%,57%,55%,120,130,114,24%,30%,19%,7,4,3,10,5,5
24,https://vlr.gg/player/26316/ramen,2024-09-24 00:00:00,0.42,0.71,0.59,132,74,154,16,4,12,28,11,17,2,0,2,0,0,0,67%,64%,68%,85,57,103,43%,38%,44%,2,0,2,2,0,2
25,https://vlr.gg/player/43064/aace,2024-09-24 00:00:00,1.13,1.63,1.33,224,216,232,32,17,15,20,14,6,14,8,6,-2,0,-2,67%,59%,79%,147,149,143,41%,40%,42%,1,1,0,3,1,2
26,https://vlr.gg/player/29843/yatsuka,2024-09-24 00:00:00,1.22,1.42,1.30,209,192,240,29,17,12,18,11,7,5,2,3,-2,-1,-1,69%,68%,71%,139,118,172,39%,52%,31%,2,1,1,4,2,2
27,https://vlr.gg/player/10584/seoldam,2024-09-24 00:00:00,1.10,1.43,1.23,263,266,233,33,21,12,22,16,6,8,4,4,+4,+1,+3,75%,73%,79%,156,163,145,19%,21%,13%,10,7,3,6,6,0
28,https://vlr.gg/player/4663/joxjo,2024-09-24 00:00:00,1.27,0.89,1.12,221,222,195,25,17,8,22,12,10,14,8,6,0,-1,+1,75%,77%,71%,154,158,148,29%,33%,23%,3,1,2,3,2,1
29,https://vlr.gg/player/29841/caedye,2024-09-24 00:00:00,1.12,0.88,1.03,228,235,200,26,17,9,26,15,11,17,12,5,+2,+1,+1,75%,77%,71%,139,145,128,27%,24%,31%,3,1,2,1,0,1
30,https://vlr.gg/player/35547/raquinuki,2024-09-23 18:00:00,1.10,0.98,1.03,208,210,208,57,26,31,60,25,35,17,6,11,+1,+1,0,69%,76%,63%,140,141,140,31%,32%,30%,6,2,4,5,1,4
31,https://vlr.gg/player/35927/dano,2024-09-23 18:00:00,1.14,0.91,1.01,193,232,169,55,28,27,60,26,34,27,13,14,+1,+1,0,65%,74%,59%,132,156,113,31%,23%,41%,6,3,3,5,2,3
32,https://vlr.gg/player/29223/tura,2024-09-23 18:00:00,1.12,0.71,0.89,188,249,149,54,32,22,65,28,37,31,17,14,-1,0,-1,65%,71%,61%,121,154,96,27%,31%,24%,10,5,5,11,5,6
33,https://vlr.gg/player/44481/melsm,2024-09-23 18:00:00,0.97,0.64,0.78,172,197,146,47,24,23,64,28,36,18,9,9,-3,-1,-2,66%,76%,59%,113,143,91,22%,29%,15%,2,1,1,5,2,3
34,https://vlr.gg/player/40338/natas,2024-09-23 18:00:00,0.23,0.89,0.60,148,80,203,42,9,33,66,28,38,14,5,9,-14,-9,-5,59%,50%,65%,100,62,127,25%,25%,24%,8,2,6,22,11,11
35,https://vlr.gg/player/12055/mmonch,2024-09-23 18:00:00,1.50,1.16,1.36,275,303,215,75,48,27,48,28,20,20,11,9,+8,+7,+1,79%,83%,74%,171,194,140,33%,37%,26%,11,9,2,3,2,1
36,https://vlr.gg/player/20491/ivy,2024-09-23 18:00:00,1.08,1.48,1.24,221,176,297,66,32,34,50,25,25,34,13,21,+1,-3,+4,81%,78%,85%,150,118,193,41%,37%,43%,6,0,6,5,3,2
37,https://vlr.gg/player/20539/juw,2024-09-23 18:00:00,1.29,1.18,1.24,264,255,263,73,43,30,54,29,25,18,10,8,+3,0,+3,79%,80%,76%,169,166,173,31%,33%,30%,15,9,6,12,9,3
38,https://vlr.gg/player/20538/linlin,2024-09-23 18:00:00,1.06,1.04,1.05,182,177,187,53,29,24,51,28,23,27,17,10,-1,+2,-3,80%,85%,74%,131,122,143,34%,36%,31%,5,4,1,6,2,4
39,https://vlr.gg/player/20537/andrehs,2024-09-23 18:00:00,0.93,0.83,0.88,166,161,184,47,27,20,52,27,25,20,11,9,+5,+2,+3,71%,74%,68%,115,109,123,31%,37%,26%,11,5,6,6,3,3
40,https://vlr.gg/player/20761/looxie,2024-09-23 13:15:00,1.33,1.43,1.38,286,262,311,48,22,26,33,16,17,15,8,7,-1,-1,0,77%,75%,79%,178,160,196,36%,38%,35%,4,1,3,5,2,3
41,https://vlr.gg/player/21158/marti,2024-09-23 13:15:00,0.61,1.61,1.11,219,162,277,37,13,24,31,19,12,4,1,3,-1,-6,+5,67%,58%,75%,138,102,175,29%,31%,27%,11,4,7,12,10,2
42,https://vlr.gg/player/24058/tokameite,2024-09-23 13:15:00,0.98,1.11,1.05,190,184,196,33,16,17,31,17,14,20,6,14,-4,0,-4,69%,71%,67%,132,124,140,26%,25%,27%,0,0,0,4,0,4
43,https://vlr.gg/player/30186/nami,2024-09-23 13:15:00,0.72,0.96,0.84,159,133,185,26,10,16,36,18,18,17,9,8,+1,-1,+2,71%,67%,75%,103,99,107,32%,30%,35%,2,0,2,1,1,0
44,https://vlr.gg/player/39057/safiaa,2024-09-23 13:15:00,0.68,0.84,0.76,164,171,158,27,13,14,36,20,16,11,4,7,+1,0,+1,71%,67%,75%,118,122,115,28%,29%,28%,5,3,2,4,3,1
45,https://vlr.gg/player/26632/joliinaa,2024-09-23 13:15:00,1.20,1.02,1.11,227,260,194,36,19,17,34,19,15,26,18,8,+5,+2,+3,83%,88%,79%,153,170,135,30%,30%,29%,6,3,3,1,1,0
46,https://vlr.gg/player/24107/sarah,2024-09-23 13:15:00,0.91,1.18,1.05,197,178,217,31,14,17,34,18,16,26,14,12,-1,-2,+1,81%,75%,88%,134,123,145,25%,29%,22%,2,0,2,3,2,1
47,https://vlr.gg/player/16418/smurfette,2024-09-23 13:15:00,0.99,0.99,0.99,203,221,186,36,19,17,35,19,16,8,3,5,-2,-2,0,71%,67%,75%,137,144,130,34%,38%,30%,5,2,3,7,4,3
48,https://vlr.gg/player/17343/ness,2024-09-23 13:15:00,0.57,1.35,0.96,182,150,214,28,11,17,32,21,11,10,4,6,+1,-2,+3,60%,46%,75%,125,112,138,32%,35%,29%,3,0,3,2,2,0
49,https://vlr.gg/player/24101/miyori,2024-09-23 13:15:00,0.65,1.25,0.95,204,160,249,36,14,22,36,20,16,7,2,5,+1,0,+1,60%,50%,71%,140,104,175,29%,34%,27%,10,5,5,9,5,4
50,https://vlr.gg/player/29900/sandra,2024-09-23 11:00:00,0.89,1.60,1.25,227,163,291,39,14,25,27,15,12,10,4,6,0,-1,+1,73%,68%,77%,154,106,203,52%,57%,50%,3,1,2,3,2,1
51,https://vlr.gg/player/19371/eva,2024-09-23 11:00:00,0.79,1.48,1.13,188,156,221,28,11,17,26,17,9,21,10,11,0,-1,+1,84%,77%,91%,120,96,144,22%,15%,29%,1,0,1,1,1,0
52,https://vlr.gg/player/17333/mary,2024-09-23 11:00:00,0.81,1.35,1.08,216,176,255,35,14,21,30,17,13,8,3,5,+2,+1,+1,75%,68%,82%,134,106,162,25%,34%,20%,8,4,4,6,3,3
53,https://vlr.gg/player/29903/madv,2024-09-23 11:00:00,0.95,0.97,0.96,169,185,152,27,13,14,29,17,12,9,5,4,+2,0,+2,73%,64%,82%,111,120,102,38%,33%,44%,7,3,4,5,3,2
54,https://vlr.gg/player/20055/toki,2024-09-23 11:00:00,0.67,1.04,0.86,170,146,194,26,11,15,30,17,13,11,5,6,+2,-1,+3,66%,59%,73%,113,100,126,32%,30%,33%,6,2,4,4,3,1
55,https://vlr.gg/player/16196/annie,2024-09-23 11:00:00,0.85,1.28,1.07,213,212,214,33,16,17,29,18,11,4,1,3,+7,+3,+4,77%,73%,82%,142,140,145,38%,44%,32%,11,5,6,4,2,2
56,https://vlr.gg/player/20058/devilasxa,2024-09-23 11:00:00,0.74,1.21,0.97,184,164,204,30,13,17,30,18,12,6,3,3,-7,-4,-3,61%,55%,68%,126,113,138,44%,46%,43%,1,0,1,8,4,4
57,https://vlr.gg/player/7460/6sonya,2024-09-23 11:00:00,0.84,0.94,0.89,156,146,166,25,12,13,29,17,12,8,4,4,0,+1,-1,68%,64%,73%,99,98,100,32%,35%,29%,3,1,2,3,0,3
58,https://vlr.gg/player/39506/cabbit,2024-09-23 11:00:00,0.49,1.27,0.88,189,144,235,26,9,17,34,20,14,18,9,9,-4,-5,+1,73%,68%,77%,122,92,151,30%,28%,31%,2,0,2,6,5,1
59,https://vlr.gg/player/20116/jademwah,2024-09-23 11:00:00,0.53,1.22,0.88,190,133,248,28,9,19,33,19,14,23,6,17,-2,-3,+1,73%,68%,77%,129,87,171,26%,22%,28%,2,1,1,4,4,0
60,https://vlr.gg/player/34032/grumble,2024-09-23 06:10:00,1.38,1.49,1.43,291,279,283,69,35,34,39,21,18,19,6,13,+4,+3,+1,84%,84%,84%,191,176,205,36%,39%,33%,5,3,2,1,0,1
61,https://vlr.gg/player/24628/wayne,2024-09-23 06:10:00,1.09,1.22,1.16,212,187,242,46,21,25,42,20,22,34,17,17,+6,+1,+5,81%,84%,78%,133,113,152,24%,21%,27%,9,2,7,3,1,2
62,https://vlr.gg/player/24653/vera,2024-09-23 06:10:00,1.00,1.27,1.13,253,248,269,57,26,31,50,27,23,19,12,7,+9,+4,+5,84%,78%,91%,166,160,172,18%,16%,21%,17,9,8,8,5,3
63,https://vlr.gg/player/11704/styron,2024-09-23 06:10:00,0.84,1.18,1.01,165,114,206,40,15,25,34,17,17,12,5,7,0,-2,+2,83%,81%,84%,112,72,153,25%,18%,28%,3,0,3,3,2,1
64,https://vlr.gg/player/7426/juicy,2024-09-23 06:10:00,0.81,1.10,0.95,164,153,177,36,17,19,37,22,15,19,5,14,+1,0,+1,80%,78%,81%,127,113,141,23%,29%,19%,8,5,3,7,5,2
65,https://vlr.gg/player/6913/sultan,2024-09-23 06:10:00,1.03,1.14,1.09,215,221,221,50,26,24,46,25,21,15,7,8,-3,-2,-1,72%,63%,81%,143,137,150,45%,44%,45%,7,4,3,10,6,4
66,https://vlr.gg/player/16215/dos9,2024-09-23 06:10:00,0.74,1.01,0.88,187,172,215,42,17,25,51,27,24,14,11,3,-4,-3,-1,73%,63%,84%,125,112,137,25%,22%,27%,3,1,2,7,4,3
67,https://vlr.gg/player/10463/paradox,2024-09-23 06:10:00,1.12,0.44,0.78,166,225,118,39,27,12,51,25,26,10,3,7,-7,-4,-3,61%,59%,63%,108,138,78,29%,38%,20%,5,2,3,12,6,6
68,https://vlr.gg/player/4095/skrossi,2024-09-23 06:10:00,0.43,1.18,0.77,163,120,198,37,13,24,50,29,21,10,4,6,-7,-6,-1,56%,41%,72%,104,73,135,21%,18%,23%,1,0,1,8,6,2
69,https://vlr.gg/player/3630/skillz,2024-09-23 06:10:00,0.46,1.00,0.73,159,124,202,34,13,21,51,28,23,21,13,8,+1,+1,0,66%,63%,69%,100,76,124,23%,13%,29%,6,2,4,5,1,4
70,https://vlr.gg/player/29843/yatsuka,2024-09-23 02:25:00,1.02,1.19,1.10,231,220,236,60,25,35,47,19,28,15,4,11,+5,-1,+6,76%,78%,75%,130,111,153,29%,29%,29%,7,1,6,2,2,0
71,https://vlr.gg/player/29841/caedye,2024-09-23 02:25:00,0.86,1.32,1.06,279,250,299,67,26,41,60,28,32,20,12,8,+8,+1,+7,81%,75%,88%,153,118,196,34%,39%,31%,15,6,9,7,5,2
72,https://vlr.gg/player/4663/joxjo,2024-09-23 02:25:00,1.10,0.79,0.96,186,204,139,46,25,21,50,19,31,23,4,19,0,0,0,76%,78%,75%,104,111,96,25%,26%,23%,3,2,1,3,2,1
73,https://vlr.gg/player/43064/aace,2024-09-23 02:25:00,0.82,1.00,0.90,183,169,207,48,18,30,54,24,30,28,11,17,-4,-2,-2,74%,78%,69%,112,90,138,31%,29%,33%,2,1,1,6,3,3
74,https://vlr.gg/player/10584/seoldam,2024-09-23 02:25:00,0.76,0.91,0.82,204,189,195,44,21,23,58,26,32,13,8,5,0,+1,-1,67%,70%,63%,119,108,133,25%,35%,18%,9,5,4,9,4,5
75,https://vlr.gg/player/13219/papi,2024-09-23 02:25:00,1.27,1.31,1.29,236,248,251,64,29,35,49,22,27,31,17,14,+2,+2,0,82%,81%,83%,153,159,148,29%,36%,24%,5,3,2,3,1,2
76,https://vlr.gg/player/13220/ja,2024-09-23 02:25:00,0.83,1.26,1.07,227,185,261,59,22,37,56,25,31,14,7,7,+4,+1,+3,85%,78%,90%,150,138,160,33%,25%,39%,9,3,6,5,2,3
77,https://vlr.gg/player/9747/emman,2024-09-23 02:25:00,1.07,0.96,1.01,227,228,219,54,24,30,50,23,27,23,13,10,-4,-3,-1,78%,66%,88%,127,165,96,30%,33%,27%,3,1,2,7,4,3
78,https://vlr.gg/player/16842/mojer,2024-09-23 02:25:00,0.90,0.79,0.84,226,213,235,55,23,32,54,26,28,18,10,8,-6,-5,-1,71%,59%,80%,118,137,102,26%,23%,30%,7,3,4,13,8,5
79,https://vlr.gg/player/7749/nexi,2024-09-23 02:25:00,0.79,0.58,0.67,138,181,121,37,20,17,56,25,31,17,9,8,-5,-5,0,72%,69%,75%,83,111,60,27%,27%,27%,3,1,2,8,6,2
80,https://vlr.gg/player/6723/foxz,2024-09-23 00:00:00,1.17,1.51,1.34,231,200,263,36,18,18,24,12,12,17,4,13,+3,0,+3,79%,73%,86%,152,129,175,28%,18%,38%,3,0,3,0,0,0
81,https://vlr.gg/player/3401/ptc,2024-09-23 00:00:00,0.95,1.42,1.18,259,218,303,39,14,25,29,16,13,21,10,11,0,-2,+2,70%,64%,76%,162,153,171,25%,29%,22%,5,2,3,5,4,1
82,https://vlr.gg/player/3342/sushiboys,2024-09-23 00:00:00,0.99,1.21,1.10,240,237,245,35,18,17,32,18,14,15,6,9,+2,+1,+1,79%,73%,86%,172,156,188,24%,15%,31%,4,2,2,2,1,1
83,https://vlr.gg/player/27254/leviathan,2024-09-23 00:00:00,0.68,1.04,0.85,162,151,173,24,10,14,32,17,15,28,10,18,-1,0,-1,74%,73%,76%,107,110,105,24%,23%,24%,1,0,1,2,0,2
84,https://vlr.gg/player/4377/johnolsen,2024-09-23 00:00:00,0.57,1.03,0.80,200,169,234,31,13,18,34,19,15,12,1,11,+1,-3,+4,65%,50%,81%,137,110,164,26%,32%,20%,11,5,6,10,8,2
85,https://vlr.gg/player/26310/ikana,2024-09-23 00:00:00,0.71,1.73,1.23,244,134,346,36,9,27,30,18,12,17,9,8,0,-2,+2,72%,52%,91%,166,98,231,22%,21%,22%,3,0,3,3,2,1
86,https://vlr.gg/player/10089/andy,2024-09-23 00:00:00,1.00,1.16,1.08,219,237,203,35,18,17,35,20,15,7,3,4,-2,-4,+2,77%,76%,77%,139,143,137,15%,10%,25%,7,2,5,9,6,3
87,https://vlr.gg/player/31593/kiss,2024-09-23 00:00:00,0.99,1.03,1.02,239,254,229,17,7,10,18,9,9,8,5,3,+1,+1,0,76%,89%,67%,151,154,150,44%,37%,50%,3,2,1,2,1,1
88,https://vlr.gg/player/31589/murza,2024-09-23 00:00:00,0.92,0.89,0.90,165,191,144,25,14,11,30,17,13,9,5,4,-6,-3,-3,70%,71%,68%,127,150,106,25%,29%,21%,0,0,0,6,3,3
89,https://vlr.gg/player/26316/ramen,2024-09-23 00:00:00,0.83,0.90,0.86,177,188,167,25,13,12,33,18,15,10,5,5,+3,+1,+2,74%,71%,77%,116,118,114,18%,22%,14%,4,1,3,1,0,1
90,https://vlr.gg/player/46993/long,2024-09-23 00:00:00,0.84,0.83,0.83,193,202,184,13,8,5,19,10,9,13,5,8,-1,-2,+1,68%,67%,70%,119,119,119,12%,17%,9%,2,1,1,3,3,0
91,https://vlr.gg/player/11259/conir,2024-09-22 18:00:00,1.32,1.50,1.42,267,270,256,92,39,53,56,30,26,44,21,23,+4,-1,+5,85%,77%,91%,167,178,158,30%,29%,31%,11,4,7,7,5,2
92,https://vlr.gg/player/25663/dods,2024-09-22 18:00:00,0.87,1.58,1.27,275,210,319,101,33,68,69,34,35,10,2,8,+8,+3,+5,74%,67%,80%,174,132,207,37%,27%,42%,23,12,11,15,9,6
93,https://vlr.gg/player/21558/micaela,2024-09-22 18:00:00,1.11,1.23,1.18,191,197,191,73,34,39,55,28,27,34,17,17,-3,-3,0,80%,74%,84%,126,126,126,31%,32%,30%,4,1,3,7,4,3
94,https://vlr.gg/player/18982/romily,2024-09-22 18:00:00,0.82,1.05,0.95,169,129,196,60,21,39,60,27,33,21,6,15,+1,-3,+4,70%,60%,78%,115,92,133,30%,27%,31%,7,1,6,6,4,2
95,https://vlr.gg/player/11235/biazik,2024-09-22 18:00:00,0.97,0.91,0.94,176,177,171,58,28,30,61,29,32,29,13,16,+4,+1,+3,71%,70%,73%,124,116,131,28%,32%,25%,11,2,9,7,1,6
96,https://vlr.gg/player/21108/ponix,2024-09-22 18:00:00,1.03,1.31,1.16,217,193,252,75,36,39,72,43,29,29,15,14,0,+1,-1,67%,62%,74%,142,132,155,27%,34%,22%,6,3,3,6,2,4
97,https://vlr.gg/player/42378/nicky,2024-09-22 18:00:00,0.92,0.94,0.93,185,198,187,65,38,27,76,45,31,27,13,14,0,-3,+3,62%,64%,60%,127,138,112,34%,45%,24%,9,1,8,9,4,5
98,https://vlr.gg/player/33177/none,2024-09-22 18:00:00,0.66,1.24,0.91,211,197,248,69,31,38,81,50,31,19,11,8,-2,-3,+1,66%,56%,79%,151,135,171,21%,25%,18%,16,8,8,18,11,7
99,https://vlr.gg/player/24770/babzzz,2024-09-22 18:00:00,0.67,0.87,0.76,175,158,200,61,30,31,77,45,32,7,4,3,-9,-9,0,57%,47%,70%,111,100,126,23%,21%,26%,6,4,2,15,13,2
100,https://vlr.gg/player/21548/adenina,2024-09-22 18:00:00,0.38,0.52,0.44,96,91,110,31,18,13,78,46,32,22,6,16,-3,-3,0,54%,45%,65%,70,61,81,23%,28%,19%,5,3,2,8,6,2
101,https://vlr.gg/player/4122/persia,2024-09-22 04:05:00,1.44,1.37,1.41,243,240,250,34,24,10,21,12,9,20,10,10,0,+1,-1,76%,79%,71%,167,161,178,37%,33%,44%,2,2,0,2,1,1
102,https://vlr.gg/player/33576/margaret,2024-09-22 04:05:00,1.28,1.05,1.20,216,209,239,31,19,12,23,12,11,5,4,1,0,-1,+1,63%,63%,64%,147,141,157,30%,30%,30%,5,2,3,5,3,2
103,https://vlr.gg/player/31829/ivy,2024-09-22 04:05:00,1.18,1.15,1.17,220,219,199,28,18,10,23,13,10,14,9,5,+2,0,+2,87%,96%,71%,137,145,124,31%,31%,30%,3,1,2,1,1,0
104,https://vlr.gg/player/31827/dambi,2024-09-22 04:05:00,1.22,0.76,1.05,232,271,151,28,22,6,27,15,12,11,5,6,+3,+3,0,79%,83%,71%,142,168,97,28%,29%,26%,8,6,2,5,3,2
105,https://vlr.gg/player/31828/francis,2024-09-22 04:05:00,0.68,0.74,0.70,123,115,140,18,10,8,24,14,10,8,7,1,-5,-3,-2,76%,88%,57%,92,82,110,29%,35%,22%,1,1,0,6,4,2
106,https://vlr.gg/player/4874/berserx,2024-09-22 04:05:00,1.15,1.07,1.10,212,212,207,27,11,16,25,9,16,6,4,2,-1,0,-1,63%,71%,58%,147,135,154,27%,20%,33%,4,1,3,5,1,4
107,https://vlr.gg/player/2380/zesbeew,2024-09-22 04:05:00,1.07,0.93,0.98,192,266,158,24,11,13,27,10,17,9,2,7,+3,+2,+1,63%,57%,67%,129,177,101,26%,26%,26%,4,3,1,1,1,0
108,https://vlr.gg/player/2348/famouz,2024-09-22 04:05:00,0.78,1.04,0.95,193,153,236,25,8,17,28,9,19,6,3,3,+2,-2,+4,63%,50%,71%,144,112,163,27%,44%,21%,6,1,5,4,3,1
109,https://vlr.gg/player/7043/ncslasher,2024-09-22 04:05:00,1.19,0.43,0.71,165,215,138,22,12,10,31,9,22,14,7,7,-5,0,-5,58%,57%,58%,97,117,86,26%,36%,20%,2,2,0,7,2,5
110,https://vlr.gg/player/10739/shiro,2024-09-22 04:05:00,0.91,0.59,0.71,156,198,131,20,10,10,28,9,19,7,5,2,+1,0,+1,55%,79%,42%,107,121,99,21%,22%,19%,3,0,3,2,0,2
111,https://vlr.gg/player/44149/pr0digy,2024-09-22 02:25:00,0.02,1.27,0.92,192,3,255,21,0,21,27,8,19,7,0,7,-2,-2,0,66%,25%,79%,134,3,178,33%,0%,34%,1,0,1,3,2,1
112,https://vlr.gg/player/23042/tripciew,2024-09-22 02:25:00,1.38,0.49,0.71,163,283,123,17,8,9,28,7,21,10,1,9,-4,0,-4,63%,75%,58%,102,179,77,31%,43%,24%,1,0,1,5,0,5
113,https://vlr.gg/player/14587/daft,2024-09-22 02:25:00,0.21,0.69,0.57,164,112,182,15,2,13,29,8,21,6,1,5,0,-2,+2,56%,50%,58%,117,83,128,21%,29%,19%,5,0,5,5,2,3
114,https://vlr.gg/player/14209/suka,2024-09-22 02:25:00,0.02,0.72,0.51,140,31,176,13,0,13,29,8,21,9,1,8,-3,-2,-1,56%,13%,71%,90,31,110,12%,14%,12%,2,0,2,5,2,3
115,https://vlr.gg/player/19154/albus,2024-09-22 02:25:00,0.53,0.45,0.47,129,158,120,13,5,8,28,8,20,5,0,5,-3,-2,-1,59%,63%,58%,80,83,79,28%,25%,29%,1,0,1,4,2,2
116,https://vlr.gg/player/16215/dos9,2024-09-22 02:25:00,1.50,2.65,1.79,287,229,461,35,21,14,12,11,1,11,9,2,+4,+1,+3,88%,83%,100%,190,166,264,27%,25%,31%,5,2,3,1,1,0
117,https://vlr.gg/player/6913/sultan,2024-09-22 02:25:00,1.25,1.89,1.41,277,231,415,31,19,12,17,12,5,10,8,2,-1,-3,+2,81%,75%,100%,199,175,273,32%,28%,44%,4,2,2,5,5,0
118,https://vlr.gg/player/10463/paradox,2024-09-22 02:25:00,1.50,0.66,1.29,265,313,123,30,26,4,20,15,5,10,8,2,+6,+4,+2,78%,79%,75%,172,204,75,31%,29%,44%,7,5,2,1,1,0
119,https://vlr.gg/player/3630/skillz,2024-09-22 02:25:00,1.15,1.33,1.19,159,158,163,20,15,5,12,10,2,7,5,2,+1,0,+1,84%,79%,100%,102,98,114,25%,25%,24%,3,2,1,2,2,0
120,https://vlr.gg/player/4095/skrossi,2024-09-22 02:25:00,1.20,1.15,1.19,201,235,103,25,21,4,18,16,2,7,6,1,+2,+2,0,81%,75%,100%,133,152,74,40%,41%,36%,3,3,0,1,1,0
121,https://vlr.gg/player/13219/papi,2024-09-22 00:00:00,1.08,1.79,1.47,260,214,301,41,14,27,22,12,10,14,3,11,+1,0,+1,79%,74%,83%,173,148,192,28%,34%,25%,4,2,2,3,2,1
122,https://vlr.gg/player/16842/mojer,2024-09-22 00:00:00,1.22,1.57,1.42,305,276,323,44,18,26,28,13,15,12,2,10,+1,+1,0,86%,74%,96%,206,187,222,26%,34%,21%,8,3,5,7,2,5
123,https://vlr.gg/player/9747/emman,2024-09-22 00:00:00,0.99,1.54,1.29,230,170,273,37,13,24,24,11,13,19,6,13,+1,-1,+2,86%,84%,88%,159,115,193,39%,36%,40%,4,1,3,3,2,1
124,https://vlr.gg/player/13220/ja,2024-09-22 00:00:00,1.09,0.87,0.97,171,191,158,29,15,14,25,12,13,8,0,8,+1,0,+1,77%,74%,79%,121,135,109,24%,31%,18%,4,3,1,3,3,0
125,https://vlr.gg/player/7749/nexi,2024-09-22 00:00:00,0.63,0.98,0.83,142,112,169,22,6,16,30,14,16,17,6,11,-3,-1,-2,81%,74%,88%,98,73,117,20%,9%,30%,2,0,2,5,1,4
126,https://vlr.gg/player/12365/coconut,2024-09-22 00:00:00,1.10,0.83,0.98,219,255,174,31,20,11,33,20,13,8,6,2,+5,+4,+1,70%,71%,68%,140,163,112,44%,56%,30%,8,5,3,3,1,2
127,https://vlr.gg/player/47977/chak,2024-09-22 00:00:00,0.68,1.07,0.85,172,163,184,24,12,12,33,21,12,10,2,8,-3,-1,-2,53%,38%,74%,109,103,117,26%,21%,33%,3,2,1,6,3,3
128,https://vlr.gg/player/24302/chimei,2024-09-22 00:00:00,0.60,0.97,0.76,182,163,208,26,12,14,37,22,15,16,7,9,-2,-3,+1,67%,67%,68%,118,109,129,25%,23%,28%,1,0,1,3,3,0
129,https://vlr.gg/player/37421/riyabtw,2024-09-22 00:00:00,0.47,0.99,0.70,159,143,177,25,12,13,36,22,14,4,1,3,-3,-3,0,56%,46%,68%,103,100,107,36%,48%,27%,3,2,1,6,5,1
130,https://vlr.gg/player/7851/uta,2024-09-22 00:00:00,0.42,1.03,0.69,161,135,197,23,11,12,34,22,12,7,2,5,+2,+1,+1,58%,50%,68%,113,94,136,23%,27%,20%,6,2,4,4,1,3
131,https://vlr.gg/player/3169/zap,2024-09-21 15:00:00,1.30,1.40,1.34,220,192,256,75,36,39,57,27,30,39,26,13,+3,+1,+2,80%,81%,77%,153,138,172,34%,32%,37%,6,2,4,3,1,2
132,https://vlr.gg/player/6195/lz,2024-09-21 15:00:00,1.24,1.12,1.18,207,198,218,74,40,34,61,30,31,35,24,11,+4,-2,+6,77%,81%,70%,135,128,144,40%,45%,35%,11,2,9,7,4,3
133,https://vlr.gg/player/21661/spike,2024-09-21 15:00:00,1.27,1.03,1.16,229,246,206,74,45,29,68,35,33,51,26,25,+2,+5,-3,80%,85%,73%,146,163,125,29%,31%,25%,14,10,4,12,5,7
134,https://vlr.gg/player/662/pryze,2024-09-21 15:00:00,1.16,0.76,0.98,172,176,167,66,40,26,60,26,34,22,13,9,-2,-1,-1,74%,76%,73%,114,119,109,29%,32%,25%,5,2,3,7,3,4
135,https://vlr.gg/player/11921/silentzz,2024-09-21 15:00:00,1.12,0.61,0.89,213,282,125,72,54,18,77,44,33,21,13,8,+1,+3,-2,70%,78%,61%,139,184,85,31%,33%,25%,17,14,3,16,11,5
136,https://vlr.gg/player/3722/koalanoob,2024-09-21 15:00:00,1.08,1.08,1.08,226,242,218,81,38,43,72,31,41,19,11,8,0,-3,+3,65%,70%,61%,153,165,142,24%,24%,25%,10,4,6,10,7,3
137,https://vlr.gg/player/6582/net,2024-09-21 15:00:00,1.30,0.84,1.04,212,251,182,74,41,33,70,27,43,22,8,14,-4,-2,-2,76%,80%,72%,142,168,121,33%,34%,32%,8,4,4,12,6,6
138,https://vlr.gg/player/8082/zander,2024-09-21 15:00:00,1.15,0.87,0.99,221,237,210,76,37,39,76,31,45,33,19,14,0,+3,-3,72%,84%,63%,141,145,137,29%,33%,26%,12,7,5,12,4,8
139,https://vlr.gg/player/864/bcj,2024-09-21 15:00:00,0.91,0.61,0.75,150,153,149,51,24,27,73,28,45,24,12,12,-4,-1,-3,66%,70%,63%,99,101,97,21%,20%,22%,8,2,6,12,3,9
140,https://vlr.gg/player/4828/nismo,2024-09-21 15:00:00,0.75,0.66,0.70,130,145,118,41,21,20,71,30,41,50,24,26,0,+1,-1,76%,73%,78%,86,91,82,33%,43%,26%,7,4,3,7,3,4
141,https://vlr.gg/player/1916/free1ng,2024-09-21 05:00:00,,,,222,,,41,,,42,,,8,,,-1,,,,,,147,,,34%,,,5,,,6,,
142,https://vlr.gg/player/4428/udotan,2024-09-21 05:00:00,,,,172,,,34,,,44,,,15,,,-5,,,,,,103,,,42%,,,3,,,8,,
143,https://vlr.gg/player/3531/midnight,2024-09-21 05:00:00,,,,170,,,30,,,43,,,17,,,-1,,,,,,107,,,24%,,,4,,,5,,
144,https://vlr.gg/player/11527/noman,2024-09-21 05:00:00,,,,167,,,30,,,45,,,5,,,-7,,,,,,103,,,27%,,,6,,,13,,
145,https://vlr.gg/player/45811/sn0wflake,2024-09-21 05:00:00,,,,119,,,22,,,47,,,16,,,-1,,,,,,79,,,39%,,,2,,,3,,
146,https://vlr.gg/player/5796/kr1stal,2024-09-21 05:00:00,,,,274,,,57,,,26,,,20,,,+6,,,,,,174,,,28%,,,7,,,1,,
147,https://vlr.gg/player/22047/rarga,2024-09-21 05:00:00,,,,252,,,49,,,38,,,16,,,+2,,,,,,164,,,35%,,,13,,,11,,
148,https://vlr.gg/player/37927/happywei,2024-09-21 05:00:00,,,,206,,,40,,,31,,,17,,,+2,,,,,,130,,,32%,,,7,,,5,,
149,https://vlr.gg/player/37674/mrcani,2024-09-21 05:00:00,,,,188,,,40,,,34,,,25,,,+1,,,,,,118,,,37%,,,3,,,2,,
150,https://vlr.gg/player/36668/mart1n,2024-09-21 05:00:00,,,,187,,,35,,,28,,,22,,,+4,,,,,,119,,,34%,,,5,,,1,,
151,https://vlr.gg/player/7426/juicy,2024-09-21 04:45:00,1.46,0.82,1.17,236,300,173,39,26,13,32,16,16,8,6,2,-1,0,-1,70%,76%,62%,150,187,107,24%,22%,29%,5,3,2,6,3,3
152,https://vlr.gg/player/34032/grumble,2024-09-21 04:45:00,1.23,0.80,1.03,231,277,179,38,25,13,36,20,16,8,5,3,-2,-1,-1,70%,76%,62%,156,186,121,40%,43%,35%,2,1,1,4,2,2
153,https://vlr.gg/player/24628/wayne,2024-09-21 04:45:00,0.74,1.14,0.92,192,151,254,31,13,18,35,19,16,10,5,5,-1,-1,0,70%,72%,67%,133,98,175,24%,23%,25%,4,3,1,5,4,1
154,https://vlr.gg/player/24653/vera,2024-09-21 04:45:00,0.49,1.39,0.90,216,143,316,34,11,23,34,20,14,6,4,2,+3,-1,+4,63%,60%,67%,143,109,184,17%,9%,26%,9,3,6,6,4,2
155,https://vlr.gg/player/11704/styron,2024-09-21 04:45:00,0.70,0.70,0.70,129,94,161,19,9,10,31,16,15,10,5,5,-1,0,-1,67%,76%,57%,91,73,112,24%,14%,38%,2,1,1,3,1,2
156,https://vlr.gg/player/3342/sushiboys,2024-09-21 04:45:00,1.15,1.46,1.32,237,202,272,41,15,26,27,13,14,6,2,4,+1,-1,+2,76%,76%,76%,155,128,177,30%,32%,29%,3,0,3,2,1,1
157,https://vlr.gg/player/4377/johnolsen,2024-09-21 04:45:00,0.82,1.46,1.17,255,222,264,40,16,24,34,18,16,10,4,6,+2,0,+2,63%,52%,72%,166,161,170,35%,38%,33%,10,4,6,8,4,4
158,https://vlr.gg/player/27254/leviathan,2024-09-21 04:45:00,1.54,0.57,1.02,173,274,92,29,20,9,31,13,18,13,8,5,-1,+1,-2,63%,67%,60%,121,181,70,38%,39%,38%,2,1,1,3,0,3
159,https://vlr.gg/player/6723/foxz,2024-09-21 04:45:00,0.93,1.02,0.98,209,207,204,29,15,14,33,16,17,21,9,12,0,0,0,76%,76%,76%,143,142,144,23%,26%,21%,3,1,2,3,1,2
160,https://vlr.gg/player/3401/ptc,2024-09-21 04:45:00,0.58,0.94,0.78,165,131,195,29,11,18,36,17,19,19,5,14,0,-1,+1,63%,57%,68%,106,68,137,35%,50%,30%,6,4,2,6,5,1
161,https://vlr.gg/player/29841/caedye,2024-09-21 02:10:00,1.42,0.74,1.06,203,259,154,32,21,11,34,15,19,20,7,13,-2,-1,-1,77%,87%,68%,139,182,100,38%,49%,25%,3,2,1,5,3,2
162,https://vlr.gg/player/10584/seoldam,2024-09-21 02:10:00,0.82,1.27,1.05,258,223,297,43,18,25,38,18,20,10,6,4,+4,+1,+3,67%,61%,72%,162,143,178,20%,19%,21%,10,4,6,6,3,3
163,https://vlr.gg/player/29843/yatsuka,2024-09-21 02:10:00,0.90,1.05,0.98,202,184,227,36,15,21,36,15,21,8,3,5,+2,+1,+1,67%,70%,64%,140,127,151,36%,43%,32%,5,2,3,3,1,2
164,https://vlr.gg/player/4663/joxjo,2024-09-21 02:10:00,0.96,0.81,0.88,199,193,195,27,13,14,36,16,20,20,10,10,+2,+5,-3,77%,78%,76%,126,122,130,23%,20%,26%,8,6,2,6,1,5
165,https://vlr.gg/player/43064/aace,2024-09-21 02:10:00,0.85,0.87,0.86,151,136,166,28,12,16,34,15,19,10,8,2,0,+1,-1,65%,74%,56%,101,91,111,25%,21%,29%,1,1,0,1,0,1
166,https://vlr.gg/player/31828/francis,2024-09-21 02:10:00,1.20,1.46,1.33,218,184,249,39,19,20,28,14,14,28,12,16,-1,-1,0,83%,80%,87%,129,115,143,23%,18%,28%,1,0,1,2,1,1
167,https://vlr.gg/player/4122/persia,2024-09-21 02:10:00,1.07,1.19,1.13,225,217,229,36,18,18,34,18,16,23,15,8,+1,+1,0,73%,88%,57%,145,146,144,34%,39%,30%,6,3,3,5,2,3
168,https://vlr.gg/player/31827/dambi,2024-09-21 02:10:00,1.18,0.98,1.09,245,251,245,39,21,18,37,19,18,14,7,7,0,+4,-4,77%,84%,70%,152,149,155,23%,21%,27%,10,6,4,10,2,8
169,https://vlr.gg/player/31829/ivy,2024-09-21 02:10:00,1.06,1.09,1.08,214,235,188,36,22,14,33,18,15,19,7,12,-1,+1,-2,85%,88%,83%,141,152,128,29%,28%,30%,2,2,0,3,1,2
170,https://vlr.gg/player/33576/margaret,2024-09-21 02:10:00,0.97,0.64,0.81,174,224,128,28,19,9,34,18,16,16,10,6,-5,-4,-1,69%,68%,70%,114,147,79,34%,32%,38%,2,2,0,7,6,1
171,https://vlr.gg/player/26316/ramen,2024-09-21 00:00:00,1.65,0.96,1.41,239,277,154,29,23,6,19,11,8,16,10,6,+2,+2,0,81%,79%,85%,157,182,110,23%,24%,21%,2,2,0,0,0,0
172,https://vlr.gg/player/31589/murza,2024-09-21 00:00:00,1.41,1.10,1.30,249,250,228,33,22,11,22,13,9,15,10,5,+1,0,+1,86%,83%,92%,148,157,132,23%,29%,13%,5,2,3,4,2,2
173,https://vlr.gg/player/26310/ikana,2024-09-21 00:00:00,1.09,1.19,1.12,222,195,274,29,17,12,25,15,10,10,5,5,+3,+2,+1,81%,83%,77%,134,119,162,18%,16%,21%,4,2,2,1,0,1
174,https://vlr.gg/player/10089/andy,2024-09-21 00:00:00,0.88,1.52,1.10,221,194,283,30,17,13,27,17,10,10,5,5,-1,-2,+1,73%,67%,85%,147,133,172,18%,22%,15%,5,3,2,6,5,1
175,https://vlr.gg/player/31593/kiss,2024-09-21 00:00:00,0.99,1.26,1.09,217,234,194,31,20,11,26,18,8,14,11,3,-2,0,-2,76%,75%,77%,154,169,125,33%,32%,36%,4,4,0,6,4,2
176,https://vlr.gg/player/14209/suka,2024-09-21 00:00:00,0.36,1.29,0.96,212,124,246,25,4,21,30,12,18,15,9,6,0,-1,+1,76%,77%,75%,131,80,158,19%,7%,27%,3,1,2,3,2,1
177,https://vlr.gg/player/23042/tripciew,2024-09-21 00:00:00,1.11,0.82,0.92,223,216,220,27,12,15,28,8,20,9,2,7,-2,-1,-1,65%,69%,63%,139,127,146,26%,27%,25%,2,0,2,4,1,3
178,https://vlr.gg/player/44149/pr0digy,2024-09-21 00:00:00,0.66,1.03,0.90,208,198,224,29,9,20,34,13,21,9,4,5,+2,+2,0,78%,77%,79%,143,121,154,36%,35%,36%,5,3,2,3,1,2
179,https://vlr.gg/player/14587/daft,2024-09-21 00:00:00,1.56,0.38,0.79,187,340,113,24,16,8,30,9,21,9,5,4,+2,+2,0,65%,85%,54%,128,221,78,25%,35%,12%,6,2,4,4,0,4
180,https://vlr.gg/player/19154/albus,2024-09-21 00:00:00,0.36,0.51,0.43,113,96,127,14,4,10,30,11,19,8,3,5,-5,-3,-2,68%,69%,67%,82,72,87,31%,27%,33%,1,0,1,6,3,3
181,https://vlr.gg/player/41135/dantedeu5,2024-09-20 15:00:00,0.95,1.19,1.07,241,207,264,73,33,40,68,32,36,23,7,16,+5,-2,+7,68%,62%,74%,150,124,175,24%,20%,27%,15,6,9,10,8,2
182,https://vlr.gg/player/9354/cebando,2024-09-20 15:00:00,1.21,0.90,1.05,197,199,188,65,33,32,65,28,37,34,20,14,+4,+1,+3,64%,71%,57%,116,120,111,34%,36%,31%,13,5,8,9,4,5
183,https://vlr.gg/player/3826/adverso,2024-09-20 15:00:00,0.91,1.10,1.01,172,133,209,56,22,34,59,27,32,26,14,12,-3,-1,-2,67%,64%,70%,111,86,135,20%,12%,26%,3,0,3,6,1,5
184,https://vlr.gg/player/13861/nicomachine,2024-09-20 15:00:00,0.94,0.92,0.93,168,184,155,53,28,25,59,29,30,34,16,18,-6,-1,-5,78%,78%,79%,106,115,97,24%,24%,24%,4,3,1,10,4,6
185,https://vlr.gg/player/2585/tinchoff,2024-09-20 15:00:00,0.73,0.93,0.83,172,174,160,53,27,26,65,34,31,22,4,18,-2,-2,0,65%,60%,70%,105,111,98,33%,39%,28%,10,6,4,12,8,4
186,https://vlr.gg/player/4828/nismo,2024-09-20 15:00:00,1.20,1.18,1.19,216,218,212,67,36,31,58,32,26,51,28,23,+3,+1,+2,76%,77%,76%,148,156,140,33%,34%,31%,6,2,4,3,1,2
187,https://vlr.gg/player/3722/koalanoob,2024-09-20 15:00:00,1.14,1.17,1.15,242,246,254,81,41,40,64,33,31,24,15,9,+11,+9,+2,72%,72%,71%,161,160,163,27%,25%,29%,24,13,11,13,4,9
188,https://vlr.gg/player/8082/zander,2024-09-20 15:00:00,0.97,1.06,1.01,194,197,208,66,34,32,65,35,30,26,12,14,-3,-5,+2,71%,77%,64%,124,123,126,30%,29%,32%,8,3,5,11,8,3
189,https://vlr.gg/player/864/bcj,2024-09-20 15:00:00,1.05,0.83,0.94,162,180,143,54,32,22,58,29,29,37,18,19,-7,-4,-3,75%,74%,76%,104,109,98,19%,22%,16%,4,2,2,11,6,5
190,https://vlr.gg/player/6582/net,2024-09-20 15:00:00,0.73,0.99,0.86,149,141,158,48,23,25,57,30,27,10,3,7,-2,-4,+2,61%,60%,62%,107,104,111,28%,26%,31%,5,2,3,7,6,1
191,https://vlr.gg/player/22047/rarga,2024-09-20 05:00:00,,,,290,,,110,,,71,,,23,,,+20,,,,,,186,,,42%,,,35,,,15,,
192,https://vlr.gg/player/5796/kr1stal,2024-09-20 05:00:00,,,,259,,,88,,,61,,,28,,,+7,,,,,,171,,,26%,,,13,,,6,,
193,https://vlr.gg/player/37927/happywei,2024-09-20 05:00:00,,,,217,,,72,,,73,,,34,,,+2,,,,,,135,,,28%,,,8,,,6,,
194,https://vlr.gg/player/37674/mrcani,2024-09-20 05:00:00,,,,185,,,77,,,65,,,43,,,+1,,,,,,124,,,40%,,,4,,,3,,
195,https://vlr.gg/player/36668/mart1n,2024-09-20 05:00:00,,,,138,,,53,,,61,,,42,,,-4,,,,,,93,,,35%,,,6,,,10,,
196,https://vlr.gg/player/5241/maple,2024-09-20 05:00:00,,,,211,,,67,,,83,,,42,,,-4,,,,,,130,,,20%,,,10,,,14,,
197,https://vlr.gg/player/34181/green,2024-09-20 05:00:00,,,,193,,,70,,,83,,,26,,,-8,,,,,,134,,,32%,,,12,,,20,,
198,https://vlr.gg/player/4763/zixuan,2024-09-20 05:00:00,,,,182,,,71,,,81,,,42,,,-5,,,,,,120,,,27%,,,8,,,13,,
199,https://vlr.gg/player/47629/coco,2024-09-20 05:00:00,,,,171,,,61,,,75,,,49,,,-3,,,,,,115,,,33%,,,2,,,5,,
200,https://vlr.gg/player/29184/kawentw,2024-09-20 05:00:00,,,,154,,,61,,,79,,,19,,,-6,,,,,,108,,,33%,,,8,,,14,,
201,https://vlr.gg/player/13220/ja,2024-09-20 04:50:00,0.90,1.01,0.95,204,190,227,24,12,12,29,16,13,7,4,3,-1,-3,+2,58%,50%,69%,136,125,150,33%,33%,34%,3,1,2,4,4,0
202,https://vlr.gg/player/7749/nexi,2024-09-20 04:50:00,0.61,1.26,0.90,193,152,249,25,10,15,30,17,13,2,1,1,-2,-2,0,64%,60%,69%,129,107,156,24%,19%,30%,2,1,1,4,3,1
203,https://vlr.gg/player/13219/papi,2024-09-20 04:50:00,0.84,0.60,0.73,167,185,141,20,13,7,30,16,14,7,2,5,-5,-2,-3,61%,60%,63%,99,107,89,25%,31%,17%,0,0,0,5,2,3
204,https://vlr.gg/player/9747/emman,2024-09-20 04:50:00,0.37,1.02,0.66,134,95,196,16,5,11,32,19,13,11,6,5,-1,0,-1,64%,55%,75%,92,66,124,30%,16%,44%,1,0,1,2,0,2
205,https://vlr.gg/player/16842/mojer,2024-09-20 04:50:00,0.41,0.47,0.40,115,111,128,9,5,4,31,17,14,9,5,4,-7,-5,-2,53%,45%,63%,88,84,93,20%,35%,10%,4,2,2,11,7,4
206,https://vlr.gg/player/7043/ncslasher,2024-09-20 04:50:00,1.50,1.67,1.60,289,291,290,39,18,21,19,10,9,10,4,6,+4,+1,+3,83%,75%,90%,182,176,187,20%,17%,23%,4,1,3,0,0,0
207,https://vlr.gg/player/2348/famouz,2024-09-20 04:50:00,1.20,1.52,1.38,278,289,269,34,14,20,20,11,9,11,6,5,+7,+2,+5,92%,88%,95%,181,196,169,17%,13%,22%,9,3,6,2,1,1
208,https://vlr.gg/player/2380/zesbeew,2024-09-20 04:50:00,0.97,1.64,1.34,240,156,287,30,9,21,17,9,8,17,10,7,+5,+1,+4,86%,81%,90%,153,99,196,20%,24%,19%,6,2,4,1,1,0
209,https://vlr.gg/player/4874/berserx,2024-09-20 04:50:00,1.29,0.94,1.10,181,223,147,25,14,11,17,8,9,8,5,3,+1,+2,-1,72%,81%,65%,123,165,89,38%,40%,37%,3,2,1,2,0,2
210,https://vlr.gg/player/10739/shiro,2024-09-20 04:50:00,0.90,1.06,0.98,171,177,178,24,12,12,21,11,10,17,4,13,-1,-2,+1,75%,63%,85%,112,109,114,26%,42%,19%,4,2,2,5,4,1
211,https://vlr.gg/player/4377/johnolsen,2024-09-20 03:00:00,1.19,1.74,1.57,301,206,349,38,8,30,18,6,12,15,4,11,0,-1,+1,80%,73%,83%,196,146,219,26%,25%,27%,6,1,5,6,2,4
212,https://vlr.gg/player/6723/foxz,2024-09-20 03:00:00,1.82,1.44,1.56,239,272,226,32,12,20,14,4,10,13,4,9,+3,0,+3,80%,82%,79%,163,188,152,39%,39%,39%,3,0,3,0,0,0
213,https://vlr.gg/player/3401/ptc,2024-09-20 03:00:00,1.24,1.49,1.42,187,161,199,25,7,18,13,5,8,20,4,16,0,-2,+2,94%,91%,96%,124,113,128,35%,35%,34%,3,0,3,3,2,1
214,https://vlr.gg/player/27254/leviathan,2024-09-20 03:00:00,1.42,1.26,1.31,218,196,229,29,8,21,18,5,13,17,7,10,+3,+1,+2,77%,73%,79%,137,134,138,29%,50%,22%,5,2,3,2,1,1
215,https://vlr.gg/player/3342/sushiboys,2024-09-20 03:00:00,1.11,1.18,1.15,235,240,223,29,10,19,21,9,12,12,3,9,+3,-1,+4,86%,82%,88%,149,149,149,16%,23%,13%,5,1,4,2,2,0
216,https://vlr.gg/player/47977/chak,2024-09-20 03:00:00,0.67,1.16,0.82,205,189,246,26,16,10,32,23,9,7,5,2,+5,+2,+3,66%,58%,82%,133,122,159,36%,27%,59%,8,4,4,3,2,1
217,https://vlr.gg/player/37421/riyabtw,2024-09-20 03:00:00,0.59,1.03,0.73,181,153,270,20,11,9,31,22,9,7,4,3,-3,-4,+1,51%,46%,64%,123,96,182,24%,32%,13%,3,2,1,6,6,0
218,https://vlr.gg/player/7851/uta,2024-09-20 03:00:00,0.76,0.66,0.72,151,167,118,18,13,5,28,20,8,5,2,3,-2,-2,0,49%,42%,64%,104,117,76,25%,29%,13%,2,0,2,4,2,2
219,https://vlr.gg/player/24302/chimei,2024-09-20 03:00:00,0.67,0.35,0.57,110,116,94,11,9,2,30,20,10,15,9,6,-2,-2,0,51%,50%,55%,75,75,74,17%,16%,19%,0,0,0,2,2,0
220,https://vlr.gg/player/12365/coconut,2024-09-20 03:00:00,0.32,0.44,0.32,87,89,90,9,6,3,32,23,9,4,3,1,-7,-6,-1,54%,50%,64%,68,65,76,19%,17%,25%,0,0,0,7,6,1
221,https://vlr.gg/player/6913/sultan,2024-09-20 00:00:00,1.28,1.08,1.17,226,233,224,33,16,17,33,13,20,7,2,5,+2,+3,-1,63%,67%,61%,145,145,145,30%,33%,27%,6,3,3,4,0,4
222,https://vlr.gg/player/16215/dos9,2024-09-20 00:00:00,1.11,1.03,1.07,201,232,189,30,14,16,31,13,18,10,6,4,-1,-1,0,71%,67%,74%,136,137,136,27%,21%,33%,0,0,0,1,1,0
223,https://vlr.gg/player/4095/skrossi,2024-09-20 00:00:00,0.73,0.81,0.76,164,167,169,23,10,13,31,13,18,4,2,2,-2,0,-2,54%,50%,57%,108,103,113,17%,8%,22%,3,2,1,5,2,3
224,https://vlr.gg/player/10463/paradox,2024-09-20 00:00:00,0.70,0.71,0.71,188,194,199,27,12,15,36,15,21,5,3,2,-8,-5,-3,63%,56%,70%,128,123,132,26%,22%,30%,5,1,4,13,6,7
225,https://vlr.gg/player/3630/skillz,2024-09-20 00:00:00,0.16,0.61,0.41,117,60,156,12,2,10,35,15,20,16,6,10,-2,-3,+1,73%,61%,83%,84,43,115,16%,13%,17%,1,0,1,3,3,0
226,https://vlr.gg/player/4122/persia,2024-09-20 00:00:00,1.75,0.83,1.35,240,279,197,36,25,11,24,10,14,22,15,7,0,+1,-1,78%,83%,72%,167,191,137,33%,32%,33%,3,2,1,3,1,2
227,https://vlr.gg/player/31827/dambi,2024-09-20 00:00:00,0.83,2.00,1.35,288,212,368,41,17,24,27,18,9,9,5,4,+6,+2,+4,76%,78%,72%,188,145,243,22%,21%,23%,8,3,5,2,1,1
228,https://vlr.gg/player/31828/francis,2024-09-20 00:00:00,1.36,0.92,1.17,216,276,141,32,23,9,25,14,11,18,13,5,+3,+2,+1,76%,83%,67%,134,165,95,29%,32%,25%,6,4,2,3,2,1
229,https://vlr.gg/player/33576/margaret,2024-09-20 00:00:00,1.08,1.07,1.08,177,204,146,28,18,10,22,14,8,7,3,4,+1,+2,-1,78%,74%,83%,128,147,105,33%,31%,36%,4,3,1,3,1,2
230,https://vlr.gg/player/31829/ivy,2024-09-20 00:00:00,0.85,1.15,0.98,193,171,222,29,14,15,27,15,12,11,8,3,+1,-2,+3,90%,87%,94%,123,110,140,33%,26%,41%,5,2,3,4,4,0
231,https://vlr.gg/player/3722/koalanoob,2024-09-19 18:20:00,1.15,1.50,1.32,270,251,287,44,20,24,33,20,13,12,5,7,+13,+6,+7,71%,60%,83%,172,170,174,22%,29%,14%,16,8,8,3,2,1
232,https://vlr.gg/player/8082/zander,2024-09-19 18:20:00,1.16,1.43,1.29,219,225,202,36,19,17,27,17,10,21,9,12,0,0,0,75%,68%,83%,134,140,127,32%,37%,27%,3,1,2,3,1,2
233,https://vlr.gg/player/4828/nismo,2024-09-19 18:20:00,0.95,1.40,1.16,186,155,221,31,14,17,27,16,11,25,9,16,-1,-1,0,69%,56%,83%,134,112,158,31%,35%,28%,2,1,1,3,2,1
234,https://vlr.gg/player/864/bcj,2024-09-19 18:20:00,0.76,1.21,0.98,188,160,221,29,13,16,30,19,11,17,5,12,+1,+1,0,77%,68%,87%,134,114,155,13%,16%,11%,5,3,2,4,2,2
235,https://vlr.gg/player/6582/net,2024-09-19 18:20:00,0.44,1.34,0.87,165,108,228,30,10,20,31,20,11,7,2,5,-1,-3,+2,75%,60%,91%,106,74,140,32%,45%,26%,4,1,3,5,4,1
236,https://vlr.gg/player/1994/evilkyk,2024-09-19 18:20:00,0.97,1.53,1.26,234,201,262,40,16,24,29,17,12,13,3,10,+3,-1,+4,73%,65%,80%,150,135,163,31%,36%,29%,6,1,5,3,2,1
237,https://vlr.gg/player/1688/rood,2024-09-19 18:20:00,1.04,1.07,1.05,192,205,186,30,17,13,31,19,12,21,4,17,-2,0,-2,67%,61%,72%,129,131,126,24%,25%,23%,2,1,1,4,1,3
238,https://vlr.gg/player/28716/lukxo,2024-09-19 18:20:00,0.40,1.26,0.85,170,82,246,31,6,25,37,19,18,11,2,9,+1,0,+1,56%,43%,68%,109,64,150,26%,29%,25%,3,1,2,2,1,1
239,https://vlr.gg/player/6238/urango,2024-09-19 18:20:00,0.51,0.91,0.72,163,112,208,25,8,17,38,19,19,12,6,6,-7,-3,-4,67%,52%,80%,114,78,147,26%,16%,32%,2,0,2,9,3,6
240,https://vlr.gg/player/21659/sato,2024-09-19 18:20:00,0.29,0.76,0.53,128,123,133,22,9,13,35,20,15,5,1,4,-7,-5,-2,56%,35%,76%,75,74,76,25%,29%,22%,5,4,1,12,9,3
241,https://vlr.gg/player/11921/silentzz,2024-09-19 15:00:00,1.19,0.97,1.09,242,277,190,58,37,21,47,28,19,10,4,6,+6,+5,+1,77%,80%,73%,149,172,122,36%,38%,33%,15,9,6,9,4,5
242,https://vlr.gg/player/6195/lz,2024-09-19 15:00:00,0.99,1.21,1.09,198,156,228,46,22,24,38,20,18,17,8,9,+1,+2,-1,75%,77%,73%,122,101,146,44%,38%,50%,6,3,3,5,1,4
243,https://vlr.gg/player/662/pryze,2024-09-19 15:00:00,1.06,1.02,1.04,158,157,152,36,17,19,35,18,17,19,14,5,0,-1,+1,68%,74%,60%,114,112,115,17%,16%,18%,2,1,1,2,2,0
244,https://vlr.gg/player/21661/spike,2024-09-19 15:00:00,0.80,1.21,0.99,213,182,250,47,21,26,48,28,20,23,14,9,0,-5,+5,74%,66%,83%,130,113,149,25%,26%,24%,10,3,7,10,8,2
245,https://vlr.gg/player/3169/zap,2024-09-19 15:00:00,1.15,0.68,0.93,177,219,138,44,30,14,45,24,21,24,10,14,0,0,0,72%,83%,60%,118,141,91,28%,28%,28%,3,2,1,3,2,1
246,https://vlr.gg/player/9354/cebando,2024-09-19 15:00:00,1.08,1.09,1.09,214,180,256,49,20,29,48,20,28,29,12,17,+2,-3,+5,72%,70%,74%,137,119,153,27%,38%,22%,10,2,8,8,5,3
247,https://vlr.gg/player/41135/dantedeu5,2024-09-19 15:00:00,1.13,1.03,1.08,250,252,248,53,25,28,52,23,29,21,6,15,-3,-4,+1,69%,60%,77%,149,151,148,28%,28%,28%,6,2,4,9,6,3
248,https://vlr.gg/player/13861/nicomachine,2024-09-19 15:00:00,0.95,1.12,1.05,209,183,223,40,16,24,45,21,24,43,17,26,-2,0,-2,74%,63%,83%,133,113,150,22%,22%,21%,4,2,2,6,2,4
249,https://vlr.gg/player/2585/tinchoff,2024-09-19 15:00:00,0.80,1.00,0.91,134,148,140,37,16,21,41,21,20,14,4,10,+2,+2,0,72%,77%,69%,97,98,95,36%,40%,33%,6,4,2,4,2,2
250,https://vlr.gg/player/3826/adverso,2024-09-19 15:00:00,0.94,0.83,0.88,170,191,148,34,18,16,45,19,26,29,12,17,-6,-1,-5,75%,77%,74%,111,121,102,34%,36%,33%,3,2,1,9,3,6
251,https://vlr.gg/player/46755/volay,2024-09-19 08:25:00,,,,211,,,59,,,50,,,21,,,+4,,,,,,145,,,33%,,,8,,,4,,
252,https://vlr.gg/player/46751/chaos,2024-09-19 08:25:00,,,,205,,,60,,,55,,,12,,,-2,,,,,,149,,,25%,,,12,,,14,,
253,https://vlr.gg/player/47634/ec1ipsed,2024-09-19 08:25:00,,,,190,,,48,,,56,,,20,,,-3,,,,,,127,,,34%,,,5,,,8,,
254,https://vlr.gg/player/4416/link,2024-09-19 08:25:00,,,,164,,,41,,,59,,,32,,,+2,,,,,,112,,,25%,,,10,,,8,,
255,https://vlr.gg/player/15549/pinklove,2024-09-19 08:25:00,,,,154,,,39,,,55,,,47,,,-1,,,,,,107,,,14%,,,4,,,5,,
256,https://vlr.gg/player/34181/green,2024-09-19 08:25:00,,,,228,,,61,,,49,,,26,,,+3,,,,,,147,,,33%,,,8,,,5,,
257,https://vlr.gg/player/29184/kawentw,2024-09-19 08:25:00,,,,210,,,60,,,47,,,21,,,+5,,,,,,130,,,32%,,,9,,,4,,
258,https://vlr.gg/player/4763/zixuan,2024-09-19 08:25:00,,,,207,,,57,,,46,,,34,,,-1,,,,,,133,,,14%,,,4,,,5,,
259,https://vlr.gg/player/5241/maple,2024-09-19 08:25:00,,,,202,,,51,,,55,,,23,,,-3,,,,,,133,,,25%,,,16,,,19,,
260,https://vlr.gg/player/47629/coco,2024-09-19 08:25:00,,,,171,,,46,,,50,,,29,,,-4,,,,,,124,,,31%,,,2,,,6,,
261,https://vlr.gg/player/1916/free1ng,2024-09-19 05:00:00,,,,268,,,66,,,47,,,7,,,-2,,,,,,168,,,39%,,,9,,,11,,
262,https://vlr.gg/player/4428/udotan,2024-09-19 05:00:00,,,,265,,,67,,,48,,,11,,,+5,,,,,,173,,,40%,,,12,,,7,,
263,https://vlr.gg/player/11527/noman,2024-09-19 05:00:00,,,,209,,,46,,,46,,,28,,,0,,,,,,135,,,20%,,,6,,,6,,
264,https://vlr.gg/player/3531/midnight,2024-09-19 05:00:00,,,,183,,,44,,,42,,,24,,,+3,,,,,,117,,,17%,,,5,,,2,,
265,https://vlr.gg/player/45811/sn0wflake,2024-09-19 05:00:00,,,,124,,,24,,,45,,,35,,,-1,,,,,,79,,,41%,,,4,,,5,,
266,https://vlr.gg/player/22047/rarga,2024-09-19 05:00:00,,,,254,,,64,,,50,,,12,,,0,,,,,,179,,,29%,,,9,,,9,,
267,https://vlr.gg/player/5796/kr1stal,2024-09-19 05:00:00,,,,213,,,42,,,52,,,20,,,-7,,,,,,145,,,24%,,,7,,,14,,
268,https://vlr.gg/player/37927/happywei,2024-09-19 05:00:00,,,,183,,,43,,,53,,,15,,,-2,,,,,,125,,,34%,,,7,,,9,,
269,https://vlr.gg/player/36668/mart1n,2024-09-19 05:00:00,,,,171,,,40,,,42,,,21,,,+3,,,,,,115,,,34%,,,6,,,3,,
270,https://vlr.gg/player/37674/mrcani,2024-09-19 05:00:00,,,,150,,,38,,,50,,,23,,,+1,,,,,,100,,,43%,,,2,,,1,,
271,https://vlr.gg/player/9354/cebando,2024-09-18 18:00:00,1.17,1.53,1.36,226,181,273,39,15,24,27,12,15,19,11,8,+1,0,+1,81%,87%,76%,139,102,173,39%,38%,39%,5,3,2,4,3,1
272,https://vlr.gg/player/41135/dantedeu5,2024-09-18 18:00:00,1.67,0.80,1.22,255,318,201,41,26,15,34,13,21,11,6,5,+5,0,+5,75%,83%,68%,175,211,141,29%,29%,30%,12,4,8,7,4,3
273,https://vlr.gg/player/3826/adverso,2024-09-18 18:00:00,1.47,0.94,1.19,224,276,173,37,24,13,30,14,16,18,9,9,-4,-3,-1,71%,78%,64%,145,176,116,26%,28%,24%,2,0,2,6,3,3
274,https://vlr.gg/player/13861/nicomachine,2024-09-18 18:00:00,1.51,0.74,1.11,176,224,132,31,19,12,28,12,16,21,14,7,-1,+1,-2,81%,91%,72%,121,163,82,38%,40%,35%,3,2,1,4,1,3
275,https://vlr.gg/player/2585/tinchoff,2024-09-18 18:00:00,0.80,0.82,0.81,164,147,175,28,12,16,34,15,19,11,7,4,+1,-1,+2,69%,78%,60%,96,86,106,39%,29%,50%,3,1,2,2,2,0
276,https://vlr.gg/player/21659/sato,2024-09-18 18:00:00,1.37,0.89,1.14,247,278,210,45,28,17,34,16,18,4,0,4,0,-3,+3,69%,64%,74%,149,162,136,31%,39%,21%,8,4,4,8,7,1
277,https://vlr.gg/player/6238/urango,2024-09-18 18:00:00,1.34,0.85,1.10,235,285,188,39,25,14,35,16,19,18,11,7,-1,-1,0,73%,72%,74%,164,195,130,44%,42%,47%,1,0,1,2,1,1
278,https://vlr.gg/player/28716/lukxo,2024-09-18 18:00:00,0.92,0.55,0.75,166,176,153,28,16,12,36,17,19,9,7,2,+1,+2,-1,60%,72%,48%,101,109,92,33%,39%,28%,7,5,2,6,3,3
279,https://vlr.gg/player/1688/rood,2024-09-18 18:00:00,0.93,0.47,0.71,129,106,159,21,9,12,31,11,20,10,6,4,-1,-2,+1,63%,64%,61%,90,83,97,15%,24%,11%,3,0,3,4,2,2
280,https://vlr.gg/player/1994/evilkyk,2024-09-18 18:00:00,0.51,0.46,0.49,131,116,146,20,9,11,40,20,20,12,9,3,-1,-1,0,71%,76%,65%,88,79,98,16%,16%,16%,4,1,3,5,2,3
281,https://vlr.gg/player/6582/net,2024-09-18 15:00:00,1.11,0.88,1.00,184,200,170,27,15,12,27,13,14,7,5,2,-1,0,-1,66%,67%,65%,124,128,119,37%,26%,58%,3,1,2,4,1,3
282,https://vlr.gg/player/3722/koalanoob,2024-09-18 15:00:00,1.28,0.55,0.92,208,271,143,27,18,9,32,15,17,13,9,4,+3,+4,-1,68%,81%,55%,130,166,91,20%,19%,21%,8,6,2,5,2,3
283,https://vlr.gg/player/4828/nismo,2024-09-18 15:00:00,0.64,1.17,0.90,148,114,186,22,8,14,27,15,12,19,11,8,-4,0,-4,76%,71%,80%,97,74,121,26%,20%,31%,2,2,0,6,2,4
284,https://vlr.gg/player/864/bcj,2024-09-18 15:00:00,0.80,0.96,0.88,189,164,214,25,11,14,28,14,14,15,8,7,-1,-1,0,80%,81%,80%,133,115,151,23%,21%,25%,3,1,2,4,2,2
285,https://vlr.gg/player/8082/zander,2024-09-18 15:00:00,0.44,0.73,0.58,155,117,194,21,8,13,35,17,18,11,6,5,-4,-4,0,61%,57%,65%,99,81,117,28%,35%,24%,1,0,1,5,4,1
286,https://vlr.gg/player/21661/spike,2024-09-18 15:00:00,1.29,1.44,1.37,283,291,277,39,20,19,28,14,14,21,6,15,0,+2,-2,80%,80%,81%,182,184,180,27%,25%,30%,5,3,2,5,1,4
287,https://vlr.gg/player/11921/silentzz,2024-09-18 15:00:00,0.88,1.63,1.26,261,207,310,36,14,22,25,15,10,5,3,2,+2,+2,0,73%,70%,76%,164,124,202,38%,50%,30%,7,5,2,5,3,2
288,https://vlr.gg/player/662/pryze,2024-09-18 15:00:00,1.35,1.05,1.20,158,205,116,24,16,8,18,10,8,11,7,4,0,0,0,83%,90%,76%,121,152,92,29%,33%,25%,1,0,1,1,0,1
289,https://vlr.gg/player/6195/lz,2024-09-18 15:00:00,1.13,0.98,1.05,196,190,203,29,14,15,27,11,16,15,6,9,+4,+2,+2,80%,85%,76%,130,123,137,43%,52%,39%,8,3,5,4,1,3
290,https://vlr.gg/player/3169/zap,2024-09-18 15:00:00,0.94,0.85,0.89,135,154,118,21,11,10,24,12,12,10,6,4,+1,0,+1,78%,80%,76%,85,92,79,21%,13%,40%,3,2,1,2,2,0
291,https://vlr.gg/player/5241/maple,2024-09-18 06:35:00,,,,232,,,31,,,34,,,6,,,-6,,,,,,144,,,40%,,,4,,,10,,
292,https://vlr.gg/player/29184/kawentw,2024-09-18 06:35:00,,,,219,,,32,,,30,,,11,,,+3,,,,,,124,,,37%,,,4,,,1,,
293,https://vlr.gg/player/34181/green,2024-09-18 06:35:00,,,,204,,,32,,,30,,,6,,,+2,,,,,,143,,,47%,,,7,,,5,,
294,https://vlr.gg/player/4763/zixuan,2024-09-18 06:35:00,,,,147,,,18,,,31,,,19,,,-1,,,,,,99,,,31%,,,2,,,3,,
295,https://vlr.gg/player/47629/coco,2024-09-18 06:35:00,,,,119,,,16,,,31,,,14,,,-1,,,,,,81,,,38%,,,2,,,3,,
296,https://vlr.gg/player/22047/rarga,2024-09-18 06:35:00,,,,290,,,44,,,28,,,2,,,+3,,,,,,166,,,29%,,,10,,,7,,
297,https://vlr.gg/player/37674/mrcani,2024-09-18 06:35:00,,,,228,,,33,,,23,,,13,,,+4,,,,,,140,,,45%,,,4,,,0,,
298,https://vlr.gg/player/37927/happywei,2024-09-18 06:35:00,,,,198,,,30,,,29,,,5,,,-1,,,,,,151,,,35%,,,4,,,5,,
299,https://vlr.gg/player/5796/kr1stal,2024-09-18 06:35:00,,,,181,,,26,,,26,,,11,,,-3,,,,,,118,,,27%,,,3,,,6,,
300,https://vlr.gg/player/36668/mart1n,2024-09-18 06:35:00,,,,169,,,22,,,23,,,14,,,0,,,,,,103,,,27%,,,1,,,1,,
301,https://vlr.gg/player/4428/udotan,2024-09-18 05:00:00,,,,344,,,39,,,7,,,15,,,+3,,,,,,224,,,33%,,,4,,,1,,
302,https://vlr.gg/player/11527/noman,2024-09-18 05:00:00,,,,296,,,34,,,20,,,3,,,+4,,,,,,198,,,28%,,,6,,,2,,
303,https://vlr.gg/player/1916/free1ng,2024-09-18 05:00:00,,,,256,,,30,,,10,,,11,,,+4,,,,,,163,,,39%,,,6,,,2,,
304,https://vlr.gg/player/3531/midnight,2024-09-18 05:00:00,,,,189,,,21,,,13,,,14,,,+2,,,,,,112,,,15%,,,3,,,1,,
305,https://vlr.gg/player/45811/sn0wflake,2024-09-18 05:00:00,,,,147,,,16,,,12,,,18,,,-1,,,,,,101,,,57%,,,2,,,3,,
306,https://vlr.gg/player/47632/lilmad,2024-09-18 05:00:00,,,,160,,,16,,,28,,,3,,,-1,,,,,,104,,,35%,,,2,,,3,,
307,https://vlr.gg/player/46751/chaos,2024-09-18 05:00:00,,,,149,,,14,,,29,,,4,,,-2,,,,,,99,,,43%,,,4,,,6,,
308,https://vlr.gg/player/15549/pinklove,2024-09-18 05:00:00,,,,128,,,12,,,29,,,5,,,-2,,,,,,96,,,19%,,,1,,,3,,
309,https://vlr.gg/player/46755/volay,2024-09-18 05:00:00,,,,125,,,11,,,27,,,5,,,-3,,,,,,93,,,45%,,,2,,,5,,
310,https://vlr.gg/player/4416/link,2024-09-18 05:00:00,,,,101,,,9,,,27,,,8,,,-4,,,,,,72,,,22%,,,0,,,4,,
311,https://vlr.gg/player/8329/starbound,2024-09-17 22:00:00,0.89,1.29,1.11,202,145,244,44,15,29,37,17,20,12,5,7,+3,+1,+2,77%,67%,85%,130,93,159,23%,28%,20%,6,2,4,3,1,2
312,https://vlr.gg/player/8849/sonder,2024-09-17 22:00:00,1.38,0.88,1.10,239,284,186,49,27,22,42,18,24,16,7,9,+6,+5,+1,72%,81%,65%,147,183,118,29%,35%,22%,13,7,6,7,2,5
313,https://vlr.gg/player/9185/dodonut,2024-09-17 22:00:00,1.02,0.98,1.00,203,218,192,40,19,21,45,21,24,19,10,9,+1,+4,-3,75%,81%,71%,146,147,146,23%,24%,21%,8,7,1,7,3,4
314,https://vlr.gg/player/33694/evv,2024-09-17 22:00:00,0.86,1.09,0.99,202,149,219,43,15,28,41,18,23,15,9,6,-3,0,-3,74%,70%,76%,124,99,144,30%,28%,32%,2,1,1,5,1,4
315,https://vlr.gg/player/17/theia,2024-09-17 22:00:00,0.92,0.88,0.89,148,126,160,35,15,20,36,13,23,18,5,13,-2,-3,+1,74%,78%,71%,95,85,102,23%,23%,23%,4,0,4,6,3,3
316,https://vlr.gg/player/19556/melya,2024-09-17 22:00:00,1.24,1.14,1.19,227,235,225,52,30,22,43,23,20,16,9,7,0,0,0,69%,76%,59%,142,148,135,31%,32%,29%,1,1,0,1,1,0
317,https://vlr.gg/player/30700/elab0rate,2024-09-17 22:00:00,1.23,0.81,1.04,210,251,159,44,29,15,41,23,18,11,5,6,-2,+2,-4,70%,71%,70%,142,171,106,37%,38%,36%,8,6,2,10,4,6
318,https://vlr.gg/player/14403/marceline,2024-09-17 22:00:00,0.79,1.31,1.02,202,169,263,45,20,25,42,26,16,6,3,3,-1,-1,0,61%,53%,70%,135,112,163,30%,31%,29%,10,6,4,11,7,4
319,https://vlr.gg/player/28870/k0rupt,2024-09-17 22:00:00,0.74,0.82,0.77,160,162,176,31,19,12,44,25,19,19,7,12,+2,+2,0,69%,68%,70%,113,106,123,19%,33%,10%,6,4,2,4,2,2
320,https://vlr.gg/player/32667/nora,2024-09-17 22:00:00,0.88,0.58,0.75,142,140,137,29,16,13,41,23,18,22,16,6,-4,-1,-3,66%,68%,63%,95,99,89,31%,36%,26%,3,1,2,7,2,5
321,https://vlr.gg/player/8329/starbound,2024-09-17 19:15:00,1.26,1.35,1.30,229,226,231,49,25,24,33,18,15,15,5,10,+7,+2,+5,78%,77%,79%,154,145,163,18%,19%,17%,10,3,7,3,1,2
322,https://vlr.gg/player/8849/sonder,2024-09-17 19:15:00,1.12,1.21,1.16,237,212,271,50,23,27,43,21,22,27,14,13,-3,-6,+3,78%,71%,86%,156,141,171,23%,26%,20%,5,1,4,8,7,1
323,https://vlr.gg/player/9185/dodonut,2024-09-17 19:15:00,1.06,1.24,1.15,210,204,224,44,21,23,36,20,16,15,5,10,-5,-2,-3,70%,68%,72%,133,127,139,25%,25%,24%,4,1,3,9,3,6
324,https://vlr.gg/player/17/theia,2024-09-17 19:15:00,0.94,0.95,0.94,200,199,195,40,21,19,43,23,20,21,12,9,+2,0,+2,72%,65%,79%,132,132,132,27%,34%,21%,7,5,2,5,5,0
325,https://vlr.gg/player/33694/evv,2024-09-17 19:15:00,0.54,1.19,0.85,182,125,243,39,13,26,49,27,22,17,5,12,-1,-1,0,77%,68%,86%,122,81,167,36%,29%,40%,4,2,2,5,3,2
326,https://vlr.gg/player/14867/emluo,2024-09-17 19:15:00,1.03,1.25,1.14,244,235,252,52,24,28,43,22,21,4,1,3,+4,-3,+7,62%,55%,68%,159,147,170,38%,33%,43%,12,3,9,8,6,2
327,https://vlr.gg/player/25167/kazler,2024-09-17 19:15:00,0.80,1.21,1.01,226,197,250,45,20,25,44,23,21,15,8,7,+5,-1,+6,75%,72%,77%,157,138,175,36%,30%,40%,11,4,7,6,5,1
328,https://vlr.gg/player/28187/mili,2024-09-17 19:15:00,0.87,1.05,0.97,214,211,217,48,23,25,47,25,22,14,4,10,-2,-1,-1,70%,66%,74%,144,134,153,40%,40%,40%,1,1,0,3,2,1
329,https://vlr.gg/player/5149/rise,2024-09-17 19:15:00,0.65,1.01,0.84,162,153,175,31,14,17,43,25,18,13,7,6,-3,-2,-1,65%,55%,74%,120,112,127,28%,27%,28%,5,3,2,8,5,3
330,https://vlr.gg/player/25400/riv,2024-09-17 19:15:00,0.76,0.63,0.70,135,160,116,28,15,13,46,24,22,17,8,9,-4,0,-4,65%,62%,68%,95,109,81,29%,23%,37%,1,0,1,5,0,5
331,https://vlr.gg/player/28870/k0rupt,2024-09-17 17:00:00,1.58,1.30,1.44,284,282,286,42,20,22,28,13,15,11,7,4,-1,+3,-4,76%,70%,81%,199,195,202,28%,24%,32%,3,3,0,4,0,4
332,https://vlr.gg/player/19556/melya,2024-09-17 17:00:00,0.85,1.41,1.14,231,199,263,32,12,20,29,17,12,25,13,12,0,-1,+1,83%,70%,95%,147,129,164,39%,39%,38%,1,0,1,1,1,0
333,https://vlr.gg/player/32667/nora,2024-09-17 17:00:00,0.89,1.22,1.06,196,182,211,28,13,15,26,15,11,16,8,8,+1,-3,+4,83%,75%,90%,136,120,151,25%,24%,26%,5,1,4,4,4,0
334,https://vlr.gg/player/30700/elab0rate,2024-09-17 17:00:00,1.06,0.93,1.00,174,182,169,29,15,14,26,14,12,3,2,1,-1,-1,0,76%,75%,76%,121,128,114,32%,30%,35%,3,1,2,4,2,2
335,https://vlr.gg/player/14403/marceline,2024-09-17 17:00:00,0.68,1.14,0.92,191,178,203,28,12,16,31,18,13,9,1,8,+6,+4,+2,63%,50%,76%,128,104,151,26%,18%,34%,11,6,5,5,2,3
336,https://vlr.gg/player/17951/karie,2024-09-17 17:00:00,0.99,1.36,1.17,250,215,287,38,15,23,31,17,14,3,3,0,+2,+2,0,76%,76%,75%,178,155,201,37%,36%,38%,6,3,3,4,1,3
337,https://vlr.gg/player/11949/panini,2024-09-17 17:00:00,0.87,1.32,1.09,258,241,276,35,16,19,34,20,14,15,7,8,0,-1,+1,71%,76%,65%,161,154,169,35%,34%,36%,2,0,2,2,1,1
338,https://vlr.gg/player/17950/avery,2024-09-17 17:00:00,0.61,1.11,0.85,177,114,245,24,8,16,32,17,15,19,10,9,+1,-1,+2,85%,76%,95%,131,88,176,32%,42%,28%,2,0,2,1,1,0
339,https://vlr.gg/player/28549/superkat,2024-09-17 17:00:00,0.93,0.67,0.80,172,225,117,24,16,8,31,17,14,5,2,3,0,0,0,68%,76%,60%,114,139,88,28%,27%,28%,8,6,2,8,6,2
340,https://vlr.gg/player/26032/panday,2024-09-17 17:00:00,0.63,0.62,0.63,119,104,134,18,8,10,31,16,15,9,5,4,-8,-3,-5,71%,76%,65%,83,70,97,27%,26%,28%,0,0,0,8,3,5
341,https://vlr.gg/player/21158/marti,2024-09-17 13:35:00,1.68,1.42,1.55,298,348,252,44,24,20,26,13,13,11,5,6,+2,+3,-1,83%,90%,77%,204,228,182,30%,30%,30%,11,8,3,9,5,4
342,https://vlr.gg/player/20761/looxie,2024-09-17 13:35:00,1.15,1.27,1.22,206,176,231,32,13,19,26,13,13,20,11,9,-5,-3,-2,81%,75%,86%,139,131,146,50%,63%,43%,2,1,1,7,4,3
343,https://vlr.gg/player/30186/nami,2024-09-17 13:35:00,1.11,1.31,1.21,221,230,210,34,15,19,27,15,12,19,14,5,+1,+1,0,83%,80%,86%,143,159,127,37%,30%,45%,2,1,1,1,0,1
344,https://vlr.gg/player/24058/tokameite,2024-09-17 13:35:00,1.25,0.82,1.02,157,198,125,25,16,9,24,11,13,26,16,10,-5,-1,-4,69%,80%,59%,106,136,78,26%,32%,19%,1,0,1,6,1,5
345,https://vlr.gg/player/39057/safiaa,2024-09-17 13:35:00,1.30,0.73,1.00,176,225,135,28,18,10,25,11,14,12,5,7,+1,0,+1,71%,75%,68%,122,163,85,36%,46%,26%,2,0,2,1,0,1
346,https://vlr.gg/player/11183/glance,2024-09-17 13:35:00,1.10,0.93,1.02,204,198,206,28,15,13,31,14,17,21,9,12,+2,0,+2,71%,77%,65%,134,139,129,33%,36%,31%,4,1,3,2,1,1
347,https://vlr.gg/player/21153/matrix,2024-09-17 13:35:00,1.04,0.68,0.87,211,226,190,30,18,12,35,15,20,5,0,5,+5,+4,+1,62%,55%,70%,136,141,130,36%,55%,26%,8,6,2,3,2,1
348,https://vlr.gg/player/19356/kuripuuya,2024-09-17 13:35:00,0.85,0.84,0.84,153,144,165,21,11,10,30,14,16,17,7,10,+1,+1,0,64%,59%,70%,98,93,104,21%,31%,12%,5,2,3,4,1,3
349,https://vlr.gg/player/16419/roxi,2024-09-17 13:35:00,1.02,0.64,0.84,176,208,149,24,14,10,31,15,16,9,5,4,-1,0,-1,57%,64%,50%,122,142,100,32%,31%,33%,5,3,2,6,3,3
350,https://vlr.gg/player/16321/nelo,2024-09-17 13:35:00,0.49,1.10,0.78,163,108,226,24,7,17,36,19,17,27,16,11,-1,+1,-2,79%,77%,80%,105,58,155,37%,35%,38%,2,2,0,3,1,2
351,https://vlr.gg/player/24107/sarah,2024-09-17 11:00:00,0.94,1.80,1.34,248,170,308,44,16,28,29,18,11,29,10,19,+3,0,+3,84%,85%,83%,143,100,190,32%,32%,32%,5,2,3,2,2,0
352,https://vlr.gg/player/16418/smurfette,2024-09-17 11:00:00,1.14,1.31,1.22,265,278,278,46,23,23,33,19,14,10,4,6,+6,0,+6,76%,69%,83%,187,189,184,22%,22%,22%,12,4,8,6,4,2
353,https://vlr.gg/player/17343/ness,2024-09-17 11:00:00,1.07,1.23,1.15,194,203,206,35,17,18,27,16,11,12,9,3,+1,0,+1,86%,85%,87%,137,138,137,28%,26%,30%,4,2,2,3,2,1
354,https://vlr.gg/player/26632/joliinaa,2024-09-17 11:00:00,0.95,1.01,0.98,180,161,196,31,15,16,30,16,14,24,11,13,+5,+1,+4,90%,88%,91%,115,106,126,18%,16%,20%,7,2,5,2,1,1
355,https://vlr.gg/player/24101/miyori,2024-09-17 11:00:00,0.84,0.93,0.88,211,206,197,34,19,15,35,19,16,10,2,8,-4,-3,-1,67%,65%,70%,129,125,134,27%,36%,19%,2,2,0,6,5,1
356,https://vlr.gg/player/24071/liza,2024-09-17 11:00:00,0.68,1.29,1.00,214,179,259,35,13,22,39,21,18,12,4,8,+2,0,+2,61%,48%,73%,142,117,164,27%,23%,31%,10,4,6,8,4,4
357,https://vlr.gg/player/22792/jiex,2024-09-17 11:00:00,0.71,1.17,0.96,206,188,211,33,13,20,38,21,17,18,9,9,-1,-2,+1,67%,57%,77%,137,125,147,38%,42%,35%,2,0,2,3,2,1
358,https://vlr.gg/player/17394/ninou,2024-09-17 11:00:00,0.73,1.03,0.89,182,175,203,31,14,17,38,20,18,16,8,8,-2,-4,+2,59%,61%,58%,124,108,138,18%,26%,14%,4,0,4,6,4,2
359,https://vlr.gg/player/20098/mel,2024-09-17 11:00:00,0.54,1.09,0.83,166,140,195,29,11,18,38,20,18,16,6,10,-8,-5,-3,71%,65%,77%,108,89,125,27%,30%,24%,2,1,1,10,6,4
360,https://vlr.gg/player/38142/dream,2024-09-17 11:00:00,0.94,0.54,0.73,160,200,130,26,15,11,37,18,19,5,1,4,-2,-2,0,67%,70%,65%,108,139,81,24%,21%,31%,1,0,1,3,2,1
361,https://vlr.gg/player/17951/karie,2024-09-16 20:00:00,2.03,1.46,1.77,297,349,226,43,27,16,17,9,8,12,8,4,+2,+1,+1,81%,85%,76%,199,233,159,46%,52%,36%,4,2,2,2,1,1
362,https://vlr.gg/player/11949/panini,2024-09-16 20:00:00,1.22,1.62,1.41,273,217,338,36,17,19,22,10,12,11,4,7,+3,+1,+2,76%,75%,76%,178,137,226,34%,38%,31%,6,3,3,3,2,1
363,https://vlr.gg/player/28549/superkat,2024-09-16 20:00:00,0.98,1.43,1.19,225,184,266,30,14,16,24,13,11,7,2,5,+4,+1,+3,81%,80%,82%,147,134,163,39%,46%,34%,8,4,4,4,3,1
364,https://vlr.gg/player/17950/avery,2024-09-16 20:00:00,0.96,1.32,1.12,187,176,220,26,12,14,21,13,8,13,9,4,+1,+2,-1,81%,80%,82%,139,117,163,32%,23%,45%,3,2,1,2,0,2
365,https://vlr.gg/player/26032/panday,2024-09-16 20:00:00,1.26,0.57,0.94,172,252,81,21,16,5,23,13,10,15,11,4,-1,+1,-2,76%,85%,65%,131,193,58,31%,35%,19%,2,2,0,3,1,2
366,https://vlr.gg/player/30395/edith,2024-09-16 20:00:00,0.87,1.28,1.09,262,200,318,31,11,20,30,13,17,7,3,4,-1,-1,0,73%,71%,75%,166,126,199,23%,20%,24%,3,1,2,4,2,2
367,https://vlr.gg/player/14722/slandy,2024-09-16 20:00:00,0.84,0.90,0.87,145,138,148,21,9,12,27,11,16,5,2,3,-2,-1,-1,59%,53%,65%,98,95,100,25%,33%,20%,0,0,0,2,1,1
368,https://vlr.gg/player/6575/aniemal,2024-09-16 20:00:00,0.84,0.58,0.70,162,165,151,21,10,11,29,12,17,2,2,0,0,0,0,51%,59%,45%,106,102,110,22%,15%,29%,2,1,1,2,1,1
369,https://vlr.gg/player/25510/teddyisfluffy,2024-09-16 20:00:00,0.66,0.61,0.63,182,218,163,24,13,11,38,19,19,10,4,6,+2,+1,+1,62%,59%,65%,117,135,101,29%,31%,27%,8,4,4,6,3,3
370,https://vlr.gg/player/28547/habibti,2024-09-16 20:00:00,0.26,0.30,0.28,97,114,82,10,6,4,32,15,17,6,1,5,-8,-2,-6,38%,35%,40%,75,78,72,21%,25%,18%,1,1,0,9,3,6
371,https://vlr.gg/player/8329/starbound,2024-09-16 19:00:00,1.22,2.93,1.64,267,207,448,17,10,7,6,6,0,4,2,2,+1,-1,+2,81%,75%,100%,189,152,299,18%,21%,11%,3,1,2,2,2,0
372,https://vlr.gg/player/8849/sonder,2024-09-16 19:00:00,1.27,2.72,1.63,271,221,423,18,10,8,6,6,0,11,8,3,+3,+2,+1,94%,92%,100%,149,136,188,20%,26%,14%,3,2,1,0,0,0
373,https://vlr.gg/player/9185/dodonut,2024-09-16 19:00:00,1.67,1.14,1.54,287,356,82,17,16,1,8,7,1,10,8,2,0,-1,+1,94%,92%,100%,169,214,34,24%,24%,25%,1,0,1,1,1,0
374,https://vlr.gg/player/17/theia,2024-09-16 19:00:00,1.43,0.96,1.31,229,262,132,13,11,2,7,5,2,3,2,1,+1,+1,0,88%,83%,100%,158,171,118,29%,27%,38%,3,3,0,2,2,0
375,https://vlr.gg/player/33694/evv,2024-09-16 19:00:00,0.69,1.70,0.94,145,129,195,8,6,2,7,7,0,5,1,4,+1,+1,0,88%,83%,100%,114,101,154,48%,54%,40%,1,1,0,0,0,0
376,https://vlr.gg/player/28546/venus,2024-09-16 19:00:00,0.25,0.95,0.78,172,116,191,9,1,8,15,4,11,1,0,1,-2,0,-2,38%,25%,42%,111,82,120,41%,38%,42%,2,0,2,4,0,4
377,https://vlr.gg/player/21127/korosu,2024-09-16 19:00:00,0.01,1.03,0.70,140,3,186,8,0,8,13,4,9,1,0,1,-2,-2,0,50%,,67%,89,5,117,45%,33%,47%,0,0,0,2,2,0
378,https://vlr.gg/player/28530/calsushi,2024-09-16 19:00:00,0.32,0.70,0.61,152,88,174,8,1,7,15,4,11,1,0,1,0,0,0,38%,25%,42%,102,65,115,39%,33%,40%,1,0,1,1,0,1
379,https://vlr.gg/player/37920/oranges,2024-09-16 19:00:00,0.23,0.45,0.40,90,50,104,4,0,4,15,4,11,3,1,2,-1,0,-1,50%,25%,58%,64,43,71,21%,20%,21%,0,0,0,1,0,1
380,https://vlr.gg/player/43380/aria,2024-09-16 19:00:00,0.04,0.49,0.37,113,84,124,5,1,4,15,4,11,3,0,3,-1,-2,+1,50%,25%,58%,74,53,81,30%,100%,22%,2,0,2,3,2,1
381,https://vlr.gg/player/21127/korosu,2024-09-16 18:00:00,1.97,2.95,2.04,368,354,535,20,20,0,4,4,0,1,1,0,+1,+1,0,85%,83%,100%,251,253,228,45%,46%,40%,1,1,0,0,0,0
382,https://vlr.gg/player/37920/oranges,2024-09-16 18:00:00,1.76,2.44,1.81,227,233,161,10,10,0,3,3,0,12,12,0,+3,+3,0,100%,100%,100%,136,138,105,27%,24%,100%,3,3,0,0,0,0
383,https://vlr.gg/player/28530/calsushi,2024-09-16 18:00:00,1.79,1.41,1.76,191,222,-176,9,10,-1,1,1,0,5,4,1,+1,+1,0,100%,100%,100%,133,144,,39%,39%,,1,1,0,0,0,0
384,https://vlr.gg/player/28546/venus,2024-09-16 18:00:00,1.81,0.54,1.71,361,349,505,17,16,1,6,6,0,4,4,0,+4,+3,+1,100%,100%,100%,241,248,159,45%,44%,100%,5,4,1,1,1,0
385,https://vlr.gg/player/43380/aria,2024-09-16 18:00:00,1.37,2.72,1.48,193,195,174,9,9,0,4,4,0,10,9,1,0,0,0,92%,92%,100%,131,123,221,32%,29%,50%,1,1,0,1,1,0
386,https://vlr.gg/player/47912/ali-san,2024-09-16 18:00:00,1.26,0.44,0.50,162,224,157,7,1,6,13,1,12,1,0,1,-4,0,-4,46%,100%,42%,114,105,114,33%,100%,29%,0,0,0,4,0,4
387,https://vlr.gg/player/47915/butter,2024-09-16 18:00:00,0.01,0.56,0.48,138,,150,5,0,5,13,1,12,2,0,2,-1,0,-1,38%,,42%,91,,99,32%,,32%,0,0,0,1,0,1
388,https://vlr.gg/player/47914/mel,2024-09-16 18:00:00,0.01,0.49,0.44,144,22,155,5,0,5,13,1,12,1,0,1,0,0,0,31%,,33%,114,22,122,16%,0%,16%,2,0,2,2,0,2
389,https://vlr.gg/player/47916/cawfee,2024-09-16 18:00:00,0.22,0.03,0.03,25,26,25,0,0,0,13,1,12,1,0,1,-1,0,-1,8%,,8%,23,26,23,13%,0%,14%,0,0,0,1,0,1
390,https://vlr.gg/player/47913/marz,2024-09-16 18:00:00,0.02,0.03,0.03,40,,44,1,0,1,13,1,12,1,0,1,-3,-1,-2,31%,100%,25%,32,,35,15%,,15%,0,0,0,3,1,2
391,https://vlr.gg/player/6575/aniemal,2024-09-16 17:00:00,0.65,1.50,0.99,211,153,299,14,5,9,14,9,5,3,3,0,0,-1,+1,65%,58%,75%,146,118,188,37%,29%,45%,1,0,1,1,1,0
392,https://vlr.gg/player/28547/habibti,2024-09-16 17:00:00,0.55,1.40,0.89,172,91,295,11,3,8,14,9,5,2,2,0,+1,0,+1,55%,50%,63%,113,73,174,21%,22%,21%,2,1,1,1,1,0
393,https://vlr.gg/player/30395/edith,2024-09-16 17:00:00,0.78,0.94,0.84,232,208,271,15,8,7,18,11,7,7,5,2,-2,-1,-1,65%,67%,63%,156,147,170,21%,18%,24%,2,2,0,4,3,1
394,https://vlr.gg/player/25510/teddyisfluffy,2024-09-16 17:00:00,1.17,0.31,0.82,174,223,101,13,10,3,15,8,7,9,6,3,-3,+1,-4,65%,67%,63%,125,160,73,19%,14%,43%,2,2,0,5,1,4
395,https://vlr.gg/player/14722/slandy,2024-09-16 17:00:00,0.88,0.68,0.80,111,111,112,8,5,3,14,8,6,8,4,4,-2,-1,-1,55%,42%,75%,66,63,72,17%,30%,8%,0,0,0,2,1,1
396,https://vlr.gg/player/19556/melya,2024-09-16 17:00:00,1.94,0.97,1.36,203,318,128,15,10,5,11,5,6,7,3,4,0,+1,-1,65%,63%,67%,129,193,86,38%,40%,35%,1,1,0,1,0,1
397,https://vlr.gg/player/32667/nora,2024-09-16 17:00:00,1.21,1.44,1.35,252,273,239,17,7,10,12,6,6,9,3,6,+3,+2,+1,80%,63%,92%,160,155,163,49%,28%,68%,3,2,1,0,0,0
398,https://vlr.gg/player/14403/marceline,2024-09-16 17:00:00,0.66,1.46,1.14,270,133,363,19,4,15,14,6,8,2,2,0,+4,+1,+3,80%,75%,83%,181,99,236,37%,29%,41%,6,2,4,2,1,1
399,https://vlr.gg/player/30700/elab0rate,2024-09-16 17:00:00,0.44,1.46,1.05,158,60,224,13,2,11,12,6,6,3,3,0,0,-1,+1,65%,63%,67%,107,47,148,33%,67%,30%,2,0,2,2,1,1
400,https://vlr.gg/player/28870/k0rupt,2024-09-16 17:00:00,0.91,0.85,0.87,169,258,111,11,7,4,12,7,5,6,2,4,-1,+1,-2,80%,88%,75%,131,185,95,33%,45%,15%,1,1,0,2,0,2
401,https://vlr.gg/player/38142/dream,2024-09-16 13:10:00,1.32,1.36,1.34,234,261,187,36,25,11,20,14,6,11,4,7,+4,+2,+2,83%,80%,88%,139,154,117,21%,24%,13%,6,3,3,2,1,1
402,https://vlr.gg/player/24071/liza,2024-09-16 13:10:00,1.46,0.89,1.23,280,318,221,41,29,12,29,17,12,7,4,3,0,+2,-2,74%,76%,71%,183,209,144,30%,33%,24%,10,8,2,10,6,4
403,https://vlr.gg/player/22792/jiex,2024-09-16 13:10:00,0.99,1.49,1.19,231,193,266,34,18,16,25,16,9,18,7,11,0,0,0,83%,88%,76%,138,118,168,43%,42%,43%,2,2,0,2,2,0
404,https://vlr.gg/player/17394/ninou,2024-09-16 13:10:00,0.98,1.41,1.15,188,138,258,26,12,14,21,14,7,17,10,7,+1,0,+1,86%,80%,94%,118,106,135,22%,25%,19%,3,1,2,2,1,1
405,https://vlr.gg/player/20098/mel,2024-09-16 13:10:00,0.98,1.02,1.00,158,143,169,24,13,11,24,15,9,19,11,8,-5,-1,-4,79%,76%,82%,106,110,99,34%,29%,43%,0,0,0,5,1,4
406,https://vlr.gg/player/47911/berryx,2024-09-16 13:10:00,0.86,1.03,0.96,170,169,181,26,9,17,30,13,17,13,6,7,0,0,0,60%,59%,60%,119,118,119,37%,35%,38%,0,0,0,0,0,0
407,https://vlr.gg/player/29442/wens,2024-09-16 13:10:00,0.80,0.93,0.88,193,181,204,28,10,18,32,13,19,5,1,4,+2,+2,0,62%,53%,68%,127,125,128,42%,40%,43%,6,3,3,4,1,3
408,https://vlr.gg/player/17332/jduh,2024-09-16 13:10:00,0.64,0.99,0.85,142,80,192,20,4,16,30,11,19,14,4,10,-1,0,-1,64%,59%,68%,84,45,111,24%,25%,24%,1,1,0,2,1,1
409,https://vlr.gg/player/23049/alkyia,2024-09-16 13:10:00,0.94,0.56,0.70,194,249,177,26,14,12,36,14,22,6,1,5,+3,+2,+1,55%,71%,44%,140,168,120,35%,43%,27%,11,5,6,8,3,5
410,https://vlr.gg/player/19363/proxima,2024-09-16 13:10:00,0.55,0.73,0.66,150,107,156,19,6,13,33,13,20,8,1,7,-4,-1,-3,60%,65%,56%,86,75,93,40%,32%,45%,3,1,2,7,2,5
411,https://vlr.gg/player/17323/mimi,2024-09-16 11:00:00,1.18,1.50,1.36,229,157,266,36,13,23,22,8,14,9,2,7,-2,-1,-1,73%,74%,72%,148,99,185,44%,50%,41%,0,0,0,2,1,1
412,https://vlr.gg/player/20064/vania,2024-09-16 11:00:00,1.17,1.28,1.23,210,190,223,33,14,19,24,10,14,22,7,15,-2,0,-2,82%,79%,84%,132,128,136,40%,39%,41%,2,1,1,4,1,3
413,https://vlr.gg/player/36175/rezq,2024-09-16 11:00:00,1.07,0.94,1.00,267,268,239,37,17,20,32,15,17,10,4,6,+7,+1,+6,70%,74%,68%,160,172,151,21%,20%,22%,13,4,9,6,3,3
414,https://vlr.gg/player/24149/amy,2024-09-16 11:00:00,0.93,0.82,0.87,175,219,140,27,13,14,30,14,16,11,8,3,+4,+3,+1,77%,84%,72%,109,141,85,34%,39%,29%,6,4,2,2,1,1
415,https://vlr.gg/player/17320/petra,2024-09-16 11:00:00,1.25,0.57,0.87,165,250,122,29,18,11,30,12,18,8,2,6,-5,-2,-3,66%,79%,56%,118,151,93,29%,29%,29%,2,1,1,7,3,4
416,https://vlr.gg/player/24058/tokameite,2024-09-16 11:00:00,1.23,0.96,1.11,187,205,173,31,19,12,29,15,14,16,12,4,-1,-2,+1,80%,88%,68%,125,130,118,40%,36%,45%,2,0,2,3,2,1
417,https://vlr.gg/player/30186/nami,2024-09-16 11:00:00,1.14,1.02,1.09,207,229,195,33,20,13,33,19,14,14,5,9,+1,+1,0,77%,80%,74%,141,150,129,34%,51%,21%,6,3,3,5,2,3
418,https://vlr.gg/player/39057/safiaa,2024-09-16 11:00:00,1.42,0.64,1.08,203,259,142,33,24,9,32,16,16,7,2,5,+2,+3,-1,66%,64%,68%,143,178,97,43%,55%,23%,3,3,0,1,0,1
419,https://vlr.gg/player/21158/marti,2024-09-16 11:00:00,0.50,0.99,0.71,189,127,271,23,8,15,34,18,16,13,7,6,-4,-2,-2,59%,52%,68%,131,97,176,18%,12%,24%,5,3,2,9,5,4
420,https://vlr.gg/player/20761/looxie,2024-09-16 11:00:00,0.65,0.78,0.69,123,113,167,18,8,10,34,19,15,24,14,10,0,-1,+1,68%,64%,74%,84,72,101,22%,21%,24%,5,3,2,5,4,1
421,https://vlr.gg/player/13861/nicomachine,2024-09-15 19:50:00,1.06,1.46,1.25,230,199,267,58,27,31,46,26,20,40,18,22,-2,0,-2,84%,80%,89%,154,123,189,27%,36%,21%,3,3,0,5,3,2
422,https://vlr.gg/player/3826/adverso,2024-09-15 19:50:00,1.37,1.04,1.22,229,256,197,56,35,21,51,27,24,36,17,19,+3,+3,0,79%,78%,80%,155,178,130,33%,33%,32%,7,3,4,4,0,4
423,https://vlr.gg/player/9354/cebando,2024-09-15 19:50:00,1.12,0.83,0.99,205,233,163,52,33,19,55,30,25,29,16,13,-2,-3,+1,71%,68%,74%,130,151,107,36%,47%,25%,6,2,4,8,5,3
424,https://vlr.gg/player/41135/dantedeu5,2024-09-15 19:50:00,0.93,0.98,0.95,228,224,240,60,31,29,59,30,29,18,9,9,-3,-2,-1,72%,70%,74%,134,126,144,26%,26%,26%,15,9,6,18,11,7
425,https://vlr.gg/player/2585/tinchoff,2024-09-15 19:50:00,0.55,1.06,0.79,140,113,176,39,15,24,52,29,23,17,5,12,-5,-4,-1,68%,58%,80%,100,81,121,31%,28%,33%,2,0,2,7,4,3
426,https://vlr.gg/player/3702/sym,2024-09-15 19:50:00,1.20,1.27,1.23,265,272,266,70,33,37,53,26,27,19,9,10,+11,+7,+4,83%,83%,83%,168,164,172,32%,36%,29%,20,12,8,9,5,4
427,https://vlr.gg/player/64/gmd,2024-09-15 19:50:00,1.31,1.14,1.22,248,260,244,65,30,35,54,23,31,34,12,22,+8,+4,+4,79%,83%,75%,160,172,149,21%,20%,21%,10,4,6,2,0,2
428,https://vlr.gg/player/8376/seven,2024-09-15 19:50:00,0.86,0.92,0.89,197,176,216,49,22,27,55,25,30,24,8,16,-3,-6,+3,83%,77%,88%,131,114,145,17%,18%,17%,8,1,7,11,7,4
429,https://vlr.gg/player/849/poised,2024-09-15 19:50:00,0.93,0.70,0.81,152,201,120,42,23,19,54,26,28,23,15,8,-4,0,-4,77%,77%,78%,104,133,79,26%,30%,21%,2,1,1,6,1,5
430,https://vlr.gg/player/740/aproto,2024-09-15 19:50:00,0.56,0.99,0.79,136,104,162,37,13,24,49,24,25,16,6,10,-3,-2,-1,72%,77%,68%,94,78,109,32%,24%,38%,2,1,1,5,3,2
431,https://vlr.gg/player/11921/silentzz,2024-09-15 17:20:00,1.09,1.31,1.19,230,201,279,42,20,22,38,21,17,6,3,3,0,-1,+1,60%,56%,65%,149,116,188,34%,36%,33%,6,2,4,6,3,3
432,https://vlr.gg/player/662/pryze,2024-09-15 17:20:00,0.68,1.18,0.91,177,168,209,30,14,16,38,24,14,17,6,11,0,-1,+1,72%,70%,74%,133,119,148,19%,16%,21%,4,1,3,4,2,2
433,https://vlr.gg/player/3169/zap,2024-09-15 17:20:00,0.57,1.31,0.91,150,110,193,26,9,17,33,21,12,19,5,14,0,0,0,64%,48%,83%,98,74,126,23%,24%,22%,0,0,0,0,0,0
434,https://vlr.gg/player/21661/spike,2024-09-15 17:20:00,0.46,1.28,0.84,238,159,302,36,11,25,42,25,17,16,11,5,-3,-7,+4,64%,56%,74%,140,107,179,31%,29%,33%,10,5,5,13,12,1
435,https://vlr.gg/player/6195/lz,2024-09-15 17:20:00,0.65,0.60,0.63,122,143,87,20,14,6,37,24,13,13,6,7,-3,-2,-1,64%,59%,70%,69,83,53,24%,24%,25%,2,0,2,5,2,3
436,https://vlr.gg/player/8082/zander,2024-09-15 17:20:00,1.37,1.57,1.48,274,281,253,48,22,26,26,16,10,20,7,13,+4,+2,+2,84%,78%,89%,160,172,150,37%,46%,30%,7,4,3,3,2,1
437,https://vlr.gg/player/4828/nismo,2024-09-15 17:20:00,1.28,1.27,1.28,240,239,263,43,19,24,33,16,17,25,11,14,+7,+2,+5,82%,87%,78%,159,153,164,27%,39%,21%,7,2,5,0,0,0
438,https://vlr.gg/player/864/bcj,2024-09-15 17:20:00,0.61,1.45,1.07,222,154,283,40,11,29,34,18,16,20,7,13,0,-2,+2,76%,65%,85%,138,91,178,19%,10%,24%,3,0,3,3,2,1
439,https://vlr.gg/player/3722/koalanoob,2024-09-15 17:20:00,0.65,1.33,1.02,211,166,261,38,13,25,30,17,13,4,0,4,-2,-5,+3,68%,43%,89%,128,90,161,26%,34%,20%,10,3,7,12,8,4
440,https://vlr.gg/player/6582/net,2024-09-15 17:20:00,0.41,0.86,0.65,115,108,106,19,8,11,31,19,12,11,5,6,-3,-2,-1,70%,61%,78%,66,68,65,30%,40%,24%,1,0,1,4,2,2
441,https://vlr.gg/player/1294/nagz,2024-09-15 15:00:00,0.86,0.97,0.91,208,233,169,30,19,11,31,21,10,8,3,5,-2,0,-2,68%,63%,76%,135,146,119,27%,25%,29%,4,3,1,6,3,3
442,https://vlr.gg/player/2468/delz1k,2024-09-15 15:00:00,0.99,0.74,0.89,199,206,162,26,17,9,30,19,11,13,10,3,-4,-1,-3,78%,88%,65%,119,132,101,25%,27%,20%,2,1,1,6,2,4
443,https://vlr.gg/player/8892/snw,2024-09-15 15:00:00,0.56,1.28,0.86,177,123,260,26,11,15,29,18,11,4,2,2,+1,-1,+2,61%,54%,71%,118,77,175,16%,17%,15%,5,2,3,4,3,1
444,https://vlr.gg/player/2464/suther,2024-09-15 15:00:00,0.62,0.86,0.72,153,122,210,20,10,10,32,19,13,11,4,7,0,-1,+1,63%,58%,71%,103,79,136,24%,24%,24%,5,3,2,5,4,1
445,https://vlr.gg/player/783/murizzz,2024-09-15 15:00:00,0.71,0.62,0.67,134,157,114,18,12,6,31,20,11,16,12,4,+2,+1,+1,68%,67%,71%,94,107,76,25%,23%,30%,3,2,1,1,1,0
446,https://vlr.gg/player/6238/urango,2024-09-15 15:00:00,1.50,1.29,1.37,248,289,226,37,17,20,25,11,14,12,4,8,+1,+1,0,76%,82%,71%,166,183,153,30%,30%,30%,3,1,2,2,0,2
447,https://vlr.gg/player/21659/sato,2024-09-15 15:00:00,1.04,1.53,1.33,283,211,310,42,14,28,26,11,15,5,0,5,+3,0,+3,68%,71%,67%,159,126,182,31%,32%,30%,11,4,7,8,4,4
448,https://vlr.gg/player/1688/rood,2024-09-15 15:00:00,1.10,1.34,1.24,211,148,244,31,10,21,23,9,14,12,5,7,+2,-1,+3,85%,76%,92%,139,105,162,24%,30%,21%,3,0,3,1,1,0
449,https://vlr.gg/player/1994/evilkyk,2024-09-15 15:00:00,1.02,1.17,1.11,182,121,227,24,7,17,22,7,15,18,6,12,-2,-1,-1,78%,82%,75%,124,85,153,21%,38%,17%,1,0,1,3,1,2
450,https://vlr.gg/player/28716/lukxo,2024-09-15 15:00:00,0.73,0.94,0.85,125,145,104,19,8,11,24,13,11,12,7,5,-1,+2,-3,73%,76%,71%,83,89,78,21%,15%,28%,4,4,0,5,2,3
451,https://vlr.gg/player/36175/rezq,2024-09-15 13:20:00,1.67,1.74,1.72,348,346,348,46,17,29,23,7,16,12,2,10,+6,+2,+4,89%,92%,88%,226,216,231,23%,23%,22%,11,4,7,5,2,3
452,https://vlr.gg/player/20064/vania,2024-09-15 13:20:00,1.46,1.38,1.41,237,202,258,33,10,23,18,4,14,16,7,9,+3,+1,+2,78%,85%,75%,151,131,162,51%,48%,52%,5,1,4,2,0,2
453,https://vlr.gg/player/17320/petra,2024-09-15 13:20:00,1.39,1.32,1.35,230,182,256,33,10,23,17,3,14,14,2,12,+3,+3,0,92%,92%,92%,157,120,178,33%,50%,27%,4,3,1,1,0,1
454,https://vlr.gg/player/24149/amy,2024-09-15 13:20:00,1.58,0.94,1.16,179,182,176,25,10,15,17,2,15,11,2,9,+1,+1,0,84%,92%,79%,129,130,129,36%,32%,38%,3,1,2,2,0,2
455,https://vlr.gg/player/17323/mimi,2024-09-15 13:20:00,1.65,0.75,1.07,162,225,130,22,11,11,17,2,15,13,3,10,0,+2,-2,81%,92%,75%,94,130,75,38%,47%,32%,2,2,0,2,0,2
456,https://vlr.gg/player/20116/jademwah,2024-09-15 13:20:00,1.30,0.34,0.96,193,257,77,25,22,3,28,17,11,6,5,1,-1,-1,0,43%,54%,23%,125,164,53,24%,27%,13%,3,2,1,4,3,1
457,https://vlr.gg/player/39506/cabbit,2024-09-15 13:20:00,0.82,0.39,0.67,169,196,119,20,16,4,34,22,12,9,7,2,+1,+2,-1,62%,67%,54%,102,116,75,49%,53%,38%,5,4,1,4,2,2
458,https://vlr.gg/player/20058/devilasxa,2024-09-15 13:20:00,0.71,0.42,0.61,141,145,134,18,12,6,32,19,13,8,7,1,-2,0,-2,51%,58%,38%,93,95,90,26%,25%,28%,1,1,0,3,1,2
459,https://vlr.gg/player/16196/annie,2024-09-15 13:20:00,0.67,0.19,0.50,123,157,61,16,13,3,33,21,12,4,4,0,-8,-3,-5,57%,75%,23%,79,100,39,28%,31%,18%,2,2,0,10,5,5
460,https://vlr.gg/player/7460/6sonya,2024-09-15 13:20:00,0.49,0.20,0.39,109,141,53,13,11,2,32,22,10,7,6,1,-3,-2,-1,54%,63%,38%,79,104,33,42%,40%,67%,1,1,0,4,3,1
461,https://vlr.gg/player/1507/avova,2024-09-15 12:00:00,1.35,0.98,1.18,191,221,165,77,48,29,65,32,33,47,30,17,-2,-2,0,77%,77%,77%,121,136,105,33%,28%,42%,9,5,4,11,7,4
462,https://vlr.gg/player/129/hype,2024-09-15 12:00:00,1.33,0.76,1.07,193,226,155,73,47,26,71,34,37,23,16,7,+4,+5,-1,67%,74%,58%,129,151,102,30%,30%,29%,11,9,2,7,4,3
463,https://vlr.gg/player/1281/molsi,2024-09-15 12:00:00,0.95,1.05,1.00,208,199,221,73,40,33,75,39,36,43,23,20,+4,+2,+2,70%,74%,65%,133,121,146,22%,21%,24%,8,4,4,4,2,2
464,https://vlr.gg/player/101/soulcas,2024-09-15 12:00:00,1.19,0.68,0.96,178,208,144,68,46,22,73,35,38,32,19,13,-4,0,-4,69%,75%,60%,119,137,97,42%,48%,36%,4,3,1,8,3,5
465,https://vlr.gg/player/9554/kaajak,2024-09-15 12:00:00,0.64,1.08,0.84,222,190,241,77,37,40,84,47,37,16,8,8,+3,-2,+5,61%,60%,63%,133,123,146,35%,42%,29%,23,9,14,20,11,9
466,https://vlr.gg/player/31305/lar0k,2024-09-15 12:00:00,1.36,1.00,1.17,201,221,186,76,41,35,67,26,41,33,15,18,0,+3,-3,68%,73%,63%,140,150,130,35%,37%,32%,8,5,3,8,2,6
467,https://vlr.gg/player/31855/celasun,2024-09-15 12:00:00,1.10,0.88,0.98,181,195,177,74,37,37,69,29,40,11,7,4,-1,+1,-2,72%,77%,68%,127,133,122,33%,35%,32%,6,2,4,7,1,6
468,https://vlr.gg/player/40591/comeback,2024-09-15 12:00:00,0.80,1.03,0.92,234,222,242,86,38,48,82,37,45,13,7,6,+1,-3,+4,68%,65%,70%,149,140,157,30%,29%,31%,20,10,10,19,13,6
469,https://vlr.gg/player/5565/ros,2024-09-15 12:00:00,1.16,0.73,0.92,177,206,158,67,36,31,72,27,45,24,12,12,-1,0,-1,70%,73%,67%,126,145,109,31%,31%,31%,7,5,2,8,5,3
470,https://vlr.gg/player/24344/loita,2024-09-15 12:00:00,1.00,0.80,0.89,183,175,191,65,29,36,78,31,47,42,25,17,-4,-3,-1,70%,77%,65%,117,115,120,40%,38%,41%,9,1,8,13,4,9
471,https://vlr.gg/player/30107/fluxxy,2024-09-15 11:00:00,1.64,1.42,1.55,278,301,233,42,26,16,24,15,9,19,13,6,+1,0,+1,86%,92%,78%,175,199,144,34%,37%,30%,2,1,1,1,1,0
472,https://vlr.gg/player/24140/superphrog,2024-09-15 11:00:00,1.34,1.12,1.24,242,270,203,39,25,14,28,16,12,9,1,8,+2,+3,-1,69%,71%,67%,167,193,132,45%,55%,32%,6,4,2,4,1,3
473,https://vlr.gg/player/19362/lyda,2024-09-15 11:00:00,0.95,1.12,1.02,215,197,226,30,16,14,30,18,12,18,12,6,+4,0,+4,90%,88%,94%,140,140,141,27%,33%,22%,4,0,4,0,0,0
474,https://vlr.gg/player/37990/adora,2024-09-15 11:00:00,0.68,1.27,0.93,223,205,263,31,16,15,33,21,12,7,3,4,+5,-1,+6,74%,58%,94%,152,130,181,32%,38%,26%,14,7,7,9,8,1
475,https://vlr.gg/player/9431/cille,2024-09-15 11:00:00,0.76,0.73,0.75,119,113,121,21,12,9,28,16,12,20,11,9,-2,-2,0,74%,75%,72%,70,68,73,26%,25%,28%,0,0,0,2,2,0
476,https://vlr.gg/player/16418/smurfette,2024-09-15 11:00:00,0.88,1.08,1.00,236,244,255,36,14,22,34,15,19,5,4,1,-12,-9,-3,60%,61%,58%,154,153,154,29%,22%,34%,3,1,2,15,10,5
477,https://vlr.gg/player/24101/miyori,2024-09-15 11:00:00,0.91,1.03,0.98,223,163,255,31,11,20,33,13,20,12,3,9,+1,-1,+2,69%,61%,75%,140,115,159,38%,50%,33%,5,1,4,4,2,2
478,https://vlr.gg/player/26632/joliinaa,2024-09-15 11:00:00,1.14,0.74,0.91,169,189,159,29,14,15,31,13,18,11,6,5,+1,+1,0,69%,72%,67%,107,116,100,36%,55%,26%,2,1,1,1,0,1
479,https://vlr.gg/player/24107/sarah,2024-09-15 11:00:00,0.91,0.87,0.89,159,174,137,21,9,12,30,13,17,21,11,10,-3,0,-3,69%,61%,75%,105,125,90,27%,21%,34%,1,1,0,4,1,3
480,https://vlr.gg/player/17343/ness,2024-09-15 11:00:00,0.72,0.94,0.84,203,145,241,26,9,17,35,14,21,16,7,9,+3,-1,+4,71%,67%,75%,139,103,166,29%,21%,33%,5,0,5,2,1,1
481,https://vlr.gg/player/4404/suyjing,2024-09-15 08:00:00,,,,274,,,66,,,43,,,16,,,+3,,,,,,172,,,30%,,,10,,,7,,
482,https://vlr.gg/player/9558/wolfen,2024-09-15 08:00:00,,,,239,,,56,,,48,,,12,,,+4,,,,,,155,,,36%,,,13,,,9,,
483,https://vlr.gg/player/320/dimasick,2024-09-15 08:00:00,,,,191,,,44,,,46,,,15,,,0,,,,,,129,,,29%,,,7,,,7,,
484,https://vlr.gg/player/41053/snail,2024-09-15 08:00:00,,,,181,,,40,,,45,,,17,,,+1,,,,,,122,,,26%,,,3,,,2,,
485,https://vlr.gg/player/17216/ucc,2024-09-15 08:00:00,,,,175,,,39,,,46,,,23,,,+1,,,,,,117,,,55%,,,4,,,3,,
486,https://vlr.gg/player/46751/chaos,2024-09-15 08:00:00,,,,277,,,67,,,45,,,14,,,+2,,,,,,182,,,36%,,,12,,,10,,
487,https://vlr.gg/player/47632/lilmad,2024-09-15 08:00:00,,,,197,,,45,,,51,,,13,,,-10,,,,,,133,,,38%,,,2,,,12,,
488,https://vlr.gg/player/4416/link,2024-09-15 08:00:00,,,,188,,,42,,,50,,,27,,,-2,,,,,,124,,,25%,,,4,,,6,,
489,https://vlr.gg/player/46754/pink,2024-09-15 08:00:00,,,,179,,,40,,,49,,,24,,,+4,,,,,,124,,,26%,,,7,,,3,,
490,https://vlr.gg/player/46755/volay,2024-09-15 08:00:00,,,,143,,,34,,,50,,,10,,,-3,,,,,,104,,,35%,,,3,,,6,,
491,https://vlr.gg/player/5796/kr1stal,2024-09-15 05:00:00,,,,227,,,42,,,43,,,16,,,+3,,,,,,146,,,16%,,,9,,,6,,
492,https://vlr.gg/player/22047/rarga,2024-09-15 05:00:00,,,,194,,,47,,,47,,,8,,,-8,,,,,,137,,,44%,,,7,,,15,,
493,https://vlr.gg/player/37927/happywei,2024-09-15 05:00:00,,,,194,,,38,,,44,,,10,,,+4,,,,,,122,,,32%,,,8,,,4,,
494,https://vlr.gg/player/36668/mart1n,2024-09-15 05:00:00,,,,170,,,37,,,43,,,24,,,+1,,,,,,117,,,28%,,,4,,,3,,
495,https://vlr.gg/player/37674/mrcani,2024-09-15 05:00:00,,,,164,,,41,,,39,,,18,,,-6,,,,,,108,,,44%,,,0,,,6,,
496,https://vlr.gg/player/41739/slowly,2024-09-15 05:00:00,,,,273,,,62,,,40,,,14,,,+6,,,,,,170,,,40%,,,13,,,7,,
497,https://vlr.gg/player/251/b1sk,2024-09-15 05:00:00,,,,241,,,49,,,41,,,9,,,-2,,,,,,151,,,24%,,,11,,,13,,
498,https://vlr.gg/player/4710/you,2024-09-15 05:00:00,,,,185,,,34,,,42,,,27,,,-2,,,,,,125,,,26%,,,1,,,3,,
499,https://vlr.gg/player/8225/f1cio,2024-09-15 05:00:00,,,,171,,,38,,,43,,,15,,,+5,,,,,,112,,,23%,,,7,,,2,,
500,https://vlr.gg/player/14439/ffs,2024-09-15 05:00:00,,,,149,,,33,,,39,,,21,,,-1,,,,,,100,,,27%,,,2,,,3,,
0,https://vlr.gg/player/6582/net,2024-09-14 19:45:00,0.81,1.35,1.11,214,126,280,52,15,37,42,19,23,5,1,4,+8,-2,+10,67%,57%,76%,146,97,186,38%,31%,42%,10,0,10,2,2,0
1,https://vlr.gg/player/4828/nismo,2024-09-14 19:45:00,1.33,0.90,1.09,199,218,173,43,23,20,41,17,24,31,15,16,+1,-2,+3,75%,77%,73%,126,139,114,27%,27%,27%,3,0,3,2,2,0
2,https://vlr.gg/player/3722/koalanoob,2024-09-14 19:45:00,1.12,0.88,0.98,229,258,208,54,26,28,50,20,30,13,7,6,+1,0,+1,75%,80%,70%,147,171,128,22%,21%,23%,14,8,6,13,8,5
3,https://vlr.gg/player/864/bcj,2024-09-14 19:45:00,0.87,1.08,0.93,207,224,205,49,24,25,47,22,25,23,7,16,+2,-1,+3,76%,77%,76%,136,141,131,19%,17%,20%,7,2,5,5,3,2
4,https://vlr.gg/player/8082/zander,2024-09-14 19:45:00,0.87,0.71,0.78,172,189,164,41,22,19,49,21,28,27,11,16,-5,-1,-4,76%,77%,76%,113,109,116,24%,27%,23%,3,2,1,8,3,5
5,https://vlr.gg/player/64/gmd,2024-09-14 19:45:00,1.26,1.19,1.23,231,223,250,55,30,25,47,25,22,23,14,9,+4,0,+4,76%,76%,77%,154,140,171,35%,37%,32%,8,2,6,4,2,2
6,https://vlr.gg/player/8376/seven,2024-09-14 19:45:00,1.07,1.39,1.21,225,202,256,54,28,26,48,26,22,15,7,8,-3,-4,+1,78%,76%,80%,149,132,170,21%,25%,16%,6,2,4,9,6,3
7,https://vlr.gg/player/740/aproto,2024-09-14 19:45:00,1.26,0.98,1.14,190,222,156,47,29,18,40,22,18,11,5,6,+3,+1,+2,69%,70%,67%,121,140,98,43%,49%,35%,5,3,2,2,2,0
8,https://vlr.gg/player/849/poised,2024-09-14 19:45:00,0.71,0.84,0.77,154,148,157,32,18,14,48,27,21,36,16,20,-3,-3,0,72%,62%,83%,99,88,113,28%,23%,33%,5,2,3,8,5,3
9,https://vlr.gg/player/3702/sym,2024-09-14 19:45:00,0.91,0.59,0.77,186,203,170,41,25,16,56,29,27,28,18,10,-8,-7,-1,69%,68%,70%,125,140,107,26%,26%,25%,6,3,3,14,10,4
10,https://vlr.gg/player/21661/spike,2024-09-14 17:25:00,1.17,1.07,1.13,247,259,220,31,20,11,29,17,12,18,8,10,+1,+1,0,68%,67%,71%,155,156,154,32%,27%,42%,4,3,1,3,2,1
11,https://vlr.gg/player/11921/silentzz,2024-09-14 17:25:00,0.60,1.45,0.95,199,148,309,32,11,21,32,21,11,4,3,1,0,-2,+2,71%,75%,65%,141,105,190,34%,34%,34%,6,3,3,6,5,1
12,https://vlr.gg/player/662/pryze,2024-09-14 17:25:00,0.83,0.61,0.74,133,157,101,20,14,6,28,17,11,5,2,3,-3,-1,-2,56%,58%,53%,92,104,75,33%,34%,30%,1,1,0,4,2,2
13,https://vlr.gg/player/6195/lz,2024-09-14 17:25:00,0.88,0.62,0.74,168,197,130,24,17,7,30,19,11,3,1,2,-4,0,-4,63%,67%,59%,104,119,83,44%,38%,62%,2,2,0,6,2,4
14,https://vlr.gg/player/3169/zap,2024-09-14 17:25:00,0.63,0.79,0.70,163,124,213,21,10,11,35,21,14,14,8,6,-2,-1,-1,73%,71%,76%,122,101,151,29%,36%,24%,4,2,2,6,3,3
15,https://vlr.gg/player/28716/lukxo,2024-09-14 17:25:00,0.98,1.60,1.34,269,237,297,42,15,27,26,13,13,14,8,6,+3,0,+3,73%,65%,79%,169,137,192,30%,42%,25%,7,2,5,4,2,2
16,https://vlr.gg/player/1688/rood,2024-09-14 17:25:00,1.47,1.15,1.29,207,240,191,30,14,16,19,9,10,9,4,5,0,+1,-1,71%,71%,71%,138,146,132,22%,29%,18%,4,2,2,4,1,3
17,https://vlr.gg/player/21659/sato,2024-09-14 17:25:00,0.83,1.29,1.10,237,197,251,33,12,21,29,13,16,6,2,4,+5,+5,0,71%,65%,75%,135,107,155,38%,33%,42%,8,5,3,3,0,3
18,https://vlr.gg/player/6238/urango,2024-09-14 17:25:00,0.89,1.04,0.98,194,175,204,28,10,18,29,12,17,9,2,7,0,+1,-1,66%,47%,79%,129,116,139,28%,13%,46%,3,2,1,3,1,2
19,https://vlr.gg/player/1994/evilkyk,2024-09-14 17:25:00,1.04,0.71,0.85,138,128,142,20,8,12,25,9,16,11,3,8,0,-1,+1,71%,65%,75%,100,95,103,23%,27%,20%,2,0,2,2,1,1
20,https://vlr.gg/player/3826/adverso,2024-09-14 15:00:00,0.80,1.37,1.13,228,186,251,28,10,18,29,16,13,21,5,16,-2,-2,0,76%,59%,88%,147,116,169,24%,32%,20%,2,1,1,4,3,1
21,https://vlr.gg/player/41135/dantedeu5,2024-09-14 15:00:00,0.33,1.31,0.90,185,116,241,29,5,24,32,17,15,6,4,2,-4,-4,0,56%,29%,75%,122,75,156,40%,42%,38%,6,1,5,10,5,5
22,https://vlr.gg/player/9354/cebando,2024-09-14 15:00:00,0.54,1.13,0.89,215,142,264,27,8,19,33,15,18,16,2,14,0,-3,+3,68%,53%,79%,142,90,179,31%,39%,28%,5,0,5,5,3,2
23,https://vlr.gg/player/13861/nicomachine,2024-09-14 15:00:00,0.47,0.87,0.71,140,142,142,18,8,10,31,17,14,21,5,16,+1,0,+1,73%,65%,79%,89,89,89,32%,38%,28%,4,2,2,3,2,1
24,https://vlr.gg/player/2585/tinchoff,2024-09-14 15:00:00,0.25,0.90,0.63,140,80,182,21,3,18,32,16,16,4,3,1,-2,0,-2,51%,35%,63%,103,59,134,31%,21%,35%,0,0,0,2,0,2
25,https://vlr.gg/player/1294/nagz,2024-09-14 15:00:00,1.26,1.71,1.44,219,201,245,31,16,15,19,15,4,8,3,5,+4,0,+4,76%,63%,94%,150,145,158,21%,16%,31%,5,1,4,1,1,0
26,https://vlr.gg/player/2464/suther,2024-09-14 15:00:00,0.80,1.88,1.25,223,159,316,34,15,19,25,19,6,28,10,18,0,-2,+2,78%,63%,100%,149,108,207,19%,22%,17%,3,1,2,3,3,0
27,https://vlr.gg/player/2468/delz1k,2024-09-14 15:00:00,1.05,1.51,1.24,223,211,237,35,18,17,25,19,6,15,8,7,0,0,0,80%,75%,88%,137,138,135,36%,36%,35%,3,1,2,3,1,2
28,https://vlr.gg/player/783/murizzz,2024-09-14 15:00:00,0.95,1.51,1.18,214,162,283,32,14,18,26,16,10,13,7,6,+3,0,+3,73%,58%,94%,136,104,181,28%,34%,23%,6,3,3,3,3,0
29,https://vlr.gg/player/8892/snw,2024-09-14 15:00:00,0.62,0.97,0.76,171,181,154,25,13,12,28,20,8,5,5,0,0,0,0,54%,42%,71%,120,122,117,31%,38%,13%,7,5,2,7,5,2
30,https://vlr.gg/player/19371/eva,2024-09-14 12:30:00,1.38,1.14,1.26,216,210,223,61,30,31,47,17,30,18,12,6,0,0,0,73%,79%,67%,137,135,138,23%,21%,27%,4,3,1,4,3,1
31,https://vlr.gg/player/29903/madv,2024-09-14 12:30:00,1.02,1.05,1.04,177,167,188,49,24,25,50,22,28,20,11,9,+3,+1,+2,65%,77%,54%,123,116,131,39%,42%,35%,4,1,3,1,0,1
32,https://vlr.gg/player/20055/toki,2024-09-14 12:30:00,1.34,0.63,0.99,225,275,178,61,39,22,60,25,35,15,11,4,+1,+3,-2,60%,67%,54%,153,177,130,34%,33%,38%,12,6,6,11,3,8
33,https://vlr.gg/player/17333/mary,2024-09-14 12:30:00,0.95,0.67,0.81,192,224,163,51,31,20,62,29,33,10,5,5,-5,+3,-8,58%,64%,51%,123,140,105,33%,29%,38%,14,11,3,19,8,11
34,https://vlr.gg/player/29900/sandra,2024-09-14 12:30:00,0.79,0.69,0.74,167,186,143,45,26,19,61,29,32,16,13,3,+1,0,+1,60%,82%,38%,109,122,96,36%,31%,42%,5,2,3,4,2,2
35,https://vlr.gg/player/17332/jduh,2024-09-14 12:30:00,1.22,1.24,1.23,229,224,236,65,33,32,48,21,27,15,11,4,-5,-1,-4,67%,77%,56%,148,144,152,44%,44%,45%,5,4,1,10,5,5
36,https://vlr.gg/player/29442/wens,2024-09-14 12:30:00,1.30,0.84,1.07,212,241,187,59,37,22,53,22,31,12,2,10,+1,+4,-3,71%,77%,64%,154,170,138,39%,40%,38%,7,4,3,6,0,6
37,https://vlr.gg/player/23049/alkyia,2024-09-14 12:30:00,1.15,0.80,0.97,240,287,200,65,38,27,59,27,32,14,10,4,-3,-1,-2,59%,64%,54%,163,197,128,23%,21%,27%,16,10,6,19,11,8
38,https://vlr.gg/player/19363/proxima,2024-09-14 12:30:00,0.99,0.76,0.87,171,175,165,47,26,21,54,23,31,18,9,9,+3,+3,0,74%,82%,67%,113,117,110,38%,41%,36%,5,3,2,2,0,2
39,https://vlr.gg/player/17339/felipa,2024-09-14 12:30:00,1.00,0.74,0.87,166,178,156,44,24,20,53,24,29,27,19,8,+4,+2,+2,74%,82%,67%,111,117,104,29%,25%,35%,6,2,4,2,0,2
40,https://vlr.gg/player/1835/elllement,2024-09-14 12:00:00,1.06,1.15,1.10,240,238,244,51,25,26,47,24,23,15,7,8,+11,+9,+2,75%,74%,77%,164,166,162,26%,24%,28%,13,9,4,2,0,2
41,https://vlr.gg/player/7490/anguist,2024-09-14 12:00:00,1.41,0.71,1.08,228,297,155,53,37,16,48,23,25,9,6,3,+7,+6,+1,69%,76%,61%,147,189,101,34%,38%,26%,12,8,4,5,2,3
42,https://vlr.gg/player/10885/davih,2024-09-14 12:00:00,0.72,1.18,0.94,175,132,224,38,15,23,45,23,22,19,8,11,0,-1,+1,65%,56%,74%,125,101,151,30%,27%,33%,4,1,3,4,2,2
43,https://vlr.gg/player/4329/vince,2024-09-14 12:00:00,1.03,0.67,0.86,154,156,152,37,21,16,45,19,26,23,15,8,-7,-2,-5,68%,74%,61%,99,94,104,18%,18%,19%,2,1,1,9,3,6
44,https://vlr.gg/player/2472/benny,2024-09-14 12:00:00,0.69,0.52,0.61,149,157,142,34,19,15,52,24,28,14,7,7,-2,-2,0,71%,71%,71%,100,107,92,43%,58%,31%,6,3,3,8,5,3
45,https://vlr.gg/player/31305/lar0k,2024-09-14 12:00:00,1.49,1.36,1.42,240,245,234,61,32,29,39,17,22,23,12,11,+2,+3,-1,83%,90%,76%,144,140,147,29%,36%,24%,4,3,1,2,0,2
46,https://vlr.gg/player/40591/comeback,2024-09-14 12:00:00,1.18,1.22,1.20,253,271,238,57,28,29,47,23,24,14,10,4,-3,-1,-2,74%,74%,74%,172,188,158,24%,20%,28%,10,7,3,13,8,5
47,https://vlr.gg/player/31855/celasun,2024-09-14 12:00:00,1.28,0.86,1.06,187,209,167,41,23,18,38,16,22,23,16,7,-5,-2,-3,74%,84%,65%,129,140,119,30%,30%,30%,2,0,2,7,2,5
48,https://vlr.gg/player/24344/loita,2024-09-14 12:00:00,1.10,0.95,1.02,213,226,201,45,24,21,45,20,25,26,11,15,-2,-1,-1,78%,84%,74%,151,152,149,45%,48%,42%,7,2,5,9,3,6
49,https://vlr.gg/player/5565/ros,2024-09-14 12:00:00,0.83,0.75,0.79,142,157,130,33,17,16,44,20,24,18,9,9,-1,+2,-3,63%,68%,59%,91,101,82,35%,35%,34%,5,4,1,6,2,4
50,https://vlr.gg/player/19373/ginger,2024-09-14 11:00:00,0.98,0.65,0.81,179,189,164,18,11,7,25,13,12,3,0,3,-3,-1,-2,46%,47%,46%,108,116,97,28%,36%,20%,1,0,1,4,1,3
51,https://vlr.gg/player/41207/jade,2024-09-14 11:00:00,0.74,0.88,0.80,184,175,194,15,7,8,25,14,11,9,6,3,-1,0,-1,61%,60%,62%,124,121,127,30%,31%,29%,0,0,0,1,0,1
52,https://vlr.gg/player/30042/harmonee,2024-09-14 11:00:00,0.29,0.64,0.46,135,82,199,11,3,8,27,14,13,7,5,2,-3,-3,0,46%,47%,46%,100,64,141,41%,36%,44%,2,0,2,5,3,2
53,https://vlr.gg/player/17318/blossi,2024-09-14 11:00:00,0.09,0.50,0.25,95,60,140,8,2,6,28,15,13,9,5,4,-7,-6,-1,39%,33%,46%,67,44,92,27%,17%,33%,1,0,1,8,6,2
54,https://vlr.gg/player/37969/ellie,2024-09-14 11:00:00,0.03,0.25,0.12,89,61,122,9,3,6,28,15,13,1,1,0,-4,-5,+1,43%,40%,46%,54,38,73,18%,7%,29%,1,0,1,5,5,0
55,https://vlr.gg/player/11183/glance,2024-09-14 11:00:00,2.52,1.47,1.96,276,396,181,33,22,11,7,4,3,8,3,5,+4,+3,+1,96%,100%,93%,177,258,107,45%,43%,47%,4,3,1,0,0,0
56,https://vlr.gg/player/21153/matrix,2024-09-14 11:00:00,1.62,1.89,1.76,321,332,317,34,16,18,14,8,6,7,4,3,+2,-1,+3,89%,77%,100%,224,231,218,43%,39%,47%,4,1,3,2,2,0
57,https://vlr.gg/player/16419/roxi,2024-09-14 11:00:00,1.61,1.57,1.59,280,308,264,31,15,16,12,7,5,2,2,0,+3,0,+3,89%,77%,100%,200,229,174,39%,41%,38%,5,2,3,2,2,0
58,https://vlr.gg/player/19356/kuripuuya,2024-09-14 11:00:00,0.74,1.90,1.36,233,94,338,20,3,17,12,7,5,20,13,7,+7,0,+7,93%,92%,93%,146,54,225,27%,6%,36%,8,1,7,1,1,0
59,https://vlr.gg/player/16321/nelo,2024-09-14 11:00:00,0.93,1.20,1.08,166,146,178,15,6,9,16,9,7,25,12,13,+2,+1,+1,86%,77%,93%,101,93,109,42%,43%,41%,2,1,1,0,0,0
60,https://vlr.gg/player/47632/lilmad,2024-09-14 06:50:00,,,,215,,,42,,,37,,,15,,,+4,,,,,,139,,,37%,,,11,,,7,,
61,https://vlr.gg/player/46751/chaos,2024-09-14 06:50:00,,,,210,,,37,,,36,,,24,,,+2,,,,,,139,,,29%,,,6,,,4,,
62,https://vlr.gg/player/46754/pink,2024-09-14 06:50:00,,,,202,,,40,,,32,,,22,,,-2,,,,,,128,,,26%,,,2,,,4,,
63,https://vlr.gg/player/46755/volay,2024-09-14 06:50:00,,,,173,,,33,,,34,,,22,,,-1,,,,,,126,,,26%,,,5,,,6,,
64,https://vlr.gg/player/4416/link,2024-09-14 06:50:00,,,,156,,,32,,,38,,,18,,,0,,,,,,101,,,29%,,,5,,,5,,
65,https://vlr.gg/player/46749/player,2024-09-14 06:50:00,,,,204,,,40,,,40,,,6,,,+2,,,,,,115,,,30%,,,15,,,13,,
66,https://vlr.gg/player/46748/k1ra,2024-09-14 06:50:00,,,,185,,,37,,,34,,,15,,,-2,,,,,,121,,,31%,,,4,,,6,,
67,https://vlr.gg/player/37019/x3b,2024-09-14 06:50:00,,,,180,,,33,,,39,,,14,,,0,,,,,,135,,,35%,,,2,,,2,,
68,https://vlr.gg/player/25494/shr1mp,2024-09-14 06:50:00,,,,176,,,35,,,36,,,32,,,-2,,,,,,118,,,42%,,,4,,,6,,
69,https://vlr.gg/player/42537/hanche,2024-09-14 06:50:00,,,,171,,,32,,,35,,,10,,,-1,,,,,,124,,,42%,,,1,,,2,,
70,https://vlr.gg/player/4710/you,2024-09-14 05:00:00,,,,286,,,36,,,19,,,21,,,+1,,,,,,180,,,30%,,,5,,,4,,
71,https://vlr.gg/player/41739/slowly,2024-09-14 05:00:00,,,,275,,,35,,,21,,,22,,,+1,,,,,,184,,,32%,,,2,,,1,,
72,https://vlr.gg/player/251/b1sk,2024-09-14 05:00:00,,,,258,,,32,,,26,,,6,,,-1,,,,,,157,,,19%,,,6,,,7,,
73,https://vlr.gg/player/8225/f1cio,2024-09-14 05:00:00,,,,250,,,34,,,22,,,19,,,-2,,,,,,152,,,33%,,,4,,,6,,
74,https://vlr.gg/player/14439/ffs,2024-09-14 05:00:00,,,,191,,,24,,,21,,,20,,,0,,,,,,132,,,29%,,,0,,,0,,
75,https://vlr.gg/player/47101/5cm,2024-09-14 05:00:00,,,,257,,,31,,,33,,,8,,,+2,,,,,,161,,,36%,,,13,,,11,,
76,https://vlr.gg/player/3124/core,2024-09-14 05:00:00,,,,203,,,24,,,32,,,8,,,+1,,,,,,127,,,19%,,,1,,,0,,
77,https://vlr.gg/player/19531/qiuye,2024-09-14 05:00:00,,,,191,,,26,,,31,,,3,,,0,,,,,,132,,,24%,,,1,,,1,,
78,https://vlr.gg/player/47103/g1xad,2024-09-14 05:00:00,,,,137,,,15,,,32,,,6,,,-2,,,,,,98,,,25%,,,1,,,3,,
79,https://vlr.gg/player/47102/waituu,2024-09-14 05:00:00,,,,131,,,13,,,33,,,17,,,0,,,,,,95,,,24%,,,2,,,2,,
80,https://vlr.gg/player/28716/lukxo,2024-09-13 18:25:00,1.51,1.24,1.38,295,343,244,77,47,30,53,26,27,21,12,9,+11,+1,+10,72%,76%,68%,196,235,157,34%,34%,35%,16,4,12,5,3,2
81,https://vlr.gg/player/21659/sato,2024-09-13 18:25:00,1.19,1.01,1.10,247,271,224,64,35,29,56,27,29,9,4,5,0,+3,-3,70%,73%,68%,162,166,158,36%,41%,31%,15,11,4,15,8,7
82,https://vlr.gg/player/6238/urango,2024-09-13 18:25:00,0.93,1.02,0.97,176,160,193,44,21,23,50,24,26,37,14,23,-2,-3,+1,78%,78%,78%,118,104,132,25%,21%,30%,4,0,4,6,3,3
83,https://vlr.gg/player/1688/rood,2024-09-13 18:25:00,0.97,0.75,0.86,154,156,156,37,19,18,45,20,25,13,7,6,+3,+1,+2,64%,68%,59%,105,103,107,22%,24%,19%,6,3,3,3,2,1
84,https://vlr.gg/player/1994/evilkyk,2024-09-13 18:25:00,0.60,0.70,0.65,120,94,146,31,12,19,53,24,29,21,8,13,-4,-3,-1,65%,65%,65%,83,63,102,21%,21%,22%,0,0,0,4,3,1
85,https://vlr.gg/player/3722/koalanoob,2024-09-13 18:25:00,1.34,1.36,1.35,275,262,289,71,34,37,49,22,27,17,11,6,0,-1,+1,70%,70%,70%,178,178,178,25%,24%,26%,13,7,6,13,8,5
86,https://vlr.gg/player/8082/zander,2024-09-13 18:25:00,1.17,0.91,1.04,186,203,172,48,26,22,50,24,26,36,23,13,-4,-3,-1,72%,73%,70%,125,131,118,24%,29%,19%,6,2,4,10,5,5
87,https://vlr.gg/player/864/bcj,2024-09-13 18:25:00,0.91,0.89,0.90,173,176,170,42,21,21,49,25,24,23,10,13,-4,-2,-2,80%,78%,81%,117,122,112,22%,24%,20%,3,2,1,7,4,3
88,https://vlr.gg/player/4828/nismo,2024-09-13 18:25:00,1.03,0.78,0.90,181,200,162,49,27,22,55,24,31,28,14,14,+1,0,+1,65%,68%,62%,120,135,104,31%,35%,26%,4,1,3,3,1,2
89,https://vlr.gg/player/6582/net,2024-09-13 18:25:00,1.00,0.76,0.88,183,220,148,47,28,19,50,24,26,10,5,5,-1,-3,+2,66%,70%,62%,117,134,100,29%,28%,31%,7,2,5,8,5,3
90,https://vlr.gg/player/3826/adverso,2024-09-13 15:00:00,1.34,1.40,1.37,266,256,270,64,33,31,42,19,23,22,9,13,0,0,0,73%,71%,75%,168,157,180,35%,35%,35%,7,3,4,7,3,4
91,https://vlr.gg/player/41135/dantedeu5,2024-09-13 15:00:00,0.89,1.39,1.13,237,183,296,55,22,33,47,22,25,14,8,6,-3,-1,-2,79%,79%,78%,158,123,195,28%,26%,30%,8,5,3,11,6,5
92,https://vlr.gg/player/13861/nicomachine,2024-09-13 15:00:00,1.28,0.84,1.07,178,205,153,43,26,17,41,17,24,34,15,19,+5,+4,+1,86%,94%,78%,115,137,90,28%,31%,25%,7,4,3,2,0,2
93,https://vlr.gg/player/2585/tinchoff,2024-09-13 15:00:00,0.92,1.09,1.00,172,178,175,44,22,22,40,20,20,10,3,7,-2,+1,-3,68%,76%,59%,116,108,124,41%,40%,42%,7,5,2,9,4,5
94,https://vlr.gg/player/9354/cebando,2024-09-13 15:00:00,1.06,0.69,0.88,164,183,144,34,21,13,45,22,23,30,17,13,+6,+4,+2,77%,74%,81%,116,129,102,34%,34%,33%,7,4,3,1,0,1
95,https://vlr.gg/player/3169/zap,2024-09-13 15:00:00,1.11,1.07,1.09,221,234,214,48,25,23,47,22,25,26,10,16,-4,+1,-5,79%,78%,79%,153,164,142,27%,31%,22%,3,3,0,7,2,5
96,https://vlr.gg/player/11921/silentzz,2024-09-13 15:00:00,1.10,1.04,1.07,233,243,219,54,30,24,49,23,26,13,5,8,-1,-1,0,73%,81%,65%,153,160,147,27%,32%,21%,7,3,4,8,4,4
97,https://vlr.gg/player/662/pryze,2024-09-13 15:00:00,1.17,0.90,1.03,174,196,160,42,25,17,41,19,22,11,4,7,+2,+4,-2,76%,81%,71%,126,141,111,21%,21%,22%,7,4,3,5,0,5
98,https://vlr.gg/player/21661/spike,2024-09-13 15:00:00,0.76,0.74,0.74,172,198,156,39,21,18,54,28,26,19,9,10,-2,+1,-3,79%,78%,79%,114,133,97,26%,32%,19%,8,6,2,10,5,5
99,https://vlr.gg/player/6195/lz,2024-09-13 15:00:00,0.61,0.84,0.73,146,131,163,32,14,18,49,24,25,21,12,9,-1,-3,+2,61%,66%,56%,94,79,109,33%,40%,29%,5,1,4,6,4,2
100,https://vlr.gg/player/16196/annie,2024-09-13 12:50:00,1.16,1.32,1.24,281,273,290,45,22,23,36,20,16,8,5,3,+7,0,+7,68%,58%,78%,180,181,180,32%,35%,29%,14,5,9,7,5,2
101,https://vlr.gg/player/7460/6sonya,2024-09-13 12:50:00,1.00,1.14,1.06,174,175,175,29,15,14,30,17,13,16,7,9,+3,+1,+2,70%,71%,70%,118,119,116,40%,36%,44%,3,1,2,0,0,0
102,https://vlr.gg/player/39506/cabbit,2024-09-13 12:50:00,0.88,1.07,0.97,194,226,161,32,18,14,31,20,11,6,3,3,-1,-1,0,68%,63%,74%,137,155,119,23%,23%,23%,3,2,1,4,3,1
103,https://vlr.gg/player/20116/jademwah,2024-09-13 12:50:00,0.66,1.24,0.95,202,160,245,33,12,21,35,21,14,16,8,8,-2,-4,+2,66%,54%,78%,138,112,166,22%,20%,22%,5,1,4,7,5,2
104,https://vlr.gg/player/20058/devilasxa,2024-09-13 12:50:00,0.41,1.08,0.74,121,79,164,20,7,13,31,18,13,20,7,13,-4,-2,-2,66%,58%,74%,77,48,108,30%,21%,34%,0,0,0,4,2,2
105,https://vlr.gg/player/41207/jade,2024-09-13 12:50:00,0.79,1.66,1.23,219,155,280,39,12,27,29,17,12,23,9,14,0,-1,+1,72%,61%,83%,135,98,171,25%,23%,27%,3,1,2,3,2,1
106,https://vlr.gg/player/17318/blossi,2024-09-13 12:50:00,1.05,1.34,1.20,191,170,211,33,14,19,28,15,13,26,15,11,+1,-2,+3,72%,65%,79%,122,105,138,26%,25%,27%,5,1,4,4,3,1
107,https://vlr.gg/player/37969/ellie,2024-09-13 12:50:00,1.08,1.16,1.12,230,250,209,39,21,18,33,17,16,11,3,8,-2,-3,+1,74%,65%,83%,150,151,150,31%,39%,25%,5,3,2,7,6,1
108,https://vlr.gg/player/30042/harmonee,2024-09-13 12:50:00,0.72,1.00,0.87,168,144,193,25,11,14,32,18,14,18,5,13,+1,-2,+3,68%,52%,83%,125,119,131,28%,30%,26%,4,0,4,3,2,1
109,https://vlr.gg/player/19373/ginger,2024-09-13 12:50:00,0.65,0.92,0.79,171,136,205,27,9,18,37,18,19,10,4,6,-3,-1,-2,62%,48%,75%,122,89,153,20%,18%,22%,5,2,3,8,3,5
110,https://vlr.gg/player/29903/madv,2024-09-13 11:00:00,1.11,0.78,0.97,180,184,175,22,13,9,25,13,12,5,3,2,0,+1,-1,66%,70%,60%,108,100,120,41%,37%,48%,3,3,0,3,2,1
111,https://vlr.gg/player/19371/eva,2024-09-13 11:00:00,0.78,1.08,0.91,156,142,194,22,12,10,23,14,9,2,1,1,-2,-1,-1,69%,75%,60%,101,88,118,30%,29%,32%,1,0,1,3,1,2
112,https://vlr.gg/player/29900/sandra,2024-09-13 11:00:00,0.72,0.59,0.66,206,224,179,24,15,9,31,18,13,3,1,2,+3,+2,+1,57%,55%,60%,137,149,122,33%,41%,25%,4,2,2,1,0,1
113,https://vlr.gg/player/20055/toki,2024-09-13 11:00:00,0.71,0.35,0.55,159,170,135,16,10,6,31,16,15,11,7,4,-4,-1,-3,63%,80%,40%,108,116,98,38%,33%,47%,3,1,2,7,2,5
114,https://vlr.gg/player/17333/mary,2024-09-13 11:00:00,0.45,0.54,0.49,129,134,122,14,8,6,30,18,12,7,5,2,-4,-5,+1,60%,60%,60%,95,105,82,29%,32%,24%,3,2,1,7,7,0
115,https://vlr.gg/player/19362/lyda,2024-09-13 11:00:00,1.46,1.52,1.49,223,208,214,28,12,16,15,7,8,12,5,7,+1,0,+1,89%,93%,85%,148,150,147,30%,40%,24%,3,1,2,2,1,1
116,https://vlr.gg/player/30107/fluxxy,2024-09-13 11:00:00,1.34,1.57,1.47,238,248,236,33,15,18,18,9,9,13,4,9,+3,+2,+1,86%,80%,90%,140,131,148,29%,24%,34%,4,2,2,1,0,1
117,https://vlr.gg/player/9431/cille,2024-09-13 11:00:00,1.76,1.24,1.46,240,283,209,32,16,16,18,7,11,8,2,6,0,0,0,74%,87%,65%,163,176,153,36%,47%,30%,2,1,1,2,1,1
118,https://vlr.gg/player/37990/adora,2024-09-13 11:00:00,0.71,1.16,0.97,223,143,268,26,7,19,25,9,16,7,3,4,+2,-1,+3,66%,67%,65%,151,107,185,29%,19%,35%,8,2,6,6,3,3
119,https://vlr.gg/player/24140/superphrog,2024-09-13 11:00:00,1.17,0.71,0.91,177,212,152,21,11,10,22,8,14,8,4,4,+1,+2,-1,74%,73%,75%,133,165,109,27%,31%,24%,4,3,1,3,1,2
120,https://vlr.gg/player/5241/maple,2024-09-13 07:05:00,,,,307,,,42,,,27,,,16,,,+1,,,,,,202,,,24%,,,9,,,8,,
121,https://vlr.gg/player/29184/kawentw,2024-09-13 07:05:00,,,,255,,,42,,,25,,,4,,,-1,,,,,,159,,,35%,,,2,,,3,,
122,https://vlr.gg/player/34181/green,2024-09-13 07:05:00,,,,207,,,31,,,28,,,14,,,+4,,,,,,137,,,47%,,,6,,,2,,
123,https://vlr.gg/player/4763/zixuan,2024-09-13 07:05:00,,,,199,,,28,,,27,,,13,,,-1,,,,,,128,,,24%,,,2,,,3,,
124,https://vlr.gg/player/47629/coco,2024-09-13 07:05:00,,,,157,,,26,,,29,,,13,,,-3,,,,,,102,,,33%,,,2,,,5,,
125,https://vlr.gg/player/4404/suyjing,2024-09-13 07:05:00,,,,267,,,37,,,32,,,6,,,+1,,,,,,169,,,28%,,,6,,,5,,
126,https://vlr.gg/player/9558/wolfen,2024-09-13 07:05:00,,,,214,,,29,,,34,,,3,,,-2,,,,,,139,,,38%,,,4,,,6,,
127,https://vlr.gg/player/320/dimasick,2024-09-13 07:05:00,,,,199,,,26,,,37,,,7,,,+2,,,,,,131,,,28%,,,6,,,4,,
128,https://vlr.gg/player/41053/snail,2024-09-13 07:05:00,,,,152,,,24,,,33,,,6,,,-2,,,,,,104,,,32%,,,1,,,3,,
129,https://vlr.gg/player/17216/ucc,2024-09-13 07:05:00,,,,138,,,19,,,34,,,19,,,+1,,,,,,90,,,32%,,,3,,,2,,
130,https://vlr.gg/player/1916/free1ng,2024-09-13 05:00:00,,,,277,,,40,,,26,,,12,,,-1,,,,,,185,,,43%,,,3,,,4,,
131,https://vlr.gg/player/11527/noman,2024-09-13 05:00:00,,,,241,,,34,,,27,,,2,,,+5,,,,,,143,,,28%,,,10,,,5,,
132,https://vlr.gg/player/4428/udotan,2024-09-13 05:00:00,,,,230,,,31,,,21,,,15,,,+3,,,,,,156,,,44%,,,5,,,2,,
133,https://vlr.gg/player/3531/midnight,2024-09-13 05:00:00,,,,205,,,27,,,20,,,20,,,+1,,,,,,130,,,19%,,,3,,,2,,
134,https://vlr.gg/player/45811/sn0wflake,2024-09-13 05:00:00,,,,189,,,28,,,24,,,11,,,+1,,,,,,130,,,36%,,,3,,,2,,
135,https://vlr.gg/player/22047/rarga,2024-09-13 05:00:00,,,,234,,,30,,,33,,,7,,,-2,,,,,,148,,,33%,,,8,,,10,,
136,https://vlr.gg/player/5796/kr1stal,2024-09-13 05:00:00,,,,203,,,26,,,29,,,8,,,-3,,,,,,139,,,23%,,,2,,,5,,
137,https://vlr.gg/player/37927/happywei,2024-09-13 05:00:00,,,,191,,,26,,,32,,,8,,,0,,,,,,116,,,34%,,,5,,,5,,
138,https://vlr.gg/player/37674/mrcani,2024-09-13 05:00:00,,,,165,,,24,,,33,,,13,,,-3,,,,,,100,,,30%,,,0,,,3,,
139,https://vlr.gg/player/36668/mart1n,2024-09-13 05:00:00,,,,107,,,11,,,33,,,17,,,-1,,,,,,80,,,32%,,,0,,,1,,
140,https://vlr.gg/player/2468/delz1k,2024-09-12 18:00:00,1.29,1.01,1.16,217,241,188,45,29,16,43,26,17,31,17,14,-1,0,-1,82%,82%,83%,146,157,133,26%,29%,21%,3,2,1,4,2,2
141,https://vlr.gg/player/1294/nagz,2024-09-12 18:00:00,0.94,1.21,1.07,216,210,221,45,22,23,43,26,17,11,6,5,0,+2,-2,69%,58%,83%,144,142,147,30%,23%,39%,8,5,3,8,3,5
142,https://vlr.gg/player/8892/snw,2024-09-12 18:00:00,0.67,1.36,0.97,211,185,271,49,20,29,49,31,18,14,6,8,-1,-2,+1,73%,64%,83%,145,126,167,17%,20%,14%,12,5,7,13,7,6
143,https://vlr.gg/player/783/murizzz,2024-09-12 18:00:00,0.72,1.20,0.94,187,161,201,42,20,22,46,28,18,16,5,11,-6,-6,0,73%,67%,79%,114,104,126,28%,36%,22%,1,0,1,7,6,1
144,https://vlr.gg/player/2464/suther,2024-09-12 18:00:00,0.71,0.89,0.80,163,141,193,32,14,18,46,25,21,23,11,12,-2,-3,+1,74%,64%,86%,112,99,127,24%,19%,30%,2,0,2,4,3,1
145,https://vlr.gg/player/8082/zander,2024-09-12 18:00:00,1.23,1.31,1.27,246,224,260,56,24,32,40,19,21,26,7,19,+4,+1,+3,82%,83%,82%,149,139,157,25%,25%,25%,8,4,4,4,3,1
146,https://vlr.gg/player/6582/net,2024-09-12 18:00:00,1.12,1.27,1.20,223,194,252,49,20,29,39,19,20,15,7,8,+5,+3,+2,77%,69%,85%,147,121,169,33%,32%,35%,9,5,4,4,2,2
147,https://vlr.gg/player/864/bcj,2024-09-12 18:00:00,0.67,1.63,1.18,244,143,319,54,16,38,41,21,20,20,8,12,0,-4,+4,79%,59%,97%,147,85,200,18%,20%,18%,5,0,5,5,4,1
148,https://vlr.gg/player/3722/koalanoob,2024-09-12 18:00:00,0.77,0.99,0.89,210,220,198,42,20,22,48,27,21,28,13,15,+2,+2,0,74%,69%,79%,133,140,126,18%,19%,16%,11,6,5,9,4,5
149,https://vlr.gg/player/4828/nismo,2024-09-12 18:00:00,0.64,0.79,0.72,126,120,136,26,11,15,45,22,23,40,16,24,-1,-1,0,82%,83%,82%,82,77,87,20%,26%,16%,3,0,3,4,1,3
150,https://vlr.gg/player/3702/sym,2024-09-12 15:00:00,1.40,1.10,1.25,284,329,242,70,41,29,54,28,26,15,6,9,+1,+2,-1,66%,64%,68%,186,216,153,36%,38%,32%,15,8,7,14,6,8
151,https://vlr.gg/player/8376/seven,2024-09-12 15:00:00,0.67,1.18,0.92,179,121,239,44,16,28,50,26,24,19,8,11,-6,-5,-1,74%,69%,79%,117,81,156,25%,33%,21%,3,1,2,9,6,3
152,https://vlr.gg/player/64/gmd,2024-09-12 15:00:00,0.82,0.98,0.90,184,171,205,45,20,25,50,28,22,17,10,7,+2,0,+2,76%,67%,85%,118,110,126,28%,22%,34%,7,3,4,5,3,2
153,https://vlr.gg/player/740/aproto,2024-09-12 15:00:00,0.93,0.86,0.90,167,167,168,38,20,18,49,25,24,21,8,13,+1,0,+1,71%,67%,76%,117,118,116,32%,38%,25%,4,2,2,3,2,1
154,https://vlr.gg/player/849/poised,2024-09-12 15:00:00,0.85,0.78,0.82,150,171,131,40,23,17,48,26,22,13,6,7,-6,-3,-3,67%,69%,65%,97,106,88,32%,35%,30%,2,1,1,8,4,4
155,https://vlr.gg/player/11921/silentzz,2024-09-12 15:00:00,1.22,1.56,1.40,282,271,290,72,33,39,46,25,21,7,5,2,+10,+4,+6,77%,74%,81%,184,169,199,34%,43%,26%,13,6,7,3,2,1
156,https://vlr.gg/player/3169/zap,2024-09-12 15:00:00,1.06,1.11,1.08,186,178,197,47,22,25,45,22,23,22,11,11,-1,-1,0,71%,74%,69%,129,121,136,30%,33%,28%,3,1,2,4,2,2
157,https://vlr.gg/player/21661/spike,2024-09-12 15:00:00,0.88,1.03,0.96,208,202,218,47,21,26,50,25,25,38,19,19,-1,-2,+1,79%,74%,83%,134,130,138,19%,17%,21%,9,5,4,10,7,3
158,https://vlr.gg/player/662/pryze,2024-09-12 15:00:00,0.84,1.00,0.92,171,158,185,41,19,22,46,23,23,17,6,11,+2,+1,+1,80%,82%,78%,116,103,128,21%,28%,16%,6,2,4,4,1,3
159,https://vlr.gg/player/6195/lz,2024-09-12 15:00:00,1.06,0.64,0.84,175,182,164,44,23,21,50,22,28,14,9,5,-2,0,-2,71%,79%,64%,108,111,106,36%,42%,31%,8,4,4,10,4,6
160,https://vlr.gg/player/9558/wolfen,2024-09-12 07:00:00,,,,317,,,48,,,32,,,5,,,+5,,,,,,192,,,37%,,,12,,,7,,
161,https://vlr.gg/player/320/dimasick,2024-09-12 07:00:00,,,,247,,,37,,,23,,,18,,,+2,,,,,,180,,,26%,,,5,,,3,,
162,https://vlr.gg/player/41053/snail,2024-09-12 07:00:00,,,,209,,,34,,,30,,,10,,,+2,,,,,,144,,,33%,,,2,,,0,,
163,https://vlr.gg/player/4404/suyjing,2024-09-12 07:00:00,,,,171,,,26,,,27,,,5,,,0,,,,,,117,,,37%,,,6,,,6,,
164,https://vlr.gg/player/17216/ucc,2024-09-12 07:00:00,,,,142,,,19,,,28,,,22,,,0,,,,,,95,,,34%,,,0,,,0,,
165,https://vlr.gg/player/46749/player,2024-09-12 07:00:00,,,,261,,,39,,,35,,,5,,,-2,,,,,,167,,,32%,,,8,,,10,,
166,https://vlr.gg/player/46748/k1ra,2024-09-12 07:00:00,,,,200,,,29,,,32,,,11,,,-2,,,,,,131,,,30%,,,3,,,5,,
167,https://vlr.gg/player/25494/shr1mp,2024-09-12 07:00:00,,,,184,,,26,,,33,,,15,,,-4,,,,,,119,,,31%,,,0,,,4,,
168,https://vlr.gg/player/37019/x3b,2024-09-12 07:00:00,,,,164,,,23,,,34,,,13,,,-3,,,,,,113,,,33%,,,2,,,5,,
169,https://vlr.gg/player/42537/hanche,2024-09-12 07:00:00,,,,156,,,23,,,32,,,7,,,+2,,,,,,108,,,49%,,,4,,,2,,
170,https://vlr.gg/player/5241/maple,2024-09-12 05:00:00,,,,268,,,34,,,21,,,8,,,+5,,,,,,157,,,15%,,,11,,,6,,
171,https://vlr.gg/player/29184/kawentw,2024-09-12 05:00:00,,,,263,,,35,,,19,,,9,,,+2,,,,,,171,,,28%,,,6,,,4,,
172,https://vlr.gg/player/4763/zixuan,2024-09-12 05:00:00,,,,237,,,31,,,15,,,19,,,+1,,,,,,157,,,20%,,,2,,,1,,
173,https://vlr.gg/player/47629/coco,2024-09-12 05:00:00,,,,208,,,29,,,23,,,11,,,+2,,,,,,141,,,37%,,,3,,,1,,
174,https://vlr.gg/player/34181/green,2024-09-12 05:00:00,,,,183,,,19,,,21,,,22,,,-1,,,,,,129,,,25%,,,0,,,1,,
175,https://vlr.gg/player/46751/chaos,2024-09-12 05:00:00,,,,206,,,23,,,29,,,7,,,0,,,,,,129,,,38%,,,4,,,4,,
176,https://vlr.gg/player/4416/link,2024-09-12 05:00:00,,,,198,,,25,,,28,,,6,,,-2,,,,,,129,,,29%,,,3,,,5,,
177,https://vlr.gg/player/46755/volay,2024-09-12 05:00:00,,,,179,,,22,,,28,,,10,,,-1,,,,,,116,,,44%,,,0,,,1,,
178,https://vlr.gg/player/47632/lilmad,2024-09-12 05:00:00,,,,160,,,19,,,32,,,5,,,-3,,,,,,116,,,29%,,,4,,,7,,
179,https://vlr.gg/player/46753/hunter,2024-09-12 05:00:00,,,,117,,,10,,,31,,,16,,,-3,,,,,,76,,,25%,,,2,,,5,,
180,https://vlr.gg/player/28716/lukxo,2024-09-11 18:35:00,1.47,0.80,1.11,207,265,159,34,20,14,32,13,19,8,5,3,-1,+2,-3,69%,77%,62%,141,190,99,41%,41%,41%,5,3,2,6,1,5
181,https://vlr.gg/player/21659/sato,2024-09-11 18:35:00,0.88,1.09,0.99,232,209,260,38,16,22,37,17,20,10,4,6,-1,-2,+1,63%,55%,69%,144,124,161,29%,33%,25%,7,3,4,8,5,3
182,https://vlr.gg/player/1994/evilkyk,2024-09-11 18:35:00,0.89,0.68,0.77,147,167,148,27,12,15,32,14,18,11,9,2,-3,+1,-4,69%,68%,69%,107,119,97,27%,26%,29%,2,2,0,5,1,4
183,https://vlr.gg/player/6238/urango,2024-09-11 18:35:00,0.95,0.50,0.71,158,169,147,27,15,12,38,14,24,18,10,8,-4,-3,-1,58%,64%,54%,100,113,88,18%,13%,25%,2,0,2,6,3,3
184,https://vlr.gg/player/1688/rood,2024-09-11 18:35:00,1.02,0.44,0.71,158,187,130,25,16,9,37,14,23,20,9,11,-3,-2,-1,67%,68%,65%,106,117,96,16%,20%,12%,2,1,1,5,3,2
185,https://vlr.gg/player/41135/dantedeu5,2024-09-11 18:35:00,1.67,1.46,1.58,354,372,323,58,34,24,38,19,19,11,5,6,+16,+12,+4,90%,96%,82%,221,232,208,39%,38%,39%,19,13,6,3,1,2
186,https://vlr.gg/player/2585/tinchoff,2024-09-11 18:35:00,1.17,1.07,1.12,185,188,188,33,17,16,28,13,15,11,7,4,0,0,0,77%,85%,68%,124,129,118,42%,40%,45%,6,2,4,6,2,4
187,https://vlr.gg/player/3826/adverso,2024-09-11 18:35:00,1.26,0.67,0.99,176,192,168,28,19,9,29,12,17,21,13,8,0,0,0,75%,92%,55%,121,119,122,20%,23%,17%,3,1,2,3,1,2
188,https://vlr.gg/player/9354/cebando,2024-09-11 18:35:00,1.32,0.58,0.98,192,250,103,30,25,5,29,14,15,19,7,12,-2,-2,0,75%,85%,64%,121,163,72,27%,32%,15%,1,1,0,3,3,0
189,https://vlr.gg/player/13861/nicomachine,2024-09-11 18:35:00,0.71,1.29,0.98,157,107,214,26,9,17,27,14,13,21,13,8,-2,-2,0,73%,85%,59%,102,72,138,18%,16%,20%,1,0,1,3,2,1
190,https://vlr.gg/player/64/gmd,2024-09-11 15:00:00,1.40,0.92,1.13,217,264,180,41,23,18,40,18,22,25,9,16,-4,-2,-2,70%,68%,71%,136,166,113,28%,25%,31%,1,0,1,5,2,3
191,https://vlr.gg/player/849/poised,2024-09-11 15:00:00,0.73,1.18,0.98,187,158,209,37,12,25,41,21,20,23,10,13,-2,0,-2,66%,56%,74%,109,102,114,25%,16%,32%,4,2,2,6,2,4
192,https://vlr.gg/player/3702/sym,2024-09-11 15:00:00,0.74,1.13,0.96,228,202,249,44,17,27,46,21,25,9,3,6,-1,-5,+4,68%,68%,68%,154,136,168,34%,40%,30%,13,3,10,14,8,6
193,https://vlr.gg/player/740/aproto,2024-09-11 15:00:00,0.34,1.06,0.74,144,75,202,27,6,21,39,19,20,10,3,7,0,0,0,64%,56%,71%,99,59,131,29%,26%,30%,1,1,0,1,1,0
194,https://vlr.gg/player/8376/seven,2024-09-11 15:00:00,0.76,0.68,0.71,152,162,146,28,14,14,40,19,21,17,7,10,-7,-2,-5,68%,64%,71%,110,110,110,27%,39%,21%,2,2,0,9,4,5
195,https://vlr.gg/player/8892/snw,2024-09-11 15:00:00,0.93,1.93,1.37,298,227,389,59,24,35,39,25,14,12,5,7,+9,+5,+4,77%,68%,88%,201,157,256,24%,28%,22%,14,8,6,5,3,2
196,https://vlr.gg/player/1294/nagz,2024-09-11 15:00:00,1.29,1.39,1.33,229,206,260,45,25,20,31,18,13,9,2,7,+6,+1,+5,88%,84%,92%,160,143,181,27%,35%,22%,6,1,5,0,0,0
197,https://vlr.gg/player/2464/suther,2024-09-11 15:00:00,0.96,1.19,1.06,169,164,174,35,19,16,35,22,13,25,11,14,+3,0,+3,75%,71%,80%,110,111,108,25%,24%,26%,7,4,3,4,4,0
198,https://vlr.gg/player/2468/delz1k,2024-09-11 15:00:00,1.06,0.98,1.03,184,201,161,37,22,15,35,20,15,17,8,9,-3,-2,-1,73%,71%,76%,118,129,103,26%,27%,26%,3,1,2,6,3,3
199,https://vlr.gg/player/783/murizzz,2024-09-11 15:00:00,0.86,0.69,0.78,155,177,130,30,18,12,37,20,17,14,9,5,-1,+1,-2,71%,71%,72%,101,117,82,24%,21%,30%,5,4,1,6,3,3
200,https://vlr.gg/player/19371/eva,2024-09-11 11:00:00,1.14,1.25,1.20,213,204,219,45,18,27,34,14,20,10,3,7,+2,+2,0,74%,71%,76%,137,124,147,28%,29%,28%,4,3,1,2,1,1
201,https://vlr.gg/player/29903/madv,2024-09-11 11:00:00,1.31,0.93,1.09,201,238,183,44,22,22,39,15,24,21,6,15,-2,0,-2,79%,79%,79%,136,153,124,34%,53%,22%,3,2,1,5,2,3
202,https://vlr.gg/player/17333/mary,2024-09-11 11:00:00,0.52,1.54,1.07,263,149,353,50,12,38,46,20,26,12,4,8,+7,-2,+9,70%,63%,76%,166,94,218,35%,38%,33%,15,3,12,8,5,3
203,https://vlr.gg/player/20055/toki,2024-09-11 11:00:00,1.17,0.65,0.87,163,194,143,31,17,14,39,15,24,25,10,15,-5,-2,-3,70%,71%,70%,118,147,96,31%,36%,27%,3,1,2,8,3,5
204,https://vlr.gg/player/29900/sandra,2024-09-11 11:00:00,1.09,0.64,0.83,165,235,117,34,19,15,41,19,22,15,10,5,+1,+2,-1,68%,79%,61%,119,161,89,39%,40%,38%,5,3,2,4,1,3
205,https://vlr.gg/player/26632/joliinaa,2024-09-11 11:00:00,1.06,1.09,1.07,194,186,202,39,22,17,39,22,17,20,15,5,-2,-3,+1,65%,64%,67%,124,114,139,24%,22%,26%,4,2,2,6,5,1
206,https://vlr.gg/player/24101/miyori,2024-09-11 11:00:00,0.95,1.18,1.05,213,200,223,42,23,19,41,24,17,13,8,5,0,0,0,65%,64%,67%,136,133,140,33%,36%,29%,6,3,3,6,3,3
207,https://vlr.gg/player/24107/sarah,2024-09-11 11:00:00,1.05,1.03,1.04,227,230,219,48,29,19,40,24,16,18,11,7,+2,+1,+1,77%,82%,71%,134,139,127,33%,30%,38%,4,2,2,2,1,1
208,https://vlr.gg/player/16418/smurfette,2024-09-11 11:00:00,1.02,0.72,0.89,196,217,165,40,25,15,44,24,20,8,7,1,0,+1,-1,67%,70%,63%,122,132,108,32%,31%,33%,10,7,3,10,6,4
209,https://vlr.gg/player/17343/ness,2024-09-11 11:00:00,0.91,0.77,0.85,165,162,161,30,17,13,40,22,18,18,11,7,-3,-2,-1,65%,76%,50%,116,113,120,22%,22%,22%,3,1,2,6,3,3
210,https://vlr.gg/player/22047/rarga,2024-09-11 07:15:00,,,,294,,,61,,,45,,,11,,,+12,,,,,,195,,,33%,,,18,,,6,,
211,https://vlr.gg/player/37927/happywei,2024-09-11 07:15:00,,,,240,,,50,,,46,,,16,,,+1,,,,,,151,,,32%,,,7,,,6,,
212,https://vlr.gg/player/5796/kr1stal,2024-09-11 07:15:00,,,,209,,,43,,,40,,,18,,,-3,,,,,,150,,,29%,,,6,,,9,,
213,https://vlr.gg/player/36668/mart1n,2024-09-11 07:15:00,,,,199,,,42,,,34,,,28,,,+2,,,,,,118,,,25%,,,3,,,1,,
214,https://vlr.gg/player/37674/mrcani,2024-09-11 07:15:00,,,,166,,,39,,,37,,,22,,,-1,,,,,,114,,,34%,,,2,,,3,,
215,https://vlr.gg/player/19531/qiuye,2024-09-11 07:15:00,,,,232,,,51,,,41,,,16,,,+1,,,,,,147,,,28%,,,6,,,5,,
216,https://vlr.gg/player/3124/core,2024-09-11 07:15:00,,,,193,,,42,,,45,,,24,,,-3,,,,,,128,,,34%,,,1,,,4,,
217,https://vlr.gg/player/47102/waituu,2024-09-11 07:15:00,,,,192,,,42,,,47,,,23,,,-7,,,,,,123,,,20%,,,5,,,12,,
218,https://vlr.gg/player/47101/5cm,2024-09-11 07:15:00,,,,190,,,36,,,56,,,16,,,+1,,,,,,126,,,25%,,,11,,,10,,
219,https://vlr.gg/player/47103/g1xad,2024-09-11 07:15:00,,,,138,,,31,,,46,,,7,,,-3,,,,,,91,,,29%,,,2,,,5,,
220,https://vlr.gg/player/41739/slowly,2024-09-11 05:00:00,,,,293,,,46,,,30,,,3,,,+3,,,,,,175,,,33%,,,8,,,5,,
221,https://vlr.gg/player/251/b1sk,2024-09-11 05:00:00,,,,227,,,32,,,34,,,6,,,-4,,,,,,144,,,25%,,,5,,,9,,
222,https://vlr.gg/player/4710/you,2024-09-11 05:00:00,,,,214,,,32,,,33,,,13,,,+1,,,,,,135,,,33%,,,3,,,2,,
223,https://vlr.gg/player/8225/f1cio,2024-09-11 05:00:00,,,,167,,,25,,,33,,,17,,,-1,,,,,,101,,,28%,,,2,,,3,,
224,https://vlr.gg/player/14439/ffs,2024-09-11 05:00:00,,,,99,,,13,,,35,,,15,,,-3,,,,,,72,,,15%,,,1,,,4,,
225,https://vlr.gg/player/1916/free1ng,2024-09-11 05:00:00,,,,373,,,58,,,27,,,8,,,+5,,,,,,229,,,36%,,,8,,,3,,
226,https://vlr.gg/player/3531/midnight,2024-09-11 05:00:00,,,,240,,,35,,,28,,,19,,,+4,,,,,,165,,,30%,,,5,,,1,,
227,https://vlr.gg/player/4428/udotan,2024-09-11 05:00:00,,,,236,,,33,,,31,,,15,,,-1,,,,,,171,,,28%,,,4,,,5,,
228,https://vlr.gg/player/45811/sn0wflake,2024-09-11 05:00:00,,,,137,,,21,,,29,,,18,,,-2,,,,,,79,,,40%,,,2,,,4,,
229,https://vlr.gg/player/11527/noman,2024-09-11 05:00:00,,,,119,,,18,,,33,,,8,,,-2,,,,,,86,,,27%,,,4,,,6,,
230,https://vlr.gg/player/8082/zander,2024-09-10 22:25:00,0.82,1.64,1.23,239,186,295,45,17,28,36,20,16,16,6,10,+5,+3,+2,80%,74%,85%,153,123,182,21%,24%,20%,8,5,3,3,2,1
231,https://vlr.gg/player/3722/koalanoob,2024-09-10 22:25:00,1.37,0.87,1.12,227,262,189,44,26,18,37,17,20,22,13,9,+5,+3,+2,74%,78%,70%,144,173,116,24%,23%,26%,12,7,5,7,4,3
232,https://vlr.gg/player/864/bcj,2024-09-10 22:25:00,1.15,0.88,1.01,212,222,202,37,20,17,39,19,20,24,15,9,+1,+2,-1,80%,85%,74%,134,141,128,20%,21%,20%,6,3,3,5,1,4
233,https://vlr.gg/player/4828/nismo,2024-09-10 22:25:00,0.84,1.06,0.95,175,164,186,32,14,18,38,20,18,34,18,16,-1,0,-1,72%,70%,74%,114,109,119,26%,33%,21%,1,1,0,2,1,1
234,https://vlr.gg/player/6582/net,2024-09-10 22:25:00,0.98,0.76,0.87,162,183,137,33,19,14,37,18,19,7,2,5,-2,+1,-3,69%,59%,78%,110,121,98,41%,39%,43%,4,2,2,6,1,5
235,https://vlr.gg/player/9354/cebando,2024-09-10 22:25:00,1.39,1.14,1.26,213,237,189,38,22,16,36,17,19,33,13,20,+2,+2,0,76%,78%,74%,139,155,123,30%,35%,26%,4,2,2,2,0,2
236,https://vlr.gg/player/41135/dantedeu5,2024-09-10 22:25:00,1.17,1.24,1.20,260,270,247,51,28,23,41,22,19,14,2,12,-4,+1,-5,70%,67%,74%,172,170,174,36%,42%,32%,5,5,0,9,4,5
237,https://vlr.gg/player/2585/tinchoff,2024-09-10 22:25:00,0.98,0.93,0.96,196,201,192,37,20,17,39,18,21,10,5,5,+1,+3,-2,70%,70%,70%,136,125,147,33%,33%,33%,7,6,1,6,3,3
238,https://vlr.gg/player/3826/adverso,2024-09-10 22:25:00,0.89,0.97,0.93,189,179,206,37,17,20,39,19,20,11,6,5,-1,-1,0,74%,81%,67%,130,128,133,31%,39%,25%,4,0,4,5,1,4
239,https://vlr.gg/player/13861/nicomachine,2024-09-10 22:25:00,0.49,0.94,0.71,134,91,178,24,6,18,36,19,17,17,8,9,-6,-4,-2,78%,78%,78%,94,79,110,22%,17%,27%,3,1,2,9,5,4
240,https://vlr.gg/player/28716/lukxo,2024-09-10 18:00:00,1.29,0.93,1.13,271,299,213,70,45,25,59,31,28,24,11,13,-2,0,-2,79%,72%,86%,171,192,146,32%,31%,33%,8,5,3,10,5,5
241,https://vlr.gg/player/21659/sato,2024-09-10 18:00:00,1.14,1.04,1.10,251,289,210,71,43,28,61,35,26,8,6,2,+9,+5,+4,75%,81%,68%,159,173,143,40%,40%,40%,16,8,8,7,3,4
242,https://vlr.gg/player/1688/rood,2024-09-10 18:00:00,0.85,1.19,1.01,169,136,209,50,21,29,51,27,24,22,13,9,-6,-4,-2,71%,74%,68%,111,94,131,22%,24%,20%,3,2,1,9,6,3
243,https://vlr.gg/player/1994/evilkyk,2024-09-10 18:00:00,0.96,0.86,0.91,171,178,173,50,29,21,56,28,28,21,11,10,-2,-1,-1,71%,74%,68%,116,112,120,34%,35%,33%,5,2,3,7,3,4
244,https://vlr.gg/player/6238/urango,2024-09-10 18:00:00,0.67,0.72,0.69,145,118,176,40,19,21,60,29,31,24,14,10,-3,-3,0,70%,65%,76%,96,76,120,40%,41%,38%,6,3,3,9,6,3
245,https://vlr.gg/player/8376/seven,2024-09-10 18:00:00,1.30,1.08,1.18,236,230,244,66,33,33,57,23,34,31,13,18,-2,-3,+1,74%,76%,72%,158,147,167,23%,31%,18%,8,1,7,10,4,6
246,https://vlr.gg/player/3702/sym,2024-09-10 18:00:00,1.12,1.11,1.11,253,302,235,74,38,36,63,31,32,8,3,5,+12,+9,+3,74%,78%,70%,165,181,150,27%,36%,19%,23,13,10,11,4,7
247,https://vlr.gg/player/64/gmd,2024-09-10 18:00:00,0.96,1.10,1.04,169,166,185,48,21,27,52,25,27,46,27,19,+1,-1,+2,80%,78%,81%,119,100,136,32%,20%,43%,3,1,2,2,2,0
248,https://vlr.gg/player/740/aproto,2024-09-10 18:00:00,1.13,0.80,0.95,168,185,159,49,24,25,57,23,34,22,12,10,-2,+1,-3,71%,78%,65%,118,128,110,41%,45%,38%,4,2,2,6,1,5
249,https://vlr.gg/player/849/poised,2024-09-10 18:00:00,0.87,0.98,0.93,180,157,204,50,21,29,52,22,30,29,15,14,-5,-5,0,83%,81%,84%,123,115,129,29%,30%,28%,4,2,2,9,7,2
250,https://vlr.gg/player/2464/suther,2024-09-10 15:00:00,0.61,1.21,1.02,182,151,186,22,6,16,25,10,15,15,4,11,-1,0,-1,74%,73%,75%,109,74,125,27%,25%,28%,0,0,0,1,0,1
251,https://vlr.gg/player/8892/snw,2024-09-10 15:00:00,0.59,0.90,0.80,228,206,246,28,7,21,31,11,20,2,0,2,+1,-2,+3,60%,45%,67%,148,125,158,16%,11%,20%,10,2,8,9,4,5
252,https://vlr.gg/player/1294/nagz,2024-09-10 15:00:00,0.96,0.60,0.72,141,163,133,17,6,11,25,8,17,4,3,1,-2,0,-2,57%,45%,63%,98,118,89,22%,18%,24%,0,0,0,2,0,2
253,https://vlr.gg/player/783/murizzz,2024-09-10 15:00:00,0.79,0.53,0.62,150,206,138,15,6,9,30,10,20,11,4,7,-4,0,-4,69%,64%,71%,119,146,107,24%,27%,22%,1,1,0,5,1,4
254,https://vlr.gg/player/2468/delz1k,2024-09-10 15:00:00,0.35,0.75,0.59,146,55,194,16,2,14,28,9,19,15,4,11,-3,-3,0,66%,45%,75%,95,32,124,18%,29%,17%,2,0,2,5,3,2
255,https://vlr.gg/player/21661/spike,2024-09-10 15:00:00,1.76,1.74,1.75,336,335,328,44,31,13,20,14,6,10,6,4,+5,+1,+4,80%,79%,82%,203,210,188,28%,36%,17%,10,5,5,5,4,1
256,https://vlr.gg/player/11921/silentzz,2024-09-10 15:00:00,1.41,1.43,1.42,272,278,234,34,24,10,20,16,4,10,6,4,+6,+5,+1,86%,83%,91%,168,183,135,22%,23%,19%,6,5,1,0,0,0
257,https://vlr.gg/player/3169/zap,2024-09-10 15:00:00,1.04,1.80,1.28,197,169,264,25,13,12,19,13,6,20,11,9,+2,+1,+1,83%,83%,82%,127,112,160,29%,28%,29%,3,2,1,1,1,0
258,https://vlr.gg/player/662/pryze,2024-09-10 15:00:00,1.23,0.95,1.14,161,172,151,21,15,6,17,12,5,18,12,6,-2,-2,0,86%,83%,91%,112,119,98,16%,16%,15%,1,0,1,3,2,1
259,https://vlr.gg/player/6195/lz,2024-09-10 15:00:00,0.61,1.02,0.74,127,110,156,15,8,7,22,16,6,17,11,6,-2,-1,-1,77%,79%,73%,87,81,101,25%,28%,22%,2,2,0,4,3,1
260,https://vlr.gg/player/16196/annie,2024-09-10 11:00:00,1.09,1.21,1.14,226,237,230,55,25,30,46,22,24,8,3,5,-4,-3,-1,71%,68%,74%,149,151,148,39%,55%,27%,8,4,4,12,7,5
261,https://vlr.gg/player/39506/cabbit,2024-09-10 11:00:00,0.96,1.15,1.06,221,207,228,49,21,28,46,22,24,13,4,9,-1,-4,+3,75%,64%,83%,156,149,162,30%,39%,26%,6,1,5,7,5,2
262,https://vlr.gg/player/20058/devilasxa,2024-09-10 11:00:00,1.00,1.08,1.04,193,179,209,41,16,25,45,20,25,32,17,15,+3,0,+3,76%,79%,74%,132,118,143,24%,23%,25%,6,2,4,3,2,1
263,https://vlr.gg/player/20116/jademwah,2024-09-10 11:00:00,1.05,0.83,0.93,210,241,185,45,23,22,49,22,27,24,10,14,+1,-1,+2,70%,75%,66%,124,141,110,25%,32%,20%,8,3,5,7,4,3
264,https://vlr.gg/player/7460/6sonya,2024-09-10 11:00:00,0.80,0.63,0.71,130,156,117,30,16,14,45,20,25,15,7,8,-4,0,-4,65%,68%,63%,99,116,86,37%,33%,41%,1,0,1,5,0,5
265,https://vlr.gg/player/39057/safiaa,2024-09-10 11:00:00,1.26,1.19,1.23,227,201,248,51,25,26,40,19,21,16,7,9,+3,0,+3,81%,77%,86%,151,146,156,34%,36%,32%,4,1,3,1,1,0
266,https://vlr.gg/player/21158/marti,2024-09-10 11:00:00,1.16,1.13,1.15,243,246,237,53,30,23,48,26,22,16,8,8,+1,-2,+3,68%,66%,71%,162,162,162,23%,22%,25%,16,8,8,15,10,5
267,https://vlr.gg/player/30186/nami,2024-09-10 11:00:00,0.86,1.25,1.04,214,190,251,53,25,28,48,27,21,19,13,6,+1,+1,0,68%,63%,75%,141,125,161,36%,39%,34%,5,3,2,4,2,2
268,https://vlr.gg/player/24058/tokameite,2024-09-10 11:00:00,0.96,0.97,0.96,169,174,173,35,21,14,39,22,17,25,11,14,+4,+1,+3,81%,80%,82%,125,133,116,29%,34%,22%,5,2,3,1,1,0
269,https://vlr.gg/player/20761/looxie,2024-09-10 11:00:00,0.91,0.79,0.86,172,202,138,39,26,13,47,25,22,27,12,15,-4,-3,-1,78%,74%,82%,111,132,84,41%,43%,38%,4,2,2,8,5,3
270,https://vlr.gg/player/24058/tokameite,2024-09-09 13:40:00,1.22,1.34,1.29,238,192,276,42,15,27,33,15,18,19,9,10,+3,+1,+2,72%,55%,86%,161,129,187,34%,33%,35%,4,1,3,1,0,1
271,https://vlr.gg/player/21158/marti,2024-09-09 13:40:00,0.76,1.09,0.94,213,190,227,33,12,21,38,18,20,9,7,2,+2,-4,+6,72%,64%,79%,132,126,137,28%,24%,30%,9,2,7,7,6,1
272,https://vlr.gg/player/39057/safiaa,2024-09-09 13:40:00,0.72,1.08,0.92,179,150,219,35,12,23,37,19,18,9,4,5,-4,-3,-1,70%,59%,79%,138,114,158,37%,28%,42%,2,0,2,6,3,3
273,https://vlr.gg/player/30186/nami,2024-09-09 13:40:00,0.55,1.17,0.90,183,124,219,30,9,21,35,18,17,17,5,12,-1,-2,+1,66%,59%,71%,118,97,135,42%,48%,38%,5,1,4,6,3,3
274,https://vlr.gg/player/20761/looxie,2024-09-09 13:40:00,0.54,0.77,0.67,137,133,169,24,9,15,40,20,20,22,8,14,-4,-2,-2,70%,64%,75%,102,84,116,21%,10%,31%,3,2,1,7,4,3
275,https://vlr.gg/player/41207/jade,2024-09-09 13:40:00,1.30,1.39,1.34,267,253,272,45,25,20,36,22,14,27,14,13,+7,+2,+5,76%,64%,91%,160,159,161,28%,29%,26%,7,2,5,0,0,0
276,https://vlr.gg/player/19373/ginger,2024-09-09 13:40:00,0.92,1.27,1.07,217,173,244,37,18,19,32,17,15,16,7,9,-2,-4,+2,68%,54%,86%,130,104,162,20%,20%,21%,5,3,2,7,7,0
277,https://vlr.gg/player/37969/ellie,2024-09-09 13:40:00,0.77,1.39,1.04,239,223,233,44,22,22,35,25,10,1,1,0,+2,-2,+4,70%,61%,82%,146,140,153,39%,43%,33%,10,3,7,8,5,3
278,https://vlr.gg/player/30042/harmonee,2024-09-09 13:40:00,0.89,1.20,1.03,191,182,209,31,16,15,33,22,11,15,8,7,0,0,0,74%,68%,82%,132,120,149,17%,14%,20%,3,2,1,3,2,1
279,https://vlr.gg/player/17318/blossi,2024-09-09 13:40:00,0.68,1.30,0.95,143,122,180,26,13,13,29,21,8,26,8,18,-3,-2,-1,68%,54%,86%,102,83,125,30%,28%,32%,2,1,1,5,3,2
280,https://vlr.gg/player/17333/mary,2024-09-09 11:00:00,1.56,1.09,1.32,317,359,276,57,34,23,40,17,23,9,2,7,+13,+8,+5,79%,77%,81%,197,207,188,46%,51%,40%,18,11,7,5,3,2
281,https://vlr.gg/player/20055/toki,2024-09-09 11:00:00,1.19,1.41,1.30,252,236,270,46,23,23,33,15,18,17,6,11,-3,-3,0,73%,69%,77%,170,156,184,37%,39%,35%,2,1,1,5,4,1
282,https://vlr.gg/player/29900/sandra,2024-09-09 11:00:00,1.12,0.92,1.02,208,199,218,40,21,19,34,13,21,10,4,6,-1,-3,+2,71%,77%,65%,136,139,133,43%,46%,40%,5,0,5,6,3,3
283,https://vlr.gg/player/29903/madv,2024-09-09 11:00:00,1.23,0.60,0.92,153,176,130,28,17,11,32,12,20,27,15,12,+3,+3,0,73%,81%,65%,102,116,88,37%,41%,32%,5,3,2,2,0,2
284,https://vlr.gg/player/19371/eva,2024-09-09 11:00:00,0.84,0.95,0.90,133,111,156,25,9,16,32,14,18,16,10,6,+2,+1,+1,77%,73%,81%,96,86,105,26%,20%,32%,3,1,2,1,0,1
285,https://vlr.gg/player/38142/dream,2024-09-09 11:00:00,1.38,0.58,0.98,199,273,127,37,25,12,38,17,21,9,7,2,+1,+1,0,65%,73%,58%,135,188,83,28%,25%,34%,6,3,3,5,2,3
286,https://vlr.gg/player/22792/jiex,2024-09-09 11:00:00,0.86,1.06,0.96,193,173,213,36,18,18,40,19,21,17,14,3,-1,-2,+1,73%,88%,58%,124,105,142,30%,24%,35%,2,0,2,3,2,1
287,https://vlr.gg/player/24071/liza,2024-09-09 11:00:00,0.83,1.08,0.96,236,248,224,42,22,20,42,21,21,12,7,5,-3,-2,-1,73%,73%,73%,148,153,144,19%,20%,19%,10,6,4,13,8,5
288,https://vlr.gg/player/17394/ninou,2024-09-09 11:00:00,1.25,0.62,0.94,164,207,121,28,19,9,34,15,19,19,10,9,-3,-2,-1,75%,85%,65%,120,154,87,15%,20%,8%,1,0,1,4,2,2
289,https://vlr.gg/player/20098/mel,2024-09-09 11:00:00,0.75,0.55,0.65,148,163,134,28,16,12,42,20,22,16,9,7,-8,-3,-5,67%,69%,65%,94,104,84,24%,22%,26%,0,0,0,8,3,5
290,https://vlr.gg/player/44464/nezha,2024-09-08 18:00:00,1.60,1.31,1.45,304,328,285,108,57,51,71,32,39,38,21,17,-2,-4,+2,78%,78%,77%,191,203,179,39%,33%,47%,13,5,8,15,9,6
291,https://vlr.gg/player/28993/guterwoman,2024-09-08 18:00:00,1.30,1.19,1.25,244,256,235,96,52,44,69,32,37,15,7,8,-5,-2,-3,69%,78%,60%,158,171,146,35%,37%,33%,5,2,3,10,4,6
292,https://vlr.gg/player/35830/zidian,2024-09-08 18:00:00,1.08,0.92,1.00,171,174,168,39,19,20,43,20,23,28,17,11,-1,-1,0,69%,73%,65%,115,112,118,28%,27%,29%,6,1,5,7,2,5
293,https://vlr.gg/player/44500/atisca,2024-09-08 18:00:00,1.05,0.86,0.95,214,220,208,75,40,35,76,35,41,19,12,7,+7,0,+7,70%,80%,60%,137,138,136,15%,14%,17%,18,8,10,11,8,3
294,https://vlr.gg/player/35857/mayzin,2024-09-08 18:00:00,0.86,0.69,0.77,175,176,171,35,17,18,48,21,27,28,19,9,-6,-5,-1,79%,80%,77%,119,122,117,25%,19%,33%,1,1,0,7,6,1
295,https://vlr.gg/player/35920/lapapaluna,2024-09-08 18:00:00,0.80,0.72,0.76,152,147,153,39,19,20,56,27,29,23,12,11,-4,0,-4,72%,73%,71%,104,106,101,16%,17%,15%,3,2,1,7,2,5
296,https://vlr.gg/player/21588/miku,2024-09-08 18:00:00,1.15,1.21,1.18,269,262,274,97,50,47,81,39,42,20,10,10,+8,+1,+7,68%,62%,74%,162,155,168,16%,18%,13%,25,14,11,17,13,4
297,https://vlr.gg/player/39558/liz,2024-09-08 18:00:00,1.22,1.09,1.16,219,219,220,80,43,37,70,33,37,27,16,11,-3,+1,-4,74%,83%,64%,151,148,154,29%,31%,28%,3,2,1,6,1,5
298,https://vlr.gg/player/47627/xirxia,2024-09-08 18:00:00,1.21,0.67,0.96,228,256,199,68,42,26,68,31,37,19,9,10,+9,+2,+7,75%,77%,74%,144,160,126,28%,33%,22%,14,5,9,5,3,2
299,https://vlr.gg/player/35841/maygg,2024-09-08 18:00:00,0.80,0.92,0.86,180,169,198,62,29,33,76,37,39,24,11,13,+2,-1,+3,69%,66%,72%,127,121,133,25%,28%,23%,10,4,6,8,5,3
300,https://vlr.gg/player/45181/kaz,2024-09-08 18:00:00,0.49,0.93,0.73,128,75,173,8,1,7,16,8,8,11,6,5,-3,-2,-1,64%,50%,75%,82,55,105,19%,25%,17%,0,0,0,3,2,1
301,https://vlr.gg/player/35842/asomy,2024-09-08 18:00:00,0.81,0.47,0.65,129,149,109,48,31,17,81,40,41,45,27,18,-2,-2,0,73%,77%,68%,80,87,73,18%,20%,16%,5,1,4,7,3,4
302,https://vlr.gg/player/37847/fighter,2024-09-08 14:05:00,0.81,1.22,0.99,217,178,256,34,16,18,35,20,15,4,4,0,-5,-4,-1,50%,42%,60%,139,120,162,33%,27%,40%,5,3,2,10,7,3
303,https://vlr.gg/player/1618/spyzera,2024-09-08 14:05:00,0.59,1.46,0.99,203,145,290,29,10,19,34,19,15,15,7,8,-3,-1,-2,64%,54%,75%,144,100,198,25%,38%,18%,2,2,0,5,3,2
304,https://vlr.gg/player/5599/khaalid,2024-09-08 14:05:00,1.29,0.48,0.92,182,235,130,28,22,6,33,14,19,10,3,7,-1,-1,0,73%,79%,65%,126,151,96,39%,44%,32%,4,1,3,5,2,3
305,https://vlr.gg/player/6503/sand,2024-09-08 14:05:00,0.91,0.40,0.68,172,219,116,28,19,9,37,19,18,1,1,0,-5,-2,-3,59%,75%,40%,119,148,85,29%,31%,27%,1,1,0,6,3,3
306,https://vlr.gg/player/5600/moh,2024-09-08 14:05:00,0.79,0.50,0.66,139,155,121,22,13,9,35,19,16,6,3,3,-2,0,-2,61%,71%,50%,93,99,85,31%,31%,32%,2,1,1,4,1,3
307,https://vlr.gg/player/40591/comeback,2024-09-08 14:05:00,1.22,1.51,1.38,315,296,334,50,21,29,29,13,16,6,4,2,+8,+5,+3,77%,70%,83%,200,189,209,31%,31%,31%,12,6,6,4,1,3
308,https://vlr.gg/player/31305/lar0k,2024-09-08 14:05:00,1.22,1.31,1.27,237,191,266,36,14,22,27,12,15,16,7,9,+5,+2,+3,75%,85%,67%,140,116,161,35%,29%,38%,6,2,4,1,0,1
309,https://vlr.gg/player/31855/celasun,2024-09-08 14:05:00,1.53,0.91,1.19,223,296,163,38,23,15,27,12,15,3,2,1,+1,-1,+2,73%,80%,67%,142,193,99,33%,33%,33%,3,1,2,2,2,0
310,https://vlr.gg/player/5565/ros,2024-09-08 14:05:00,1.41,0.51,0.92,139,219,79,22,16,6,24,9,15,10,4,6,+1,+3,-2,73%,80%,67%,102,156,57,30%,33%,22%,3,3,0,2,0,2
311,https://vlr.gg/player/24344/loita,2024-09-08 14:05:00,0.55,1.13,0.86,185,131,230,27,8,19,34,16,18,21,9,12,+1,-1,+2,73%,65%,79%,119,91,143,42%,46%,39%,6,2,4,5,3,2
312,https://vlr.gg/player/26632/joliinaa,2024-09-08 13:35:00,1.49,1.32,1.40,223,241,204,30,17,13,21,11,10,36,16,20,0,0,0,93%,89%,95%,139,148,130,18%,18%,18%,1,0,1,1,0,1
313,https://vlr.gg/player/24101/miyori,2024-09-08 13:35:00,1.62,1.20,1.40,257,320,202,41,24,17,25,13,12,7,4,3,+6,+4,+2,83%,89%,76%,168,199,140,24%,28%,20%,9,5,4,3,1,2
314,https://vlr.gg/player/24107/sarah,2024-09-08 13:35:00,0.75,1.74,1.27,237,141,317,34,8,26,24,13,11,23,7,16,+4,+2,+2,78%,63%,90%,143,102,180,27%,17%,33%,4,2,2,0,0,0
315,https://vlr.gg/player/17343/ness,2024-09-08 13:35:00,1.10,1.23,1.17,184,156,217,24,9,15,20,10,10,21,8,13,0,+1,-1,85%,79%,90%,134,119,147,18%,27%,14%,1,1,0,1,0,1
316,https://vlr.gg/player/16418/smurfette,2024-09-08 13:35:00,1.06,1.20,1.13,263,225,295,41,16,25,32,13,19,5,3,2,+8,0,+8,75%,63%,86%,165,149,180,26%,23%,29%,14,5,9,6,5,1
317,https://vlr.gg/player/23049/alkyia,2024-09-08 13:35:00,0.56,1.52,1.02,242,151,351,35,11,24,36,20,16,8,4,4,0,-3,+3,63%,57%,68%,151,104,204,19%,26%,16%,5,1,4,5,4,1
318,https://vlr.gg/player/19363/proxima,2024-09-08 13:35:00,0.79,0.95,0.87,170,184,150,24,13,11,30,18,12,10,6,4,-5,-2,-3,68%,67%,68%,118,119,118,35%,34%,37%,0,0,0,5,2,3
319,https://vlr.gg/player/29442/wens,2024-09-08 13:35:00,1.13,0.37,0.77,191,264,107,26,19,7,34,18,16,6,3,3,-7,-3,-4,60%,71%,47%,131,176,81,43%,51%,30%,3,2,1,10,5,5
320,https://vlr.gg/player/17332/jduh,2024-09-08 13:35:00,0.56,0.65,0.60,156,151,163,20,10,10,36,20,16,16,10,6,-5,-3,-2,70%,76%,63%,96,90,103,26%,25%,27%,2,1,1,7,4,3
321,https://vlr.gg/player/17339/felipa,2024-09-08 13:35:00,0.48,0.65,0.56,132,142,123,17,9,8,34,20,14,9,3,6,-1,0,-1,53%,52%,53%,95,92,98,27%,27%,27%,1,1,0,2,1,1
322,https://vlr.gg/player/9554/kaajak,2024-09-08 12:00:00,1.96,1.05,1.42,299,376,248,45,24,21,26,9,17,5,1,4,+5,+3,+2,75%,100%,58%,197,268,150,44%,52%,33%,10,4,6,5,1,4
323,https://vlr.gg/player/1281/molsi,2024-09-08 12:00:00,1.07,1.47,1.31,227,176,262,30,9,21,20,8,12,16,7,9,+3,+1,+2,88%,81%,92%,164,118,194,27%,17%,31%,5,2,3,2,1,1
324,https://vlr.gg/player/129/hype,2024-09-08 12:00:00,0.90,1.13,1.04,253,245,253,34,14,20,31,13,18,16,5,11,+2,0,+2,75%,75%,75%,159,150,165,34%,41%,30%,7,3,4,5,3,2
325,https://vlr.gg/player/1507/avova,2024-09-08 12:00:00,1.37,0.81,1.04,153,151,154,24,9,15,20,4,16,16,10,6,-2,-1,-1,78%,94%,67%,98,95,99,32%,18%,46%,1,0,1,3,1,2
326,https://vlr.gg/player/101/soulcas,2024-09-08 12:00:00,1.17,0.85,0.97,179,218,154,26,12,14,25,9,16,13,8,5,0,+1,-1,78%,88%,71%,113,143,93,24%,23%,25%,1,1,0,1,0,1
327,https://vlr.gg/player/4329/vince,2024-09-08 12:00:00,0.98,1.20,1.07,210,198,232,31,18,13,29,17,12,11,7,4,-2,-2,0,63%,63%,63%,129,115,149,21%,21%,20%,1,0,1,3,2,1
328,https://vlr.gg/player/7490/anguist,2024-09-08 12:00:00,1.28,0.58,1.00,203,248,112,27,22,5,30,17,13,5,0,5,-2,0,-2,60%,58%,63%,126,156,81,23%,30%,11%,1,1,0,3,1,2
329,https://vlr.gg/player/10885/davih,2024-09-08 12:00:00,0.84,0.67,0.77,163,175,155,22,14,8,32,18,14,6,4,2,+1,+2,-1,60%,71%,44%,118,124,110,22%,28%,12%,4,3,1,3,1,2
330,https://vlr.gg/player/1835/elllement,2024-09-08 12:00:00,0.70,0.85,0.76,184,152,228,24,12,12,34,19,15,3,1,2,-2,-1,-1,48%,42%,56%,116,99,141,23%,42%,15%,7,4,3,9,5,4
331,https://vlr.gg/player/2472/benny,2024-09-08 12:00:00,0.64,0.40,0.54,145,167,118,18,13,5,34,20,14,7,3,4,-3,-3,0,50%,46%,56%,101,105,93,30%,29%,30%,3,2,1,6,5,1
332,https://vlr.gg/player/20064/vania,2024-09-08 11:00:00,2.02,1.19,1.59,282,349,222,35,15,10,22,4,8,17,4,4,0,0,0,91%,91%,92%,174,203,148,38%,33%,45%,0,0,0,0,0,0
333,https://vlr.gg/player/17323/mimi,2024-09-08 11:00:00,1.32,1.35,1.34,241,219,262,35,9,12,23,6,8,11,1,2,+3,+1,+2,87%,82%,92%,168,171,165,30%,38%,24%,4,2,2,1,1,0
334,https://vlr.gg/player/17320/petra,2024-09-08 11:00:00,0.88,1.20,1.05,166,127,203,22,5,9,22,6,8,15,5,2,-1,-1,0,83%,82%,83%,115,88,140,38%,31%,44%,1,0,1,2,1,1
335,https://vlr.gg/player/36175/rezq,2024-09-08 11:00:00,1.12,0.66,0.88,211,235,191,39,9,7,26,8,11,8,2,5,+2,+4,-2,61%,64%,58%,132,131,133,18%,11%,23%,6,5,1,4,1,3
336,https://vlr.gg/player/24149/amy,2024-09-08 11:00:00,0.41,0.55,0.48,147,132,161,30,6,7,29,10,11,15,2,2,+1,-1,+2,78%,82%,75%,86,85,86,43%,56%,36%,3,0,3,2,1,1
337,https://vlr.gg/player/11183/glance,2024-09-08 11:00:00,1.25,0.91,1.09,211,223,198,29,9,7,28,7,8,9,4,2,-5,-3,-2,78%,92%,64%,134,153,112,22%,33%,10%,0,0,0,5,3,2
338,https://vlr.gg/player/19356/kuripuuya,2024-09-08 11:00:00,0.78,1.38,1.07,277,210,351,29,10,13,33,9,10,2,2,0,+3,+1,+2,74%,83%,64%,179,134,229,42%,44%,40%,4,1,3,1,0,1
339,https://vlr.gg/player/21153/matrix,2024-09-08 11:00:00,1.11,0.82,0.97,256,327,180,28,14,7,33,10,8,1,0,0,0,+1,-1,70%,67%,73%,172,208,132,43%,37%,58%,4,3,1,4,2,2
340,https://vlr.gg/player/16419/roxi,2024-09-08 11:00:00,1.14,0.05,0.62,144,230,50,21,11,1,32,8,9,5,1,1,-1,0,-1,52%,67%,36%,85,126,41,27%,42%,11%,1,1,0,2,1,1
341,https://vlr.gg/player/16321/nelo,2024-09-08 11:00:00,0.19,0.87,0.52,116,70,168,15,2,6,35,11,9,15,5,4,-2,-1,-1,78%,75%,82%,78,49,111,36%,25%,43%,0,0,0,2,1,1
342,https://vlr.gg/player/35876/tconda,2024-09-07 18:00:00,1.20,1.44,1.32,312,296,326,45,22,23,32,17,15,10,3,7,+6,0,+6,77%,71%,82%,201,187,214,35%,30%,39%,11,3,8,5,3,2
343,https://vlr.gg/player/28222/panchill,2024-09-07 18:00:00,1.18,1.41,1.30,210,165,255,34,12,22,21,10,11,10,6,4,+2,0,+2,79%,76%,82%,147,128,166,31%,26%,36%,3,0,3,1,0,1
344,https://vlr.gg/player/35907/naxa,2024-09-07 18:00:00,1.41,0.95,1.17,276,339,217,39,24,15,30,15,15,12,5,7,-3,-1,-2,74%,81%,68%,182,223,144,22%,27%,18%,7,5,2,10,6,4
345,https://vlr.gg/player/21008/mcfly,2024-09-07 18:00:00,0.79,0.93,0.86,150,130,167,24,10,14,28,14,14,16,7,9,-3,-1,-2,72%,67%,77%,104,88,119,28%,17%,39%,0,0,0,3,1,2
346,https://vlr.gg/player/35873/gelatycat,2024-09-07 18:00:00,0.82,0.73,0.77,129,154,106,21,12,9,28,16,12,15,6,9,-1,-1,0,65%,62%,68%,89,109,70,42%,50%,32%,1,1,0,2,2,0
347,https://vlr.gg/player/20977/lynn,2024-09-07 18:00:00,1.06,1.26,1.16,287,259,316,41,18,23,35,17,18,11,4,7,+1,-1,+2,70%,59%,81%,187,164,211,28%,25%,32%,7,3,4,6,4,2
348,https://vlr.gg/player/29173/amxlist,2024-09-07 18:00:00,0.99,1.03,1.01,175,130,221,26,11,15,29,13,16,7,4,3,+4,+1,+3,65%,59%,71%,125,91,161,29%,23%,34%,4,1,3,0,0,0
349,https://vlr.gg/player/29823/mizzy,2024-09-07 18:00:00,0.89,0.91,0.90,190,211,166,28,16,12,33,18,15,13,6,7,-3,-3,0,72%,73%,71%,120,129,111,42%,42%,42%,3,1,2,6,4,2
350,https://vlr.gg/player/46258/bittersuite,2024-09-07 18:00:00,0.85,0.84,0.85,160,156,167,23,11,12,30,15,15,14,5,9,0,+1,-1,56%,55%,57%,112,107,117,49%,57%,43%,1,1,0,1,0,1
351,https://vlr.gg/player/35906/patitop,2024-09-07 18:00:00,0.47,0.65,0.56,137,137,139,21,11,10,36,20,16,4,1,3,-3,-2,-1,44%,41%,48%,90,90,90,30%,34%,26%,6,3,3,9,5,4
352,https://vlr.gg/player/31305/lar0k,2024-09-07 13:55:00,1.21,1.15,1.18,216,215,204,47,25,22,42,22,20,27,12,15,+1,-2,+3,71%,70%,73%,137,137,135,39%,35%,43%,7,3,4,6,5,1
353,https://vlr.gg/player/40591/comeback,2024-09-07 13:55:00,0.92,1.13,1.02,238,230,264,54,26,28,47,27,20,11,7,4,-8,-5,-3,60%,58%,63%,168,157,181,28%,28%,27%,8,5,3,16,10,6
354,https://vlr.gg/player/24344/loita,2024-09-07 13:55:00,0.81,1.16,0.98,187,183,206,41,18,23,44,26,18,25,13,12,-6,-5,-1,73%,76%,70%,134,131,136,38%,39%,38%,2,0,2,8,5,3
355,https://vlr.gg/player/31855/celasun,2024-09-07 13:55:00,0.81,0.90,0.86,172,145,197,35,16,19,45,26,19,15,8,7,+2,-1,+3,71%,70%,73%,115,94,138,30%,35%,27%,4,0,4,2,1,1
356,https://vlr.gg/player/5565/ros,2024-09-07 13:55:00,0.46,0.85,0.64,118,83,166,24,9,15,44,24,20,16,6,10,+4,+2,+2,60%,58%,63%,90,58,125,26%,27%,25%,7,3,4,3,1,2
357,https://vlr.gg/player/4329/vince,2024-09-07 13:55:00,1.14,1.38,1.27,226,173,264,51,20,31,37,18,19,24,10,14,+3,-2,+5,71%,63%,79%,141,113,167,28%,22%,31%,5,0,5,2,2,0
358,https://vlr.gg/player/7490/anguist,2024-09-07 13:55:00,1.12,1.39,1.26,239,202,271,58,24,34,41,22,19,7,3,4,+4,+2,+2,73%,67%,79%,166,138,190,44%,47%,42%,8,2,6,4,0,4
359,https://vlr.gg/player/1835/elllement,2024-09-07 13:55:00,1.09,1.23,1.17,226,247,208,51,26,25,40,23,17,13,5,8,+8,+2,+6,68%,60%,76%,151,162,142,28%,35%,19%,18,10,8,10,8,2
360,https://vlr.gg/player/10885/davih,2024-09-07 13:55:00,1.20,0.97,1.08,173,198,148,34,19,15,35,18,17,17,8,9,-2,-1,-1,70%,70%,70%,117,132,104,15%,22%,9%,3,1,2,5,2,3
361,https://vlr.gg/player/2472/benny,2024-09-07 13:55:00,0.35,0.87,0.59,128,93,161,28,8,20,48,26,22,17,5,12,-6,-5,-1,62%,50%,73%,77,61,92,20%,7%,33%,1,0,1,7,5,2
362,https://vlr.gg/player/20064/vania,2024-09-07 13:55:00,1.67,1.83,1.78,294,286,296,42,12,30,13,6,7,15,3,12,+4,+2,+2,86%,91%,83%,199,189,203,57%,46%,64%,4,2,2,0,0,0
363,https://vlr.gg/player/36175/rezq,2024-09-07 13:55:00,1.10,1.66,1.48,308,286,318,38,11,27,21,9,12,8,2,6,+5,-1,+6,86%,73%,92%,180,178,181,20%,31%,12%,7,1,6,2,2,0
364,https://vlr.gg/player/17320/petra,2024-09-07 13:55:00,1.19,1.43,1.36,241,239,243,30,9,21,19,7,12,14,2,12,-1,-1,0,80%,64%,88%,164,157,167,29%,50%,23%,3,1,2,4,2,2
365,https://vlr.gg/player/24149/amy,2024-09-07 13:55:00,1.19,1.12,1.14,188,234,169,25,10,15,18,7,11,11,1,10,+2,0,+2,80%,73%,83%,128,143,122,44%,42%,46%,4,0,4,2,0,2
366,https://vlr.gg/player/17323/mimi,2024-09-07 13:55:00,0.39,1.41,1.09,166,62,213,21,2,19,15,7,8,6,1,5,-1,-3,+2,83%,73%,88%,112,50,140,23%,7%,28%,4,0,4,5,3,2
367,https://vlr.gg/player/19373/ginger,2024-09-07 13:55:00,0.61,1.37,0.85,152,145,172,21,12,9,28,22,6,4,3,1,-4,-4,0,46%,38%,64%,91,89,96,26%,35%,15%,1,1,0,5,5,0
368,https://vlr.gg/player/41207/jade,2024-09-07 13:55:00,0.48,1.54,0.81,216,142,377,25,11,14,33,23,10,10,5,5,+1,-4,+5,66%,50%,100%,134,93,224,33%,22%,48%,6,1,5,5,5,0
369,https://vlr.gg/player/37969/ellie,2024-09-07 13:55:00,0.76,0.39,0.61,145,178,74,18,15,3,30,21,9,4,3,1,-4,-2,-2,49%,42%,64%,99,120,53,45%,53%,20%,3,2,1,7,4,3
370,https://vlr.gg/player/17318/blossi,2024-09-07 13:55:00,0.39,0.62,0.46,130,93,214,14,6,8,32,22,10,10,7,3,+1,0,+1,49%,42%,64%,78,55,128,12%,14%,10%,2,1,1,1,1,0
371,https://vlr.gg/player/30042/harmonee,2024-09-07 13:55:00,0.32,0.50,0.37,107,106,106,8,6,2,33,24,9,12,5,7,-3,-2,-1,54%,46%,73%,79,78,81,20%,25%,7%,1,1,0,4,3,1
372,https://vlr.gg/player/9554/kaajak,2024-09-07 12:00:00,1.70,1.76,1.74,382,379,382,53,21,32,28,11,17,13,3,10,+3,-4,+7,83%,69%,92%,243,237,247,44%,53%,39%,10,2,8,7,6,1
373,https://vlr.gg/player/101/soulcas,2024-09-07 12:00:00,1.51,1.40,1.44,234,214,247,36,13,23,21,9,12,14,4,10,+1,-1,+2,73%,63%,79%,167,147,180,36%,38%,34%,4,1,3,3,2,1
374,https://vlr.gg/player/129/hype,2024-09-07 12:00:00,0.96,1.19,1.10,214,194,220,30,10,20,27,13,14,17,7,10,+2,+1,+1,80%,69%,88%,139,126,148,26%,38%,21%,5,2,3,3,1,2
375,https://vlr.gg/player/1281/molsi,2024-09-07 12:00:00,0.57,1.37,1.05,171,117,209,24,5,19,22,12,10,21,6,15,+1,-1,+2,75%,63%,83%,112,80,134,25%,29%,24%,2,0,2,1,1,0
376,https://vlr.gg/player/1507/avova,2024-09-07 12:00:00,0.58,0.79,0.70,108,42,150,14,2,12,25,10,15,20,6,14,-1,-1,0,70%,56%,79%,63,23,90,32%,29%,32%,2,0,2,3,1,2
377,https://vlr.gg/player/37847/fighter,2024-09-07 12:00:00,1.09,1.22,1.14,240,218,276,35,19,16,29,19,10,3,0,3,0,+1,-1,68%,71%,63%,164,143,196,39%,40%,38%,4,3,1,4,2,2
378,https://vlr.gg/player/1618/spyzera,2024-09-07 12:00:00,0.71,0.82,0.76,171,173,172,24,14,10,31,20,11,7,2,5,-1,-2,+1,53%,54%,50%,107,103,112,22%,23%,21%,1,0,1,2,2,0
379,https://vlr.gg/player/5600/moh,2024-09-07 12:00:00,0.57,0.99,0.74,153,132,202,22,10,12,31,21,10,6,5,1,+2,0,+2,70%,63%,81%,114,96,140,27%,24%,29%,6,2,4,4,2,2
380,https://vlr.gg/player/6503/sand,2024-09-07 12:00:00,0.68,0.64,0.66,177,205,120,23,16,7,34,24,10,6,3,3,-4,-6,+2,50%,46%,56%,99,115,75,42%,37%,54%,4,1,3,8,7,1
381,https://vlr.gg/player/5599/khaalid,2024-09-07 12:00:00,0.26,0.97,0.54,145,118,184,19,9,10,32,22,10,5,4,1,-3,-5,+2,55%,54%,56%,91,75,115,23%,19%,27%,2,0,2,5,5,0
382,https://vlr.gg/player/23049/alkyia,2024-09-07 11:00:00,1.26,1.35,1.29,241,232,252,48,31,17,34,22,12,9,7,2,+7,+2,+5,81%,82%,80%,152,144,166,31%,37%,22%,13,5,8,6,3,3
383,https://vlr.gg/player/29442/wens,2024-09-07 11:00:00,1.21,1.30,1.25,251,252,224,49,30,19,31,21,10,3,3,0,+5,+4,+1,81%,85%,75%,156,162,145,42%,44%,39%,9,8,1,4,4,0
384,https://vlr.gg/player/19363/proxima,2024-09-07 11:00:00,1.33,1.06,1.23,245,267,196,46,31,15,33,20,13,11,6,5,+1,+2,-1,93%,91%,95%,164,188,123,45%,45%,44%,6,4,2,5,2,3
385,https://vlr.gg/player/17332/jduh,2024-09-07 11:00:00,0.92,1.63,1.19,211,196,255,42,24,18,32,23,9,17,10,7,-1,-2,+1,81%,79%,85%,140,128,161,27%,26%,29%,3,2,1,4,4,0
386,https://vlr.gg/player/17339/felipa,2024-09-07 11:00:00,0.93,0.93,0.93,154,152,137,28,19,9,29,18,11,18,8,10,-4,-2,-2,72%,74%,70%,99,102,94,26%,31%,18%,0,0,0,4,2,2
387,https://vlr.gg/player/19362/lyda,2024-09-07 11:00:00,0.80,1.15,1.01,221,189,252,45,15,30,39,14,25,6,2,4,+1,-4,+5,63%,60%,65%,135,118,145,47%,48%,47%,8,2,6,7,6,1
388,https://vlr.gg/player/37990/adora,2024-09-07 11:00:00,0.83,0.92,0.88,180,195,184,35,13,22,42,16,26,9,5,4,-7,+2,-9,63%,65%,62%,133,135,132,34%,30%,37%,5,3,2,12,1,11
389,https://vlr.gg/player/30107/fluxxy,2024-09-07 11:00:00,0.83,0.77,0.79,147,165,136,27,10,17,38,15,23,14,7,7,-1,-1,0,63%,65%,62%,96,116,84,28%,17%,41%,2,1,1,3,2,1
390,https://vlr.gg/player/9431/cille,2024-09-07 11:00:00,0.68,0.56,0.61,132,139,137,26,10,16,47,16,31,16,8,8,-2,0,-2,61%,55%,65%,88,89,87,15%,24%,11%,1,0,1,3,0,3
391,https://vlr.gg/player/24140/superphrog,2024-09-07 11:00:00,0.36,0.66,0.55,139,101,164,26,7,19,47,17,30,3,1,2,+1,-1,+2,50%,45%,53%,95,73,108,30%,22%,33%,7,2,5,6,3,3
392,https://vlr.gg/player/30107/fluxxy,2024-09-06 13:10:00,1.29,1.14,1.22,237,253,228,62,33,29,50,24,26,25,8,17,-1,+1,-2,76%,76%,75%,158,160,156,26%,26%,26%,5,3,2,6,2,4
393,https://vlr.gg/player/37990/adora,2024-09-06 13:10:00,0.68,1.31,0.99,223,138,307,55,17,38,57,28,29,20,7,13,+2,-2,+4,66%,58%,75%,144,100,191,26%,37%,21%,10,4,6,8,6,2
394,https://vlr.gg/player/19362/lyda,2024-09-06 13:10:00,0.86,1.07,0.97,217,215,232,56,25,31,58,31,27,24,11,13,0,0,0,77%,68%,86%,155,157,154,30%,39%,21%,10,4,6,10,4,6
395,https://vlr.gg/player/24140/superphrog,2024-09-06 13:10:00,0.92,0.83,0.88,166,184,166,48,26,22,52,28,24,6,3,3,-3,-4,+1,58%,50%,67%,117,126,107,30%,25%,39%,7,3,4,10,7,3
396,https://vlr.gg/player/9431/cille,2024-09-06 13:10:00,0.80,0.67,0.74,153,149,150,39,21,18,57,29,28,23,9,14,-4,-3,-1,68%,68%,67%,91,87,96,23%,36%,13%,2,1,1,6,4,2
397,https://vlr.gg/player/17394/ninou,2024-09-06 13:10:00,1.19,1.39,1.29,245,237,263,62,31,31,48,25,23,29,9,20,-1,-1,0,77%,81%,74%,160,153,167,17%,26%,12%,2,0,2,3,1,2
398,https://vlr.gg/player/38142/dream,2024-09-06 13:10:00,1.36,1.01,1.18,215,251,179,55,32,23,48,23,25,22,8,14,+5,+5,0,72%,72%,71%,145,171,120,18%,21%,15%,6,5,1,1,0,1
399,https://vlr.gg/player/20098/mel,2024-09-06 13:10:00,0.94,1.02,0.98,196,182,210,53,24,29,51,28,23,28,13,15,0,-1,+1,70%,67%,74%,127,126,129,28%,35%,22%,7,3,4,7,4,3
400,https://vlr.gg/player/24071/liza,2024-09-06 13:10:00,0.80,1.13,0.97,247,230,252,65,29,36,59,32,27,8,3,5,+2,-4,+6,74%,67%,82%,156,152,161,31%,30%,32%,20,7,13,18,11,7
401,https://vlr.gg/player/22792/jiex,2024-09-06 13:10:00,0.72,0.95,0.84,163,150,167,39,18,21,54,30,24,37,21,16,0,-1,+1,73%,75%,71%,110,103,117,33%,31%,34%,5,2,3,5,3,2
402,https://vlr.gg/player/16321/nelo,2024-09-06 11:00:00,1.61,1.21,1.42,240,259,224,41,23,18,28,12,16,23,10,13,+2,+2,0,80%,83%,76%,156,163,148,34%,44%,25%,3,2,1,1,0,1
403,https://vlr.gg/player/11183/glance,2024-09-06 11:00:00,1.57,1.08,1.33,237,276,201,37,23,14,28,13,15,20,12,8,+1,+2,-1,82%,91%,71%,166,186,143,18%,18%,17%,3,2,1,2,0,2
404,https://vlr.gg/player/21153/matrix,2024-09-06 11:00:00,1.12,1.33,1.22,266,249,284,41,21,20,31,15,16,13,6,7,+4,-1,+5,73%,74%,71%,171,166,177,35%,44%,29%,12,6,6,8,7,1
405,https://vlr.gg/player/16419/roxi,2024-09-06 11:00:00,0.87,0.98,0.92,154,138,172,27,13,14,28,14,14,5,4,1,0,-1,+1,66%,65%,67%,111,94,129,26%,27%,25%,4,1,3,4,2,2
406,https://vlr.gg/player/19356/kuripuuya,2024-09-06 11:00:00,1.00,0.62,0.82,165,182,139,23,13,10,31,14,17,24,14,10,-3,+1,-4,75%,83%,67%,107,115,97,31%,37%,23%,2,2,0,5,1,4
407,https://vlr.gg/player/16196/annie,2024-09-06 11:00:00,0.74,1.39,1.08,224,156,288,35,12,23,33,15,18,5,3,2,0,-5,+5,75%,62%,87%,143,102,181,37%,40%,35%,9,3,6,9,8,1
408,https://vlr.gg/player/7460/6sonya,2024-09-06 11:00:00,1.07,0.91,0.99,202,227,178,33,17,16,32,15,17,8,4,4,0,+2,-2,70%,86%,57%,137,147,127,37%,33%,43%,5,3,2,5,1,4
409,https://vlr.gg/player/39506/cabbit,2024-09-06 11:00:00,1.00,0.81,0.90,182,199,168,29,15,14,33,14,19,8,4,4,+2,+2,0,73%,76%,70%,120,125,116,34%,30%,38%,4,3,1,2,1,1
410,https://vlr.gg/player/20116/jademwah,2024-09-06 11:00:00,1.47,0.28,0.85,188,292,93,29,24,5,35,15,20,19,8,11,-6,-1,-5,66%,76%,57%,110,162,62,13%,16%,8%,1,0,1,7,1,6
411,https://vlr.gg/player/20058/devilasxa,2024-09-06 11:00:00,0.66,0.81,0.74,163,161,163,20,10,10,36,17,19,35,11,24,0,+1,-1,77%,76%,78%,111,118,104,31%,31%,31%,1,1,0,1,0,1
412,https://vlr.gg/player/44501/lauguz,2024-09-04 21:00:00,1.19,1.40,1.29,274,266,281,46,22,24,31,17,14,10,4,6,-1,-2,+1,78%,77%,78%,174,157,190,33%,43%,25%,6,2,4,7,4,3
413,https://vlr.gg/player/15592/angel,2024-09-04 21:00:00,0.86,1.38,1.13,190,163,217,29,12,17,27,15,12,32,12,20,0,-3,+3,71%,59%,83%,113,100,125,28%,34%,24%,4,0,4,4,3,1
414,https://vlr.gg/player/28598/chloe,2024-09-04 21:00:00,0.82,1.25,1.04,221,185,254,35,14,21,32,16,16,11,4,7,+2,-1,+3,69%,55%,83%,135,120,150,28%,26%,29%,8,3,5,6,4,2
415,https://vlr.gg/player/21476/cami,2024-09-04 21:00:00,1.13,0.96,1.04,194,241,151,32,19,13,32,17,15,18,7,11,0,+1,-1,76%,86%,65%,141,167,117,25%,32%,18%,3,2,1,3,1,2
416,https://vlr.gg/player/35839/vefa,2024-09-04 21:00:00,0.66,1.30,0.99,179,125,232,28,10,18,30,15,15,10,3,7,0,-1,+1,73%,64%,83%,117,81,151,23%,29%,21%,2,1,1,2,2,0
417,https://vlr.gg/player/17982/lunafox,2024-09-04 21:00:00,1.16,1.27,1.21,270,274,267,40,21,19,35,20,15,19,8,11,+2,+1,+1,73%,78%,68%,193,208,178,29%,40%,19%,8,3,5,6,2,4
418,https://vlr.gg/player/37923/oasis,2024-09-04 21:00:00,0.57,1.55,1.05,245,173,320,39,15,24,39,21,18,11,3,8,-2,-4,+2,67%,57%,77%,154,107,203,38%,34%,39%,7,2,5,9,6,3
419,https://vlr.gg/player/36737/alexaishot,2024-09-04 21:00:00,0.76,0.95,0.85,150,142,159,25,11,14,29,16,13,8,4,4,+2,0,+2,69%,61%,77%,91,92,91,28%,38%,21%,5,3,2,3,3,0
420,https://vlr.gg/player/44540/memi,2024-09-04 21:00:00,0.77,0.67,0.72,150,175,127,25,15,10,33,17,16,12,6,6,-3,-2,-1,62%,65%,59%,103,118,88,26%,22%,32%,0,0,0,3,2,1
421,https://vlr.gg/player/28387/fire,2024-09-04 21:00:00,0.54,0.91,0.72,127,103,153,23,10,13,34,19,15,9,2,7,0,-2,+2,67%,65%,68%,79,64,95,28%,45%,18%,2,0,2,2,2,0
422,https://vlr.gg/player/20675/flossie,2024-09-04 18:00:00,1.21,1.32,1.27,241,232,253,50,23,27,38,17,21,9,5,4,+2,+1,+1,61%,66%,57%,165,157,172,27%,29%,26%,5,4,1,3,3,0
423,https://vlr.gg/player/19256/frantastic,2024-09-04 18:00:00,1.12,0.85,0.98,174,216,146,39,25,14,39,17,22,22,9,13,-6,-4,-2,69%,79%,60%,124,145,104,22%,19%,25%,3,2,1,9,6,3
424,https://vlr.gg/player/37115/lendary,2024-09-04 18:00:00,0.99,0.94,0.96,227,210,251,46,20,26,47,22,25,12,8,4,-4,-1,-3,76%,79%,73%,148,135,161,27%,23%,31%,7,1,6,11,2,9
425,https://vlr.gg/player/21091/azul,2024-09-04 18:00:00,0.76,1.09,0.93,178,156,203,37,16,21,41,21,20,8,3,5,-2,-2,0,64%,62%,67%,127,109,143,36%,29%,42%,4,1,3,6,3,3
426,https://vlr.gg/player/25356/reshi,2024-09-04 18:00:00,1.07,0.54,0.80,148,216,94,30,22,8,40,19,21,17,10,7,+3,+3,0,69%,79%,60%,97,129,66,20%,25%,10%,7,5,2,4,2,2
427,https://vlr.gg/player/35660/tok1o,2024-09-04 18:00:00,1.77,1.17,1.48,289,358,222,62,39,23,37,18,19,10,4,6,+5,+5,0,78%,80%,76%,190,230,150,26%,34%,17%,12,9,3,7,4,3
428,https://vlr.gg/player/35018/allie,2024-09-04 18:00:00,1.13,1.05,1.09,173,154,189,35,17,18,35,16,19,26,13,13,0,+1,-1,73%,80%,66%,113,102,124,23%,32%,17%,4,3,1,4,2,2
429,https://vlr.gg/player/40657/ataraxia,2024-09-04 18:00:00,0.85,1.15,1.00,187,154,237,42,17,25,40,19,21,7,2,5,0,+1,-1,66%,60%,72%,125,101,149,38%,28%,49%,3,2,1,3,1,2
430,https://vlr.gg/player/40135/nati,2024-09-04 18:00:00,1.00,0.51,0.76,167,199,121,36,23,13,44,20,24,12,8,4,+1,-1,+2,66%,77%,55%,114,141,86,40%,50%,27%,6,1,5,5,2,3
431,https://vlr.gg/player/35869/meleliita,2024-09-04 18:00:00,0.50,0.82,0.65,160,143,173,28,12,16,46,24,22,17,11,6,+1,-2,+3,73%,70%,76%,109,98,119,24%,22%,25%,8,2,6,7,4,3
432,https://vlr.gg/player/101/soulcas,2024-09-04 14:00:00,1.29,1.46,1.38,247,235,248,58,27,31,37,18,19,23,8,15,+2,0,+2,71%,73%,69%,156,165,148,35%,44%,28%,5,1,4,3,1,2
433,https://vlr.gg/player/9554/kaajak,2024-09-04 14:00:00,1.00,1.61,1.33,288,242,325,73,28,45,45,23,22,4,1,3,+3,-2,+5,66%,60%,71%,182,152,209,47%,49%,45%,16,8,8,13,10,3
434,https://vlr.gg/player/1507/avova,2024-09-04 14:00:00,0.88,1.16,1.03,171,131,202,40,15,25,37,17,20,26,10,16,+3,0,+3,74%,70%,77%,115,89,138,45%,41%,48%,6,2,4,3,2,1
435,https://vlr.gg/player/1281/molsi,2024-09-04 14:00:00,1.15,0.85,0.99,163,193,149,36,19,17,43,19,24,29,12,17,0,+1,-1,72%,77%,69%,123,155,95,33%,40%,24%,2,1,1,2,0,2
436,https://vlr.gg/player/129/hype,2024-09-04 14:00:00,1.10,0.52,0.78,162,221,108,35,24,11,44,19,25,11,4,7,+1,+3,-2,66%,70%,63%,100,134,71,21%,29%,13%,8,4,4,7,1,6
437,https://vlr.gg/player/7220/saiz,2024-09-04 14:00:00,1.24,0.97,1.11,202,233,166,50,31,19,47,26,21,8,2,6,+6,+1,+5,63%,66%,60%,136,161,107,41%,42%,39%,10,4,6,4,3,1
438,https://vlr.gg/player/2653/jesse,2024-09-04 14:00:00,0.93,1.00,0.96,169,155,183,41,20,21,46,25,21,18,12,6,-3,-2,-1,66%,63%,70%,107,105,110,32%,32%,33%,3,1,2,6,3,3
439,https://vlr.gg/player/5199/guardy,2024-09-04 14:00:00,0.73,1.03,0.87,178,161,200,37,18,19,50,27,23,24,13,11,-4,-3,-1,68%,66%,70%,117,102,134,28%,27%,30%,2,1,1,6,4,2
440,https://vlr.gg/player/2701/maniek,2024-09-04 14:00:00,0.68,0.86,0.76,182,192,183,45,23,22,50,28,22,9,7,2,-7,-2,-5,58%,54%,63%,124,128,120,24%,23%,24%,9,6,3,16,8,8
441,https://vlr.gg/player/20271/vorwenn,2024-09-04 14:00:00,0.78,0.62,0.70,153,140,171,33,18,15,49,23,26,15,5,10,-1,-1,0,66%,69%,63%,102,89,117,23%,18%,27%,4,2,2,5,3,2
442,https://vlr.gg/player/1616/starki,2024-09-04 13:45:00,1.36,1.04,1.19,240,264,222,58,29,29,46,21,25,19,10,9,+5,+1,+4,76%,80%,72%,154,170,140,29%,30%,28%,11,4,7,6,3,3
443,https://vlr.gg/player/7660/fizzy,2024-09-04 13:45:00,1.07,1.18,1.13,227,226,228,55,25,30,49,24,25,15,6,9,+4,+1,+3,74%,67%,81%,150,144,155,34%,35%,33%,6,3,3,2,2,0
444,https://vlr.gg/player/2658/xuss,2024-09-04 13:45:00,0.80,1.23,1.03,246,224,267,59,24,35,51,25,26,4,2,2,+2,-5,+7,68%,63%,72%,158,147,166,27%,28%,26%,14,3,11,12,8,4
445,https://vlr.gg/player/3674/iluri,2024-09-04 13:45:00,1.03,1.00,1.01,178,187,175,44,21,23,43,19,24,28,13,15,-4,-3,-1,70%,67%,72%,118,118,118,43%,58%,33%,3,1,2,7,4,3
446,https://vlr.gg/player/3753/obnoks,2024-09-04 13:45:00,0.88,0.88,0.88,168,163,175,35,13,22,46,21,25,27,14,13,+1,+2,-1,74%,73%,75%,117,116,119,24%,23%,25%,3,2,1,2,0,2
447,https://vlr.gg/player/4308/magik,2024-09-04 13:45:00,1.05,1.29,1.16,245,225,266,57,28,29,48,27,21,22,13,9,+2,0,+2,73%,75%,70%,160,153,170,21%,19%,22%,5,1,4,3,1,2
448,https://vlr.gg/player/5893/robbiebk,2024-09-04 13:45:00,1.38,0.77,1.11,237,286,176,54,37,17,50,26,24,15,7,8,+4,+4,0,82%,89%,73%,153,184,116,29%,30%,27%,7,4,3,3,0,3
449,https://vlr.gg/player/1284/mikee,2024-09-04 13:45:00,0.97,0.76,0.88,183,185,176,43,24,19,51,28,23,19,10,9,-5,-1,-4,67%,67%,67%,121,120,123,28%,35%,23%,2,2,0,7,3,4
450,https://vlr.gg/player/1475/kamyk,2024-09-04 13:45:00,0.83,0.76,0.80,173,167,186,42,22,20,51,26,25,12,9,3,-2,-5,+3,62%,61%,63%,118,107,132,35%,30%,40%,7,1,6,9,6,3
451,https://vlr.gg/player/2700/jas,2024-09-04 13:45:00,0.35,1.28,0.76,175,126,228,39,14,25,51,32,19,14,7,7,-7,-10,+3,67%,58%,77%,120,86,160,30%,24%,35%,8,4,4,15,14,1
452,https://vlr.gg/player/7162/wackie,2024-09-04 12:00:00,1.58,1.45,1.51,289,281,278,34,16,18,15,6,9,7,2,5,0,-1,+1,81%,64%,94%,171,179,165,32%,33%,30%,2,0,2,2,1,1
453,https://vlr.gg/player/8226/waddle,2024-09-04 12:00:00,1.25,1.40,1.34,223,206,216,28,11,17,17,9,8,9,4,5,0,+1,-1,81%,79%,83%,133,131,134,34%,26%,44%,2,1,1,2,0,2
454,https://vlr.gg/player/12474/tag,2024-09-04 12:00:00,1.55,1.11,1.30,238,310,206,30,17,13,21,10,11,10,5,5,+6,+2,+4,91%,93%,89%,181,224,148,36%,40%,33%,6,2,4,0,0,0
455,https://vlr.gg/player/1944/cayden,2024-09-04 12:00:00,0.83,1.64,1.29,161,158,169,20,8,12,16,10,6,22,9,13,+1,+1,0,88%,86%,89%,110,99,119,25%,9%,39%,2,2,0,1,1,0
456,https://vlr.gg/player/4544/filu,2024-09-04 12:00:00,0.57,1.86,1.28,286,154,384,32,7,25,22,11,11,4,1,3,+5,-1,+6,88%,79%,94%,176,99,236,34%,21%,38%,10,3,7,5,4,1
457,https://vlr.gg/player/23169/minny,2024-09-04 12:00:00,0.66,1.71,1.12,239,153,358,26,8,18,27,16,11,4,3,1,-1,-2,+1,63%,56%,71%,151,114,197,23%,14%,33%,2,0,2,3,2,1
458,https://vlr.gg/player/5554/profek,2024-09-04 12:00:00,0.67,0.94,0.78,203,201,217,23,12,11,30,18,12,7,3,4,-2,-1,-1,63%,50%,79%,137,136,137,30%,31%,28%,4,2,2,6,3,3
459,https://vlr.gg/player/562/zeek,2024-09-04 12:00:00,0.61,0.72,0.66,191,189,195,19,11,8,30,18,12,7,3,4,-2,-1,-1,63%,67%,57%,129,130,128,30%,37%,23%,0,0,0,2,1,1
460,https://vlr.gg/player/1155/buld,2024-09-04 12:00:00,0.44,0.72,0.56,152,140,166,16,9,7,28,16,12,5,2,3,0,-2,+2,72%,78%,64%,99,86,114,41%,43%,38%,2,0,2,2,2,0
461,https://vlr.gg/player/25906/alexiiik,2024-09-04 12:00:00,0.06,0.14,0.08,74,85,60,7,5,2,29,17,12,2,0,2,-7,-4,-3,34%,28%,43%,50,52,48,33%,45%,20%,2,2,0,9,6,3
462,https://vlr.gg/player/40591/comeback,2024-09-04 12:00:00,1.13,1.56,1.34,275,236,316,39,17,22,24,12,12,3,2,1,+7,+4,+3,79%,75%,84%,181,156,209,31%,34%,29%,9,6,3,2,2,0
463,https://vlr.gg/player/24344/loita,2024-09-04 12:00:00,1.18,1.49,1.33,205,196,214,28,14,14,20,10,10,21,9,12,+1,0,+1,77%,70%,84%,144,130,157,30%,23%,37%,4,2,2,3,2,1
464,https://vlr.gg/player/31305/lar0k,2024-09-04 12:00:00,1.31,1.23,1.27,209,197,223,31,16,15,20,8,12,19,11,8,+2,-1,+3,72%,80%,63%,146,152,139,26%,30%,23%,5,1,4,3,2,1
465,https://vlr.gg/player/5565/ros,2024-09-04 12:00:00,1.18,0.97,1.08,192,185,199,28,14,14,23,10,13,8,4,4,-1,0,-1,74%,80%,68%,122,118,126,20%,32%,13%,2,1,1,3,1,2
466,https://vlr.gg/player/31855/celasun,2024-09-04 12:00:00,1.43,0.63,1.04,184,233,137,27,18,9,22,8,14,6,2,4,-4,-1,-3,74%,80%,68%,124,153,94,31%,38%,21%,2,1,1,6,2,4
467,https://vlr.gg/player/1378/addicted,2024-09-04 12:00:00,1.22,0.93,1.07,168,183,153,24,14,10,26,13,13,10,6,4,+3,+1,+2,69%,74%,65%,114,121,107,41%,50%,35%,3,1,2,0,0,0
468,https://vlr.gg/player/29340/cunha20,2024-09-04 12:00:00,1.14,0.81,0.97,184,202,169,27,14,13,30,14,16,13,10,3,0,-1,+1,59%,63%,55%,122,134,112,39%,35%,43%,3,0,3,3,1,2
469,https://vlr.gg/player/15577/brk,2024-09-04 12:00:00,0.98,0.86,0.92,221,262,182,29,17,12,31,16,15,1,0,1,-3,-2,-1,56%,58%,55%,145,165,126,29%,25%,38%,6,3,3,9,5,4
470,https://vlr.gg/player/13435/fragger,2024-09-04 12:00:00,0.66,0.75,0.70,154,148,159,17,9,8,31,14,17,15,6,9,-3,-2,-1,56%,63%,50%,105,90,119,23%,45%,13%,2,1,1,5,3,2
471,https://vlr.gg/player/15376/grtw,2024-09-04 12:00:00,0.18,0.32,0.25,100,109,94,11,6,5,35,18,17,9,4,5,-2,+1,-3,51%,53%,50%,72,71,73,19%,6%,35%,3,3,0,5,2,3
472,https://vlr.gg/player/35951/morgan,2024-09-03 21:25:00,0.83,0.71,0.75,189,226,166,19,10,9,26,12,14,4,1,3,-4,-1,-3,57%,46%,67%,122,148,99,38%,32%,50%,1,1,0,5,2,3
473,https://vlr.gg/player/28386/junki,2024-09-03 21:25:00,0.38,0.78,0.59,145,80,197,11,2,9,27,12,15,8,5,3,0,0,0,46%,46%,47%,96,64,124,26%,43%,21%,0,0,0,0,0,0
474,https://vlr.gg/player/42203/shotoo,2024-09-03 21:25:00,0.52,0.16,0.30,91,139,53,7,5,2,27,12,15,4,3,1,-2,-1,-1,32%,46%,20%,68,99,41,24%,26%,21%,1,1,0,3,2,1
475,https://vlr.gg/player/44462/kyujinn,2024-09-03 21:25:00,0.47,0.09,0.26,110,137,90,9,5,4,28,13,15,3,2,1,-4,-1,-3,43%,46%,40%,75,97,55,27%,32%,21%,2,0,2,6,1,5
476,https://vlr.gg/player/20500/zaki,2024-09-03 21:25:00,0.32,0.17,0.21,67,100,43,6,4,2,27,12,15,1,0,1,-6,-2,-4,29%,38%,20%,47,65,31,28%,24%,38%,2,2,0,8,4,4
477,https://vlr.gg/player/24210/tasty,2024-09-03 21:25:00,1.66,2.90,2.23,396,293,527,44,17,27,7,4,3,8,3,5,+5,+3,+2,86%,87%,85%,266,191,354,48%,56%,43%,6,4,2,1,1,0
478,https://vlr.gg/player/25741/lied,2024-09-03 21:25:00,2.31,1.33,1.84,332,409,239,34,22,12,12,5,7,12,6,6,+4,+5,-1,82%,100%,62%,218,261,169,32%,33%,28%,6,5,1,2,0,2
479,https://vlr.gg/player/35547/raquinuki,2024-09-03 21:25:00,1.52,1.16,1.35,224,241,197,23,15,8,11,5,6,8,4,4,+2,+1,+1,93%,100%,85%,147,157,135,29%,29%,28%,5,2,3,3,1,2
480,https://vlr.gg/player/29223/tura,2024-09-03 21:25:00,1.20,1.50,1.34,208,196,224,17,9,8,11,7,4,17,8,9,+3,+1,+2,93%,87%,100%,138,122,156,18%,22%,14%,3,1,2,0,0,0
481,https://vlr.gg/player/35927/dano,2024-09-03 21:25:00,1.37,1.16,1.27,173,201,137,17,11,6,11,5,6,21,11,10,+2,+1,+1,93%,100%,85%,116,130,100,23%,29%,15%,2,1,1,0,0,0
482,https://vlr.gg/player/28222/panchill,2024-09-03 18:00:00,0.97,1.11,1.05,192,210,183,46,19,27,41,21,20,8,2,6,+2,+2,0,66%,58%,72%,132,136,129,31%,27%,33%,4,2,2,2,0,2
483,https://vlr.gg/player/35907/naxa,2024-09-03 18:00:00,0.65,1.23,0.99,240,179,286,52,16,36,52,23,29,8,2,6,-3,-5,+2,56%,42%,67%,153,107,186,28%,24%,29%,7,1,6,10,6,4
484,https://vlr.gg/player/35876/tconda,2024-09-03 18:00:00,0.40,1.01,0.76,196,132,245,38,10,28,53,24,29,13,5,8,0,-4,+4,55%,38%,67%,127,84,157,24%,29%,23%,10,3,7,10,7,3
485,https://vlr.gg/player/35873/gelatycat,2024-09-03 18:00:00,0.71,0.75,0.74,145,145,149,30,12,18,50,24,26,14,2,12,0,0,0,61%,46%,72%,103,96,108,39%,41%,38%,4,1,3,4,1,3
486,https://vlr.gg/player/21008/mcfly,2024-09-03 18:00:00,0.36,0.86,0.65,118,86,150,27,7,20,46,23,23,14,4,10,-7,-5,-2,61%,42%,75%,85,57,105,25%,37%,21%,2,0,2,9,5,4
487,https://vlr.gg/player/11259/conir,2024-09-03 18:00:00,1.26,1.55,1.38,258,269,247,59,34,25,36,26,10,19,8,11,+5,+2,+3,76%,67%,88%,172,177,166,35%,31%,41%,9,5,4,4,3,1
488,https://vlr.gg/player/18982/romily,2024-09-03 18:00:00,1.10,1.47,1.26,210,189,234,47,26,21,31,20,11,10,2,8,+2,0,+2,71%,64%,81%,135,127,146,26%,22%,31%,5,1,4,3,1,2
489,https://vlr.gg/player/21558/micaela,2024-09-03 18:00:00,0.87,1.60,1.18,217,182,266,50,23,27,38,27,11,23,15,8,+1,-2,+3,84%,83%,85%,141,114,178,39%,36%,44%,6,1,5,5,3,2
490,https://vlr.gg/player/11235/biazik,2024-09-03 18:00:00,1.00,0.98,0.99,188,170,210,40,20,20,39,24,15,22,17,5,+2,-1,+3,82%,83%,81%,123,110,141,28%,28%,27%,5,1,4,3,2,1
491,https://vlr.gg/player/25663/dods,2024-09-03 18:00:00,0.73,1.16,0.91,209,199,223,46,24,22,49,32,17,12,3,9,-2,-3,+1,66%,56%,81%,139,124,158,27%,24%,33%,10,8,2,12,11,1
492,https://vlr.gg/player/5599/khaalid,2024-09-03 15:10:00,1.04,1.75,1.47,285,193,331,62,17,45,34,15,19,15,6,9,+4,0,+4,78%,61%,89%,186,129,222,35%,47%,31%,7,2,5,3,2,1
493,https://vlr.gg/player/5600/moh,2024-09-03 15:10:00,1.58,1.06,1.26,225,280,188,47,23,24,34,13,21,30,14,16,0,+1,-1,81%,78%,83%,150,171,136,30%,27%,33%,5,3,2,5,2,3
494,https://vlr.gg/player/1618/spyzera,2024-09-03 15:10:00,1.04,1.17,1.12,212,180,225,46,15,31,37,15,22,20,6,14,-1,0,-1,81%,91%,75%,130,123,134,30%,31%,29%,5,2,3,6,2,4
495,https://vlr.gg/player/37847/fighter,2024-09-03 15:10:00,0.84,1.23,1.08,204,180,227,43,14,29,37,17,20,13,7,6,0,-3,+3,69%,65%,72%,141,121,154,32%,26%,36%,11,3,8,11,6,5
496,https://vlr.gg/player/6503/sand,2024-09-03 15:10:00,1.04,0.74,0.86,163,174,161,35,15,20,39,13,26,12,4,8,+2,+1,+1,73%,78%,69%,115,116,115,25%,30%,23%,4,1,3,2,0,2
497,https://vlr.gg/player/15577/brk,2024-09-03 15:10:00,1.07,1.47,1.23,259,248,304,52,28,24,47,30,17,17,12,5,-3,-8,+5,66%,58%,78%,177,166,194,29%,26%,33%,12,4,8,15,12,3
498,https://vlr.gg/player/15376/grtw,2024-09-03 15:10:00,0.97,0.74,0.88,190,208,161,36,24,12,47,30,17,13,7,6,-1,0,-1,69%,72%,65%,128,135,115,22%,28%,15%,7,4,3,8,4,4
499,https://vlr.gg/player/1378/addicted,2024-09-03 15:10:00,0.78,0.77,0.78,153,170,138,31,20,11,47,30,17,18,9,9,-1,0,-1,59%,58%,61%,111,127,87,27%,31%,21%,2,2,0,3,2,1
500,https://vlr.gg/player/13435/fragger,2024-09-03 15:10:00,0.62,0.96,0.76,154,136,191,31,15,16,47,31,16,29,20,9,-1,0,-1,63%,58%,70%,100,86,121,26%,33%,20%,3,3,0,4,3,1
501,https://vlr.gg/player/29340/cunha20,2024-09-03 15:10:00,0.79,0.67,0.74,139,147,126,31,22,9,46,28,18,23,13,10,+1,+2,-1,59%,58%,61%,89,92,84,38%,44%,31%,3,2,1,2,0,2
0,https://vlr.gg/player/7490/anguist,2024-09-03 14:10:00,1.01,2.05,1.39,251,152,421,33,13,20,22,12,10,9,5,4,+4,0,+4,74%,79%,64%,167,115,256,30%,23%,36%,5,1,4,1,1,0
1,https://vlr.gg/player/10885/davih,2024-09-03 14:10:00,1.26,1.40,1.31,195,194,197,29,17,12,17,11,6,10,6,4,-2,0,-2,79%,75%,86%,127,138,109,23%,31%,13%,0,0,0,2,0,2
2,https://vlr.gg/player/4329/vince,2024-09-03 14:10:00,1.32,1.18,1.27,218,237,187,30,20,10,22,14,8,15,11,4,-3,-3,0,82%,83%,79%,151,155,144,20%,23%,16%,0,0,0,3,3,0
3,https://vlr.gg/player/1835/elllement,2024-09-03 14:10:00,1.38,0.66,1.11,254,312,156,33,26,7,26,16,10,5,2,3,+7,+7,0,71%,79%,57%,160,193,103,29%,32%,23%,13,10,3,6,3,3
4,https://vlr.gg/player/2472/benny,2024-09-03 14:10:00,1.04,0.39,0.80,128,167,61,18,16,2,21,12,9,7,2,5,-2,0,-2,63%,71%,50%,84,108,43,36%,41%,23%,3,3,0,5,3,2
5,https://vlr.gg/player/25906/alexiiik,2024-09-03 14:10:00,0.55,1.39,1.08,224,176,252,30,8,22,29,13,16,6,3,3,+1,0,+1,61%,64%,58%,144,119,159,30%,30%,29%,5,2,3,4,2,2
6,https://vlr.gg/player/5554/profek,2024-09-03 14:10:00,1.56,0.68,1.00,187,242,155,24,13,11,26,7,19,6,0,6,+2,+1,+1,74%,64%,79%,121,145,108,31%,30%,32%,4,2,2,2,1,1
7,https://vlr.gg/player/23169/minny,2024-09-03 14:10:00,1.22,0.71,0.90,176,245,136,24,13,11,26,9,17,4,2,2,0,+1,-1,63%,79%,54%,113,148,93,34%,34%,33%,3,1,2,3,0,3
8,https://vlr.gg/player/562/zeek,2024-09-03 14:10:00,0.23,0.90,0.65,133,71,169,17,4,13,29,11,18,7,1,6,-2,-3,+1,55%,43%,63%,100,57,125,21%,12%,24%,1,0,1,3,3,0
9,https://vlr.gg/player/1155/buld,2024-09-03 14:10:00,0.60,0.16,0.32,135,146,129,13,5,8,33,11,22,9,7,2,-5,+1,-6,42%,57%,33%,88,97,84,15%,20%,13%,4,2,2,9,1,8
10,https://vlr.gg/player/4544/filu,2024-09-03 12:00:00,1.21,1.38,1.30,248,259,244,65,31,34,46,26,20,10,5,5,+2,0,+2,74%,65%,83%,156,154,158,35%,37%,33%,13,7,6,11,7,4
11,https://vlr.gg/player/12474/tag,2024-09-03 12:00:00,0.69,1.61,1.16,218,155,289,58,18,40,47,29,18,13,3,10,-2,-3,+1,67%,56%,78%,154,116,190,43%,38%,47%,5,2,3,7,5,2
12,https://vlr.gg/player/8226/waddle,2024-09-03 12:00:00,0.98,0.97,0.98,174,185,160,43,23,20,47,26,21,20,7,13,0,0,0,76%,71%,81%,114,127,101,29%,36%,23%,4,1,3,4,1,3
13,https://vlr.gg/player/7162/wackie,2024-09-03 12:00:00,0.65,1.18,0.89,164,116,205,37,12,25,48,27,21,31,17,14,+3,-4,+7,76%,65%,86%,109,79,138,36%,32%,39%,8,1,7,5,5,0
14,https://vlr.gg/player/1944/cayden,2024-09-03 12:00:00,0.53,1.11,0.82,153,103,201,35,11,24,49,28,21,25,10,15,+3,-3,+6,64%,44%,83%,101,69,132,24%,26%,24%,8,1,7,5,4,1
15,https://vlr.gg/player/5199/guardy,2024-09-03 12:00:00,0.97,1.19,1.07,211,222,203,51,28,23,47,28,19,27,8,19,0,-3,+3,71%,61%,82%,136,135,138,26%,32%,20%,6,2,4,6,5,1
16,https://vlr.gg/player/7220/saiz,2024-09-03 12:00:00,0.86,1.28,1.06,202,158,253,54,22,32,44,25,19,9,3,6,-5,-3,-2,69%,58%,79%,141,106,179,39%,35%,42%,2,1,1,7,4,3
17,https://vlr.gg/player/2701/maniek,2024-09-03 12:00:00,0.52,1.29,0.90,227,152,301,53,17,36,57,32,25,14,8,6,-1,-6,+5,67%,56%,79%,145,108,183,22%,22%,22%,10,3,7,11,9,2
18,https://vlr.gg/player/2653/jesse,2024-09-03 12:00:00,0.66,1.12,0.88,173,142,204,42,16,26,46,29,17,18,11,7,0,-2,+2,71%,64%,79%,114,97,133,42%,38%,46%,7,1,6,7,3,4
19,https://vlr.gg/player/20271/vorwenn,2024-09-03 12:00:00,0.66,1.04,0.84,146,143,145,37,18,19,44,29,15,9,4,5,0,-2,+2,67%,61%,74%,101,96,108,36%,32%,40%,7,3,4,7,5,2
20,https://vlr.gg/player/31305/lar0k,2024-09-03 12:00:00,1.20,1.67,1.49,282,219,303,39,12,27,22,10,12,16,4,12,-1,-1,0,82%,73%,88%,182,133,212,36%,41%,34%,5,2,3,6,3,3
21,https://vlr.gg/player/40591/comeback,2024-09-03 12:00:00,1.11,1.47,1.33,302,221,333,43,13,30,26,10,16,6,1,5,+2,-3,+5,79%,60%,92%,180,132,210,22%,32%,20%,8,1,7,6,4,2
22,https://vlr.gg/player/24344/loita,2024-09-03 12:00:00,1.22,1.23,1.23,231,230,229,33,14,19,23,9,14,24,7,17,+1,0,+1,82%,80%,83%,141,142,141,41%,34%,47%,2,0,2,1,0,1
23,https://vlr.gg/player/5565/ros,2024-09-03 12:00:00,0.90,1.08,1.01,182,165,209,26,9,17,26,10,16,17,4,13,+5,+1,+4,74%,60%,83%,130,102,147,30%,30%,30%,6,2,4,1,1,0
24,https://vlr.gg/player/31855/celasun,2024-09-03 12:00:00,1.14,0.82,0.95,156,212,125,23,11,12,19,8,11,11,6,5,+2,0,+2,82%,87%,79%,118,166,89,31%,36%,26%,3,1,2,1,1,0
25,https://vlr.gg/player/1475/kamyk,2024-09-03 12:00:00,1.35,0.63,1.08,183,250,109,26,20,6,30,19,11,17,12,5,+1,0,+1,64%,71%,53%,142,183,77,37%,39%,29%,3,2,1,2,2,0
26,https://vlr.gg/player/1284/mikee,2024-09-03 12:00:00,0.82,1.26,0.99,199,188,205,27,14,13,32,22,10,7,7,0,+2,0,+2,69%,63%,80%,124,125,122,23%,24%,22%,5,3,2,3,3,0
27,https://vlr.gg/player/4308/magik,2024-09-03 12:00:00,0.83,0.70,0.75,172,184,173,22,14,8,33,20,13,17,9,8,-5,-3,-2,69%,67%,73%,115,114,117,30%,30%,31%,1,0,1,6,3,3
28,https://vlr.gg/player/5893/robbiebk,2024-09-03 12:00:00,0.38,1.06,0.64,140,94,237,19,7,12,33,22,11,11,7,4,-3,-3,0,56%,50%,67%,107,76,156,33%,33%,32%,1,0,1,4,3,1
29,https://vlr.gg/player/2700/jas,2024-09-03 12:00:00,0.61,0.66,0.63,166,167,172,22,14,8,36,22,14,7,1,6,-4,-6,+2,59%,54%,67%,122,121,124,32%,39%,23%,5,1,4,9,7,2
30,https://vlr.gg/player/12055/mmonch,2024-09-02 20:10:00,1.74,2.63,1.89,289,273,406,34,25,9,10,9,1,8,8,0,+4,+3,+1,90%,88%,100%,184,170,252,57%,61%,50%,6,5,1,2,2,0
31,https://vlr.gg/player/20491/ivy,2024-09-02 20:10:00,1.50,1.64,1.52,260,252,269,27,23,4,15,13,2,19,12,7,0,-1,+1,86%,83%,100%,169,175,144,50%,53%,36%,2,1,1,2,2,0
32,https://vlr.gg/player/20537/andrehs,2024-09-02 20:10:00,1.53,1.43,1.51,265,253,280,27,22,5,11,8,3,9,7,2,+2,+2,0,97%,96%,100%,173,177,155,43%,40%,63%,3,2,1,1,0,1
33,https://vlr.gg/player/45186/sam,2024-09-02 20:10:00,1.27,1.58,1.32,275,297,189,30,26,4,18,16,2,5,5,0,-1,0,-1,79%,75%,100%,181,193,123,41%,39%,75%,5,5,0,6,5,1
34,https://vlr.gg/player/20538/linlin,2024-09-02 20:10:00,1.12,0.62,1.03,149,163,81,16,14,2,14,11,3,14,14,0,0,0,0,93%,96%,80%,103,106,91,33%,31%,67%,1,1,0,1,1,0
35,https://vlr.gg/player/44500/atisca,2024-09-02 20:10:00,0.01,0.97,0.76,169,15,204,18,0,18,25,5,20,2,1,1,0,-1,+1,45%,20%,50%,106,15,125,5%,0%,6%,3,0,3,3,1,2
36,https://vlr.gg/player/35920/lapapaluna,2024-09-02 20:10:00,0.10,0.79,0.67,152,55,177,14,1,13,27,5,22,7,0,7,0,0,0,55%,40%,58%,103,26,120,30%,0%,33%,1,0,1,1,0,1
37,https://vlr.gg/player/35857/mayzin,2024-09-02 20:10:00,0.50,0.55,0.54,164,172,167,15,3,12,29,5,24,3,0,3,+2,0,+2,48%,60%,46%,111,108,111,17%,13%,18%,5,1,4,3,1,2
38,https://vlr.gg/player/28993/guterwoman,2024-09-02 20:10:00,0.37,0.44,0.43,146,185,139,13,3,10,27,5,22,2,0,2,0,+1,-1,48%,60%,46%,99,118,96,22%,18%,23%,3,1,2,3,0,3
39,https://vlr.gg/player/35930/alyssa,2024-09-02 20:10:00,0.90,0.14,0.28,87,168,68,8,4,4,26,4,22,8,0,8,-7,-1,-6,45%,40%,46%,57,80,52,26%,30%,24%,0,0,0,7,1,6
40,https://vlr.gg/player/33177/none,2024-09-02 18:00:00,1.36,1.46,1.40,295,315,256,42,27,15,24,18,6,4,2,2,+2,+1,+1,79%,75%,86%,189,200,169,33%,31%,41%,7,4,3,5,3,2
41,https://vlr.gg/player/42378/nicky,2024-09-02 18:00:00,1.02,1.98,1.38,274,208,382,39,19,20,24,17,7,10,5,5,+3,-1,+4,74%,67%,86%,163,124,232,43%,38%,46%,7,2,5,4,3,1
42,https://vlr.gg/player/21548/adenina,2024-09-02 18:00:00,1.12,1.67,1.32,217,212,230,30,19,11,18,14,4,14,6,8,-2,-2,0,84%,75%,100%,138,129,155,26%,29%,23%,1,1,0,3,3,0
43,https://vlr.gg/player/24770/babzzz,2024-09-02 18:00:00,0.80,1.19,0.94,166,157,185,23,12,11,26,18,8,9,8,1,-1,-2,+1,71%,67%,79%,117,120,112,20%,24%,15%,3,2,1,4,4,0
44,https://vlr.gg/player/21108/ponix,2024-09-02 18:00:00,0.58,1.19,0.80,136,115,179,19,9,10,24,17,7,13,4,9,0,0,0,76%,67%,93%,93,86,105,28%,28%,27%,2,1,1,2,1,1
45,https://vlr.gg/player/28620/freya,2024-09-02 18:00:00,0.80,0.93,0.88,194,198,193,25,10,15,31,13,18,11,2,9,+2,+1,+1,68%,71%,67%,134,131,136,24%,19%,28%,2,1,1,0,0,0
46,https://vlr.gg/player/45468/bae,2024-09-02 18:00:00,0.23,1.18,0.83,188,94,245,24,4,20,31,15,16,10,3,7,+1,-2,+3,71%,50%,83%,123,72,152,27%,14%,32%,7,1,6,6,3,3
47,https://vlr.gg/player/36082/asia,2024-09-02 18:00:00,0.50,0.97,0.80,187,177,190,26,8,18,30,14,16,7,1,6,0,0,0,63%,50%,71%,111,107,114,19%,39%,12%,3,1,2,3,1,2
48,https://vlr.gg/player/35860/vossu,2024-09-02 18:00:00,0.85,0.76,0.79,154,170,140,21,8,13,29,12,17,11,5,6,+1,+1,0,63%,64%,63%,97,114,88,30%,30%,30%,2,1,1,1,0,1
49,https://vlr.gg/player/35867/saikiwi,2024-09-02 18:00:00,0.12,0.95,0.59,154,55,214,20,2,18,33,14,19,8,2,6,-6,-6,0,53%,29%,67%,104,38,142,34%,20%,38%,4,0,4,10,6,4
50,https://vlr.gg/player/1281/molsi,2024-09-02 15:35:00,1.12,1.73,1.44,259,198,316,41,15,26,23,11,12,25,10,15,-2,-3,+1,83%,80%,86%,164,130,195,22%,29%,18%,2,0,2,4,3,1
51,https://vlr.gg/player/9554/kaajak,2024-09-02 15:35:00,1.43,1.38,1.40,283,300,270,42,20,22,26,12,14,13,4,9,+5,+2,+3,81%,85%,77%,179,185,174,40%,50%,32%,12,6,6,7,4,3
52,https://vlr.gg/player/101/soulcas,2024-09-02 15:35:00,1.08,1.21,1.15,180,136,220,26,10,16,23,9,14,26,13,13,+1,-1,+2,83%,90%,77%,120,93,144,24%,31%,21%,4,0,4,3,1,2
53,https://vlr.gg/player/1507/avova,2024-09-02 15:35:00,1.32,0.79,1.05,170,221,128,28,17,11,27,12,15,9,4,5,+1,+2,-1,71%,80%,64%,115,138,93,50%,47%,54%,2,2,0,1,0,1
54,https://vlr.gg/player/129/hype,2024-09-02 15:35:00,0.89,0.76,0.82,160,167,152,22,12,10,26,12,14,13,4,9,+1,+4,-3,67%,75%,59%,100,99,101,19%,38%,9%,4,4,0,3,0,3
55,https://vlr.gg/player/4544/filu,2024-09-02 15:35:00,1.02,1.38,1.19,250,241,263,37,18,19,32,18,14,6,5,1,+6,+4,+2,64%,59%,70%,164,150,178,45%,43%,49%,12,7,5,6,3,3
56,https://vlr.gg/player/8226/waddle,2024-09-02 15:35:00,1.19,0.48,0.86,151,204,89,22,16,6,29,14,15,12,7,5,-3,0,-3,67%,68%,65%,104,139,67,33%,43%,18%,0,0,0,3,0,3
57,https://vlr.gg/player/1944/cayden,2024-09-02 15:35:00,0.72,0.89,0.80,175,182,167,24,11,13,33,20,13,15,8,7,-1,0,-1,69%,64%,75%,122,127,116,25%,26%,23%,2,2,0,3,2,1
58,https://vlr.gg/player/7162/wackie,2024-09-02 15:35:00,0.74,0.67,0.70,158,167,150,22,14,8,31,16,15,12,1,11,-5,-4,-1,60%,55%,65%,115,118,112,26%,32%,20%,2,0,2,7,4,3
59,https://vlr.gg/player/12474/tag,2024-09-02 15:35:00,0.68,0.64,0.66,146,146,150,20,10,10,34,17,17,12,5,7,-3,-2,-1,57%,55%,60%,98,93,104,24%,22%,25%,2,1,1,5,3,2
60,https://vlr.gg/player/7660/fizzy,2024-09-02 15:25:00,0.83,1.27,1.06,239,199,277,55,21,34,50,25,25,15,5,10,-1,-3,+2,67%,65%,69%,157,134,178,35%,36%,34%,6,2,4,7,5,2
61,https://vlr.gg/player/3674/iluri,2024-09-02 15:25:00,0.80,1.23,1.03,176,139,209,43,17,26,45,24,21,20,9,11,+4,+2,+2,85%,74%,94%,119,87,147,38%,47%,34%,6,3,3,2,1,1
62,https://vlr.gg/player/2658/xuss,2024-09-02 15:25:00,0.97,1.01,1.00,214,239,197,49,24,25,48,26,22,16,11,5,+5,+5,0,70%,68%,71%,137,154,121,32%,37%,25%,15,8,7,10,3,7
63,https://vlr.gg/player/3753/obnoks,2024-09-02 15:25:00,0.75,1.16,0.97,191,152,228,45,17,28,49,24,25,24,9,15,+1,-1,+2,76%,71%,80%,132,94,165,31%,33%,30%,5,1,4,4,2,2
64,https://vlr.gg/player/1616/starki,2024-09-02 15:25:00,1.01,0.80,0.90,168,197,146,40,21,19,45,23,22,18,10,8,-3,-2,-1,67%,68%,66%,109,125,95,23%,29%,17%,4,2,2,7,4,3
65,https://vlr.gg/player/24344/loita,2024-09-02 15:25:00,1.43,1.25,1.35,251,281,210,60,35,25,42,24,18,20,10,10,+2,+3,-1,74%,71%,77%,170,196,142,49%,44%,56%,10,6,4,8,3,5
66,https://vlr.gg/player/40591/comeback,2024-09-02 15:25:00,1.08,1.34,1.20,258,242,278,63,32,31,46,27,19,9,3,6,+3,-2,+5,74%,71%,77%,171,166,176,34%,43%,27%,13,7,6,10,9,1
67,https://vlr.gg/player/31305/lar0k,2024-09-02 15:25:00,0.59,1.25,0.90,166,139,202,39,16,23,48,29,19,26,7,19,-4,-3,-1,73%,63%,84%,123,101,148,31%,24%,37%,3,1,2,7,4,3
68,https://vlr.gg/player/5565/ros,2024-09-02 15:25:00,0.85,0.86,0.85,169,170,169,39,21,18,50,28,22,20,11,9,-6,-1,-5,64%,69%,58%,117,109,125,25%,26%,23%,1,1,0,7,2,5
69,https://vlr.gg/player/31855/celasun,2024-09-02 15:25:00,0.60,1.02,0.80,159,99,229,36,11,25,46,24,22,17,4,13,-1,-2,+1,64%,54%,74%,103,73,137,25%,26%,24%,3,0,3,4,2,2
70,https://vlr.gg/player/1835/elllement,2024-09-02 12:00:00,1.12,1.06,1.09,235,253,218,64,36,28,53,29,24,13,6,7,+4,+3,+1,71%,72%,71%,160,166,153,24%,26%,20%,15,10,5,11,7,4
71,https://vlr.gg/player/4329/vince,2024-09-02 12:00:00,1.04,1.11,1.07,190,183,212,54,26,28,46,24,22,29,14,15,+1,+1,0,73%,72%,74%,127,122,132,19%,18%,20%,5,2,3,4,1,3
72,https://vlr.gg/player/10885/davih,2024-09-02 12:00:00,1.08,1.05,1.07,177,176,181,45,25,20,43,23,20,16,7,9,+2,+2,0,70%,69%,71%,125,120,132,15%,14%,16%,5,3,2,3,1,2
73,https://vlr.gg/player/7490/anguist,2024-09-02 12:00:00,0.94,0.98,0.96,172,159,188,45,22,23,45,25,20,6,4,2,+3,-1,+4,70%,67%,74%,115,110,121,30%,28%,31%,8,3,5,5,4,1
74,https://vlr.gg/player/2472/benny,2024-09-02 12:00:00,0.56,0.89,0.72,166,146,196,45,21,24,56,32,24,8,6,2,-9,-6,-3,60%,56%,65%,109,96,124,32%,28%,36%,4,1,3,13,7,6
75,https://vlr.gg/player/7220/saiz,2024-09-02 12:00:00,1.16,1.07,1.11,205,187,210,53,24,29,47,20,27,15,6,9,+3,0,+3,75%,76%,74%,131,128,134,43%,40%,46%,10,2,8,7,2,5
76,https://vlr.gg/player/2701/maniek,2024-09-02 12:00:00,1.00,1.07,1.04,235,248,210,57,28,29,55,29,26,15,8,7,-3,-3,0,67%,68%,67%,150,163,138,29%,30%,28%,14,7,7,17,10,7
77,https://vlr.gg/player/5199/guardy,2024-09-02 12:00:00,1.14,0.94,1.03,196,216,197,51,26,25,52,24,28,18,11,7,+5,+4,+1,70%,76%,64%,140,132,148,30%,34%,27%,7,4,3,2,0,2
78,https://vlr.gg/player/20271/vorwenn,2024-09-02 12:00:00,0.71,1.08,0.91,164,140,187,41,15,26,49,24,25,20,8,12,-3,-2,-1,73%,76%,69%,114,105,122,36%,43%,32%,2,0,2,5,2,3
79,https://vlr.gg/player/2653/jesse,2024-09-02 12:00:00,0.71,0.97,0.85,173,147,185,41,17,24,50,26,24,16,6,10,-3,-1,-2,73%,74%,72%,112,99,123,40%,35%,44%,3,3,0,6,4,2
80,https://vlr.gg/player/5600/moh,2024-09-02 12:00:00,1.30,1.39,1.35,259,243,274,69,31,38,51,23,28,29,20,9,+6,0,+6,76%,71%,82%,175,163,186,33%,28%,38%,9,3,6,3,3,0
81,https://vlr.gg/player/37847/fighter,2024-09-02 12:00:00,1.25,0.86,1.06,248,279,218,66,39,27,61,28,33,13,6,7,+7,+4,+3,79%,87%,71%,160,177,144,33%,30%,38%,13,7,6,6,3,3
82,https://vlr.gg/player/6503/sand,2024-09-02 12:00:00,0.90,0.85,0.88,173,176,170,47,26,21,56,28,28,19,7,12,-4,-2,-2,75%,71%,79%,121,118,124,33%,39%,28%,5,2,3,9,4,5
83,https://vlr.gg/player/5599/khaalid,2024-09-02 12:00:00,0.83,0.94,0.88,169,152,187,49,22,27,55,26,29,22,11,11,-5,-4,-1,72%,71%,74%,119,106,132,32%,35%,30%,5,2,3,10,6,4
84,https://vlr.gg/player/1618/spyzera,2024-09-02 12:00:00,0.84,0.88,0.86,187,166,210,49,21,28,58,27,31,25,16,9,-2,-6,+4,74%,74%,74%,124,118,131,34%,36%,32%,7,1,6,9,7,2
85,https://vlr.gg/player/1475/kamyk,2024-09-02 12:00:00,1.37,1.02,1.19,237,267,209,64,37,27,55,26,29,24,10,14,+3,+1,+2,76%,76%,76%,155,177,133,38%,37%,38%,10,5,5,7,4,3
86,https://vlr.gg/player/4308/magik,2024-09-02 12:00:00,1.19,0.93,1.06,234,263,205,61,36,25,57,28,29,24,11,13,+3,-1,+4,75%,76%,74%,156,180,132,23%,26%,19%,8,3,5,5,4,1
87,https://vlr.gg/player/1284/mikee,2024-09-02 12:00:00,1.16,0.81,0.98,206,248,164,53,33,20,55,28,27,25,14,11,0,-1,+1,75%,79%,71%,135,166,103,26%,24%,28%,4,0,4,4,1,3
88,https://vlr.gg/player/5893/robbiebk,2024-09-02 12:00:00,0.79,1.14,0.96,184,151,220,50,20,30,57,30,27,27,18,9,-5,-4,-1,68%,71%,66%,126,99,152,32%,24%,38%,2,1,1,7,5,2
89,https://vlr.gg/player/2700/jas,2024-09-02 12:00:00,0.76,1.13,0.95,206,178,233,53,23,30,56,29,27,16,8,8,-3,-5,+2,68%,61%,76%,136,115,158,30%,33%,28%,13,5,8,16,10,6
90,https://vlr.gg/player/7716/penny,2024-09-01 20:25:00,1.02,1.48,1.26,255,237,273,44,19,25,28,15,13,5,2,3,-1,-3,+2,64%,57%,71%,172,162,181,18%,16%,22%,7,1,6,8,4,4
91,https://vlr.gg/player/8742/jakee,2024-09-01 20:25:00,1.11,1.34,1.23,247,205,272,38,15,23,29,15,14,21,10,11,+1,0,+1,67%,57%,75%,161,136,183,34%,27%,40%,4,1,3,3,1,2
92,https://vlr.gg/player/69/thief,2024-09-01 20:25:00,1.49,0.85,1.15,234,331,146,39,26,13,28,16,12,9,3,6,+2,+1,+1,82%,81%,83%,146,198,101,46%,49%,41%,4,3,1,2,2,0
93,https://vlr.gg/player/733/stellar,2024-09-01 20:25:00,0.75,1.15,0.97,159,104,209,25,8,17,28,13,15,15,5,10,-2,-2,0,67%,52%,79%,100,73,124,27%,19%,31%,3,1,2,5,3,2
94,https://vlr.gg/player/739/fiziq,2024-09-01 20:25:00,0.41,1.14,0.80,171,124,218,26,7,19,32,18,14,13,8,5,+3,-1,+4,76%,76%,75%,116,87,142,13%,10%,15%,6,2,4,3,3,0
95,https://vlr.gg/player/8373/okeanos,2024-09-01 20:25:00,0.68,1.82,1.21,266,196,348,44,17,27,34,20,14,7,4,3,+2,-3,+5,69%,54%,86%,160,104,223,25%,26%,24%,11,5,6,9,8,1
96,https://vlr.gg/player/8422/spaz,2024-09-01 20:25:00,1.06,0.86,0.97,155,178,135,26,16,10,31,17,14,22,8,14,-3,-1,-2,76%,75%,76%,101,114,87,19%,18%,20%,1,0,1,4,1,3
97,https://vlr.gg/player/3874/teague,2024-09-01 20:25:00,0.95,0.98,0.96,204,205,199,30,15,15,34,19,15,16,7,9,-2,-1,-1,67%,54%,81%,147,142,152,25%,24%,26%,3,2,1,5,3,2
98,https://vlr.gg/player/29688/mikee,2024-09-01 20:25:00,0.95,0.73,0.85,175,167,185,28,16,12,37,18,19,12,4,8,0,-2,+2,62%,50%,76%,120,119,120,33%,39%,28%,2,0,2,2,2,0
99,https://vlr.gg/player/4385/monsi,2024-09-01 20:25:00,0.30,1.01,0.63,131,88,182,17,4,13,36,23,13,16,11,5,0,-1,+1,62%,50%,76%,89,65,116,20%,10%,29%,4,1,3,4,2,2
100,https://vlr.gg/player/8742/jakee,2024-09-01 18:25:00,1.11,1.62,1.40,252,202,280,38,14,24,23,11,12,12,3,9,+3,+1,+2,71%,65%,76%,153,114,185,45%,40%,48%,5,2,3,2,1,1
101,https://vlr.gg/player/733/stellar,2024-09-01 18:25:00,1.49,1.08,1.26,218,266,183,30,17,13,22,10,12,13,6,7,0,+1,-1,82%,88%,76%,145,179,118,30%,33%,27%,1,1,0,1,0,1
102,https://vlr.gg/player/739/fiziq,2024-09-01 18:25:00,0.72,1.44,1.12,224,141,290,27,6,21,25,12,13,17,10,7,+6,-1,+7,79%,71%,86%,155,123,182,18%,11%,22%,7,0,7,1,1,0
103,https://vlr.gg/player/69/thief,2024-09-01 18:25:00,0.86,1.11,1.00,168,140,191,24,10,14,22,10,12,5,0,5,-2,-2,0,71%,65%,76%,110,87,128,22%,36%,16%,2,1,1,4,3,1
104,https://vlr.gg/player/7716/penny,2024-09-01 18:25:00,1.15,0.76,0.93,239,262,217,32,17,15,28,11,17,5,1,4,+3,0,+3,66%,65%,67%,158,180,141,27%,32%,23%,9,4,5,6,4,2
105,https://vlr.gg/player/16671/welyy,2024-09-01 18:25:00,0.80,1.32,1.03,212,187,236,27,13,14,28,17,11,12,6,6,0,-1,+1,76%,81%,71%,138,123,155,27%,20%,35%,4,1,3,4,2,2
106,https://vlr.gg/player/26848/zeek,2024-09-01 18:25:00,0.90,0.96,0.93,190,193,189,26,14,12,30,17,13,19,13,6,-3,-2,-1,66%,76%,53%,121,122,120,33%,30%,39%,0,0,0,3,2,1
107,https://vlr.gg/player/23407/pa1nt,2024-09-01 18:25:00,0.67,1.11,0.87,221,214,244,27,13,14,33,19,14,6,2,4,-2,-6,+4,63%,57%,71%,144,138,152,33%,24%,47%,7,3,4,9,9,0
108,https://vlr.gg/player/25902/shondex,2024-09-01 18:25:00,0.97,0.62,0.81,176,200,133,22,16,6,30,17,13,8,1,7,-3,+1,-4,63%,67%,59%,124,132,115,31%,35%,25%,1,1,0,4,0,4
109,https://vlr.gg/player/11696/zoestol,2024-09-01 18:25:00,0.69,0.77,0.71,146,145,154,18,10,8,30,17,13,16,6,10,-2,-3,+1,63%,62%,65%,91,88,94,29%,28%,30%,2,0,2,4,3,1
110,https://vlr.gg/player/4385/monsi,2024-09-01 18:15:00,0.65,1.89,1.18,209,119,329,32,11,21,25,18,7,11,5,6,-1,-1,0,71%,63%,83%,129,68,210,33%,34%,32%,1,0,1,2,1,1
111,https://vlr.gg/player/3874/teague,2024-09-01 18:15:00,1.09,1.05,1.07,203,192,218,32,17,15,30,17,13,13,5,8,-2,-1,-1,76%,67%,89%,131,130,132,27%,27%,26%,1,0,1,3,1,2
112,https://vlr.gg/player/29688/mikee,2024-09-01 18:15:00,0.82,1.34,1.04,188,185,194,28,15,13,25,19,6,7,3,4,-3,-1,-2,71%,63%,83%,124,122,127,33%,39%,28%,2,1,1,5,2,3
113,https://vlr.gg/player/8422/spaz,2024-09-01 18:15:00,1.11,0.94,1.04,183,228,123,26,19,7,27,19,8,18,6,12,-5,-3,-2,76%,67%,89%,123,152,86,20%,25%,12%,1,1,0,6,4,2
114,https://vlr.gg/player/8373/okeanos,2024-09-01 18:15:00,0.36,1.84,0.99,245,132,398,37,9,28,34,23,11,8,4,4,-3,-6,+3,69%,54%,89%,154,83,248,29%,28%,29%,9,4,5,12,10,2
115,https://vlr.gg/player/3227/screwface,2024-09-01 18:15:00,0.92,1.98,1.53,317,237,378,45,14,31,28,17,11,8,3,5,+12,+3,+9,81%,78%,83%,201,156,236,18%,21%,15%,18,8,10,6,5,1
116,https://vlr.gg/player/8518/tillo,2024-09-01 18:15:00,0.51,1.43,1.04,187,143,221,28,8,20,28,17,11,11,3,8,-1,0,-1,69%,50%,83%,137,96,167,30%,17%,38%,1,1,0,2,1,1
117,https://vlr.gg/player/1089/lenx,2024-09-01 18:15:00,0.91,0.72,0.80,196,177,211,29,12,17,37,17,20,10,1,9,+3,0,+3,64%,50%,75%,131,119,140,32%,26%,35%,6,1,5,3,1,2
118,https://vlr.gg/player/24865/acrian,2024-09-01 18:15:00,0.60,0.79,0.71,161,169,155,22,9,13,32,17,15,12,6,6,0,0,0,71%,67%,75%,121,130,113,22%,27%,17%,1,0,1,1,0,1
119,https://vlr.gg/player/30470/kyu,2024-09-01 18:15:00,0.15,0.91,0.56,110,58,150,17,2,15,31,17,14,16,5,11,0,-1,+1,62%,44%,75%,69,38,92,18%,7%,22%,2,0,2,2,1,1
120,https://vlr.gg/player/23169/minny,2024-09-01 15:45:00,1.31,1.32,1.31,240,243,237,60,28,32,39,22,17,17,11,6,+3,0,+3,74%,69%,79%,153,160,145,40%,46%,34%,7,3,4,4,3,1
121,https://vlr.gg/player/5554/profek,2024-09-01 15:45:00,1.17,1.27,1.22,202,206,199,52,28,24,43,25,18,31,10,21,+4,0,+4,72%,66%,79%,133,144,122,23%,21%,24%,7,2,5,3,2,1
122,https://vlr.gg/player/25906/alexiiik,2024-09-01 15:45:00,0.81,1.23,1.02,217,198,238,51,22,29,49,30,19,12,8,4,+5,-1,+6,67%,60%,74%,140,134,147,26%,34%,20%,16,6,10,11,7,4
123,https://vlr.gg/player/562/zeek,2024-09-01 15:45:00,0.79,1.10,0.94,183,151,216,46,19,27,47,25,22,29,15,14,-4,-5,+1,71%,66%,76%,121,99,143,28%,34%,24%,2,0,2,6,5,1
124,https://vlr.gg/player/1155/buld,2024-09-01 15:45:00,0.65,1.17,0.90,179,125,236,46,17,29,46,27,19,13,3,10,+1,-1,+2,78%,71%,85%,115,75,158,27%,44%,21%,7,3,4,6,4,2
125,https://vlr.gg/player/2653/jesse,2024-09-01 15:45:00,0.77,1.32,1.05,212,170,255,51,19,32,52,30,22,27,9,18,+1,-1,+2,72%,62%,83%,135,112,158,38%,43%,35%,4,0,4,3,1,2
126,https://vlr.gg/player/20271/vorwenn,2024-09-01 15:45:00,0.70,1.25,0.98,205,135,274,48,15,33,52,29,23,19,11,8,-5,-7,+2,72%,62%,83%,132,84,178,31%,28%,32%,5,2,3,10,9,1
127,https://vlr.gg/player/7220/saiz,2024-09-01 15:45:00,1.05,0.77,0.91,169,198,142,42,25,17,49,27,22,8,2,6,+1,-1,+2,58%,50%,66%,113,130,96,37%,36%,37%,6,2,4,5,3,2
128,https://vlr.gg/player/2701/maniek,2024-09-01 15:45:00,0.76,0.95,0.86,211,211,213,52,25,27,53,29,24,12,6,6,-5,-6,+1,57%,56%,57%,134,134,133,20%,33%,7%,13,5,8,18,11,7
129,https://vlr.gg/player/5199/guardy,2024-09-01 15:45:00,0.56,0.92,0.74,136,101,172,31,11,20,53,30,23,36,13,23,-1,-1,0,77%,65%,89%,83,64,102,23%,19%,26%,2,0,2,3,1,2
130,https://vlr.gg/player/64/gmd,2024-09-01 15:00:00,1.07,1.04,1.05,218,229,209,57,30,27,57,29,28,28,14,14,-2,-1,-1,72%,75%,68%,140,149,132,32%,34%,30%,5,1,4,7,2,5
131,https://vlr.gg/player/8376/seven,2024-09-01 15:00:00,0.72,1.33,1.03,196,144,243,50,17,33,51,27,24,24,11,13,-2,-2,0,72%,58%,84%,126,97,154,17%,11%,21%,1,0,1,3,2,1
132,https://vlr.gg/player/53/inspire,2024-09-01 15:00:00,0.83,1.15,1.00,193,193,200,50,24,26,54,28,26,16,4,12,+3,+1,+2,70%,61%,79%,131,128,133,37%,42%,34%,8,5,3,5,4,1
133,https://vlr.gg/player/901/exalt,2024-09-01 15:00:00,0.64,1.26,0.96,182,123,235,47,15,32,52,28,24,30,15,15,0,-2,+2,73%,67%,79%,113,83,142,35%,29%,39%,5,0,5,5,2,3
134,https://vlr.gg/player/3702/sym,2024-09-01 15:00:00,0.76,0.85,0.81,226,254,200,54,30,24,63,34,29,16,7,9,-7,-6,-1,66%,67%,66%,151,158,144,26%,27%,26%,14,7,7,21,13,8
135,https://vlr.gg/player/733/stellar,2024-09-01 15:00:00,1.17,1.49,1.33,237,216,260,67,30,37,45,26,19,28,16,12,+4,+1,+3,76%,74%,78%,152,145,159,27%,28%,26%,7,3,4,3,2,1
136,https://vlr.gg/player/7716/penny,2024-09-01 15:00:00,0.97,1.54,1.25,254,224,280,66,28,38,52,29,23,14,5,9,+7,+2,+5,78%,66%,92%,166,151,181,19%,23%,17%,13,7,6,6,5,1
137,https://vlr.gg/player/69/thief,2024-09-01 15:00:00,1.07,1.26,1.16,233,199,275,59,28,31,52,27,25,25,13,12,+6,+1,+5,73%,68%,78%,151,125,178,29%,29%,28%,12,4,8,6,3,3
138,https://vlr.gg/player/8742/jakee,2024-09-01 15:00:00,0.93,1.09,1.01,199,204,200,52,28,24,54,31,23,41,19,22,-3,-4,+1,77%,74%,81%,128,128,127,28%,38%,20%,4,2,2,7,6,1
139,https://vlr.gg/player/739/fiziq,2024-09-01 15:00:00,0.48,0.68,0.57,128,124,129,31,15,16,55,31,24,30,15,15,-6,-2,-4,64%,66%,61%,78,82,75,26%,33%,20%,5,2,3,11,4,7
140,https://vlr.gg/player/25902/shondex,2024-09-01 15:00:00,0.97,1.75,1.34,249,193,314,66,27,39,45,26,19,9,2,7,+1,+1,0,75%,68%,82%,176,131,225,33%,34%,32%,8,5,3,7,4,3
141,https://vlr.gg/player/23407/pa1nt,2024-09-01 15:00:00,1.13,1.43,1.28,290,269,306,72,34,38,55,30,25,11,5,6,+9,+1,+8,68%,65%,71%,177,168,188,32%,32%,32%,22,11,11,13,10,3
142,https://vlr.gg/player/26848/zeek,2024-09-01 15:00:00,0.93,0.83,0.88,170,184,156,41,26,15,49,25,24,44,14,30,-1,-2,+1,65%,59%,71%,111,118,105,22%,30%,15%,2,0,2,3,2,1
143,https://vlr.gg/player/11696/zoestol,2024-09-01 15:00:00,0.79,0.80,0.79,151,148,156,33,16,17,48,26,22,28,19,9,+1,+1,0,68%,65%,71%,99,99,99,16%,16%,17%,4,1,3,3,0,3
144,https://vlr.gg/player/16671/welyy,2024-09-01 15:00:00,0.68,0.90,0.78,151,146,159,35,15,20,48,26,22,18,9,9,+1,0,+1,66%,68%,65%,112,107,118,34%,35%,33%,5,2,3,4,2,2
145,https://vlr.gg/player/19292/jowa,2024-09-01 15:00:00,0.78,1.31,1.06,194,158,230,44,17,27,47,26,21,31,17,14,-2,-4,+2,70%,65%,76%,128,100,154,26%,21%,30%,8,2,6,10,6,4
146,https://vlr.gg/player/25745/kumi,2024-09-01 15:00:00,1.09,1.04,1.06,221,254,196,59,29,30,49,26,23,9,7,2,-2,-1,-1,65%,62%,68%,143,166,122,21%,26%,15%,10,5,5,12,6,6
147,https://vlr.gg/player/14048/zerona,2024-09-01 15:00:00,0.96,1.15,1.06,217,188,245,52,22,30,53,26,27,23,11,12,0,-1,+1,76%,74%,78%,148,136,159,28%,27%,29%,4,0,4,4,1,3
148,https://vlr.gg/player/8758/benjii,2024-09-01 15:00:00,0.95,0.96,0.96,208,211,206,48,24,24,49,25,24,10,5,5,-1,-1,0,66%,68%,65%,138,135,141,17%,27%,12%,7,4,3,8,5,3
149,https://vlr.gg/player/20959/toozy,2024-09-01 15:00:00,0.80,0.91,0.86,166,171,163,42,20,22,49,26,23,14,8,6,-6,-3,-3,63%,59%,68%,114,114,113,26%,27%,25%,1,1,0,7,4,3
150,https://vlr.gg/player/4917/kaoticcc,2024-09-01 15:00:00,1.35,0.73,1.04,269,332,197,63,42,21,58,30,28,8,4,4,+7,+7,0,63%,68%,58%,166,207,118,25%,34%,12%,19,14,5,12,7,5
151,https://vlr.gg/player/2164/paincakes,2024-09-01 15:00:00,0.94,1.03,0.98,183,192,188,44,26,18,49,27,22,22,5,17,-2,+1,-3,69%,68%,71%,129,124,136,30%,38%,25%,6,5,1,8,4,4
152,https://vlr.gg/player/3687/jonaaa6,2024-09-01 15:00:00,0.95,0.81,0.88,201,228,173,49,30,19,51,28,23,8,3,5,-1,-2,+1,60%,59%,61%,132,147,114,19%,21%,17%,3,0,3,4,2,2
153,https://vlr.gg/player/818/mummay,2024-09-01 15:00:00,0.75,0.94,0.84,153,134,189,40,17,23,46,25,21,7,6,1,-3,0,-3,62%,68%,55%,101,91,113,23%,35%,16%,1,0,1,4,0,4
154,https://vlr.gg/player/2139/neptune,2024-09-01 15:00:00,0.62,0.87,0.74,165,133,193,37,16,21,54,28,26,32,20,12,-3,-3,0,66%,62%,71%,101,79,126,32%,22%,41%,4,1,3,7,4,3
155,https://vlr.gg/player/8422/spaz,2024-09-01 15:00:00,1.21,1.34,1.28,217,206,226,50,22,28,40,19,21,36,18,18,+4,+3,+1,85%,90%,81%,131,119,141,21%,22%,21%,7,3,4,3,0,3
156,https://vlr.gg/player/29688/mikee,2024-09-01 15:00:00,1.52,0.95,1.21,267,312,225,65,37,28,52,20,32,18,8,10,+2,+2,0,78%,87%,70%,162,186,141,38%,36%,40%,12,6,6,10,4,6
157,https://vlr.gg/player/3874/teague,2024-09-01 15:00:00,0.88,1.24,1.08,181,129,213,43,15,28,41,19,22,31,14,17,0,-1,+1,75%,71%,78%,117,86,142,28%,33%,26%,2,0,2,2,1,1
158,https://vlr.gg/player/8373/okeanos,2024-09-01 15:00:00,1.30,0.79,1.02,250,280,229,57,29,28,55,22,33,18,10,8,-2,+2,-4,72%,74%,70%,166,193,144,29%,31%,27%,11,8,3,13,6,7
159,https://vlr.gg/player/4385/monsi,2024-09-01 15:00:00,0.93,1.06,1.00,176,168,187,43,17,26,45,22,23,21,12,9,-2,-1,-1,69%,74%,65%,118,122,114,26%,30%,24%,3,1,2,5,2,3
160,https://vlr.gg/player/8329/starbound,2024-09-01 15:00:00,1.08,1.68,1.37,257,230,286,35,15,20,30,18,12,6,5,1,+3,+4,-1,68%,65%,72%,168,145,194,21%,23%,19%,6,5,1,3,1,2
161,https://vlr.gg/player/33694/evv,2024-09-01 15:00:00,0.51,1.15,0.79,159,94,232,20,6,14,30,17,13,9,5,4,-2,-2,0,63%,55%,72%,98,57,145,38%,22%,47%,1,0,1,3,2,1
162,https://vlr.gg/player/8849/sonder,2024-09-01 15:00:00,0.81,0.65,0.73,192,201,176,26,14,12,36,18,18,5,3,2,-2,-2,0,58%,60%,56%,113,120,105,30%,37%,22%,5,1,4,7,3,4
163,https://vlr.gg/player/17/theia,2024-09-01 15:00:00,0.67,0.42,0.55,135,172,100,18,13,5,34,18,16,10,3,7,-1,-1,0,53%,55%,50%,91,109,72,44%,50%,35%,0,0,0,1,1,0
164,https://vlr.gg/player/9185/dodonut,2024-09-01 15:00:00,0.19,0.38,0.28,89,60,124,9,3,6,34,17,17,8,2,6,-8,-5,-3,39%,30%,50%,70,47,97,27%,21%,30%,2,1,1,10,6,4
165,https://vlr.gg/player/30470/kyu,2024-09-01 15:00:00,1.61,1.48,1.54,286,323,255,38,21,17,23,12,11,21,5,16,+4,+1,+3,92%,89%,95%,184,210,161,32%,28%,37%,4,1,3,0,0,0
166,https://vlr.gg/player/1089/lenx,2024-09-01 15:00:00,1.32,1.37,1.35,305,326,288,43,22,21,24,11,13,11,7,4,+3,+2,+1,74%,83%,65%,200,209,192,27%,33%,22%,7,4,3,4,2,2
167,https://vlr.gg/player/3227/screwface,2024-09-01 15:00:00,0.82,1.61,1.23,235,179,280,31,12,19,22,13,9,9,4,5,+4,0,+4,84%,78%,90%,158,133,181,25%,30%,22%,9,3,6,5,3,2
168,https://vlr.gg/player/8518/tillo,2024-09-01 15:00:00,1.00,1.25,1.13,185,179,191,26,12,14,19,11,8,12,5,7,+1,+1,0,84%,83%,85%,121,113,128,18%,25%,13%,3,2,1,2,1,1
169,https://vlr.gg/player/24865/acrian,2024-09-01 15:00:00,0.81,1.04,0.93,159,132,187,26,10,16,21,10,11,6,1,5,-2,0,-2,71%,72%,70%,106,85,125,20%,17%,22%,1,1,0,3,1,2
170,https://vlr.gg/player/15376/grtw,2024-09-01 14:15:00,0.55,1.25,0.97,223,155,269,29,7,22,29,12,17,1,0,1,+3,+2,+1,65%,53%,73%,147,94,183,32%,27%,34%,4,2,2,1,0,1
171,https://vlr.gg/player/15577/brk,2024-09-01 14:15:00,0.76,1.01,0.91,196,205,198,26,11,15,28,12,16,5,1,4,+5,+2,+3,51%,60%,45%,131,119,140,26%,32%,23%,9,4,5,4,2,2
172,https://vlr.gg/player/29340/cunha20,2024-09-01 14:15:00,0.87,0.94,0.91,207,168,230,26,8,18,30,11,19,6,3,3,0,0,0,59%,53%,64%,128,100,147,44%,42%,44%,3,1,2,3,1,2
173,https://vlr.gg/player/1378/addicted,2024-09-01 14:15:00,0.76,0.46,0.58,117,138,98,13,8,5,27,11,16,7,1,6,-4,-1,-3,62%,73%,55%,81,96,70,38%,50%,27%,0,0,0,4,1,3
174,https://vlr.gg/player/13435/fragger,2024-09-01 14:15:00,0.53,0.35,0.40,106,108,112,14,6,8,31,12,19,3,2,1,-1,-2,+1,54%,60%,50%,76,76,76,29%,50%,21%,4,1,3,5,3,2
175,https://vlr.gg/player/1475/kamyk,2024-09-01 14:15:00,1.02,1.61,1.26,217,182,276,30,14,16,22,14,8,12,8,4,-1,-2,+1,76%,73%,80%,152,126,190,30%,28%,32%,2,0,2,3,2,1
176,https://vlr.gg/player/4308/magik,2024-09-01 14:15:00,1.44,1.02,1.25,260,272,214,36,23,13,20,11,9,1,0,1,+4,+4,0,65%,64%,67%,164,179,143,21%,23%,18%,5,4,1,1,0,1
177,https://vlr.gg/player/1284/mikee,2024-09-01 14:15:00,1.16,1.33,1.23,214,206,203,27,16,11,20,13,7,13,6,7,+1,0,+1,84%,77%,93%,133,139,125,25%,32%,18%,2,1,1,1,1,0
178,https://vlr.gg/player/5893/robbiebk,2024-09-01 14:15:00,1.10,0.91,1.02,154,188,91,21,15,6,20,14,6,4,3,1,-5,-3,-2,70%,64%,80%,98,127,56,31%,29%,38%,0,0,0,5,3,2
179,https://vlr.gg/player/2700/jas,2024-09-01 14:15:00,0.89,1.08,0.97,232,229,232,31,19,12,26,16,10,7,4,3,-2,-1,-1,73%,73%,73%,151,143,163,26%,21%,34%,8,5,3,10,6,4
180,https://vlr.gg/player/9554/kaajak,2024-09-01 12:00:00,1.12,1.54,1.33,275,249,304,74,31,43,51,26,25,9,6,3,+7,0,+7,72%,67%,76%,179,159,197,43%,38%,47%,21,8,13,14,8,6
181,https://vlr.gg/player/1281/molsi,2024-09-01 12:00:00,0.94,1.13,1.04,175,139,207,43,19,24,46,22,24,36,12,24,+5,+2,+3,74%,72%,76%,113,88,137,27%,27%,28%,6,2,4,1,0,1
182,https://vlr.gg/player/129/hype,2024-09-01 12:00:00,1.02,1.01,1.01,204,215,192,54,29,25,51,26,25,13,4,9,+2,0,+2,73%,72%,74%,135,151,120,31%,32%,30%,7,3,4,5,3,2
183,https://vlr.gg/player/1507/avova,2024-09-01 12:00:00,0.98,0.92,0.95,168,196,144,45,26,19,48,27,21,25,12,13,+4,+3,+1,74%,81%,68%,114,131,97,47%,57%,38%,7,5,2,3,2,1
184,https://vlr.gg/player/101/soulcas,2024-09-01 12:00:00,0.75,1.12,0.94,192,175,211,50,22,28,53,28,25,24,12,12,-4,-3,-1,64%,61%,66%,134,123,144,43%,41%,45%,3,1,2,7,4,3
185,https://vlr.gg/player/10885/davih,2024-09-01 12:00:00,1.03,1.24,1.14,207,197,220,53,24,29,43,22,21,16,9,7,0,-1,+1,66%,68%,64%,144,137,151,26%,25%,26%,3,1,2,3,2,1
186,https://vlr.gg/player/7490/anguist,2024-09-01 12:00:00,1.19,1.02,1.10,228,253,202,64,38,26,56,29,27,5,1,4,+1,+1,0,69%,66%,72%,150,162,137,35%,38%,32%,10,4,6,9,3,6
187,https://vlr.gg/player/4329/vince,2024-09-01 12:00:00,1.00,0.95,0.98,198,205,191,47,25,22,55,28,27,40,22,18,+2,-1,+3,77%,76%,78%,137,150,124,23%,27%,18%,4,0,4,2,1,1
188,https://vlr.gg/player/2472/benny,2024-09-01 12:00:00,0.80,0.77,0.78,151,153,151,40,20,20,52,26,26,21,9,12,-3,-1,-2,59%,61%,58%,99,101,97,24%,25%,23%,5,3,2,8,4,4
189,https://vlr.gg/player/1835/elllement,2024-09-01 12:00:00,0.26,1.15,0.67,178,103,251,45,13,32,60,34,26,13,5,8,-14,-10,-4,61%,50%,72%,117,72,164,27%,33%,24%,8,5,3,22,15,7
190,https://vlr.gg/player/3674/iluri,2024-09-01 12:00:00,1.28,0.92,1.06,195,215,180,28,13,15,31,10,21,8,2,6,+1,0,+1,59%,53%,63%,128,150,113,41%,40%,42%,4,1,3,3,1,2
191,https://vlr.gg/player/2658/xuss,2024-09-01 12:00:00,0.10,1.25,0.79,200,74,262,25,3,22,32,15,17,4,2,2,-3,-3,0,64%,40%,79%,132,51,183,27%,15%,30%,3,1,2,6,4,2
192,https://vlr.gg/player/1616/starki,2024-09-01 12:00:00,0.75,0.81,0.79,179,171,172,22,8,14,31,12,19,7,2,5,+2,+2,0,59%,60%,58%,104,97,109,30%,29%,30%,5,2,3,3,0,3
193,https://vlr.gg/player/7660/fizzy,2024-09-01 12:00:00,0.93,0.62,0.74,153,195,149,23,11,12,32,12,20,7,2,5,+4,+2,+2,56%,60%,54%,101,118,90,36%,38%,34%,6,2,4,2,0,2
194,https://vlr.gg/player/3753/obnoks,2024-09-01 12:00:00,0.63,0.70,0.67,156,152,169,21,7,14,34,13,21,12,4,8,-7,-4,-3,59%,47%,67%,107,105,108,21%,18%,23%,0,0,0,7,4,3
195,https://vlr.gg/player/5599/khaalid,2024-09-01 12:00:00,1.49,1.35,1.44,258,231,259,36,24,12,19,11,8,10,3,7,+2,0,+2,69%,71%,67%,157,149,170,33%,30%,36%,4,2,2,2,2,0
196,https://vlr.gg/player/5600/moh,2024-09-01 12:00:00,1.27,1.21,1.24,250,253,209,33,22,11,22,15,7,14,9,5,0,+1,-1,79%,79%,80%,165,183,136,30%,31%,30%,5,3,2,5,2,3
197,https://vlr.gg/player/6503/sand,2024-09-01 12:00:00,1.06,1.32,1.16,212,208,252,32,18,14,24,15,9,12,8,4,-1,-2,+1,74%,71%,80%,149,139,163,35%,31%,39%,2,1,1,3,3,0
198,https://vlr.gg/player/1618/spyzera,2024-09-01 12:00:00,1.10,1.15,1.12,185,192,170,27,17,10,22,15,7,18,15,3,+2,+1,+1,77%,71%,87%,114,115,112,30%,28%,35%,5,3,2,3,2,1
199,https://vlr.gg/player/37847/fighter,2024-09-01 12:00:00,0.66,1.20,0.87,221,207,269,32,17,15,32,21,11,3,2,1,0,0,0,67%,67%,67%,162,139,199,38%,41%,34%,5,3,2,5,3,2
200,https://vlr.gg/player/40591/comeback,2024-08-31 16:45:00,1.55,1.32,1.49,337,341,293,39,29,10,21,15,6,8,4,4,+7,+5,+2,79%,79%,78%,212,224,179,19%,22%,6%,11,8,3,4,3,1
201,https://vlr.gg/player/31305/lar0k,2024-08-31 16:45:00,1.52,1.33,1.47,217,231,188,28,21,7,16,11,5,13,9,4,+2,+1,+1,85%,83%,89%,140,147,121,44%,48%,33%,3,2,1,1,1,0
202,https://vlr.gg/player/24344/loita,2024-08-31 16:45:00,1.14,1.54,1.25,269,273,251,29,21,8,21,17,4,15,9,6,+4,+2,+2,79%,71%,100%,168,174,152,35%,35%,37%,5,3,2,1,1,0
203,https://vlr.gg/player/31855/celasun,2024-08-31 16:45:00,0.96,1.21,1.02,152,164,123,19,15,4,17,15,2,7,5,2,+1,+1,0,82%,79%,89%,114,122,95,29%,31%,24%,2,2,0,1,1,0
204,https://vlr.gg/player/5565/ros,2024-08-31 16:45:00,0.85,1.25,0.96,196,185,235,23,16,7,21,16,5,10,7,3,+1,-1,+2,73%,71%,78%,120,111,146,28%,29%,25%,3,1,2,2,2,0
205,https://vlr.gg/player/37847/fighter,2024-08-31 16:45:00,0.80,1.03,0.95,209,190,215,23,6,17,27,8,19,6,0,6,-6,-3,-3,64%,56%,67%,139,117,147,29%,31%,28%,1,0,1,7,3,4
206,https://vlr.gg/player/5599/khaalid,2024-08-31 16:45:00,0.70,0.89,0.84,179,117,218,20,3,17,28,7,21,19,6,13,-2,-2,0,70%,89%,63%,115,80,128,35%,33%,35%,3,0,3,5,2,3
207,https://vlr.gg/player/1618/spyzera,2024-08-31 16:45:00,0.33,0.94,0.78,193,96,224,22,3,19,28,8,20,8,1,7,-2,-2,0,64%,67%,63%,122,74,141,33%,27%,34%,2,0,2,4,2,2
208,https://vlr.gg/player/6503/sand,2024-08-31 16:45:00,1.30,0.38,0.63,139,251,92,15,8,7,27,6,21,7,2,5,-5,0,-5,52%,67%,46%,86,164,57,40%,37%,44%,1,0,1,6,0,6
209,https://vlr.gg/player/5600/moh,2024-08-31 16:45:00,0.48,0.69,0.63,145,91,180,16,2,14,28,7,21,8,4,4,0,0,0,55%,56%,54%,108,69,122,27%,38%,25%,2,1,1,2,1,1
210,https://vlr.gg/player/8226/waddle,2024-08-31 15:15:00,1.11,1.11,1.10,206,238,188,46,23,23,42,20,22,18,4,14,+1,+1,0,79%,77%,81%,143,166,126,34%,40%,29%,2,2,0,1,1,0
211,https://vlr.gg/player/7162/wackie,2024-08-31 15:15:00,0.89,1.24,1.09,217,174,248,46,15,31,43,20,23,18,9,9,+1,+1,0,69%,62%,75%,141,115,160,25%,25%,25%,7,3,4,6,2,4
212,https://vlr.gg/player/4544/filu,2024-08-31 15:15:00,0.67,1.13,0.91,221,190,250,48,16,32,53,25,28,13,4,9,+1,0,+1,73%,62%,81%,144,122,160,29%,24%,32%,13,5,8,12,5,7
213,https://vlr.gg/player/12474/tag,2024-08-31 15:15:00,0.70,1.03,0.89,181,164,211,41,14,27,46,21,25,9,2,7,-2,-2,0,63%,46%,75%,135,117,148,48%,45%,50%,4,1,3,6,3,3
214,https://vlr.gg/player/1944/cayden,2024-08-31 15:15:00,0.69,0.82,0.77,161,159,163,32,13,19,44,19,25,26,3,23,-1,0,-1,69%,65%,72%,108,105,110,29%,29%,28%,5,2,3,6,2,4
215,https://vlr.gg/player/10885/davih,2024-08-31 15:15:00,1.09,1.92,1.44,247,175,327,52,20,32,33,21,12,27,15,12,+3,0,+3,76%,75%,77%,176,134,235,31%,31%,30%,5,0,5,2,0,2
216,https://vlr.gg/player/7490/anguist,2024-08-31 15:15:00,1.15,1.06,1.11,211,212,220,54,33,21,42,25,17,14,3,11,-5,-3,-2,74%,75%,73%,150,150,150,28%,38%,19%,0,0,0,5,3,2
217,https://vlr.gg/player/1835/elllement,2024-08-31 15:15:00,0.85,1.49,1.11,253,227,263,56,30,26,45,29,16,12,4,8,+3,+1,+2,69%,58%,85%,162,147,183,26%,25%,27%,13,8,5,10,7,3
218,https://vlr.gg/player/4329/vince,2024-08-31 15:15:00,0.81,0.84,0.82,169,178,163,33,18,15,47,29,18,25,17,8,+1,0,+1,69%,67%,73%,112,126,92,18%,17%,20%,6,3,3,5,3,2
219,https://vlr.gg/player/2472/benny,2024-08-31 15:15:00,0.83,0.73,0.79,159,175,133,33,22,11,46,28,18,20,12,8,-2,+2,-4,69%,67%,73%,102,114,87,26%,24%,29%,7,7,0,9,5,4
220,https://vlr.gg/player/9554/kaajak,2024-08-31 12:00:00,1.11,1.21,1.15,253,246,287,55,30,25,48,27,21,11,7,4,+3,+2,+1,60%,58%,62%,173,167,180,33%,28%,41%,17,9,8,14,7,7
221,https://vlr.gg/player/1507/avova,2024-08-31 12:00:00,1.21,0.60,0.95,171,235,89,40,31,9,46,25,21,21,9,12,-3,-1,-2,69%,75%,62%,114,156,56,43%,48%,29%,3,2,1,6,3,3
222,https://vlr.gg/player/1281/molsi,2024-08-31 12:00:00,0.99,0.84,0.93,175,185,174,36,22,14,44,25,19,27,13,14,0,0,0,74%,72%,77%,126,124,128,28%,31%,25%,3,2,1,3,2,1
223,https://vlr.gg/player/101/soulcas,2024-08-31 12:00:00,0.71,0.79,0.74,132,126,145,28,15,13,42,24,18,17,9,8,0,+1,-1,66%,67%,65%,89,87,91,35%,33%,37%,4,3,1,4,2,2
224,https://vlr.gg/player/129/hype,2024-08-31 12:00:00,0.52,0.92,0.69,143,128,171,30,14,16,49,30,19,14,7,7,0,-2,+2,66%,58%,77%,98,88,111,32%,30%,34%,4,2,2,4,4,0
225,https://vlr.gg/player/5554/profek,2024-08-31 12:00:00,1.51,1.19,1.32,219,227,207,47,21,26,31,11,20,25,13,12,+3,+2,+1,81%,85%,78%,152,159,147,28%,29%,27%,4,2,2,1,0,1
226,https://vlr.gg/player/25906/alexiiik,2024-08-31 12:00:00,1.09,1.36,1.25,283,252,297,62,24,38,41,19,22,14,6,8,-2,-3,+1,71%,62%,78%,175,156,189,31%,27%,34%,13,5,8,15,8,7
227,https://vlr.gg/player/1155/buld,2024-08-31 12:00:00,1.04,1.18,1.12,215,202,225,46,19,27,39,17,22,17,7,10,+4,+3,+1,73%,77%,69%,137,122,148,27%,29%,27%,9,4,5,5,1,4
228,https://vlr.gg/player/23169/minny,2024-08-31 12:00:00,1.27,0.77,0.98,178,218,151,39,21,18,41,15,26,19,8,11,-3,+1,-4,74%,85%,67%,124,147,108,26%,26%,27%,3,2,1,6,1,5
229,https://vlr.gg/player/562/zeek,2024-08-31 12:00:00,0.86,0.93,0.90,145,129,164,35,13,22,38,15,23,14,9,5,-2,-3,+1,71%,73%,69%,104,85,117,22%,11%,29%,2,0,2,4,3,1
230,https://vlr.gg/player/2658/xuss,2024-08-31 12:00:00,0.95,1.47,1.21,249,221,288,88,37,51,67,37,30,12,7,5,+10,+3,+7,79%,75%,83%,164,147,181,24%,31%,19%,23,10,13,13,7,6
231,https://vlr.gg/player/3674/iluri,2024-08-31 12:00:00,1.20,0.87,1.04,187,208,157,63,37,26,62,30,32,24,13,11,-3,0,-3,77%,85%,69%,128,147,110,43%,46%,39%,3,3,0,6,3,3
232,https://vlr.gg/player/3753/obnoks,2024-08-31 12:00:00,1.06,0.99,1.03,199,189,220,64,30,34,66,29,37,42,20,22,+1,-1,+2,80%,81%,79%,138,129,146,27%,25%,29%,8,2,6,7,3,4
233,https://vlr.gg/player/7660/fizzy,2024-08-31 12:00:00,1.00,0.93,0.97,208,210,216,75,37,38,69,33,36,9,7,2,-7,-4,-3,69%,71%,67%,138,132,144,25%,27%,23%,5,3,2,12,7,5
234,https://vlr.gg/player/1616/starki,2024-08-31 12:00:00,1.02,0.69,0.85,175,185,166,60,33,27,70,32,38,27,15,12,-1,0,-1,69%,71%,67%,114,121,108,34%,43%,28%,9,5,4,10,5,5
235,https://vlr.gg/player/15577/brk,2024-08-31 12:00:00,0.85,1.21,1.03,233,202,246,71,31,40,70,36,34,20,11,9,+3,-2,+5,64%,60%,67%,151,137,166,18%,21%,16%,18,9,9,15,11,4
236,https://vlr.gg/player/29340/cunha20,2024-08-31 12:00:00,1.16,0.88,1.02,207,254,160,71,43,28,69,37,32,28,11,17,0,+2,-2,75%,73%,77%,136,163,110,34%,34%,35%,6,5,1,6,3,3
237,https://vlr.gg/player/1378/addicted,2024-08-31 12:00:00,0.92,1.03,0.98,189,172,199,66,31,35,69,35,34,26,16,10,0,-1,+1,68%,73%,63%,135,127,142,34%,34%,35%,8,2,6,8,3,5
238,https://vlr.gg/player/15376/grtw,2024-08-31 12:00:00,0.98,0.84,0.91,181,189,170,59,33,26,68,33,35,19,6,13,+3,+1,+2,71%,69%,73%,126,133,120,25%,30%,20%,14,5,9,11,4,7
239,https://vlr.gg/player/13435/fragger,2024-08-31 12:00:00,0.95,0.80,0.87,184,194,184,66,35,31,74,35,39,29,12,17,-6,-2,-4,73%,71%,75%,120,123,116,36%,38%,35%,2,2,0,8,4,4
240,https://vlr.gg/player/44462/kyujinn,2024-08-28 21:15:00,0.95,1.04,1.00,208,185,227,31,10,21,33,16,17,7,4,3,-1,+1,-2,60%,61%,58%,145,131,155,31%,26%,35%,3,2,1,4,1,3
241,https://vlr.gg/player/20500/zaki,2024-08-28 21:15:00,0.53,1.00,0.80,169,110,216,25,8,17,34,16,18,13,2,11,-3,-3,0,64%,50%,75%,112,64,148,33%,29%,35%,6,2,4,9,5,4
242,https://vlr.gg/player/25737/buffala,2024-08-28 21:15:00,0.42,0.98,0.74,178,108,222,23,7,16,34,16,18,13,4,9,-3,-2,-1,57%,39%,71%,115,77,144,20%,12%,25%,3,1,2,6,3,3
243,https://vlr.gg/player/28386/junki,2024-08-28 21:15:00,0.38,0.97,0.72,130,93,162,18,4,14,33,17,16,14,5,9,-2,-1,-1,62%,50%,71%,83,67,94,19%,14%,21%,0,0,0,2,1,1
244,https://vlr.gg/player/35951/morgan,2024-08-28 21:15:00,0.66,0.65,0.65,169,165,174,23,10,13,36,16,20,9,3,6,-7,-3,-4,50%,50%,50%,120,98,136,23%,16%,30%,1,0,1,8,3,5
245,https://vlr.gg/player/20538/linlin,2024-08-28 21:15:00,1.33,1.47,1.39,247,245,238,36,22,14,24,16,8,20,4,16,+2,+1,+1,83%,83%,83%,174,182,163,37%,33%,44%,4,2,2,2,1,1
246,https://vlr.gg/player/20539/juw,2024-08-28 21:15:00,1.16,1.58,1.34,291,257,324,42,21,21,27,18,9,8,4,4,+12,+4,+8,74%,67%,83%,182,164,207,29%,25%,33%,16,8,8,4,4,0
247,https://vlr.gg/player/12055/mmonch,2024-08-28 21:15:00,1.10,1.63,1.33,204,181,243,34,16,18,20,15,5,6,4,2,+5,+5,0,76%,71%,83%,136,101,182,42%,26%,63%,6,5,1,1,0,1
248,https://vlr.gg/player/20537/andrehs,2024-08-28 21:15:00,0.94,1.43,1.15,203,174,254,31,14,17,25,16,9,18,12,6,+1,0,+1,76%,75%,78%,135,126,147,31%,25%,38%,1,0,1,0,0,0
249,https://vlr.gg/player/20491/ivy,2024-08-28 21:15:00,1.03,1.08,1.05,175,175,169,27,16,11,24,16,8,19,8,11,-4,-2,-2,83%,83%,83%,115,119,110,36%,28%,52%,2,1,1,6,3,3
250,https://vlr.gg/player/25663/dods,2024-08-28 18:00:00,1.52,0.78,1.22,324,341,196,65,47,18,47,26,21,9,5,4,-2,+1,-3,69%,68%,69%,192,231,137,36%,40%,29%,9,8,1,11,7,4
251,https://vlr.gg/player/21558/micaela,2024-08-28 18:00:00,1.28,1.13,1.22,176,194,190,47,30,17,34,17,17,29,12,17,-3,-2,-1,88%,92%,81%,125,125,126,36%,34%,38%,4,2,2,7,4,3
252,https://vlr.gg/player/11259/conir,2024-08-28 18:00:00,1.18,1.17,1.17,231,224,230,54,33,21,37,21,16,22,13,9,0,+1,-1,80%,84%,73%,143,146,139,37%,35%,41%,8,4,4,8,3,5
253,https://vlr.gg/player/11235/biazik,2024-08-28 18:00:00,1.06,1.05,1.06,168,167,212,37,19,18,34,18,16,20,14,6,+3,+2,+1,75%,76%,73%,132,119,152,28%,21%,39%,5,3,2,2,1,1
254,https://vlr.gg/player/18982/romily,2024-08-28 18:00:00,1.01,1.08,1.04,191,164,210,42,22,20,36,18,18,6,1,5,+6,+2,+4,72%,76%,65%,120,110,135,26%,25%,27%,8,4,4,2,2,0
255,https://vlr.gg/player/40657/ataraxia,2024-08-28 18:00:00,0.74,1.06,0.93,181,123,215,40,12,28,43,15,28,3,1,2,+1,-1,+2,64%,65%,63%,115,77,142,37%,24%,44%,3,0,3,2,1,1
256,https://vlr.gg/player/35018/allie,2024-08-28 18:00:00,1.18,0.75,0.92,171,235,145,40,20,20,46,18,28,26,17,9,+2,+1,+1,69%,81%,61%,113,147,89,27%,23%,33%,4,1,3,2,0,2
257,https://vlr.gg/player/35869/meleliita,2024-08-28 18:00:00,1.04,0.53,0.73,180,230,158,39,20,19,54,20,34,12,7,5,+1,+5,-4,63%,73%,55%,118,140,103,44%,51%,39%,10,6,4,9,1,8
258,https://vlr.gg/player/40135/nati,2024-08-28 18:00:00,0.99,0.53,0.72,135,199,104,32,19,13,49,19,30,5,4,1,-1,-3,+2,55%,69%,45%,101,139,74,55%,58%,52%,3,0,3,4,3,1
259,https://vlr.gg/player/35660/tok1o,2024-08-28 18:00:00,0.76,0.62,0.67,166,212,167,36,17,19,53,22,31,12,6,6,-7,-2,-5,59%,65%,55%,118,131,110,21%,13%,29%,10,6,4,17,8,9
260,https://vlr.gg/player/28993/guterwoman,2024-08-27 20:15:00,1.17,1.04,1.09,252,251,264,36,15,21,34,12,22,8,2,6,+1,-1,+2,65%,56%,71%,167,172,163,32%,37%,30%,6,1,5,5,2,3
261,https://vlr.gg/player/35857/mayzin,2024-08-27 20:15:00,0.71,1.01,0.89,180,138,217,27,7,20,33,13,20,11,9,2,-2,-1,-1,63%,63%,63%,120,94,138,25%,10%,36%,1,0,1,3,1,2
262,https://vlr.gg/player/44464/nezha,2024-08-27 20:15:00,1.03,0.57,0.76,191,267,141,25,15,10,34,14,20,14,8,6,0,+1,-1,60%,63%,58%,130,165,107,44%,42%,46%,4,3,1,4,2,2
263,https://vlr.gg/player/44500/atisca,2024-08-27 20:15:00,0.67,0.72,0.70,146,143,156,22,8,14,32,12,20,4,2,2,+1,-3,+4,53%,56%,50%,106,97,112,29%,21%,37%,7,1,6,6,4,2
264,https://vlr.gg/player/35930/alyssa,2024-08-27 20:15:00,0.47,0.53,0.48,107,69,130,15,5,10,33,12,21,9,3,6,-2,-2,0,60%,63%,58%,72,47,89,21%,22%,21%,1,0,1,3,2,1
265,https://vlr.gg/player/28598/chloe,2024-08-27 20:15:00,2.29,1.46,1.96,388,459,302,57,39,18,27,15,12,21,11,10,+2,+1,+1,83%,79%,88%,256,317,164,25%,30%,16%,6,4,2,4,3,1
266,https://vlr.gg/player/44501/lauguz,2024-08-27 20:15:00,1.22,1.36,1.28,267,281,238,40,26,14,28,19,9,7,3,4,+1,0,+1,85%,75%,100%,178,198,149,30%,30%,29%,6,3,3,5,3,2
267,https://vlr.gg/player/21476/cami,2024-08-27 20:15:00,1.07,1.43,1.22,192,150,251,24,12,12,22,12,10,34,19,15,0,-1,+1,78%,75%,81%,132,104,174,23%,31%,18%,2,1,1,2,2,0
268,https://vlr.gg/player/15592/angel,2024-08-27 20:15:00,1.24,1.08,1.18,162,177,140,23,15,8,21,12,9,26,20,6,+1,0,+1,85%,96%,69%,95,105,80,26%,35%,14%,2,1,1,1,1,0
269,https://vlr.gg/player/35839/vefa,2024-08-27 20:15:00,0.46,0.88,0.63,148,114,195,22,11,11,28,18,10,4,1,3,-2,-4,+2,70%,75%,63%,93,74,122,26%,22%,29%,5,1,4,7,5,2
270,https://vlr.gg/player/35873/gelatycat,2024-08-27 18:00:00,0.92,1.03,0.98,188,193,185,30,14,16,28,13,15,8,3,5,0,-3,+3,71%,67%,74%,124,130,120,46%,52%,42%,3,0,3,3,3,0
271,https://vlr.gg/player/21008/mcfly,2024-08-27 18:00:00,1.10,0.80,0.93,181,211,157,25,13,12,31,14,17,11,5,6,-1,-1,0,68%,67%,70%,130,154,111,18%,26%,11%,1,0,1,2,1,1
272,https://vlr.gg/player/35907/naxa,2024-08-27 18:00:00,0.71,1.10,0.93,220,197,250,33,12,21,32,17,15,5,3,2,+4,+1,+3,68%,61%,74%,152,138,163,28%,27%,29%,7,3,4,3,2,1
273,https://vlr.gg/player/28222/panchill,2024-08-27 18:00:00,0.91,0.79,0.84,170,178,162,25,11,14,30,13,17,5,2,3,-1,0,-1,73%,67%,78%,117,126,110,36%,37%,35%,2,2,0,3,2,1
274,https://vlr.gg/player/35876/tconda,2024-08-27 18:00:00,0.59,0.52,0.55,161,154,161,22,9,13,34,16,18,7,4,3,-5,-1,-4,59%,50%,65%,102,105,100,33%,28%,38%,6,2,4,11,3,8
275,https://vlr.gg/player/21108/ponix,2024-08-27 18:00:00,1.21,1.40,1.29,187,163,223,28,14,14,20,11,9,20,9,11,+1,0,+1,80%,74%,89%,126,112,144,31%,28%,35%,1,0,1,0,0,0
276,https://vlr.gg/player/42378/nicky,2024-08-27 18:00:00,0.91,1.64,1.23,235,178,314,34,15,19,28,17,11,17,8,9,+4,-1,+5,78%,74%,83%,151,120,191,41%,44%,40%,5,0,5,1,1,0
277,https://vlr.gg/player/24770/babzzz,2024-08-27 18:00:00,0.97,1.46,1.18,217,194,253,36,17,19,28,17,11,8,4,4,-2,0,-2,68%,65%,72%,145,129,165,30%,35%,26%,4,3,1,6,3,3
278,https://vlr.gg/player/33177/none,2024-08-27 18:00:00,1.37,0.92,1.17,285,331,217,40,27,13,33,19,14,14,7,7,+2,+2,0,80%,74%,89%,176,201,145,25%,27%,21%,10,6,4,8,4,4
279,https://vlr.gg/player/21548/adenina,2024-08-27 18:00:00,0.90,0.48,0.71,117,114,105,16,9,7,26,12,14,10,5,5,-2,-2,0,71%,70%,72%,76,85,65,23%,29%,16%,2,2,0,4,4,0
280,https://vlr.gg/player/24210/tasty,2024-08-26 21:15:00,1.82,1.34,1.53,294,331,266,64,31,33,33,10,23,12,6,6,+8,+3,+5,77%,83%,72%,191,217,173,36%,49%,28%,10,3,7,2,0,2
281,https://vlr.gg/player/25741/lied,2024-08-26 21:15:00,1.48,1.00,1.19,260,329,214,54,27,27,40,16,24,13,6,7,0,0,0,68%,67%,69%,170,215,140,34%,45%,26%,14,8,6,14,8,6
282,https://vlr.gg/player/35927/dano,2024-08-26 21:15:00,1.21,1.07,1.13,200,254,160,44,23,21,37,16,21,23,10,13,-1,+1,-2,80%,88%,75%,128,158,108,21%,20%,23%,2,1,1,3,0,3
283,https://vlr.gg/player/35547/raquinuki,2024-08-26 21:15:00,0.49,1.29,0.97,191,97,259,41,8,33,41,17,24,6,1,5,-1,-3,+2,63%,58%,67%,138,76,180,34%,24%,38%,3,0,3,4,3,1
284,https://vlr.gg/player/29223/tura,2024-08-26 21:15:00,1.14,0.81,0.94,164,167,159,33,16,17,38,12,26,32,9,23,-3,-1,-2,78%,83%,75%,104,112,99,29%,28%,30%,2,0,2,5,1,4
285,https://vlr.gg/player/17982/lunafox,2024-08-26 21:15:00,1.19,0.93,1.09,237,246,228,49,33,16,47,25,22,14,7,7,0,+1,-1,65%,72%,54%,158,157,161,39%,46%,32%,8,4,4,8,3,5
286,https://vlr.gg/player/36737/alexaishot,2024-08-26 21:15:00,1.17,0.74,0.99,215,231,186,44,29,15,46,24,22,12,8,4,+1,+1,0,70%,69%,71%,144,161,119,32%,41%,19%,5,2,3,4,1,3
287,https://vlr.gg/player/37923/oasis,2024-08-26 21:15:00,0.69,0.83,0.75,218,224,206,43,27,16,54,34,20,6,4,2,-4,-3,-1,62%,61%,63%,138,141,135,32%,33%,30%,10,8,2,14,11,3
288,https://vlr.gg/player/28387/fire,2024-08-26 21:15:00,0.77,0.68,0.73,142,136,158,30,17,13,46,25,21,10,7,3,0,+1,-1,53%,58%,46%,100,92,112,18%,20%,16%,4,3,1,4,2,2
289,https://vlr.gg/player/44540/memi,2024-08-26 21:15:00,0.71,0.51,0.63,105,105,118,22,12,10,44,24,20,20,16,4,0,-2,+2,62%,69%,50%,76,75,77,23%,21%,27%,2,0,2,2,2,0
290,https://vlr.gg/player/45468/bae,2024-08-26 18:00:00,1.29,1.57,1.44,279,235,311,43,18,25,32,16,16,13,6,7,+7,+5,+2,84%,90%,79%,180,157,200,27%,24%,28%,9,6,3,2,1,1
291,https://vlr.gg/player/28620/freya,2024-08-26 18:00:00,0.93,0.97,0.95,178,178,183,31,15,16,31,15,16,5,3,2,0,+1,-1,57%,60%,54%,129,108,147,29%,29%,29%,1,1,0,1,0,1
292,https://vlr.gg/player/36082/asia,2024-08-26 18:00:00,0.92,0.67,0.78,172,178,158,24,11,13,36,15,21,18,11,7,-5,-1,-4,66%,70%,63%,106,116,97,21%,23%,19%,0,0,0,5,1,4
293,https://vlr.gg/player/35867/saikiwi,2024-08-26 18:00:00,1.09,0.44,0.72,173,247,129,27,17,10,37,15,22,10,9,1,-1,+1,-2,50%,65%,38%,115,155,82,25%,24%,28%,10,5,5,11,4,7
294,https://vlr.gg/player/35860/vossu,2024-08-26 18:00:00,0.36,1.00,0.71,161,105,205,24,7,17,38,18,20,18,7,11,-5,-2,-3,57%,45%,67%,113,77,143,31%,24%,34%,0,0,0,5,2,3
295,https://vlr.gg/player/43958/yuna,2024-08-26 18:00:00,,,,,,,,,,,,,,,,,,,,,,,,,,,,,,,,,
296,https://vlr.gg/player/19256/frantastic,2024-08-26 18:00:00,1.27,1.68,1.46,271,224,320,38,16,22,27,14,13,35,18,17,+2,0,+2,80%,71%,90%,175,157,197,20%,19%,22%,6,2,4,4,2,2
297,https://vlr.gg/player/25356/reshi,2024-08-26 18:00:00,1.58,1.03,1.33,250,273,213,38,24,14,30,15,15,22,13,9,+1,+2,-1,73%,79%,65%,162,179,141,35%,46%,22%,4,3,1,3,1,2
298,https://vlr.gg/player/21091/azul,2024-08-26 18:00:00,0.84,1.51,1.15,212,148,290,34,13,21,28,16,12,24,14,10,-4,-2,-2,82%,79%,85%,141,93,198,29%,24%,33%,0,0,0,4,2,2
299,https://vlr.gg/player/37115/lendary,2024-08-26 18:00:00,1.03,0.85,0.95,202,240,157,35,22,13,32,18,14,6,3,3,+3,+5,-2,68%,75%,60%,138,166,105,25%,22%,31%,9,7,2,6,2,4
300,https://vlr.gg/player/20675/flossie,2024-08-26 18:00:00,0.92,0.69,0.81,189,231,146,29,20,9,32,18,14,9,5,4,+2,+3,-1,70%,71%,70%,121,138,101,14%,15%,12%,5,4,1,3,1,2
301,https://vlr.gg/player/3520/zmjjkk,2024-08-25 03:00:00,1.32,1.48,1.39,309,283,333,111,59,52,72,37,35,24,14,10,0,+1,-1,71%,74%,67%,193,176,214,23%,27%,19%,26,17,9,26,16,10
302,https://vlr.gg/player/15559/chichoo,2024-08-25 03:00:00,1.25,0.96,1.12,223,213,241,85,47,38,69,31,38,24,15,9,-1,-2,+1,76%,78%,74%,150,145,155,39%,38%,40%,6,1,5,7,3,4
303,https://vlr.gg/player/4742/smoggy,2024-08-25 03:00:00,1.21,0.95,1.10,188,194,187,71,42,29,63,31,32,44,23,21,0,+3,-3,84%,91%,74%,123,131,114,32%,30%,34%,5,3,2,5,0,5
304,https://vlr.gg/player/13768/s1mon,2024-08-25 03:00:00,1.16,0.82,1.01,161,192,127,60,39,21,66,34,32,48,29,19,+5,+4,+1,80%,86%,72%,113,133,89,30%,35%,22%,8,6,2,3,2,1
305,https://vlr.gg/player/3017/nobody,2024-08-25 03:00:00,0.85,0.88,0.86,166,159,172,59,32,27,69,37,32,33,16,17,0,0,0,79%,83%,74%,108,110,106,30%,35%,25%,9,5,4,9,5,4
306,https://vlr.gg/player/21328/wo0t,2024-08-25 03:00:00,1.07,0.91,0.98,207,221,200,73,34,39,80,36,44,39,26,13,0,+1,-1,74%,78%,71%,137,147,129,34%,36%,32%,7,3,4,7,2,5
307,https://vlr.gg/player/10971/riens,2024-08-25 03:00:00,0.97,0.98,0.97,182,170,194,64,28,36,73,33,40,29,15,14,-2,0,-2,76%,80%,72%,124,114,131,40%,40%,41%,9,4,5,11,4,7
308,https://vlr.gg/player/18350/miniboo,2024-08-25 03:00:00,0.92,0.90,0.91,195,203,190,71,32,39,80,35,45,18,11,7,-4,-1,-3,65%,67%,64%,124,130,120,26%,27%,26%,11,6,5,15,7,8
309,https://vlr.gg/player/29873/benjyfishy,2024-08-25 03:00:00,1.10,0.75,0.90,200,244,169,72,40,32,79,34,45,24,12,12,-2,+1,-3,66%,78%,57%,134,161,113,39%,41%,37%,16,8,8,18,7,11
310,https://vlr.gg/player/1144/boo,2024-08-25 03:00:00,0.99,0.57,0.76,148,187,124,58,34,24,78,34,44,31,21,10,+4,+1,+3,67%,80%,57%,91,105,79,28%,32%,24%,7,3,4,3,2,1
311,https://vlr.gg/player/8549/kingg,2024-08-24 03:00:00,1.09,0.84,0.96,169,173,166,55,27,28,58,26,32,31,20,11,-3,-1,-2,71%,76%,66%,110,104,116,36%,38%,34%,5,2,3,8,3,5
312,https://vlr.gg/player/7603/mazino,2024-08-24 03:00:00,0.93,0.97,0.95,182,167,204,54,25,29,63,28,35,44,22,22,+3,+1,+2,69%,71%,66%,117,103,130,23%,22%,24%,11,4,7,8,3,5
313,https://vlr.gg/player/8480/aspas,2024-08-24 03:00:00,0.96,0.85,0.90,180,215,154,56,32,24,63,32,31,15,10,5,+2,+3,-1,69%,79%,59%,122,138,107,23%,24%,22%,12,9,3,10,6,4
314,https://vlr.gg/player/619/c0m,2024-08-24 03:00:00,0.99,0.70,0.84,171,186,166,51,29,22,58,26,32,19,8,11,-1,+1,-2,72%,79%,66%,120,120,121,31%,25%,39%,3,2,1,4,1,3
315,https://vlr.gg/player/1818/tex,2024-08-24 03:00:00,0.87,0.72,0.79,189,198,189,57,29,28,69,32,37,19,8,11,+3,+2,+1,65%,69%,61%,126,131,120,35%,39%,32%,14,7,7,11,5,6
316,https://vlr.gg/player/10971/riens,2024-08-24 03:00:00,1.07,1.38,1.22,227,215,240,68,33,35,54,26,28,36,19,17,-9,-5,-4,76%,70%,81%,156,146,167,37%,36%,39%,7,4,3,16,9,7
317,https://vlr.gg/player/18350/miniboo,2024-08-24 03:00:00,1.38,0.88,1.13,229,276,170,66,42,24,59,30,29,18,8,10,+7,+10,-3,73%,80%,67%,149,175,121,31%,30%,31%,17,13,4,10,3,7
318,https://vlr.gg/player/1144/boo,2024-08-24 03:00:00,1.24,0.92,1.08,185,187,171,59,33,26,50,22,28,18,14,4,+2,+3,-1,80%,91%,69%,120,126,113,36%,37%,34%,7,3,4,5,0,5
319,https://vlr.gg/player/21328/wo0t,2024-08-24 03:00:00,1.23,0.89,1.07,189,210,176,57,34,23,56,29,27,53,30,23,-4,-3,-1,80%,86%,74%,126,137,115,39%,43%,35%,5,2,3,9,5,4
320,https://vlr.gg/player/29873/benjyfishy,2024-08-24 03:00:00,0.91,1.12,1.01,190,155,227,60,25,35,54,24,30,15,10,5,0,-3,+3,77%,77%,76%,128,108,148,37%,37%,38%,5,1,4,5,4,1
321,https://vlr.gg/player/1144/boo,2024-08-23 06:45:00,0.84,1.35,1.09,189,179,203,41,19,22,39,25,14,36,16,20,+2,-1,+3,79%,78%,81%,120,117,123,31%,35%,27%,7,3,4,5,4,1
322,https://vlr.gg/player/10971/riens,2024-08-23 06:45:00,1.03,1.07,1.05,228,212,241,50,26,24,42,21,21,15,6,9,+2,+2,0,71%,72%,71%,151,135,167,37%,43%,33%,7,4,3,5,2,3
323,https://vlr.gg/player/18350/miniboo,2024-08-23 06:45:00,1.02,1.08,1.05,215,235,195,48,24,24,43,24,19,8,5,3,+4,+3,+1,75%,72%,77%,142,156,127,33%,28%,40%,11,6,5,7,3,4
324,https://vlr.gg/player/21328/wo0t,2024-08-23 06:45:00,1.12,0.87,1.00,177,203,150,39,22,17,37,19,18,14,7,7,+1,0,+1,67%,56%,77%,116,136,96,38%,30%,55%,6,3,3,5,3,2
325,https://vlr.gg/player/29873/benjyfishy,2024-08-23 06:45:00,0.45,1.21,0.83,177,107,250,42,12,30,45,25,20,5,2,3,-2,-4,+2,60%,47%,74%,113,69,159,38%,34%,39%,4,0,4,6,4,2
326,https://vlr.gg/player/9/tenz,2024-08-23 06:45:00,1.35,1.40,1.38,246,240,251,55,27,28,40,21,19,28,9,19,0,-2,+2,68%,58%,78%,161,158,163,30%,32%,29%,6,0,6,6,2,4
327,https://vlr.gg/player/4004/zekken,2024-08-23 06:45:00,0.74,1.57,1.16,252,204,295,58,22,36,47,27,20,12,4,8,-4,-6,+2,67%,58%,75%,163,123,201,27%,23%,30%,10,5,5,14,11,3
328,https://vlr.gg/player/729/zellsis,2024-08-23 06:45:00,0.82,1.09,0.96,180,140,224,39,14,25,46,22,24,25,11,14,-3,-2,-1,75%,74%,75%,118,92,144,32%,35%,30%,3,1,2,6,3,3
329,https://vlr.gg/player/1265/johnqt,2024-08-23 06:45:00,0.82,0.71,0.76,137,163,113,27,16,11,41,23,18,17,8,9,0,+1,-1,67%,65%,69%,95,115,77,27%,28%,25%,5,3,2,5,2,3
330,https://vlr.gg/player/659/sacy,2024-08-23 06:45:00,0.65,0.85,0.75,152,135,170,27,13,14,46,24,22,19,7,12,0,+2,-2,60%,55%,66%,110,97,122,24%,29%,22%,4,3,1,4,1,3
331,https://vlr.gg/player/15559/chichoo,2024-08-23 03:00:00,1.22,1.45,1.32,226,224,223,59,29,30,40,25,15,17,11,6,+4,+2,+2,75%,74%,75%,145,146,143,24%,23%,26%,6,4,2,2,2,0
332,https://vlr.gg/player/4742/smoggy,2024-08-23 03:00:00,0.97,1.33,1.13,235,197,261,58,28,30,48,28,20,23,13,10,-1,-3,+2,77%,74%,81%,146,122,174,25%,29%,23%,5,0,5,6,3,3
333,https://vlr.gg/player/3520/zmjjkk,2024-08-23 03:00:00,0.74,1.37,1.02,241,212,281,61,26,35,56,35,21,11,8,3,+10,+5,+5,69%,62%,78%,149,138,163,18%,20%,16%,20,11,9,10,6,4
334,https://vlr.gg/player/3017/nobody,2024-08-23 03:00:00,0.88,1.05,0.96,169,156,200,44,23,21,42,25,17,19,7,12,-3,-3,0,72%,62%,84%,120,101,144,30%,38%,25%,6,4,2,9,7,2
335,https://vlr.gg/player/13768/s1mon,2024-08-23 03:00:00,0.71,0.85,0.77,160,124,186,33,14,19,51,29,22,46,26,20,+3,+2,+1,76%,74%,78%,96,83,113,26%,30%,23%,5,2,3,2,0,2
336,https://vlr.gg/player/7603/mazino,2024-08-23 03:00:00,0.76,1.35,1.08,224,164,272,57,20,37,53,28,25,23,6,17,-4,-3,-1,68%,59%,74%,147,101,185,25%,24%,26%,4,0,4,8,3,5
337,https://vlr.gg/player/8480/aspas,2024-08-23 03:00:00,0.90,1.21,1.07,219,224,216,53,25,28,49,27,22,11,3,8,+3,+3,0,69%,56%,79%,149,143,154,24%,25%,24%,13,7,6,10,4,6
338,https://vlr.gg/player/1818/tex,2024-08-23 03:00:00,0.75,1.11,0.95,203,175,211,50,19,31,52,26,26,7,1,6,-8,-4,-4,68%,63%,72%,128,116,138,43%,37%,47%,5,3,2,13,7,6
339,https://vlr.gg/player/619/c0m,2024-08-23 03:00:00,0.76,1.06,0.92,182,176,193,42,16,26,52,27,25,21,9,12,-2,-5,+3,70%,66%,74%,129,134,124,25%,26%,23%,4,0,4,6,5,1
340,https://vlr.gg/player/8549/kingg,2024-08-23 03:00:00,0.73,0.97,0.86,151,156,159,35,15,20,49,27,22,35,17,18,-2,-1,-1,72%,59%,82%,107,103,110,25%,21%,29%,3,1,2,5,2,3
341,https://vlr.gg/player/18350/miniboo,2024-08-18 07:25:00,1.27,1.46,1.39,260,234,280,59,20,39,40,14,26,11,7,4,+1,-2,+3,81%,83%,81%,165,152,173,25%,27%,23%,11,3,8,10,5,5
342,https://vlr.gg/player/10971/riens,2024-08-18 07:25:00,1.72,0.76,1.13,206,291,160,44,25,19,39,11,28,23,7,16,+2,+2,0,75%,87%,67%,141,182,114,42%,51%,34%,5,3,2,3,1,2
343,https://vlr.gg/player/21328/wo0t,2024-08-18 07:25:00,0.73,1.20,1.02,202,145,246,42,12,30,41,15,26,27,8,19,+4,+1,+3,80%,78%,81%,129,83,158,28%,33%,26%,8,2,6,4,1,3
344,https://vlr.gg/player/1144/boo,2024-08-18 07:25:00,1.26,0.83,1.00,200,225,174,39,18,21,44,16,28,30,17,13,+4,+4,0,68%,83%,58%,119,139,105,34%,38%,31%,8,5,3,4,1,3
345,https://vlr.gg/player/29873/benjyfishy,2024-08-18 07:25:00,0.83,0.91,0.86,150,124,174,33,11,22,37,13,24,11,1,10,-4,0,-4,69%,65%,72%,104,79,121,30%,15%,38%,1,1,0,5,1,4
346,https://vlr.gg/player/4462/mako,2024-08-18 07:25:00,1.18,1.21,1.19,244,262,221,52,33,19,43,27,16,22,11,11,-3,-1,-2,78%,81%,74%,150,162,132,31%,28%,36%,3,3,0,6,4,2
347,https://vlr.gg/player/11600/foxy9,2024-08-18 07:25:00,1.12,0.69,0.95,190,200,171,38,26,12,43,25,18,27,21,6,-1,-1,0,75%,81%,65%,112,118,103,25%,23%,29%,3,1,2,4,2,2
348,https://vlr.gg/player/35013/flashback,2024-08-18 07:25:00,0.79,1.10,0.91,192,170,221,40,21,19,45,27,18,13,8,5,+1,-2,+3,69%,72%,65%,133,122,150,39%,39%,39%,5,2,3,4,4,0
349,https://vlr.gg/player/4678/beyn,2024-08-18 07:25:00,0.96,0.71,0.87,162,181,129,32,23,9,41,24,17,17,12,5,-2,+1,-3,71%,81%,57%,111,118,99,30%,34%,24%,4,2,2,6,1,5
350,https://vlr.gg/player/804/buzz,2024-08-18 07:25:00,0.85,0.49,0.71,180,235,101,38,30,8,46,28,18,10,9,1,-2,+1,-3,66%,69%,61%,116,143,73,25%,27%,14%,11,9,2,13,8,5
351,https://vlr.gg/player/1265/johnqt,2024-08-18 04:00:00,1.19,1.22,1.20,223,234,212,55,30,25,37,22,15,14,13,1,+4,+4,0,80%,86%,72%,145,150,140,24%,23%,24%,7,6,1,3,2,1
352,https://vlr.gg/player/4004/zekken,2024-08-18 04:00:00,0.95,1.21,1.06,245,240,245,54,31,23,49,29,20,19,7,12,-4,+2,-6,68%,69%,66%,157,156,159,20%,22%,17%,12,9,3,16,7,9
353,https://vlr.gg/player/659/sacy,2024-08-18 04:00:00,0.86,0.95,0.90,178,188,173,40,24,16,46,27,19,24,13,11,-1,0,-1,74%,78%,69%,118,127,107,25%,33%,17%,5,2,3,6,2,4
354,https://vlr.gg/player/729/zellsis,2024-08-18 04:00:00,1.00,0.68,0.86,160,191,119,36,25,11,44,24,20,30,16,14,-2,-1,-1,72%,78%,66%,101,124,73,25%,30%,20%,2,2,0,4,3,1
355,https://vlr.gg/player/9/tenz,2024-08-18 04:00:00,0.99,0.49,0.76,153,185,111,33,25,8,49,26,23,31,16,15,-4,-3,-1,71%,78%,62%,103,130,71,19%,21%,15%,3,0,3,7,3,4
356,https://vlr.gg/player/458/chronicle,2024-08-18 04:00:00,1.33,1.56,1.46,266,221,309,59,23,36,39,15,24,24,8,16,+5,+3,+2,78%,76%,81%,179,158,195,34%,29%,38%,10,5,5,5,2,3
357,https://vlr.gg/player/5022/derke,2024-08-18 04:00:00,1.23,1.14,1.18,258,263,253,61,28,33,47,19,28,10,5,5,+2,-1,+3,69%,72%,67%,173,183,166,23%,23%,22%,11,4,7,9,5,4
358,https://vlr.gg/player/9810/alfajer,2024-08-18 04:00:00,0.98,1.06,1.03,182,167,198,43,17,26,44,16,28,20,10,10,+4,+5,-1,80%,76%,83%,127,105,145,36%,38%,35%,7,5,2,3,0,3
359,https://vlr.gg/player/29867/hiro,2024-08-18 04:00:00,0.86,0.77,0.80,159,133,178,35,13,22,46,17,29,18,8,10,0,+1,-1,60%,59%,61%,100,89,110,27%,19%,32%,3,2,1,3,1,2
360,https://vlr.gg/player/438/boaster,2024-08-18 04:00:00,0.97,0.50,0.71,123,161,94,27,16,11,42,16,26,17,6,11,-4,+1,-5,66%,69%,64%,78,106,55,25%,31%,19%,5,3,2,9,2,7
361,https://vlr.gg/player/8480/aspas,2024-08-17 07:15:00,1.15,1.46,1.30,274,258,279,52,25,27,38,18,20,6,3,3,+2,+3,-1,84%,92%,77%,169,154,184,22%,24%,21%,7,4,3,5,1,4
362,https://vlr.gg/player/7603/mazino,2024-08-17 07:15:00,1.20,0.86,1.03,206,241,171,38,23,15,34,14,20,14,8,6,+3,+2,+1,69%,80%,58%,137,149,124,30%,34%,25%,5,3,2,2,1,1
363,https://vlr.gg/player/8549/kingg,2024-08-17 07:15:00,1.17,0.89,1.03,175,181,173,31,15,16,34,13,21,19,12,7,+2,+1,+1,78%,80%,77%,111,117,104,22%,22%,22%,4,2,2,2,1,1
364,https://vlr.gg/player/1818/tex,2024-08-17 07:15:00,1.29,0.70,0.99,203,240,178,35,21,14,34,13,21,9,4,5,+3,+5,-2,75%,84%,65%,144,169,120,29%,25%,35%,10,7,3,7,2,5
365,https://vlr.gg/player/619/c0m,2024-08-17 07:15:00,1.19,0.65,0.91,180,213,150,30,19,11,37,15,22,22,11,11,-1,0,-1,69%,76%,62%,130,152,108,27%,31%,24%,4,2,2,5,2,3
366,https://vlr.gg/player/1144/boo,2024-08-17 07:15:00,1.11,1.04,1.08,178,172,197,33,17,16,32,14,18,13,7,6,+1,+2,-1,71%,81%,60%,127,116,139,43%,45%,41%,4,2,2,3,0,3
367,https://vlr.gg/player/29873/benjyfishy,2024-08-17 07:15:00,1.24,0.86,1.05,222,250,193,43,26,17,35,16,19,2,0,2,0,+5,-5,67%,73%,60%,138,150,125,36%,38%,34%,7,6,1,7,1,6
368,https://vlr.gg/player/18350/miniboo,2024-08-17 07:15:00,1.05,0.98,1.01,227,258,200,42,25,17,41,19,22,7,4,3,+1,+1,0,71%,85%,56%,156,177,135,37%,33%,41%,7,5,2,6,4,2
369,https://vlr.gg/player/10971/riens,2024-08-17 07:15:00,1.22,0.69,0.96,193,201,187,35,20,15,37,14,23,11,7,4,-3,-3,0,75%,85%,64%,133,138,127,39%,42%,35%,2,0,2,5,3,2
370,https://vlr.gg/player/21328/wo0t,2024-08-17 07:15:00,0.75,0.36,0.56,145,193,96,24,16,8,41,20,21,19,14,5,-8,-3,-5,69%,88%,48%,104,134,72,28%,30%,23%,1,1,0,9,4,5
371,https://vlr.gg/player/4004/zekken,2024-08-17 04:00:00,1.05,1.14,1.10,276,289,267,59,28,31,52,26,26,18,9,9,+5,+3,+2,73%,86%,62%,172,174,170,22%,22%,22%,16,8,8,11,5,6
372,https://vlr.gg/player/9/tenz,2024-08-17 04:00:00,1.37,0.86,1.09,246,304,192,55,34,21,48,20,28,24,10,14,-1,-1,0,76%,79%,74%,166,207,131,34%,34%,34%,3,1,2,4,2,2
373,https://vlr.gg/player/1265/johnqt,2024-08-17 04:00:00,1.10,0.96,1.02,170,180,165,41,19,22,39,15,24,17,9,8,-4,-4,0,76%,86%,68%,112,128,98,30%,26%,36%,3,1,2,7,5,2
374,https://vlr.gg/player/659/sacy,2024-08-17 04:00:00,0.80,1.16,0.99,177,128,226,38,13,25,43,18,25,25,7,18,-1,-2,+1,76%,76%,76%,118,83,148,25%,30%,23%,3,1,2,4,3,1
375,https://vlr.gg/player/729/zellsis,2024-08-17 04:00:00,1.10,0.67,0.87,152,187,125,31,17,14,45,19,26,27,19,8,-4,-1,-3,67%,72%,62%,106,133,82,28%,33%,24%,4,1,3,8,2,6
376,https://vlr.gg/player/13768/s1mon,2024-08-17 04:00:00,1.31,0.91,1.12,174,190,162,39,23,16,42,20,22,40,22,18,+4,+3,+1,81%,88%,72%,121,131,108,35%,35%,34%,6,4,2,2,1,1
377,https://vlr.gg/player/15559/chichoo,2024-08-17 04:00:00,0.99,1.27,1.11,232,198,262,49,23,26,44,23,21,23,12,11,+3,0,+3,73%,68%,79%,150,128,176,23%,24%,23%,7,3,4,4,3,1
378,https://vlr.gg/player/3017/nobody,2024-08-17 04:00:00,1.01,1.12,1.06,203,187,217,49,26,23,43,22,21,12,6,6,0,0,0,71%,79%,62%,120,115,126,34%,42%,28%,5,3,2,5,3,2
379,https://vlr.gg/player/3520/zmjjkk,2024-08-17 04:00:00,0.94,1.02,0.97,233,246,219,51,30,21,47,24,23,18,6,12,0,-1,+1,71%,62%,83%,148,148,148,29%,31%,27%,14,6,8,14,7,7
380,https://vlr.gg/player/4742/smoggy,2024-08-17 04:00:00,1.15,0.55,0.87,176,227,121,39,27,12,48,24,24,27,17,10,-2,-2,0,68%,68%,69%,115,146,79,23%,25%,18%,2,1,1,4,3,1
381,https://vlr.gg/player/3885/valyn,2024-08-16 05:50:00,0.93,0.89,0.92,167,174,164,22,14,8,28,16,12,17,8,9,0,+1,-1,73%,71%,75%,108,110,105,27%,23%,34%,3,3,0,3,2,1
382,https://vlr.gg/player/15500/trent,2024-08-16 05:50:00,0.91,0.83,0.88,193,184,203,23,12,11,32,17,15,13,9,4,-1,0,-1,65%,67%,63%,133,139,123,20%,23%,17%,3,2,1,4,2,2
383,https://vlr.gg/player/7873/leaf,2024-08-16 05:50:00,0.89,0.52,0.74,176,193,159,25,17,8,33,18,15,6,3,3,-4,-1,-3,58%,67%,44%,112,120,101,21%,24%,16%,5,3,2,9,4,5
384,https://vlr.gg/player/4581/jonahp,2024-08-16 05:50:00,0.85,0.50,0.71,160,172,127,24,16,8,34,19,15,7,4,3,0,-1,+1,58%,54%,63%,93,105,75,24%,25%,23%,2,0,2,2,1,1
385,https://vlr.gg/player/8402/icy,2024-08-16 05:50:00,0.53,0.87,0.67,130,129,160,18,9,9,33,20,13,8,4,4,-1,-3,+2,55%,54%,56%,108,101,119,30%,29%,31%,4,2,2,5,5,0
386,https://vlr.gg/player/9810/alfajer,2024-08-16 05:50:00,1.12,1.76,1.50,315,237,337,44,15,29,23,10,13,5,2,3,+9,+3,+6,73%,69%,75%,190,155,214,34%,37%,33%,10,4,6,1,1,0
387,https://vlr.gg/player/458/chronicle,2024-08-16 05:50:00,1.77,1.09,1.36,237,349,176,36,21,15,21,8,13,8,2,6,+2,+1,+1,80%,88%,75%,154,210,116,20%,21%,19%,6,2,4,4,1,3
388,https://vlr.gg/player/5022/derke,2024-08-16 05:50:00,1.55,1.16,1.31,265,332,227,41,21,20,23,9,14,3,0,3,+1,+1,0,78%,88%,71%,178,205,160,31%,29%,33%,5,2,3,4,1,3
389,https://vlr.gg/player/29867/hiro,2024-08-16 05:50:00,0.84,1.20,1.05,208,146,228,27,8,19,22,8,14,12,6,6,0,-1,+1,78%,75%,79%,134,93,162,20%,40%,15%,2,1,1,2,2,0
390,https://vlr.gg/player/438/boaster,2024-08-16 05:50:00,0.66,0.46,0.54,82,110,73,12,5,7,23,9,14,16,11,5,-6,-2,-4,68%,81%,58%,54,72,42,18%,25%,12%,0,0,0,6,2,4
391,https://vlr.gg/player/4678/beyn,2024-08-16 04:00:00,1.33,1.75,1.53,247,207,296,33,15,18,17,9,8,15,9,6,0,0,0,88%,89%,88%,152,111,199,24%,23%,26%,1,0,1,1,0,1
392,https://vlr.gg/player/804/buzz,2024-08-16 04:00:00,1.04,1.60,1.30,305,266,342,37,17,20,26,14,12,6,3,3,+3,0,+3,82%,83%,81%,183,164,205,27%,37%,16%,10,4,6,7,4,3
393,https://vlr.gg/player/35013/flashback,2024-08-16 04:00:00,1.61,0.78,1.22,204,266,131,25,18,7,17,7,10,13,7,6,+2,+1,+1,91%,94%,88%,134,179,83,40%,41%,37%,4,2,2,2,1,1
394,https://vlr.gg/player/4462/mako,2024-08-16 04:00:00,1.24,0.70,0.99,139,159,118,16,11,5,18,7,11,20,8,12,-2,0,-2,79%,94%,63%,90,106,72,29%,32%,24%,1,1,0,3,1,2
395,https://vlr.gg/player/11600/foxy9,2024-08-16 04:00:00,1.09,0.88,0.99,194,213,180,24,14,10,21,10,11,13,8,5,-3,-3,0,74%,78%,69%,144,145,142,29%,18%,44%,1,1,0,4,4,0
396,https://vlr.gg/player/4770/fengf,2024-08-16 04:00:00,1.00,1.02,1.01,227,183,262,26,10,16,26,11,15,4,3,1,+5,+1,+4,71%,63%,78%,145,119,168,38%,36%,40%,8,2,6,3,1,2
397,https://vlr.gg/player/3045/luok1ng,2024-08-16 04:00:00,1.61,0.27,0.90,181,302,80,21,17,4,25,10,15,16,7,9,-1,+1,-2,65%,88%,44%,127,192,70,27%,34%,14%,1,1,0,2,0,2
398,https://vlr.gg/player/37494/kai,2024-08-16 04:00:00,1.24,0.50,0.85,196,311,103,23,18,5,28,13,15,4,0,4,-3,0,-3,65%,75%,56%,132,188,82,16%,17%,16%,3,3,0,6,3,3
399,https://vlr.gg/player/4712/heybay,2024-08-16 04:00:00,0.46,0.89,0.69,136,106,167,13,4,9,29,13,16,20,9,11,0,-1,+1,65%,69%,61%,101,79,120,19%,24%,16%,3,1,2,3,2,1
400,https://vlr.gg/player/3021/biank,2024-08-16 04:00:00,0.30,0.86,0.55,142,58,213,16,3,13,27,13,14,5,4,1,-1,-3,+2,62%,56%,67%,89,33,138,22%,20%,23%,2,0,2,3,3,0
401,https://vlr.gg/player/10971/riens,2024-08-15 06:35:00,1.42,1.34,1.37,261,272,263,40,17,23,25,10,15,10,5,5,+4,+2,+2,79%,76%,80%,177,179,176,43%,48%,39%,6,2,4,2,0,2
402,https://vlr.gg/player/21328/wo0t,2024-08-15 06:35:00,1.25,1.09,1.16,191,190,153,28,13,15,22,9,13,9,4,5,0,+1,-1,81%,88%,76%,117,127,110,55%,76%,41%,2,2,0,2,1,1
403,https://vlr.gg/player/29873/benjyfishy,2024-08-15 06:35:00,1.17,0.96,1.05,186,216,174,30,12,18,26,11,15,5,3,2,-1,+2,-3,71%,76%,68%,125,157,103,32%,26%,38%,3,2,1,4,0,4
404,https://vlr.gg/player/1144/boo,2024-08-15 06:35:00,1.12,0.73,0.88,162,161,153,22,11,11,27,9,18,17,10,7,+1,-1,+2,76%,88%,68%,104,111,99,21%,23%,20%,3,0,3,2,1,1
405,https://vlr.gg/player/18350/miniboo,2024-08-15 06:35:00,0.96,0.80,0.86,186,187,180,27,12,15,29,11,18,7,2,5,-3,-1,-2,67%,65%,68%,120,123,118,32%,38%,27%,7,4,3,10,5,5
406,https://vlr.gg/player/5022/derke,2024-08-15 06:35:00,1.47,1.00,1.25,276,321,227,41,29,12,34,21,13,7,3,4,+6,+4,+2,67%,76%,53%,181,205,145,31%,31%,30%,12,7,5,6,3,3
407,https://vlr.gg/player/29867/hiro,2024-08-15 06:35:00,0.85,1.35,1.05,177,126,277,28,11,17,26,12,14,14,8,6,-5,-1,-4,74%,72%,76%,121,79,184,30%,26%,33%,1,1,0,6,2,4
408,https://vlr.gg/player/458/chronicle,2024-08-15 06:35:00,1.20,0.66,0.98,185,229,144,28,20,8,31,18,13,8,3,5,+4,+3,+1,74%,72%,76%,134,160,96,24%,21%,33%,6,4,2,2,1,1
409,https://vlr.gg/player/9810/alfajer,2024-08-15 06:35:00,0.85,0.67,0.77,134,141,146,22,14,8,30,17,13,4,1,3,-1,-1,0,64%,60%,71%,116,111,123,37%,43%,30%,0,0,0,1,1,0
410,https://vlr.gg/player/438/boaster,2024-08-15 06:35:00,0.42,0.19,0.31,73,81,58,9,6,3,31,18,13,12,7,5,-5,-2,-3,64%,68%,59%,45,53,33,26%,29%,18%,2,2,0,7,4,3
411,https://vlr.gg/player/7873/leaf,2024-08-15 04:00:00,1.17,0.86,1.04,217,254,196,38,25,13,38,22,16,8,1,7,+4,+3,+1,73%,70%,76%,147,153,138,24%,29%,18%,6,5,1,2,2,0
412,https://vlr.gg/player/4581/jonahp,2024-08-15 04:00:00,0.95,0.98,0.97,219,194,239,34,18,16,37,20,17,12,6,6,0,+2,-2,69%,78%,57%,131,116,151,27%,29%,25%,7,5,2,7,3,4
413,https://vlr.gg/player/15500/trent,2024-08-15 04:00:00,0.92,0.90,0.91,198,217,182,29,16,13,37,22,15,16,13,3,-2,-2,0,69%,74%,62%,137,149,123,35%,33%,39%,3,1,2,5,3,2
414,https://vlr.gg/player/3885/valyn,2024-08-15 04:00:00,0.97,0.48,0.75,171,208,149,33,22,11,41,22,19,9,8,1,-1,-2,+1,67%,70%,62%,106,122,86,26%,29%,22%,2,0,2,3,2,1
415,https://vlr.gg/player/8402/icy,2024-08-15 04:00:00,0.69,0.71,0.70,152,132,180,24,13,11,38,20,18,13,5,8,-2,-1,-1,71%,70%,71%,100,90,113,35%,38%,32%,6,3,3,8,4,4
416,https://vlr.gg/player/619/c0m,2024-08-15 04:00:00,1.33,1.43,1.39,264,229,275,42,17,25,26,11,15,10,5,5,+2,+1,+1,79%,81%,78%,177,161,190,29%,22%,35%,7,4,3,5,3,2
417,https://vlr.gg/player/8480/aspas,2024-08-15 04:00:00,1.27,1.22,1.24,214,247,179,38,18,20,26,13,13,6,4,2,-1,+1,-2,81%,76%,85%,140,172,115,38%,39%,36%,1,1,0,2,0,2
418,https://vlr.gg/player/8549/kingg,2024-08-15 04:00:00,1.05,1.03,1.04,216,141,251,36,12,24,30,10,20,14,5,9,+5,+1,+4,73%,81%,67%,134,107,154,37%,44%,34%,5,1,4,0,0,0
419,https://vlr.gg/player/7603/mazino,2024-08-15 04:00:00,1.25,0.67,0.92,217,256,179,39,21,18,38,15,23,15,8,7,-2,-2,0,73%,86%,63%,132,167,105,27%,22%,35%,4,0,4,6,2,4
420,https://vlr.gg/player/1818/tex,2024-08-15 04:00:00,0.93,0.55,0.69,166,216,162,31,17,14,38,15,23,8,2,6,-3,+1,-4,65%,62%,67%,130,143,120,24%,27%,21%,7,5,2,10,4,6
421,https://vlr.gg/player/37494/kai,2024-08-14 06:25:00,1.22,1.00,1.10,209,246,181,32,18,14,29,15,14,6,3,3,+1,+1,0,74%,75%,74%,144,169,122,36%,49%,26%,6,4,2,5,3,2
422,https://vlr.gg/player/3045/luok1ng,2024-08-14 06:25:00,0.99,0.90,0.94,168,195,144,27,14,13,28,14,14,13,7,6,0,0,0,67%,70%,65%,113,126,102,25%,27%,22%,2,0,2,2,0,2
423,https://vlr.gg/player/4770/fengf,2024-08-14 06:25:00,0.87,0.75,0.81,165,204,131,25,14,11,31,14,17,5,1,4,-6,-5,-1,60%,50%,70%,109,129,91,19%,26%,12%,2,1,1,8,6,2
424,https://vlr.gg/player/3021/biank,2024-08-14 06:25:00,0.64,0.84,0.75,152,116,189,22,8,14,31,14,17,13,7,6,+1,-1,+2,58%,65%,52%,98,69,122,26%,24%,28%,4,1,3,3,2,1
425,https://vlr.gg/player/4712/heybay,2024-08-14 06:25:00,0.57,0.85,0.72,174,143,206,26,9,17,35,17,18,13,6,7,-3,-1,-2,70%,75%,65%,107,89,123,29%,24%,33%,4,1,3,7,2,5
426,https://vlr.gg/player/3520/zmjjkk,2024-08-14 06:25:00,1.54,1.30,1.42,309,321,300,47,27,20,31,16,15,4,3,1,+5,+1,+4,63%,70%,55%,209,223,192,27%,35%,19%,13,7,6,8,6,2
427,https://vlr.gg/player/3017/nobody,2024-08-14 06:25:00,1.22,1.24,1.23,252,220,281,37,18,19,28,13,15,15,7,8,+1,0,+1,72%,78%,65%,168,148,190,48%,47%,49%,4,2,2,3,2,1
428,https://vlr.gg/player/15559/chichoo,2024-08-14 06:25:00,0.81,1.53,1.15,193,132,273,31,10,21,27,14,13,10,3,7,+1,-1,+2,63%,57%,70%,121,84,164,29%,30%,29%,5,2,3,4,3,1
429,https://vlr.gg/player/4742/smoggy,2024-08-14 06:25:00,1.29,0.80,1.06,179,226,114,25,17,8,23,13,10,19,13,6,+1,+1,0,70%,65%,75%,102,135,64,27%,25%,29%,2,1,1,1,0,1
430,https://vlr.gg/player/13768/s1mon,2024-08-14 06:25:00,0.85,0.80,0.83,100,116,89,14,8,6,23,13,10,22,15,7,-1,0,-1,77%,87%,65%,72,69,75,22%,17%,29%,1,0,1,2,0,2
431,https://vlr.gg/player/35013/flashback,2024-08-14 04:00:00,1.04,1.16,1.10,228,204,248,39,17,22,34,17,17,7,1,6,+5,+1,+4,69%,70%,69%,151,131,169,28%,25%,30%,7,2,5,2,1,1
432,https://vlr.gg/player/11600/foxy9,2024-08-14 04:00:00,0.96,1.04,1.00,173,177,182,31,14,17,32,16,16,23,10,13,-1,-1,0,73%,74%,73%,109,103,115,27%,24%,29%,1,0,1,2,1,1
433,https://vlr.gg/player/4462/mako,2024-08-14 04:00:00,0.82,0.93,0.88,197,166,216,30,13,17,37,17,20,21,6,15,+1,-1,+2,78%,74%,81%,123,101,143,22%,18%,25%,5,1,4,4,2,2
434,https://vlr.gg/player/4678/beyn,2024-08-14 04:00:00,0.46,1.16,0.83,150,95,204,28,7,21,36,18,18,9,4,5,-4,-2,-2,69%,57%,81%,99,72,123,23%,28%,20%,1,1,0,5,3,2
435,https://vlr.gg/player/804/buzz,2024-08-14 04:00:00,0.60,0.96,0.79,206,192,216,33,14,19,39,19,20,10,2,8,-4,0,-4,57%,52%,62%,128,113,142,28%,35%,24%,9,6,3,13,6,7
436,https://vlr.gg/player/4004/zekken,2024-08-14 04:00:00,1.21,1.43,1.31,319,299,333,54,26,28,39,23,16,15,8,7,+8,+4,+4,82%,88%,74%,198,187,211,28%,27%,29%,14,9,5,6,5,1
437,https://vlr.gg/player/729/zellsis,2024-08-14 04:00:00,0.92,1.59,1.23,209,149,271,34,12,22,27,16,11,33,14,19,-2,-3,+1,80%,77%,83%,130,111,150,15%,11%,19%,2,0,2,4,3,1
438,https://vlr.gg/player/9/tenz,2024-08-14 04:00:00,1.09,1.05,1.07,204,241,166,36,22,14,34,21,13,21,13,8,-1,+1,-2,78%,81%,74%,134,150,115,23%,20%,30%,4,3,1,5,2,3
439,https://vlr.gg/player/659/sacy,2024-08-14 04:00:00,1.06,1.00,1.03,192,204,177,30,17,13,34,19,15,30,18,12,-1,0,-1,78%,77%,78%,127,132,121,25%,25%,26%,4,1,3,5,1,4
440,https://vlr.gg/player/1265/johnqt,2024-08-14 04:00:00,0.85,0.96,0.90,122,129,121,24,14,10,27,17,10,15,6,9,-1,-2,+1,73%,54%,96%,77,74,79,25%,24%,27%,2,0,2,3,2,1
441,https://vlr.gg/player/4742/smoggy,2024-08-11 06:15:00,1.10,1.80,1.44,265,200,329,52,20,32,31,17,14,17,7,10,+3,+3,0,76%,68%,85%,168,124,214,36%,34%,37%,6,3,3,3,0,3
442,https://vlr.gg/player/15559/chichoo,2024-08-11 06:15:00,1.43,1.18,1.31,228,238,217,44,23,21,33,15,18,21,11,10,+7,+5,+2,87%,89%,85%,152,160,143,29%,35%,23%,8,5,3,1,0,1
443,https://vlr.gg/player/13768/s1mon,2024-08-11 06:15:00,1.02,1.09,1.05,168,152,185,32,16,16,32,16,16,21,11,10,+5,+1,+4,78%,71%,85%,111,97,126,30%,42%,24%,5,1,4,0,0,0
444,https://vlr.gg/player/3017/nobody,2024-08-11 06:15:00,0.77,1.26,1.00,212,151,287,39,15,24,39,19,20,21,7,14,-2,-3,+1,67%,57%,77%,139,106,174,33%,32%,33%,4,1,3,6,4,2
445,https://vlr.gg/player/3520/zmjjkk,2024-08-11 06:15:00,0.85,0.81,0.82,198,234,173,38,21,17,42,24,18,14,9,5,+5,+4,+1,80%,75%,85%,131,144,118,32%,41%,20%,13,9,4,8,5,3
446,https://vlr.gg/player/9800/mindfreak,2024-08-11 06:15:00,1.01,0.95,0.98,201,229,186,37,20,17,41,23,18,19,8,11,+2,+2,0,74%,77%,71%,136,153,120,28%,30%,26%,4,2,2,2,0,2
447,https://vlr.gg/player/17086/something,2024-08-11 06:15:00,0.79,1.16,0.98,219,244,188,39,22,17,42,26,16,14,4,10,-2,-2,0,70%,69%,71%,136,148,124,28%,33%,24%,7,3,4,9,5,4
448,https://vlr.gg/player/9801/f0rsaken,2024-08-11 06:15:00,1.07,0.75,0.89,182,199,146,37,21,16,41,20,21,4,3,1,-6,-3,-3,56%,58%,54%,127,159,97,35%,35%,34%,2,1,1,8,4,4
449,https://vlr.gg/player/9803/d4v41,2024-08-11 06:15:00,0.72,1.01,0.87,161,146,184,32,12,20,39,20,19,18,10,8,-2,0,-2,70%,77%,64%,109,105,113,39%,28%,50%,3,2,1,5,2,3
450,https://vlr.gg/player/7378/jinggg,2024-08-11 06:15:00,0.52,1.09,0.81,194,134,250,32,11,21,42,21,21,19,10,9,-10,-5,-5,69%,69%,68%,130,86,171,13%,12%,14%,2,1,1,12,6,6
451,https://vlr.gg/player/8480/aspas,2024-08-11 04:00:00,0.87,1.56,1.27,217,190,239,36,12,24,26,15,11,8,4,4,+3,+1,+2,84%,78%,88%,147,127,162,39%,52%,33%,7,3,4,4,2,2
452,https://vlr.gg/player/8549/kingg,2024-08-11 04:00:00,0.83,1.40,1.16,199,173,229,34,11,23,26,13,13,8,4,4,+3,-1,+4,77%,72%,80%,134,124,141,37%,32%,41%,5,1,4,2,2,0
453,https://vlr.gg/player/7603/mazino,2024-08-11 04:00:00,1.25,1.07,1.15,229,247,205,33,16,17,30,13,17,17,2,15,-1,-3,+2,72%,61%,80%,145,162,133,29%,27%,32%,4,2,2,5,5,0
454,https://vlr.gg/player/619/c0m,2024-08-11 04:00:00,1.08,1.14,1.11,210,188,217,32,12,20,28,14,14,10,7,3,+3,+1,+2,74%,83%,68%,145,146,144,24%,21%,27%,4,1,3,1,0,1
455,https://vlr.gg/player/1818/tex,2024-08-11 04:00:00,0.85,0.84,0.84,218,190,221,31,13,18,36,15,21,11,5,6,+1,0,+1,65%,78%,56%,128,117,136,34%,35%,33%,6,1,5,5,1,4
456,https://vlr.gg/player/2168/trexx,2024-08-11 04:00:00,0.85,1.26,1.03,212,160,292,34,16,18,34,19,15,10,3,7,-2,-5,+3,65%,56%,78%,140,112,179,20%,28%,14%,3,0,3,5,5,0
457,https://vlr.gg/player/312/sayf,2024-08-11 04:00:00,0.92,1.14,1.02,226,215,225,34,18,16,31,19,12,4,3,1,-4,-1,-3,58%,56%,61%,137,136,138,25%,17%,46%,5,2,3,9,3,6
458,https://vlr.gg/player/11134/kicks,2024-08-11 04:00:00,0.66,1.23,0.90,164,144,219,26,12,14,33,21,12,16,9,7,0,0,0,70%,60%,83%,119,85,167,36%,42%,33%,3,2,1,3,2,1
459,https://vlr.gg/player/4321/cender,2024-08-11 04:00:00,0.77,0.77,0.77,170,192,159,27,16,11,33,21,12,13,9,4,-4,-5,+1,72%,76%,67%,116,120,111,31%,33%,28%,3,1,2,7,6,1
460,https://vlr.gg/player/21610/runner,2024-08-11 04:00:00,0.75,0.77,0.76,199,203,184,25,14,11,35,22,13,15,8,7,+1,0,+1,67%,64%,72%,133,145,117,18%,20%,15%,3,2,1,2,2,0
461,https://vlr.gg/player/5022/derke,2024-08-10 06:15:00,1.06,1.77,1.46,301,242,325,65,23,42,42,22,20,19,7,12,0,0,0,88%,86%,89%,190,167,207,21%,27%,18%,12,7,5,12,7,5
462,https://vlr.gg/player/458/chronicle,2024-08-10 06:15:00,1.40,1.16,1.26,240,228,257,49,22,27,40,14,26,24,7,17,+3,+1,+2,70%,68%,72%,172,172,172,28%,30%,26%,5,1,4,2,0,2
463,https://vlr.gg/player/29867/hiro,2024-08-10 06:15:00,0.96,1.06,1.01,207,207,205,50,21,29,44,19,25,12,7,5,+4,+3,+1,78%,71%,83%,127,120,133,29%,26%,31%,9,6,3,5,3,2
464,https://vlr.gg/player/9810/alfajer,2024-08-10 06:15:00,1.15,0.73,0.92,176,242,133,40,26,14,44,18,26,21,6,15,-7,-3,-4,70%,75%,67%,130,177,93,27%,26%,28%,1,0,1,8,3,5
465,https://vlr.gg/player/438/boaster,2024-08-10 06:15:00,1.08,0.72,0.88,157,169,154,38,17,21,41,15,26,21,12,9,+2,+1,+1,73%,82%,67%,96,103,90,26%,26%,25%,6,1,5,4,0,4
466,https://vlr.gg/player/2462/keznit,2024-08-10 06:15:00,1.08,1.04,1.06,237,260,209,50,31,19,51,29,22,21,11,10,0,0,0,75%,78%,71%,164,167,161,22%,20%,24%,7,6,1,7,6,1
467,https://vlr.gg/player/24007/shyy,2024-08-10 06:15:00,1.02,1.12,1.06,210,201,230,49,26,23,42,25,17,16,11,5,+1,0,+1,73%,67%,82%,139,128,153,29%,27%,32%,8,4,4,7,4,3
468,https://vlr.gg/player/8673/heat,2024-08-10 06:15:00,0.79,0.85,0.81,161,140,192,39,19,20,48,25,23,17,11,6,0,-1,+1,66%,64%,68%,101,91,114,33%,30%,36%,3,1,2,3,2,1
469,https://vlr.gg/player/1311/melser,2024-08-10 06:15:00,0.77,0.70,0.74,157,168,142,38,22,16,49,29,20,7,5,2,-4,0,-4,61%,58%,64%,101,114,85,38%,43%,32%,6,4,2,10,4,6
470,https://vlr.gg/player/36169/mta,2024-08-10 06:15:00,0.90,0.37,0.67,157,182,118,34,24,10,52,26,26,14,8,6,+1,+1,0,58%,61%,54%,100,114,83,36%,50%,21%,7,3,4,6,2,4
471,https://vlr.gg/player/9196/t3xture,2024-08-10 04:00:00,1.56,1.01,1.30,276,294,257,41,24,17,30,15,15,6,4,2,+1,+1,0,68%,68%,68%,169,184,152,27%,28%,25%,8,5,3,7,4,3
472,https://vlr.gg/player/2489/munchkin,2024-08-10 04:00:00,0.97,1.25,1.10,224,189,272,32,14,18,32,17,15,17,14,3,-2,-1,-1,76%,73%,79%,146,119,176,22%,19%,24%,3,0,3,5,1,4
473,https://vlr.gg/player/13039/meteor,2024-08-10 04:00:00,0.56,0.71,0.63,188,188,183,26,15,11,36,21,15,5,2,3,-1,-1,0,56%,59%,53%,125,123,127,33%,34%,32%,3,2,1,4,3,1
474,https://vlr.gg/player/34974/karon,2024-08-10 04:00:00,0.55,0.57,0.56,125,142,108,18,10,8,33,19,14,12,7,5,-1,0,-1,66%,68%,63%,88,97,78,28%,25%,32%,2,2,0,3,2,1
475,https://vlr.gg/player/773/lakia,2024-08-10 04:00:00,0.29,0.49,0.38,83,66,103,9,4,5,30,16,14,11,4,7,-2,-1,-1,71%,68%,74%,56,45,69,22%,17%,25%,2,1,1,4,2,2
476,https://vlr.gg/player/9/tenz,2024-08-10 04:00:00,0.96,1.64,1.32,227,142,292,34,11,23,25,12,13,25,11,14,0,0,0,83%,74%,91%,142,82,193,21%,42%,16%,2,0,2,2,0,2
477,https://vlr.gg/player/1265/johnqt,2024-08-10 04:00:00,1.48,0.99,1.22,174,225,132,26,15,11,22,10,12,20,9,11,+3,+3,0,83%,79%,86%,112,146,82,12%,9%,19%,4,3,1,1,0,1
478,https://vlr.gg/player/4004/zekken,2024-08-10 04:00:00,1.49,0.93,1.19,245,302,199,40,22,18,28,12,16,11,6,5,+4,+1,+3,73%,68%,77%,153,197,115,26%,34%,13%,9,4,5,5,3,2
479,https://vlr.gg/player/659/sacy,2024-08-10 04:00:00,0.99,1.31,1.17,215,174,243,28,11,17,27,13,14,19,4,15,-3,0,-3,78%,84%,73%,149,120,174,18%,23%,15%,3,2,1,6,2,4
480,https://vlr.gg/player/729/zellsis,2024-08-10 04:00:00,1.06,1.22,1.15,219,199,240,33,14,19,24,12,12,6,4,2,+1,-1,+2,80%,74%,86%,135,128,141,16%,25%,11%,5,2,3,4,3,1
481,https://vlr.gg/player/8369/yetujey,2024-08-09 06:25:00,1.07,1.31,1.18,242,209,281,36,18,18,31,16,15,4,2,2,+7,+4,+3,65%,67%,63%,156,130,189,33%,42%,28%,10,6,4,3,2,1
482,https://vlr.gg/player/573/cned,2024-08-09 06:25:00,0.70,1.51,1.06,234,179,313,35,14,21,34,19,15,6,2,4,+1,0,+1,63%,58%,68%,158,125,200,22%,29%,16%,4,2,2,3,2,1
483,https://vlr.gg/player/6510/atakaptan,2024-08-09 06:25:00,0.62,1.04,0.81,153,119,204,22,8,14,29,15,14,14,6,8,-5,-4,-1,58%,50%,68%,105,87,129,30%,26%,32%,2,0,2,7,4,3
484,https://vlr.gg/player/1139/qraxs,2024-08-09 06:25:00,0.70,0.84,0.76,138,152,133,22,13,9,32,19,13,11,5,6,-3,0,-3,65%,63%,68%,93,93,94,33%,41%,26%,2,2,0,5,2,3
485,https://vlr.gg/player/8044/mrfalin,2024-08-09 06:25:00,1.00,0.38,0.73,168,208,120,24,19,5,32,17,15,14,7,7,-3,-2,-1,67%,67%,68%,115,138,87,28%,31%,21%,2,1,1,5,3,2
486,https://vlr.gg/player/9803/d4v41,2024-08-09 06:25:00,1.09,1.36,1.24,222,198,237,34,14,20,27,12,15,10,5,5,+1,0,+1,77%,79%,75%,153,137,165,32%,23%,40%,2,0,2,1,0,1
487,https://vlr.gg/player/9800/mindfreak,2024-08-09 06:25:00,1.35,1.09,1.20,209,247,183,33,17,16,27,12,15,22,8,14,+1,0,+1,84%,89%,79%,137,163,117,37%,42%,33%,1,0,1,0,0,0
488,https://vlr.gg/player/7378/jinggg,2024-08-09 06:25:00,1.22,1.11,1.16,261,290,228,37,19,18,30,15,15,13,7,6,+2,+2,0,70%,74%,67%,158,178,142,23%,20%,27%,11,5,6,9,3,6
489,https://vlr.gg/player/17086/something,2024-08-09 06:25:00,0.60,1.27,0.98,194,167,217,29,11,18,29,16,13,16,4,12,-1,-2,+1,77%,68%,83%,133,110,150,33%,43%,27%,5,2,3,6,4,2
490,https://vlr.gg/player/9801/f0rsaken,2024-08-09 06:25:00,0.68,1.04,0.88,153,157,150,24,10,14,26,13,13,19,7,12,0,+1,-1,81%,84%,79%,103,102,104,39%,33%,45%,4,3,1,4,2,2
491,https://vlr.gg/player/25255/primmie,2024-08-09 04:00:00,1.03,1.22,1.14,237,211,258,35,13,22,30,13,17,8,3,5,+2,-1,+3,70%,69%,71%,156,146,163,34%,34%,35%,4,0,4,2,1,1
492,https://vlr.gg/player/5129/ban,2024-08-09 04:00:00,0.62,1.12,0.92,208,221,202,30,12,18,30,14,16,5,1,4,0,-1,+1,73%,69%,75%,138,147,131,40%,46%,35%,4,2,2,4,3,1
493,https://vlr.gg/player/13788/jitboys,2024-08-09 04:00:00,0.81,0.56,0.66,171,184,162,22,10,12,34,13,21,11,4,7,+4,+2,+2,73%,81%,67%,110,119,105,30%,31%,30%,4,2,2,0,0,0
494,https://vlr.gg/player/3980/governor,2024-08-09 04:00:00,0.23,0.92,0.63,173,111,213,22,6,16,33,15,18,8,2,6,-5,-5,0,60%,56%,63%,113,77,138,24%,32%,22%,5,1,4,10,6,4
495,https://vlr.gg/player/3977/crws,2024-08-09 04:00:00,0.74,0.37,0.52,138,161,126,18,9,9,33,13,20,10,5,5,-1,+1,-2,63%,69%,58%,90,96,86,27%,36%,22%,3,1,2,4,0,4
496,https://vlr.gg/player/11134/kicks,2024-08-09 04:00:00,1.42,1.83,1.58,273,231,332,40,20,20,23,12,11,23,12,11,+2,+1,+1,85%,83%,88%,163,141,197,26%,34%,19%,4,2,2,2,1,1
497,https://vlr.gg/player/312/sayf,2024-08-09 04:00:00,1.13,1.31,1.20,227,229,230,33,19,14,25,15,10,10,6,4,-1,0,-1,73%,67%,81%,155,149,164,25%,25%,25%,4,3,1,5,3,2
498,https://vlr.gg/player/2168/trexx,2024-08-09 04:00:00,1.42,0.61,1.10,209,266,115,28,25,3,26,15,11,20,10,10,0,+1,-1,83%,83%,81%,141,171,95,21%,22%,19%,2,2,0,2,1,1
499,https://vlr.gg/player/21610/runner,2024-08-09 04:00:00,0.94,1.27,1.07,216,201,247,31,18,13,27,17,10,7,0,7,+4,0,+4,75%,67%,88%,138,129,152,20%,18%,22%,7,2,5,3,2,1
500,https://vlr.gg/player/4321/cender,2024-08-09 04:00:00,0.52,1.66,0.97,192,138,273,28,10,18,26,18,8,16,10,6,-5,-6,+1,70%,54%,94%,117,89,161,25%,28%,23%,3,1,2,8,7,1
0,https://vlr.gg/player/4705/flex1n,2024-08-08 06:10:00,1.26,1.09,1.19,227,238,205,32,21,11,30,18,12,12,10,2,+1,+1,0,79%,88%,67%,159,157,161,40%,45%,32%,5,4,1,4,3,1
1,https://vlr.gg/player/4774/knight,2024-08-08 06:10:00,0.73,0.87,0.78,142,146,149,18,12,6,31,19,12,20,11,9,-2,-1,-1,64%,71%,53%,90,81,105,30%,31%,30%,0,0,0,2,1,1
2,https://vlr.gg/player/4885/whzy,2024-08-08 06:10:00,0.97,0.47,0.78,232,275,167,27,20,7,37,22,15,11,9,2,-2,-1,-1,56%,67%,40%,140,159,110,23%,27%,18%,8,6,2,10,7,3
3,https://vlr.gg/player/6022/yosemite,2024-08-08 06:10:00,0.57,0.60,0.58,137,119,143,17,10,7,32,18,14,7,3,4,-1,0,-1,54%,63%,40%,86,82,93,25%,21%,32%,1,1,0,2,1,1
4,https://vlr.gg/player/10698/nephh,2024-08-08 06:10:00,0.61,0.51,0.57,135,132,149,16,10,6,33,19,14,12,10,2,-5,-1,-4,54%,63%,40%,90,78,108,18%,13%,26%,1,0,1,6,1,5
5,https://vlr.gg/player/8673/heat,2024-08-08 06:10:00,1.98,1.23,1.52,265,335,217,39,20,19,18,5,13,7,4,3,+3,+1,+2,90%,100%,83%,170,214,142,38%,41%,36%,5,1,4,2,0,2
6,https://vlr.gg/player/2462/keznit,2024-08-08 06:10:00,1.57,1.23,1.36,232,252,226,32,13,19,21,7,14,14,8,6,+3,+2,+1,92%,100%,88%,174,204,155,16%,18%,15%,4,2,2,1,0,1
7,https://vlr.gg/player/36169/mta,2024-08-08 06:10:00,1.00,1.51,1.32,217,147,249,32,9,23,20,8,12,11,3,8,+3,+3,0,87%,93%,83%,135,98,158,36%,27%,39%,6,4,2,3,1,2
8,https://vlr.gg/player/24007/shyy,2024-08-08 06:10:00,1.38,1.16,1.24,261,303,236,40,19,21,24,8,16,6,0,6,+2,+3,-1,74%,73%,75%,175,205,156,25%,32%,21%,5,4,1,3,1,2
9,https://vlr.gg/player/1311/melser,2024-08-08 06:10:00,0.69,0.79,0.75,159,124,185,20,6,14,27,9,18,21,11,10,-2,-2,0,79%,87%,75%,111,78,131,29%,13%,38%,4,0,4,6,2,4
10,https://vlr.gg/player/4004/zekken,2024-08-08 04:00:00,1.05,1.86,1.49,275,232,311,39,14,25,24,15,9,12,4,8,+4,+1,+3,79%,67%,90%,177,148,203,22%,19%,25%,9,4,5,5,3,2
11,https://vlr.gg/player/9/tenz,2024-08-08 04:00:00,1.10,1.35,1.24,234,207,251,33,13,20,23,13,10,15,7,8,+2,0,+2,79%,78%,81%,148,132,161,19%,17%,21%,4,1,3,2,1,1
12,https://vlr.gg/player/1265/johnqt,2024-08-08 04:00:00,0.75,1.53,1.17,160,100,213,22,6,16,16,10,6,11,4,7,+1,-2,+3,79%,67%,90%,110,70,145,20%,6%,33%,4,0,4,3,2,1
13,https://vlr.gg/player/729/zellsis,2024-08-08 04:00:00,0.70,1.40,1.08,181,180,189,26,11,15,20,15,5,13,5,8,-2,-4,+2,77%,61%,90%,106,97,114,19%,13%,23%,2,0,2,4,4,0
14,https://vlr.gg/player/659/sacy,2024-08-08 04:00:00,0.68,1.40,1.07,201,148,243,25,8,17,24,14,10,28,12,16,0,-1,+1,79%,72%,86%,141,114,165,20%,17%,22%,3,1,2,3,2,1
15,https://vlr.gg/player/7857/berlin,2024-08-08 04:00:00,0.53,1.59,1.02,203,132,285,26,8,18,28,19,9,14,6,8,0,-2,+2,62%,48%,78%,134,98,176,24%,30%,21%,3,0,3,3,2,1
16,https://vlr.gg/player/872/autumn,2024-08-08 04:00:00,0.72,1.29,0.98,222,188,268,32,14,18,31,20,11,1,1,0,+5,-2,+7,64%,52%,78%,129,112,149,38%,43%,32%,10,3,7,5,5,0
17,https://vlr.gg/player/19530/aaaay,2024-08-08 04:00:00,0.54,1.05,0.78,121,80,171,16,4,12,25,16,9,9,4,5,-1,-1,0,67%,57%,78%,85,58,116,20%,17%,21%,1,0,1,2,1,1
18,https://vlr.gg/player/3028/life,2024-08-08 04:00:00,0.42,0.92,0.65,163,127,208,22,9,13,32,19,13,4,2,2,-7,-4,-3,56%,48%,67%,104,72,141,36%,27%,43%,3,2,1,10,6,4
19,https://vlr.gg/player/37489/lysoar,2024-08-08 04:00:00,0.30,0.83,0.54,91,79,104,11,5,6,29,19,10,13,4,9,-2,-2,0,59%,38%,83%,66,53,81,27%,29%,25%,0,0,0,2,2,0
20,https://vlr.gg/player/13768/s1mon,2024-08-07 07:15:00,1.18,1.29,1.23,229,222,234,58,31,27,43,19,24,24,10,14,-3,-2,-1,64%,69%,58%,143,136,150,28%,24%,35%,3,2,1,6,4,2
21,https://vlr.gg/player/4742/smoggy,2024-08-07 07:15:00,1.25,0.84,1.05,197,224,166,49,30,19,43,17,26,22,10,12,+3,+3,0,70%,81%,58%,120,132,107,23%,28%,18%,7,4,3,4,1,3
22,https://vlr.gg/player/15559/chichoo,2024-08-07 07:15:00,1.03,1.01,1.02,203,193,208,50,25,25,43,19,24,11,5,6,+8,+6,+2,74%,78%,70%,126,121,132,30%,28%,32%,12,6,6,4,0,4
23,https://vlr.gg/player/3520/zmjjkk,2024-08-07 07:15:00,1.05,0.90,0.98,224,247,200,53,31,22,49,23,26,11,4,7,+2,+3,-1,61%,64%,58%,149,157,140,20%,19%,22%,12,8,4,10,5,5
24,https://vlr.gg/player/3017/nobody,2024-08-07 07:15:00,0.72,0.76,0.74,131,124,144,29,15,14,45,21,24,14,6,8,-1,-2,+1,65%,64%,67%,95,81,110,35%,33%,38%,5,2,3,6,4,2
25,https://vlr.gg/player/3885/valyn,2024-08-07 07:15:00,1.36,0.99,1.17,215,254,179,54,32,22,43,18,25,17,10,7,+2,0,+2,72%,82%,64%,130,151,111,24%,24%,25%,5,2,3,3,2,1
26,https://vlr.gg/player/8402/icy,2024-08-07 07:15:00,1.34,0.96,1.14,220,263,179,52,32,20,47,21,26,12,5,7,-5,-3,-2,65%,73%,58%,145,173,120,26%,26%,26%,6,2,4,11,5,6
27,https://vlr.gg/player/15500/trent,2024-08-07 07:15:00,0.93,0.89,0.90,174,206,150,44,25,19,48,23,25,15,9,6,-4,0,-4,67%,82%,53%,119,142,99,38%,37%,39%,5,4,1,9,4,5
28,https://vlr.gg/player/7873/leaf,2024-08-07 07:15:00,0.70,1.02,0.87,186,157,217,40,16,24,52,24,28,13,7,6,+5,+2,+3,65%,73%,58%,130,110,149,19%,20%,19%,12,6,6,7,4,3
29,https://vlr.gg/player/4581/jonahp,2024-08-07 07:15:00,0.84,0.71,0.77,150,160,139,33,19,14,49,21,28,26,9,17,-7,0,-7,65%,67%,64%,102,104,99,17%,24%,12%,2,2,0,9,2,7
30,https://vlr.gg/player/8480/aspas,2024-08-07 04:00:00,1.04,1.23,1.13,232,264,206,54,31,23,43,27,16,12,6,6,+2,+4,-2,68%,67%,70%,154,167,139,32%,40%,23%,10,8,2,8,4,4
31,https://vlr.gg/player/8549/kingg,2024-08-07 04:00:00,0.89,1.16,1.02,188,176,190,39,20,19,40,24,16,26,9,17,-5,-4,-1,78%,73%,83%,120,119,122,37%,39%,35%,4,1,3,9,5,4
32,https://vlr.gg/player/1818/tex,2024-08-07 04:00:00,1.14,0.82,0.99,204,219,198,48,27,21,46,24,22,11,5,6,0,0,0,70%,67%,73%,137,143,129,31%,26%,37%,5,2,3,5,2,3
33,https://vlr.gg/player/619/c0m,2024-08-07 04:00:00,0.61,1.23,0.88,176,124,240,38,12,26,45,26,19,12,7,5,+1,-1,+2,59%,55%,63%,131,103,161,21%,20%,23%,5,1,4,4,2,2
34,https://vlr.gg/player/7603/mazino,2024-08-07 04:00:00,0.69,0.80,0.74,167,153,181,34,16,18,49,26,23,22,11,11,-1,-4,+3,65%,64%,67%,101,98,105,30%,36%,26%,6,2,4,7,6,1
35,https://vlr.gg/player/37494/kai,2024-08-07 04:00:00,0.97,1.53,1.26,240,208,265,52,21,31,42,22,20,14,6,8,+4,-1,+5,71%,63%,79%,159,139,178,29%,33%,26%,11,4,7,7,5,2
36,https://vlr.gg/player/4770/fengf,2024-08-07 04:00:00,1.11,1.00,1.05,232,248,210,50,25,25,45,23,22,8,5,3,-2,0,-2,71%,70%,73%,155,168,144,31%,37%,27%,7,4,3,9,4,5
37,https://vlr.gg/player/4712/heybay,2024-08-07 04:00:00,1.17,0.85,1.00,179,199,165,41,22,19,40,19,21,23,12,11,-2,0,-2,75%,77%,73%,121,133,111,25%,28%,23%,2,1,1,4,1,3
38,https://vlr.gg/player/3021/biank,2024-08-07 04:00:00,0.95,0.99,0.97,187,190,180,37,19,18,42,21,21,29,13,16,-1,-3,+2,70%,67%,73%,114,111,118,11%,14%,8%,7,3,4,8,6,2
39,https://vlr.gg/player/3045/luok1ng,2024-08-07 04:00:00,0.54,1.35,0.96,187,100,263,43,9,34,44,22,22,25,15,10,+4,+2,+2,76%,67%,85%,113,62,160,38%,24%,44%,6,2,4,2,0,2
40,https://vlr.gg/player/9810/alfajer,2024-08-06 07:35:00,1.23,1.89,1.60,291,236,339,45,16,29,28,15,13,9,0,9,+3,+3,0,79%,79%,79%,193,169,213,30%,28%,32%,6,3,3,3,0,3
41,https://vlr.gg/player/5022/derke,2024-08-06 07:35:00,0.85,0.85,0.85,197,188,193,28,12,16,32,15,17,7,1,6,-2,+1,-3,58%,63%,54%,117,110,122,26%,26%,26%,5,3,2,7,2,5
42,https://vlr.gg/player/29867/hiro,2024-08-06 07:35:00,0.64,0.92,0.79,146,133,166,24,10,14,32,16,16,12,4,8,-2,-3,+1,77%,63%,88%,99,90,106,23%,17%,28%,2,0,2,4,3,1
43,https://vlr.gg/player/458/chronicle,2024-08-06 07:35:00,0.33,1.06,0.74,147,94,190,20,4,16,31,17,14,10,4,6,-3,-2,-1,63%,53%,71%,104,76,127,19%,6%,28%,3,1,2,6,3,3
44,https://vlr.gg/player/438/boaster,2024-08-06 07:35:00,0.50,0.78,0.66,115,100,122,16,7,9,29,15,14,11,3,8,-3,-2,-1,65%,58%,71%,70,57,80,22%,35%,17%,2,1,1,5,3,2
45,https://vlr.gg/player/804/buzz,2024-08-06 07:35:00,1.25,1.63,1.42,298,273,322,47,22,25,26,17,9,2,2,0,+9,+4,+5,74%,67%,84%,179,171,189,23%,25%,20%,14,7,7,5,3,2
46,https://vlr.gg/player/4462/mako,2024-08-06 07:35:00,1.10,1.27,1.18,224,212,232,34,18,16,25,15,10,11,5,6,+2,+2,0,81%,75%,89%,146,134,160,30%,32%,28%,3,2,1,1,0,1
47,https://vlr.gg/player/35013/flashback,2024-08-06 07:35:00,0.66,1.00,0.81,138,126,158,22,11,11,23,14,9,12,6,6,0,-1,+1,72%,63%,84%,88,78,101,28%,24%,31%,2,1,1,2,2,0
48,https://vlr.gg/player/4678/beyn,2024-08-06 07:35:00,0.67,0.91,0.78,161,140,193,25,11,14,28,17,11,12,6,6,-3,-2,-1,77%,71%,84%,112,97,131,21%,20%,22%,2,1,1,5,3,2
49,https://vlr.gg/player/11600/foxy9,2024-08-06 07:35:00,0.58,0.88,0.71,146,142,153,23,12,11,31,21,10,14,7,7,-1,+1,-2,65%,54%,79%,111,102,123,33%,61%,19%,4,3,1,5,2,3
50,https://vlr.gg/player/13039/meteor,2024-08-06 04:00:00,1.69,1.19,1.44,286,320,254,76,42,34,48,19,29,15,6,9,+5,+2,+3,73%,77%,69%,184,211,158,43%,46%,38%,11,7,4,6,5,1
51,https://vlr.gg/player/34974/karon,2024-08-06 04:00:00,0.97,1.14,1.06,188,176,199,51,24,27,47,21,26,29,13,16,+3,0,+3,68%,63%,72%,117,109,124,34%,48%,28%,7,2,5,4,2,2
52,https://vlr.gg/player/9196/t3xture,2024-08-06 04:00:00,0.92,0.90,0.91,211,232,194,49,26,23,56,26,30,13,4,9,+5,+1,+4,61%,54%,67%,149,158,140,22%,27%,18%,13,6,7,8,5,3
53,https://vlr.gg/player/2489/munchkin,2024-08-06 04:00:00,0.71,0.96,0.84,162,148,177,33,15,18,49,24,25,37,17,20,+1,+1,0,76%,80%,72%,114,92,136,27%,15%,37%,7,2,5,6,1,5
54,https://vlr.gg/player/773/lakia,2024-08-06 04:00:00,0.62,0.71,0.67,127,123,134,30,15,15,53,25,28,29,12,17,-5,-5,0,65%,66%,64%,81,69,93,23%,23%,23%,2,0,2,7,5,2
55,https://vlr.gg/player/1144/boo,2024-08-06 04:00:00,1.20,1.18,1.19,221,204,242,55,29,26,46,20,26,36,15,21,+1,-1,+2,83%,83%,83%,135,123,148,29%,29%,29%,8,1,7,7,2,5
56,https://vlr.gg/player/10971/riens,2024-08-06 04:00:00,0.83,1.29,1.06,183,145,222,47,19,28,45,23,22,15,9,6,-2,-4,+2,77%,75%,80%,121,94,149,32%,36%,30%,4,0,4,6,4,2
57,https://vlr.gg/player/21328/wo0t,2024-08-06 04:00:00,1.39,0.72,1.06,196,263,130,50,34,16,47,23,24,20,14,6,-2,0,-2,72%,75%,69%,130,173,86,39%,44%,30%,4,3,1,6,3,3
58,https://vlr.gg/player/29873/benjyfishy,2024-08-06 04:00:00,1.17,0.90,1.03,205,242,166,56,34,22,50,24,26,17,7,10,-2,-1,-1,75%,78%,71%,134,161,107,39%,44%,34%,5,3,2,7,4,3
59,https://vlr.gg/player/18350/miniboo,2024-08-06 04:00:00,0.70,0.89,0.79,181,180,183,45,22,23,51,27,24,14,9,5,-4,-4,0,70%,72%,69%,121,125,117,32%,24%,43%,10,6,4,14,10,4
60,https://vlr.gg/player/4742/smoggy,2024-08-04 06:15:00,1.80,1.20,1.52,279,318,234,46,30,16,25,12,13,13,3,10,-3,0,-3,84%,88%,81%,176,196,154,30%,28%,33%,2,2,0,5,2,3
61,https://vlr.gg/player/15559/chichoo,2024-08-04 06:15:00,1.51,1.12,1.33,243,273,211,35,21,14,28,13,15,23,11,12,+2,+2,0,84%,92%,76%,166,190,138,28%,33%,21%,6,3,3,4,1,3
62,https://vlr.gg/player/3520/zmjjkk,2024-08-04 06:15:00,1.06,0.88,0.98,207,203,213,33,17,16,32,14,18,13,7,6,-2,-2,0,69%,75%,62%,130,131,129,20%,12%,28%,7,3,4,9,5,4
63,https://vlr.gg/player/3017/nobody,2024-08-04 06:15:00,0.54,1.12,0.81,152,134,169,25,11,14,32,19,13,12,8,4,-4,-2,-2,71%,67%,76%,99,86,113,22%,30%,17%,3,2,1,7,4,3
64,https://vlr.gg/player/13768/s1mon,2024-08-04 06:15:00,0.73,0.82,0.77,130,122,139,20,10,10,30,16,14,19,14,5,0,0,0,73%,79%,67%,84,77,93,24%,29%,20%,1,1,0,1,1,0
65,https://vlr.gg/player/1139/qraxs,2024-08-04 06:15:00,1.02,1.21,1.12,174,153,192,28,13,15,25,11,14,15,6,9,+1,+1,0,76%,76%,75%,110,100,119,26%,32%,21%,2,1,1,1,0,1
66,https://vlr.gg/player/8369/yetujey,2024-08-04 06:15:00,0.87,1.05,0.96,222,193,247,36,14,22,32,14,18,12,5,7,+3,+2,+1,73%,86%,63%,135,116,151,27%,30%,25%,7,4,3,4,2,2
67,https://vlr.gg/player/573/cned,2024-08-04 06:15:00,0.75,1.08,0.93,211,198,223,33,14,19,35,17,18,5,3,2,+3,+1,+2,71%,67%,75%,145,142,148,30%,33%,28%,12,5,7,9,4,5
68,https://vlr.gg/player/8044/mrfalin,2024-08-04 06:15:00,1.19,0.51,0.83,178,244,118,25,16,9,33,14,19,17,11,6,0,+2,-2,73%,86%,63%,112,157,72,22%,17%,32%,3,2,1,3,0,3
69,https://vlr.gg/player/6510/atakaptan,2024-08-04 06:15:00,1.12,0.52,0.80,169,209,133,25,16,9,34,14,20,16,8,8,0,-1,+1,69%,71%,67%,107,127,89,19%,29%,11%,2,1,1,2,2,0
70,https://vlr.gg/player/7873/leaf,2024-08-04 04:00:00,1.16,1.41,1.28,241,235,246,37,17,20,27,14,13,10,5,5,+3,+3,0,81%,82%,81%,167,167,168,20%,25%,16%,5,4,1,2,1,1
71,https://vlr.gg/player/15500/trent,2024-08-04 04:00:00,1.03,1.35,1.19,231,210,256,34,17,17,29,15,14,17,5,12,+4,0,+4,70%,68%,71%,148,136,161,25%,29%,23%,7,3,4,3,3,0
72,https://vlr.gg/player/8402/icy,2024-08-04 04:00:00,1.34,0.89,1.12,214,243,184,35,22,13,29,14,15,9,1,8,+6,+4,+2,74%,73%,76%,134,145,122,32%,40%,24%,7,5,2,1,1,0
73,https://vlr.gg/player/4581/jonahp,2024-08-04 04:00:00,0.72,1.52,1.11,224,154,300,34,10,24,31,17,14,11,7,4,+1,0,+1,70%,68%,71%,149,112,188,28%,21%,33%,6,2,4,5,2,3
74,https://vlr.gg/player/3885/valyn,2024-08-04 04:00:00,1.01,1.06,1.04,202,194,209,30,14,16,28,13,15,24,8,16,-1,-1,0,77%,68%,86%,122,117,128,15%,22%,10%,3,0,3,4,1,3
75,https://vlr.gg/player/9801/f0rsaken,2024-08-04 04:00:00,1.41,0.79,1.09,211,274,152,33,21,12,34,16,18,19,10,9,-3,-1,-2,70%,67%,73%,135,167,103,37%,36%,38%,1,1,0,4,2,2
76,https://vlr.gg/player/9800/mindfreak,2024-08-04 04:00:00,1.00,1.04,1.02,225,249,201,34,19,15,32,18,14,17,9,8,-2,0,-2,77%,86%,68%,129,137,122,31%,37%,26%,2,1,1,4,1,3
77,https://vlr.gg/player/17086/something,2024-08-04 04:00:00,0.42,1.19,0.81,196,157,234,29,10,19,33,19,14,6,4,2,+1,0,+1,58%,57%,59%,133,113,151,22%,20%,24%,6,3,3,5,3,2
78,https://vlr.gg/player/7378/jinggg,2024-08-04 04:00:00,0.50,1.06,0.79,183,131,232,25,8,17,35,18,17,17,6,11,-7,-5,-2,67%,57%,77%,125,95,155,19%,16%,22%,4,1,3,11,6,5
79,https://vlr.gg/player/9803/d4v41,2024-08-04 04:00:00,0.75,0.61,0.68,170,215,131,23,13,10,36,19,17,10,5,5,-2,-1,-1,70%,71%,68%,117,151,85,26%,27%,24%,2,1,1,4,2,2
80,https://vlr.gg/player/2168/trexx,2024-08-03 06:30:00,1.75,1.14,1.45,252,290,218,61,36,25,39,17,22,22,10,12,+5,+6,-1,71%,76%,65%,173,187,159,27%,27%,27%,8,6,2,3,0,3
81,https://vlr.gg/player/21610/runner,2024-08-03 06:30:00,0.87,0.96,0.91,203,186,228,45,22,23,53,26,27,18,8,10,+1,-1,+2,65%,65%,65%,139,122,156,21%,18%,24%,10,3,7,9,4,5
82,https://vlr.gg/player/4321/cender,2024-08-03 06:30:00,0.89,0.90,0.90,149,160,139,41,22,19,48,24,24,19,9,10,-4,-2,-2,63%,65%,62%,98,96,100,30%,26%,35%,4,2,2,8,4,4
83,https://vlr.gg/player/312/sayf,2024-08-03 06:30:00,0.66,1.14,0.90,188,153,216,42,16,26,50,26,24,19,12,7,-4,-6,+2,69%,71%,68%,131,110,153,30%,21%,38%,7,2,5,11,8,3
84,https://vlr.gg/player/11134/kicks,2024-08-03 06:30:00,0.84,0.81,0.82,146,141,140,29,16,13,47,23,24,36,16,20,-4,-3,-1,65%,68%,62%,96,94,97,15%,14%,16%,2,1,1,6,4,2
85,https://vlr.gg/player/3045/luok1ng,2024-08-03 06:30:00,1.30,1.19,1.25,253,254,256,64,32,32,44,22,22,19,11,8,+3,0,+3,79%,76%,82%,162,171,153,36%,33%,39%,6,3,3,3,3,0
86,https://vlr.gg/player/37494/kai,2024-08-03 06:30:00,1.11,1.03,1.07,203,233,184,51,28,23,44,22,22,12,8,4,+1,+2,-1,68%,71%,65%,141,151,131,32%,37%,25%,9,5,4,8,3,5
87,https://vlr.gg/player/4712/heybay,2024-08-03 06:30:00,1.07,0.76,0.92,159,173,138,37,22,15,44,19,25,28,15,13,+2,+1,+1,81%,94%,68%,102,120,85,26%,29%,22%,4,1,3,2,0,2
88,https://vlr.gg/player/4770/fengf,2024-08-03 06:30:00,0.99,0.83,0.91,183,193,172,46,26,20,42,21,21,4,1,3,+2,+1,+1,65%,65%,65%,120,125,115,28%,32%,26%,11,7,4,9,6,3
89,https://vlr.gg/player/3021/biank,2024-08-03 06:30:00,0.60,1.09,0.85,169,122,222,38,14,24,45,22,23,24,10,14,-2,-4,+2,65%,56%,74%,115,87,143,17%,13%,19%,7,1,6,9,5,4
90,https://vlr.gg/player/8549/kingg,2024-08-03 04:00:00,1.54,1.30,1.41,230,271,199,41,22,19,24,13,11,15,7,8,+2,+1,+1,78%,81%,75%,144,162,127,31%,43%,22%,5,1,4,3,0,3
91,https://vlr.gg/player/8480/aspas,2024-08-03 04:00:00,1.25,1.41,1.34,244,240,252,37,18,19,29,15,14,10,3,7,+8,-1,+9,76%,71%,79%,163,165,162,29%,43%,19%,11,2,9,3,3,0
92,https://vlr.gg/player/619/c0m,2024-08-03 04:00:00,0.71,1.29,1.02,205,166,233,25,8,17,28,15,13,15,6,9,-2,-2,0,71%,67%,75%,142,116,165,16%,16%,16%,4,2,2,6,4,2
93,https://vlr.gg/player/1818/tex,2024-08-03 04:00:00,0.66,1.03,0.86,176,156,186,28,11,17,32,16,16,11,3,8,-3,-1,-2,60%,52%,67%,117,101,132,32%,34%,30%,3,2,1,6,3,3
94,https://vlr.gg/player/7603/mazino,2024-08-03 04:00:00,0.72,0.90,0.82,152,146,153,24,11,13,31,17,14,11,6,5,0,0,0,78%,76%,79%,105,98,111,30%,48%,23%,2,2,0,2,2,0
95,https://vlr.gg/player/25255/primmie,2024-08-03 04:00:00,1.42,1.13,1.28,250,272,220,40,23,17,27,15,12,15,9,6,0,0,0,78%,88%,67%,149,169,126,39%,40%,39%,3,1,2,3,1,2
96,https://vlr.gg/player/5129/ban,2024-08-03 04:00:00,0.53,1.61,1.03,160,98,236,28,7,21,26,17,9,12,6,6,0,-3,+3,71%,67%,76%,102,68,140,37%,36%,37%,3,0,3,3,3,0
97,https://vlr.gg/player/3980/governor,2024-08-03 04:00:00,0.96,0.74,0.86,194,196,201,28,15,13,33,14,19,13,5,8,0,-3,+3,64%,67%,62%,126,132,120,17%,17%,18%,5,2,3,5,5,0
98,https://vlr.gg/player/13788/jitboys,2024-08-03 04:00:00,1.08,0.57,0.84,193,251,130,28,20,8,35,19,16,8,3,5,+2,+2,0,71%,71%,71%,125,156,89,39%,39%,38%,8,5,3,6,3,3
99,https://vlr.gg/player/3977/crws,2024-08-03 04:00:00,0.14,0.93,0.51,130,58,213,20,3,17,34,20,14,10,6,4,-7,-4,-3,60%,54%,67%,93,46,146,12%,9%,13%,1,0,1,8,4,4
100,https://vlr.gg/player/458/chronicle,2024-08-02 07:00:00,1.15,1.45,1.34,244,221,260,35,12,23,23,9,14,10,4,6,+6,+1,+5,74%,73%,75%,159,150,166,28%,22%,31%,8,2,6,2,1,1
101,https://vlr.gg/player/29867/hiro,2024-08-02 07:00:00,1.56,1.17,1.32,218,256,178,29,14,15,20,9,11,15,5,10,-2,-1,-1,77%,80%,75%,138,177,115,41%,38%,43%,2,0,2,4,1,3
102,https://vlr.gg/player/5022/derke,2024-08-02 07:00:00,0.69,1.51,1.19,227,169,265,33,9,24,24,12,12,8,3,5,+2,-1,+3,67%,60%,71%,148,114,170,15%,15%,15%,6,2,4,4,3,1
103,https://vlr.gg/player/438/boaster,2024-08-02 07:00:00,0.80,1.34,1.13,166,133,184,23,7,16,19,11,8,18,5,13,0,+1,-1,85%,73%,92%,110,88,124,31%,33%,30%,3,2,1,3,1,2
104,https://vlr.gg/player/9810/alfajer,2024-08-02 07:00:00,0.86,0.83,0.84,191,237,163,26,13,13,29,13,16,9,3,6,-1,-1,0,69%,67%,71%,133,155,119,32%,37%,28%,3,1,2,4,2,2
105,https://vlr.gg/player/4885/whzy,2024-08-02 07:00:00,1.13,0.96,1.06,259,306,201,35,26,9,31,18,13,5,3,2,-2,-3,+1,74%,79%,67%,162,186,123,21%,28%,8%,6,3,3,8,6,2
106,https://vlr.gg/player/10698/nephh,2024-08-02 07:00:00,0.87,1.14,0.97,199,166,251,26,13,13,29,17,12,13,8,5,0,+1,-1,62%,58%,67%,122,100,158,22%,9%,45%,3,2,1,3,1,2
107,https://vlr.gg/player/4774/knight,2024-08-02 07:00:00,0.63,1.14,0.83,153,121,210,22,10,12,29,19,10,13,6,7,-1,0,-1,64%,58%,73%,103,69,156,28%,12%,45%,2,2,0,3,2,1
108,https://vlr.gg/player/4705/flex1n,2024-08-02 07:00:00,0.67,0.69,0.67,139,129,164,18,9,9,30,18,12,13,11,2,+1,-1,+2,67%,71%,60%,95,82,116,32%,26%,39%,3,1,2,2,2,0
109,https://vlr.gg/player/6022/yosemite,2024-08-02 07:00:00,0.32,1.16,0.64,118,64,204,14,4,10,28,19,9,11,3,8,-3,-3,0,56%,42%,80%,83,44,147,25%,14%,31%,3,1,2,6,4,2
110,https://vlr.gg/player/35013/flashback,2024-08-02 04:00:00,1.05,1.33,1.19,238,220,266,51,22,29,34,19,15,9,3,6,+4,+2,+2,83%,65%,100%,154,131,177,24%,29%,20%,6,4,2,2,2,0
111,https://vlr.gg/player/804/buzz,2024-08-02 04:00:00,1.08,1.01,1.04,247,279,226,43,22,21,41,23,18,12,7,5,0,0,0,68%,62%,74%,162,184,141,15%,17%,13%,9,4,5,9,4,5
112,https://vlr.gg/player/11600/foxy9,2024-08-02 04:00:00,0.72,1.19,0.96,190,148,237,36,12,24,37,20,17,20,11,9,-5,-5,0,66%,58%,74%,129,96,160,32%,39%,28%,2,0,2,7,5,2
113,https://vlr.gg/player/4678/beyn,2024-08-02 04:00:00,0.77,1.08,0.91,169,136,214,35,16,19,36,20,16,10,2,8,-1,-1,0,66%,50%,81%,114,78,149,27%,32%,25%,4,2,2,5,3,2
114,https://vlr.gg/player/4462/mako,2024-08-02 04:00:00,0.76,0.97,0.86,154,138,168,25,11,14,35,20,15,21,11,10,-1,-2,+1,70%,65%,74%,104,97,110,22%,21%,23%,4,0,4,5,2,3
115,https://vlr.gg/player/1311/melser,2024-08-02 04:00:00,1.01,1.43,1.21,213,162,240,36,14,22,33,19,14,19,9,10,0,-2,+2,70%,67%,73%,133,116,151,27%,26%,27%,5,1,4,5,3,2
116,https://vlr.gg/player/2462/keznit,2024-08-02 04:00:00,1.06,1.35,1.20,277,231,312,48,19,29,40,22,18,16,7,9,+6,+2,+4,64%,52%,77%,176,155,197,27%,19%,33%,11,6,5,5,4,1
117,https://vlr.gg/player/24007/shyy,2024-08-02 04:00:00,0.84,1.06,0.95,179,138,215,32,12,20,38,20,18,18,10,8,0,-1,+1,60%,48%,73%,115,97,134,24%,19%,30%,8,2,6,8,3,5
118,https://vlr.gg/player/8673/heat,2024-08-02 04:00:00,0.94,0.91,0.93,173,191,155,36,20,16,39,23,16,16,5,11,0,0,0,74%,74%,73%,116,122,110,27%,31%,23%,2,2,0,2,2,0
119,https://vlr.gg/player/36169/mta,2024-08-02 04:00:00,0.82,0.79,0.81,162,179,158,31,16,15,40,23,17,17,11,6,-3,-2,-1,75%,74%,77%,119,132,106,27%,29%,24%,2,1,1,5,3,2
120,https://vlr.gg/player/872/autumn,2024-08-01 06:25:00,1.08,1.17,1.12,205,194,216,54,25,29,46,23,23,26,11,15,+3,+3,0,75%,78%,72%,137,130,144,30%,33%,28%,9,4,5,6,1,5
121,https://vlr.gg/player/19530/aaaay,2024-08-01 06:25:00,0.84,1.29,1.07,222,185,261,65,27,38,52,27,25,11,2,9,+4,+3,+1,68%,65%,72%,142,119,165,35%,29%,40%,8,5,3,4,2,2
122,https://vlr.gg/player/37489/lysoar,2024-08-01 06:25:00,1.18,0.86,1.01,217,260,175,55,35,20,56,27,29,29,8,21,+2,+1,+1,76%,78%,74%,146,177,117,19%,29%,9%,5,2,3,3,1,2
123,https://vlr.gg/player/7857/berlin,2024-08-01 06:25:00,0.86,0.99,0.93,163,147,185,45,19,26,49,23,26,27,13,14,+2,+2,0,72%,76%,69%,110,95,125,27%,28%,27%,8,4,4,6,2,4
124,https://vlr.gg/player/3028/life,2024-08-01 06:25:00,0.67,0.79,0.74,185,174,189,47,22,25,57,29,28,12,6,6,-3,-2,-1,63%,59%,67%,123,122,124,30%,32%,28%,12,7,5,15,9,6
125,https://vlr.gg/player/10971/riens,2024-08-01 06:25:00,1.59,1.38,1.49,260,269,253,71,40,31,44,20,24,19,8,11,+6,+3,+3,70%,72%,68%,173,186,160,36%,35%,36%,8,4,4,2,1,1
126,https://vlr.gg/player/21328/wo0t,2024-08-01 06:25:00,0.98,1.04,1.01,185,182,191,50,23,27,52,27,25,32,19,13,-1,+4,-5,80%,82%,78%,119,122,117,34%,37%,31%,6,5,1,7,1,6
127,https://vlr.gg/player/29873/benjyfishy,2024-08-01 06:25:00,0.72,1.27,0.99,196,150,233,52,22,30,54,29,25,20,7,13,-8,-6,-2,68%,62%,76%,139,112,168,35%,34%,36%,5,1,4,13,7,6
128,https://vlr.gg/player/1144/boo,2024-08-01 06:25:00,0.85,0.84,0.85,172,195,156,47,27,20,56,30,26,29,16,13,-2,-1,-1,71%,72%,70%,107,116,98,28%,26%,30%,2,2,0,4,3,1
129,https://vlr.gg/player/18350/miniboo,2024-08-01 06:25:00,0.64,0.75,0.70,155,155,164,40,19,21,60,32,28,14,9,5,-3,-1,-2,57%,59%,54%,109,102,116,30%,38%,24%,13,7,6,16,8,8
130,https://vlr.gg/player/9196/t3xture,2024-08-01 04:00:00,1.27,1.50,1.38,257,256,260,38,18,20,23,12,11,8,5,3,+1,+1,0,83%,86%,80%,160,158,161,30%,31%,28%,7,4,3,6,3,3
131,https://vlr.gg/player/34974/karon,2024-08-01 04:00:00,1.40,1.17,1.29,225,212,237,34,18,16,23,9,14,23,13,10,-1,-1,0,88%,86%,90%,138,124,154,33%,36%,30%,2,1,1,3,2,1
132,https://vlr.gg/player/13039/meteor,2024-08-01 04:00:00,1.19,1.32,1.25,227,236,218,35,19,16,20,11,9,6,3,3,-3,0,-3,80%,81%,80%,156,155,157,30%,28%,32%,3,3,0,6,3,3
133,https://vlr.gg/player/2489/munchkin,2024-08-01 04:00:00,1.15,0.83,0.99,204,219,185,27,15,12,28,13,15,21,12,9,+3,+3,0,83%,86%,80%,132,142,120,23%,24%,22%,5,3,2,2,0,2
134,https://vlr.gg/player/773/lakia,2024-08-01 04:00:00,0.68,0.83,0.75,141,124,160,21,10,11,25,11,14,6,5,1,+1,0,+1,73%,71%,75%,100,89,111,23%,17%,29%,4,1,3,3,1,2
135,https://vlr.gg/player/659/sacy,2024-08-01 04:00:00,1.31,1.39,1.35,248,236,260,34,17,17,27,14,13,17,10,7,+3,+3,0,78%,90%,67%,163,138,186,23%,24%,22%,4,3,1,1,0,1
136,https://vlr.gg/player/9/tenz,2024-08-01 04:00:00,1.06,0.68,0.86,182,201,167,25,14,11,32,14,18,14,10,4,-2,-2,0,73%,85%,62%,118,134,104,23%,29%,18%,5,1,4,7,3,4
137,https://vlr.gg/player/729/zellsis,2024-08-01 04:00:00,0.68,1.00,0.84,142,141,143,21,9,12,30,16,14,15,6,9,+2,+3,-1,63%,65%,62%,89,90,88,26%,22%,30%,6,4,2,4,1,3
138,https://vlr.gg/player/1265/johnqt,2024-08-01 04:00:00,1.06,0.44,0.74,129,187,74,19,15,4,30,14,16,7,3,4,+2,+2,0,61%,70%,52%,85,116,54,32%,34%,27%,2,2,0,0,0,0
139,https://vlr.gg/player/4004/zekken,2024-08-01 04:00:00,0.30,0.68,0.49,146,124,165,19,7,12,36,18,18,7,5,2,-6,-4,-2,54%,60%,48%,96,88,103,12%,23%,6%,3,1,2,9,5,4
140,https://vlr.gg/player/44500/atisca,2024-07-31 18:00:00,0.76,1.53,1.13,258,184,338,39,14,25,35,21,14,4,1,3,+5,0,+5,67%,55%,80%,162,113,216,27%,31%,23%,11,4,7,6,4,2
141,https://vlr.gg/player/28993/guterwoman,2024-07-31 18:00:00,1.12,1.06,1.09,216,235,191,32,17,15,29,17,12,6,2,4,0,0,0,69%,55%,85%,142,157,125,43%,46%,41%,4,4,0,4,4,0
142,https://vlr.gg/player/35857/mayzin,2024-07-31 18:00:00,0.81,1.11,0.95,199,202,201,29,15,14,32,20,12,13,6,7,-3,0,-3,74%,68%,80%,130,134,126,25%,28%,21%,0,0,0,3,0,3
143,https://vlr.gg/player/35830/zidian,2024-07-31 18:00:00,0.51,1.14,0.81,185,135,236,23,7,16,35,21,14,24,13,11,-4,-3,-1,69%,59%,80%,118,90,149,14%,12%,16%,3,0,3,7,3,4
144,https://vlr.gg/player/35920/lapapaluna,2024-07-31 18:00:00,0.40,0.42,0.41,94,106,85,11,7,4,34,19,15,9,4,5,-4,-3,-1,60%,55%,65%,70,76,62,23%,22%,25%,0,0,0,4,3,1
145,https://vlr.gg/player/44462/kyujinn,2024-07-31 18:00:00,1.11,1.58,1.35,234,172,290,37,14,23,24,12,12,10,2,8,+1,-1,+2,81%,70%,91%,158,118,195,30%,33%,28%,3,1,2,2,2,0
146,https://vlr.gg/player/28386/junki,2024-07-31 18:00:00,1.15,1.37,1.27,224,224,227,34,15,19,26,14,12,29,6,23,+2,+1,+1,74%,65%,82%,149,157,141,37%,32%,43%,3,1,2,1,0,1
147,https://vlr.gg/player/35951/morgan,2024-07-31 18:00:00,0.99,1.36,1.19,242,238,247,34,15,19,27,16,11,16,5,11,-2,0,-2,74%,65%,82%,161,146,176,24%,29%,20%,5,4,1,7,4,3
148,https://vlr.gg/player/25737/buffala,2024-07-31 18:00:00,0.94,1.41,1.18,229,196,262,33,13,20,29,16,13,20,8,12,+3,+1,+2,74%,65%,82%,152,122,179,29%,26%,31%,9,4,5,6,3,3
149,https://vlr.gg/player/20500/zaki,2024-07-31 18:00:00,0.57,1.16,0.88,177,147,201,27,10,17,28,16,12,11,3,8,+2,-1,+3,76%,70%,82%,111,89,130,33%,33%,33%,4,0,4,2,1,1
150,https://vlr.gg/player/8082/zander,2024-07-31 16:00:00,1.72,1.86,1.81,312,317,305,39,13,26,17,9,8,18,5,13,+4,+1,+3,86%,75%,92%,186,185,187,29%,35%,27%,4,1,3,0,0,0
151,https://vlr.gg/player/3722/koalanoob,2024-07-31 16:00:00,0.77,1.81,1.46,286,215,333,39,9,30,19,10,9,7,2,5,+12,+3,+9,89%,83%,92%,172,125,196,22%,21%,23%,14,4,10,2,1,1
152,https://vlr.gg/player/4828/nismo,2024-07-31 16:00:00,0.78,1.57,1.30,209,84,254,27,3,24,19,8,11,22,7,15,+2,0,+2,86%,67%,96%,136,72,168,38%,20%,44%,2,0,2,0,0,0
153,https://vlr.gg/player/6582/net,2024-07-31 16:00:00,1.12,1.09,1.10,166,209,157,25,10,15,16,8,8,9,2,7,+1,-1,+2,86%,75%,92%,111,135,100,35%,83%,20%,3,1,2,2,2,0
154,https://vlr.gg/player/864/bcj,2024-07-31 16:00:00,1.05,1.09,1.08,212,161,230,26,6,20,21,7,14,9,4,5,+1,+1,0,72%,58%,79%,131,114,140,27%,47%,22%,5,2,3,4,1,3
155,https://vlr.gg/player/64/gmd,2024-07-31 16:00:00,0.64,1.64,0.97,204,165,291,26,13,13,31,24,7,12,8,4,-1,-2,+1,64%,63%,67%,133,105,190,33%,30%,38%,3,1,2,4,3,1
156,https://vlr.gg/player/849/poised,2024-07-31 16:00:00,0.77,0.57,0.70,178,186,162,21,15,6,32,22,10,9,3,6,-5,-3,-2,64%,54%,83%,116,120,109,35%,45%,21%,1,0,1,6,3,3
157,https://vlr.gg/player/8376/seven,2024-07-31 16:00:00,0.42,0.83,0.56,120,117,127,13,8,5,29,23,6,12,6,6,-5,-3,-2,58%,50%,75%,82,79,88,24%,21%,31%,1,1,0,6,4,2
158,https://vlr.gg/player/740/aproto,2024-07-31 16:00:00,0.49,0.66,0.55,126,118,139,17,10,7,30,22,8,3,1,2,-2,-1,-1,44%,38%,58%,82,78,90,45%,40%,54%,1,1,0,3,2,1
159,https://vlr.gg/player/3702/sym,2024-07-31 16:00:00,0.12,1.00,0.36,122,65,236,15,4,11,34,24,10,5,1,4,-7,-7,0,39%,21%,75%,80,48,145,26%,21%,30%,2,1,1,9,8,1
160,https://vlr.gg/player/6998/nvrfear,2024-07-31 13:30:00,1.76,1.64,1.70,307,293,318,40,21,19,18,8,10,10,6,4,+5,+1,+4,80%,83%,76%,186,181,191,41%,43%,39%,5,1,4,0,0,0
161,https://vlr.gg/player/44170/niwt,2024-07-31 13:30:00,1.14,1.35,1.24,245,238,252,29,14,15,22,12,10,6,3,3,-1,-2,+1,77%,72%,82%,171,162,180,31%,33%,29%,4,2,2,5,4,1
162,https://vlr.gg/player/8034/thenightche,2024-07-31 13:30:00,1.36,0.95,1.16,220,267,172,31,19,12,24,12,12,9,4,5,-4,-3,-1,80%,78%,82%,143,175,110,41%,42%,40%,2,1,1,6,4,2
163,https://vlr.gg/player/3860/al1en,2024-07-31 13:30:00,0.66,1.33,0.98,165,156,179,22,10,12,18,11,7,7,2,5,0,0,0,74%,72%,76%,112,109,115,23%,21%,24%,3,2,1,3,2,1
164,https://vlr.gg/player/10429/luvjix,2024-07-31 13:30:00,0.90,1.06,0.98,166,163,169,19,9,10,20,10,10,19,15,4,+3,0,+3,77%,78%,76%,103,103,103,17%,23%,13%,5,1,4,2,1,1
165,https://vlr.gg/player/2614/tankzor,2024-07-31 13:30:00,0.86,1.08,0.98,217,168,261,26,11,15,25,11,14,3,2,1,-1,-2,+1,57%,47%,67%,152,118,183,32%,39%,29%,3,0,3,4,2,2
166,https://vlr.gg/player/6547/1ce2k,2024-07-31 13:30:00,0.61,0.76,0.69,162,163,160,18,9,9,28,14,14,16,3,13,0,+1,-1,60%,53%,67%,100,97,103,20%,27%,16%,2,2,0,2,1,1
167,https://vlr.gg/player/40002/outcazt,2024-07-31 13:30:00,0.51,0.83,0.67,167,159,175,19,9,10,30,15,15,5,1,4,0,-1,+1,60%,65%,56%,120,108,132,31%,21%,44%,4,2,2,4,3,1
168,https://vlr.gg/player/4201/m4xikk,2024-07-31 13:30:00,0.75,0.61,0.67,164,177,158,19,10,9,28,14,14,9,7,2,+1,0,+1,71%,76%,67%,100,107,94,39%,34%,45%,3,0,3,2,0,2
169,https://vlr.gg/player/33731/stonezy,2024-07-31 13:30:00,0.52,0.72,0.62,163,157,168,20,10,10,30,14,16,4,0,4,-3,-5,+2,54%,35%,72%,107,104,110,33%,35%,32%,4,1,3,7,6,1
170,https://vlr.gg/player/41731/julc-esar,2024-07-31 11:30:00,1.18,1.09,1.14,221,228,221,79,45,34,70,37,33,13,6,7,0,+1,-1,66%,65%,68%,157,160,153,37%,34%,39%,7,4,3,7,3,4
171,https://vlr.gg/player/42348/elyxo,2024-07-31 11:30:00,0.95,1.06,1.00,204,191,243,71,35,36,74,39,35,29,20,9,-2,-2,0,63%,59%,68%,142,129,158,40%,33%,48%,9,4,5,11,6,5
172,https://vlr.gg/player/23487/flick,2024-07-31 11:30:00,1.01,0.85,0.94,194,230,168,71,43,28,76,44,32,6,5,1,+1,-6,+7,61%,57%,66%,128,145,106,34%,36%,31%,13,3,10,12,9,3
173,https://vlr.gg/player/41686/k-llua,2024-07-31 11:30:00,0.89,0.89,0.89,188,184,189,63,34,29,75,42,33,15,6,9,-2,-2,0,67%,67%,68%,121,113,130,45%,52%,38%,14,9,5,16,11,5
174,https://vlr.gg/player/23489/hunter,2024-07-31 11:30:00,0.60,0.73,0.65,114,103,130,40,20,20,73,41,32,25,13,12,-3,-5,+2,64%,63%,66%,74,67,82,29%,38%,22%,3,0,3,6,5,1
175,https://vlr.gg/player/12226/sturnn,2024-07-31 11:30:00,1.21,1.01,1.10,240,243,228,85,41,44,69,31,38,31,14,17,-4,-5,+1,70%,70%,70%,148,145,149,21%,17%,26%,7,1,6,11,6,5
176,https://vlr.gg/player/5563/cacan,2024-07-31 11:30:00,1.19,1.00,1.08,199,197,199,70,31,39,63,27,36,24,10,14,+1,-1,+2,74%,70%,78%,131,132,131,30%,27%,33%,6,2,4,5,3,2
177,https://vlr.gg/player/5564/deadink,2024-07-31 11:30:00,0.74,1.30,1.05,244,194,271,80,29,51,66,33,33,19,9,10,+3,-4,+7,67%,66%,69%,154,134,171,16%,23%,10%,20,8,12,17,12,5
178,https://vlr.gg/player/19776/jrayn,2024-07-31 11:30:00,0.93,1.10,1.03,185,176,193,69,29,40,61,28,33,32,18,14,+4,0,+4,76%,68%,81%,123,112,131,39%,49%,34%,9,3,6,5,3,2
179,https://vlr.gg/player/31307/yigox,2024-07-31 11:30:00,1.17,0.74,0.93,185,229,153,64,35,29,65,28,37,20,12,8,+2,+2,0,67%,70%,65%,122,150,99,29%,22%,41%,10,4,6,8,2,6
180,https://vlr.gg/player/5810/kryo,2024-07-31 11:00:00,0.81,1.26,1.05,201,159,236,30,10,20,31,14,17,8,2,6,-1,0,-1,68%,65%,71%,140,129,150,44%,37%,51%,2,1,1,3,1,2
181,https://vlr.gg/player/5487/adm1k,2024-07-31 11:00:00,0.99,1.06,1.03,217,175,246,31,12,19,35,14,21,10,4,6,0,0,0,61%,55%,67%,146,119,168,36%,48%,29%,2,0,2,2,0,2
182,https://vlr.gg/player/9143/darkosek,2024-07-31 11:00:00,1.00,0.78,0.88,177,173,181,28,13,15,34,13,21,1,0,1,+3,+2,+1,61%,65%,58%,124,117,129,44%,44%,43%,7,4,3,4,2,2
183,https://vlr.gg/player/19505/szalony,2024-07-31 11:00:00,0.90,0.78,0.84,203,228,186,29,16,13,37,17,20,5,1,4,-3,-1,-2,55%,60%,50%,136,150,125,32%,40%,24%,5,2,3,8,3,5
184,https://vlr.gg/player/5488/mermi,2024-07-31 11:00:00,0.50,0.40,0.44,99,137,71,16,10,6,36,17,19,6,3,3,-5,-1,-4,50%,65%,38%,73,92,56,56%,64%,46%,3,3,0,8,4,4
185,https://vlr.gg/player/6547/1ce2k,2024-07-31 11:00:00,1.60,1.43,1.53,280,278,288,46,25,21,24,13,11,17,9,8,+2,+2,0,91%,96%,85%,180,187,172,39%,40%,38%,4,2,2,2,0,2
186,https://vlr.gg/player/33731/stonezy,2024-07-31 11:00:00,1.17,1.59,1.36,290,277,304,47,24,23,28,18,10,6,3,3,+4,+4,0,82%,75%,90%,192,193,190,24%,25%,23%,9,6,3,5,2,3
187,https://vlr.gg/player/2614/tankzor,2024-07-31 11:00:00,0.95,0.99,0.97,190,180,204,30,16,14,27,13,14,2,1,1,+2,+2,0,73%,75%,70%,137,115,162,50%,56%,44%,5,3,2,3,1,2
188,https://vlr.gg/player/4201/m4xikk,2024-07-31 11:00:00,1.10,0.76,0.95,170,184,152,26,16,10,24,13,11,18,10,8,+1,0,+1,66%,71%,60%,113,129,94,40%,39%,43%,6,3,3,5,3,2
189,https://vlr.gg/player/40002/outcazt,2024-07-31 11:00:00,0.84,0.50,0.68,139,165,105,24,17,7,31,16,15,10,6,4,-3,-2,-1,70%,75%,65%,96,114,75,24%,28%,15%,1,1,0,4,3,1
190,https://vlr.gg/player/402/insider,2024-07-31 10:00:00,0.98,1.03,1.00,209,188,237,45,21,24,48,24,24,9,3,6,+3,+2,+1,63%,56%,71%,147,129,166,30%,27%,33%,8,4,4,5,2,3
191,https://vlr.gg/player/251/b1sk,2024-07-31 10:00:00,1.11,0.85,0.96,183,203,163,45,26,19,45,23,22,6,0,6,-1,+1,-2,62%,65%,58%,124,139,107,27%,33%,22%,9,6,3,10,5,5
192,https://vlr.gg/player/443/zeddy,2024-07-31 10:00:00,0.95,0.52,0.74,154,207,104,31,23,8,48,25,23,30,14,16,-6,-2,-4,65%,68%,61%,102,131,70,18%,24%,9%,1,1,0,7,3,4
193,https://vlr.gg/player/2894/kiles,2024-07-31 10:00:00,0.41,1.08,0.73,127,84,176,29,9,20,46,27,19,24,16,8,-3,-2,-1,72%,62%,84%,88,50,131,33%,15%,42%,2,0,2,5,2,3
194,https://vlr.gg/player/33902/sayonara,2024-07-31 10:00:00,0.55,0.91,0.72,169,152,186,39,17,22,54,30,24,13,8,5,-8,-7,-1,60%,53%,68%,114,100,128,33%,39%,26%,5,2,3,13,9,4
195,https://vlr.gg/player/1835/elllement,2024-07-31 10:00:00,1.42,1.30,1.36,277,314,244,63,34,29,41,22,19,12,6,6,+14,+10,+4,77%,81%,74%,194,207,182,35%,39%,31%,20,11,9,6,1,5
196,https://vlr.gg/player/4329/vince,2024-07-31 10:00:00,1.20,1.32,1.26,250,234,261,61,29,32,42,19,23,22,8,14,+2,+1,+1,72%,71%,74%,149,134,162,24%,21%,26%,5,2,3,3,1,2
197,https://vlr.gg/player/10885/davih,2024-07-31 10:00:00,1.26,1.15,1.20,195,177,212,43,20,23,32,14,18,13,5,8,+1,-2,+3,77%,77%,76%,137,127,146,25%,35%,18%,3,0,3,2,2,0
198,https://vlr.gg/player/7490/anguist,2024-07-31 10:00:00,1.20,1.00,1.10,204,203,214,48,22,26,40,18,22,8,2,6,+1,+1,0,71%,74%,68%,152,154,150,37%,34%,39%,6,2,4,5,1,4
199,https://vlr.gg/player/2472/benny,2024-07-31 10:00:00,0.50,1.08,0.80,121,77,153,26,7,19,34,20,14,14,6,8,-3,-3,0,69%,65%,74%,80,55,102,23%,24%,22%,6,4,2,9,7,2
200,https://vlr.gg/player/16842/mojer,2024-07-31 03:00:00,1.14,1.25,1.20,270,282,257,110,54,56,91,45,46,22,10,12,+7,+1,+6,72%,73%,71%,173,175,170,26%,27%,24%,25,13,12,18,12,6
201,https://vlr.gg/player/13220/ja,2024-07-31 03:00:00,1.29,1.04,1.15,231,261,213,103,53,50,83,38,45,37,17,20,0,-3,+3,72%,75%,70%,153,174,134,26%,25%,29%,11,2,9,11,5,6
202,https://vlr.gg/player/13219/papi,2024-07-31 03:00:00,1.08,0.93,1.00,175,188,156,71,36,35,74,36,38,43,24,19,-8,-1,-7,74%,75%,73%,115,121,109,26%,30%,22%,5,4,1,13,5,8
203,https://vlr.gg/player/7749/nexi,2024-07-31 03:00:00,0.89,1.07,0.98,193,160,225,81,33,48,83,36,47,28,10,18,-1,-3,+2,71%,66%,76%,128,116,139,33%,41%,28%,7,2,5,8,5,3
204,https://vlr.gg/player/9747/emman,2024-07-31 03:00:00,0.90,0.96,0.93,189,169,192,74,34,40,84,38,46,54,22,32,-1,-2,+1,72%,77%,68%,116,113,119,29%,31%,27%,10,3,7,11,5,6
205,https://vlr.gg/player/16953/zynd,2024-07-31 03:00:00,0.86,1.18,1.01,232,218,251,101,49,52,94,49,45,21,9,12,+10,-1,+11,71%,68%,75%,149,143,155,29%,34%,24%,25,12,13,15,13,2
206,https://vlr.gg/player/21677/jeee,2024-07-31 03:00:00,1.17,0.83,1.00,182,205,164,74,45,29,82,41,41,51,31,20,-6,-4,-2,71%,79%,63%,131,149,112,32%,33%,29%,6,2,4,12,6,6
207,https://vlr.gg/player/9737/kakarot,2024-07-31 03:00:00,0.78,1.19,0.97,210,205,224,82,40,42,91,54,37,50,26,24,-3,-5,+2,75%,67%,84%,139,131,149,24%,21%,28%,11,6,5,14,11,3
208,https://vlr.gg/player/13744/patmen,2024-07-31 03:00:00,1.03,0.91,0.97,208,206,205,85,47,38,89,45,44,26,12,14,+4,+4,0,71%,71%,70%,144,144,144,30%,39%,24%,13,7,6,9,3,6
209,https://vlr.gg/player/7746/kevzii,2024-07-31 03:00:00,1.01,0.74,0.88,175,178,173,73,41,32,83,40,43,25,12,13,-2,+1,-3,66%,73%,57%,123,128,116,34%,39%,28%,6,2,4,8,1,7
210,https://vlr.gg/player/37923/oasis,2024-07-30 21:20:00,1.06,1.34,1.19,261,221,302,40,17,23,33,17,16,6,3,3,+12,+5,+7,78%,74%,82%,165,146,184,27%,22%,33%,16,7,9,4,2,2
211,https://vlr.gg/player/17982/lunafox,2024-07-30 21:20:00,1.19,0.96,1.08,238,268,208,40,24,16,36,18,18,9,5,4,-1,0,-1,71%,78%,64%,152,164,140,33%,30%,37%,4,2,2,5,2,3
212,https://vlr.gg/player/28387/fire,2024-07-30 21:20:00,1.18,0.37,0.79,162,213,110,25,18,7,32,14,18,10,6,4,-2,0,-2,76%,83%,68%,114,146,80,25%,31%,16%,2,2,0,4,2,2
213,https://vlr.gg/player/39565/ellie,2024-07-30 21:20:00,0.71,0.65,0.68,168,161,178,26,13,13,35,17,18,12,5,7,-1,-1,0,62%,65%,59%,106,107,106,30%,39%,23%,2,1,1,3,2,1
214,https://vlr.gg/player/36737/alexaishot,2024-07-30 21:20:00,0.60,0.71,0.65,141,119,165,21,10,11,35,18,17,18,10,8,-1,+1,-2,73%,70%,77%,96,82,110,19%,31%,13%,2,2,0,3,1,2
215,https://vlr.gg/player/12055/mmonch,2024-07-30 21:20:00,1.78,1.10,1.43,217,257,180,37,22,15,23,8,15,17,6,11,-1,-2,+1,78%,77%,78%,152,167,137,45%,52%,38%,2,1,1,3,3,0
216,https://vlr.gg/player/20538/linlin,2024-07-30 21:20:00,1.13,1.46,1.30,244,217,271,41,18,23,32,16,16,14,6,8,+3,+2,+1,82%,86%,78%,149,137,161,29%,17%,41%,4,2,2,1,0,1
217,https://vlr.gg/player/20539/juw,2024-07-30 21:20:00,1.15,0.96,1.05,237,246,230,36,19,17,34,16,18,12,8,4,-3,-1,-2,71%,73%,70%,158,163,153,28%,23%,34%,6,3,3,9,4,5
218,https://vlr.gg/player/20491/ivy,2024-07-30 21:20:00,0.86,1.00,0.93,190,185,196,31,14,17,32,16,16,12,8,4,-5,-1,-4,64%,64%,65%,129,125,133,32%,33%,31%,3,2,1,8,3,5
219,https://vlr.gg/player/20537/andrehs,2024-07-30 21:20:00,1.05,0.82,0.93,173,180,165,26,14,12,31,14,17,20,12,8,-1,0,-1,71%,77%,65%,119,117,121,35%,30%,38%,4,2,2,5,2,3
220,https://vlr.gg/player/14690/lissa,2024-07-30 17:50:00,1.07,1.39,1.22,238,219,267,62,29,33,52,29,23,19,7,12,+1,-2,+3,75%,69%,82%,170,153,188,41%,36%,46%,10,3,7,9,5,4
221,https://vlr.gg/player/24764/akame,2024-07-30 17:50:00,0.61,1.41,0.99,228,154,319,54,18,36,57,33,24,21,9,12,0,-1,+1,68%,61%,76%,146,99,198,34%,43%,31%,7,2,5,7,3,4
222,https://vlr.gg/player/6994/shyz,2024-07-30 17:50:00,0.82,1.05,0.93,168,171,171,38,19,19,49,30,19,25,14,11,+1,-1,+2,68%,64%,73%,112,114,108,19%,15%,24%,5,2,3,4,3,1
223,https://vlr.gg/player/24763/speedy,2024-07-30 17:50:00,0.72,0.98,0.85,169,149,189,40,18,22,53,30,23,21,10,11,-3,-4,+1,61%,56%,67%,121,102,141,24%,21%,26%,4,1,3,7,5,2
224,https://vlr.gg/player/29179/vii,2024-07-30 17:50:00,0.75,0.69,0.72,157,184,129,36,22,14,54,30,24,17,7,10,-4,-2,-2,64%,53%,76%,109,117,100,30%,27%,33%,6,5,1,10,7,3
225,https://vlr.gg/player/14291/mindle,2024-07-30 17:50:00,1.16,1.28,1.22,224,212,236,59,27,32,46,23,23,30,12,18,+8,+1,+7,81%,82%,81%,131,125,137,31%,26%,36%,8,1,7,0,0,0
226,https://vlr.gg/player/11256/isa1,2024-07-30 17:50:00,0.87,1.40,1.15,203,172,244,50,18,32,40,23,17,25,13,12,-1,0,-1,77%,70%,83%,139,110,166,21%,11%,29%,2,0,2,3,0,3
227,https://vlr.gg/player/42397/winter,2024-07-30 17:50:00,0.71,1.52,1.13,280,210,335,67,24,43,51,28,23,13,2,11,-3,-8,+5,77%,67%,86%,180,140,218,25%,32%,22%,12,4,8,15,12,3
228,https://vlr.gg/player/19255/luiza,2024-07-30 17:50:00,0.97,0.92,0.94,192,205,176,47,23,24,48,25,23,12,4,8,-3,-1,-2,74%,70%,78%,129,131,128,32%,36%,29%,5,4,1,8,5,3
229,https://vlr.gg/player/11244/gabit,2024-07-30 17:50:00,0.84,1.01,0.93,171,196,154,42,21,21,45,25,20,16,10,6,+4,+3,+1,72%,64%,81%,116,122,111,22%,27%,17%,10,5,5,6,2,4
230,https://vlr.gg/player/17433/v1c,2024-07-30 16:00:00,1.08,1.49,1.27,269,250,284,64,32,32,44,28,16,23,12,11,+3,+3,0,78%,78%,77%,164,150,181,28%,26%,30%,9,6,3,6,3,3
231,https://vlr.gg/player/2172/brawk,2024-07-30 16:00:00,1.03,1.42,1.20,243,199,308,58,25,33,47,27,20,18,9,9,+6,0,+6,68%,68%,68%,156,133,183,17%,20%,15%,7,0,7,1,0,1
232,https://vlr.gg/player/1851/oderus,2024-07-30 16:00:00,0.86,1.11,0.97,180,160,208,46,21,25,45,26,19,16,7,9,-1,-1,0,72%,73%,71%,125,117,134,37%,29%,48%,3,1,2,4,2,2
233,https://vlr.gg/player/5132/mada,2024-07-30 16:00:00,0.76,0.53,0.66,142,162,123,31,19,12,49,27,22,12,6,6,-6,-1,-5,59%,62%,55%,97,105,87,23%,24%,21%,10,8,2,16,9,7
234,https://vlr.gg/player/3685/flyuh,2024-07-30 16:00:00,0.52,0.78,0.64,145,141,149,34,18,16,54,32,22,25,10,15,-8,-8,0,71%,68%,74%,95,96,93,26%,31%,22%,2,0,2,10,8,2
235,https://vlr.gg/player/8376/seven,2024-07-30 16:00:00,1.23,1.56,1.41,263,219,284,60,22,38,41,21,20,24,13,11,+5,+1,+4,78%,77%,78%,154,136,169,14%,16%,12%,8,3,5,3,2,1
236,https://vlr.gg/player/740/aproto,2024-07-30 16:00:00,1.09,1.25,1.18,229,227,223,56,25,31,44,23,21,15,3,12,+4,+2,+2,78%,71%,84%,148,143,151,41%,44%,39%,6,3,3,2,1,1
237,https://vlr.gg/player/3702/sym,2024-07-30 16:00:00,1.11,0.83,0.96,207,229,201,50,25,25,52,24,28,8,4,4,+5,+2,+3,59%,61%,57%,140,161,123,30%,40%,23%,17,8,9,12,6,6
238,https://vlr.gg/player/64/gmd,2024-07-30 16:00:00,0.61,1.15,0.90,178,157,197,40,15,25,48,28,20,25,12,13,-7,-5,-2,79%,68%,89%,122,110,132,27%,28%,27%,1,0,1,8,5,3
239,https://vlr.gg/player/849/poised,2024-07-30 16:00:00,0.63,0.83,0.74,134,113,158,33,12,21,48,22,26,22,9,13,-1,-1,0,59%,55%,62%,92,79,102,31%,30%,32%,5,1,4,6,2,4
240,https://vlr.gg/player/22997/waved,2024-07-30 16:00:00,1.43,1.58,1.48,326,348,287,43,29,14,25,17,8,9,7,2,-2,-3,+1,78%,79%,77%,213,219,202,31%,29%,37%,6,3,3,8,6,2
241,https://vlr.gg/player/11236/antg,2024-07-30 16:00:00,1.60,1.24,1.47,234,252,185,33,24,9,19,10,9,20,12,8,+2,+2,0,81%,88%,69%,134,150,104,23%,26%,15%,2,2,0,0,0,0
242,https://vlr.gg/player/9821/m4ndzin,2024-07-30 16:00:00,1.51,1.07,1.35,242,250,240,33,23,10,20,10,10,15,7,8,0,+2,-2,73%,79%,62%,159,163,151,34%,31%,39%,5,4,1,5,2,3
243,https://vlr.gg/player/27724/natasha,2024-07-30 16:00:00,1.13,0.82,1.02,178,210,118,23,19,4,21,12,9,11,7,4,+4,+3,+1,78%,83%,69%,119,144,75,32%,31%,36%,5,3,2,1,0,1
244,https://vlr.gg/player/11242/blu,2024-07-30 16:00:00,1.09,0.51,0.88,122,145,84,16,12,4,20,10,10,12,7,5,-3,-2,-1,62%,67%,54%,91,108,61,30%,31%,27%,1,1,0,4,3,1
245,https://vlr.gg/player/2245/krysme,2024-07-30 16:00:00,1.20,0.94,1.03,227,229,225,30,12,18,29,8,21,5,1,4,+3,+1,+2,62%,69%,58%,162,161,163,51%,56%,49%,6,1,5,3,0,3
246,https://vlr.gg/player/29823/mizzy,2024-07-30 16:00:00,0.96,0.72,0.81,180,213,172,23,10,13,31,9,22,9,2,7,0,+1,-1,62%,85%,50%,124,123,124,37%,28%,42%,3,2,1,3,1,2
247,https://vlr.gg/player/11262/kalita,2024-07-30 16:00:00,1.08,0.60,0.77,160,208,130,20,10,10,29,8,21,10,6,4,+1,+1,0,62%,85%,50%,114,144,98,30%,31%,30%,3,1,2,2,0,2
248,https://vlr.gg/player/2199/drn,2024-07-30 16:00:00,0.81,0.68,0.72,140,146,139,16,6,10,29,8,21,11,5,6,+1,0,+1,62%,69%,58%,97,100,95,19%,15%,22%,4,2,2,3,2,1
249,https://vlr.gg/player/25580/jenny,2024-07-30 16:00:00,0.87,0.38,0.55,133,167,114,16,8,8,30,8,22,6,2,4,-6,-2,-4,57%,69%,50%,95,120,82,31%,36%,26%,2,1,1,8,3,5
250,https://vlr.gg/player/5517/masic,2024-07-30 14:15:00,1.27,1.04,1.15,214,216,212,43,20,23,42,18,24,15,10,5,+4,+3,+1,74%,81%,68%,142,146,139,33%,38%,30%,7,4,3,3,1,2
251,https://vlr.gg/player/4962/lurzy0y0,2024-07-30 14:15:00,0.57,1.22,0.91,140,103,174,30,10,20,39,21,18,18,8,10,+1,-1,+2,66%,56%,74%,99,71,124,30%,18%,38%,3,1,2,2,2,0
252,https://vlr.gg/player/6559/destruct1vee,2024-07-30 14:15:00,0.87,0.88,0.88,177,186,171,38,19,19,43,21,22,17,9,8,-4,0,-4,78%,81%,74%,112,112,112,28%,34%,23%,5,4,1,9,4,5
253,https://vlr.gg/player/7353/glovee,2024-07-30 14:15:00,0.91,0.83,0.87,182,181,185,36,17,19,45,21,24,17,11,6,+4,0,+4,74%,78%,71%,111,106,115,30%,33%,28%,8,2,6,4,2,2
254,https://vlr.gg/player/10137/ip0tt,2024-07-30 14:15:00,0.82,0.65,0.73,195,226,166,36,19,17,48,21,27,8,5,3,-9,-5,-4,64%,67%,61%,135,170,105,28%,28%,28%,4,1,3,13,6,7
255,https://vlr.gg/player/7490/anguist,2024-07-30 14:15:00,1.43,1.36,1.40,237,233,243,50,25,25,31,15,16,12,6,6,0,+1,-1,79%,81%,78%,164,167,161,39%,36%,43%,7,5,2,7,4,3
256,https://vlr.gg/player/10885/davih,2024-07-30 14:15:00,1.27,1.18,1.23,213,215,211,43,23,20,32,16,16,24,16,8,+3,+3,0,83%,87%,78%,144,147,142,19%,21%,17%,5,3,2,2,0,2
257,https://vlr.gg/player/1835/elllement,2024-07-30 14:15:00,0.87,1.25,1.05,229,205,261,49,24,25,39,23,16,6,4,2,+5,+1,+4,69%,71%,67%,147,141,155,30%,36%,24%,12,4,8,7,3,4
258,https://vlr.gg/player/4329/vince,2024-07-30 14:15:00,1.03,0.84,0.94,194,216,173,40,25,15,39,21,18,20,7,13,0,+1,-1,78%,84%,70%,118,132,103,26%,33%,17%,3,3,0,3,2,1
259,https://vlr.gg/player/2472/benny,2024-07-30 14:15:00,0.68,0.86,0.76,160,157,164,35,18,17,42,23,19,10,5,5,-4,-5,+1,66%,58%,74%,109,105,112,33%,33%,33%,4,1,3,8,6,2
260,https://vlr.gg/player/6998/nvrfear,2024-07-30 14:00:00,0.64,1.64,1.13,233,155,317,37,12,25,34,22,12,20,8,12,+3,-1,+4,79%,71%,87%,142,97,189,18%,33%,14%,4,0,4,1,1,0
261,https://vlr.gg/player/10429/luvjix,2024-07-30 14:00:00,0.65,1.39,1.01,190,153,230,31,12,19,31,20,11,16,5,11,+4,+2,+2,77%,71%,83%,130,105,156,24%,29%,21%,6,3,3,2,1,1
262,https://vlr.gg/player/8034/thenightche,2024-07-30 14:00:00,0.88,0.96,0.92,164,170,159,27,16,11,33,19,14,9,2,7,+1,+2,-1,70%,67%,74%,109,108,109,18%,25%,12%,3,2,1,2,0,2
263,https://vlr.gg/player/44170/niwt,2024-07-30 14:00:00,0.79,1.00,0.89,201,195,206,32,15,17,37,21,16,9,2,7,+2,0,+2,64%,58%,70%,128,123,133,24%,28%,19%,11,6,5,9,6,3
264,https://vlr.gg/player/3860/al1en,2024-07-30 14:00:00,0.74,0.96,0.85,159,156,162,26,13,13,32,19,13,16,4,12,-5,-3,-2,72%,63%,83%,102,107,97,16%,18%,14%,2,1,1,7,4,3
265,https://vlr.gg/player/29553/dagg3r,2024-07-30 14:00:00,0.73,1.79,1.27,277,181,367,47,14,33,31,18,13,4,2,2,+6,+2,+4,81%,74%,88%,170,118,220,39%,32%,44%,11,6,5,5,4,1
266,https://vlr.gg/player/2431/basya,2024-07-30 14:00:00,0.72,1.54,1.14,239,172,304,39,13,26,32,18,14,10,4,6,+1,-1,+2,81%,70%,92%,160,118,200,27%,25%,29%,7,3,4,6,4,2
267,https://vlr.gg/player/7268/6ix,2024-07-30 14:00:00,1.16,0.76,0.96,149,181,117,25,16,9,26,13,13,17,5,12,-2,0,-2,77%,74%,79%,98,114,83,23%,36%,9%,0,0,0,2,0,2
268,https://vlr.gg/player/16259/tweethy,2024-07-30 14:00:00,0.54,1.18,0.87,172,138,207,26,10,16,32,19,13,19,9,10,-4,-3,-1,68%,61%,75%,112,81,141,19%,16%,21%,1,0,1,5,3,2
269,https://vlr.gg/player/33358/shinnok,2024-07-30 14:00:00,0.85,0.85,0.85,182,175,188,30,13,17,32,17,15,7,5,2,-6,-3,-3,62%,65%,58%,113,112,114,32%,47%,22%,2,0,2,8,3,5
270,https://vlr.gg/player/41686/k-llua,2024-07-30 12:10:00,1.00,1.41,1.20,242,220,267,59,26,33,49,28,21,17,13,4,+8,+1,+7,76%,75%,78%,154,137,173,45%,41%,49%,15,7,8,7,6,1
271,https://vlr.gg/player/42348/elyxo,2024-07-30 12:10:00,0.86,1.15,0.99,221,206,250,54,26,28,55,29,26,34,14,20,0,-4,+4,78%,78%,78%,142,137,149,30%,32%,27%,4,0,4,4,4,0
272,https://vlr.gg/player/23487/flick,2024-07-30 12:10:00,0.72,1.09,0.89,186,161,220,48,21,27,53,31,22,8,3,5,+3,0,+3,62%,61%,63%,122,98,150,37%,36%,39%,10,4,6,7,4,3
273,https://vlr.gg/player/41731/julc-esar,2024-07-30 12:10:00,1.07,0.63,0.86,171,214,121,39,29,10,49,28,21,16,8,8,-6,-4,-2,68%,67%,69%,122,150,90,21%,23%,18%,1,0,1,7,4,3
274,https://vlr.gg/player/23489/hunter,2024-07-30 12:10:00,0.71,0.93,0.81,167,162,167,39,21,18,50,30,20,15,7,8,+1,-1,+2,60%,58%,63%,106,99,113,42%,41%,43%,7,3,4,6,4,2
275,https://vlr.gg/player/39351/wezzy,2024-07-30 12:10:00,1.34,1.18,1.26,255,273,240,64,32,32,49,24,25,12,4,8,-2,-3,+1,68%,63%,72%,176,190,164,42%,50%,36%,5,1,4,7,4,3
276,https://vlr.gg/player/16552/pckwn,2024-07-30 12:10:00,1.04,1.37,1.21,242,207,265,55,21,34,45,22,23,22,11,11,+2,0,+2,74%,66%,81%,166,141,188,24%,21%,26%,8,3,5,6,3,3
277,https://vlr.gg/player/3862/deepmans,2024-07-30 12:10:00,0.80,1.47,1.15,256,199,300,64,22,42,50,25,25,11,7,4,0,-4,+4,74%,66%,81%,164,136,188,44%,42%,45%,11,3,8,11,7,4
278,https://vlr.gg/player/40843/audaz,2024-07-30 12:10:00,1.06,0.92,0.98,170,181,167,40,21,19,44,21,23,31,14,17,-2,-2,0,74%,69%,78%,120,126,114,41%,41%,42%,3,1,2,5,3,2
279,https://vlr.gg/player/13545/werlass,2024-07-30 12:10:00,0.72,0.86,0.79,159,146,177,33,15,18,52,24,28,37,15,22,-4,-5,+1,75%,72%,78%,107,97,116,28%,29%,27%,4,1,3,8,6,2
280,https://vlr.gg/player/33731/stonezy,2024-07-30 12:00:00,0.72,1.19,0.86,190,176,256,23,14,9,29,20,9,2,0,2,+1,+1,0,58%,54%,67%,132,106,185,19%,23%,15%,7,6,1,6,5,1
281,https://vlr.gg/player/40002/outcazt,2024-07-30 12:00:00,0.85,0.49,0.73,161,171,122,17,12,5,28,18,10,5,4,1,-1,0,-1,56%,63%,42%,113,126,85,36%,34%,42%,1,1,0,2,1,1
282,https://vlr.gg/player/2614/tankzor,2024-07-30 12:00:00,0.46,1.12,0.68,177,134,260,22,10,12,31,21,10,5,4,1,-1,-3,+2,56%,50%,67%,106,89,141,43%,41%,45%,4,1,3,5,4,1
283,https://vlr.gg/player/4201/m4xikk,2024-07-30 12:00:00,0.66,0.49,0.60,123,138,123,17,12,5,28,19,9,7,4,3,-6,-5,-1,58%,58%,58%,87,89,84,22%,16%,35%,0,0,0,6,5,1
284,https://vlr.gg/player/6547/1ce2k,2024-07-30 12:00:00,0.64,0.33,0.52,107,113,112,14,9,5,30,19,11,2,2,0,+1,+1,0,50%,58%,33%,83,87,77,24%,21%,33%,3,1,2,2,0,2
285,https://vlr.gg/player/29553/dagg3r,2024-07-30 12:00:00,1.68,1.70,1.69,309,316,315,42,15,27,20,8,12,8,1,7,-1,0,-1,69%,58%,75%,197,194,198,45%,68%,36%,5,2,3,6,2,4
286,https://vlr.gg/player/16259/tweethy,2024-07-30 12:00:00,0.85,1.60,1.35,238,126,277,29,5,24,19,8,11,17,6,11,+4,0,+4,78%,75%,79%,145,73,181,28%,15%,32%,6,2,4,2,2,0
287,https://vlr.gg/player/7268/6ix,2024-07-30 12:00:00,1.12,1.26,1.22,206,168,237,27,7,20,19,6,13,10,4,6,+3,+1,+2,78%,83%,75%,152,128,164,38%,42%,36%,4,1,3,1,0,1
288,https://vlr.gg/player/33358/shinnok,2024-07-30 12:00:00,1.33,1.01,1.12,194,257,162,25,11,14,17,7,10,5,3,2,0,-1,+1,75%,75%,75%,125,165,104,24%,33%,15%,4,1,3,4,2,2
289,https://vlr.gg/player/2431/basya,2024-07-30 12:00:00,1.31,0.92,1.05,180,244,137,23,11,12,18,7,11,7,3,4,0,0,0,75%,83%,71%,122,164,101,18%,17%,19%,2,0,2,2,0,2
290,https://vlr.gg/player/33902/sayonara,2024-07-30 11:00:00,1.83,1.45,1.65,341,386,311,75,43,32,37,19,18,12,9,3,+9,+2,+7,84%,87%,81%,223,231,213,35%,33%,37%,14,6,8,5,4,1
291,https://vlr.gg/player/251/b1sk,2024-07-30 11:00:00,1.03,1.19,1.11,225,235,227,49,28,21,37,21,16,9,6,3,+7,+1,+6,76%,74%,78%,146,152,138,22%,20%,23%,13,6,7,6,5,1
292,https://vlr.gg/player/2894/kiles,2024-07-30 11:00:00,0.98,0.87,0.93,157,148,148,32,18,14,35,17,18,25,12,13,-2,-1,-1,76%,77%,74%,101,102,101,26%,29%,23%,1,1,0,3,2,1
293,https://vlr.gg/player/402/insider,2024-07-30 11:00:00,1.00,0.74,0.88,167,158,156,34,19,15,34,18,16,11,5,6,-4,0,-4,64%,68%,59%,109,115,102,28%,30%,26%,3,2,1,7,2,5
294,https://vlr.gg/player/443/zeddy,2024-07-30 11:00:00,0.76,0.89,0.82,167,137,188,33,16,17,37,19,18,17,8,9,0,-1,+1,69%,68%,70%,102,86,121,14%,11%,17%,3,1,2,3,2,1
295,https://vlr.gg/player/6889/neskaas,2024-07-30 11:00:00,0.97,1.04,1.00,185,188,209,40,18,22,45,20,25,10,3,7,+1,-2,+3,60%,56%,65%,134,122,144,27%,31%,24%,7,2,5,6,4,2
296,https://vlr.gg/player/314/ambi,2024-07-30 11:00:00,1.35,0.69,1.00,195,231,168,42,23,19,42,16,26,14,7,7,-5,-2,-3,66%,74%,58%,123,137,110,30%,27%,33%,2,2,0,7,4,3
297,https://vlr.gg/player/2653/jesse,2024-07-30 11:00:00,0.94,0.86,0.90,158,163,164,32,13,19,42,18,24,15,10,5,-5,-2,-3,52%,56%,48%,113,117,109,27%,30%,25%,3,1,2,8,3,5
298,https://vlr.gg/player/8805/sacake,2024-07-30 11:00:00,0.85,0.79,0.82,164,161,158,31,15,16,44,21,23,16,9,7,-2,-2,0,64%,67%,61%,103,101,105,31%,29%,33%,3,0,3,5,2,3
299,https://vlr.gg/player/252/d3ffo,2024-07-30 11:00:00,0.62,0.74,0.68,172,182,178,34,17,17,51,25,26,8,5,3,+1,-1,+2,57%,56%,58%,123,120,125,25%,34%,19%,9,4,5,8,5,3
300,https://vlr.gg/player/41719/mepeezy,2024-07-30 10:30:00,0.67,0.95,0.80,212,182,255,21,10,11,31,17,14,10,3,7,+2,0,+2,56%,47%,67%,137,105,174,24%,21%,26%,4,2,2,2,2,0
301,https://vlr.gg/player/23493/panexa,2024-07-30 10:30:00,0.70,0.69,0.68,147,141,149,16,8,8,28,15,13,2,0,2,-1,-2,+1,53%,41%,67%,97,100,94,37%,40%,35%,3,0,3,4,2,2
302,https://vlr.gg/player/22675/brady,2024-07-30 10:30:00,0.58,0.68,0.63,136,123,155,14,6,8,27,15,12,4,3,1,-2,-1,-1,44%,47%,40%,93,79,108,20%,29%,14%,0,0,0,2,1,1
303,https://vlr.gg/player/39353/ra1no,2024-07-30 10:30:00,0.40,0.81,0.59,159,147,171,17,7,10,29,17,12,4,3,1,-8,-6,-2,53%,53%,53%,102,97,108,33%,30%,37%,1,0,1,9,6,3
304,https://vlr.gg/player/40595/var,2024-07-30 10:30:00,0.21,0.83,0.49,108,69,163,11,3,8,29,17,12,9,2,7,-3,-2,-1,59%,41%,80%,66,54,80,25%,21%,29%,2,1,1,5,3,2
305,https://vlr.gg/player/19776/jrayn,2024-07-30 10:30:00,1.56,1.76,1.66,269,263,270,34,15,19,14,8,6,14,4,10,+1,-1,+2,94%,87%,100%,172,188,157,47%,38%,59%,2,0,2,1,1,0
306,https://vlr.gg/player/12226/sturnn,2024-07-30 10:30:00,1.13,1.69,1.43,280,224,324,32,12,20,17,9,8,9,5,4,+3,0,+3,88%,73%,100%,186,137,229,42%,40%,43%,4,1,3,1,1,0
307,https://vlr.gg/player/5563/cacan,2024-07-30 10:30:00,1.08,1.38,1.23,237,206,271,28,11,17,17,9,8,8,2,6,+2,-1,+3,81%,73%,88%,151,135,166,36%,56%,27%,5,2,3,3,3,0
308,https://vlr.gg/player/5564/deadink,2024-07-30 10:30:00,0.89,1.31,1.11,233,185,269,28,11,17,19,11,8,2,0,2,+6,+2,+4,69%,60%,76%,144,125,160,28%,35%,24%,10,4,6,4,2,2
309,https://vlr.gg/player/31307/yigox,2024-07-30 10:30:00,1.15,1.07,1.11,174,248,114,22,14,8,12,8,4,3,2,1,0,+1,-1,84%,80%,88%,119,162,80,50%,58%,38%,1,1,0,1,0,1
310,https://vlr.gg/player/9143/darkosek,2024-07-30 09:00:00,0.82,1.08,0.94,216,179,269,49,23,26,48,26,22,15,8,7,+1,-1,+2,69%,71%,67%,141,119,171,40%,41%,39%,7,3,4,6,4,2
311,https://vlr.gg/player/5810/kryo,2024-07-30 09:00:00,0.72,1.16,0.91,177,143,233,38,17,21,47,28,19,19,8,11,0,-1,+1,68%,57%,81%,122,107,140,24%,24%,25%,4,1,3,4,2,2
312,https://vlr.gg/player/19505/szalony,2024-07-30 09:00:00,0.88,0.88,0.88,205,222,157,41,25,16,45,27,18,6,5,1,-7,-6,-1,65%,60%,70%,129,144,110,29%,29%,29%,8,6,2,15,12,3
313,https://vlr.gg/player/5488/mermi,2024-07-30 09:00:00,0.75,1.04,0.87,156,168,152,38,22,16,43,28,15,15,4,11,-1,-1,0,73%,63%,85%,110,117,101,38%,39%,35%,1,0,1,2,1,1
314,https://vlr.gg/player/5487/adm1k,2024-07-30 09:00:00,0.73,0.84,0.78,177,139,229,36,15,21,49,25,24,21,11,10,-3,0,-3,69%,69%,70%,124,104,149,23%,26%,21%,6,3,3,9,3,6
315,https://vlr.gg/player/8034/thenightche,2024-07-30 09:00:00,1.35,1.70,1.55,301,265,316,68,25,43,37,19,18,15,7,8,+5,+2,+3,79%,81%,77%,185,186,184,28%,27%,29%,7,3,4,2,1,1
316,https://vlr.gg/player/44170/niwt,2024-07-30 09:00:00,1.44,1.29,1.36,231,281,208,57,30,27,39,21,18,11,4,7,+6,+3,+3,82%,89%,77%,150,179,127,24%,37%,8%,11,6,5,5,3,2
317,https://vlr.gg/player/3860/al1en,2024-07-30 09:00:00,1.04,1.11,1.08,229,210,237,49,20,29,45,22,23,20,13,7,+4,0,+4,82%,81%,83%,140,136,143,27%,27%,27%,12,3,9,8,3,5
318,https://vlr.gg/player/10429/luvjix,2024-07-30 09:00:00,0.62,1.10,0.89,167,145,173,31,11,20,39,20,19,25,13,12,-3,-4,+1,73%,67%,77%,110,98,119,17%,19%,16%,4,1,3,7,5,2
319,https://vlr.gg/player/6998/nvrfear,2024-07-30 09:00:00,0.65,0.72,0.69,134,127,142,27,12,15,43,19,24,18,6,12,-2,0,-2,76%,70%,80%,100,93,106,21%,29%,16%,2,1,1,4,1,3
320,https://vlr.gg/player/44501/lauguz,2024-07-29 21:00:00,0.91,1.26,1.11,261,215,296,53,21,32,42,18,24,6,1,5,+4,-1,+5,71%,68%,73%,170,138,193,36%,33%,39%,14,4,10,10,5,5
321,https://vlr.gg/player/21476/cami,2024-07-29 21:00:00,1.07,1.00,1.03,189,172,206,38,15,23,40,17,23,12,9,3,+1,+1,0,74%,84%,67%,126,108,141,48%,44%,51%,5,3,2,4,2,2
322,https://vlr.gg/player/28598/chloe,2024-07-29 21:00:00,0.94,1.07,1.01,201,222,198,41,18,23,44,20,24,21,7,14,0,+2,-2,72%,68%,76%,140,152,130,22%,27%,18%,5,4,1,5,2,3
323,https://vlr.gg/player/15592/angel,2024-07-29 21:00:00,0.94,0.97,0.96,165,174,159,30,13,17,38,16,22,26,12,14,+3,+1,+2,76%,76%,76%,112,121,105,43%,48%,38%,4,1,3,1,0,1
324,https://vlr.gg/player/35839/vefa,2024-07-29 21:00:00,0.86,0.61,0.70,160,164,165,32,15,17,46,18,28,7,1,6,-2,0,-2,57%,60%,55%,113,103,120,32%,35%,31%,4,2,2,6,2,4
325,https://vlr.gg/player/25741/lied,2024-07-29 21:00:00,1.37,1.52,1.44,316,333,283,66,39,27,40,25,15,10,5,5,+6,+3,+3,72%,73%,72%,204,205,202,33%,29%,39%,17,10,7,11,7,4
326,https://vlr.gg/player/35547/raquinuki,2024-07-29 21:00:00,1.29,1.00,1.17,222,253,171,48,32,16,39,22,17,15,8,7,-2,-2,0,66%,67%,64%,149,169,123,40%,38%,43%,3,2,1,5,4,1
327,https://vlr.gg/player/40338/natas,2024-07-29 21:00:00,0.92,0.94,0.93,151,124,177,31,14,17,35,18,17,18,14,4,-4,-1,-3,71%,73%,68%,94,81,111,26%,19%,33%,2,1,1,6,2,4
328,https://vlr.gg/player/29223/tura,2024-07-29 21:00:00,0.90,0.92,0.90,170,167,175,32,18,14,40,22,18,32,17,15,-2,-2,0,74%,79%,68%,116,109,126,21%,26%,16%,2,0,2,4,2,2
329,https://vlr.gg/player/35927/dano,2024-07-29 21:00:00,0.77,1.08,0.90,165,162,173,33,18,15,40,25,15,25,13,12,-4,-1,-3,72%,67%,80%,117,107,130,26%,27%,25%,2,2,0,6,3,3
330,https://vlr.gg/player/31574/srn,2024-07-29 19:30:00,1.60,1.18,1.39,274,342,203,44,27,17,27,16,11,7,5,2,+4,+4,0,80%,74%,86%,183,225,139,21%,25%,15%,10,8,2,6,4,2
331,https://vlr.gg/player/11239/sayuri,2024-07-29 19:30:00,1.36,1.28,1.32,216,194,239,33,15,18,25,13,12,28,17,11,+2,0,+2,91%,91%,91%,146,138,154,23%,29%,19%,3,0,3,1,0,1
332,https://vlr.gg/player/21435/jelly,2024-07-29 19:30:00,1.08,1.50,1.29,257,203,316,41,16,25,32,17,15,24,12,12,+4,+2,+2,87%,83%,91%,158,121,197,35%,31%,38%,7,3,4,3,1,2
333,https://vlr.gg/player/14685/jubs,2024-07-29 19:30:00,0.87,1.17,1.01,206,174,239,32,14,18,32,17,15,13,6,7,-1,0,-1,80%,78%,82%,150,121,180,24%,33%,19%,2,1,1,3,1,2
334,https://vlr.gg/player/19791/mel,2024-07-29 19:30:00,0.62,1.06,0.83,144,113,177,24,9,15,27,17,10,10,5,5,0,-3,+3,69%,65%,73%,96,80,112,21%,23%,20%,5,1,4,5,4,1
335,https://vlr.gg/player/22997/waved,2024-07-29 19:30:00,1.06,1.21,1.14,261,255,264,41,20,21,36,20,16,9,3,6,+1,0,+1,80%,77%,83%,175,175,175,20%,25%,16%,8,3,5,7,3,4
336,https://vlr.gg/player/27724/natasha,2024-07-29 19:30:00,0.85,0.85,0.85,166,164,170,28,13,15,32,17,15,8,3,5,-3,-1,-2,71%,68%,74%,107,103,112,29%,29%,29%,2,2,0,5,3,2
337,https://vlr.gg/player/11236/antg,2024-07-29 19:30:00,0.52,1.12,0.82,146,103,188,22,7,15,32,19,13,20,8,12,-5,-3,-2,56%,50%,61%,94,66,120,41%,33%,45%,0,0,0,5,3,2
338,https://vlr.gg/player/9821/m4ndzin,2024-07-29 19:30:00,0.44,1.14,0.80,198,122,273,30,8,22,39,20,19,13,8,5,+2,-2,+4,67%,59%,74%,130,78,179,16%,9%,21%,6,1,5,4,3,1
339,https://vlr.gg/player/11242/blu,2024-07-29 19:30:00,1.02,0.45,0.73,152,207,98,22,15,7,35,17,18,12,5,7,-4,0,-4,60%,59%,61%,95,132,59,36%,45%,25%,2,2,0,6,2,4
340,https://vlr.gg/player/21668/verno,2024-07-29 18:40:00,0.91,1.50,1.20,247,153,343,42,14,28,35,16,19,18,11,7,-2,0,-2,80%,84%,75%,160,100,222,36%,26%,41%,3,2,1,5,2,3
341,https://vlr.gg/player/11118/skuba,2024-07-29 18:40:00,1.07,1.23,1.15,201,203,201,38,20,18,32,18,14,18,7,11,0,+1,-1,82%,84%,79%,126,132,118,29%,27%,33%,4,2,2,4,1,3
342,https://vlr.gg/player/612/mitch,2024-07-29 18:40:00,1.21,1.04,1.12,220,242,200,36,21,15,34,18,16,23,9,14,-2,-1,-1,76%,72%,79%,141,157,124,31%,38%,25%,5,4,1,7,5,2
343,https://vlr.gg/player/8419/reduxx,2024-07-29 18:40:00,1.19,0.62,0.91,215,271,161,35,23,12,39,20,19,13,10,3,-6,-3,-3,73%,84%,63%,141,161,121,38%,44%,29%,4,1,3,10,4,6
344,https://vlr.gg/player/454/dapr,2024-07-29 18:40:00,0.37,0.60,0.48,116,106,123,17,8,9,39,21,18,10,4,6,+1,0,+1,67%,64%,71%,76,74,78,20%,16%,23%,4,2,2,3,2,1
345,https://vlr.gg/player/64/gmd,2024-07-29 18:40:00,0.89,1.50,1.20,236,161,303,41,14,27,35,16,19,22,14,8,+6,-1,+7,78%,79%,76%,148,107,187,32%,33%,31%,7,0,7,1,1,0
346,https://vlr.gg/player/8376/seven,2024-07-29 18:40:00,1.40,0.68,1.03,205,208,203,36,21,15,34,12,22,14,6,8,-5,-2,-3,71%,71%,72%,136,140,133,24%,29%,19%,1,0,1,6,2,4
347,https://vlr.gg/player/849/poised,2024-07-29 18:40:00,0.87,1.10,0.99,189,176,201,33,14,19,29,17,12,22,13,9,+3,+2,+1,80%,79%,80%,120,112,128,29%,22%,39%,4,2,2,1,0,1
348,https://vlr.gg/player/3702/sym,2024-07-29 18:40:00,1.01,0.95,0.98,229,268,198,42,24,18,38,20,18,5,1,4,+5,+6,-1,67%,71%,64%,133,152,116,24%,22%,26%,15,11,4,10,5,5
349,https://vlr.gg/player/740/aproto,2024-07-29 18:40:00,0.74,0.80,0.77,152,157,152,27,13,14,32,17,15,11,2,9,0,+1,-1,78%,71%,84%,100,106,93,32%,34%,29%,2,2,0,2,1,1
350,https://vlr.gg/player/5132/mada,2024-07-29 16:00:00,1.30,1.58,1.45,264,279,252,45,22,23,28,17,11,8,4,4,+5,+3,+2,83%,83%,84%,180,184,176,28%,28%,29%,8,4,4,3,1,2
351,https://vlr.gg/player/2172/brawk,2024-07-29 16:00:00,0.99,1.19,1.09,223,210,238,39,18,21,34,18,16,11,6,5,0,-2,+2,77%,74%,80%,152,137,166,30%,28%,32%,3,0,3,3,2,1
352,https://vlr.gg/player/1851/oderus,2024-07-29 16:00:00,0.76,1.09,0.93,169,130,194,29,10,19,30,14,16,7,3,4,-2,-2,0,69%,65%,72%,115,99,130,32%,33%,31%,2,1,1,4,3,1
353,https://vlr.gg/player/17433/v1c,2024-07-29 16:00:00,1.05,0.69,0.86,171,197,156,29,16,13,33,15,18,11,5,6,0,-1,+1,79%,78%,80%,115,130,100,23%,29%,16%,6,3,3,6,4,2
354,https://vlr.gg/player/3685/flyuh,2024-07-29 16:00:00,0.45,1.12,0.80,165,108,218,24,7,17,34,19,15,25,10,15,-5,-3,-2,79%,74%,84%,110,73,144,29%,19%,36%,4,1,3,9,4,5
355,https://vlr.gg/player/8082/zander,2024-07-29 16:00:00,1.17,1.17,1.17,227,229,233,40,21,19,32,16,16,15,7,8,+3,-3,+6,77%,72%,83%,147,153,140,32%,38%,26%,8,1,7,5,4,1
356,https://vlr.gg/player/4828/nismo,2024-07-29 16:00:00,0.98,1.17,1.07,213,211,214,34,18,16,34,19,15,15,6,9,-2,-2,0,77%,68%,87%,142,122,164,28%,24%,31%,1,0,1,3,2,1
357,https://vlr.gg/player/864/bcj,2024-07-29 16:00:00,0.76,1.09,0.92,181,150,211,29,12,17,33,18,15,17,7,10,+2,+3,-1,71%,68%,74%,118,101,136,30%,27%,32%,6,4,2,4,1,3
358,https://vlr.gg/player/6582/net,2024-07-29 16:00:00,0.89,0.89,0.89,185,200,171,31,17,14,35,20,15,4,2,2,-1,0,-1,67%,60%,74%,127,141,112,26%,35%,17%,4,3,1,5,3,2
359,https://vlr.gg/player/3722/koalanoob,2024-07-29 16:00:00,0.46,1.20,0.82,157,118,201,25,8,17,32,20,12,10,2,8,0,-1,+1,63%,52%,74%,95,80,110,11%,12%,11%,6,3,3,6,4,2
360,https://vlr.gg/player/4807/bstrdd,2024-07-29 16:00:00,1.44,1.12,1.26,284,369,214,64,38,26,45,20,25,9,6,3,+2,0,+2,68%,66%,69%,175,217,141,26%,27%,26%,14,7,7,12,7,5
361,https://vlr.gg/player/11232/daiki,2024-07-29 16:00:00,1.26,0.97,1.10,212,205,220,50,23,27,45,18,27,32,17,15,+1,+2,-1,78%,90%,69%,135,132,138,40%,37%,43%,4,2,2,3,0,3
362,https://vlr.gg/player/12143/bizerra,2024-07-29 16:00:00,1.10,1.00,1.04,181,189,180,42,19,23,39,15,24,18,9,9,+1,+1,0,78%,83%,75%,133,134,133,28%,32%,25%,5,4,1,4,3,1
363,https://vlr.gg/player/15297/joojina,2024-07-29 16:00:00,1.13,0.96,1.04,192,167,212,43,18,25,43,15,28,22,15,7,+6,+2,+4,68%,76%,61%,127,117,135,34%,43%,30%,10,3,7,4,1,3
364,https://vlr.gg/player/14386/isaa,2024-07-29 16:00:00,1.24,0.63,0.91,186,220,159,42,23,19,43,15,28,11,7,4,-5,0,-5,69%,83%,58%,121,139,106,34%,37%,32%,2,1,1,7,1,6
365,https://vlr.gg/player/29179/vii,2024-07-29 16:00:00,1.15,1.47,1.29,263,225,310,61,29,32,50,26,24,15,13,2,+2,+1,+1,83%,83%,83%,174,152,202,26%,22%,32%,10,5,5,8,4,4
366,https://vlr.gg/player/14690/lissa,2024-07-29 16:00:00,1.13,0.73,0.95,214,255,168,48,34,14,49,25,24,19,7,12,0,+1,-1,71%,75%,66%,139,161,112,41%,48%,33%,8,6,2,8,5,3
367,https://vlr.gg/player/6994/shyz,2024-07-29 16:00:00,1.25,0.55,0.94,156,200,102,40,29,11,41,18,23,10,4,6,-3,-1,-2,66%,78%,52%,105,132,71,26%,25%,30%,0,0,0,3,1,2
368,https://vlr.gg/player/24764/akame,2024-07-29 16:00:00,1.00,0.84,0.93,191,210,171,46,27,19,49,26,23,16,10,6,-3,-1,-2,68%,67%,69%,124,134,110,42%,35%,56%,5,3,2,8,4,4
369,https://vlr.gg/player/24763/speedy,2024-07-29 16:00:00,0.61,0.22,0.43,100,117,83,20,13,7,52,25,27,14,11,3,-1,0,-1,51%,69%,28%,72,85,56,21%,18%,26%,7,4,3,8,4,4
370,https://vlr.gg/player/29628/famzzam,2024-07-29 15:00:00,1.05,1.08,1.07,181,173,193,48,23,25,45,20,25,16,10,6,-1,0,-1,76%,79%,74%,117,103,132,17%,16%,18%,2,2,0,3,2,1
371,https://vlr.gg/player/16188/tempo,2024-07-29 15:00:00,1.22,0.87,1.04,218,223,212,56,29,27,48,19,29,7,4,3,+4,-1,+5,68%,71%,65%,141,148,134,41%,38%,45%,8,1,7,4,2,2
372,https://vlr.gg/player/33994/creamydreamy,2024-07-29 15:00:00,1.29,0.71,1.00,199,260,140,50,33,17,49,22,27,45,22,23,0,+4,-4,82%,88%,76%,121,152,91,28%,27%,31%,6,5,1,6,1,5
373,https://vlr.gg/player/2182/hearthbeat,2024-07-29 15:00:00,1.22,0.66,0.94,174,202,146,39,24,15,45,19,26,39,26,13,-1,-1,0,76%,85%,68%,116,132,100,24%,25%,22%,3,1,2,4,2,2
374,https://vlr.gg/player/12519/ticey,2024-07-29 15:00:00,0.68,1.02,0.85,214,196,239,51,23,28,55,28,27,8,4,4,+2,0,+2,68%,76%,59%,143,128,159,23%,20%,29%,17,9,8,15,9,6
375,https://vlr.gg/player/1524/h1ber,2024-07-29 15:00:00,1.51,1.17,1.34,283,295,276,69,37,32,51,22,29,18,11,7,+2,0,+2,75%,88%,62%,182,187,178,34%,34%,34%,7,3,4,5,3,2
376,https://vlr.gg/player/1493/starkk,2024-07-29 15:00:00,1.17,1.03,1.10,181,208,160,44,26,18,39,19,20,23,13,10,+2,+2,0,76%,85%,68%,118,124,112,25%,35%,17%,6,4,2,4,2,2
377,https://vlr.gg/player/23347/alannn,2024-07-29 15:00:00,1.05,0.68,0.87,196,219,167,48,28,20,52,23,29,15,6,9,-2,+2,-4,68%,76%,59%,126,147,104,36%,35%,36%,8,4,4,10,2,8
378,https://vlr.gg/player/18400/bipo,2024-07-29 15:00:00,0.82,0.89,0.86,185,187,186,46,24,22,50,24,26,9,2,7,-2,-5,+3,60%,62%,59%,120,118,122,33%,41%,26%,10,4,6,12,9,3
379,https://vlr.gg/player/4277/n-a-i-s,2024-07-29 15:00:00,0.85,0.70,0.78,155,174,139,35,19,16,52,24,28,20,10,10,-4,-1,-3,66%,74%,59%,109,125,94,30%,33%,25%,1,1,0,5,2,3
380,https://vlr.gg/player/314/ambi,2024-07-29 12:00:00,1.36,1.29,1.33,237,225,204,45,30,15,31,20,11,33,15,18,+5,+2,+3,79%,75%,86%,145,155,127,31%,33%,26%,6,3,3,1,1,0
381,https://vlr.gg/player/6889/neskaas,2024-07-29 12:00:00,1.25,0.95,1.14,217,230,192,48,33,15,37,23,14,10,4,6,-1,-1,0,79%,75%,86%,137,141,130,29%,26%,34%,6,5,1,7,6,1
382,https://vlr.gg/player/8805/sacake,2024-07-29 12:00:00,1.07,1.17,1.11,178,151,218,35,17,18,31,18,13,18,15,3,+2,0,+2,75%,78%,71%,110,96,135,24%,18%,32%,3,1,2,1,1,0
383,https://vlr.gg/player/252/d3ffo,2024-07-29 12:00:00,0.85,1.50,1.09,235,208,291,51,27,24,42,29,13,7,4,3,-2,-3,+1,65%,58%,76%,155,141,181,25%,30%,20%,9,5,4,11,8,3
384,https://vlr.gg/player/2653/jesse,2024-07-29 12:00:00,0.77,1.20,0.93,167,156,208,35,21,14,37,25,12,23,11,12,+3,+2,+1,67%,61%,76%,115,99,144,30%,33%,27%,8,4,4,5,2,3
385,https://vlr.gg/player/1493/starkk,2024-07-29 12:00:00,1.09,1.01,1.04,183,207,180,39,16,23,38,15,23,10,3,7,0,0,0,58%,57%,58%,126,132,123,31%,42%,26%,3,1,2,3,1,2
386,https://vlr.gg/player/18400/bipo,2024-07-29 12:00:00,1.14,0.91,0.99,189,271,157,42,20,22,42,18,24,10,4,6,-1,-2,+1,58%,52%,61%,125,180,93,31%,43%,19%,10,3,7,11,5,6
387,https://vlr.gg/player/4277/n-a-i-s,2024-07-29 12:00:00,0.62,1.01,0.87,183,110,232,39,10,29,44,17,27,5,1,4,0,0,0,63%,52%,69%,123,71,152,44%,47%,43%,4,0,4,4,0,4
388,https://vlr.gg/player/23347/alannn,2024-07-29 12:00:00,0.42,0.98,0.77,179,120,207,35,9,26,46,19,27,12,4,8,-2,-1,-1,61%,48%,69%,116,80,138,37%,24%,44%,4,1,3,6,2,4
389,https://vlr.gg/player/1524/h1ber,2024-07-29 12:00:00,0.56,0.58,0.57,120,122,130,23,8,15,44,17,27,16,7,9,-4,-4,0,49%,38%,56%,93,85,98,27%,22%,31%,4,2,2,8,6,2
390,https://vlr.gg/player/12519/ticey,2024-07-29 09:00:00,1.16,1.25,1.21,275,290,254,46,23,23,37,18,19,8,4,4,-1,-2,+1,76%,83%,69%,174,182,167,18%,15%,21%,8,3,5,9,5,4
391,https://vlr.gg/player/33994/creamydreamy,2024-07-29 09:00:00,1.26,1.05,1.15,233,259,210,41,23,18,39,17,22,24,12,12,0,0,0,73%,83%,65%,156,171,142,31%,30%,32%,2,1,1,2,1,1
392,https://vlr.gg/player/16188/tempo,2024-07-29 09:00:00,1.07,0.83,0.94,206,240,186,36,20,16,36,17,19,10,4,6,-4,+1,-5,69%,70%,69%,132,145,121,25%,29%,22%,3,3,0,7,2,5
393,https://vlr.gg/player/2182/hearthbeat,2024-07-29 09:00:00,0.80,1.03,0.92,165,150,192,31,13,18,36,17,19,17,12,5,-6,-5,-1,73%,87%,62%,114,109,119,28%,32%,25%,2,0,2,8,5,3
394,https://vlr.gg/player/29628/famzzam,2024-07-29 09:00:00,0.78,0.43,0.60,114,138,104,16,10,6,37,16,21,15,8,7,-4,+1,-5,69%,83%,58%,85,98,73,23%,31%,15%,2,2,0,6,1,5
395,https://vlr.gg/player/252/d3ffo,2024-07-29 09:00:00,1.50,1.08,1.30,266,308,233,49,31,18,33,15,18,8,3,5,+7,+7,0,78%,77%,78%,174,187,160,24%,25%,24%,13,11,2,6,4,2
396,https://vlr.gg/player/2653/jesse,2024-07-29 09:00:00,1.05,1.41,1.21,234,192,276,43,19,24,32,16,16,15,6,9,+5,0,+5,67%,65%,70%,149,146,151,27%,22%,32%,6,1,5,1,1,0
397,https://vlr.gg/player/6889/neskaas,2024-07-29 09:00:00,1.25,1.08,1.17,191,197,197,36,20,16,31,15,16,20,11,9,-1,0,-1,78%,77%,78%,129,136,122,26%,30%,21%,4,2,2,5,2,3
398,https://vlr.gg/player/314/ambi,2024-07-29 09:00:00,1.01,0.97,0.99,209,190,204,35,17,18,35,17,18,15,12,3,+3,+2,+1,80%,88%,70%,133,132,134,28%,25%,33%,6,2,4,3,0,3
399,https://vlr.gg/player/8805/sacake,2024-07-29 09:00:00,0.73,0.61,0.68,145,145,147,22,13,9,39,18,21,24,10,14,+1,+1,0,65%,65%,65%,100,98,102,21%,18%,24%,3,2,1,2,1,1
400,https://vlr.gg/player/9354/cebando,2024-07-28 17:00:00,1.07,1.25,1.15,194,200,201,72,38,34,64,38,26,43,23,20,+4,+1,+3,73%,74%,73%,119,127,109,32%,31%,32%,9,4,5,5,3,2
401,https://vlr.gg/player/13861/nicomachine,2024-07-28 17:00:00,1.05,1.27,1.15,202,172,240,68,32,36,67,37,30,59,33,26,0,-6,+6,79%,78%,80%,129,103,162,23%,24%,23%,9,2,7,9,8,1
402,https://vlr.gg/player/41135/dantedeu5,2024-07-28 17:00:00,1.13,1.04,1.09,246,250,241,84,47,37,76,39,37,28,16,12,-1,0,-1,72%,74%,70%,158,160,155,27%,29%,25%,16,11,5,17,11,6
403,https://vlr.gg/player/3826/adverso,2024-07-28 17:00:00,1.03,0.99,1.01,198,197,200,60,35,25,67,36,31,47,19,28,-2,+2,-4,70%,67%,75%,128,124,134,23%,25%,21%,8,5,3,10,3,7
404,https://vlr.gg/player/2585/tinchoff,2024-07-28 17:00:00,0.75,0.77,0.75,123,122,128,41,21,20,63,33,30,22,12,10,-3,-1,-2,59%,65%,52%,80,82,77,30%,27%,34%,6,3,3,9,4,5
405,https://vlr.gg/player/3983/virtyy,2024-07-28 17:00:00,1.36,1.13,1.24,288,321,263,98,49,49,70,31,39,28,10,18,+9,+6,+3,77%,80%,74%,181,195,169,23%,26%,19%,30,16,14,21,10,11
406,https://vlr.gg/player/7616/feniz,2024-07-28 17:00:00,0.93,1.02,0.98,191,188,194,67,30,37,65,31,34,21,8,13,-1,-2,+1,73%,80%,69%,138,132,142,30%,28%,32%,6,2,4,7,4,3
407,https://vlr.gg/player/8056/mited,2024-07-28 17:00:00,0.76,1.04,0.92,175,153,189,56,21,35,64,32,32,47,18,29,-2,-2,0,76%,75%,76%,123,112,132,23%,20%,25%,4,1,3,6,3,3
408,https://vlr.gg/player/10557/darker,2024-07-28 17:00:00,0.85,0.97,0.92,167,164,168,61,26,35,66,32,34,28,18,10,-5,-3,-2,68%,70%,67%,114,112,117,24%,24%,24%,4,1,3,9,4,5
409,https://vlr.gg/player/17690/jow,2024-07-28 17:00:00,0.99,0.82,0.90,150,150,146,55,28,27,60,26,34,21,11,10,+1,-1,+2,71%,77%,67%,101,106,97,35%,32%,38%,6,1,5,5,2,3
410,https://vlr.gg/player/33994/creamydreamy,2024-07-28 16:30:00,1.16,1.28,1.22,237,225,249,38,17,21,34,15,19,17,9,8,-1,-1,0,70%,77%,63%,147,147,147,43%,50%,35%,2,1,1,3,2,1
411,https://vlr.gg/player/12519/ticey,2024-07-28 16:30:00,1.39,0.90,1.13,244,304,194,39,23,16,35,15,20,4,2,2,+1,+3,-2,65%,73%,58%,151,169,136,26%,26%,25%,10,6,4,9,3,6
412,https://vlr.gg/player/16188/tempo,2024-07-28 16:30:00,0.85,1.00,0.92,193,168,217,30,13,17,31,13,18,9,3,6,-5,-5,0,63%,59%,67%,131,118,144,32%,33%,31%,3,0,3,8,5,3
413,https://vlr.gg/player/2182/hearthbeat,2024-07-28 16:30:00,0.96,0.63,0.79,130,145,116,20,11,9,31,13,18,7,4,3,-3,-1,-2,61%,77%,46%,99,109,90,29%,29%,30%,1,1,0,4,2,2
414,https://vlr.gg/player/29628/famzzam,2024-07-28 16:30:00,1.02,0.12,0.55,119,173,69,19,14,5,36,14,22,6,4,2,-6,-2,-4,52%,73%,33%,79,113,49,34%,32%,43%,0,0,0,6,2,4
415,https://vlr.gg/player/33902/sayonara,2024-07-28 16:30:00,1.54,0.74,1.16,250,349,143,41,31,10,32,17,15,23,12,11,+5,+5,0,72%,83%,59%,155,195,110,29%,33%,23%,9,7,2,4,2,2
416,https://vlr.gg/player/443/zeddy,2024-07-28 16:30:00,0.99,1.20,1.09,226,218,234,35,18,17,31,15,16,19,10,9,+3,+2,+1,74%,75%,73%,143,142,145,23%,19%,29%,6,4,2,3,2,1
417,https://vlr.gg/player/2894/kiles,2024-07-28 16:30:00,1.37,0.76,1.08,170,207,129,28,17,11,24,9,15,14,10,4,+1,-1,+2,76%,88%,64%,115,147,79,29%,34%,22%,2,0,2,1,1,0
418,https://vlr.gg/player/402/insider,2024-07-28 16:30:00,0.85,1.18,1.01,202,150,258,32,13,19,29,13,16,11,5,6,+3,+1,+2,67%,71%,64%,155,120,193,43%,41%,44%,5,1,4,2,0,2
419,https://vlr.gg/player/251/b1sk,2024-07-28 16:30:00,1.15,0.76,0.97,191,207,169,31,18,13,30,14,16,7,4,3,+2,+1,+1,72%,79%,64%,122,135,108,17%,18%,16%,8,4,4,6,3,3
420,https://vlr.gg/player/2486/pollo,2024-07-28 16:00:00,1.12,1.28,1.20,235,224,251,74,36,38,60,30,30,20,10,10,-3,-2,-1,73%,73%,73%,159,160,159,39%,34%,45%,5,2,3,8,4,4
421,https://vlr.gg/player/42867/ghoul33,2024-07-28 16:00:00,0.95,0.99,0.97,224,227,225,65,34,31,66,35,31,16,9,7,+9,+6,+3,68%,68%,68%,152,142,162,35%,33%,38%,19,13,6,10,7,3
422,https://vlr.gg/player/1578/shion,2024-07-28 16:00:00,0.94,0.91,0.93,178,192,172,49,27,22,57,30,27,24,14,10,-2,+1,-3,74%,75%,73%,126,135,116,27%,27%,27%,4,2,2,6,1,5
423,https://vlr.gg/player/5722/prince,2024-07-28 16:00:00,1.11,0.58,0.86,156,180,133,45,29,16,57,27,30,36,21,15,-4,-2,-2,70%,68%,73%,105,119,90,28%,32%,23%,5,1,4,9,3,6
424,https://vlr.gg/player/21251/blowz,2024-07-28 16:00:00,0.70,0.75,0.72,181,189,174,52,29,23,66,35,31,11,6,5,+2,+1,+1,57%,55%,60%,118,117,118,23%,23%,23%,10,6,4,8,5,3
425,https://vlr.gg/player/28716/lukxo,2024-07-28 16:00:00,1.20,1.21,1.20,218,220,216,65,31,34,54,25,29,34,15,19,+2,+1,+1,73%,78%,68%,144,146,142,23%,17%,32%,7,4,3,5,3,2
426,https://vlr.gg/player/1688/rood,2024-07-28 16:00:00,1.18,1.06,1.11,176,188,169,53,29,24,49,21,28,30,13,17,-3,-3,0,79%,78%,80%,112,120,105,21%,14%,28%,4,1,3,7,4,3
427,https://vlr.gg/player/21659/sato,2024-07-28 16:00:00,1.06,1.14,1.10,270,260,278,77,37,40,71,33,38,11,4,7,+8,+7,+1,73%,73%,73%,171,164,178,26%,25%,28%,18,10,8,10,3,7
428,https://vlr.gg/player/1994/evilkyk,2024-07-28 16:00:00,1.02,0.95,0.98,159,141,174,50,24,26,52,22,30,33,13,20,-3,0,-3,74%,80%,68%,104,98,110,31%,26%,37%,2,1,1,5,1,4
429,https://vlr.gg/player/6238/urango,2024-07-28 16:00:00,0.88,0.97,0.93,201,204,196,61,29,32,60,29,31,20,14,6,-6,-3,-3,61%,68%,55%,136,137,135,25%,22%,27%,10,5,5,16,8,8
430,https://vlr.gg/player/7490/anguist,2024-07-28 15:25:00,1.59,1.30,1.44,253,285,222,45,25,20,23,12,11,6,4,2,+1,-2,+3,76%,78%,74%,173,206,140,37%,38%,36%,3,0,3,2,2,0
431,https://vlr.gg/player/1835/elllement,2024-07-28 15:25:00,0.94,1.27,1.10,229,226,233,38,19,19,29,18,11,5,2,3,+4,0,+4,76%,78%,74%,158,161,154,29%,32%,27%,8,3,5,4,3,1
432,https://vlr.gg/player/4329/vince,2024-07-28 15:25:00,1.08,1.10,1.09,184,205,163,33,18,15,26,14,12,14,4,10,0,0,0,67%,61%,74%,118,141,95,25%,36%,13%,5,3,2,5,3,2
433,https://vlr.gg/player/10885/davih,2024-07-28 15:25:00,1.00,1.00,1.00,194,202,187,29,17,12,29,15,14,19,9,10,+3,-1,+4,83%,83%,83%,135,141,130,13%,20%,6%,6,1,5,3,2,1
434,https://vlr.gg/player/2472/benny,2024-07-28 15:25:00,0.86,0.80,0.83,148,179,119,25,14,11,27,15,12,8,5,3,+4,+4,0,76%,74%,78%,98,121,76,24%,26%,22%,7,5,2,3,1,2
435,https://vlr.gg/player/23347/alannn,2024-07-28 15:25:00,1.49,1.07,1.28,236,265,207,38,21,17,29,12,17,4,1,3,+3,+3,0,63%,70%,57%,155,177,133,42%,40%,46%,5,3,2,2,0,2
436,https://vlr.gg/player/1493/starkk,2024-07-28 15:25:00,1.31,0.96,1.13,208,244,172,33,19,14,32,15,17,14,3,11,0,0,0,72%,70%,74%,135,160,110,32%,33%,31%,2,1,1,2,1,1
437,https://vlr.gg/player/4277/n-a-i-s,2024-07-28 15:25:00,0.70,1.17,0.93,194,120,269,27,8,19,34,15,19,15,6,9,-1,-2,+1,63%,61%,65%,131,82,180,24%,26%,24%,4,1,3,5,3,2
438,https://vlr.gg/player/1524/h1ber,2024-07-28 15:25:00,0.37,0.76,0.57,112,49,174,14,2,12,36,16,20,21,9,12,-8,-6,-2,67%,65%,70%,74,34,114,23%,17%,26%,1,0,1,9,6,3
439,https://vlr.gg/player/18400/bipo,2024-07-28 15:25:00,0.40,0.71,0.55,144,125,162,22,10,12,39,19,20,4,0,4,-6,-6,0,50%,35%,65%,91,76,106,41%,65%,29%,5,1,4,11,7,4
440,https://vlr.gg/player/2653/jesse,2024-07-28 15:10:00,1.08,1.22,1.16,240,242,242,35,15,20,31,15,16,13,7,6,-3,-1,-2,66%,67%,65%,161,165,157,37%,31%,43%,3,1,2,6,2,4
441,https://vlr.gg/player/252/d3ffo,2024-07-28 15:10:00,0.94,1.07,1.01,212,215,203,28,13,15,31,15,16,9,2,7,0,+2,-2,63%,72%,57%,143,134,151,24%,28%,21%,5,3,2,5,1,4
442,https://vlr.gg/player/8805/sacake,2024-07-28 15:10:00,0.71,0.97,0.86,184,147,212,28,9,19,35,15,20,11,4,7,+4,0,+4,63%,50%,74%,120,114,125,23%,16%,29%,5,0,5,1,0,1
443,https://vlr.gg/player/6889/neskaas,2024-07-28 15:10:00,0.84,0.66,0.74,151,188,128,20,11,9,31,14,17,7,1,6,-1,+1,-2,78%,78%,78%,113,132,98,31%,42%,24%,2,2,0,3,1,2
444,https://vlr.gg/player/314/ambi,2024-07-28 15:10:00,0.50,0.70,0.61,123,115,126,18,8,10,32,14,18,15,5,10,-7,-4,-3,61%,44%,74%,78,74,82,20%,30%,14%,2,2,0,9,6,3
445,https://vlr.gg/player/6559/destruct1vee,2024-07-28 15:10:00,1.34,1.48,1.40,262,256,280,40,21,19,25,14,11,17,13,4,+2,+2,0,83%,87%,78%,166,158,177,32%,38%,27%,5,4,1,3,2,1
446,https://vlr.gg/player/7353/glovee,2024-07-28 15:10:00,1.51,0.87,1.23,213,256,146,30,22,8,23,13,10,14,7,7,0,+1,-1,76%,78%,72%,143,168,112,27%,30%,22%,3,3,0,3,2,1
447,https://vlr.gg/player/10137/ip0tt,2024-07-28 15:10:00,0.81,1.47,1.10,233,182,313,37,15,22,30,17,13,7,5,2,+4,+2,+2,78%,74%,83%,153,127,185,21%,28%,15%,10,6,4,6,4,2
448,https://vlr.gg/player/4962/lurzy0y0,2024-07-28 15:10:00,1.09,1.02,1.06,205,213,182,30,18,12,25,14,11,10,5,5,+1,0,+1,68%,61%,78%,143,164,118,35%,39%,30%,3,1,2,2,1,1
449,https://vlr.gg/player/5517/masic,2024-07-28 15:10:00,0.84,0.96,0.89,167,139,195,23,11,12,26,15,11,15,11,4,0,0,0,71%,78%,61%,108,84,137,31%,29%,35%,3,0,3,3,0,3
450,https://vlr.gg/player/1470/simond4rk,2024-07-28 13:00:00,0.98,1.09,1.04,259,272,247,40,22,18,38,18,20,13,4,9,+2,0,+2,70%,70%,71%,163,165,161,21%,25%,15%,8,4,4,6,4,2
451,https://vlr.gg/player/1897/bgg,2024-07-28 13:00:00,0.91,1.10,1.00,193,204,179,45,25,20,44,25,19,16,6,10,0,0,0,70%,71%,68%,129,134,124,24%,26%,23%,7,4,3,7,4,3
452,https://vlr.gg/player/3807/winteryrook,2024-07-28 13:00:00,1.11,0.70,0.91,215,241,193,50,30,20,53,26,27,14,10,4,+2,-2,+4,73%,80%,65%,142,158,124,27%,31%,21%,9,4,5,7,6,1
453,https://vlr.gg/player/5795/sickrey,2024-07-28 13:00:00,0.74,0.94,0.83,152,128,181,32,14,18,46,23,23,19,11,8,-4,-1,-3,64%,66%,61%,104,88,122,20%,16%,24%,2,0,2,6,1,5
454,https://vlr.gg/player/1874/steady,2024-07-28 13:00:00,1.15,0.14,0.78,177,228,90,11,10,1,15,8,7,3,2,1,-1,0,-1,63%,75%,43%,121,150,73,19%,21%,14%,0,0,0,1,0,1
455,https://vlr.gg/player/2432/moner,2024-07-28 13:00:00,0.67,0.64,0.66,141,121,165,32,15,17,49,23,26,6,3,3,-7,-4,-3,59%,54%,65%,98,85,114,23%,31%,18%,3,2,1,10,6,4
456,https://vlr.gg/player/33994/creamydreamy,2024-07-28 13:00:00,1.31,1.35,1.33,215,199,237,53,24,29,41,17,24,44,21,23,+1,-1,+2,85%,90%,80%,140,134,146,36%,35%,38%,4,0,4,3,1,2
457,https://vlr.gg/player/12519/ticey,2024-07-28 13:00:00,1.36,1.29,1.32,252,286,225,61,32,29,43,21,22,16,6,10,+6,+4,+2,80%,84%,77%,168,188,151,21%,19%,25%,14,8,6,8,4,4
458,https://vlr.gg/player/29628/famzzam,2024-07-28 13:00:00,1.27,1.32,1.29,207,195,217,52,24,28,36,15,21,20,9,11,+1,-4,+5,77%,81%,74%,135,133,138,26%,28%,25%,5,0,5,4,4,0
459,https://vlr.gg/player/16188/tempo,2024-07-28 13:00:00,1.09,1.06,1.07,217,248,179,50,27,23,43,22,21,9,4,5,+6,+3,+3,68%,71%,66%,145,163,128,25%,24%,26%,9,6,3,3,3,0
460,https://vlr.gg/player/2182/hearthbeat,2024-07-28 13:00:00,0.77,0.60,0.68,138,135,139,29,15,14,47,19,28,30,11,19,-6,-1,-5,73%,74%,71%,89,81,95,22%,23%,21%,5,2,3,11,3,8
461,https://vlr.gg/player/34684/westside,2024-07-28 12:00:00,1.15,1.21,1.18,200,186,220,36,16,20,30,12,18,13,4,9,-1,0,-1,69%,68%,69%,141,131,149,37%,43%,33%,2,1,1,3,1,2
462,https://vlr.gg/player/24424/pa1ze,2024-07-28 12:00:00,0.91,0.92,0.91,211,244,185,34,17,17,36,17,19,8,5,3,0,0,0,65%,64%,65%,133,152,118,31%,33%,28%,10,5,5,10,5,5
463,https://vlr.gg/player/8593/grmekista,2024-07-28 12:00:00,1.21,0.54,0.85,197,268,131,32,22,10,36,16,20,13,5,8,-5,-2,-3,71%,73%,69%,132,177,95,18%,20%,14%,2,2,0,7,4,3
464,https://vlr.gg/player/3839/prti,2024-07-28 12:00:00,0.82,0.86,0.84,196,172,217,32,13,19,36,14,22,14,5,9,+3,+2,+1,71%,77%,65%,122,107,134,33%,29%,36%,5,2,3,2,0,2
465,https://vlr.gg/player/5490/xitsha,2024-07-28 12:00:00,0.79,0.83,0.81,154,146,168,29,13,16,32,13,19,15,5,10,-3,-2,-1,75%,77%,73%,114,108,119,32%,29%,35%,2,0,2,5,2,3
466,https://vlr.gg/player/2653/jesse,2024-07-28 12:00:00,1.58,1.49,1.54,290,286,295,50,27,23,29,13,16,14,7,7,+2,+3,-1,77%,88%,64%,191,184,200,39%,40%,39%,6,3,3,4,0,4
467,https://vlr.gg/player/252/d3ffo,2024-07-28 12:00:00,0.98,1.31,1.13,226,216,240,39,19,20,33,19,14,6,5,1,+3,+2,+1,71%,69%,73%,148,148,149,24%,28%,20%,7,4,3,4,2,2
468,https://vlr.gg/player/8805/sacake,2024-07-28 12:00:00,1.11,0.63,0.89,172,203,132,26,19,7,33,16,17,16,6,10,+4,+1,+3,73%,77%,68%,123,150,90,32%,39%,21%,6,2,4,2,1,1
469,https://vlr.gg/player/314/ambi,2024-07-28 12:00:00,0.88,0.82,0.85,143,152,146,25,13,12,33,17,16,15,11,4,-1,+1,-2,69%,69%,68%,109,110,108,27%,26%,27%,4,3,1,5,2,3
470,https://vlr.gg/player/6889/neskaas,2024-07-28 12:00:00,0.97,0.67,0.84,172,197,139,30,20,10,35,17,18,10,8,2,-2,-3,+1,65%,69%,59%,106,117,95,27%,22%,34%,4,3,1,6,6,0
471,https://vlr.gg/player/4277/n-a-i-s,2024-07-28 12:00:00,1.25,1.18,1.22,232,242,210,56,34,22,43,25,18,18,12,6,+3,+1,+2,76%,79%,71%,152,155,148,36%,32%,43%,4,1,3,1,0,1
472,https://vlr.gg/player/18400/bipo,2024-07-28 12:00:00,1.17,1.10,1.13,248,263,249,63,36,27,51,28,23,19,8,11,+4,+1,+3,77%,77%,77%,170,167,173,39%,40%,38%,15,9,6,11,8,3
473,https://vlr.gg/player/1493/starkk,2024-07-28 12:00:00,1.42,0.67,1.09,200,241,128,51,36,15,45,22,23,28,17,11,-1,+3,-4,69%,79%,55%,119,145,86,31%,32%,28%,6,6,0,7,3,4
474,https://vlr.gg/player/1524/h1ber,2024-07-28 12:00:00,0.79,1.36,1.04,189,135,270,49,18,31,47,26,21,31,20,11,+5,0,+5,81%,82%,81%,122,90,164,23%,22%,25%,11,4,7,6,4,2
475,https://vlr.gg/player/23347/alannn,2024-07-28 12:00:00,0.91,0.94,0.92,178,182,188,47,26,21,50,28,22,16,10,6,-1,-2,+1,74%,72%,77%,132,129,135,26%,26%,25%,4,1,3,5,3,2
476,https://vlr.gg/player/7883/silenttt,2024-07-28 12:00:00,1.01,1.22,1.13,218,194,247,56,23,33,52,24,28,16,7,9,+2,+1,+1,76%,77%,74%,149,122,171,35%,29%,39%,7,2,5,5,1,4
477,https://vlr.gg/player/26808/fainz,2024-07-28 12:00:00,0.86,1.18,1.04,247,232,264,61,23,38,56,25,31,14,7,7,-6,-3,-3,69%,68%,69%,167,158,174,33%,36%,30%,8,4,4,14,7,7
478,https://vlr.gg/player/16012/akira,2024-07-28 12:00:00,0.91,0.87,0.89,172,171,182,42,19,23,54,22,32,14,4,10,+2,0,+2,71%,71%,72%,120,116,123,21%,18%,24%,6,3,3,4,3,1
479,https://vlr.gg/player/8590/killdream,2024-07-28 12:00:00,1.02,0.77,0.87,173,195,168,43,20,23,55,23,32,21,12,9,-1,-1,0,66%,68%,64%,125,120,128,28%,24%,32%,7,2,5,8,3,5
480,https://vlr.gg/player/1377/phatt,2024-07-28 12:00:00,1.02,0.60,0.79,140,180,108,34,22,12,49,22,27,28,11,17,-7,-4,-3,73%,81%,67%,90,115,69,30%,40%,20%,2,1,1,9,5,4
481,https://vlr.gg/player/7104/juseu,2024-07-28 11:00:00,1.94,1.44,1.65,303,343,266,45,24,21,22,9,13,4,1,3,+4,+4,0,76%,83%,71%,183,205,166,16%,20%,11%,10,6,4,6,2,4
482,https://vlr.gg/player/3579/marctylinho,2024-07-28 11:00:00,1.07,1.34,1.22,227,214,233,35,16,19,26,11,15,18,6,12,+3,0,+3,86%,89%,83%,138,131,143,24%,16%,31%,3,0,3,0,0,0
483,https://vlr.gg/player/2525/szimpli,2024-07-28 11:00:00,1.02,1.13,1.08,218,225,216,32,14,18,27,12,15,13,3,10,0,0,0,71%,72%,71%,145,142,148,34%,20%,49%,4,1,3,4,1,3
484,https://vlr.gg/player/6828/pa1ka,2024-07-28 11:00:00,0.87,0.73,0.79,175,198,149,23,11,12,29,12,17,11,3,8,+1,+2,-1,69%,78%,63%,120,134,109,33%,41%,28%,4,3,1,3,1,2
485,https://vlr.gg/player/2841/foxie,2024-07-28 11:00:00,0.82,0.61,0.70,130,158,119,19,11,8,30,14,16,15,6,9,-4,-4,0,74%,72%,75%,92,103,83,36%,38%,34%,2,0,2,6,4,2
486,https://vlr.gg/player/26809/tenshi,2024-07-28 11:00:00,1.07,1.14,1.10,176,164,195,27,14,13,30,16,14,24,13,11,+2,+1,+1,83%,75%,94%,124,119,130,33%,32%,34%,6,3,3,4,2,2
487,https://vlr.gg/player/31058/kpro,2024-07-28 11:00:00,1.24,0.74,1.03,204,220,162,28,19,9,27,14,13,14,8,6,-1,0,-1,74%,79%,67%,121,128,111,32%,37%,26%,2,2,0,3,2,1
488,https://vlr.gg/player/7169/glenn,2024-07-28 11:00:00,0.93,0.89,0.92,205,189,245,31,16,15,34,17,17,12,5,7,-3,-4,+1,71%,63%,83%,139,126,156,25%,19%,34%,3,1,2,6,5,1
489,https://vlr.gg/player/5498/kipperman,2024-07-28 11:00:00,0.88,0.67,0.79,187,203,177,27,15,12,35,18,17,7,6,1,0,0,0,69%,67%,72%,126,139,110,30%,30%,31%,5,3,2,5,3,2
490,https://vlr.gg/player/26837/poegii,2024-07-28 11:00:00,0.76,0.67,0.72,137,125,164,20,11,9,28,14,14,7,5,2,-2,+1,-3,55%,63%,44%,96,86,109,21%,18%,23%,3,2,1,5,1,4
491,https://vlr.gg/player/251/b1sk,2024-07-28 10:00:00,1.38,1.34,1.36,264,311,240,42,20,22,24,14,10,2,1,1,+1,-2,+3,67%,61%,71%,169,194,150,21%,36%,10%,8,3,5,7,5,2
492,https://vlr.gg/player/33902/sayonara,2024-07-28 10:00:00,0.83,1.74,1.35,300,196,370,46,12,34,27,13,14,7,3,4,-2,-4,+2,76%,56%,92%,199,139,243,38%,45%,35%,3,0,3,5,4,1
493,https://vlr.gg/player/2894/kiles,2024-07-28 10:00:00,0.85,1.38,1.15,179,135,207,28,9,19,22,13,9,17,6,11,0,0,0,86%,67%,100%,122,92,145,36%,40%,34%,0,0,0,0,0,0
494,https://vlr.gg/player/402/insider,2024-07-28 10:00:00,0.82,1.07,0.96,195,172,205,27,10,17,25,14,11,6,3,3,+1,0,+1,67%,61%,71%,128,113,139,36%,38%,35%,6,2,4,5,2,3
495,https://vlr.gg/player/443/zeddy,2024-07-28 10:00:00,0.62,0.96,0.81,153,123,176,21,7,14,29,15,14,15,6,9,+3,+1,+2,81%,67%,92%,99,76,116,14%,8%,19%,5,1,4,2,0,2
496,https://vlr.gg/player/3807/winteryrook,2024-07-28 10:00:00,0.99,1.10,1.04,200,205,193,31,17,14,31,21,10,12,4,8,+7,+5,+2,71%,67%,78%,121,129,110,36%,33%,41%,9,6,3,2,1,1
497,https://vlr.gg/player/5795/sickrey,2024-07-28 10:00:00,1.03,0.95,0.99,187,197,185,26,16,10,33,21,12,14,8,6,+1,0,+1,62%,58%,67%,127,119,138,31%,35%,26%,1,0,1,0,0,0
498,https://vlr.gg/player/1897/bgg,2024-07-28 10:00:00,0.63,0.98,0.78,182,177,195,25,13,12,34,22,12,10,4,6,-6,-4,-2,57%,50%,67%,129,125,134,41%,35%,50%,3,2,1,9,6,3
499,https://vlr.gg/player/1470/simond4rk,2024-07-28 10:00:00,0.12,1.71,0.78,158,62,295,24,3,21,33,24,9,4,2,2,-3,-7,+4,52%,29%,83%,119,52,209,17%,5%,29%,5,0,5,8,7,1
500,https://vlr.gg/player/2432/moner,2024-07-28 10:00:00,0.67,0.66,0.67,156,133,191,21,9,12,34,19,15,5,2,3,-2,-3,+1,57%,46%,72%,114,109,121,18%,20%,17%,2,0,2,4,3,1
0,https://vlr.gg/player/7353/glovee,2024-07-28 09:00:00,0.78,1.40,1.07,182,142,231,42,15,27,40,25,15,25,17,8,0,-1,+1,78%,74%,83%,118,96,145,27%,22%,31%,4,1,3,4,2,2
1,https://vlr.gg/player/6559/destruct1vee,2024-07-28 09:00:00,0.93,1.17,1.04,199,183,223,46,23,23,46,28,18,30,14,16,-1,-1,0,71%,65%,79%,123,110,138,24%,20%,29%,3,2,1,4,3,1
2,https://vlr.gg/player/10137/ip0tt,2024-07-28 09:00:00,0.72,1.25,0.96,226,203,249,50,24,26,47,29,18,9,6,3,+7,+2,+5,67%,62%,72%,143,131,158,24%,22%,26%,17,10,7,10,8,2
3,https://vlr.gg/player/4962/lurzy0y0,2024-07-28 09:00:00,0.97,0.96,0.96,190,189,194,42,21,21,47,26,21,13,7,6,-2,-1,-1,73%,68%,79%,121,119,122,38%,34%,43%,4,1,3,6,2,4
4,https://vlr.gg/player/5517/masic,2024-07-28 09:00:00,1.02,0.59,0.80,168,197,129,33,22,11,50,27,23,21,14,7,+1,-1,+2,63%,65%,62%,112,128,93,26%,25%,28%,6,2,4,5,3,2
5,https://vlr.gg/player/34684/westside,2024-07-28 09:00:00,1.16,1.20,1.18,229,224,231,54,25,29,41,20,21,9,2,7,-1,-1,0,67%,55%,76%,158,150,165,36%,41%,32%,3,1,2,4,2,2
6,https://vlr.gg/player/5490/xitsha,2024-07-28 09:00:00,0.53,1.64,1.13,207,103,296,47,9,38,39,22,17,27,15,12,-3,-6,+3,76%,69%,82%,132,72,183,26%,24%,27%,5,0,5,8,6,2
7,https://vlr.gg/player/24424/pa1ze,2024-07-28 09:00:00,0.84,1.30,1.09,249,227,269,54,22,32,48,25,23,11,4,7,+2,0,+2,76%,69%,82%,153,132,171,19%,27%,14%,16,7,9,14,7,7
8,https://vlr.gg/player/3839/prti,2024-07-28 09:00:00,1.08,0.73,0.89,176,200,159,40,21,19,42,19,23,23,5,18,-5,-2,-3,71%,76%,68%,125,142,111,27%,31%,24%,1,0,1,6,2,4
9,https://vlr.gg/player/8593/grmekista,2024-07-28 09:00:00,0.86,0.86,0.86,160,174,149,35,18,17,43,22,21,25,6,19,+2,+2,0,76%,72%,79%,103,108,99,17%,24%,12%,4,3,1,2,1,1
10,https://vlr.gg/player/7883/silenttt,2024-07-28 09:00:00,0.69,1.15,0.97,176,142,199,26,7,19,28,14,14,7,3,4,-3,-2,-1,60%,44%,71%,119,101,132,42%,35%,45%,2,0,2,5,2,3
11,https://vlr.gg/player/1377/phatt,2024-07-28 09:00:00,0.62,1.17,0.95,160,133,177,23,8,15,28,15,13,12,4,8,-3,-2,-1,68%,56%,75%,113,84,133,37%,39%,37%,2,0,2,5,2,3
12,https://vlr.gg/player/16012/akira,2024-07-28 09:00:00,0.49,1.14,0.88,151,126,168,19,7,12,28,15,13,7,1,6,-2,-2,0,65%,50%,75%,113,92,126,27%,31%,25%,0,0,0,2,2,0
13,https://vlr.gg/player/8590/killdream,2024-07-28 09:00:00,0.57,1.06,0.87,215,147,261,26,6,20,32,14,18,13,4,9,0,0,0,65%,63%,67%,140,95,170,20%,16%,22%,4,2,2,4,2,2
14,https://vlr.gg/player/26808/fainz,2024-07-28 09:00:00,0.28,0.79,0.58,157,133,172,17,5,12,33,16,17,10,2,8,-4,-4,0,53%,38%,63%,111,95,122,17%,13%,21%,6,1,5,10,5,5
15,https://vlr.gg/player/7490/anguist,2024-07-28 09:00:00,1.16,1.55,1.32,180,159,212,30,15,15,18,13,5,7,2,5,+2,+2,0,70%,58%,88%,124,106,152,34%,33%,36%,4,3,1,2,1,1
16,https://vlr.gg/player/2472/benny,2024-07-28 09:00:00,0.99,1.61,1.24,211,198,231,31,16,15,22,17,5,16,9,7,+1,-2,+3,73%,63%,88%,127,134,117,18%,20%,16%,6,3,3,5,5,0
17,https://vlr.gg/player/4329/vince,2024-07-28 09:00:00,1.15,1.36,1.23,241,238,246,36,21,15,24,16,8,13,8,5,+4,+4,0,78%,75%,81%,146,137,160,17%,15%,19%,6,4,2,2,0,2
18,https://vlr.gg/player/1835/elllement,2024-07-28 09:00:00,0.68,1.69,1.09,231,161,336,33,12,21,25,17,8,7,3,4,+8,+1,+7,70%,54%,94%,157,110,227,22%,16%,27%,10,3,7,2,2,0
19,https://vlr.gg/player/10885/davih,2024-07-28 09:00:00,0.91,1.03,0.96,144,141,149,19,11,8,22,15,7,18,13,5,-3,-3,0,70%,63%,81%,106,108,102,10%,9%,10%,0,0,0,3,3,0
20,https://vlr.gg/player/1437/yesican,2024-07-28 06:00:00,0.97,1.45,1.24,227,179,241,62,20,42,58,28,30,41,24,17,0,+1,-1,75%,81%,71%,151,127,169,26%,23%,28%,5,2,3,5,1,4
21,https://vlr.gg/player/23976/crus,2024-07-28 06:00:00,1.03,0.95,0.98,197,188,208,58,24,34,64,26,38,36,18,18,-5,-3,-2,74%,76%,73%,136,129,142,41%,39%,43%,5,1,4,10,4,6
22,https://vlr.gg/player/8225/f1cio,2024-07-28 06:00:00,0.92,0.93,0.93,203,192,200,56,25,31,65,28,37,33,18,15,+6,+5,+1,69%,70%,69%,129,128,130,30%,25%,34%,10,6,4,4,1,3
23,https://vlr.gg/player/46463/twilight,2024-07-28 06:00:00,1.17,0.74,0.93,187,230,159,59,33,26,62,26,36,17,9,8,+3,-1,+4,73%,78%,69%,131,163,106,35%,34%,36%,9,2,7,6,3,3
24,https://vlr.gg/player/14254/gin,2024-07-28 06:00:00,0.75,0.88,0.82,222,222,216,66,30,36,75,33,42,13,6,7,-5,-5,0,71%,76%,67%,139,144,136,34%,36%,32%,13,6,7,18,11,7
25,https://vlr.gg/player/14209/suka,2024-07-28 06:00:00,1.60,1.36,1.49,292,334,261,90,54,36,60,33,27,44,28,16,-1,+1,-2,86%,88%,84%,205,219,186,28%,26%,31%,6,4,2,7,3,4
26,https://vlr.gg/player/14587/daft,2024-07-28 06:00:00,0.94,1.53,1.20,257,233,304,80,40,40,60,36,24,20,9,11,+6,-2,+8,79%,77%,81%,166,150,187,26%,26%,27%,19,9,10,13,11,2
27,https://vlr.gg/player/44149/pr0digy,2024-07-28 06:00:00,1.13,1.25,1.18,196,194,197,62,36,26,55,32,23,27,15,12,-2,+1,-3,78%,77%,78%,141,140,142,31%,31%,30%,4,3,1,6,2,4
28,https://vlr.gg/player/23042/tripciew,2024-07-28 06:00:00,1.00,0.57,0.81,158,174,137,47,31,16,61,32,29,36,18,18,-5,-3,-2,80%,83%,76%,104,118,86,28%,26%,31%,6,2,4,11,5,6
29,https://vlr.gg/player/19154/albus,2024-07-28 06:00:00,0.55,0.77,0.65,152,134,190,44,21,23,65,37,28,17,10,7,+3,+1,+2,66%,63%,70%,106,93,124,25%,27%,24%,8,5,3,5,4,1
30,https://vlr.gg/player/23710/gotten,2024-07-28 04:00:00,0.96,1.22,1.08,203,199,219,77,40,37,77,45,32,41,20,21,-1,-4,+3,72%,69%,75%,139,133,146,28%,32%,24%,9,1,8,10,5,5
31,https://vlr.gg/player/7807/valdyn,2024-07-28 04:00:00,0.96,1.20,1.07,202,185,227,81,36,45,79,45,34,53,25,28,+2,+1,+1,77%,78%,76%,131,122,142,34%,40%,29%,7,3,4,5,2,3
32,https://vlr.gg/player/2346/cud,2024-07-28 04:00:00,0.65,1.24,0.92,182,139,232,70,25,45,73,46,27,16,7,9,+7,0,+7,65%,53%,78%,120,94,149,28%,35%,25%,13,5,8,6,5,1
33,https://vlr.gg/player/4866/kushy,2024-07-28 04:00:00,0.96,0.86,0.91,197,217,176,74,43,31,83,45,38,29,11,18,-2,-4,+2,68%,62%,75%,131,139,121,35%,33%,38%,11,7,4,13,11,2
34,https://vlr.gg/player/11666/ray4c,2024-07-28 04:00:00,0.44,1.02,0.71,182,143,230,63,24,39,91,54,37,25,11,14,-11,-11,0,65%,55%,76%,125,99,155,12%,12%,12%,12,4,8,23,15,8
35,https://vlr.gg/player/2380/zesbeew,2024-07-28 04:00:00,1.05,1.67,1.38,246,204,282,97,38,59,68,40,28,54,19,35,+5,0,+5,81%,75%,86%,158,126,185,20%,21%,20%,8,2,6,3,2,1
36,https://vlr.gg/player/10739/shiro,2024-07-28 04:00:00,0.94,1.50,1.24,230,190,272,86,32,54,72,39,33,55,21,34,+2,-5,+7,81%,71%,90%,157,134,177,26%,26%,25%,12,1,11,10,6,4
37,https://vlr.gg/player/4874/berserx,2024-07-28 04:00:00,0.97,1.19,1.09,207,192,211,75,34,41,71,38,33,41,14,27,+1,-1,+2,80%,76%,83%,138,124,151,18%,15%,20%,13,7,6,12,8,4
38,https://vlr.gg/player/2348/famouz,2024-07-28 04:00:00,0.99,1.04,1.02,218,224,216,84,38,46,77,40,37,27,10,17,-2,-3,+1,68%,61%,74%,140,144,136,15%,19%,12%,16,9,7,18,12,6
39,https://vlr.gg/player/7043/ncslasher,2024-07-28 04:00:00,0.72,0.94,0.84,166,166,167,61,26,35,78,41,37,52,23,29,-1,-4,+3,79%,76%,81%,106,107,105,23%,29%,19%,8,0,8,9,4,5
40,https://vlr.gg/player/46170/dorothy,2024-07-28 03:00:00,1.18,1.43,1.29,266,259,276,73,40,33,51,31,20,15,9,6,+7,0,+7,78%,73%,85%,173,166,182,24%,32%,17%,16,7,9,9,7,2
41,https://vlr.gg/player/40151/h4ste,2024-07-28 03:00:00,1.24,1.23,1.23,223,211,240,62,32,30,49,26,23,32,17,15,+1,+1,0,76%,77%,74%,144,141,147,35%,29%,43%,10,5,5,9,4,5
42,https://vlr.gg/player/40556/f1yk,2024-07-28 03:00:00,1.30,1.09,1.21,197,189,203,57,33,24,43,22,21,15,6,9,+5,+3,+2,79%,75%,85%,137,132,144,32%,32%,32%,7,4,3,2,1,1
43,https://vlr.gg/player/40410/332,2024-07-28 03:00:00,1.09,0.99,1.05,180,186,170,49,27,22,49,25,24,24,11,13,+1,+1,0,69%,70%,68%,128,132,123,30%,27%,34%,6,3,3,5,2,3
44,https://vlr.gg/player/40423/bibi,2024-07-28 03:00:00,0.93,0.86,0.90,192,206,171,51,33,18,56,33,23,35,15,20,-4,-3,-1,73%,75%,71%,129,135,120,23%,28%,18%,5,4,1,9,7,2
45,https://vlr.gg/player/34977/delilah,2024-07-28 03:00:00,1.37,0.86,1.08,201,242,171,55,30,25,53,21,32,14,5,9,-6,-2,-4,65%,76%,57%,128,154,108,27%,34%,21%,7,4,3,13,6,7
46,https://vlr.gg/player/40411/myoh4nn,2024-07-28 03:00:00,0.83,1.20,1.04,246,202,279,69,26,43,62,28,34,15,5,10,0,-3,+3,72%,62%,80%,153,124,175,34%,27%,39%,13,4,9,13,7,6
47,https://vlr.gg/player/40416/dannn,2024-07-28 03:00:00,0.66,0.85,0.77,140,132,152,36,13,23,54,25,29,15,7,8,+1,-2,+3,62%,62%,61%,99,94,103,12%,14%,11%,7,1,6,6,3,3
48,https://vlr.gg/player/30329/yuh4,2024-07-28 03:00:00,0.90,0.64,0.76,177,213,150,46,24,22,63,27,36,21,10,11,-1,+1,-2,60%,65%,57%,115,134,99,20%,20%,21%,4,3,1,5,2,3
49,https://vlr.gg/player/40412/b1nby0,2024-07-28 03:00:00,0.71,0.71,0.71,160,158,163,42,18,24,60,26,34,25,9,16,-4,-2,-2,64%,59%,68%,108,109,108,21%,19%,23%,3,1,2,7,3,4
50,https://vlr.gg/player/18093/kamiyu,2024-07-28 02:00:00,1.30,1.40,1.34,247,233,256,71,41,30,47,29,18,31,26,5,0,+1,-1,85%,92%,74%,150,142,162,31%,33%,29%,4,3,1,4,2,2
51,https://vlr.gg/player/18091/shirazi,2024-07-28 02:00:00,1.30,1.32,1.30,235,252,239,69,43,26,46,28,18,20,12,8,0,-1,+1,80%,81%,77%,169,176,157,22%,23%,20%,6,2,4,6,3,3
52,https://vlr.gg/player/8176/enerii,2024-07-28 02:00:00,1.26,1.09,1.19,260,266,220,69,45,24,53,33,20,17,11,6,-1,-2,+1,77%,77%,77%,163,174,148,26%,25%,26%,15,10,5,16,12,4
53,https://vlr.gg/player/16621/alexy,2024-07-28 02:00:00,1.09,0.98,1.05,217,211,229,60,37,23,52,30,22,23,12,11,+4,0,+4,82%,83%,81%,149,145,155,23%,25%,21%,11,5,6,7,5,2
54,https://vlr.gg/player/8492/tara,2024-07-28 02:00:00,1.00,0.76,0.90,173,178,162,51,33,18,51,29,22,22,16,6,-2,-2,0,76%,79%,71%,114,118,107,25%,25%,25%,4,2,2,6,4,2
55,https://vlr.gg/player/26069/piety,2024-07-28 02:00:00,0.93,1.00,0.97,190,196,195,55,21,34,62,25,37,18,6,12,-2,-1,-1,68%,68%,69%,134,124,141,27%,29%,25%,2,1,1,4,2,2
56,https://vlr.gg/player/45029/grahams,2024-07-28 02:00:00,0.92,0.98,0.96,203,195,210,55,22,33,63,24,39,16,6,10,-3,-1,-2,65%,65%,65%,129,111,141,40%,35%,44%,9,4,5,12,5,7
57,https://vlr.gg/player/18062/capricious,2024-07-28 02:00:00,0.89,0.76,0.81,204,198,209,55,22,33,68,25,43,21,7,14,+4,-2,+6,67%,68%,67%,131,126,134,33%,35%,32%,16,4,12,12,6,6
58,https://vlr.gg/player/16635/poly,2024-07-28 02:00:00,0.80,0.72,0.75,158,155,167,43,18,25,64,24,40,26,11,15,-2,0,-2,76%,90%,67%,105,97,111,31%,35%,28%,5,2,3,7,2,5
59,https://vlr.gg/player/25388/kon,2024-07-28 02:00:00,0.80,0.70,0.74,154,167,153,41,17,24,63,23,40,16,5,11,+2,-1,+3,63%,55%,69%,116,118,115,35%,35%,34%,7,2,5,5,3,2
60,https://vlr.gg/player/24679/cgrs,2024-07-28 02:00:00,1.10,1.01,1.06,213,237,186,57,33,24,59,31,28,34,12,22,+3,+3,0,77%,81%,73%,141,158,124,19%,23%,15%,8,5,3,5,2,3
61,https://vlr.gg/player/13784/killua,2024-07-28 02:00:00,1.16,0.85,1.01,217,248,193,64,36,28,67,33,34,23,15,8,-2,-5,+3,73%,79%,68%,152,166,137,38%,35%,42%,7,1,6,9,6,3
62,https://vlr.gg/player/12098/kadoom,2024-07-28 02:00:00,0.72,1.19,0.95,217,191,248,61,27,34,68,35,33,15,5,10,0,-5,+5,65%,60%,71%,145,122,168,24%,24%,25%,15,6,9,15,11,4
63,https://vlr.gg/player/27244/seph1roth,2024-07-28 02:00:00,0.88,1.02,0.95,209,188,225,59,28,31,58,29,29,13,6,7,-2,-1,-1,70%,64%,76%,140,125,155,37%,42%,34%,6,3,3,8,4,4
64,https://vlr.gg/player/14674/kntz,2024-07-28 02:00:00,0.99,0.75,0.86,137,149,137,47,26,21,59,28,31,23,11,12,+2,+4,-2,70%,74%,66%,95,106,83,26%,29%,23%,6,4,2,4,0,4
65,https://vlr.gg/player/27254/leviathan,2024-07-28 02:00:00,1.30,1.25,1.28,228,221,238,72,35,37,52,22,30,35,18,17,-1,-2,+1,78%,80%,76%,149,144,154,31%,35%,27%,5,2,3,6,4,2
66,https://vlr.gg/player/6723/foxz,2024-07-28 02:00:00,1.14,0.95,1.04,191,208,175,53,31,22,56,25,31,28,9,19,+1,0,+1,72%,73%,71%,130,139,120,25%,25%,24%,5,3,2,4,3,1
67,https://vlr.gg/player/3401/ptc,2024-07-28 02:00:00,1.01,1.01,1.01,190,192,184,57,28,29,55,28,27,31,17,14,+1,-1,+2,76%,76%,76%,119,122,116,23%,24%,21%,8,3,5,7,4,3
68,https://vlr.gg/player/4377/johnolsen,2024-07-28 02:00:00,0.86,1.08,0.97,241,231,253,71,33,38,65,34,31,14,7,7,0,0,0,71%,71%,71%,160,153,167,27%,30%,24%,16,7,9,16,7,9
69,https://vlr.gg/player/3342/sushiboys,2024-07-28 02:00:00,0.93,0.86,0.89,192,183,194,58,28,30,60,29,31,25,16,9,-2,-2,0,69%,76%,62%,121,117,125,21%,22%,20%,7,3,4,9,5,4
70,https://vlr.gg/player/40411/myoh4nn,2024-07-28 01:00:00,1.60,1.35,1.47,295,267,318,45,21,24,24,8,16,9,3,6,-2,-1,-1,86%,80%,91%,192,176,206,25%,26%,25%,2,0,2,4,1,3
71,https://vlr.gg/player/40416/dannn,2024-07-28 01:00:00,1.27,1.29,1.28,236,248,225,37,20,17,25,12,13,9,3,6,+4,+2,+2,81%,85%,77%,150,164,138,24%,36%,17%,7,3,4,3,1,2
72,https://vlr.gg/player/30329/yuh4,2024-07-28 01:00:00,1.55,0.87,1.20,225,287,173,33,21,12,24,11,13,24,11,13,-1,+1,-2,76%,80%,73%,144,183,108,22%,18%,28%,3,2,1,4,1,3
73,https://vlr.gg/player/34977/delilah,2024-07-28 01:00:00,0.65,1.16,0.92,200,177,219,27,10,17,29,15,14,12,9,3,-2,-5,+3,74%,70%,77%,127,126,127,18%,18%,18%,6,2,4,8,7,1
74,https://vlr.gg/player/40412/b1nby0,2024-07-28 01:00:00,0.99,0.86,0.92,166,188,146,25,14,11,30,14,16,19,6,13,-1,-1,0,81%,85%,77%,106,128,86,27%,34%,21%,2,1,1,3,2,1
75,https://vlr.gg/player/47133/arin,2024-07-28 01:00:00,1.62,0.95,1.30,249,300,193,38,25,13,28,13,15,6,4,2,+5,+5,0,64%,73%,55%,163,192,131,30%,30%,29%,9,7,2,4,2,2
76,https://vlr.gg/player/46151/even1ng,2024-07-28 01:00:00,0.83,0.82,0.83,197,202,196,28,16,12,36,18,18,12,5,7,+1,0,+1,69%,77%,60%,125,118,133,29%,22%,37%,4,0,4,3,0,3
77,https://vlr.gg/player/46152/atti,2024-07-28 01:00:00,0.51,1.12,0.80,211,184,240,29,13,16,36,20,16,7,4,3,-3,-6,+3,67%,64%,70%,147,132,163,27%,27%,27%,4,1,3,7,7,0
78,https://vlr.gg/player/47215/ran,2024-07-28 01:00:00,0.85,0.64,0.73,142,118,163,11,5,6,18,7,11,3,2,1,+1,0,+1,68%,70%,67%,101,91,109,42%,56%,36%,2,1,1,1,1,0
79,https://vlr.gg/player/34956/penelope,2024-07-28 01:00:00,0.80,0.40,0.64,144,150,138,10,7,3,16,8,8,4,2,2,+1,0,+1,65%,75%,50%,91,92,88,21%,21%,21%,2,1,1,1,1,0
80,https://vlr.gg/player/46150/ys2,2024-07-28 01:00:00,0.54,0.61,0.55,111,82,148,16,6,10,33,15,18,15,8,7,-3,-1,-2,55%,55%,55%,73,59,88,12%,8%,15%,1,0,1,4,1,3
81,https://vlr.gg/player/10584/seoldam,2024-07-28 01:00:00,0.88,1.35,1.12,200,196,209,93,38,55,73,40,33,22,8,14,+6,+5,+1,77%,73%,81%,127,123,131,23%,22%,24%,17,10,7,11,5,6
82,https://vlr.gg/player/43064/aace,2024-07-28 01:00:00,1.16,1.01,1.09,204,220,190,89,41,48,78,35,43,33,24,9,+1,+2,-1,79%,80%,78%,135,139,130,26%,20%,34%,7,5,2,6,3,3
83,https://vlr.gg/player/29841/caedye,2024-07-28 01:00:00,1.02,0.83,0.93,174,202,145,77,43,34,79,37,42,23,6,17,0,-1,+1,77%,71%,83%,115,137,94,31%,27%,37%,11,6,5,11,7,4
84,https://vlr.gg/player/4663/joxjo,2024-07-28 01:00:00,1.02,0.85,0.93,164,184,143,76,41,35,82,36,46,30,12,18,-1,-2,+1,71%,68%,74%,109,124,94,31%,29%,34%,5,2,3,6,4,2
85,https://vlr.gg/player/29843/yatsuka,2024-07-28 01:00:00,0.76,0.89,0.83,163,160,163,74,27,47,83,40,43,26,14,12,+2,-2,+4,73%,70%,76%,112,114,109,32%,28%,36%,14,5,9,12,7,5
86,https://vlr.gg/player/2615/clz,2024-07-28 01:00:00,1.17,1.00,1.09,178,160,193,75,32,43,79,29,50,40,19,21,-2,+1,-3,74%,76%,71%,124,122,126,33%,35%,31%,8,4,4,10,3,7
87,https://vlr.gg/player/12990/syouta,2024-07-28 01:00:00,1.00,1.11,1.05,196,166,228,95,35,60,79,33,46,17,5,12,0,-1,+1,71%,78%,64%,130,111,150,40%,41%,39%,9,4,5,9,5,4
88,https://vlr.gg/player/25221/xdll,2024-07-28 01:00:00,0.90,1.00,0.95,203,173,224,85,34,51,86,39,47,27,14,13,0,-3,+3,71%,76%,66%,129,114,144,30%,30%,30%,12,2,10,12,5,7
89,https://vlr.gg/player/1395/tennn,2024-07-28 01:00:00,0.73,1.09,0.91,181,145,212,85,31,54,87,37,50,13,2,11,0,+1,-1,69%,67%,71%,123,98,149,36%,42%,33%,12,7,5,12,6,6
90,https://vlr.gg/player/6673/gon,2024-07-28 01:00:00,0.84,0.65,0.75,121,130,111,55,27,28,78,33,45,33,15,18,-6,-4,-2,68%,69%,66%,78,84,72,28%,28%,29%,5,3,2,11,7,4
91,https://vlr.gg/player/9185/dodonut,2024-07-27 19:30:00,1.04,1.34,1.19,236,213,263,66,29,37,53,26,27,25,10,15,+1,0,+1,78%,79%,77%,152,139,164,26%,31%,22%,10,4,6,9,4,5
92,https://vlr.gg/player/11968/l4ce,2024-07-27 19:30:00,1.14,1.19,1.17,193,202,182,56,28,28,48,24,24,26,11,15,-3,-1,-2,81%,82%,79%,133,148,119,37%,36%,39%,2,1,1,5,2,3
93,https://vlr.gg/player/8329/starbound,2024-07-27 19:30:00,1.03,1.01,1.02,203,220,188,55,30,25,56,28,28,26,9,17,+7,+3,+4,74%,66%,82%,131,138,124,15%,20%,11%,14,8,6,7,5,2
94,https://vlr.gg/player/8849/sonder,2024-07-27 19:30:00,0.85,1.08,0.97,237,215,250,60,27,33,64,33,31,26,13,13,+1,-3,+4,74%,71%,77%,145,141,150,24%,29%,20%,10,3,7,9,6,3
95,https://vlr.gg/player/33694/evv,2024-07-27 19:30:00,0.97,0.83,0.90,183,183,186,48,25,23,56,25,31,25,11,14,+1,-1,+2,74%,74%,74%,123,122,124,35%,39%,31%,6,2,4,5,3,2
96,https://vlr.gg/player/17976/florescent,2024-07-27 19:30:00,1.06,1.46,1.26,271,254,289,71,34,37,56,30,26,22,12,10,+2,0,+2,78%,74%,82%,177,164,191,25%,27%,24%,9,4,5,7,4,3
97,https://vlr.gg/player/17397/noia,2024-07-27 19:30:00,1.03,0.96,0.99,194,202,186,52,27,25,54,28,26,24,12,12,-1,-2,+1,68%,69%,66%,133,141,124,27%,30%,25%,5,3,2,6,5,1
98,https://vlr.gg/player/3079/alexis,2024-07-27 19:30:00,0.95,0.88,0.92,177,179,173,46,23,23,55,28,27,35,21,14,+1,+3,-2,69%,72%,66%,113,112,113,39%,40%,39%,4,4,0,3,1,2
99,https://vlr.gg/player/21486/sarahcat,2024-07-27 19:30:00,0.89,0.95,0.92,219,207,235,60,31,29,60,29,31,15,6,9,-10,-8,-2,66%,67%,66%,140,131,150,25%,22%,28%,6,1,5,16,9,7
100,https://vlr.gg/player/3063/mel,2024-07-27 19:30:00,0.88,0.81,0.84,192,210,175,48,26,22,60,31,29,31,15,16,+1,-2,+3,73%,72%,74%,123,145,99,25%,26%,24%,11,3,8,10,5,5
101,https://vlr.gg/player/2468/delz1k,2024-07-27 17:30:00,1.14,1.13,1.14,222,236,209,85,48,37,73,43,30,33,15,18,+1,+1,0,74%,66%,83%,146,158,131,27%,26%,28%,5,3,2,4,2,2
102,https://vlr.gg/player/1294/nagz,2024-07-27 17:30:00,1.04,1.09,1.07,206,205,206,71,39,32,69,41,28,31,14,17,-2,-2,0,75%,69%,81%,138,144,131,25%,32%,18%,10,5,5,12,7,5
103,https://vlr.gg/player/2464/suther,2024-07-27 17:30:00,0.92,0.92,0.92,154,144,166,53,28,25,68,38,30,48,25,23,-8,-6,-2,63%,55%,73%,104,92,119,22%,21%,23%,3,1,2,11,7,4
104,https://vlr.gg/player/783/murizzz,2024-07-27 17:30:00,1.02,0.76,0.90,188,202,175,70,42,28,79,44,35,23,13,10,+1,-2,+3,68%,69%,67%,128,136,118,30%,32%,29%,10,3,7,9,5,4
105,https://vlr.gg/player/8892/snw,2024-07-27 17:30:00,0.50,1.23,0.83,187,142,242,71,27,44,76,50,26,12,9,3,-8,-13,+5,65%,55%,77%,121,92,156,19%,17%,20%,17,6,11,25,19,6
106,https://vlr.gg/player/9354/cebando,2024-07-27 17:30:00,1.30,1.18,1.24,226,225,229,88,39,49,65,30,35,41,18,23,+1,0,+1,81%,81%,81%,148,135,158,38%,36%,38%,8,4,4,7,4,3
107,https://vlr.gg/player/41135/dantedeu5,2024-07-27 17:30:00,0.80,1.42,1.14,253,182,309,93,31,62,82,37,45,33,11,22,+15,-2,+17,78%,69%,86%,160,121,193,33%,25%,38%,31,10,21,16,12,4
108,https://vlr.gg/player/3826/adverso,2024-07-27 17:30:00,1.00,1.03,1.01,177,169,182,66,30,36,66,33,33,42,20,22,+4,-1,+5,77%,85%,71%,111,105,117,21%,20%,21%,11,2,9,7,3,4
109,https://vlr.gg/player/13861/nicomachine,2024-07-27 17:30:00,0.83,0.91,0.88,174,181,168,62,29,33,74,38,36,58,30,28,0,0,0,75%,73%,78%,110,116,106,22%,20%,24%,6,4,2,6,4,2
110,https://vlr.gg/player/2585/tinchoff,2024-07-27 17:30:00,0.71,0.91,0.82,147,126,164,56,21,35,65,29,36,26,7,19,-4,-3,-1,78%,71%,84%,97,84,108,30%,27%,32%,5,1,4,9,4,5
111,https://vlr.gg/player/28716/lukxo,2024-07-27 16:00:00,1.19,1.76,1.44,286,265,325,47,22,25,30,19,11,13,6,7,-2,-4,+2,72%,63%,84%,210,183,245,38%,32%,45%,3,0,3,5,4,1
112,https://vlr.gg/player/1688/rood,2024-07-27 16:00:00,1.05,1.39,1.20,191,171,215,31,15,16,22,14,8,12,4,8,0,-1,+1,84%,79%,89%,120,105,139,20%,24%,17%,4,1,3,4,2,2
113,https://vlr.gg/player/6238/urango,2024-07-27 16:00:00,0.93,1.46,1.17,225,166,288,35,16,19,30,16,14,22,8,14,+1,0,+1,70%,58%,84%,136,93,189,40%,48%,36%,5,2,3,4,2,2
114,https://vlr.gg/player/1994/evilkyk,2024-07-27 16:00:00,0.91,1.38,1.12,196,160,259,30,12,18,27,17,10,15,9,6,+2,+1,+1,84%,71%,100%,121,99,149,28%,20%,39%,2,1,1,0,0,0
115,https://vlr.gg/player/21659/sato,2024-07-27 16:00:00,0.75,0.72,0.74,178,215,121,25,16,9,33,21,12,12,8,4,-4,-4,0,70%,63%,79%,112,132,86,23%,25%,17%,6,4,2,10,8,2
116,https://vlr.gg/player/21661/spike,2024-07-27 16:00:00,0.74,1.20,1.00,216,183,242,34,12,22,32,17,15,5,3,2,+2,0,+2,72%,68%,75%,154,122,178,29%,22%,34%,8,4,4,6,4,2
117,https://vlr.gg/player/3169/zap,2024-07-27 16:00:00,0.60,1.21,0.94,178,150,207,29,10,19,32,17,15,7,3,4,+3,-1,+4,70%,58%,79%,125,100,144,23%,19%,25%,5,0,5,2,1,1
118,https://vlr.gg/player/11921/silentzz,2024-07-27 16:00:00,0.73,1.02,0.89,215,213,222,32,13,19,36,19,17,14,4,10,0,-1,+1,86%,89%,83%,139,137,140,39%,38%,41%,4,2,2,4,3,1
119,https://vlr.gg/player/662/pryze,2024-07-27 16:00:00,0.79,0.94,0.87,180,165,193,26,11,15,33,16,17,6,3,3,0,-1,+1,65%,63%,67%,121,108,131,34%,28%,38%,4,1,3,4,2,2
120,https://vlr.gg/player/6195/lz,2024-07-27 16:00:00,0.56,0.87,0.74,167,150,174,21,9,12,35,18,17,22,10,12,-2,-2,0,72%,68%,75%,103,87,117,42%,45%,40%,2,0,2,4,2,2
121,https://vlr.gg/player/13860/rubkkoide,2024-07-27 14:00:00,1.27,0.98,1.13,227,256,205,50,29,21,46,24,22,17,7,10,+7,+4,+3,75%,79%,70%,153,169,136,31%,30%,32%,12,6,6,5,2,3
122,https://vlr.gg/player/12872/david,2024-07-27 14:00:00,0.86,1.35,1.09,221,204,235,51,26,25,44,28,16,28,14,14,+1,-2,+3,81%,82%,80%,155,152,157,30%,30%,30%,4,0,4,3,2,1
123,https://vlr.gg/player/11046/deigara,2024-07-27 14:00:00,0.86,1.17,1.01,194,173,212,46,23,23,47,25,22,19,7,12,-4,-2,-2,70%,71%,70%,123,113,135,30%,27%,34%,2,2,0,6,4,2
124,https://vlr.gg/player/7652/tuli,2024-07-27 14:00:00,0.83,0.97,0.89,214,200,223,45,23,22,50,27,23,21,11,10,0,-1,+1,78%,76%,80%,138,137,140,29%,26%,33%,9,6,3,9,7,2
125,https://vlr.gg/player/2403/mizu,2024-07-27 14:00:00,0.83,0.91,0.87,161,152,170,34,18,16,45,23,22,25,9,16,0,-1,+1,69%,68%,70%,121,108,136,27%,25%,28%,7,2,5,7,3,4
126,https://vlr.gg/player/7616/feniz,2024-07-27 14:00:00,0.91,1.36,1.15,210,179,245,45,19,26,45,20,25,26,11,15,+1,-2,+3,80%,80%,79%,152,126,175,26%,26%,26%,3,0,3,2,2,0
127,https://vlr.gg/player/3983/virtyy,2024-07-27 14:00:00,1.05,1.01,1.03,249,254,251,55,27,28,50,23,27,7,1,6,-1,-2,+1,64%,70%,59%,156,159,153,23%,31%,17%,11,4,7,12,6,6
128,https://vlr.gg/player/10557/darker,2024-07-27 14:00:00,0.97,1.01,0.99,209,201,224,49,22,27,47,24,23,23,12,11,0,+1,-1,77%,80%,74%,136,120,150,22%,19%,23%,7,5,2,7,4,3
129,https://vlr.gg/player/8056/mited,2024-07-27 14:00:00,0.73,1.22,0.99,197,162,222,41,16,25,43,24,19,29,14,15,-3,-3,0,78%,73%,82%,126,107,144,19%,27%,14%,3,2,1,6,5,1
130,https://vlr.gg/player/17690/jow,2024-07-27 14:00:00,1.25,0.71,0.97,174,192,157,41,21,20,42,17,25,13,8,5,-1,0,-1,75%,80%,71%,118,142,97,37%,38%,37%,6,1,5,7,1,6
131,https://vlr.gg/player/7104/juseu,2024-07-27 12:30:00,1.20,1.03,1.10,233,281,214,46,21,25,45,19,26,10,4,6,+3,+1,+2,72%,82%,67%,158,180,144,28%,29%,28%,13,5,8,10,4,6
132,https://vlr.gg/player/6828/pa1ka,2024-07-27 12:30:00,0.65,1.01,0.87,158,127,174,30,10,20,40,16,24,10,1,9,-3,-2,-1,60%,50%,67%,100,90,107,29%,41%,25%,4,1,3,7,3,4
133,https://vlr.gg/player/3579/marctylinho,2024-07-27 12:30:00,0.91,0.69,0.77,167,171,158,32,14,18,44,17,27,17,5,12,-1,0,-1,66%,73%,61%,102,110,97,22%,21%,24%,4,1,3,5,1,4
134,https://vlr.gg/player/2841/foxie,2024-07-27 12:30:00,0.85,0.67,0.74,144,174,131,26,12,14,44,17,27,19,12,7,-7,-3,-4,59%,64%,56%,99,101,97,25%,24%,26%,2,1,1,9,4,5
135,https://vlr.gg/player/2525/szimpli,2024-07-27 12:30:00,0.44,0.67,0.58,150,124,178,31,9,22,52,20,32,15,10,5,+2,0,+2,59%,64%,56%,105,81,120,36%,20%,46%,3,1,2,1,1,0
136,https://vlr.gg/player/11322/sevire,2024-07-27 12:30:00,1.56,1.14,1.40,208,239,189,45,29,16,27,15,12,31,19,12,0,-1,+1,79%,72%,91%,140,155,116,21%,20%,22%,3,1,2,3,2,1
137,https://vlr.gg/player/12579/darklight,2024-07-27 12:30:00,1.19,1.33,1.24,230,226,209,44,29,15,33,21,12,23,12,11,0,+1,-1,71%,75%,64%,138,141,134,36%,38%,33%,6,4,2,6,3,3
138,https://vlr.gg/player/2114/kinguyen,2024-07-27 12:30:00,1.01,1.42,1.17,268,233,312,55,29,26,41,25,16,12,7,5,+5,+3,+2,72%,72%,73%,182,170,200,39%,41%,36%,15,9,6,10,6,4
139,https://vlr.gg/player/8217/memset,2024-07-27 12:30:00,1.37,0.85,1.17,209,229,160,45,31,14,31,17,14,12,9,3,0,0,0,78%,78%,77%,139,161,102,28%,30%,23%,4,4,0,4,4,0
140,https://vlr.gg/player/1387/apo,2024-07-27 12:30:00,0.76,1.34,0.98,160,123,236,36,18,18,33,21,12,16,5,11,+1,-1,+2,78%,75%,82%,107,75,159,30%,22%,41%,4,1,3,3,2,1
141,https://vlr.gg/player/5554/profek,2024-07-27 11:00:00,1.20,1.21,1.21,212,217,209,61,32,29,45,24,21,27,15,12,0,-2,+2,78%,83%,74%,154,159,148,29%,26%,31%,5,0,5,5,2,3
142,https://vlr.gg/player/23169/minny,2024-07-27 11:00:00,1.19,0.97,1.08,200,208,185,58,32,26,49,22,27,13,6,7,-2,0,-2,78%,80%,76%,138,150,127,31%,31%,30%,5,3,2,7,3,4
143,https://vlr.gg/player/562/zeek,2024-07-27 11:00:00,1.36,0.76,1.06,186,236,156,56,34,22,51,22,29,25,14,11,-1,0,-1,77%,80%,74%,133,164,104,22%,25%,19%,5,2,3,6,2,4
144,https://vlr.gg/player/25906/alexiiik,2024-07-27 11:00:00,0.90,0.95,0.93,220,235,211,66,34,32,64,34,30,7,5,2,+7,+6,+1,65%,70%,60%,143,148,139,34%,39%,28%,19,12,7,12,6,6
145,https://vlr.gg/player/1155/buld,2024-07-27 11:00:00,0.76,0.89,0.82,167,155,171,47,23,24,58,30,28,28,12,16,-2,-4,+2,72%,80%,64%,109,106,112,33%,32%,33%,8,3,5,10,7,3
146,https://vlr.gg/player/34684/westside,2024-07-27 11:00:00,0.88,1.28,1.08,203,157,254,56,22,34,54,26,28,16,8,8,-2,-2,0,70%,67%,73%,136,106,167,38%,32%,42%,5,2,3,7,4,3
147,https://vlr.gg/player/5490/xitsha,2024-07-27 11:00:00,1.12,0.89,1.00,195,193,191,56,29,27,58,26,32,22,12,10,+1,-1,+2,70%,81%,58%,121,117,125,31%,36%,27%,5,3,2,4,4,0
148,https://vlr.gg/player/24424/pa1ze,2024-07-27 11:00:00,1.19,0.79,0.99,225,248,189,62,37,25,60,29,31,10,2,8,+1,+2,-1,68%,69%,68%,141,151,129,33%,38%,28%,18,11,7,17,9,8
149,https://vlr.gg/player/3839/prti,2024-07-27 11:00:00,1.03,0.76,0.90,197,200,174,53,30,23,59,26,33,33,21,12,+1,-1,+2,63%,67%,60%,117,127,107,27%,27%,26%,8,3,5,7,4,3
150,https://vlr.gg/player/8593/grmekista,2024-07-27 11:00:00,0.78,0.82,0.80,149,133,176,40,17,23,57,26,31,21,13,8,-3,0,-3,67%,74%,60%,108,96,122,24%,22%,26%,4,1,3,7,1,6
151,https://vlr.gg/player/3599/ixeonn,2024-07-27 10:00:00,0.75,1.48,1.14,230,189,267,39,13,26,35,18,17,5,2,3,+4,+2,+2,77%,73%,80%,163,131,191,33%,23%,40%,9,6,3,5,4,1
152,https://vlr.gg/player/3372/ori4k,2024-07-27 10:00:00,0.92,1.14,1.03,208,181,234,33,14,19,33,16,17,9,3,6,+6,+3,+3,74%,73%,76%,142,123,160,30%,33%,28%,6,3,3,0,0,0
153,https://vlr.gg/player/7994/brazy,2024-07-27 10:00:00,0.89,1.05,0.98,198,187,221,35,14,21,36,18,18,6,2,4,0,0,0,70%,64%,76%,130,133,128,33%,32%,33%,4,2,2,4,2,2
154,https://vlr.gg/player/33292/martux,2024-07-27 10:00:00,0.62,1.06,0.85,186,153,223,32,12,20,37,17,20,14,3,11,+2,-2,+4,68%,55%,80%,119,104,132,25%,25%,25%,5,0,5,3,2,1
155,https://vlr.gg/player/1283/m4china,2024-07-27 10:00:00,0.89,0.67,0.77,204,198,194,30,16,14,36,17,19,18,8,10,-3,-1,-2,62%,64%,60%,131,131,131,29%,33%,27%,4,1,3,7,2,5
156,https://vlr.gg/player/31058/kpro,2024-07-27 10:00:00,1.12,1.79,1.43,260,259,270,44,22,22,29,19,10,20,10,10,+1,-4,+5,85%,76%,95%,165,163,168,33%,30%,36%,5,0,5,4,4,0
157,https://vlr.gg/player/26837/poegii,2024-07-27 10:00:00,1.44,1.09,1.28,255,286,198,41,26,15,29,17,12,11,5,6,+1,+3,-2,72%,76%,68%,154,174,130,20%,21%,17%,4,4,0,3,1,2
158,https://vlr.gg/player/5498/kipperman,2024-07-27 10:00:00,1.08,1.34,1.20,271,261,287,48,23,25,38,22,16,13,10,3,0,+1,-1,79%,80%,77%,186,177,196,30%,30%,30%,6,3,3,6,2,4
159,https://vlr.gg/player/7169/glenn,2024-07-27 10:00:00,0.55,0.90,0.71,152,130,181,24,12,12,35,20,15,13,5,8,-6,-2,-4,68%,64%,73%,112,94,132,28%,39%,20%,3,2,1,9,4,5
160,https://vlr.gg/player/26809/tenshi,2024-07-27 10:00:00,0.38,0.82,0.59,134,115,154,20,8,12,38,22,16,14,8,6,-5,-5,0,62%,56%,68%,89,72,109,31%,32%,31%,1,0,1,6,5,1
161,https://vlr.gg/player/3342/sushiboys,2024-07-27 06:35:00,1.59,1.35,1.45,272,262,266,41,16,25,25,9,16,17,8,9,-1,0,-1,79%,78%,80%,169,177,164,27%,23%,29%,1,1,0,2,1,1
162,https://vlr.gg/player/4377/johnolsen,2024-07-27 06:35:00,1.08,1.34,1.23,272,221,283,38,15,23,31,13,18,13,2,11,+7,+4,+3,77%,78%,76%,170,142,189,21%,27%,18%,12,6,6,5,2,3
163,https://vlr.gg/player/6723/foxz,2024-07-27 06:35:00,1.04,1.23,1.15,203,129,250,31,10,21,29,10,19,22,8,14,+3,-2,+5,79%,83%,76%,132,92,161,29%,30%,29%,6,1,5,3,3,0
164,https://vlr.gg/player/3401/ptc,2024-07-27 06:35:00,1.02,1.10,1.07,202,199,201,31,13,18,30,13,17,14,4,10,+1,+3,-2,74%,72%,76%,131,122,138,31%,33%,30%,6,3,3,5,0,5
165,https://vlr.gg/player/27254/leviathan,2024-07-27 06:35:00,1.36,0.76,1.01,176,259,138,31,18,13,29,10,19,15,5,10,+1,+1,0,74%,83%,68%,125,179,86,46%,45%,48%,2,1,1,1,0,1
166,https://vlr.gg/player/12289/siraww,2024-07-27 06:35:00,1.31,0.80,1.10,251,270,248,38,25,13,33,18,15,10,7,3,-3,-1,-2,74%,76%,72%,172,180,162,40%,35%,50%,2,1,1,5,2,3
167,https://vlr.gg/player/2366/alert,2024-07-27 06:35:00,1.43,0.28,0.94,204,298,94,32,27,5,32,17,15,4,2,2,0,-1,+1,70%,72%,67%,129,176,64,25%,27%,19%,2,0,2,2,1,1
168,https://vlr.gg/player/2368/b3ta,2024-07-27 06:35:00,0.81,0.76,0.79,196,180,213,30,16,14,35,20,15,10,8,2,-1,+1,-2,63%,68%,56%,119,112,130,43%,46%,41%,5,3,2,6,2,4
169,https://vlr.gg/player/23930/potter,2024-07-27 06:35:00,0.35,1.03,0.63,163,146,207,25,12,13,36,25,11,7,5,2,-2,-3,+1,63%,56%,72%,117,109,129,28%,29%,26%,7,6,1,9,9,0
170,https://vlr.gg/player/10791/bnwgiggs,2024-07-27 06:35:00,0.41,0.62,0.50,137,120,150,19,9,10,37,21,16,12,8,4,-5,-1,-4,58%,60%,56%,86,82,93,21%,12%,36%,0,0,0,5,1,4
171,https://vlr.gg/player/14209/suka,2024-07-27 06:00:00,0.93,1.24,1.08,224,183,276,90,37,53,85,42,43,39,18,21,+4,+2,+2,69%,69%,68%,158,125,189,29%,34%,26%,9,4,5,5,2,3
172,https://vlr.gg/player/14587/daft,2024-07-27 06:00:00,1.22,0.86,1.04,212,251,186,79,44,35,81,40,41,27,12,15,-1,-3,+2,73%,73%,74%,150,172,129,27%,29%,26%,11,5,6,12,8,4
173,https://vlr.gg/player/19154/albus,2024-07-27 06:00:00,1.11,0.94,1.02,199,200,195,77,41,36,79,37,42,29,6,23,-1,-1,0,66%,65%,67%,131,129,133,29%,33%,26%,7,3,4,8,4,4
174,https://vlr.gg/player/23042/tripciew,2024-07-27 06:00:00,0.56,1.02,0.79,162,132,195,66,26,40,86,47,39,24,9,15,-10,-6,-4,61%,53%,68%,111,92,129,29%,27%,31%,8,2,6,18,8,10
175,https://vlr.gg/player/44149/pr0digy,2024-07-27 06:00:00,0.63,0.87,0.76,182,183,175,68,33,35,93,51,42,35,23,12,-4,-1,-3,63%,64%,63%,114,115,112,27%,30%,25%,15,9,6,19,10,9
176,https://vlr.gg/player/14213/ting2k5,2024-07-27 06:00:00,1.19,1.35,1.27,248,241,258,104,52,52,69,37,32,13,7,6,+5,+5,0,75%,75%,75%,167,163,171,31%,31%,30%,19,11,8,14,6,8
177,https://vlr.gg/player/8036/k1llers,2024-07-27 06:00:00,1.10,1.17,1.14,221,202,238,88,39,49,74,39,35,42,24,18,+2,-1,+3,82%,82%,82%,143,137,149,32%,27%,38%,10,5,5,8,6,2
178,https://vlr.gg/player/8240/alyal,2024-07-27 06:00:00,1.25,0.99,1.12,238,250,225,90,49,41,80,40,40,28,18,10,+6,+3,+3,72%,75%,69%,159,171,146,25%,29%,20%,17,7,10,11,4,7
179,https://vlr.gg/player/1429/d0rf,2024-07-27 06:00:00,1.02,0.92,0.97,183,206,169,77,44,33,78,44,34,25,14,11,+4,+2,+2,74%,77%,71%,131,142,120,33%,27%,40%,8,5,3,4,3,1
180,https://vlr.gg/player/14207/viness,2024-07-27 06:00:00,0.66,1.07,0.87,175,130,221,63,22,41,79,40,39,46,26,20,-5,-6,+1,75%,70%,80%,119,89,150,27%,27%,27%,8,2,6,13,8,5
181,https://vlr.gg/player/16018/babytz,2024-07-27 04:15:00,1.66,1.08,1.37,260,294,229,53,31,22,36,14,22,17,8,9,-4,-1,-3,64%,75%,54%,185,206,164,25%,29%,20%,7,3,4,11,4,7
182,https://vlr.gg/player/8175/ayumiii,2024-07-27 04:15:00,0.93,1.09,1.01,210,206,217,39,18,21,39,18,21,19,9,10,+2,-2,+4,73%,79%,68%,140,138,143,22%,21%,22%,10,5,5,8,7,1
183,https://vlr.gg/player/17503/delbisky,2024-07-27 04:15:00,1.09,0.85,0.97,206,213,192,38,20,18,40,18,22,20,11,9,+2,+1,+1,75%,79%,71%,122,141,103,28%,37%,16%,4,3,1,2,2,0
184,https://vlr.gg/player/16641/alluka,2024-07-27 04:15:00,1.12,0.77,0.94,164,204,129,34,21,13,39,18,21,23,12,11,+4,+4,0,71%,79%,64%,105,119,91,20%,24%,17%,5,4,1,1,0,1
185,https://vlr.gg/player/9175/kohaibi,2024-07-27 04:15:00,1.11,0.58,0.85,159,179,142,30,19,11,37,15,22,19,8,11,-2,0,-2,68%,71%,64%,106,116,97,21%,27%,15%,3,0,3,5,0,5
186,https://vlr.gg/player/16635/poly,2024-07-27 04:15:00,1.03,1.25,1.14,202,173,228,43,20,23,35,18,17,18,11,7,-3,-1,-2,75%,75%,75%,132,127,137,32%,35%,29%,1,0,1,4,1,3
187,https://vlr.gg/player/26069/piety,2024-07-27 04:15:00,1.38,0.66,1.02,179,237,127,33,23,10,34,13,21,20,8,12,+3,0,+3,80%,96%,64%,114,144,83,25%,26%,24%,3,0,3,0,0,0
188,https://vlr.gg/player/45029/grahams,2024-07-27 04:15:00,1.22,0.81,1.01,208,237,174,38,23,15,38,16,22,9,7,2,-2,-1,-1,66%,75%,57%,145,170,120,29%,30%,27%,9,6,3,11,7,4
189,https://vlr.gg/player/25388/kon,2024-07-27 04:15:00,0.95,0.95,0.95,207,174,236,37,17,20,40,18,22,14,7,7,+3,+1,+2,66%,71%,61%,139,124,154,34%,44%,26%,8,4,4,5,3,2
190,https://vlr.gg/player/18062/capricious,2024-07-27 04:15:00,1.11,0.50,0.81,204,221,184,40,25,15,47,20,27,9,4,5,-3,+1,-4,66%,79%,54%,130,167,93,40%,49%,31%,6,4,2,9,3,6
191,https://vlr.gg/player/19150/niffy,2024-07-27 04:10:00,1.90,2.03,1.97,387,348,424,62,26,36,31,12,19,8,4,4,0,-2,+2,80%,75%,83%,244,233,254,28%,31%,26%,6,2,4,6,4,2
192,https://vlr.gg/player/6733/xze,2024-07-27 04:10:00,1.36,0.34,0.80,149,241,77,25,19,6,36,14,22,9,3,6,+2,+5,-3,61%,75%,50%,94,142,54,40%,59%,20%,5,5,0,3,0,3
193,https://vlr.gg/player/2390/pinocchios,2024-07-27 04:10:00,0.57,0.95,0.78,178,133,217,24,7,17,39,17,22,24,13,11,-2,-1,-1,70%,75%,67%,126,106,142,23%,18%,26%,1,0,1,3,1,2
194,https://vlr.gg/player/23918/reality,2024-07-27 04:10:00,0.53,0.45,0.49,112,116,107,15,7,8,38,16,22,12,6,6,-1,-1,0,59%,75%,46%,79,78,80,16%,13%,19%,4,2,2,5,3,2
195,https://vlr.gg/player/1910/acetics,2024-07-27 04:10:00,0.31,0.47,0.40,114,108,121,16,7,9,39,18,21,6,1,5,-7,-3,-4,50%,45%,54%,79,76,81,23%,29%,19%,2,0,2,9,3,6
196,https://vlr.gg/player/23930/potter,2024-07-27 04:10:00,1.60,1.67,1.63,378,372,385,61,34,27,31,17,14,5,1,4,+9,+6,+3,77%,75%,80%,243,250,235,36%,41%,30%,13,9,4,4,3,1
197,https://vlr.gg/player/2366/alert,2024-07-27 04:10:00,1.38,0.92,1.17,221,272,167,35,23,12,26,14,12,11,8,3,+1,0,+1,80%,83%,75%,138,167,102,31%,25%,41%,8,5,3,7,5,2
198,https://vlr.gg/player/2368/b3ta,2024-07-27 04:10:00,0.90,1.36,1.11,205,165,251,34,15,19,27,14,13,18,8,10,-2,-1,-1,77%,83%,70%,132,120,146,32%,32%,32%,1,0,1,3,1,2
199,https://vlr.gg/player/12289/siraww,2024-07-27 04:10:00,0.93,0.71,0.83,158,165,143,27,16,11,27,14,13,12,9,3,0,0,0,70%,83%,55%,108,119,94,33%,25%,50%,3,0,3,3,0,3
200,https://vlr.gg/player/10791/bnwgiggs,2024-07-27 04:10:00,1.01,0.58,0.81,165,216,109,26,18,8,31,17,14,20,12,8,0,+1,-1,80%,88%,70%,115,145,80,19%,16%,24%,1,1,0,1,0,1
201,https://vlr.gg/player/4122/persia,2024-07-27 04:00:00,1.48,1.09,1.28,212,234,190,78,43,35,62,27,35,46,22,24,+3,+2,+1,74%,78%,71%,145,169,123,34%,32%,35%,6,2,4,3,0,3
202,https://vlr.gg/player/31829/ivy,2024-07-27 04:00:00,0.98,1.27,1.13,214,178,256,74,30,44,67,31,36,33,16,17,+4,+2,+2,76%,73%,79%,135,113,156,30%,38%,25%,10,4,6,6,2,4
203,https://vlr.gg/player/33576/margaret,2024-07-27 04:00:00,0.96,0.99,0.97,171,168,172,64,32,32,65,31,34,26,9,17,+1,0,+1,73%,73%,73%,119,119,120,31%,37%,27%,12,8,4,11,8,3
204,https://vlr.gg/player/31827/dambi,2024-07-27 04:00:00,0.88,0.86,0.87,201,220,184,71,37,34,79,40,39,21,11,10,-4,+2,-6,70%,69%,71%,130,136,124,23%,23%,24%,16,11,5,20,9,11
205,https://vlr.gg/player/31828/francis,2024-07-27 04:00:00,0.80,0.86,0.83,170,156,182,61,28,33,77,36,41,39,21,18,-3,+1,-4,71%,73%,69%,110,95,124,31%,28%,33%,7,3,4,10,2,8
206,https://vlr.gg/player/42772/xross,2024-07-27 04:00:00,1.15,1.29,1.22,229,210,242,84,42,42,58,29,29,23,12,11,0,0,0,79%,81%,78%,147,135,160,23%,25%,22%,5,2,3,5,2,3
207,https://vlr.gg/player/25048/sid,2024-07-27 04:00:00,0.99,0.94,0.96,202,220,189,71,39,32,75,40,35,22,13,9,-1,0,-1,70%,71%,69%,135,151,118,29%,33%,26%,13,8,5,14,8,6
208,https://vlr.gg/player/28401/pkm,2024-07-27 04:00:00,0.84,1.02,0.93,203,194,204,71,37,34,74,38,36,21,11,10,-3,0,-3,62%,60%,65%,129,123,134,32%,34%,31%,13,8,5,16,8,8
209,https://vlr.gg/player/24979/cloy,2024-07-27 04:00:00,0.80,1.04,0.91,180,159,212,61,27,34,73,38,35,42,24,18,+2,+1,+1,67%,63%,71%,117,104,131,28%,25%,30%,12,4,8,10,3,7
210,https://vlr.gg/player/25081/yoman,2024-07-27 04:00:00,1.14,0.62,0.88,170,207,132,59,40,19,68,33,35,24,13,11,+1,+5,-4,69%,75%,63%,115,140,88,17%,17%,16%,7,7,0,6,2,4
211,https://vlr.gg/player/9279/kylee,2024-07-27 03:00:00,0.86,1.33,1.08,229,174,291,47,19,28,48,24,24,11,5,6,+1,-1,+2,61%,56%,66%,152,117,192,54%,51%,55%,8,4,4,7,5,2
212,https://vlr.gg/player/23717/nythan,2024-07-27 03:00:00,0.87,0.85,0.86,196,218,172,42,23,19,53,28,25,13,12,1,-1,-1,0,69%,72%,66%,130,139,120,31%,25%,40%,3,1,2,4,2,2
213,https://vlr.gg/player/34100/scar,2024-07-27 03:00:00,1.26,0.33,0.82,154,206,98,36,27,9,45,19,26,19,12,7,-7,-3,-4,62%,72%,52%,100,126,71,42%,49%,30%,2,1,1,9,4,5
214,https://vlr.gg/player/37057/woody,2024-07-27 03:00:00,0.83,0.58,0.71,141,157,125,27,17,10,50,25,25,26,13,13,-2,-2,0,69%,78%,59%,102,108,96,25%,31%,18%,0,0,0,2,2,0
215,https://vlr.gg/player/34096/faustao,2024-07-27 03:00:00,0.48,0.88,0.67,173,133,219,36,16,20,53,28,25,9,3,6,-4,-3,-1,56%,56%,55%,114,82,150,19%,19%,19%,11,5,6,15,8,7
216,https://vlr.gg/player/2348/famouz,2024-07-27 03:00:00,1.02,1.70,1.38,269,222,316,57,22,35,37,19,18,15,9,6,+6,-2,+8,77%,69%,84%,186,158,210,14%,13%,14%,14,5,9,8,7,1
217,https://vlr.gg/player/10739/shiro,2024-07-27 03:00:00,1.44,1.17,1.30,248,269,230,53,27,26,37,17,20,36,20,16,+6,+4,+2,85%,86%,84%,163,180,147,28%,28%,29%,9,5,4,3,1,2
218,https://vlr.gg/player/2380/zesbeew,2024-07-27 03:00:00,1.37,1.03,1.20,206,255,164,49,29,20,37,20,17,27,17,10,-1,+1,-2,87%,90%,84%,126,145,109,14%,21%,9%,3,2,1,4,1,3
219,https://vlr.gg/player/7043/ncslasher,2024-07-27 03:00:00,1.25,0.96,1.10,227,219,233,50,22,28,42,16,26,24,15,9,+4,+1,+3,82%,86%,78%,142,141,143,18%,19%,16%,8,3,5,4,2,2
220,https://vlr.gg/player/4874/berserx,2024-07-27 03:00:00,1.23,0.80,1.01,171,204,140,40,25,15,36,15,21,18,4,14,-2,-1,-1,79%,83%,75%,118,132,104,20%,22%,19%,3,1,2,5,2,3
221,https://vlr.gg/player/3401/ptc,2024-07-27 02:00:00,1.03,0.81,0.95,204,202,200,26,18,8,28,17,11,14,8,6,+1,+2,-1,65%,71%,54%,127,126,129,26%,38%,11%,3,2,1,2,0,2
222,https://vlr.gg/player/27254/leviathan,2024-07-27 02:00:00,1.04,0.63,0.88,171,176,182,23,15,8,29,16,13,13,11,2,-2,-3,+1,59%,67%,46%,110,105,118,28%,24%,37%,2,0,2,4,3,1
223,https://vlr.gg/player/3342/sushiboys,2024-07-27 02:00:00,0.82,0.91,0.85,176,155,214,20,10,10,30,18,12,17,15,2,+2,0,+2,73%,67%,85%,122,106,150,23%,21%,28%,4,2,2,2,2,0
224,https://vlr.gg/player/6723/foxz,2024-07-27 02:00:00,1.00,0.52,0.83,167,172,137,23,17,6,29,17,12,7,5,2,+1,+1,0,65%,71%,54%,101,114,76,43%,44%,38%,3,2,1,2,1,1
225,https://vlr.gg/player/4377/johnolsen,2024-07-27 02:00:00,0.98,0.48,0.79,205,259,114,23,18,5,34,22,12,10,9,1,-1,0,-1,70%,71%,69%,150,192,73,26%,28%,18%,7,6,1,8,6,2
226,https://vlr.gg/player/27244/seph1roth,2024-07-27 02:00:00,1.29,1.39,1.35,254,201,273,34,10,24,19,5,14,8,3,5,-1,-2,+1,81%,85%,79%,165,138,179,43%,24%,61%,4,1,3,5,3,2
227,https://vlr.gg/player/24679/cgrs,2024-07-27 02:00:00,1.67,1.15,1.33,225,251,212,32,14,18,21,6,15,10,3,7,+1,0,+1,78%,85%,75%,159,175,150,29%,24%,31%,2,0,2,1,0,1
228,https://vlr.gg/player/13784/killua,2024-07-27 02:00:00,1.87,0.87,1.22,274,430,198,39,21,18,27,9,18,6,2,4,-1,+3,-4,73%,85%,67%,188,259,149,31%,29%,33%,6,5,1,7,2,5
229,https://vlr.gg/player/12098/kadoom,2024-07-27 02:00:00,0.41,1.37,1.03,216,149,254,26,6,20,26,12,14,9,6,3,-1,-2,+1,78%,77%,79%,145,116,161,27%,22%,30%,3,0,3,4,2,2
230,https://vlr.gg/player/14674/kntz,2024-07-27 02:00:00,1.40,0.60,0.88,135,160,120,19,9,10,22,5,17,14,7,7,+1,0,+1,81%,92%,75%,87,89,86,19%,27%,15%,3,0,3,2,0,2
231,https://vlr.gg/player/26069/piety,2024-07-27 01:50:00,1.29,1.56,1.46,267,260,261,38,13,25,19,9,10,6,1,5,+4,+1,+3,82%,64%,92%,180,199,170,31%,31%,30%,4,1,3,0,0,0
232,https://vlr.gg/player/45029/grahams,2024-07-27 01:50:00,1.04,1.50,1.33,273,216,299,36,11,25,24,10,14,21,5,16,+2,0,+2,87%,79%,92%,175,138,196,31%,36%,28%,7,3,4,5,3,2
233,https://vlr.gg/player/16635/poly,2024-07-27 01:50:00,0.99,1.38,1.23,210,175,216,27,8,19,22,9,13,29,8,21,+1,+1,0,76%,57%,88%,135,108,151,18%,27%,15%,1,1,0,0,0,0
234,https://vlr.gg/player/25388/kon,2024-07-27 01:50:00,0.85,1.42,1.21,250,160,267,28,7,21,22,9,13,21,7,14,+3,-1,+4,84%,71%,92%,150,106,176,19%,41%,14%,6,1,5,3,2,1
235,https://vlr.gg/player/18062/capricious,2024-07-27 01:50:00,1.00,1.09,1.06,206,244,189,29,12,17,23,10,13,4,1,3,+4,+1,+3,76%,71%,79%,129,160,111,43%,46%,39%,8,2,6,4,1,3
236,https://vlr.gg/player/25406/shina,2024-07-27 01:50:00,0.86,1.51,1.10,199,188,273,27,14,13,28,19,9,7,4,3,0,0,0,61%,58%,64%,150,129,186,29%,29%,28%,5,2,3,5,2,3
237,https://vlr.gg/player/17506/69shinobu,2024-07-27 01:50:00,0.67,1.20,0.86,165,149,178,20,12,8,33,25,8,23,12,11,-1,-1,0,74%,71%,79%,104,92,125,18%,22%,14%,1,0,1,2,1,1
238,https://vlr.gg/player/8129/chloettw,2024-07-27 01:50:00,0.89,0.67,0.81,197,220,156,23,16,7,32,21,11,13,11,2,-2,-1,-1,58%,58%,57%,131,143,111,19%,22%,14%,2,2,0,4,3,1
239,https://vlr.gg/player/16015/ivory,2024-07-27 01:50:00,0.52,0.84,0.64,150,141,207,19,10,9,34,22,12,8,6,2,-6,-6,0,58%,54%,64%,110,98,131,22%,17%,32%,3,1,2,9,7,2
240,https://vlr.gg/player/16622/tweeya,2024-07-27 01:50:00,0.57,0.75,0.62,137,137,187,21,11,10,33,22,11,6,5,1,-5,-4,-1,63%,63%,64%,103,93,118,19%,27%,10%,1,1,0,6,5,1
241,https://vlr.gg/player/10769/nobita,2024-07-27 01:00:00,0.92,1.16,1.05,214,189,239,65,28,37,62,29,33,17,8,9,-1,-2,+1,69%,75%,64%,143,122,162,26%,22%,30%,5,0,5,6,2,4
242,https://vlr.gg/player/40726/gwangboong,2024-07-27 01:00:00,0.97,1.09,1.03,227,228,229,67,32,35,65,33,32,15,6,9,+5,+3,+2,74%,73%,75%,145,147,143,28%,33%,25%,19,11,8,14,8,6
243,https://vlr.gg/player/4052/jinboong,2024-07-27 01:00:00,1.12,0.85,0.98,212,242,187,63,36,27,64,29,35,17,6,11,-4,-2,-2,62%,65%,59%,135,147,123,26%,27%,25%,7,2,5,11,4,7
244,https://vlr.gg/player/37664/gatorada,2024-07-27 01:00:00,0.65,1.10,0.89,177,141,212,49,17,32,61,29,32,35,17,18,-2,-3,+1,75%,73%,77%,118,96,139,24%,25%,23%,4,2,2,6,5,1
245,https://vlr.gg/player/10628/misaya,2024-07-27 01:00:00,0.84,0.80,0.82,162,161,164,44,20,24,62,28,34,38,20,18,+2,0,+2,70%,73%,68%,109,104,114,19%,17%,20%,7,3,4,5,3,2
246,https://vlr.gg/player/25221/xdll,2024-07-27 01:00:00,1.31,1.14,1.23,254,263,239,74,42,32,58,31,27,20,8,12,+3,0,+3,74%,75%,73%,172,183,160,25%,29%,21%,9,4,5,6,4,2
247,https://vlr.gg/player/2615/clz,2024-07-27 01:00:00,1.30,1.11,1.21,230,261,197,71,44,27,52,30,22,19,8,11,-1,+2,-3,77%,75%,80%,164,194,131,31%,35%,27%,6,5,1,7,3,4
248,https://vlr.gg/player/12990/syouta,2024-07-27 01:00:00,0.77,1.14,0.95,191,172,218,58,27,31,60,31,29,17,9,8,0,-3,+3,68%,68%,68%,125,116,136,32%,33%,32%,10,3,7,10,6,4
249,https://vlr.gg/player/6673/gon,2024-07-27 01:00:00,0.81,1.10,0.94,190,162,217,59,26,33,58,31,27,19,10,9,-5,-4,-1,74%,75%,73%,121,109,134,38%,38%,38%,6,1,5,11,5,6
250,https://vlr.gg/player/1395/tennn,2024-07-27 01:00:00,0.79,0.85,0.82,167,168,165,52,27,25,60,32,28,9,4,5,+3,+1,+2,67%,70%,63%,112,109,115,35%,32%,39%,11,7,4,8,6,2
251,https://vlr.gg/player/16621/alexy,2024-07-27 00:00:00,1.79,1.70,1.75,300,303,297,44,25,19,17,10,7,7,2,5,-2,-3,+1,83%,79%,88%,189,208,168,32%,32%,31%,2,1,1,4,4,0
252,https://vlr.gg/player/18091/shirazi,2024-07-27 00:00:00,1.07,1.81,1.41,239,164,328,33,12,21,17,10,7,11,7,4,+2,0,+2,91%,89%,94%,161,115,214,22%,23%,22%,3,1,2,1,1,0
253,https://vlr.gg/player/8176/enerii,2024-07-27 00:00:00,1.50,1.22,1.37,286,326,242,34,22,12,23,13,10,10,5,5,+5,+1,+4,80%,84%,75%,190,208,169,26%,31%,18%,10,4,6,5,3,2
254,https://vlr.gg/player/18093/kamiyu,2024-07-27 00:00:00,1.29,1.12,1.22,249,280,220,30,17,13,24,13,11,19,15,4,-2,-1,-1,83%,89%,75%,162,171,150,29%,29%,30%,1,0,1,3,1,2
255,https://vlr.gg/player/8492/tara,2024-07-27 00:00:00,0.97,0.65,0.82,149,175,106,16,11,5,20,11,9,11,6,5,0,0,0,74%,74%,75%,95,115,71,18%,28%,10%,3,2,1,3,2,1
256,https://vlr.gg/player/16641/alluka,2024-07-27 00:00:00,0.99,0.66,0.81,187,201,180,23,10,13,33,14,19,11,6,5,0,0,0,69%,81%,58%,124,138,112,31%,31%,31%,1,1,0,1,1,0
257,https://vlr.gg/player/8175/ayumiii,2024-07-27 00:00:00,0.88,0.72,0.80,196,216,185,22,10,12,30,14,16,7,4,3,0,0,0,57%,56%,58%,130,140,122,16%,13%,20%,8,4,4,8,4,4
258,https://vlr.gg/player/16018/babytz,2024-07-27 00:00:00,0.64,0.88,0.77,168,159,185,23,10,13,30,14,16,3,1,2,-2,-2,0,54%,63%,47%,122,101,140,24%,39%,18%,1,0,1,3,2,1
259,https://vlr.gg/player/9175/kohaibi,2024-07-27 00:00:00,0.40,0.70,0.57,179,137,205,18,7,11,33,15,18,6,1,5,+2,0,+2,69%,75%,63%,120,88,147,22%,35%,17%,3,0,3,1,0,1
260,https://vlr.gg/player/17503/delbisky,2024-07-27 00:00:00,0.52,0.53,0.53,134,119,154,15,7,8,31,13,18,11,3,8,-3,-4,+1,60%,56%,63%,97,85,106,28%,33%,25%,3,0,3,6,4,2
261,https://vlr.gg/player/21659/sato,2024-07-26 19:00:00,1.47,1.31,1.40,312,318,317,47,29,18,33,17,16,4,3,1,+1,-1,+2,66%,63%,71%,198,195,202,38%,37%,40%,9,5,4,8,6,2
262,https://vlr.gg/player/28716/lukxo,2024-07-26 19:00:00,1.48,0.80,1.20,257,289,219,36,24,12,33,16,17,19,11,8,-5,-2,-3,76%,79%,71%,175,187,157,30%,25%,40%,0,0,0,5,2,3
263,https://vlr.gg/player/1994/evilkyk,2024-07-26 19:00:00,1.01,0.52,0.81,149,144,145,18,11,7,32,15,17,13,9,4,0,0,0,63%,67%,59%,100,103,96,28%,28%,29%,1,0,1,1,0,1
264,https://vlr.gg/player/1688/rood,2024-07-26 19:00:00,0.77,0.42,0.62,131,154,94,17,12,5,31,16,15,15,8,7,-6,-2,-4,59%,67%,47%,92,107,70,19%,17%,22%,1,1,0,7,3,4
265,https://vlr.gg/player/6238/urango,2024-07-26 19:00:00,0.50,0.12,0.34,113,149,56,14,12,2,37,21,16,8,5,3,-7,-5,-2,61%,71%,47%,77,97,49,28%,35%,16%,1,1,0,8,6,2
266,https://vlr.gg/player/42867/ghoul33,2024-07-26 19:00:00,1.64,1.29,1.43,323,372,275,47,24,23,30,12,18,8,1,7,+9,+6,+3,88%,88%,88%,204,233,183,47%,55%,42%,12,7,5,3,1,2
267,https://vlr.gg/player/5722/prince,2024-07-26 19:00:00,1.52,1.20,1.33,227,223,220,34,15,19,21,6,15,21,8,13,+3,+1,+2,83%,94%,75%,155,164,149,46%,53%,41%,3,1,2,0,0,0
268,https://vlr.gg/player/2486/pollo,2024-07-26 19:00:00,1.25,0.99,1.10,192,182,209,29,13,16,25,7,18,11,2,9,-1,-1,0,71%,94%,54%,145,133,153,30%,54%,21%,2,0,2,3,1,2
269,https://vlr.gg/player/1578/shion,2024-07-26 19:00:00,1.34,0.72,0.98,187,237,159,25,14,11,27,8,19,20,4,16,+4,+2,+2,78%,82%,75%,118,134,108,26%,26%,26%,5,2,3,1,0,1
270,https://vlr.gg/player/21251/blowz,2024-07-26 19:00:00,1.11,0.88,0.97,213,233,194,31,15,16,29,11,18,8,4,4,+2,-1,+3,61%,65%,58%,139,155,128,29%,33%,25%,7,2,5,5,3,2
271,https://vlr.gg/player/8422/spaz,2024-07-26 19:00:00,1.05,1.20,1.14,202,159,227,28,10,18,27,10,17,16,3,13,+2,+1,+1,70%,56%,79%,125,97,144,17%,11%,21%,3,1,2,1,0,1
272,https://vlr.gg/player/29688/mikee,2024-07-26 19:00:00,0.61,1.14,0.92,201,145,243,28,8,20,31,14,17,5,2,3,+5,-1,+6,68%,56%,75%,121,96,139,27%,22%,29%,8,1,7,3,2,1
273,https://vlr.gg/player/3874/teague,2024-07-26 19:00:00,0.69,0.92,0.82,176,147,208,23,6,17,31,13,18,18,7,11,+1,+1,0,70%,75%,67%,124,111,132,25%,17%,32%,5,2,3,4,1,3
274,https://vlr.gg/player/8373/okeanos,2024-07-26 19:00:00,0.77,0.49,0.60,177,254,136,26,14,12,36,15,21,8,2,6,-6,-3,-3,65%,69%,63%,108,138,88,23%,26%,19%,1,1,0,7,4,3
275,https://vlr.gg/player/4385/monsi,2024-07-26 19:00:00,0.66,0.34,0.47,116,143,100,16,9,7,34,13,21,12,5,7,-4,-4,0,58%,69%,50%,75,90,65,27%,44%,18%,2,0,2,6,4,2
276,https://vlr.gg/player/64/gmd,2024-07-26 19:00:00,1.79,1.30,1.59,282,286,252,38,25,13,22,11,11,18,10,8,+2,0,+2,83%,75%,94%,176,175,178,29%,32%,26%,4,1,3,2,1,1
277,https://vlr.gg/player/8376/seven,2024-07-26 19:00:00,1.38,1.33,1.36,239,249,221,34,22,12,22,13,9,15,8,7,-1,0,-1,78%,75%,81%,155,161,147,19%,28%,11%,4,3,1,5,3,2
278,https://vlr.gg/player/740/aproto,2024-07-26 19:00:00,1.44,1.16,1.33,220,240,196,36,22,14,23,14,9,11,7,4,0,0,0,80%,88%,69%,145,152,135,41%,42%,38%,1,1,0,1,1,0
279,https://vlr.gg/player/3702/sym,2024-07-26 19:00:00,0.85,1.48,1.10,235,199,290,34,17,17,27,18,9,7,4,3,+4,-1,+5,73%,71%,75%,148,130,174,23%,20%,27%,10,4,6,6,5,1
280,https://vlr.gg/player/849/poised,2024-07-26 19:00:00,0.44,1.03,0.68,133,101,178,17,8,9,27,18,9,22,7,15,-3,-3,0,78%,67%,94%,91,70,123,31%,19%,45%,2,1,1,5,4,1
281,https://vlr.gg/player/9354/cebando,2024-07-26 19:00:00,1.85,0.93,1.46,277,374,153,41,32,9,25,14,11,16,7,9,+7,+7,0,80%,87%,71%,171,224,100,39%,41%,31%,8,7,1,1,0,1
282,https://vlr.gg/player/41135/dantedeu5,2024-07-26 19:00:00,1.43,1.31,1.38,306,301,277,41,24,17,26,14,12,12,7,5,+3,0,+3,70%,78%,59%,183,197,164,30%,32%,27%,8,4,4,5,4,1
283,https://vlr.gg/player/2585/tinchoff,2024-07-26 19:00:00,1.45,0.85,1.19,178,201,146,26,18,8,19,9,10,11,8,3,-4,-2,-2,83%,91%,71%,114,129,92,40%,46%,33%,1,0,1,5,2,3
284,https://vlr.gg/player/3826/adverso,2024-07-26 19:00:00,1.14,1.11,1.12,184,156,209,25,13,12,22,10,12,24,16,8,+4,+2,+2,75%,78%,71%,118,103,138,34%,33%,34%,5,3,2,1,1,0
285,https://vlr.gg/player/13861/nicomachine,2024-07-26 19:00:00,1.00,1.20,1.08,165,158,199,24,13,11,25,13,12,23,12,11,-2,0,-2,85%,96%,71%,110,100,124,32%,23%,45%,2,1,1,4,1,3
286,https://vlr.gg/player/8056/mited,2024-07-26 19:00:00,1.40,0.71,1.00,173,227,144,26,15,11,26,8,18,10,5,5,+1,0,+1,63%,71%,57%,111,124,102,17%,14%,22%,3,1,2,2,1,1
287,https://vlr.gg/player/7616/feniz,2024-07-26 19:00:00,1.32,0.39,0.79,161,256,110,25,16,9,31,11,20,7,3,4,-2,+1,-3,70%,88%,57%,113,177,65,35%,46%,19%,2,1,1,4,0,4
288,https://vlr.gg/player/10557/darker,2024-07-26 19:00:00,0.76,0.76,0.76,181,186,184,24,11,13,33,13,20,11,3,8,+1,0,+1,68%,65%,70%,124,117,129,26%,31%,22%,4,2,2,3,2,1
289,https://vlr.gg/player/3983/virtyy,2024-07-26 19:00:00,0.54,0.78,0.68,178,133,211,23,7,16,35,13,22,10,5,5,-3,-1,-2,70%,71%,70%,113,93,128,20%,28%,16%,6,3,3,9,4,5
290,https://vlr.gg/player/17690/jow,2024-07-26 19:00:00,0.65,0.48,0.55,136,124,130,19,8,11,32,12,20,6,3,3,-5,-1,-4,50%,47%,52%,80,85,76,29%,40%,22%,1,1,0,6,2,4
291,https://vlr.gg/player/12872/david,2024-07-26 16:30:00,0.63,1.24,0.93,206,159,253,25,9,16,29,16,13,7,2,5,-1,-2,+1,67%,61%,72%,129,106,151,28%,28%,28%,4,1,3,5,3,2
292,https://vlr.gg/player/13860/rubkkoide,2024-07-26 16:30:00,0.93,0.76,0.84,176,221,131,21,12,9,30,17,13,10,8,2,-2,0,-2,53%,61%,44%,107,140,74,33%,40%,22%,3,1,2,5,1,4
293,https://vlr.gg/player/11046/deigara,2024-07-26 16:30:00,0.80,0.66,0.73,166,161,171,21,10,11,31,15,16,4,0,4,-1,-2,+1,56%,44%,67%,111,113,109,30%,26%,33%,2,0,2,3,2,1
294,https://vlr.gg/player/2403/mizu,2024-07-26 16:30:00,0.66,0.73,0.69,181,154,207,23,10,13,32,16,16,6,2,4,-6,-3,-3,64%,61%,67%,107,96,117,42%,39%,44%,0,0,0,6,3,3
295,https://vlr.gg/player/7652/tuli,2024-07-26 16:30:00,0.31,0.92,0.53,136,93,179,15,6,9,31,18,13,7,0,7,-8,-7,-1,56%,39%,72%,95,58,132,27%,24%,29%,0,0,0,8,7,1
296,https://vlr.gg/player/8892/snw,2024-07-26 16:30:00,1.11,1.62,1.37,290,250,330,37,16,21,24,13,11,8,4,4,+15,+5,+10,86%,78%,94%,191,158,224,31%,35%,25%,18,7,11,3,2,1
297,https://vlr.gg/player/2464/suther,2024-07-26 16:30:00,1.12,1.53,1.32,254,214,295,34,14,20,20,11,9,16,8,8,-1,-1,0,83%,78%,89%,155,128,183,32%,38%,28%,1,1,0,2,2,0
298,https://vlr.gg/player/2468/delz1k,2024-07-26 16:30:00,1.57,1.04,1.31,211,262,160,29,18,11,18,9,9,20,11,9,+3,+1,+2,78%,78%,78%,119,151,86,22%,24%,17%,3,1,2,0,0,0
299,https://vlr.gg/player/1294/nagz,2024-07-26 16:30:00,1.18,1.33,1.26,250,243,257,30,14,16,20,11,9,8,3,5,+1,0,+1,72%,72%,72%,151,153,149,36%,42%,32%,4,2,2,3,2,1
300,https://vlr.gg/player/783/murizzz,2024-07-26 16:30:00,0.71,1.27,0.99,179,139,219,23,9,14,23,14,9,11,4,7,0,-1,+1,81%,67%,94%,139,119,159,26%,33%,22%,1,0,1,1,1,0
301,https://vlr.gg/player/20240/xenom,2024-07-26 16:00:00,1.28,1.25,1.26,226,209,232,49,19,30,38,16,22,19,11,8,+1,+1,0,70%,70%,69%,151,139,160,34%,26%,40%,4,1,3,3,0,3
302,https://vlr.gg/player/6202/guuih,2024-07-26 16:00:00,1.16,1.01,1.07,181,170,183,44,17,27,39,15,24,12,5,7,0,0,0,70%,67%,72%,126,130,123,38%,34%,41%,6,2,4,6,2,4
303,https://vlr.gg/player/3424/siduzord,2024-07-26 16:00:00,1.00,1.05,1.03,197,168,215,44,17,27,42,16,26,17,8,9,+1,-4,+5,67%,59%,72%,121,103,134,25%,25%,25%,7,0,7,6,4,2
304,https://vlr.gg/player/13823/pxs,2024-07-26 16:00:00,1.07,0.98,1.02,224,272,200,49,26,23,47,21,26,23,7,16,-6,-4,-2,73%,67%,78%,149,166,136,23%,22%,25%,9,6,3,15,10,5
305,https://vlr.gg/player/23010/nicksz,2024-07-26 16:00:00,0.80,0.93,0.87,196,149,226,38,13,25,50,20,30,41,15,26,+1,+2,-1,73%,70%,75%,115,86,136,18%,9%,23%,4,2,2,3,0,3
306,https://vlr.gg/player/21661/spike,2024-07-26 16:00:00,1.55,1.08,1.35,291,354,237,66,44,22,49,29,20,18,13,5,+6,+1,+5,76%,78%,74%,194,220,159,20%,21%,18%,14,7,7,8,6,2
307,https://vlr.gg/player/662/pryze,2024-07-26 16:00:00,0.75,1.17,0.93,188,162,224,41,20,21,44,27,17,18,10,8,0,-1,+1,67%,69%,63%,118,105,135,17%,15%,18%,4,2,2,4,3,1
308,https://vlr.gg/player/11921/silentzz,2024-07-26 16:00:00,0.88,0.97,0.92,188,183,202,41,24,17,43,25,18,11,3,8,-1,-3,+2,71%,72%,70%,126,121,133,34%,34%,33%,7,3,4,8,6,2
309,https://vlr.gg/player/3169/zap,2024-07-26 16:00:00,0.92,0.87,0.90,158,146,167,33,18,15,40,22,18,19,13,6,0,+1,-1,71%,69%,74%,107,102,113,22%,22%,22%,4,2,2,4,1,3
310,https://vlr.gg/player/6195/lz,2024-07-26 16:00:00,0.80,0.77,0.79,168,178,151,35,22,13,48,29,19,32,13,19,-2,0,-2,73%,83%,59%,109,122,92,33%,33%,34%,4,3,1,6,3,3
311,https://vlr.gg/player/21668/verno,2024-07-26 16:00:00,1.29,1.33,1.31,234,231,247,47,25,22,33,17,16,21,11,10,0,+1,-1,80%,77%,83%,169,170,167,38%,36%,40%,4,2,2,4,1,3
312,https://vlr.gg/player/8419/reduxx,2024-07-26 16:00:00,0.82,1.57,1.15,264,226,297,49,23,26,42,26,16,12,7,5,+3,+2,+1,80%,71%,92%,165,143,193,27%,25%,29%,11,8,3,8,6,2
313,https://vlr.gg/player/11118/skuba,2024-07-26 16:00:00,1.18,1.00,1.10,225,232,154,40,26,14,35,20,15,21,8,13,-1,0,-1,76%,74%,79%,131,155,101,36%,39%,31%,5,2,3,6,2,4
314,https://vlr.gg/player/454/dapr,2024-07-26 16:00:00,1.13,1.04,1.09,201,212,200,39,24,15,33,16,17,19,7,12,+2,0,+2,89%,87%,92%,138,141,133,30%,24%,39%,4,1,3,2,1,1
315,https://vlr.gg/player/612/mitch,2024-07-26 16:00:00,0.95,1.02,0.98,190,186,205,37,23,14,37,20,17,26,9,17,-1,-2,+1,78%,74%,83%,131,114,152,27%,31%,23%,5,3,2,6,5,1
316,https://vlr.gg/player/4931/add3r,2024-07-26 16:00:00,1.02,1.05,1.04,225,171,246,39,15,24,42,18,24,11,6,5,0,-1,+1,69%,71%,68%,153,147,157,34%,39%,31%,5,2,3,5,3,2
317,https://vlr.gg/player/733/stellar,2024-07-26 16:00:00,1.05,0.98,1.01,190,192,188,38,17,21,40,16,24,17,9,8,+1,-1,+2,71%,79%,65%,114,115,113,28%,30%,26%,5,2,3,4,3,1
318,https://vlr.gg/player/844/bdog,2024-07-26 16:00:00,0.83,0.99,0.90,142,135,177,31,12,19,39,17,22,20,11,9,-4,-3,-1,67%,58%,74%,111,105,116,33%,23%,43%,3,0,3,7,3,4
319,https://vlr.gg/player/260/corey,2024-07-26 16:00:00,0.84,0.90,0.87,195,222,199,41,19,22,44,20,24,7,3,4,+1,+1,0,69%,71%,68%,137,143,133,25%,25%,25%,9,4,5,8,3,5
320,https://vlr.gg/player/1856/wedid,2024-07-26 16:00:00,0.79,0.54,0.65,171,217,141,31,18,13,47,20,27,23,7,16,-1,+2,-3,65%,71%,61%,116,133,104,24%,24%,24%,4,3,1,5,1,4
321,https://vlr.gg/player/7162/wackie,2024-07-26 12:00:00,1.19,1.63,1.42,255,205,303,61,25,36,41,18,23,35,9,26,+3,+2,+1,83%,77%,89%,163,126,195,31%,25%,35%,7,3,4,4,1,3
322,https://vlr.gg/player/8226/waddle,2024-07-26 12:00:00,1.59,1.13,1.35,225,253,207,54,28,26,35,15,20,21,14,7,-1,-2,+1,80%,81%,80%,156,176,137,32%,35%,29%,3,0,3,4,2,2
323,https://vlr.gg/player/12474/tag,2024-07-26 12:00:00,1.27,1.02,1.13,185,216,152,43,26,17,40,19,21,28,11,17,-3,0,-3,74%,77%,71%,122,146,99,32%,33%,31%,3,2,1,6,2,4
324,https://vlr.gg/player/4544/filu,2024-07-26 12:00:00,0.92,1.31,1.13,246,211,276,61,23,38,47,23,24,7,3,4,+1,+2,-1,70%,65%,74%,158,128,184,25%,25%,25%,14,10,4,13,8,5
325,https://vlr.gg/player/1944/cayden,2024-07-26 12:00:00,0.88,0.80,0.84,155,157,147,33,16,17,44,21,23,29,17,12,-6,-1,-5,68%,81%,57%,105,110,99,21%,22%,21%,3,1,2,9,2,7
326,https://vlr.gg/player/18400/bipo,2024-07-26 12:00:00,0.87,1.07,0.96,227,228,233,53,28,25,52,28,24,9,6,3,+9,+6,+3,61%,66%,55%,142,143,142,26%,25%,26%,21,11,10,12,5,7
327,https://vlr.gg/player/1524/h1ber,2024-07-26 12:00:00,0.94,0.88,0.91,170,174,171,40,22,18,46,25,21,24,12,12,-2,0,-2,70%,66%,74%,114,117,111,19%,20%,18%,3,2,1,5,2,3
328,https://vlr.gg/player/1493/starkk,2024-07-26 12:00:00,0.99,0.68,0.84,161,168,153,38,22,16,50,24,26,19,11,8,+2,+2,0,70%,71%,68%,107,110,104,29%,29%,28%,4,3,1,2,1,1
329,https://vlr.gg/player/23347/alannn,2024-07-26 12:00:00,0.96,0.71,0.84,170,199,139,41,25,16,48,27,21,15,9,6,-2,-1,-1,61%,63%,58%,114,137,87,34%,44%,22%,3,1,2,5,2,3
330,https://vlr.gg/player/4277/n-a-i-s,2024-07-26 12:00:00,0.49,0.81,0.64,151,120,190,35,14,21,56,30,26,18,10,8,-1,0,-1,61%,57%,65%,101,80,125,24%,22%,26%,5,4,1,6,4,2
331,https://vlr.gg/player/6503/sand,2024-07-26 12:00:00,1.06,1.20,1.14,211,194,228,84,34,50,68,32,36,22,8,14,+1,-1,+2,67%,60%,72%,146,132,157,36%,41%,33%,9,2,7,8,3,5
332,https://vlr.gg/player/5600/moh,2024-07-26 12:00:00,1.07,0.97,1.01,197,229,176,80,40,40,75,38,37,24,14,10,+3,+1,+2,69%,71%,68%,133,151,120,33%,34%,32%,11,5,6,8,4,4
333,https://vlr.gg/player/20292/akai,2024-07-26 12:00:00,0.84,0.97,0.91,218,203,236,82,33,49,87,38,49,14,7,7,-6,-9,+3,62%,67%,58%,148,135,158,26%,28%,23%,22,6,16,28,15,13
334,https://vlr.gg/player/1618/spyzera,2024-07-26 12:00:00,0.68,1.09,0.91,163,129,187,59,20,39,71,35,36,29,13,16,-2,-4,+2,67%,65%,68%,107,89,122,26%,20%,30%,5,2,3,7,6,1
335,https://vlr.gg/player/5599/khaalid,2024-07-26 12:00:00,0.94,0.76,0.84,166,175,149,61,31,30,76,38,38,30,17,13,-2,-1,-1,69%,67%,72%,110,122,100,30%,35%,26%,4,2,2,6,3,3
336,https://vlr.gg/player/5795/sickrey,2024-07-26 12:00:00,1.06,1.35,1.19,219,199,244,86,44,42,65,38,27,33,12,21,+3,0,+3,75%,72%,79%,141,128,157,35%,43%,28%,8,4,4,5,4,1
337,https://vlr.gg/player/1470/simond4rk,2024-07-26 12:00:00,0.90,1.24,1.05,225,199,258,83,42,41,78,44,34,28,8,20,-13,-13,0,69%,58%,81%,158,142,178,17%,17%,17%,9,4,5,22,17,5
338,https://vlr.gg/player/1897/bgg,2024-07-26 12:00:00,0.97,1.08,1.02,191,170,222,75,35,40,71,38,33,28,12,16,+6,+1,+5,70%,65%,77%,124,107,147,23%,27%,21%,14,6,8,8,5,3
339,https://vlr.gg/player/2432/moner,2024-07-26 12:00:00,0.93,1.11,1.00,194,167,232,71,32,39,73,40,33,25,13,12,+9,+2,+7,74%,72%,77%,131,116,151,25%,27%,24%,16,5,11,7,3,4
340,https://vlr.gg/player/3807/winteryrook,2024-07-26 12:00:00,0.94,0.65,0.81,171,206,122,62,43,19,79,48,31,32,16,16,+1,+2,-1,71%,70%,73%,104,123,81,32%,37%,24%,10,7,3,9,5,4
341,https://vlr.gg/player/321/chiwa,2024-07-26 11:00:00,1.22,1.30,1.25,229,230,239,94,54,40,67,42,25,14,8,6,-2,0,-2,71%,69%,74%,155,150,163,34%,39%,28%,7,6,1,9,6,3
342,https://vlr.gg/player/8808/pyrolll,2024-07-26 11:00:00,1.31,1.14,1.24,230,227,226,87,53,34,65,36,29,27,11,16,+2,+1,+1,75%,77%,72%,141,145,136,35%,35%,34%,12,7,5,10,6,4
343,https://vlr.gg/player/1374/alive,2024-07-26 11:00:00,0.88,1.34,1.06,217,184,274,79,40,39,74,45,29,19,10,9,+1,-2,+3,69%,68%,72%,150,132,178,25%,25%,26%,15,9,6,14,11,3
344,https://vlr.gg/player/32351/cullumx,2024-07-26 11:00:00,0.83,0.83,0.83,173,171,202,69,44,25,82,51,31,26,13,13,+2,-3,+5,65%,62%,70%,116,119,112,38%,41%,34%,14,5,9,12,8,4
345,https://vlr.gg/player/4325/musashi,2024-07-26 11:00:00,0.53,0.81,0.64,123,106,143,42,21,21,74,49,25,30,20,10,-7,-5,-2,62%,58%,67%,85,74,102,24%,17%,31%,4,1,3,11,6,5
346,https://vlr.gg/player/34684/westside,2024-07-26 11:00:00,1.03,1.19,1.13,211,187,215,80,31,49,70,32,38,19,7,12,+8,+1,+7,69%,65%,71%,138,132,142,36%,38%,35%,14,2,12,6,1,5
347,https://vlr.gg/player/24424/pa1ze,2024-07-26 11:00:00,1.08,1.06,1.06,244,247,245,96,37,59,79,32,47,15,6,9,+3,-1,+4,67%,58%,72%,160,158,161,28%,30%,27%,24,10,14,21,11,10
348,https://vlr.gg/player/5490/xitsha,2024-07-26 11:00:00,0.81,1.13,1.00,183,137,211,71,22,49,75,32,43,32,12,20,-5,-5,0,69%,58%,75%,127,99,145,36%,40%,34%,7,1,6,12,6,6
349,https://vlr.gg/player/3839/prti,2024-07-26 11:00:00,0.74,1.02,0.91,156,118,181,58,19,39,71,30,41,38,11,27,-6,-3,-3,67%,58%,72%,108,89,120,30%,40%,27%,3,1,2,9,4,5
350,https://vlr.gg/player/8593/grmekista,2024-07-26 11:00:00,0.94,0.77,0.84,142,207,118,57,30,27,76,33,43,36,12,24,+4,+3,+1,62%,56%,66%,107,145,82,20%,20%,19%,8,5,3,4,2,2
351,https://vlr.gg/player/9554/kaajak,2024-07-26 11:00:00,1.36,1.55,1.45,295,300,290,66,33,33,40,23,17,12,4,8,+14,+10,+4,84%,87%,81%,185,186,184,33%,37%,29%,19,12,7,5,2,3
352,https://vlr.gg/player/1507/avova,2024-07-26 11:00:00,1.32,1.19,1.26,199,220,176,47,26,21,34,19,15,26,10,16,+3,+2,+1,78%,77%,78%,131,140,121,34%,37%,32%,6,4,2,3,2,1
353,https://vlr.gg/player/1281/molsi,2024-07-26 11:00:00,1.14,1.33,1.24,232,211,253,52,23,29,38,20,18,22,11,11,+4,+1,+3,84%,84%,84%,152,144,159,27%,19%,39%,6,2,4,2,1,1
354,https://vlr.gg/player/129/hype,2024-07-26 11:00:00,0.85,1.27,1.07,192,140,249,42,15,27,37,18,19,18,8,10,-5,-3,-2,71%,68%,75%,137,103,169,29%,19%,35%,3,1,2,8,4,4
355,https://vlr.gg/player/101/soulcas,2024-07-26 11:00:00,1.11,0.74,0.92,187,231,139,44,28,16,40,21,19,16,7,9,-3,-3,0,75%,77%,72%,125,160,92,35%,37%,32%,4,0,4,7,3,4
356,https://vlr.gg/player/12519/ticey,2024-07-26 11:00:00,0.83,1.20,1.01,253,219,295,56,23,33,54,28,26,8,5,3,+1,0,+1,62%,56%,68%,161,141,182,20%,25%,16%,14,7,7,13,7,6
357,https://vlr.gg/player/33994/creamydreamy,2024-07-26 11:00:00,0.80,0.93,0.86,156,137,180,30,15,15,47,23,24,33,12,21,-2,-1,-1,65%,63%,68%,113,102,124,27%,27%,27%,0,0,0,2,1,1
358,https://vlr.gg/player/2182/hearthbeat,2024-07-26 11:00:00,0.80,0.92,0.86,157,135,183,35,15,20,45,22,23,16,8,8,-4,-2,-2,65%,59%,71%,109,82,137,34%,43%,29%,2,1,1,6,3,3
359,https://vlr.gg/player/16188/tempo,2024-07-26 11:00:00,0.80,0.79,0.80,200,195,204,41,20,21,54,27,27,7,5,2,-5,0,-5,63%,66%,61%,134,125,143,29%,25%,32%,6,4,2,11,4,7
360,https://vlr.gg/player/29628/famzzam,2024-07-26 11:00:00,0.70,0.54,0.62,136,144,124,27,15,12,51,26,25,24,9,15,-3,-3,0,60%,53%,68%,87,101,73,33%,33%,32%,3,1,2,6,4,2
361,https://vlr.gg/player/24344/loita,2024-07-26 10:30:00,1.13,1.79,1.41,293,252,336,88,44,44,56,37,19,31,15,16,+6,-2,+8,80%,79%,81%,173,149,205,47%,48%,47%,17,4,13,11,6,5
362,https://vlr.gg/player/40591/comeback,2024-07-26 10:30:00,1.19,1.07,1.14,244,268,210,71,45,26,62,39,23,18,7,11,+4,0,+4,74%,69%,81%,158,169,144,30%,41%,15%,14,9,5,10,9,1
363,https://vlr.gg/player/31305/lar0k,2024-07-26 10:30:00,1.05,1.25,1.14,193,184,199,57,30,27,49,30,19,30,20,10,+1,-1,+2,68%,67%,69%,124,116,135,32%,42%,24%,7,3,4,6,4,2
364,https://vlr.gg/player/31855/celasun,2024-07-26 10:30:00,0.92,1.06,0.98,206,187,223,58,30,28,57,35,22,17,13,4,+1,-3,+4,74%,71%,78%,140,136,145,24%,20%,29%,4,0,4,3,3,0
365,https://vlr.gg/player/5565/ros,2024-07-26 10:30:00,0.66,0.73,0.69,129,120,145,41,21,20,58,34,24,19,12,7,-6,-6,0,65%,65%,67%,86,84,89,29%,35%,24%,3,2,1,9,8,1
366,https://vlr.gg/player/12793/xeus,2024-07-26 10:30:00,1.22,1.50,1.38,278,262,299,85,35,50,61,28,33,20,5,15,+4,-6,+10,73%,61%,81%,193,172,208,30%,28%,32%,15,3,12,11,9,2
367,https://vlr.gg/player/12774/anima,2024-07-26 10:30:00,0.85,0.97,0.92,180,179,183,49,20,29,60,30,30,41,25,16,+2,0,+2,75%,72%,77%,124,116,130,25%,21%,29%,5,1,4,3,1,2
368,https://vlr.gg/player/16483/gloomy,2024-07-26 10:30:00,0.59,1.06,0.86,154,125,172,47,14,33,54,28,26,14,7,7,-8,-7,-1,70%,61%,77%,98,93,103,20%,21%,20%,3,0,3,11,7,4
369,https://vlr.gg/player/22676/ventt,2024-07-26 10:30:00,0.81,0.82,0.82,191,176,204,56,22,34,73,30,43,30,10,20,0,-5,+5,73%,72%,73%,113,97,125,28%,21%,35%,10,2,8,10,7,3
370,https://vlr.gg/player/12795/crewen,2024-07-26 10:30:00,0.70,0.76,0.73,160,150,172,45,16,29,67,29,38,21,8,13,-4,0,-4,68%,72%,65%,120,114,125,26%,23%,29%,6,3,3,10,3,7
371,https://vlr.gg/player/12098/kadoom,2024-07-26 08:00:00,1.04,1.65,1.31,280,255,312,43,20,23,31,20,11,4,3,1,+15,+7,+8,77%,75%,79%,173,159,191,32%,36%,28%,18,10,8,3,3,0
372,https://vlr.gg/player/27244/seph1roth,2024-07-26 08:00:00,1.07,1.50,1.26,229,230,228,38,20,18,25,19,6,8,4,4,+2,0,+2,77%,71%,84%,149,160,135,39%,40%,38%,3,1,2,1,1,0
373,https://vlr.gg/player/14674/kntz,2024-07-26 08:00:00,0.79,1.72,1.20,220,164,289,34,13,21,27,19,8,22,11,11,+1,-1,+2,77%,71%,84%,139,106,181,30%,19%,44%,3,1,2,2,2,0
374,https://vlr.gg/player/24679/cgrs,2024-07-26 08:00:00,1.13,1.18,1.15,196,190,205,30,16,14,24,16,8,21,13,8,+4,+3,+1,79%,71%,89%,130,123,139,27%,28%,26%,4,3,1,0,0,0
375,https://vlr.gg/player/13784/killua,2024-07-26 08:00:00,1.13,0.91,1.03,197,212,179,31,20,11,28,17,11,19,12,7,+3,+1,+2,86%,83%,89%,138,139,136,36%,34%,38%,6,2,4,3,1,2
376,https://vlr.gg/player/12289/siraww,2024-07-26 08:00:00,0.89,1.28,1.11,217,182,245,34,12,22,32,16,16,8,3,5,-4,-1,-3,58%,58%,58%,149,123,169,36%,32%,39%,0,0,0,4,1,3
377,https://vlr.gg/player/23930/potter,2024-07-26 08:00:00,0.26,1.40,0.89,192,109,257,28,6,22,35,19,16,5,1,4,-10,-9,-1,60%,47%,71%,126,72,168,26%,17%,31%,5,0,5,15,9,6
378,https://vlr.gg/player/2366/alert,2024-07-26 08:00:00,0.56,1.04,0.83,187,150,216,26,8,18,35,17,18,7,1,6,-3,-2,-1,63%,42%,79%,127,109,141,39%,44%,36%,1,0,1,4,2,2
379,https://vlr.gg/player/2368/b3ta,2024-07-26 08:00:00,0.64,0.58,0.61,161,158,165,24,11,13,37,18,19,12,7,5,-7,-3,-4,67%,63%,71%,105,106,104,29%,33%,26%,2,1,1,9,4,5
380,https://vlr.gg/player/10791/bnwgiggs,2024-07-26 08:00:00,0.42,0.71,0.58,157,111,194,22,7,15,37,17,20,11,2,9,-1,0,-1,65%,47%,79%,102,72,125,23%,17%,26%,1,1,0,2,1,1
381,https://vlr.gg/player/27012/felce,2024-07-26 07:00:00,0.92,1.41,1.17,257,222,284,45,18,27,40,24,16,20,6,14,+3,+3,0,75%,62%,88%,173,146,200,31%,28%,33%,5,3,2,2,0,2
382,https://vlr.gg/player/16634/kitkatwc,2024-07-26 07:00:00,1.02,1.17,1.09,239,212,265,44,20,24,37,20,17,26,6,20,-1,-3,+2,71%,58%,85%,148,137,159,23%,25%,21%,5,1,4,6,4,2
383,https://vlr.gg/player/16630/rosey,2024-07-26 07:00:00,0.83,1.22,1.03,181,182,186,34,16,18,34,21,13,23,11,12,+3,+2,+1,77%,65%,88%,114,105,123,26%,24%,28%,5,2,3,2,0,2
384,https://vlr.gg/player/16639/izze,2024-07-26 07:00:00,0.81,1.11,0.96,195,181,211,30,13,17,37,22,15,18,8,10,0,+1,-1,75%,62%,88%,139,122,157,21%,16%,24%,2,2,0,2,1,1
385,https://vlr.gg/player/26077/angela,2024-07-26 07:00:00,0.25,1.29,0.75,181,97,264,30,6,24,41,24,17,10,5,5,-7,-7,0,56%,42%,69%,122,74,170,17%,9%,22%,8,3,5,15,10,5
386,https://vlr.gg/player/17532/aisling,2024-07-26 07:00:00,1.09,1.58,1.33,229,203,253,46,19,27,29,19,10,18,8,10,-2,-3,+1,75%,69%,81%,148,127,168,23%,22%,24%,3,0,3,5,3,2
387,https://vlr.gg/player/25406/shina,2024-07-26 07:00:00,1.32,1.12,1.22,211,247,176,41,23,18,32,18,14,7,3,4,+5,+2,+3,67%,58%,77%,136,154,118,23%,33%,17%,7,3,4,2,1,1
388,https://vlr.gg/player/17506/69shinobu,2024-07-26 07:00:00,0.50,1.63,1.06,201,107,296,18,5,13,21,14,7,22,7,15,+2,+1,+1,75%,64%,86%,117,75,159,14%,13%,15%,2,1,1,0,0,0
389,https://vlr.gg/player/16622/tweeya,2024-07-26 07:00:00,0.64,1.26,0.95,209,153,260,37,13,24,39,23,16,15,5,10,-5,-3,-2,79%,81%,77%,141,107,175,16%,16%,15%,2,1,1,7,4,3
390,https://vlr.gg/player/16015/ivory,2024-07-26 07:00:00,0.42,1.15,0.78,187,157,224,35,13,22,42,26,16,6,4,2,+3,0,+3,75%,69%,81%,122,97,147,26%,20%,32%,11,5,6,8,5,3
391,https://vlr.gg/player/8129/chloettw,2024-07-26 07:00:00,0.67,0.53,0.60,198,212,186,12,7,5,23,11,12,10,4,6,-1,+1,-2,83%,92%,75%,129,138,121,12%,7%,19%,2,2,0,3,1,2
392,https://vlr.gg/player/47133/arin,2024-07-26 06:25:00,0.97,1.16,1.07,229,206,246,33,15,18,31,14,17,12,2,10,+2,0,+2,74%,60%,87%,151,132,168,26%,20%,31%,5,2,3,3,2,1
393,https://vlr.gg/player/46152/atti,2024-07-26 06:25:00,0.50,1.45,0.99,244,133,340,36,8,28,35,18,17,6,3,3,+3,-6,+9,70%,45%,91%,148,97,192,21%,15%,25%,13,3,10,10,9,1
394,https://vlr.gg/player/46150/ys2,2024-07-26 06:25:00,0.95,1.03,0.99,189,211,177,28,15,13,31,16,15,17,4,13,+1,-1,+2,70%,55%,83%,130,137,124,24%,33%,17%,3,1,2,2,2,0
395,https://vlr.gg/player/47215/ran,2024-07-26 06:25:00,1.07,0.84,0.96,148,159,136,12,7,5,14,7,7,5,1,4,+2,0,+2,78%,58%,100%,101,116,85,31%,44%,19%,2,0,2,0,0,0
396,https://vlr.gg/player/46151/even1ng,2024-07-26 06:25:00,0.60,1.11,0.87,142,121,160,25,8,17,30,18,12,7,5,2,0,0,0,70%,60%,78%,97,81,111,48%,35%,57%,1,0,1,1,0,1
397,https://vlr.gg/player/34956/penelope,2024-07-26 06:25:00,0.35,0.88,0.67,130,87,160,9,2,7,14,7,7,0,0,0,-1,-1,0,60%,38%,75%,94,65,114,16%,6%,21%,1,0,1,2,1,1
398,https://vlr.gg/player/40411/myoh4nn,2024-07-26 06:25:00,1.24,1.47,1.35,271,237,299,41,20,21,25,15,10,6,3,3,0,-2,+2,67%,65%,70%,192,171,216,37%,51%,29%,4,0,4,4,2,2
399,https://vlr.gg/player/30329/yuh4,2024-07-26 06:25:00,1.12,1.09,1.10,199,225,171,30,16,14,29,18,11,22,14,8,-2,0,-2,84%,78%,90%,136,152,119,23%,19%,30%,1,1,0,3,1,2
400,https://vlr.gg/player/34977/delilah,2024-07-26 06:25:00,0.73,1.33,1.01,207,192,234,31,15,16,31,19,12,6,2,4,-2,-6,+4,67%,61%,75%,136,116,159,22%,17%,29%,7,2,5,9,8,1
401,https://vlr.gg/player/40412/b1nby0,2024-07-26 06:25:00,0.58,1.26,0.90,203,160,247,29,12,17,32,20,12,19,7,12,-3,-5,+2,79%,65%,95%,123,97,153,27%,25%,28%,4,1,3,7,6,1
402,https://vlr.gg/player/40416/dannn,2024-07-26 06:25:00,0.73,1.08,0.89,153,135,183,23,11,12,26,17,9,11,5,6,0,-2,+2,74%,70%,80%,107,91,126,22%,27%,20%,2,0,2,2,2,0
403,https://vlr.gg/player/11666/ray4c,2024-07-26 05:25:00,1.20,1.57,1.40,313,307,331,50,23,27,33,19,14,14,6,8,+4,0,+4,77%,73%,80%,186,176,195,10%,11%,9%,12,5,7,8,5,3
404,https://vlr.gg/player/23710/gotten,2024-07-26 05:25:00,0.87,1.40,1.15,197,140,249,36,12,24,28,13,15,12,3,9,+2,0,+2,77%,68%,84%,140,106,169,31%,33%,29%,3,0,3,1,0,1
405,https://vlr.gg/player/2346/cud,2024-07-26 05:25:00,1.28,0.99,1.12,201,243,160,32,18,14,27,13,14,14,3,11,+2,+1,+1,79%,73%,84%,128,165,96,20%,22%,18%,3,1,2,1,0,1
406,https://vlr.gg/player/4866/kushy,2024-07-26 05:25:00,0.78,1.33,1.08,210,155,256,38,12,26,31,15,16,17,6,11,-2,-3,+1,72%,68%,76%,128,90,162,29%,33%,27%,5,2,3,7,5,2
407,https://vlr.gg/player/7807/valdyn,2024-07-26 05:25:00,0.87,0.93,0.90,160,157,156,27,13,14,31,16,15,15,4,11,-1,0,-1,81%,82%,80%,111,105,116,48%,50%,47%,3,2,1,4,2,2
408,https://vlr.gg/player/9279/kylee,2024-07-26 05:25:00,1.12,1.03,1.08,235,233,242,38,20,18,35,19,16,11,6,5,0,-1,+1,68%,56%,82%,158,147,169,34%,36%,33%,5,2,3,5,3,2
409,https://vlr.gg/player/34100/scar,2024-07-26 05:25:00,0.73,1.22,0.96,178,167,182,26,13,13,37,23,14,25,10,15,+1,+1,0,74%,72%,77%,111,113,109,34%,30%,39%,3,2,1,2,1,1
410,https://vlr.gg/player/23717/nythan,2024-07-26 05:25:00,0.68,1.10,0.88,151,143,168,28,13,15,34,21,13,8,4,4,-2,-1,-1,57%,52%,64%,114,110,120,46%,37%,56%,1,0,1,3,1,2
411,https://vlr.gg/player/34096/faustao,2024-07-26 05:25:00,0.69,0.92,0.80,197,186,216,32,15,17,39,22,17,7,6,1,-4,-5,+1,57%,60%,55%,124,123,125,15%,21%,11%,8,4,4,12,9,3
412,https://vlr.gg/player/37057/woody,2024-07-26 05:25:00,0.76,0.71,0.74,179,156,200,26,13,13,38,20,18,19,9,10,0,-1,+1,57%,56%,59%,116,97,138,27%,25%,29%,4,1,3,4,2,2
413,https://vlr.gg/player/45029/grahams,2024-07-26 05:00:00,1.60,1.53,1.55,278,314,246,35,14,21,17,8,9,6,3,3,+6,+2,+4,84%,77%,88%,193,205,187,35%,35%,35%,7,3,4,1,1,0
414,https://vlr.gg/player/25388/kon,2024-07-26 05:00:00,1.15,1.59,1.44,269,227,299,36,11,25,20,8,12,18,2,16,+3,+1,+2,81%,77%,83%,175,154,186,42%,43%,42%,6,2,4,3,1,2
415,https://vlr.gg/player/16635/poly,2024-07-26 05:00:00,1.09,1.40,1.29,217,188,238,30,8,22,18,8,10,17,6,11,+7,+3,+4,92%,85%,96%,141,117,154,45%,30%,55%,8,3,5,1,0,1
416,https://vlr.gg/player/18062/capricious,2024-07-26 05:00:00,1.24,1.17,1.20,236,245,235,36,13,23,21,8,13,2,1,1,+6,+1,+5,84%,77%,88%,158,183,144,47%,48%,47%,7,2,5,1,1,0
417,https://vlr.gg/player/26069/piety,2024-07-26 05:00:00,1.11,1.22,1.18,209,150,223,26,7,19,19,6,13,15,3,12,+3,0,+3,70%,69%,71%,144,112,161,43%,53%,39%,3,0,3,0,0,0
418,https://vlr.gg/player/39991/elfie,2024-07-26 05:00:00,1.05,0.73,0.94,193,221,163,25,17,8,33,22,11,11,6,5,-6,-3,-3,57%,58%,54%,140,163,98,37%,35%,44%,0,0,0,6,3,3
419,https://vlr.gg/player/9183/envious,2024-07-26 05:00:00,0.69,0.75,0.71,200,174,237,23,13,10,36,23,13,4,4,0,-3,-3,0,57%,63%,46%,134,119,161,26%,24%,28%,5,2,3,8,5,3
420,https://vlr.gg/player/45078/kikowo,2024-07-26 05:00:00,0.76,0.66,0.71,158,168,147,18,13,5,32,21,11,11,6,5,-7,-5,-2,57%,46%,77%,114,114,114,28%,34%,19%,0,0,0,7,5,2
421,https://vlr.gg/player/36904/sampphire,2024-07-26 05:00:00,0.61,0.82,0.68,135,132,154,18,11,7,31,22,9,4,1,3,-4,-4,0,68%,63%,77%,97,99,92,23%,21%,28%,0,0,0,4,4,0
422,https://vlr.gg/player/18072/pigruto,2024-07-26 05:00:00,0.13,0.92,0.40,93,52,164,11,3,8,31,22,9,5,2,3,-5,-3,-2,51%,42%,69%,67,44,110,30%,18%,40%,1,1,0,6,4,2
423,https://vlr.gg/player/3401/ptc,2024-07-26 05:00:00,1.48,1.47,1.48,248,257,227,57,33,24,35,21,14,35,19,16,-2,-2,0,86%,89%,81%,162,165,157,27%,27%,26%,1,0,1,3,2,1
424,https://vlr.gg/player/6723/foxz,2024-07-26 05:00:00,1.22,1.41,1.30,237,214,273,51,27,24,36,20,16,32,14,18,+2,+2,0,84%,81%,89%,163,145,185,30%,30%,29%,5,2,3,3,0,3
425,https://vlr.gg/player/27254/leviathan,2024-07-26 05:00:00,1.03,1.12,1.07,195,188,199,46,27,19,42,24,18,21,7,14,+5,+3,+2,81%,78%,85%,133,133,133,35%,34%,35%,7,4,3,2,1,1
426,https://vlr.gg/player/4377/johnolsen,2024-07-26 05:00:00,1.02,1.11,1.06,244,251,235,53,31,22,47,28,19,10,4,6,+10,+4,+6,71%,58%,89%,166,176,153,27%,31%,20%,23,14,9,13,10,3
427,https://vlr.gg/player/3342/sushiboys,2024-07-26 05:00:00,0.68,1.19,0.86,164,151,190,39,20,19,41,27,14,11,4,7,0,-1,+1,67%,58%,78%,112,100,129,26%,25%,28%,3,1,2,3,2,1
428,https://vlr.gg/player/23918/reality,2024-07-26 05:00:00,0.77,1.07,0.94,213,180,237,45,16,29,49,21,28,14,5,9,-4,0,-4,62%,67%,58%,140,118,157,24%,16%,30%,7,2,5,11,2,9
429,https://vlr.gg/player/6733/xze,2024-07-26 05:00:00,0.89,0.93,0.92,167,152,181,37,15,22,46,19,27,17,7,10,-2,0,-2,70%,78%,64%,116,103,125,38%,30%,44%,3,1,2,5,1,4
430,https://vlr.gg/player/19150/niffy,2024-07-26 05:00:00,0.69,1.08,0.91,205,202,212,46,18,28,50,24,26,6,1,5,-2,-3,+1,62%,52%,69%,149,148,151,32%,32%,32%,7,5,2,9,8,1
431,https://vlr.gg/player/1910/acetics,2024-07-26 05:00:00,0.94,0.75,0.83,171,190,158,37,19,18,49,21,28,18,7,11,-4,-3,-1,63%,67%,61%,120,122,119,33%,32%,35%,5,1,4,9,4,5
432,https://vlr.gg/player/2390/pinocchios,2024-07-26 05:00:00,0.51,0.95,0.76,175,138,207,36,13,23,52,23,29,21,7,14,-3,-3,0,65%,63%,67%,127,103,145,18%,21%,17%,2,0,2,5,3,2
433,https://vlr.gg/player/46170/dorothy,2024-07-26 04:00:00,2.04,1.69,1.86,340,373,311,45,26,19,16,5,11,6,1,5,+8,+5,+3,83%,94%,72%,219,229,209,32%,36%,28%,10,6,4,2,1,1
434,https://vlr.gg/player/40423/bibi,2024-07-26 04:00:00,1.63,1.03,1.32,232,248,216,28,15,13,18,5,13,14,8,6,0,+2,-2,83%,100%,67%,165,171,159,26%,29%,24%,5,3,2,5,1,4
435,https://vlr.gg/player/40410/332,2024-07-26 04:00:00,1.35,1.14,1.24,184,216,154,23,14,9,15,7,8,15,4,11,-2,-2,0,80%,88%,72%,128,144,114,31%,29%,33%,0,0,0,2,2,0
436,https://vlr.gg/player/40151/h4ste,2024-07-26 04:00:00,1.39,1.09,1.23,246,270,225,29,15,14,24,11,13,26,15,11,0,+1,-1,83%,82%,83%,165,180,151,39%,47%,33%,3,2,1,3,1,2
437,https://vlr.gg/player/40556/f1yk,2024-07-26 04:00:00,0.97,1.21,1.09,163,144,177,22,10,12,15,7,8,1,0,1,+1,+1,0,83%,82%,83%,111,97,124,38%,36%,39%,3,1,2,2,0,2
438,https://vlr.gg/player/40430/nlight,2024-07-26 04:00:00,1.07,0.34,0.72,157,212,102,18,14,4,29,13,16,4,1,3,-1,+1,-2,63%,78%,47%,106,138,72,18%,26%,8%,3,3,0,4,2,2
439,https://vlr.gg/player/37540/d0r1,2024-07-26 04:00:00,0.98,0.43,0.71,160,201,116,19,13,6,29,12,17,10,7,3,-1,-1,0,54%,67%,41%,111,137,83,28%,31%,23%,0,0,0,1,1,0
440,https://vlr.gg/player/46146/helencoco,2024-07-26 04:00:00,0.47,0.86,0.66,161,128,196,19,7,12,31,15,16,2,2,0,+1,+1,0,51%,56%,47%,109,85,134,41%,29%,52%,6,3,3,5,2,3
441,https://vlr.gg/player/30319/chamsae,2024-07-26 04:00:00,0.85,0.47,0.65,151,175,128,19,13,6,29,13,16,8,3,5,-6,-2,-4,54%,61%,47%,97,109,84,22%,21%,24%,0,0,0,6,2,4
442,https://vlr.gg/player/34886/yxx,2024-07-26 04:00:00,0.58,0.46,0.52,122,121,121,13,6,7,29,14,15,10,10,0,0,+1,-1,66%,78%,53%,82,86,78,22%,22%,22%,5,3,2,5,2,3
443,https://vlr.gg/player/7783/zhar,2024-07-26 03:00:00,0.87,1.01,0.94,210,213,209,26,13,13,28,15,13,8,6,2,+1,-2,+3,69%,72%,65%,127,131,123,25%,17%,37%,5,1,4,4,3,1
444,https://vlr.gg/player/7048/budimeister,2024-07-26 03:00:00,0.82,0.87,0.85,197,198,196,21,12,9,29,15,14,16,5,11,0,-1,+1,57%,44%,71%,130,130,130,28%,31%,26%,2,0,2,2,1,1
445,https://vlr.gg/player/7804/severine,2024-07-26 03:00:00,0.61,0.89,0.75,126,151,101,12,6,6,26,16,10,12,7,5,-7,-4,-3,69%,72%,65%,85,107,62,10%,10%,10%,0,0,0,7,4,3
446,https://vlr.gg/player/4872/frostmind,2024-07-26 03:00:00,0.54,0.62,0.58,130,102,159,18,8,10,30,16,14,3,2,1,0,0,0,60%,67%,53%,80,65,95,43%,50%,38%,1,0,1,1,0,1
447,https://vlr.gg/player/9717/lilo,2024-07-26 03:00:00,0.61,0.46,0.54,166,206,121,18,11,7,31,17,14,6,4,2,-3,-1,-2,46%,50%,41%,111,134,86,24%,26%,20%,5,4,1,8,5,3
448,https://vlr.gg/player/4874/berserx,2024-07-26 03:00:00,1.29,1.51,1.41,215,238,191,29,14,15,15,9,6,10,4,6,0,0,0,86%,82%,89%,136,152,121,27%,24%,31%,0,0,0,0,0,0
449,https://vlr.gg/player/2380/zesbeew,2024-07-26 03:00:00,1.57,1.25,1.40,235,288,189,29,18,11,17,8,9,16,6,10,+3,+1,+2,83%,88%,78%,150,182,120,18%,17%,20%,7,3,4,4,2,2
450,https://vlr.gg/player/2348/famouz,2024-07-26 03:00:00,1.10,1.57,1.34,270,212,324,32,11,21,20,9,11,7,3,4,+4,+2,+2,74%,76%,72%,172,142,200,14%,15%,13%,8,3,5,4,1,3
451,https://vlr.gg/player/10739/shiro,2024-07-26 03:00:00,1.26,1.41,1.34,238,195,279,30,13,17,21,8,13,22,4,18,0,-2,+2,91%,94%,89%,155,136,173,25%,19%,29%,3,1,2,3,3,0
452,https://vlr.gg/player/7043/ncslasher,2024-07-26 03:00:00,0.71,1.14,0.93,182,134,226,24,9,15,22,11,11,16,8,8,+2,0,+2,80%,82%,78%,118,90,145,28%,42%,21%,4,2,2,2,2,0
453,https://vlr.gg/player/10217/marky,2024-07-26 03:00:00,1.08,1.34,1.25,254,233,271,66,22,44,52,20,32,25,8,17,+5,-2,+7,82%,74%,87%,172,160,179,27%,30%,25%,16,4,12,11,6,5
454,https://vlr.gg/player/7437/kellys,2024-07-26 03:00:00,1.02,1.17,1.12,227,244,224,58,23,35,54,23,31,26,13,13,+2,-1,+3,82%,81%,83%,154,160,150,26%,23%,28%,7,3,4,5,4,1
455,https://vlr.gg/player/7754/xavi8k,2024-07-26 03:00:00,1.04,1.16,1.12,226,203,229,62,20,42,51,18,33,12,3,9,-2,-1,-1,74%,81%,70%,143,130,151,27%,24%,28%,6,2,4,8,3,5
456,https://vlr.gg/player/2679/dubstep,2024-07-26 03:00:00,1.08,0.92,0.98,192,192,189,50,19,31,52,19,33,26,11,15,0,+2,-2,69%,85%,60%,124,121,126,38%,27%,45%,5,2,3,5,0,5
457,https://vlr.gg/player/10782/witz,2024-07-26 03:00:00,0.70,0.59,0.63,143,173,118,36,19,17,57,22,35,28,6,22,-5,+1,-6,69%,70%,68%,86,93,82,18%,15%,21%,3,2,1,8,1,7
458,https://vlr.gg/player/16953/zynd,2024-07-26 03:00:00,1.40,0.90,1.21,226,264,177,64,47,17,50,31,19,11,5,6,-1,+3,-4,78%,83%,70%,154,173,121,39%,42%,33%,8,7,1,9,4,5
459,https://vlr.gg/player/13744/patmen,2024-07-26 03:00:00,1.03,0.91,0.98,219,215,241,57,35,22,59,35,24,24,18,6,+5,+2,+3,70%,68%,74%,155,154,156,28%,27%,31%,10,5,5,5,3,2
460,https://vlr.gg/player/21677/jeee,2024-07-26 03:00:00,0.94,1.04,0.97,192,180,214,52,31,21,54,33,21,20,13,7,-2,-3,+1,66%,66%,67%,134,120,158,38%,43%,32%,4,1,3,6,4,2
461,https://vlr.gg/player/7746/kevzii,2024-07-26 03:00:00,0.81,1.10,0.92,159,148,202,44,25,19,52,32,20,26,10,16,+3,+1,+2,66%,62%,74%,115,102,137,24%,26%,21%,8,5,3,5,4,1
462,https://vlr.gg/player/9737/kakarot,2024-07-26 03:00:00,0.64,1.29,0.88,198,176,230,49,26,23,57,38,19,24,14,10,-5,-4,-1,69%,68%,70%,129,115,155,24%,21%,30%,7,5,2,12,9,3
463,https://vlr.gg/player/11921/silentzz,2024-07-25 18:15:00,1.09,1.54,1.32,262,242,285,40,17,23,23,15,8,7,5,2,+1,-1,+2,78%,70%,86%,165,146,183,29%,28%,29%,7,2,5,6,3,3
464,https://vlr.gg/player/3169/zap,2024-07-25 18:15:00,0.80,1.82,1.32,219,153,283,35,11,24,21,15,6,20,8,12,-2,-3,+1,83%,70%,95%,147,103,190,25%,31%,22%,1,0,1,3,3,0
465,https://vlr.gg/player/662/pryze,2024-07-25 18:15:00,1.19,1.23,1.21,204,235,173,30,17,13,24,16,8,17,7,10,0,+1,-1,83%,85%,81%,133,158,110,32%,37%,25%,3,2,1,3,1,2
466,https://vlr.gg/player/21661/spike,2024-07-25 18:15:00,0.69,1.63,1.17,254,164,339,36,11,25,28,16,12,10,4,6,+6,0,+6,83%,75%,90%,152,96,206,28%,19%,33%,9,3,6,3,3,0
467,https://vlr.gg/player/6195/lz,2024-07-25 18:15:00,0.89,1.09,0.99,165,150,177,22,10,12,23,14,9,16,8,8,+2,-1,+3,71%,65%,76%,107,105,109,41%,41%,40%,4,1,3,2,2,0
468,https://vlr.gg/player/27149/brinks,2024-07-25 18:15:00,0.64,1.37,1.00,193,143,243,27,10,17,30,19,11,14,3,11,-1,-1,0,68%,52%,85%,124,94,155,21%,20%,22%,2,1,1,3,2,1
469,https://vlr.gg/player/1566/prozin,2024-07-25 18:15:00,0.58,1.27,0.91,200,140,264,32,10,22,31,19,12,5,2,3,0,-3,+3,68%,57%,80%,126,94,159,30%,30%,31%,5,0,5,5,3,2
470,https://vlr.gg/player/1999/rnd,2024-07-25 18:15:00,0.18,1.67,0.90,213,104,326,29,5,24,33,21,12,6,4,2,0,-4,+4,66%,52%,80%,131,78,187,10%,6%,12%,8,3,5,8,7,1
471,https://vlr.gg/player/1567/bezn1,2024-07-25 18:15:00,0.66,1.05,0.85,170,158,185,21,9,12,33,18,15,19,3,16,-1,-2,+1,73%,67%,80%,120,117,123,21%,23%,19%,1,0,1,2,2,0
472,https://vlr.gg/player/1684/denaro,2024-07-25 18:15:00,0.57,0.12,0.33,87,135,37,10,9,1,36,20,16,8,3,5,-5,-1,-4,54%,57%,50%,59,88,28,13%,22%,0%,1,1,0,6,2,4
473,https://vlr.gg/player/15636/scarn,2024-07-25 18:00:00,1.18,1.17,1.17,261,281,238,55,30,25,50,27,23,10,6,4,+3,+2,+1,71%,69%,73%,176,200,150,31%,35%,25%,15,9,6,12,7,5
474,https://vlr.gg/player/21886/furbsa,2024-07-25 18:00:00,1.38,0.95,1.17,234,290,177,53,34,19,48,23,25,17,5,12,-3,-1,-2,68%,72%,63%,157,185,128,47%,48%,46%,3,1,2,6,2,4
475,https://vlr.gg/player/6437/dark3st,2024-07-25 18:00:00,1.09,0.75,0.92,197,184,208,43,23,20,48,21,27,16,11,5,+1,+3,-2,76%,75%,77%,121,115,127,27%,40%,19%,5,3,2,4,0,4
476,https://vlr.gg/player/8397/dip,2024-07-25 18:00:00,0.74,0.90,0.82,165,140,192,34,16,18,44,20,24,19,9,10,-4,-3,-1,63%,66%,60%,108,86,131,27%,25%,28%,2,1,1,6,4,2
477,https://vlr.gg/player/16757/cohburg,2024-07-25 18:00:00,0.91,0.57,0.74,143,175,112,30,19,11,47,23,24,21,12,9,-3,-1,-2,68%,81%,53%,92,114,69,29%,34%,21%,3,2,1,6,3,3
478,https://vlr.gg/player/8376/seven,2024-07-25 18:00:00,1.39,1.25,1.32,271,266,269,60,31,29,41,16,25,18,12,6,+5,+2,+3,82%,90%,75%,175,162,187,32%,29%,35%,9,4,5,4,2,2
479,https://vlr.gg/player/64/gmd,2024-07-25 18:00:00,1.26,1.14,1.20,228,237,224,48,24,24,45,20,25,39,22,17,0,+2,-2,81%,90%,72%,152,152,151,28%,27%,30%,3,2,1,3,0,3
480,https://vlr.gg/player/3702/sym,2024-07-25 18:00:00,0.93,1.07,1.01,263,266,266,59,29,30,51,26,25,8,5,3,+2,+2,0,69%,80%,59%,171,174,168,31%,30%,33%,16,9,7,14,7,7
481,https://vlr.gg/player/740/aproto,2024-07-25 18:00:00,0.98,0.76,0.87,149,157,138,33,17,16,35,14,21,17,8,9,-1,0,-1,76%,77%,75%,95,95,95,27%,26%,28%,4,2,2,5,2,3
482,https://vlr.gg/player/849/poised,2024-07-25 18:00:00,1.05,0.56,0.80,159,191,131,36,22,14,43,17,26,20,7,13,0,0,0,74%,73%,75%,98,115,83,25%,23%,26%,2,1,1,2,1,1
483,https://vlr.gg/player/6202/guuih,2024-07-25 16:00:00,1.49,1.48,1.48,283,263,298,38,14,24,22,8,14,15,6,9,+6,+4,+2,80%,81%,79%,181,169,188,33%,31%,34%,8,4,4,2,0,2
484,https://vlr.gg/player/13823/pxs,2024-07-25 16:00:00,1.03,1.52,1.32,283,281,286,43,16,27,26,13,13,8,3,5,0,0,0,83%,88%,79%,181,175,185,21%,21%,22%,6,3,3,6,3,3
485,https://vlr.gg/player/20240/xenom,2024-07-25 16:00:00,1.30,1.04,1.14,167,169,164,27,12,15,21,7,14,23,12,11,+1,-1,+2,78%,88%,71%,104,119,94,23%,18%,28%,4,0,4,3,1,2
486,https://vlr.gg/player/23010/nicksz,2024-07-25 16:00:00,1.61,0.81,1.13,199,253,164,27,15,12,22,6,16,24,11,13,-1,0,-1,88%,88%,88%,136,172,113,23%,27%,20%,1,0,1,2,0,2
487,https://vlr.gg/player/3424/siduzord,2024-07-25 16:00:00,1.34,0.99,1.13,226,256,200,32,16,16,24,8,16,17,5,12,0,+1,-1,88%,94%,83%,138,145,133,31%,42%,24%,4,3,1,4,2,2
488,https://vlr.gg/player/5395/cortezia,2024-07-25 16:00:00,1.22,0.57,0.96,213,230,185,27,19,8,34,18,16,13,11,2,-3,-5,+2,63%,67%,56%,144,157,126,23%,25%,19%,2,0,2,5,5,0
489,https://vlr.gg/player/1586/v1nny,2024-07-25 16:00:00,0.93,0.88,0.91,189,190,186,24,13,11,33,18,15,15,11,4,-2,-1,-1,68%,67%,69%,130,142,113,29%,25%,36%,0,0,0,2,1,1
490,https://vlr.gg/player/3455/zanatsu,2024-07-25 16:00:00,0.81,0.91,0.85,218,227,211,28,17,11,34,20,14,11,7,4,0,+2,-2,65%,63%,69%,140,141,139,20%,16%,27%,9,7,2,9,5,4
491,https://vlr.gg/player/3433/ctc,2024-07-25 16:00:00,0.90,0.39,0.69,137,161,97,19,13,6,32,18,14,7,4,3,+1,+3,-2,48%,54%,38%,86,113,46,18%,24%,8%,3,3,0,2,0,2
492,https://vlr.gg/player/3157/gaabxx,2024-07-25 16:00:00,0.59,0.57,0.58,127,124,134,17,11,6,34,20,14,12,6,6,-2,-1,-1,63%,63%,63%,79,74,87,23%,20%,27%,3,1,2,5,2,3
493,https://vlr.gg/player/844/bdog,2024-07-25 16:00:00,1.26,1.60,1.41,246,212,289,33,15,18,17,10,7,9,9,0,+2,-1,+3,74%,68%,81%,150,140,163,22%,20%,26%,6,2,4,4,3,1
494,https://vlr.gg/player/4931/add3r,2024-07-25 16:00:00,0.96,1.69,1.29,263,214,316,34,15,19,23,12,11,10,4,6,-1,-3,+2,74%,63%,88%,174,149,204,37%,44%,33%,2,0,2,3,3,0
495,https://vlr.gg/player/733/stellar,2024-07-25 16:00:00,1.42,0.99,1.22,204,231,162,27,17,10,19,11,8,14,8,6,0,0,0,86%,84%,88%,125,146,100,20%,26%,11%,1,1,0,1,1,0
496,https://vlr.gg/player/260/corey,2024-07-25 16:00:00,1.37,0.89,1.14,226,262,185,28,18,10,23,12,11,9,6,3,-3,0,-3,77%,84%,69%,154,174,129,34%,26%,55%,3,2,1,6,2,4
497,https://vlr.gg/player/1856/wedid,2024-07-25 16:00:00,0.77,1.39,1.05,209,181,250,26,12,14,24,15,9,15,8,7,+1,-1,+2,86%,95%,75%,144,118,174,26%,31%,24%,5,2,3,4,3,1
498,https://vlr.gg/player/2139/neptune,2024-07-25 16:00:00,1.27,0.76,0.99,248,300,210,28,16,12,31,15,16,12,5,7,+2,0,+2,80%,75%,84%,157,183,135,43%,52%,35%,3,1,2,1,1,0
499,https://vlr.gg/player/818/mummay,2024-07-25 16:00:00,0.37,1.15,0.79,146,97,189,20,5,15,27,14,13,9,5,4,0,0,0,74%,63%,84%,107,69,139,32%,16%,41%,2,0,2,2,0,2
500,https://vlr.gg/player/2164/paincakes,2024-07-25 16:00:00,0.57,0.91,0.76,157,138,183,20,8,12,27,13,14,6,2,4,-1,-1,0,66%,56%,74%,100,83,114,50%,69%,41%,4,1,3,5,2,3
501,https://vlr.gg/player/3687/jonaaa6,2024-07-25 16:00:00,0.73,0.66,0.69,204,210,183,21,11,10,31,15,16,6,1,5,+2,+1,+1,60%,50%,68%,133,143,125,41%,56%,29%,6,3,3,4,2,2
502,https://vlr.gg/player/8375/bones,2024-07-25 16:00:00,0.41,0.60,0.51,149,118,171,17,6,11,32,14,18,6,3,3,-2,-4,+2,66%,56%,74%,99,76,118,34%,36%,32%,3,1,2,5,5,0
0,https://vlr.gg/player/24424/pa1ze,2024-07-25 14:30:00,2.22,1.39,1.67,320,410,278,42,19,23,21,6,15,6,0,6,+2,+3,-1,83%,83%,83%,219,249,204,31%,35%,28%,8,4,4,6,1,5
1,https://vlr.gg/player/34684/westside,2024-07-25 14:30:00,0.97,1.57,1.37,250,164,294,33,7,26,19,8,11,4,3,1,0,0,0,75%,75%,75%,171,117,198,43%,53%,40%,4,1,3,4,1,3
2,https://vlr.gg/player/5490/xitsha,2024-07-25 14:30:00,1.27,1.41,1.36,265,289,251,35,12,23,23,10,13,10,5,5,+1,0,+1,89%,83%,92%,179,193,172,34%,30%,36%,2,1,1,1,1,0
3,https://vlr.gg/player/8593/grmekista,2024-07-25 14:30:00,0.27,1.35,0.99,145,25,203,19,0,19,19,8,11,13,7,6,0,-1,+1,81%,67%,88%,94,12,135,38%,0%,42%,2,0,2,2,1,1
4,https://vlr.gg/player/3839/prti,2024-07-25 14:30:00,1.09,0.67,0.81,160,188,145,21,9,12,25,8,17,10,2,8,-3,-2,-1,75%,83%,71%,110,120,104,25%,22%,26%,2,0,2,5,2,3
5,https://vlr.gg/player/21216/f4ngeer,2024-07-25 14:30:00,1.14,0.72,1.00,210,240,153,26,20,6,30,20,10,9,4,5,+4,+4,0,58%,58%,58%,151,168,118,48%,51%,41%,6,5,1,2,1,1
6,https://vlr.gg/player/21609/danda,2024-07-25 14:30:00,0.98,0.93,0.96,183,190,165,23,15,8,27,18,9,10,6,4,-3,-1,-2,69%,67%,75%,117,121,111,27%,23%,38%,2,1,1,5,2,3
7,https://vlr.gg/player/29575/luckymrj,2024-07-25 14:30:00,0.62,0.90,0.71,167,173,155,21,14,7,30,22,8,5,3,2,0,-1,+1,67%,67%,67%,102,103,99,38%,38%,38%,3,2,1,3,3,0
8,https://vlr.gg/player/29742/anxios,2024-07-25 14:30:00,0.57,0.54,0.56,161,161,159,19,12,7,32,22,10,10,5,5,-1,-1,0,58%,54%,67%,107,112,97,35%,33%,40%,3,2,1,4,3,1
9,https://vlr.gg/player/4537/tajrex,2024-07-25 14:30:00,0.26,1.12,0.55,157,95,282,17,6,11,33,23,10,11,7,4,0,-1,+1,69%,58%,92%,116,63,220,26%,20%,33%,4,2,2,4,3,1
10,https://vlr.gg/player/42371/t0ba,2024-07-25 13:00:00,1.14,1.11,1.13,230,193,271,53,23,30,46,21,25,14,9,5,0,-1,+1,65%,65%,66%,160,131,191,29%,28%,29%,5,1,4,5,2,3
11,https://vlr.gg/player/24428/harambe,2024-07-25 13:00:00,1.12,1.05,1.08,224,239,220,55,28,27,47,23,24,8,5,3,0,0,0,62%,62%,63%,143,151,134,28%,32%,23%,10,4,6,10,4,6
12,https://vlr.gg/player/30901/ianto,2024-07-25 13:00:00,0.90,0.89,0.90,153,161,148,34,20,14,43,22,21,15,4,11,+2,+4,-2,68%,68%,69%,103,100,107,26%,37%,18%,7,5,2,5,1,4
13,https://vlr.gg/player/12372/szoren,2024-07-25 13:00:00,0.93,0.74,0.84,165,187,137,37,22,15,46,23,23,16,5,11,-2,-2,0,62%,59%,66%,102,116,88,19%,18%,22%,5,4,1,7,6,1
14,https://vlr.gg/player/31350/deqadz,2024-07-25 13:00:00,0.75,0.85,0.80,163,155,178,35,18,17,47,24,23,25,11,14,-6,-7,+1,64%,56%,72%,108,103,114,21%,27%,17%,3,0,3,9,7,2
15,https://vlr.gg/player/29628/famzzam,2024-07-25 13:00:00,1.10,1.28,1.19,235,209,258,56,26,30,41,20,21,25,9,16,+1,0,+1,79%,78%,79%,151,135,165,25%,24%,26%,6,1,5,5,1,4
16,https://vlr.gg/player/33994/creamydreamy,2024-07-25 13:00:00,1.06,1.27,1.17,184,160,208,47,22,25,39,20,19,30,13,17,0,-1,+1,70%,66%,74%,122,104,140,36%,47%,29%,6,3,3,6,4,2
17,https://vlr.gg/player/16188/tempo,2024-07-25 13:00:00,1.17,0.77,0.96,170,197,147,42,24,18,40,18,22,4,3,1,+2,+1,+1,70%,75%,65%,117,141,95,28%,35%,22%,8,4,4,6,3,3
18,https://vlr.gg/player/2182/hearthbeat,2024-07-25 13:00:00,0.99,0.95,0.96,176,165,183,35,14,21,43,21,22,39,23,16,+3,+1,+2,68%,72%,65%,111,112,109,31%,26%,36%,4,1,3,1,0,1
19,https://vlr.gg/player/12519/ticey,2024-07-25 13:00:00,1.05,0.72,0.88,225,264,183,49,30,19,51,24,27,13,5,8,0,-1,+1,68%,66%,71%,137,151,124,19%,25%,13%,12,7,5,12,8,4
20,https://vlr.gg/player/5795/sickrey,2024-07-25 12:00:00,1.33,1.26,1.29,222,223,224,83,42,41,59,30,29,34,20,14,+4,+2,+2,78%,74%,82%,150,155,145,36%,36%,36%,8,4,4,4,2,2
21,https://vlr.gg/player/1470/simond4rk,2024-07-25 12:00:00,1.08,1.46,1.28,254,211,299,92,36,56,64,35,29,24,11,13,+1,-3,+4,76%,66%,86%,167,146,188,21%,20%,22%,16,5,11,15,8,7
22,https://vlr.gg/player/2432/moner,2024-07-25 12:00:00,0.88,0.99,0.94,177,173,188,65,30,35,63,34,29,13,8,5,+9,+7,+2,77%,82%,73%,122,120,124,29%,25%,33%,14,8,6,5,1,4
23,https://vlr.gg/player/3807/winteryrook,2024-07-25 12:00:00,0.67,1.06,0.86,180,158,210,66,27,39,74,40,34,29,11,18,-5,-2,-3,66%,60%,73%,125,103,146,35%,38%,33%,7,5,2,12,7,5
24,https://vlr.gg/player/1897/bgg,2024-07-25 12:00:00,0.94,0.72,0.83,160,159,149,54,26,28,66,32,34,31,19,12,0,0,0,72%,70%,75%,106,110,103,26%,25%,27%,10,5,5,10,5,5
25,https://vlr.gg/player/5654/avez,2024-07-25 12:00:00,1.18,1.42,1.30,242,231,265,88,42,46,67,36,31,18,6,12,0,0,0,70%,67%,74%,165,156,174,40%,44%,36%,6,3,3,6,3,3
26,https://vlr.gg/player/363/7ssk7,2024-07-25 12:00:00,0.98,1.02,1.00,190,197,176,67,34,33,72,40,32,37,21,16,+1,+3,-2,75%,69%,82%,120,123,117,34%,29%,41%,10,7,3,9,4,5
27,https://vlr.gg/player/172/vakk,2024-07-25 12:00:00,0.88,0.86,0.87,161,167,165,57,29,28,66,37,29,24,11,13,-3,-1,-2,69%,63%,76%,111,112,110,25%,29%,22%,8,3,5,11,4,7
28,https://vlr.gg/player/3806/xenon,2024-07-25 12:00:00,0.56,1.17,0.86,165,118,214,58,20,38,73,43,30,38,21,17,+1,-2,+3,68%,57%,80%,102,72,132,38%,32%,41%,8,3,5,7,5,2
29,https://vlr.gg/player/6126/sibeastw0w,2024-07-25 12:00:00,0.79,0.64,0.70,167,179,162,55,30,25,82,43,39,25,8,17,-8,-5,-3,61%,61%,62%,113,119,108,23%,26%,20%,14,7,7,22,12,10
30,https://vlr.gg/player/4325/musashi,2024-07-25 11:00:00,0.93,1.33,1.13,208,167,247,50,20,30,50,24,26,23,14,9,+2,-3,+5,68%,72%,64%,142,110,174,25%,25%,24%,8,1,7,6,4,2
31,https://vlr.gg/player/32351/cullumx,2024-07-25 11:00:00,0.99,1.09,1.04,222,208,239,57,27,30,54,25,29,20,7,13,+2,0,+2,67%,67%,67%,152,135,170,43%,46%,40%,11,4,7,9,4,5
32,https://vlr.gg/player/321/chiwa,2024-07-25 11:00:00,1.02,0.96,0.99,206,202,208,53,28,25,53,26,27,14,5,9,-3,-2,-1,68%,72%,64%,149,140,159,22%,23%,22%,2,1,1,5,3,2
33,https://vlr.gg/player/8808/pyrolll,2024-07-25 11:00:00,1.13,0.84,0.98,184,204,165,46,25,21,48,22,26,18,10,8,-4,-3,-1,67%,61%,72%,124,140,109,32%,39%,25%,4,3,1,8,6,2
34,https://vlr.gg/player/1374/alive,2024-07-25 11:00:00,0.85,0.75,0.80,184,184,184,39,19,20,58,28,30,21,13,8,+1,+2,-1,69%,75%,64%,131,131,131,20%,22%,18%,10,6,4,9,4,5
35,https://vlr.gg/player/5554/profek,2024-07-25 11:00:00,1.37,1.09,1.23,245,280,209,67,38,29,47,24,23,21,9,12,+1,+1,0,79%,86%,72%,160,183,137,34%,38%,30%,7,3,4,6,2,4
36,https://vlr.gg/player/1155/buld,2024-07-25 11:00:00,1.12,1.06,1.09,193,180,206,49,23,26,46,21,25,35,17,18,-2,-3,+1,71%,67%,75%,127,126,128,31%,34%,28%,6,2,4,8,5,3
37,https://vlr.gg/player/23169/minny,2024-07-25 11:00:00,0.88,1.09,0.99,191,182,202,51,25,26,50,28,22,18,8,10,-1,-4,+3,69%,67%,72%,137,129,144,34%,27%,41%,4,0,4,5,4,1
38,https://vlr.gg/player/562/zeek,2024-07-25 11:00:00,0.96,0.86,0.91,200,206,194,46,27,19,52,27,25,30,18,12,+4,+2,+2,68%,72%,64%,137,136,138,22%,25%,20%,9,4,5,5,2,3
39,https://vlr.gg/player/25906/alexiiik,2024-07-25 11:00:00,0.99,0.82,0.90,179,202,159,50,26,24,51,26,25,10,9,1,0,0,0,68%,69%,67%,121,143,100,28%,34%,20%,11,7,4,11,7,4
40,https://vlr.gg/player/12793/xeus,2024-07-25 10:30:00,1.61,1.29,1.44,305,335,267,94,50,44,57,27,30,11,6,5,+12,+9,+3,73%,80%,65%,185,208,164,25%,27%,24%,20,12,8,8,3,5
41,https://vlr.gg/player/12795/crewen,2024-07-25 10:30:00,1.35,1.07,1.21,224,211,240,65,32,33,49,17,32,21,7,14,+1,-2,+3,81%,85%,77%,161,157,166,27%,22%,32%,6,1,5,5,3,2
42,https://vlr.gg/player/22676/ventt,2024-07-25 10:30:00,1.26,1.04,1.15,202,220,184,63,35,28,50,23,27,41,23,18,+3,-1,+4,85%,85%,84%,127,142,113,25%,25%,25%,8,2,6,5,3,2
43,https://vlr.gg/player/12774/anima,2024-07-25 10:30:00,1.13,1.06,1.09,194,184,203,57,27,30,49,20,29,43,21,22,-3,-6,+3,79%,80%,77%,122,119,125,25%,33%,20%,6,1,5,9,7,2
44,https://vlr.gg/player/16483/gloomy,2024-07-25 10:30:00,0.96,0.95,0.95,155,160,157,45,22,23,50,23,27,37,20,17,-1,-1,0,80%,80%,79%,106,103,108,23%,27%,20%,8,4,4,9,5,4
45,https://vlr.gg/player/4962/lurzy0y0,2024-07-25 10:30:00,1.20,1.04,1.12,212,213,210,64,34,30,59,27,32,14,8,6,+4,-1,+5,69%,67%,71%,135,142,129,34%,35%,32%,11,2,9,7,3,4
46,https://vlr.gg/player/5517/masic,2024-07-25 10:30:00,1.12,0.55,0.84,186,244,130,51,36,15,66,32,34,25,12,13,+1,-1,+2,60%,70%,49%,132,167,96,28%,33%,21%,8,4,4,7,5,2
47,https://vlr.gg/player/7353/glovee,2024-07-25 10:30:00,0.88,0.75,0.82,161,170,166,45,23,22,64,32,32,28,17,11,-4,-4,0,67%,72%,61%,115,115,114,25%,23%,27%,2,0,2,6,4,2
48,https://vlr.gg/player/6559/destruct1vee,2024-07-25 10:30:00,0.75,0.73,0.74,155,161,166,45,23,22,65,31,34,27,14,13,-6,-6,0,63%,63%,63%,109,112,107,26%,26%,26%,3,0,3,9,6,3
49,https://vlr.gg/player/10137/ip0tt,2024-07-25 10:30:00,0.76,0.62,0.69,182,202,164,50,29,21,70,36,34,11,5,6,-7,-1,-6,61%,63%,59%,121,129,113,31%,28%,35%,12,9,3,19,10,9
50,https://vlr.gg/player/8129/chloettw,2024-07-25 09:00:00,2.12,1.29,1.59,303,327,272,42,18,24,19,4,15,19,5,14,+3,+1,+2,92%,100%,88%,189,201,183,17%,16%,18%,4,1,3,1,0,1
51,https://vlr.gg/player/16622/tweeya,2024-07-25 09:00:00,1.87,1.17,1.42,257,324,232,36,16,20,22,5,17,11,3,8,0,0,0,85%,93%,80%,176,229,146,20%,24%,17%,2,1,1,2,1,1
52,https://vlr.gg/player/17532/aisling,2024-07-25 09:00:00,0.93,1.35,1.20,216,111,233,27,6,21,21,7,14,18,12,6,+1,-1,+2,85%,93%,80%,128,78,156,24%,22%,24%,2,0,2,1,1,0
53,https://vlr.gg/player/25406/shina,2024-07-25 09:00:00,1.71,0.82,1.14,221,278,178,31,15,16,24,6,18,11,6,5,+2,+1,+1,82%,93%,76%,134,160,119,19%,23%,17%,5,1,4,3,0,3
54,https://vlr.gg/player/16015/ivory,2024-07-25 09:00:00,0.94,1.10,1.03,207,187,214,27,10,17,26,10,16,13,2,11,-1,-1,0,77%,71%,80%,139,114,153,16%,19%,14%,9,4,5,10,5,5
55,https://vlr.gg/player/46798/syd89,2024-07-25 09:00:00,1.02,0.75,0.92,167,193,185,23,17,6,32,19,13,20,11,9,-3,-2,-1,67%,64%,71%,137,131,146,39%,39%,40%,2,2,0,5,4,1
56,https://vlr.gg/player/40294/arki,2024-07-25 09:00:00,0.98,0.50,0.79,157,196,128,23,17,6,31,19,12,6,6,0,+1,+1,0,67%,76%,50%,119,138,84,27%,33%,15%,3,2,1,2,1,1
57,https://vlr.gg/player/17609/makchin,2024-07-25 09:00:00,0.74,0.82,0.76,206,217,224,27,17,10,35,22,13,7,5,2,+1,-2,+3,54%,56%,50%,138,142,130,25%,25%,25%,8,4,4,7,6,1
58,https://vlr.gg/player/46884/kathrina,2024-07-25 09:00:00,0.86,0.26,0.63,144,164,96,20,15,5,31,18,13,11,8,3,-2,-2,0,59%,60%,57%,96,116,61,18%,15%,31%,1,0,1,3,2,1
59,https://vlr.gg/player/39405/shirah0sh1,2024-07-25 09:00:00,0.87,0.16,0.60,126,161,83,18,14,4,34,20,14,9,8,1,-2,0,-2,69%,76%,57%,88,104,60,32%,29%,44%,3,2,1,5,2,3
60,https://vlr.gg/player/17594/newky,2024-07-25 05:30:00,1.03,1.31,1.17,236,217,258,60,28,32,47,27,20,8,5,3,-6,-7,+1,65%,62%,69%,156,140,174,36%,34%,38%,6,2,4,12,9,3
61,https://vlr.gg/player/19978/cendary,2024-07-25 05:30:00,0.72,1.39,1.04,283,240,333,61,25,36,63,39,24,29,19,10,+3,-2,+5,74%,76%,72%,185,147,225,20%,25%,18%,10,3,7,7,5,2
62,https://vlr.gg/player/19976/marpandyz,2024-07-25 05:30:00,1.00,1.08,1.04,213,217,207,48,23,25,47,27,20,19,13,6,+3,+2,+1,77%,74%,81%,135,140,130,17%,14%,21%,6,3,3,3,1,2
63,https://vlr.gg/player/45044/jelerak,2024-07-25 05:30:00,0.52,1.16,0.83,144,103,187,32,11,21,43,27,16,28,15,13,-2,-2,0,76%,71%,81%,99,72,128,19%,16%,21%,5,1,4,7,3,4
64,https://vlr.gg/player/46860/mimo,2024-07-25 05:30:00,0.75,0.80,0.78,168,171,169,40,20,20,49,27,22,6,2,4,-4,-5,+1,71%,68%,75%,114,115,113,21%,28%,15%,3,1,2,7,6,1
65,https://vlr.gg/player/45078/kikowo,2024-07-25 05:30:00,1.06,1.47,1.27,275,254,297,66,29,37,50,28,22,11,4,7,+2,-3,+5,70%,59%,79%,186,161,210,28%,27%,29%,11,4,7,9,7,2
66,https://vlr.gg/player/39991/elfie,2024-07-25 05:30:00,0.88,1.60,1.25,256,210,295,60,23,37,48,29,19,19,6,13,+8,+2,+6,77%,69%,85%,171,143,197,28%,30%,27%,10,3,7,2,1,1
67,https://vlr.gg/player/36904/sampphire,2024-07-25 05:30:00,1.03,1.34,1.19,199,191,212,47,21,26,41,23,18,24,9,15,+3,+1,+2,77%,75%,79%,136,135,138,25%,24%,26%,3,1,2,0,0,0
68,https://vlr.gg/player/9183/envious,2024-07-25 05:30:00,0.82,0.89,0.86,204,183,224,45,19,26,54,27,27,28,11,17,-1,-2,+1,80%,75%,85%,120,109,130,31%,31%,30%,9,3,6,10,5,5
69,https://vlr.gg/player/18072/pigruto,2024-07-25 05:30:00,0.36,0.99,0.69,146,105,187,31,10,21,48,27,21,19,6,13,-6,-6,0,68%,53%,82%,103,77,127,18%,17%,19%,3,1,2,9,7,2
70,https://vlr.gg/player/7046/no1syboy,2024-07-25 05:05:00,0.79,1.10,0.94,179,156,203,24,9,15,30,17,13,14,6,8,-1,0,-1,63%,55%,70%,127,115,139,27%,28%,25%,4,2,2,5,2,3
71,https://vlr.gg/player/10749/k1ngkappa,2024-07-25 05:05:00,0.89,0.97,0.93,190,168,213,24,11,13,30,15,15,10,2,8,-1,-3,+2,63%,45%,80%,128,106,150,33%,31%,35%,3,0,3,4,3,1
72,https://vlr.gg/player/7049/natz,2024-07-25 05:05:00,0.51,1.26,0.88,178,119,239,28,9,19,31,18,13,8,5,3,-7,-5,-2,58%,45%,70%,111,73,149,25%,35%,20%,1,0,1,8,5,3
73,https://vlr.gg/player/9290/madelyn,2024-07-25 05:05:00,0.66,0.84,0.75,160,130,190,21,8,13,32,18,14,10,5,5,0,-1,+1,60%,45%,75%,105,89,121,24%,12%,39%,2,0,2,2,1,1
74,https://vlr.gg/player/7802/flynch,2024-07-25 05:05:00,0.30,0.80,0.53,132,107,157,16,6,10,33,19,14,5,1,4,+1,-1,+2,53%,40%,65%,94,69,118,21%,35%,15%,6,3,3,5,4,1
75,https://vlr.gg/player/9717/lilo,2024-07-25 05:05:00,1.11,1.74,1.43,314,243,384,47,17,30,26,16,10,4,3,1,+6,+2,+4,78%,70%,85%,205,160,249,34%,36%,31%,11,5,6,5,3,2
76,https://vlr.gg/player/7783/zhar,2024-07-25 05:05:00,0.96,1.72,1.34,214,154,275,31,11,20,19,13,6,13,6,7,+1,0,+1,80%,65%,95%,141,102,180,26%,22%,28%,3,2,1,2,2,0
77,https://vlr.gg/player/4872/frostmind,2024-07-25 05:05:00,1.50,0.87,1.18,208,285,132,30,21,9,22,13,9,7,3,4,+1,+1,0,80%,80%,80%,147,193,101,44%,48%,38%,2,1,1,1,0,1
78,https://vlr.gg/player/7048/budimeister,2024-07-25 05:05:00,1.06,1.29,1.17,203,179,228,32,15,17,22,12,10,10,2,8,+1,-2,+3,78%,65%,90%,125,121,129,29%,30%,28%,4,0,4,3,2,1
79,https://vlr.gg/player/7804/severine,2024-07-25 05:05:00,0.38,1.19,0.79,129,84,174,16,5,11,24,16,8,15,7,8,-1,-3,+2,70%,60%,80%,84,56,113,21%,14%,25%,4,1,3,5,4,1
80,https://vlr.gg/player/10739/shiro,2024-07-25 02:15:00,1.33,1.57,1.47,264,206,297,39,14,25,21,9,12,12,5,7,+1,-1,+2,78%,71%,83%,180,149,202,29%,28%,30%,2,0,2,1,1,0
81,https://vlr.gg/player/2348/famouz,2024-07-25 02:15:00,0.69,1.77,1.32,262,192,312,38,10,28,23,14,9,8,4,4,+3,-1,+4,76%,65%,83%,174,135,201,18%,22%,15%,9,4,5,6,5,1
82,https://vlr.gg/player/4874/berserx,2024-07-25 02:15:00,1.68,1.03,1.30,224,288,191,32,16,16,22,10,12,11,8,3,-1,-1,0,83%,94%,75%,170,222,134,15%,21%,10%,4,1,3,5,2,3
83,https://vlr.gg/player/2380/zesbeew,2024-07-25 02:15:00,0.97,1.24,1.13,207,179,217,29,11,18,25,12,13,24,12,12,0,-1,+1,78%,88%,71%,130,112,142,25%,19%,29%,4,1,3,4,2,2
84,https://vlr.gg/player/7043/ncslasher,2024-07-25 02:15:00,1.21,0.84,0.99,180,229,137,23,12,11,24,11,13,29,14,15,-2,+1,-3,78%,76%,79%,120,144,103,17%,17%,16%,2,1,1,4,0,4
85,https://vlr.gg/player/15678/reeq,2024-07-25 02:15:00,0.80,1.32,1.02,208,157,294,28,12,16,29,17,12,5,0,5,+3,+1,+2,56%,46%,71%,149,109,206,26%,38%,21%,6,1,5,3,0,3
86,https://vlr.gg/player/23709/jefz,2024-07-25 02:15:00,1.01,0.98,1.00,199,239,159,29,19,10,32,20,12,7,5,2,-1,-1,0,63%,67%,59%,139,149,124,16%,16%,17%,6,6,0,7,7,0
87,https://vlr.gg/player/10738/heynf,2024-07-25 02:15:00,0.66,1.12,0.85,159,131,211,21,9,12,33,19,14,17,8,9,-2,-4,+2,61%,58%,65%,118,101,142,23%,15%,35%,2,0,2,4,4,0
88,https://vlr.gg/player/10807/dragy,2024-07-25 02:15:00,0.87,0.74,0.82,180,175,196,26,14,12,33,20,13,10,7,3,-1,+1,-2,56%,46%,71%,117,110,127,30%,36%,24%,5,3,2,6,2,4
89,https://vlr.gg/player/4867/onigiri,2024-07-25 02:15:00,0.27,0.62,0.41,80,60,107,11,5,6,34,22,12,9,2,7,0,-1,+1,56%,46%,71%,61,45,84,28%,58%,14%,1,0,1,1,1,0
90,https://vlr.gg/player/25388/kon,2024-07-25 02:00:00,1.56,1.05,1.30,263,299,228,67,38,29,51,22,29,22,12,10,+1,+4,-3,71%,71%,71%,185,207,163,39%,41%,37%,9,7,2,8,3,5
91,https://vlr.gg/player/26069/piety,2024-07-25 02:00:00,1.20,1.05,1.13,226,221,227,52,26,26,48,22,26,19,10,9,0,0,0,73%,80%,66%,154,151,158,35%,40%,31%,3,1,2,3,1,2
92,https://vlr.gg/player/16635/poly,2024-07-25 02:00:00,0.95,0.94,0.95,177,172,184,45,22,23,48,24,24,22,12,10,-4,-3,-1,74%,77%,71%,120,119,121,30%,28%,33%,2,1,1,6,4,2
93,https://vlr.gg/player/18062/capricious,2024-07-25 02:00:00,0.81,0.91,0.86,176,143,207,43,18,25,54,25,29,23,11,12,+2,-4,+6,63%,63%,63%,113,99,127,41%,30%,51%,10,2,8,8,6,2
94,https://vlr.gg/player/45029/grahams,2024-07-25 02:00:00,0.95,0.57,0.76,175,214,139,42,27,15,54,27,27,17,8,9,-5,0,-5,66%,66%,66%,115,141,89,38%,43%,33%,8,5,3,13,5,8
95,https://vlr.gg/player/9175/kohaibi,2024-07-25 02:00:00,1.25,1.29,1.27,247,213,284,62,28,34,46,20,26,14,10,4,+5,0,+5,80%,86%,74%,164,141,188,23%,18%,28%,8,1,7,3,1,2
96,https://vlr.gg/player/16641/alluka,2024-07-25 02:00:00,1.16,0.89,1.03,173,201,145,45,26,19,44,22,22,21,14,7,0,0,0,71%,74%,69%,111,130,93,26%,23%,34%,4,3,1,4,3,1
97,https://vlr.gg/player/16018/babytz,2024-07-25 02:00:00,1.07,0.93,1.00,210,221,205,54,29,25,51,24,27,14,8,6,-2,-1,-1,66%,71%,60%,141,145,137,23%,25%,22%,6,3,3,8,4,4
98,https://vlr.gg/player/8175/ayumiii,2024-07-25 02:00:00,0.83,1.04,0.94,221,194,243,53,23,30,54,28,26,12,8,4,-1,0,-1,70%,74%,66%,143,118,168,25%,26%,25%,13,8,5,14,8,6
99,https://vlr.gg/player/17503/delbisky,2024-07-25 02:00:00,1.27,0.41,0.84,181,247,117,41,29,12,54,24,30,29,20,9,+4,+4,0,66%,71%,60%,115,152,77,31%,27%,39%,7,4,3,3,0,3
100,https://vlr.gg/player/37057/woody,2024-07-25 00:00:00,1.94,1.65,1.79,310,349,271,46,24,22,19,10,9,14,10,4,+1,-1,+2,87%,84%,90%,204,225,185,44%,40%,49%,4,1,3,3,2,1
101,https://vlr.gg/player/34096/faustao,2024-07-25 00:00:00,0.88,2.08,1.50,306,244,366,41,16,25,25,15,10,14,2,12,+7,+3,+4,85%,79%,90%,207,143,267,19%,22%,17%,11,6,5,4,3,1
102,https://vlr.gg/player/23717/nythan,2024-07-25 00:00:00,1.07,0.99,1.03,163,162,168,25,12,13,21,10,11,9,2,7,+2,0,+2,79%,74%,85%,116,126,107,43%,42%,44%,4,2,2,2,2,0
103,https://vlr.gg/player/9279/kylee,2024-07-25 00:00:00,0.92,1.07,1.00,205,197,213,29,14,15,24,12,12,8,5,3,-1,-1,0,79%,74%,85%,131,137,126,43%,40%,47%,4,1,3,5,2,3
104,https://vlr.gg/player/34100/scar,2024-07-25 00:00:00,0.99,0.85,0.92,142,138,147,19,9,10,24,11,13,19,9,10,0,0,0,74%,68%,80%,97,95,99,39%,25%,57%,1,0,1,1,0,1
105,https://vlr.gg/player/10749/k1ngkappa,2024-07-25 00:00:00,0.71,1.38,1.03,202,147,262,28,12,16,28,15,13,6,2,4,-3,-4,+1,69%,70%,68%,132,93,173,15%,20%,13%,4,1,3,7,5,2
106,https://vlr.gg/player/7049/natz,2024-07-25 00:00:00,0.97,0.95,0.96,231,228,232,30,15,15,35,18,17,12,6,6,0,-2,+2,67%,75%,58%,140,142,138,21%,23%,19%,3,1,2,3,3,0
107,https://vlr.gg/player/7802/flynch,2024-07-25 00:00:00,0.62,0.81,0.71,176,188,162,20,12,8,33,19,14,9,2,7,0,0,0,56%,45%,68%,115,118,112,20%,27%,13%,5,3,2,5,3,2
108,https://vlr.gg/player/9290/madelyn,2024-07-25 00:00:00,0.68,0.52,0.60,135,145,124,19,10,9,32,16,16,10,6,4,-4,-2,-2,64%,65%,63%,82,89,75,29%,23%,36%,2,0,2,6,2,4
109,https://vlr.gg/player/7046/no1syboy,2024-07-25 00:00:00,0.43,0.57,0.50,108,89,129,16,6,10,32,17,15,11,7,4,-2,0,-2,56%,45%,68%,66,57,76,19%,12%,26%,1,1,0,3,1,2
110,https://vlr.gg/player/29688/mikee,2024-07-24 19:45:00,1.08,0.98,1.03,219,217,220,38,20,18,33,17,16,4,3,1,-2,-1,-1,64%,63%,67%,141,133,150,34%,36%,31%,3,1,2,5,2,3
111,https://vlr.gg/player/8422/spaz,2024-07-24 19:45:00,0.87,0.84,0.85,167,166,167,24,12,12,31,16,15,12,7,5,-1,0,-1,69%,71%,67%,120,126,113,19%,22%,17%,3,2,1,4,2,2
112,https://vlr.gg/player/8373/okeanos,2024-07-24 19:45:00,0.89,0.77,0.83,212,215,209,33,19,14,38,19,19,8,1,7,+6,+4,+2,64%,58%,71%,136,136,136,28%,28%,29%,11,6,5,5,2,3
113,https://vlr.gg/player/3874/teague,2024-07-24 19:45:00,0.42,1.23,0.80,151,97,218,22,8,14,33,19,14,20,7,13,-3,-3,0,71%,67%,76%,109,66,158,28%,19%,34%,1,0,1,4,3,1
114,https://vlr.gg/player/4385/monsi,2024-07-24 19:45:00,0.68,0.86,0.77,167,143,195,27,11,16,35,18,17,17,10,7,-7,-4,-3,67%,63%,71%,97,93,103,28%,31%,26%,1,1,0,8,5,3
115,https://vlr.gg/player/5132/mada,2024-07-24 19:45:00,1.61,1.26,1.42,285,345,236,48,26,22,29,15,14,6,5,1,+8,+5,+3,73%,76%,71%,180,223,141,34%,32%,35%,12,8,4,4,3,1
116,https://vlr.gg/player/17433/v1c,2024-07-24 19:45:00,0.87,1.52,1.21,263,218,292,36,13,23,29,17,12,14,7,7,+4,0,+4,78%,71%,83%,171,158,183,38%,33%,43%,7,2,5,3,2,1
117,https://vlr.gg/player/2172/brawk,2024-07-24 19:45:00,1.07,1.32,1.20,207,206,216,35,16,19,27,15,12,10,6,4,+1,-1,+2,76%,81%,71%,141,137,145,17%,14%,20%,4,1,3,3,2,1
118,https://vlr.gg/player/1851/oderus,2024-07-24 19:45:00,1.00,0.75,0.86,157,161,157,24,12,12,30,13,17,11,3,8,-3,-1,-2,64%,62%,67%,118,115,122,33%,52%,22%,1,0,1,4,1,3
119,https://vlr.gg/player/3685/flyuh,2024-07-24 19:45:00,0.88,0.79,0.83,157,166,147,27,14,13,29,14,15,19,7,12,-3,0,-3,69%,67%,71%,102,111,94,26%,23%,29%,2,1,1,5,1,4
120,https://vlr.gg/player/42397/winter,2024-07-24 18:00:00,1.35,1.64,1.52,340,382,317,67,29,38,36,18,18,13,2,11,+7,+4,+3,80%,77%,81%,229,243,219,33%,40%,29%,16,8,8,9,4,5
121,https://vlr.gg/player/19255/luiza,2024-07-24 18:00:00,1.36,1.05,1.18,218,239,209,40,17,23,32,12,20,13,4,9,+1,0,+1,78%,73%,81%,138,155,126,27%,19%,33%,5,1,4,4,1,3
122,https://vlr.gg/player/14291/mindle,2024-07-24 18:00:00,1.27,1.03,1.13,189,232,159,37,20,17,32,14,18,23,6,17,-3,0,-3,78%,77%,78%,123,140,112,35%,47%,27%,1,1,0,4,1,3
123,https://vlr.gg/player/11256/isa1,2024-07-24 18:00:00,0.53,1.41,1.05,186,100,241,35,7,28,32,15,17,18,7,11,+1,-3,+4,78%,73%,81%,119,64,157,20%,10%,24%,5,1,4,4,4,0
124,https://vlr.gg/player/11244/gabit,2024-07-24 18:00:00,0.71,1.14,0.96,196,96,246,37,9,28,31,12,19,12,1,11,0,-1,+1,74%,55%,88%,119,62,158,20%,15%,21%,3,0,3,3,1,2
125,https://vlr.gg/player/21920/ender,2024-07-24 18:00:00,0.90,1.18,1.01,169,157,192,32,16,16,35,23,12,9,6,3,+2,+2,0,61%,56%,68%,122,111,138,25%,26%,25%,4,3,1,2,1,1
126,https://vlr.gg/player/36649/gigika,2024-07-24 18:00:00,0.82,1.08,0.93,185,178,197,33,18,15,45,29,16,15,9,6,-1,-1,0,67%,66%,68%,127,124,132,28%,30%,26%,0,0,0,1,1,0
127,https://vlr.gg/player/21935/flor,2024-07-24 18:00:00,0.93,0.69,0.83,239,257,212,44,28,16,49,29,20,8,5,3,+4,+3,+1,65%,63%,68%,144,159,122,21%,21%,20%,16,8,8,12,5,7
128,https://vlr.gg/player/3444/phobia,2024-07-24 18:00:00,0.73,0.84,0.77,163,163,178,30,18,12,44,27,17,18,12,6,-4,-5,+1,57%,59%,55%,109,100,123,30%,30%,30%,4,2,2,8,7,1
129,https://vlr.gg/player/14263/ayumi,2024-07-24 18:00:00,0.52,0.75,0.61,120,106,151,24,12,12,43,26,17,9,5,4,-7,-5,-2,54%,59%,45%,82,77,88,25%,31%,19%,0,0,0,7,5,2
130,https://vlr.gg/player/5600/moh,2024-07-24 16:15:00,1.16,1.20,1.18,238,241,227,53,27,26,48,26,22,17,7,10,0,+1,-1,74%,82%,66%,157,163,150,35%,36%,33%,5,1,4,5,0,5
131,https://vlr.gg/player/20292/akai,2024-07-24 16:15:00,1.07,1.24,1.15,227,228,242,57,28,29,48,26,22,4,2,2,-7,-8,+1,67%,62%,72%,160,148,172,28%,25%,30%,7,3,4,14,11,3
132,https://vlr.gg/player/6503/sand,2024-07-24 16:15:00,0.81,1.18,0.99,178,177,207,45,22,23,45,25,20,11,3,8,-4,-4,0,64%,59%,69%,137,127,146,35%,36%,34%,3,1,2,7,5,2
133,https://vlr.gg/player/5599/khaalid,2024-07-24 16:15:00,0.84,0.70,0.77,141,180,127,34,22,12,48,26,22,12,4,8,-1,-1,0,58%,50%,66%,108,126,88,30%,28%,32%,5,2,3,6,3,3
134,https://vlr.gg/player/1618/spyzera,2024-07-24 16:15:00,0.38,0.94,0.63,158,98,209,35,12,23,52,27,25,13,8,5,0,-4,+4,67%,59%,75%,103,62,148,41%,40%,41%,7,2,5,7,6,1
135,https://vlr.gg/player/5795/sickrey,2024-07-24 16:15:00,1.31,1.04,1.17,203,236,181,47,28,19,40,21,19,33,17,16,+2,0,+2,79%,84%,74%,138,149,127,24%,24%,24%,4,1,3,2,1,1
136,https://vlr.gg/player/1470/simond4rk,2024-07-24 16:15:00,0.76,1.49,1.14,254,194,307,55,19,36,51,27,24,19,10,9,+6,-1,+7,77%,72%,82%,173,128,216,18%,17%,19%,15,6,9,9,7,2
137,https://vlr.gg/player/1897/bgg,2024-07-24 16:15:00,1.15,1.10,1.13,185,187,189,44,21,23,39,19,20,18,12,6,+7,+1,+6,79%,84%,74%,124,119,129,27%,29%,26%,11,4,7,4,3,1
138,https://vlr.gg/player/3807/winteryrook,2024-07-24 16:15:00,0.97,0.86,0.92,193,216,166,46,26,20,47,24,23,24,11,13,-3,-2,-1,71%,66%,76%,119,132,107,34%,38%,31%,4,1,3,7,3,4
139,https://vlr.gg/player/2432/moner,2024-07-24 16:15:00,0.64,1.19,0.92,209,148,256,48,16,32,47,23,24,13,5,8,0,-2,+2,62%,50%,74%,135,98,170,31%,33%,30%,5,2,3,5,4,1
140,https://vlr.gg/player/21668/verno,2024-07-24 16:00:00,1.25,0.84,1.08,176,188,186,40,23,17,41,21,20,33,25,8,0,-2,+2,71%,77%,62%,123,126,120,24%,25%,24%,3,0,3,3,2,1
141,https://vlr.gg/player/454/dapr,2024-07-24 16:00:00,1.27,0.64,1.00,188,241,133,49,36,13,48,25,23,15,8,7,-2,+1,-3,68%,69%,66%,125,153,88,23%,25%,19%,7,5,2,9,4,5
142,https://vlr.gg/player/11118/skuba,2024-07-24 16:00:00,1.06,0.76,0.93,128,138,141,34,20,14,40,20,20,20,14,6,-3,0,-3,71%,72%,69%,86,87,85,24%,23%,25%,2,1,1,5,1,4
143,https://vlr.gg/player/612/mitch,2024-07-24 16:00:00,1.06,0.58,0.86,181,211,147,41,28,13,50,26,24,18,11,7,+1,-1,+2,69%,74%,62%,122,142,96,27%,33%,20%,7,3,4,6,4,2
144,https://vlr.gg/player/8419/reduxx,2024-07-24 16:00:00,0.76,0.91,0.82,169,184,184,42,25,17,50,29,21,8,2,6,-4,-5,+1,65%,59%,72%,115,108,125,24%,31%,16%,11,7,4,15,12,3
145,https://vlr.gg/player/3722/koalanoob,2024-07-24 16:00:00,1.56,1.17,1.34,266,285,217,61,30,31,37,13,24,9,4,5,+8,+5,+3,69%,79%,62%,145,164,131,26%,23%,29%,15,6,9,7,1,6
146,https://vlr.gg/player/6582/net,2024-07-24 16:00:00,1.17,0.97,1.06,202,219,193,49,25,24,41,16,25,17,5,12,-1,0,-1,79%,83%,77%,135,133,137,31%,30%,32%,4,2,2,5,2,3
147,https://vlr.gg/player/8082/zander,2024-07-24 16:00:00,1.11,0.95,1.02,212,211,196,48,21,27,44,15,29,31,10,21,+4,-2,+6,84%,90%,79%,135,144,129,25%,26%,23%,9,2,7,5,4,1
148,https://vlr.gg/player/4828/nismo,2024-07-24 16:00:00,1.18,0.79,0.96,179,177,168,42,18,24,44,15,29,24,13,11,-4,-2,-2,68%,83%,56%,111,116,108,41%,36%,48%,6,3,3,10,5,5
149,https://vlr.gg/player/864/bcj,2024-07-24 16:00:00,0.82,0.75,0.78,139,134,122,29,14,15,40,15,25,18,9,9,+1,0,+1,74%,76%,72%,78,77,79,13%,14%,12%,4,2,2,3,2,1
150,https://vlr.gg/player/43639/niivz,2024-07-24 16:00:00,0.91,0.83,0.86,225,251,187,26,16,10,34,22,12,7,3,4,+3,-2,+5,65%,64%,67%,151,156,144,30%,28%,35%,8,3,5,5,5,0
151,https://vlr.gg/player/21927/anninha,2024-07-24 16:00:00,0.73,1.00,0.84,215,227,162,25,16,9,30,21,9,9,2,7,+2,-1,+3,65%,55%,80%,130,140,114,20%,21%,17%,3,0,3,1,1,0
152,https://vlr.gg/player/12225/fer,2024-07-24 16:00:00,0.39,1.40,0.80,171,127,236,24,9,15,29,21,8,5,2,3,-6,-5,-1,59%,45%,80%,118,92,158,27%,23%,31%,2,1,1,8,6,2
153,https://vlr.gg/player/11247/misty,2024-07-24 16:00:00,0.43,0.98,0.65,142,115,209,19,8,11,31,20,11,13,4,9,-3,-1,-2,54%,50%,60%,94,72,127,17%,20%,15%,0,0,0,3,1,2
154,https://vlr.gg/player/11240/mittens,2024-07-24 16:00:00,0.20,1.16,0.58,123,71,230,17,4,13,30,20,10,9,3,6,-1,-3,+2,59%,36%,93%,96,50,163,31%,24%,36%,3,1,2,4,4,0
155,https://vlr.gg/player/2199/drn,2024-07-24 16:00:00,1.27,1.58,1.45,251,296,236,33,14,19,21,14,7,15,6,9,+3,0,+3,92%,93%,91%,165,182,153,24%,20%,27%,5,1,4,2,1,1
156,https://vlr.gg/player/29823/mizzy,2024-07-24 16:00:00,0.98,1.67,1.39,229,182,265,31,8,23,20,11,9,23,12,11,-1,-2,+1,86%,73%,95%,144,107,169,38%,32%,43%,3,1,2,4,3,1
157,https://vlr.gg/player/25580/jenny,2024-07-24 16:00:00,1.04,1.43,1.27,271,216,298,36,12,24,25,11,14,8,1,7,-3,-5,+2,78%,67%,86%,182,156,200,39%,50%,33%,3,0,3,6,5,1
158,https://vlr.gg/player/2245/krysme,2024-07-24 16:00:00,0.97,1.26,1.15,241,181,256,29,9,20,21,9,12,4,2,2,+5,+1,+4,65%,60%,68%,150,118,173,20%,13%,24%,6,1,5,1,0,1
159,https://vlr.gg/player/11262/kalita,2024-07-24 16:00:00,0.70,1.33,1.07,183,137,223,25,7,18,24,13,11,10,2,8,+1,-1,+2,68%,47%,82%,122,95,141,20%,24%,19%,4,1,3,3,2,1
160,https://vlr.gg/player/31305/lar0k,2024-07-24 13:30:00,1.20,1.36,1.28,224,234,221,46,23,23,38,22,16,30,15,15,0,+1,-1,73%,73%,72%,145,145,145,35%,36%,35%,5,3,2,5,2,3
161,https://vlr.gg/player/40591/comeback,2024-07-24 13:30:00,1.26,0.92,1.09,249,267,229,50,28,22,43,20,23,8,5,3,+4,-1,+5,68%,70%,66%,164,173,156,31%,30%,33%,11,4,7,7,5,2
162,https://vlr.gg/player/24344/loita,2024-07-24 13:30:00,1.07,0.94,1.01,205,217,188,43,22,21,43,22,21,20,9,11,-3,-2,-1,69%,67%,72%,139,151,127,47%,51%,43%,3,1,2,6,3,3
163,https://vlr.gg/player/31855/celasun,2024-07-24 13:30:00,0.84,0.79,0.81,160,151,169,32,17,15,45,23,22,8,3,5,-3,-1,-2,63%,67%,59%,109,107,111,30%,32%,28%,2,1,1,5,2,3
164,https://vlr.gg/player/5565/ros,2024-07-24 13:30:00,0.41,1.19,0.79,176,90,277,37,9,28,46,24,22,15,8,7,-7,-5,-2,54%,47%,62%,118,65,173,28%,29%,28%,4,2,2,11,7,4
165,https://vlr.gg/player/12795/crewen,2024-07-24 13:30:00,1.28,1.05,1.16,230,266,189,49,28,21,42,22,20,18,6,12,+10,+5,+5,73%,72%,73%,143,169,118,34%,37%,30%,10,5,5,0,0,0
166,https://vlr.gg/player/12793/xeus,2024-07-24 13:30:00,0.86,1.33,1.10,246,206,286,53,23,30,44,24,20,6,2,4,+7,+2,+5,69%,62%,77%,159,135,182,34%,34%,34%,14,5,9,7,3,4
167,https://vlr.gg/player/22676/ventt,2024-07-24 13:30:00,1.13,1.03,1.08,198,222,175,42,22,20,41,22,19,35,18,17,-3,-3,0,76%,72%,80%,135,145,125,36%,35%,36%,4,1,3,7,4,3
168,https://vlr.gg/player/12774/anima,2024-07-24 13:30:00,0.72,1.18,0.95,170,129,197,32,10,22,38,20,18,34,18,16,0,0,0,73%,72%,73%,112,91,133,25%,20%,29%,1,1,0,1,1,0
169,https://vlr.gg/player/16483/gloomy,2024-07-24 13:30:00,1.05,0.84,0.94,185,195,187,39,21,18,43,21,22,27,12,15,-5,-3,-2,66%,66%,67%,125,123,127,18%,26%,12%,5,3,2,10,6,4
170,https://vlr.gg/player/101/soulcas,2024-07-24 12:25:00,1.87,2.83,2.06,371,328,548,40,28,12,15,12,3,14,10,4,+6,+2,+4,100%,100%,100%,254,232,344,33%,31%,44%,7,3,4,1,1,0
171,https://vlr.gg/player/9554/kaajak,2024-07-24 12:25:00,1.41,1.69,1.47,311,327,248,36,30,6,20,17,3,8,7,1,0,-1,+1,83%,79%,100%,225,234,191,37%,36%,44%,4,3,1,4,4,0
172,https://vlr.gg/player/1507/avova,2024-07-24 12:25:00,1.26,1.08,1.22,201,231,84,24,21,3,17,15,2,8,7,1,-1,-1,0,77%,75%,83%,138,157,60,42%,45%,25%,1,1,0,2,2,0
173,https://vlr.gg/player/1281/molsi,2024-07-24 12:25:00,1.06,0.49,0.95,178,199,91,19,18,1,18,14,4,17,11,6,-4,-3,-1,73%,71%,83%,122,137,61,24%,29%,0%,2,2,0,6,5,1
174,https://vlr.gg/player/129/hype,2024-07-24 12:25:00,0.56,2.00,0.85,161,134,270,21,13,8,18,16,2,4,2,2,-1,-1,0,77%,71%,100%,103,88,163,28%,18%,67%,1,1,0,2,2,0
175,https://vlr.gg/player/24428/harambe,2024-07-24 12:25:00,0.65,1.09,0.99,244,154,267,25,4,21,28,6,22,4,1,3,+5,0,+5,67%,67%,67%,158,85,176,33%,67%,30%,8,1,7,3,1,2
176,https://vlr.gg/player/42371/t0ba,2024-07-24 12:25:00,0.42,0.90,0.80,203,163,214,20,3,17,28,6,22,3,0,3,-1,-1,0,57%,50%,58%,136,113,142,21%,31%,19%,3,0,3,4,1,3
177,https://vlr.gg/player/30901/ianto,2024-07-24 12:25:00,0.87,0.76,0.74,172,226,159,17,5,12,26,6,20,4,0,4,-2,-1,-1,60%,50%,63%,120,164,109,42%,40%,43%,0,0,0,2,1,1
178,https://vlr.gg/player/12372/szoren,2024-07-24 12:25:00,0.15,0.77,0.62,170,86,191,17,1,16,29,6,23,8,1,7,-2,-1,-1,63%,33%,71%,117,72,128,24%,15%,27%,2,0,2,4,1,3
179,https://vlr.gg/player/31350/deqadz,2024-07-24 12:25:00,0.29,0.45,0.39,98,63,107,9,1,8,29,6,23,13,2,11,0,-1,+1,60%,50%,63%,61,36,68,29%,20%,30%,2,0,2,2,1,1
180,https://vlr.gg/player/363/7ssk7,2024-07-24 12:00:00,1.15,1.08,1.11,191,196,185,44,25,19,49,27,22,40,18,22,+1,0,+1,76%,74%,79%,126,129,123,31%,31%,32%,3,1,2,2,1,1
181,https://vlr.gg/player/5654/avez,2024-07-24 12:00:00,1.32,0.86,1.11,221,260,189,56,35,21,53,29,24,19,9,10,+5,+4,+1,69%,71%,67%,142,161,121,28%,31%,24%,10,6,4,5,2,3
182,https://vlr.gg/player/6126/sibeastw0w,2024-07-24 12:00:00,0.91,1.31,1.09,216,201,232,53,26,27,48,29,19,16,9,7,-4,-3,-1,73%,68%,79%,139,130,148,18%,22%,15%,10,6,4,14,9,5
183,https://vlr.gg/player/172/vakk,2024-07-24 12:00:00,0.94,1.09,1.01,188,168,214,50,25,25,48,27,21,21,11,10,+9,+4,+5,70%,68%,73%,129,128,130,29%,34%,24%,10,4,6,1,0,1
184,https://vlr.gg/player/3806/xenon,2024-07-24 12:00:00,0.96,0.96,0.96,180,168,195,44,21,23,46,25,21,31,21,10,-4,-5,+1,70%,71%,70%,115,104,127,34%,25%,47%,6,2,4,10,7,3
185,https://vlr.gg/player/16885/snipkw,2024-07-24 12:00:00,1.38,1.34,1.36,264,264,262,66,31,35,48,22,26,30,12,18,+6,+3,+3,76%,76%,76%,168,176,161,28%,34%,24%,10,4,6,4,1,3
186,https://vlr.gg/player/5612/near,2024-07-24 12:00:00,1.26,0.73,0.98,172,206,145,45,26,19,42,19,23,13,4,9,-3,+1,-4,63%,64%,63%,113,128,101,23%,31%,17%,5,3,2,8,2,6
187,https://vlr.gg/player/19311/kuro,2024-07-24 12:00:00,0.57,1.12,0.87,200,140,248,48,15,33,53,24,29,22,5,17,-6,-6,0,76%,73%,79%,136,98,169,27%,31%,25%,3,0,3,9,6,3
188,https://vlr.gg/player/5609/vague,2024-07-24 12:00:00,0.63,0.94,0.80,185,158,213,48,19,29,53,25,28,8,2,6,-4,-5,+1,68%,61%,74%,126,109,142,34%,35%,33%,9,3,6,13,8,5
189,https://vlr.gg/player/5614/xelouz,2024-07-24 12:00:00,0.67,0.77,0.72,145,148,142,37,16,21,51,25,26,19,10,9,0,0,0,68%,67%,68%,85,87,84,24%,20%,29%,5,3,2,5,3,2
190,https://vlr.gg/player/23174/snowi,2024-07-24 10:00:00,0.80,1.50,1.11,240,191,282,36,17,19,37,24,13,29,12,17,-3,-2,-1,75%,67%,86%,151,122,188,24%,21%,26%,0,0,0,3,2,1
191,https://vlr.gg/player/1365/nixoon,2024-07-24 10:00:00,0.55,1.20,0.83,195,143,251,33,13,20,40,25,15,14,8,6,+3,+2,+1,63%,52%,76%,108,81,143,38%,38%,37%,5,2,3,2,0,2
192,https://vlr.gg/player/2571/feeqn,2024-07-24 10:00:00,0.79,0.83,0.81,181,191,164,26,15,11,37,23,14,12,6,6,-4,-4,0,67%,59%,76%,123,132,111,17%,20%,13%,3,1,2,7,5,2
193,https://vlr.gg/player/1620/ale,2024-07-24 10:00:00,0.77,0.76,0.76,162,196,138,29,19,10,39,25,14,7,4,3,-5,-3,-2,56%,56%,57%,108,119,94,26%,29%,19%,7,5,2,12,8,4
194,https://vlr.gg/player/23220/jesmu,2024-07-24 10:00:00,0.41,1.19,0.75,151,113,231,25,8,17,37,24,13,18,10,8,-1,-2,+1,65%,52%,81%,109,76,152,11%,6%,15%,4,1,3,5,3,2
195,https://vlr.gg/player/12519/ticey,2024-07-24 10:00:00,1.39,1.68,1.55,319,306,305,55,25,30,29,17,12,4,1,3,+8,+3,+5,79%,71%,85%,187,182,190,20%,26%,14%,13,6,7,5,3,2
196,https://vlr.gg/player/2182/hearthbeat,2024-07-24 10:00:00,0.92,1.61,1.31,243,174,272,38,11,27,30,15,15,28,16,12,-1,-2,+1,77%,71%,81%,156,108,193,29%,26%,31%,4,0,4,5,2,3
197,https://vlr.gg/player/33994/creamydreamy,2024-07-24 10:00:00,0.67,1.47,1.12,212,120,285,37,8,29,30,14,16,23,9,14,+3,0,+3,83%,81%,85%,130,69,178,30%,10%,41%,4,1,3,1,1,0
198,https://vlr.gg/player/29628/famzzam,2024-07-24 10:00:00,0.64,1.26,0.99,177,143,200,27,9,18,28,17,11,20,7,13,0,-1,+1,79%,62%,93%,121,98,138,25%,27%,25%,3,1,2,3,2,1
199,https://vlr.gg/player/16188/tempo,2024-07-24 10:00:00,1.08,0.81,0.93,185,204,174,33,16,17,32,14,18,5,1,4,0,+1,-1,69%,71%,67%,124,124,125,27%,28%,26%,5,3,2,5,2,3
200,https://vlr.gg/player/6559/destruct1vee,2024-07-24 09:30:00,0.92,1.43,1.16,211,173,251,53,23,30,43,26,17,17,10,7,0,-5,+5,69%,64%,75%,132,110,156,32%,27%,37%,9,2,7,9,7,2
201,https://vlr.gg/player/4962/lurzy0y0,2024-07-24 09:30:00,0.79,1.07,0.92,181,166,200,42,20,22,49,27,22,17,8,9,+1,-1,+2,69%,64%,75%,125,112,138,29%,44%,21%,7,3,4,6,4,2
202,https://vlr.gg/player/5517/masic,2024-07-24 09:30:00,0.78,1.08,0.92,186,155,218,47,20,27,48,28,20,13,8,5,+2,+1,+1,62%,61%,63%,126,115,138,32%,33%,31%,6,2,4,4,1,3
203,https://vlr.gg/player/10137/ip0tt,2024-07-24 09:30:00,0.90,0.86,0.88,235,235,237,54,29,25,57,31,26,16,9,7,+11,+5,+6,74%,69%,78%,149,151,147,27%,33%,21%,15,9,6,4,4,0
204,https://vlr.gg/player/7353/glovee,2024-07-24 09:30:00,0.89,0.64,0.77,158,194,123,36,24,12,52,30,22,20,8,12,-7,-2,-5,66%,69%,63%,107,129,82,23%,22%,25%,1,1,0,8,3,5
205,https://vlr.gg/player/20144/lewn,2024-07-24 09:30:00,1.45,1.07,1.25,265,317,228,60,34,26,49,23,26,23,8,15,+1,-2,+3,69%,69%,69%,178,202,156,38%,39%,36%,12,5,7,11,7,4
206,https://vlr.gg/player/5500/docent,2024-07-24 09:30:00,0.93,1.41,1.19,217,178,248,52,18,34,45,24,21,25,11,14,-2,-2,0,75%,72%,78%,153,133,170,27%,21%,33%,5,2,3,7,4,3
207,https://vlr.gg/player/10152/padisah,2024-07-24 09:30:00,0.87,1.36,1.13,217,185,247,54,20,34,46,25,21,19,9,10,-1,0,-1,81%,75%,86%,152,120,181,32%,43%,27%,1,1,0,2,1,1
208,https://vlr.gg/player/10163/cyderx,2024-07-24 09:30:00,0.95,1.10,1.03,182,137,222,45,17,28,44,21,23,18,7,11,0,-1,+1,74%,72%,75%,128,102,150,36%,54%,28%,3,0,3,3,1,2
209,https://vlr.gg/player/3549/touven,2024-07-24 09:30:00,0.67,0.79,0.73,168,160,175,37,17,20,49,25,24,14,8,6,-5,-5,0,71%,69%,72%,113,99,125,25%,25%,26%,9,3,6,14,8,6
210,https://vlr.gg/player/10739/shiro,2024-07-24 05:45:00,1.27,1.11,1.20,219,215,228,52,28,24,43,22,21,17,3,14,+7,+4,+3,75%,68%,84%,145,141,149,28%,31%,26%,9,4,5,2,0,2
211,https://vlr.gg/player/2380/zesbeew,2024-07-24 05:45:00,1.05,1.19,1.11,207,191,232,49,22,27,45,24,21,23,15,8,-1,-1,0,72%,74%,71%,135,122,149,18%,21%,16%,2,0,2,3,1,2
212,https://vlr.gg/player/2348/famouz,2024-07-24 05:45:00,0.61,1.53,1.05,220,158,294,52,18,34,47,28,19,9,5,4,-5,-7,+2,69%,62%,77%,145,106,186,21%,20%,22%,11,6,5,16,13,3
213,https://vlr.gg/player/7043/ncslasher,2024-07-24 05:45:00,0.90,0.75,0.83,166,190,144,34,20,14,48,26,22,31,17,14,-6,-3,-3,66%,65%,68%,107,111,103,25%,22%,29%,2,1,1,8,4,4
214,https://vlr.gg/player/4874/berserx,2024-07-24 05:45:00,0.66,0.82,0.74,158,123,202,29,11,18,47,24,23,21,9,12,-4,-3,-1,71%,62%,81%,114,93,137,17%,17%,17%,4,1,3,8,4,4
215,https://vlr.gg/player/4866/kushy,2024-07-24 05:45:00,1.35,1.35,1.35,263,260,268,63,32,31,43,23,20,22,6,16,+2,0,+2,78%,74%,82%,181,182,179,40%,43%,38%,8,3,5,6,3,3
216,https://vlr.gg/player/11666/ray4c,2024-07-24 05:45:00,0.95,1.25,1.11,228,224,225,48,20,28,45,26,19,21,15,6,+6,+3,+3,78%,81%,76%,140,147,134,12%,10%,14%,14,7,7,8,4,4
217,https://vlr.gg/player/7807/valdyn,2024-07-24 05:45:00,1.33,0.89,1.10,196,223,166,47,26,21,40,20,20,29,15,14,0,+1,-1,68%,71%,65%,125,148,104,35%,32%,40%,5,3,2,5,2,3
218,https://vlr.gg/player/23710/gotten,2024-07-24 05:45:00,0.96,0.99,0.98,182,184,182,40,18,22,45,23,22,33,19,14,+4,0,+4,77%,74%,79%,128,123,133,31%,33%,29%,6,1,5,2,1,1
219,https://vlr.gg/player/2346/cud,2024-07-24 05:45:00,0.39,1.21,0.82,143,91,197,32,10,22,43,25,18,19,5,14,-3,-5,+2,65%,52%,76%,100,63,134,26%,16%,34%,4,1,3,7,6,1
220,https://vlr.gg/player/8176/enerii,2024-07-24 05:00:00,1.63,1.66,1.64,328,356,325,50,30,20,24,15,9,7,5,2,-2,-1,-1,79%,77%,81%,212,211,214,29%,25%,36%,3,2,1,5,3,2
221,https://vlr.gg/player/18091/shirazi,2024-07-24 05:00:00,1.52,1.36,1.45,281,304,259,37,24,13,23,14,9,16,8,8,0,0,0,82%,77%,88%,189,191,185,16%,17%,16%,4,2,2,4,2,2
222,https://vlr.gg/player/16621/alexy,2024-07-24 05:00:00,0.93,2.00,1.38,268,219,321,36,16,20,20,16,4,12,8,4,-6,-6,0,76%,68%,88%,162,133,202,23%,18%,29%,5,2,3,11,8,3
223,https://vlr.gg/player/18093/kamiyu,2024-07-24 05:00:00,0.91,1.11,0.99,182,180,165,21,13,8,22,15,7,17,9,8,0,-1,+1,79%,82%,75%,125,127,121,42%,42%,41%,1,0,1,1,1,0
224,https://vlr.gg/player/8492/tara,2024-07-24 05:00:00,1.00,0.86,0.95,202,209,177,26,16,10,25,15,10,17,10,7,-2,-2,0,79%,82%,75%,126,141,106,26%,27%,24%,1,0,1,3,2,1
225,https://vlr.gg/player/26077/angela,2024-07-24 05:00:00,0.56,1.58,1.12,256,146,337,34,9,25,33,14,19,8,0,8,+1,-2,+3,66%,44%,82%,160,78,219,21%,17%,22%,5,1,4,4,3,1
226,https://vlr.gg/player/16634/kitkatwc,2024-07-24 05:00:00,0.78,0.67,0.72,181,205,164,23,10,13,33,14,19,8,6,2,+3,+2,+1,55%,50%,59%,117,133,105,21%,20%,21%,4,3,1,1,1,0
227,https://vlr.gg/player/16630/rosey,2024-07-24 05:00:00,0.57,0.68,0.64,139,107,157,19,5,14,32,13,19,6,4,2,-3,-3,0,53%,56%,50%,78,66,87,19%,15%,21%,2,0,2,5,3,2
228,https://vlr.gg/player/16639/izze,2024-07-24 05:00:00,0.73,0.55,0.63,145,125,164,17,7,10,34,13,21,9,1,8,+6,+2,+4,47%,44%,50%,108,90,121,27%,20%,32%,8,3,5,2,1,1
229,https://vlr.gg/player/27012/felce,2024-07-24 05:00:00,0.51,0.53,0.52,167,175,174,21,8,13,38,17,21,9,3,6,+3,+1,+2,66%,63%,68%,115,122,110,32%,36%,29%,5,1,4,2,0,2
230,https://vlr.gg/player/1916/free1ng,2024-07-24 04:00:00,1.01,0.99,1.00,205,223,193,69,43,26,68,39,29,14,4,10,+6,+3,+3,64%,62%,67%,136,146,124,35%,36%,35%,15,9,6,9,6,3
231,https://vlr.gg/player/9221/kanade,2024-07-24 04:00:00,0.60,1.45,0.96,202,170,274,71,30,41,73,47,26,9,4,5,-9,-11,+2,70%,62%,81%,147,117,185,33%,30%,38%,11,4,7,20,15,5
232,https://vlr.gg/player/17049/hermes,2024-07-24 04:00:00,0.74,1.21,0.95,175,129,250,55,21,34,64,36,28,30,12,18,-5,-4,-1,65%,52%,81%,127,90,173,24%,18%,28%,5,2,3,10,6,4
233,https://vlr.gg/player/476/exy,2024-07-24 04:00:00,1.09,0.74,0.94,158,193,130,51,33,18,67,36,31,38,22,16,-5,-2,-3,73%,69%,79%,106,121,88,38%,35%,42%,4,2,2,9,4,5
234,https://vlr.gg/player/482/intro,2024-07-24 04:00:00,0.71,0.72,0.72,142,146,153,51,28,23,74,41,33,17,8,9,-3,-2,-1,56%,54%,60%,101,97,107,29%,25%,35%,4,1,3,7,3,4
235,https://vlr.gg/player/25048/sid,2024-07-24 04:00:00,0.85,1.47,1.19,243,184,285,77,25,52,57,28,29,22,11,11,+3,0,+3,70%,64%,75%,154,119,182,29%,31%,27%,12,4,8,9,4,5
236,https://vlr.gg/player/42772/xross,2024-07-24 04:00:00,1.23,1.05,1.13,210,237,200,74,37,37,59,27,32,30,10,20,+5,+3,+2,76%,71%,79%,137,144,132,27%,30%,25%,8,4,4,3,1,2
237,https://vlr.gg/player/24979/cloy,2024-07-24 04:00:00,0.87,1.31,1.12,205,180,218,69,28,41,57,31,26,35,15,20,-2,-1,-1,76%,74%,77%,126,107,141,36%,34%,37%,4,2,2,6,3,3
238,https://vlr.gg/player/25081/yoman,2024-07-24 04:00:00,1.21,0.85,1.01,181,215,149,55,31,24,54,24,30,41,13,28,+4,+2,+2,71%,74%,69%,124,151,102,22%,27%,18%,9,4,5,5,2,3
239,https://vlr.gg/player/28401/pkm,2024-07-24 04:00:00,0.64,1.07,0.87,212,162,240,70,25,45,70,33,37,10,5,5,+6,-4,+10,70%,62%,77%,128,106,146,33%,42%,28%,22,7,15,16,11,5
240,https://vlr.gg/player/39902/ur,2024-07-24 03:30:00,1.56,1.02,1.28,253,290,206,75,44,31,56,23,33,31,16,15,+1,0,+1,71%,80%,62%,155,179,133,22%,24%,20%,7,3,4,6,3,3
241,https://vlr.gg/player/29314/moco,2024-07-24 03:30:00,1.06,1.45,1.27,215,195,248,70,29,41,53,24,29,30,10,20,-2,-3,+1,78%,73%,82%,142,124,159,28%,23%,32%,6,2,4,8,5,3
242,https://vlr.gg/player/39904/serena,2024-07-24 03:30:00,1.08,0.99,1.03,202,202,203,59,29,30,56,23,33,25,8,17,-2,0,-2,70%,71%,69%,132,127,137,27%,23%,31%,5,4,1,7,4,3
243,https://vlr.gg/player/10653/suzu,2024-07-24 03:30:00,1.09,0.95,1.02,237,249,227,66,32,34,69,31,38,27,15,12,0,-4,+4,71%,71%,71%,164,172,156,22%,21%,23%,14,5,9,14,9,5
244,https://vlr.gg/player/29316/aco,2024-07-24 03:30:00,1.03,0.52,0.76,151,163,134,43,24,19,61,23,38,32,14,18,-9,-4,-5,71%,76%,67%,95,107,84,21%,26%,17%,5,1,4,14,5,9
245,https://vlr.gg/player/37521/mint,2024-07-24 03:30:00,1.37,1.25,1.31,286,314,280,89,49,40,63,33,30,17,9,8,+8,+3,+5,72%,80%,63%,190,198,181,36%,41%,31%,23,12,11,15,9,6
246,https://vlr.gg/player/25000/yamzzi,2024-07-24 03:30:00,1.22,0.76,1.00,179,223,143,56,37,19,57,28,29,31,18,13,+6,+4,+2,70%,78%,61%,119,145,90,34%,41%,26%,8,4,4,2,0,2
247,https://vlr.gg/player/29315/romia,2024-07-24 03:30:00,0.79,1.00,0.89,181,162,207,60,27,33,63,31,32,9,6,3,-2,-5,+3,67%,64%,71%,116,107,125,31%,30%,32%,5,0,5,7,5,2
248,https://vlr.gg/player/29274/curumi,2024-07-24 03:30:00,1.14,0.56,0.86,176,216,128,47,33,14,64,31,33,42,25,17,-3,-2,-1,70%,78%,61%,112,135,86,13%,18%,7%,4,3,1,7,5,2
249,https://vlr.gg/player/29290/pingsong,2024-07-24 03:30:00,0.80,0.61,0.71,155,162,134,43,25,18,66,32,34,28,18,10,+3,+1,+2,73%,80%,66%,103,118,87,27%,27%,27%,9,4,5,6,3,3
250,https://vlr.gg/player/9290/madelyn,2024-07-24 02:20:00,1.11,1.15,1.13,220,179,262,43,19,24,38,16,22,15,7,8,-1,-3,+2,74%,83%,64%,151,127,175,29%,35%,25%,6,1,5,7,4,3
251,https://vlr.gg/player/7802/flynch,2024-07-24 02:20:00,1.01,1.21,1.11,228,211,246,46,21,25,41,19,22,8,5,3,0,0,0,68%,72%,64%,152,148,155,32%,32%,31%,9,6,3,9,6,3
252,https://vlr.gg/player/10749/k1ngkappa,2024-07-24 02:20:00,1.22,0.83,1.03,228,270,176,45,30,15,43,20,23,13,7,6,0,+1,-1,72%,79%,64%,149,175,123,35%,36%,35%,3,3,0,3,2,1
253,https://vlr.gg/player/7049/natz,2024-07-24 02:20:00,1.68,0.27,0.99,209,318,91,40,34,6,42,17,25,18,8,10,-4,-1,-3,65%,86%,43%,141,211,69,35%,40%,21%,5,2,3,9,3,6
254,https://vlr.gg/player/7046/no1syboy,2024-07-24 02:20:00,0.82,0.80,0.81,146,135,165,29,13,16,41,20,21,28,17,11,+2,+2,0,74%,90%,57%,97,88,106,22%,19%,24%,4,2,2,2,0,2
255,https://vlr.gg/player/23709/jefz,2024-07-24 02:20:00,1.62,0.91,1.26,261,309,214,51,31,20,41,16,25,11,5,6,+6,+4,+2,82%,93%,72%,167,194,141,14%,14%,14%,12,6,6,6,2,4
256,https://vlr.gg/player/10807/dragy,2024-07-24 02:20:00,1.35,0.79,1.07,218,260,179,43,26,17,41,17,24,15,8,7,+5,+4,+1,67%,75%,59%,151,180,124,27%,30%,23%,10,5,5,5,1,4
257,https://vlr.gg/player/15678/reeq,2024-07-24 02:20:00,1.07,0.93,1.00,185,194,181,38,20,18,38,16,22,15,6,9,-1,+1,-2,81%,82%,79%,122,124,120,24%,21%,27%,3,2,1,4,1,3
258,https://vlr.gg/player/10738/heynf,2024-07-24 02:20:00,1.04,0.86,0.95,174,189,156,34,19,15,41,19,22,33,15,18,-3,0,-3,81%,82%,79%,117,123,111,32%,30%,33%,2,2,0,5,2,3
259,https://vlr.gg/player/4867/onigiri,2024-07-24 02:20:00,0.78,0.89,0.83,173,157,203,39,17,22,42,18,24,12,6,6,-4,-7,+3,63%,64%,62%,119,112,126,27%,27%,28%,3,0,3,7,7,0
260,https://vlr.gg/player/4872/frostmind,2024-07-24 00:00:00,1.03,1.10,1.06,201,175,248,27,13,14,30,16,14,6,5,1,+1,+1,0,70%,71%,69%,148,145,154,29%,30%,28%,1,1,0,0,0,0
261,https://vlr.gg/player/7048/budimeister,2024-07-24 00:00:00,1.05,0.42,0.80,145,175,110,21,16,5,34,18,16,15,10,5,-5,-3,-2,68%,67%,69%,97,117,68,32%,29%,37%,1,0,1,6,3,3
262,https://vlr.gg/player/9717/lilo,2024-07-24 00:00:00,0.75,0.81,0.78,214,242,168,28,19,9,36,22,14,4,3,1,-3,-4,+1,48%,46%,50%,135,156,105,36%,41%,25%,8,6,2,11,10,1
263,https://vlr.gg/player/7783/zhar,2024-07-24 00:00:00,0.82,0.49,0.69,146,155,136,20,14,6,32,18,14,8,3,5,-4,0,-4,65%,71%,56%,92,95,88,13%,8%,22%,1,0,1,5,0,5
264,https://vlr.gg/player/7804/severine,2024-07-24 00:00:00,0.77,0.09,0.47,124,176,46,13,12,1,35,20,15,16,12,4,-5,-2,-3,55%,54%,56%,82,114,33,18%,22%,7%,1,1,0,6,3,3
265,https://vlr.gg/player/2346/cud,2024-07-24 00:00:00,1.63,1.32,1.45,268,263,270,41,16,25,20,6,14,11,8,3,+1,0,+1,80%,88%,75%,173,172,173,42%,33%,51%,5,2,3,4,2,2
266,https://vlr.gg/player/4866/kushy,2024-07-24 00:00:00,1.24,1.44,1.36,250,199,287,34,12,22,22,7,15,20,7,13,+6,+2,+4,78%,81%,75%,173,140,196,38%,44%,35%,7,2,5,1,0,1
267,https://vlr.gg/player/7807/valdyn,2024-07-24 00:00:00,1.69,0.86,1.19,199,284,149,31,18,13,20,6,14,6,2,4,+2,+2,0,85%,94%,79%,125,167,96,22%,23%,21%,6,3,3,4,1,3
268,https://vlr.gg/player/11666/ray4c,2024-07-24 00:00:00,1.00,1.19,1.12,252,228,267,33,13,20,25,9,16,7,1,6,+4,+3,+1,88%,88%,88%,160,136,176,13%,9%,15%,7,4,3,3,1,2
269,https://vlr.gg/player/23710/gotten,2024-07-24 00:00:00,1.35,0.78,1.00,185,223,151,28,14,14,22,7,15,5,1,4,+3,+1,+2,73%,81%,67%,116,138,100,32%,39%,26%,3,1,2,0,0,0
270,https://vlr.gg/player/260/corey,2024-07-23 18:30:00,1.14,0.85,1.03,198,235,152,38,27,11,38,24,14,12,8,4,-1,+1,-2,65%,64%,67%,136,153,110,32%,36%,26%,5,5,0,6,4,2
271,https://vlr.gg/player/2140/rawkus,2024-07-23 18:30:00,1.20,0.77,1.03,169,185,149,34,24,10,35,20,15,17,11,6,-2,-1,-1,74%,76%,71%,117,129,97,30%,34%,23%,2,1,1,4,2,2
272,https://vlr.gg/player/733/stellar,2024-07-23 18:30:00,0.90,0.62,0.79,159,156,171,29,17,12,41,22,19,16,8,8,0,0,0,67%,73%,57%,105,100,114,25%,24%,26%,4,2,2,4,2,2
273,https://vlr.gg/player/844/bdog,2024-07-23 18:30:00,0.76,0.70,0.73,175,176,184,30,18,12,45,27,18,20,11,9,-2,0,-2,69%,73%,62%,117,111,126,28%,35%,19%,8,7,1,10,7,3
274,https://vlr.gg/player/4931/add3r,2024-07-23 18:30:00,0.67,0.77,0.71,175,161,183,34,19,15,42,26,16,8,4,4,-5,-1,-4,67%,64%,71%,100,102,97,33%,35%,31%,3,1,2,8,2,6
275,https://vlr.gg/player/8373/okeanos,2024-07-23 18:30:00,1.85,1.03,1.35,293,403,226,59,32,27,41,14,27,15,6,9,+5,+5,0,81%,95%,73%,190,255,149,27%,25%,29%,13,8,5,8,3,5
276,https://vlr.gg/player/8422/spaz,2024-07-23 18:30:00,1.00,1.34,1.21,223,134,265,37,8,29,30,9,21,21,6,15,+5,-1,+6,85%,81%,88%,138,93,167,15%,14%,16%,7,0,7,2,1,1
277,https://vlr.gg/player/3874/teague,2024-07-23 18:30:00,1.60,0.96,1.21,185,228,157,35,18,17,29,11,18,32,19,13,0,+2,-2,80%,90%,73%,129,161,109,31%,31%,31%,2,2,0,2,0,2
278,https://vlr.gg/player/29688/mikee,2024-07-23 18:30:00,1.15,1.11,1.12,230,208,246,42,13,29,36,14,22,24,17,7,+2,+3,-1,78%,81%,76%,155,155,155,28%,20%,36%,7,4,3,5,1,4
279,https://vlr.gg/player/4385/monsi,2024-07-23 18:30:00,0.86,0.98,0.93,139,134,136,28,11,17,29,12,17,19,7,12,-2,0,-2,80%,76%,82%,93,79,101,29%,29%,28%,3,1,2,5,1,4
280,https://vlr.gg/player/9821/m4ndzin,2024-07-23 17:45:00,1.72,1.92,1.78,284,296,290,40,27,13,12,9,3,21,15,6,+2,+1,+1,89%,88%,91%,183,185,180,28%,31%,22%,4,2,2,2,1,1
281,https://vlr.gg/player/22997/waved,2024-07-23 17:45:00,1.25,2.38,1.61,393,324,493,46,26,20,23,18,5,6,4,2,+4,+1,+3,77%,75%,82%,240,210,306,31%,31%,31%,12,8,4,8,7,1
282,https://vlr.gg/player/11236/antg,2024-07-23 17:45:00,1.27,1.30,1.28,193,211,158,25,17,8,14,10,4,23,12,11,+1,0,+1,91%,92%,91%,127,140,99,37%,32%,60%,1,0,1,0,0,0
283,https://vlr.gg/player/27724/natasha,2024-07-23 17:45:00,0.90,1.50,1.09,180,149,261,24,15,9,18,13,5,9,1,8,+1,0,+1,80%,71%,100%,122,101,167,35%,30%,44%,3,2,1,2,2,0
284,https://vlr.gg/player/11242/blu,2024-07-23 17:45:00,1.10,0.94,1.05,139,161,79,16,14,2,14,11,3,17,10,7,+1,0,+1,77%,75%,82%,90,109,50,24%,37%,0%,2,1,1,1,1,0
285,https://vlr.gg/player/21920/ender,2024-07-23 17:45:00,0.37,0.94,0.76,149,112,177,19,4,15,29,10,19,4,0,4,+2,0,+2,54%,36%,63%,101,60,120,21%,20%,21%,3,0,3,1,0,1
286,https://vlr.gg/player/3444/phobia,2024-07-23 17:45:00,0.68,0.72,0.71,138,147,143,16,6,10,31,11,20,8,1,7,-2,0,-2,46%,55%,42%,102,93,106,28%,37%,23%,2,1,1,4,1,3
287,https://vlr.gg/player/14263/ayumi,2024-07-23 17:45:00,0.27,0.82,0.65,103,64,131,14,2,12,27,10,17,7,2,5,-2,-2,0,49%,36%,54%,72,48,84,35%,13%,48%,0,0,0,2,2,0
288,https://vlr.gg/player/21935/flor,2024-07-23 17:45:00,0.41,0.74,0.64,184,141,208,19,4,15,34,11,23,8,2,6,-5,-2,-3,60%,55%,63%,124,92,139,23%,18%,25%,5,1,4,10,3,7
289,https://vlr.gg/player/36649/gigika,2024-07-23 17:45:00,0.45,0.62,0.55,118,114,130,13,4,9,30,10,20,10,2,8,-2,-3,+1,49%,36%,54%,86,75,91,26%,16%,32%,3,0,3,5,3,2
290,https://vlr.gg/player/5132/mada,2024-07-23 16:00:00,1.81,1.38,1.59,319,351,285,44,25,19,24,11,13,13,6,7,+9,+4,+5,80%,80%,81%,199,222,177,27%,31%,23%,11,4,7,2,0,2
291,https://vlr.gg/player/17433/v1c,2024-07-23 16:00:00,1.38,1.43,1.40,213,207,220,36,17,19,21,10,11,13,5,8,+2,+1,+1,76%,80%,71%,142,139,144,29%,27%,30%,3,1,2,1,0,1
292,https://vlr.gg/player/2172/brawk,2024-07-23 16:00:00,1.11,1.46,1.29,199,201,197,32,17,15,23,14,9,20,6,14,0,-1,+1,76%,75%,76%,130,136,124,28%,26%,30%,2,1,1,2,2,0
293,https://vlr.gg/player/1851/oderus,2024-07-23 16:00:00,1.14,0.79,0.96,163,195,135,26,15,11,26,12,14,7,4,3,+3,+5,-2,73%,75%,71%,100,109,91,43%,38%,50%,7,7,0,4,2,2
294,https://vlr.gg/player/3685/flyuh,2024-07-23 16:00:00,0.90,0.90,0.90,168,142,193,20,8,12,25,10,15,20,12,8,-3,-3,0,78%,80%,76%,118,103,132,23%,25%,22%,3,0,3,6,3,3
295,https://vlr.gg/player/2164/paincakes,2024-07-23 16:00:00,0.48,1.30,0.88,180,103,266,26,7,19,31,16,15,9,6,3,-1,-1,0,68%,62%,75%,130,75,188,46%,39%,50%,3,1,2,4,2,2
296,https://vlr.gg/player/8375/bones,2024-07-23 16:00:00,0.84,0.91,0.87,213,200,225,27,13,14,34,17,17,10,6,4,+2,0,+2,73%,76%,70%,144,135,153,30%,24%,37%,6,2,4,4,2,2
297,https://vlr.gg/player/818/mummay,2024-07-23 16:00:00,1.29,0.29,0.80,163,242,80,23,19,4,28,12,16,13,5,8,-7,-2,-5,66%,67%,65%,107,155,57,19%,18%,20%,1,1,0,8,3,5
298,https://vlr.gg/player/2139/neptune,2024-07-23 16:00:00,0.97,0.60,0.79,153,179,128,22,14,8,31,15,16,16,6,10,-3,0,-3,61%,62%,60%,100,115,83,21%,27%,16%,1,1,0,4,1,3
299,https://vlr.gg/player/3687/jonaaa6,2024-07-23 16:00:00,0.52,0.59,0.55,154,138,170,21,9,12,34,16,18,4,3,1,-2,-2,0,56%,48%,65%,100,84,117,20%,20%,20%,4,3,1,6,5,1
300,https://vlr.gg/player/21435/jelly,2024-07-23 16:00:00,1.63,1.32,1.47,258,293,225,33,18,15,19,9,10,14,5,9,+1,+1,0,83%,94%,74%,172,177,168,24%,16%,35%,2,1,1,1,0,1
301,https://vlr.gg/player/14685/jubs,2024-07-23 16:00:00,1.40,1.50,1.46,244,235,251,33,14,19,15,7,8,5,1,4,+3,0,+3,78%,76%,79%,152,142,162,23%,26%,22%,4,1,3,1,1,0
302,https://vlr.gg/player/11239/sayuri,2024-07-23 16:00:00,1.41,1.39,1.40,214,189,232,27,12,15,16,6,10,12,3,9,+5,+3,+2,86%,82%,89%,148,128,166,19%,21%,18%,5,3,2,0,0,0
303,https://vlr.gg/player/19791/mel,2024-07-23 16:00:00,1.40,1.11,1.24,200,219,183,30,15,15,14,6,8,10,7,3,0,0,0,86%,88%,84%,125,145,107,24%,30%,16%,1,0,1,1,0,1
304,https://vlr.gg/player/31574/srn,2024-07-23 16:00:00,0.62,1.33,0.99,247,185,305,29,10,19,26,13,13,9,1,8,+1,-1,+2,89%,88%,89%,164,124,201,23%,26%,21%,11,5,6,10,6,4
305,https://vlr.gg/player/11256/isa1,2024-07-23 16:00:00,0.99,0.63,0.82,165,198,126,20,12,8,29,17,12,9,8,1,+1,+1,0,64%,63%,65%,108,120,95,22%,20%,24%,1,1,0,0,0,0
306,https://vlr.gg/player/19255/luiza,2024-07-23 16:00:00,0.96,0.59,0.79,190,225,153,23,14,9,31,17,14,4,2,2,-1,+1,-2,58%,63%,53%,124,148,98,37%,43%,30%,3,2,1,4,1,3
307,https://vlr.gg/player/11244/gabit,2024-07-23 16:00:00,0.85,0.51,0.69,146,154,141,18,10,8,28,14,14,7,4,3,-4,-2,-2,64%,58%,71%,89,99,79,27%,38%,17%,1,0,1,5,2,3
308,https://vlr.gg/player/14291/mindle,2024-07-23 16:00:00,0.38,0.54,0.46,116,101,132,14,7,7,32,17,15,9,5,4,-3,-3,0,50%,42%,59%,74,59,90,24%,21%,27%,2,1,1,5,4,1
309,https://vlr.gg/player/42397/winter,2024-07-23 16:00:00,0.22,0.59,0.38,136,109,166,15,6,9,32,18,14,5,2,3,-3,-4,+1,44%,37%,53%,91,75,109,28%,24%,33%,6,2,4,9,6,3
310,https://vlr.gg/player/1470/simond4rk,2024-07-23 14:30:00,1.49,1.29,1.40,318,331,291,45,25,20,30,15,15,9,5,4,+4,+1,+3,75%,71%,79%,199,209,189,20%,20%,19%,10,5,5,6,4,2
311,https://vlr.gg/player/1897/bgg,2024-07-23 14:30:00,0.84,1.69,1.24,201,136,278,29,10,19,22,13,9,12,8,4,-1,-2,+1,78%,71%,84%,141,87,202,34%,43%,32%,4,2,2,5,4,1
312,https://vlr.gg/player/5795/sickrey,2024-07-23 14:30:00,1.12,1.25,1.18,204,196,216,29,15,14,22,10,12,16,8,8,-3,-2,-1,78%,81%,74%,139,127,151,37%,40%,34%,0,0,0,3,2,1
313,https://vlr.gg/player/2432/moner,2024-07-23 14:30:00,1.36,0.93,1.15,187,180,196,29,15,14,23,9,14,4,2,2,+1,-2,+3,78%,81%,74%,140,136,143,31%,31%,30%,3,0,3,2,2,0
314,https://vlr.gg/player/3807/winteryrook,2024-07-23 14:30:00,1.42,0.63,1.04,206,270,139,31,21,10,26,11,15,21,11,10,-5,0,-5,73%,76%,68%,145,183,104,43%,45%,38%,1,1,0,6,1,5
315,https://vlr.gg/player/5609/vague,2024-07-23 14:30:00,1.39,1.13,1.25,281,328,250,39,21,18,32,15,17,5,2,3,+7,+3,+4,75%,79%,71%,177,205,151,36%,36%,34%,13,6,7,6,3,3
316,https://vlr.gg/player/5612/near,2024-07-23 14:30:00,1.09,0.66,0.86,167,197,142,23,15,8,30,13,17,14,5,9,-6,-3,-3,65%,68%,62%,111,125,99,22%,17%,27%,0,0,0,6,3,3
317,https://vlr.gg/player/5614/xelouz,2024-07-23 14:30:00,0.53,0.99,0.77,138,104,169,21,7,14,31,15,16,8,3,5,+1,-1,+2,63%,63%,62%,100,86,113,23%,27%,21%,2,0,2,1,1,0
318,https://vlr.gg/player/19311/kuro,2024-07-23 14:30:00,0.81,0.61,0.67,170,188,151,23,13,10,35,16,19,5,3,2,+1,0,+1,53%,63%,43%,115,127,104,25%,27%,23%,4,1,3,3,1,2
319,https://vlr.gg/player/16885/snipkw,2024-07-23 14:30:00,0.52,0.50,0.51,144,167,119,17,9,8,35,18,17,13,9,4,+1,0,+1,63%,74%,52%,95,103,88,21%,16%,31%,3,2,1,2,2,0
320,https://vlr.gg/player/6994/shyz,2024-07-23 14:00:00,1.32,1.32,1.32,206,167,232,27,9,18,21,6,15,24,9,15,+1,0,+1,73%,71%,75%,142,111,164,25%,16%,31%,3,1,2,2,1,1
321,https://vlr.gg/player/14690/lissa,2024-07-23 14:00:00,1.28,1.29,1.28,228,238,220,36,15,21,25,10,15,13,7,6,-3,0,-3,71%,82%,63%,144,152,138,39%,50%,32%,1,1,0,4,1,3
322,https://vlr.gg/player/24764/akame,2024-07-23 14:00:00,1.57,0.93,1.20,258,321,226,41,22,19,30,13,17,12,6,6,0,0,0,73%,76%,71%,168,212,136,22%,41%,12%,5,1,4,5,1,4
323,https://vlr.gg/player/24763/speedy,2024-07-23 14:00:00,0.76,1.35,1.10,209,166,240,31,9,22,26,12,14,16,10,6,-5,-3,-2,78%,76%,79%,146,100,178,30%,10%,41%,2,1,1,7,4,3
324,https://vlr.gg/player/29179/vii,2024-07-23 14:00:00,1.05,0.94,0.99,204,217,195,29,14,15,30,12,18,8,4,4,+6,+4,+2,68%,76%,63%,134,136,133,27%,35%,22%,9,5,4,3,1,2
325,https://vlr.gg/player/29823/mizzy,2024-07-23 14:00:00,1.31,0.91,1.15,236,272,184,35,23,12,31,18,13,12,8,4,+3,+2,+1,71%,75%,65%,157,176,129,35%,35%,35%,4,2,2,1,0,1
326,https://vlr.gg/player/2199/drn,2024-07-23 14:00:00,1.19,1.03,1.12,220,249,185,31,20,11,30,17,13,17,11,6,+2,0,+2,71%,75%,65%,139,164,105,34%,35%,31%,7,4,3,5,4,1
327,https://vlr.gg/player/25580/jenny,2024-07-23 14:00:00,0.79,0.85,0.81,215,180,256,29,15,14,33,19,14,6,4,2,-2,-1,-1,63%,67%,59%,133,118,153,29%,26%,32%,5,4,1,7,5,2
328,https://vlr.gg/player/2245/krysme,2024-07-23 14:00:00,0.75,0.47,0.64,154,179,120,22,15,7,33,18,15,3,0,3,-1,0,-1,59%,58%,59%,108,124,85,18%,19%,17%,3,2,1,4,2,2
329,https://vlr.gg/player/11262/kalita,2024-07-23 14:00:00,0.26,0.74,0.46,123,98,160,15,6,9,37,23,14,10,5,5,-1,+1,-2,63%,54%,76%,82,68,102,13%,13%,13%,2,1,1,3,0,3
330,https://vlr.gg/player/18677/ruxic,2024-07-23 13:10:00,1.19,1.11,1.15,242,240,248,55,26,29,48,22,26,20,12,8,+2,+2,0,81%,87%,76%,170,178,162,29%,24%,35%,10,5,5,8,3,5
331,https://vlr.gg/player/568/turko,2024-07-23 13:10:00,1.28,0.84,1.05,202,217,183,48,26,22,41,16,25,5,2,3,+3,0,+3,64%,65%,64%,134,160,110,34%,43%,25%,7,4,3,4,4,0
332,https://vlr.gg/player/4893/lauress,2024-07-23 13:10:00,1.65,0.42,1.01,213,332,105,18,14,4,16,6,10,5,2,3,-2,+1,-3,74%,91%,58%,152,234,77,38%,52%,8%,1,1,0,3,0,3
333,https://vlr.gg/player/12651/w0zzip,2024-07-23 13:10:00,1.21,0.72,0.95,188,204,172,41,23,18,45,18,27,30,19,11,+3,+3,0,73%,77%,70%,126,135,117,23%,24%,22%,5,3,2,2,0,2
334,https://vlr.gg/player/5568/sociablee,2024-07-23 13:10:00,0.78,0.96,0.87,185,146,227,41,16,25,46,19,27,19,8,11,+3,+1,+2,72%,74%,70%,129,101,155,31%,37%,27%,8,2,6,5,1,4
335,https://vlr.gg/player/4890/l7,2024-07-23 13:10:00,0.47,0.52,0.49,142,151,134,20,11,9,36,18,18,6,2,4,-3,0,-3,56%,55%,57%,96,97,95,26%,18%,38%,4,4,0,7,4,3
336,https://vlr.gg/player/20144/lewn,2024-07-23 13:10:00,2.01,1.03,1.53,308,393,221,70,48,22,44,19,25,17,10,7,+2,+2,0,70%,79%,61%,192,241,140,31%,28%,36%,14,8,6,12,6,6
337,https://vlr.gg/player/10152/padisah,2024-07-23 13:10:00,1.46,0.60,1.04,228,300,151,52,37,15,46,22,24,10,3,7,0,+2,-2,73%,85%,61%,146,193,97,41%,48%,31%,7,5,2,7,3,4
338,https://vlr.gg/player/3549/touven,2024-07-23 13:10:00,1.03,0.89,0.96,195,208,180,43,25,18,46,23,23,12,7,5,-5,0,-5,64%,73%,55%,136,146,126,31%,28%,37%,4,3,1,9,3,6
339,https://vlr.gg/player/5500/docent,2024-07-23 13:10:00,0.82,1.00,0.91,155,131,177,39,17,22,45,22,23,17,10,7,-2,-2,0,67%,67%,68%,94,82,107,26%,15%,40%,3,1,2,5,3,2
340,https://vlr.gg/player/10163/cyderx,2024-07-23 13:10:00,0.48,1.13,0.80,133,60,211,28,6,22,42,21,21,18,9,9,-1,-1,0,69%,58%,81%,98,47,152,26%,15%,31%,1,0,1,2,1,1
341,https://vlr.gg/player/10338/lime,2024-07-23 12:00:00,1.54,0.90,1.24,235,278,184,59,39,20,48,21,27,10,7,3,+4,+6,-2,70%,78%,61%,151,172,128,27%,30%,24%,8,8,0,4,2,2
342,https://vlr.gg/player/12519/ticey,2024-07-23 12:00:00,1.33,0.82,1.09,240,290,194,58,36,22,53,27,26,14,13,1,+7,+6,+1,71%,84%,58%,158,194,118,19%,24%,10%,18,10,8,11,4,7
343,https://vlr.gg/player/33994/creamydreamy,2024-07-23 12:00:00,1.16,0.69,0.94,171,212,132,44,31,13,50,23,27,35,15,20,-2,+2,-4,79%,86%,70%,108,137,76,51%,52%,48%,2,2,0,4,0,4
344,https://vlr.gg/player/29628/famzzam,2024-07-23 12:00:00,0.77,0.76,0.77,169,155,179,39,21,18,57,27,30,26,13,13,0,-2,+2,69%,78%,58%,106,102,111,27%,30%,24%,6,2,4,6,4,2
345,https://vlr.gg/player/2182/hearthbeat,2024-07-23 12:00:00,0.95,0.41,0.70,128,158,102,31,22,9,53,23,30,26,16,10,+3,+1,+2,66%,84%,45%,86,100,70,22%,33%,11%,7,3,4,4,2,2
346,https://vlr.gg/player/24428/harambe,2024-07-23 12:00:00,1.62,1.02,1.30,261,304,220,65,37,28,43,13,30,14,7,7,0,+1,-1,67%,79%,57%,176,205,150,21%,21%,21%,9,6,3,9,5,4
347,https://vlr.gg/player/12372/szoren,2024-07-23 12:00:00,1.21,1.08,1.14,228,218,231,59,27,32,46,17,29,14,8,6,-4,-1,-3,70%,76%,65%,150,146,153,38%,32%,46%,5,3,2,9,4,5
348,https://vlr.gg/player/30901/ianto,2024-07-23 12:00:00,1.34,0.91,1.11,206,213,201,48,26,22,44,15,29,30,14,16,-2,0,-2,84%,85%,84%,134,135,133,24%,31%,19%,2,1,1,4,1,3
349,https://vlr.gg/player/31350/deqadz,2024-07-23 12:00:00,1.05,0.82,0.93,195,198,192,46,24,22,51,19,32,28,9,19,-1,+1,-2,77%,79%,76%,123,122,124,23%,25%,22%,9,5,4,10,4,6
350,https://vlr.gg/player/42371/t0ba,2024-07-23 12:00:00,1.19,0.64,0.90,179,229,142,43,26,17,47,18,29,24,12,12,-5,0,-5,71%,76%,68%,125,157,95,24%,27%,21%,4,2,2,9,2,7
351,https://vlr.gg/player/5600/moh,2024-07-23 12:00:00,1.43,1.13,1.26,213,264,188,37,19,18,26,12,14,12,7,5,+3,+1,+2,79%,89%,71%,143,182,113,36%,36%,36%,6,2,4,3,1,2
352,https://vlr.gg/player/20292/akai,2024-07-23 12:00:00,1.29,1.03,1.15,270,297,232,39,20,19,34,15,19,10,5,5,0,0,0,70%,74%,67%,171,201,147,26%,26%,25%,6,3,3,6,3,3
353,https://vlr.gg/player/5599/khaalid,2024-07-23 12:00:00,0.95,1.26,1.12,210,160,255,31,12,19,26,10,16,11,5,6,-3,-1,-2,67%,79%,58%,143,119,162,32%,30%,33%,1,0,1,4,1,3
354,https://vlr.gg/player/6503/sand,2024-07-23 12:00:00,1.30,0.85,1.05,161,187,137,27,15,12,23,9,14,8,6,2,-1,0,-1,70%,79%,63%,106,113,99,33%,31%,34%,1,1,0,2,1,1
355,https://vlr.gg/player/1618/spyzera,2024-07-23 12:00:00,1.25,0.70,0.94,185,210,167,27,14,13,30,11,19,19,9,10,0,+1,-1,65%,74%,58%,129,147,115,23%,31%,18%,7,4,3,7,3,4
356,https://vlr.gg/player/363/7ssk7,2024-07-23 12:00:00,1.55,0.59,1.13,189,230,144,29,19,10,29,12,17,23,17,6,+3,+4,-1,79%,88%,68%,121,139,97,46%,45%,48%,4,4,0,1,0,1
357,https://vlr.gg/player/5654/avez,2024-07-23 12:00:00,0.79,1.16,0.96,199,151,276,32,14,18,31,16,15,2,1,1,+2,0,+2,67%,54%,84%,138,114,170,37%,47%,31%,5,2,3,3,2,1
358,https://vlr.gg/player/6126/sibeastw0w,2024-07-23 12:00:00,0.89,0.88,0.88,215,225,199,29,17,12,34,18,16,8,5,3,-1,0,-1,67%,75%,58%,139,147,129,18%,19%,18%,8,5,3,9,5,4
359,https://vlr.gg/player/172/vakk,2024-07-23 12:00:00,0.99,0.55,0.79,165,189,139,24,16,8,33,18,15,11,7,4,+2,0,+2,72%,75%,68%,116,129,99,35%,34%,38%,4,1,3,2,1,1
360,https://vlr.gg/player/3806/xenon,2024-07-23 12:00:00,0.88,0.43,0.68,161,196,111,25,16,9,35,18,17,12,9,3,-5,-2,-3,65%,67%,63%,95,117,66,47%,53%,37%,1,1,0,6,3,3
361,https://vlr.gg/player/1507/avova,2024-07-23 10:00:00,1.62,1.74,1.67,280,253,283,32,17,15,13,7,6,15,12,3,+4,+2,+2,88%,100%,71%,162,162,163,44%,46%,42%,6,3,3,2,1,1
362,https://vlr.gg/player/9554/kaajak,2024-07-23 10:00:00,1.22,1.47,1.32,235,217,293,33,17,16,21,11,10,3,2,1,+1,-1,+2,85%,80%,93%,164,143,194,33%,36%,28%,5,3,2,4,4,0
363,https://vlr.gg/player/101/soulcas,2024-07-23 10:00:00,1.51,0.85,1.24,190,220,139,25,18,7,14,7,7,9,6,3,+1,0,+1,76%,90%,57%,119,140,90,39%,41%,35%,2,1,1,1,1,0
364,https://vlr.gg/player/1281/molsi,2024-07-23 10:00:00,1.48,0.59,1.11,217,240,162,24,17,7,20,8,12,23,16,7,-1,0,-1,79%,90%,64%,136,154,111,26%,25%,26%,0,0,0,1,0,1
365,https://vlr.gg/player/129/hype,2024-07-23 10:00:00,1.05,0.79,0.91,179,184,190,23,14,9,20,9,11,4,4,0,-3,-1,-2,65%,75%,50%,125,129,120,35%,36%,33%,5,3,2,8,4,4
366,https://vlr.gg/player/1365/nixoon,2024-07-23 10:00:00,1.15,0.48,0.75,166,237,131,22,13,9,29,11,18,5,3,2,+2,+1,+1,65%,79%,55%,102,135,80,30%,26%,36%,4,2,2,2,1,1
367,https://vlr.gg/player/23174/snowi,2024-07-23 10:00:00,1.12,0.50,0.75,139,214,111,16,10,6,26,10,16,12,4,8,+1,+1,0,62%,64%,60%,99,137,72,18%,13%,27%,2,1,1,1,0,1
368,https://vlr.gg/player/2571/feeqn,2024-07-23 10:00:00,1.07,0.52,0.74,149,183,129,18,9,9,25,9,16,3,2,1,-1,-1,0,62%,64%,60%,97,116,83,17%,18%,17%,0,0,0,1,1,0
369,https://vlr.gg/player/1620/ale,2024-07-23 10:00:00,0.81,0.71,0.73,169,177,176,21,9,12,27,11,16,2,1,1,-1,-2,+1,50%,43%,55%,122,141,109,28%,38%,19%,6,2,4,7,4,3
370,https://vlr.gg/player/23220/jesmu,2024-07-23 10:00:00,0.31,0.36,0.34,122,106,124,11,5,6,30,13,17,6,2,4,-3,-1,-2,53%,43%,60%,86,84,88,24%,31%,21%,4,1,3,7,2,5
371,https://vlr.gg/player/10160/izzy,2024-07-23 09:30:00,1.34,1.30,1.32,286,272,306,66,32,34,45,21,24,13,10,3,+8,+6,+2,73%,79%,68%,176,175,177,29%,22%,39%,17,9,8,9,3,6
372,https://vlr.gg/player/3557/skylen,2024-07-23 09:30:00,1.32,0.82,1.07,214,242,179,48,31,17,44,21,23,17,10,7,+1,+3,-2,73%,82%,65%,140,154,125,37%,36%,39%,4,3,1,3,0,3
373,https://vlr.gg/player/40935/umu7,2024-07-23 09:30:00,1.22,0.79,1.01,186,217,153,42,26,16,43,18,25,12,5,7,+1,0,+1,70%,82%,58%,119,139,99,28%,26%,30%,6,3,3,5,3,2
374,https://vlr.gg/player/1399/sterben,2024-07-23 09:30:00,0.72,0.86,0.79,145,135,159,33,16,17,42,22,20,18,10,8,-7,-4,-3,72%,79%,65%,100,88,112,40%,38%,42%,1,1,0,8,5,3
375,https://vlr.gg/player/556/souhcni,2024-07-23 09:30:00,0.57,0.43,0.50,117,123,104,22,13,9,47,23,24,12,6,6,-7,-6,-1,58%,64%,52%,77,83,70,20%,19%,21%,2,0,2,9,6,3
376,https://vlr.gg/player/10137/ip0tt,2024-07-23 09:30:00,1.63,1.37,1.50,308,337,288,73,41,32,44,19,25,11,2,9,0,+1,-1,73%,68%,79%,202,207,198,31%,37%,24%,13,7,6,13,6,7
377,https://vlr.gg/player/4962/lurzy0y0,2024-07-23 09:30:00,1.21,1.22,1.21,222,218,232,51,23,28,42,19,23,13,5,8,+4,+1,+3,77%,74%,79%,162,160,164,31%,29%,33%,7,3,4,3,2,1
378,https://vlr.gg/player/5517/masic,2024-07-23 09:30:00,0.98,0.83,0.90,155,154,151,33,17,16,39,16,23,23,10,13,0,+1,-1,72%,84%,61%,106,105,106,23%,30%,18%,4,2,2,4,1,3
379,https://vlr.gg/player/6559/destruct1vee,2024-07-23 09:30:00,0.98,0.75,0.86,168,190,147,36,20,16,42,19,23,17,8,9,-1,-1,0,70%,71%,70%,115,128,103,26%,25%,27%,6,3,3,7,4,3
380,https://vlr.gg/player/7353/glovee,2024-07-23 09:30:00,0.79,0.60,0.69,129,132,133,28,15,13,44,20,24,22,12,10,+1,+1,0,70%,77%,64%,85,76,92,23%,24%,22%,4,2,2,3,1,2
381,https://vlr.gg/player/8175/ayumiii,2024-07-23 07:45:00,2.10,1.28,1.52,336,379,309,40,14,26,21,4,17,14,5,9,+8,+4,+4,85%,100%,79%,215,237,206,33%,33%,33%,8,4,4,0,0,0
382,https://vlr.gg/player/16641/alluka,2024-07-23 07:45:00,1.72,1.33,1.44,238,253,236,29,9,20,15,2,13,22,5,17,0,0,0,85%,90%,83%,163,166,162,25%,37%,21%,2,1,1,2,1,1
383,https://vlr.gg/player/9175/kohaibi,2024-07-23 07:45:00,1.31,1.50,1.44,233,179,255,30,7,23,17,4,13,12,5,7,+2,0,+2,88%,100%,83%,157,115,175,32%,30%,32%,3,1,2,1,1,0
384,https://vlr.gg/player/16018/babytz,2024-07-23 07:45:00,1.83,0.94,1.20,227,266,210,25,10,15,22,4,18,21,9,12,+5,+2,+3,82%,100%,75%,139,167,128,25%,29%,22%,7,2,5,2,0,2
385,https://vlr.gg/player/17503/delbisky,2024-07-23 07:45:00,1.79,0.96,1.20,204,245,192,26,10,16,19,3,16,9,2,7,+1,0,+1,82%,90%,79%,143,170,132,34%,53%,26%,5,0,5,4,0,4
386,https://vlr.gg/player/39405/shirah0sh1,2024-07-23 07:45:00,1.08,0.55,0.93,224,236,193,26,21,5,31,21,10,6,3,3,-5,-3,-2,62%,63%,60%,138,144,123,34%,38%,27%,3,2,1,8,5,3
387,https://vlr.gg/player/17609/makchin,2024-07-23 07:45:00,0.92,0.51,0.80,198,214,163,23,17,6,30,20,10,5,4,1,-6,-4,-2,65%,67%,60%,135,146,109,27%,24%,37%,3,2,1,9,6,3
388,https://vlr.gg/player/46884/kathrina,2024-07-23 07:45:00,0.78,0.18,0.60,127,149,71,14,12,2,29,19,10,11,8,3,-3,-2,-1,53%,54%,50%,81,96,45,6%,5%,8%,1,1,0,4,3,1
389,https://vlr.gg/player/46798/syd89,2024-07-23 07:45:00,0.84,0.04,0.60,133,163,61,14,12,2,29,19,10,14,13,1,-1,-1,0,56%,67%,30%,91,116,30,43%,44%,25%,0,0,0,1,1,0
390,https://vlr.gg/player/40294/arki,2024-07-23 07:45:00,0.78,0.14,0.59,150,186,72,17,15,2,31,21,10,7,6,1,-1,0,-1,65%,75%,40%,101,117,64,39%,38%,44%,2,2,0,3,2,1
391,https://vlr.gg/player/24737/par-scofield,2024-07-23 05:30:00,1.03,1.20,1.12,240,205,274,53,23,30,51,24,27,14,5,9,+4,+2,+2,67%,67%,68%,158,124,187,26%,23%,28%,13,7,6,9,5,4
392,https://vlr.gg/player/44246/repulsive,2024-07-23 05:30:00,0.86,1.20,1.04,173,134,203,38,13,25,44,23,21,26,16,10,-6,-2,-4,66%,63%,68%,112,86,136,34%,20%,44%,0,0,0,6,2,4
393,https://vlr.gg/player/33801/loydream,2024-07-23 05:30:00,0.83,0.96,0.90,210,179,236,48,18,30,50,24,26,12,10,2,0,-5,+5,72%,70%,74%,133,126,139,17%,13%,20%,7,1,6,7,6,1
394,https://vlr.gg/player/21793/syko,2024-07-23 05:30:00,0.67,1.02,0.86,158,137,187,38,15,23,47,25,22,15,7,8,+2,-1,+3,73%,70%,76%,109,99,118,41%,33%,48%,6,0,6,4,1,3
395,https://vlr.gg/player/26143/secondlove,2024-07-23 05:30:00,0.94,0.57,0.74,162,210,122,33,20,13,51,25,26,15,9,6,-2,-2,0,61%,67%,56%,122,151,96,24%,27%,20%,5,3,2,7,5,2
396,https://vlr.gg/player/13744/patmen,2024-07-23 05:30:00,1.23,1.36,1.29,240,249,227,55,30,25,39,24,15,28,16,12,+3,-1,+4,88%,85%,90%,151,154,148,32%,43%,24%,6,2,4,3,3,0
397,https://vlr.gg/player/16953/zynd,2024-07-23 05:30:00,1.26,1.26,1.26,238,232,249,56,28,28,41,24,17,13,7,6,+8,+1,+7,77%,76%,77%,156,154,158,21%,21%,22%,13,5,8,5,4,1
398,https://vlr.gg/player/9737/kakarot,2024-07-23 05:30:00,0.79,1.29,1.02,226,187,268,50,22,28,46,26,20,20,10,10,-3,-3,0,70%,59%,83%,147,126,172,24%,20%,27%,9,5,4,12,8,4
399,https://vlr.gg/player/21677/jeee,2024-07-23 05:30:00,0.94,0.99,0.96,196,192,192,46,25,21,44,26,18,21,11,10,-5,-1,-4,70%,68%,73%,122,135,108,30%,30%,30%,2,1,1,7,2,5
400,https://vlr.gg/player/7746/kevzii,2024-07-23 05:30:00,0.93,0.90,0.92,171,166,180,36,17,19,40,21,19,21,12,9,-1,-2,+1,73%,74%,73%,126,121,133,28%,29%,27%,3,1,2,4,3,1
401,https://vlr.gg/player/25388/kon,2024-07-23 05:00:00,1.42,1.62,1.52,258,263,254,36,18,18,16,10,6,9,4,5,+3,-1,+4,82%,89%,74%,181,184,177,33%,46%,25%,5,0,5,2,1,1
402,https://vlr.gg/player/26069/piety,2024-07-23 05:00:00,1.64,1.27,1.46,258,264,252,37,20,17,20,9,11,8,3,5,+3,0,+3,84%,89%,79%,172,179,164,29%,44%,17%,3,0,3,0,0,0
403,https://vlr.gg/player/18062/capricious,2024-07-23 05:00:00,1.26,1.61,1.43,276,247,305,40,16,24,20,12,8,3,3,0,0,-1,+1,79%,74%,84%,163,145,181,52%,62%,41%,7,4,3,7,5,2
404,https://vlr.gg/player/45029/grahams,2024-07-23 05:00:00,1.05,1.34,1.20,218,197,239,28,13,15,21,12,9,14,3,11,0,-1,+1,79%,63%,95%,154,132,176,30%,29%,31%,4,3,1,4,4,0
405,https://vlr.gg/player/16635/poly,2024-07-23 05:00:00,0.53,1.23,0.88,142,93,192,19,5,14,21,13,8,15,7,8,0,-2,+2,76%,63%,89%,91,61,120,25%,17%,31%,3,0,3,3,2,1
406,https://vlr.gg/player/25406/shina,2024-07-23 05:00:00,0.87,1.58,1.23,213,135,291,28,9,19,26,15,11,2,1,1,+4,0,+4,53%,42%,63%,146,98,194,38%,38%,39%,6,1,5,2,1,1
407,https://vlr.gg/player/16622/tweeya,2024-07-23 05:00:00,0.44,1.11,0.77,180,131,230,24,8,16,31,18,13,7,3,4,-5,-4,-1,55%,58%,53%,112,78,146,13%,10%,16%,1,0,1,6,4,2
408,https://vlr.gg/player/16015/ivory,2024-07-23 05:00:00,0.59,0.43,0.51,171,188,155,20,11,9,35,18,17,5,3,2,-4,-5,+1,53%,47%,58%,114,124,104,19%,21%,16%,7,2,5,11,7,4
409,https://vlr.gg/player/17532/aisling,2024-07-23 05:00:00,0.46,0.49,0.48,151,164,139,17,9,8,35,19,16,8,3,5,-2,-2,0,53%,42%,63%,93,101,85,17%,22%,13%,1,1,0,3,3,0
410,https://vlr.gg/player/17506/69shinobu,2024-07-23 05:00:00,0.50,0.34,0.42,101,104,99,9,5,4,33,18,15,7,4,3,+1,0,+1,47%,53%,42%,75,78,72,18%,16%,19%,1,0,1,0,0,0
411,https://vlr.gg/player/37521/mint,2024-07-23 03:20:00,1.35,1.57,1.46,329,315,323,116,56,60,71,39,32,19,7,12,+8,+3,+5,79%,78%,80%,196,196,196,33%,37%,30%,27,16,11,19,13,6
412,https://vlr.gg/player/29315/romia,2024-07-23 03:20:00,1.00,1.37,1.19,218,185,253,83,34,49,62,30,32,21,10,11,+6,+1,+5,75%,71%,78%,154,137,170,33%,40%,28%,12,4,8,6,3,3
413,https://vlr.gg/player/25000/yamzzi,2024-07-23 03:20:00,1.10,1.07,1.09,169,166,167,63,31,32,59,29,30,50,24,26,-2,-2,0,78%,76%,80%,112,117,108,35%,32%,38%,3,0,3,5,2,3
414,https://vlr.gg/player/29274/curumi,2024-07-23 03:20:00,1.14,0.84,0.99,194,228,162,67,40,27,68,33,35,51,24,27,0,-3,+3,79%,76%,82%,127,151,104,22%,22%,23%,8,2,6,8,5,3
415,https://vlr.gg/player/29290/pingsong,2024-07-23 03:20:00,0.83,1.10,0.97,189,166,210,66,30,36,71,36,35,42,20,22,+5,0,+5,76%,73%,78%,125,117,132,25%,25%,25%,8,2,6,3,2,1
416,https://vlr.gg/player/29307/r4m,2024-07-23 03:20:00,0.97,0.95,0.95,205,202,207,67,35,32,82,40,42,38,16,22,-3,-2,-1,71%,70%,71%,132,132,133,20%,27%,15%,8,3,5,11,5,6
417,https://vlr.gg/player/30327/hakuna,2024-07-23 03:20:00,0.82,1.07,0.94,185,180,189,64,29,35,71,39,32,12,5,7,-7,-2,-5,62%,60%,63%,128,130,126,25%,26%,23%,0,0,0,7,2,5
418,https://vlr.gg/player/29308/zodiac,2024-07-23 03:20:00,0.63,1.25,0.94,216,181,264,74,31,43,81,44,37,23,6,17,-3,-7,+4,69%,54%,84%,155,133,177,22%,28%,17%,17,6,11,20,13,7
419,https://vlr.gg/player/29297/hane,2024-07-23 03:20:00,0.94,0.85,0.90,204,214,198,70,38,32,82,41,41,34,19,15,+3,-1,+4,75%,74%,76%,134,140,127,33%,38%,27%,10,4,6,7,5,2
420,https://vlr.gg/player/29282/maripo,2024-07-23 03:20:00,0.81,0.66,0.73,164,186,153,56,31,25,79,40,39,26,11,15,-7,-6,-1,61%,62%,59%,110,120,100,20%,22%,18%,6,3,3,13,9,4
421,https://vlr.gg/player/7754/xavi8k,2024-07-23 03:00:00,0.94,1.33,1.11,230,199,285,34,17,17,32,20,12,10,5,5,0,-3,+3,74%,67%,83%,157,134,188,29%,33%,26%,5,2,3,5,5,0
422,https://vlr.gg/player/10217/marky,2024-07-23 03:00:00,0.90,1.18,1.02,225,231,224,34,18,16,33,22,11,10,7,3,0,-5,+5,71%,71%,72%,141,149,130,25%,32%,14%,7,1,6,7,6,1
423,https://vlr.gg/player/7437/kellys,2024-07-23 03:00:00,1.18,0.54,0.90,213,265,139,28,21,7,34,21,13,24,14,10,-5,-3,-2,76%,79%,72%,140,175,92,17%,19%,11%,1,0,1,6,3,3
424,https://vlr.gg/player/2679/dubstep,2024-07-23 03:00:00,0.58,1.27,0.87,157,115,209,24,9,15,29,20,9,13,8,5,-2,-3,+1,76%,67%,89%,100,72,138,29%,24%,33%,1,0,1,3,3,0
425,https://vlr.gg/player/10782/witz,2024-07-23 03:00:00,0.72,0.71,0.72,163,168,158,23,13,10,34,21,13,6,3,3,-5,-4,-1,67%,63%,72%,112,117,105,24%,24%,24%,1,0,1,6,4,2
426,https://vlr.gg/player/13219/papi,2024-07-23 03:00:00,1.51,1.35,1.42,256,257,257,37,14,23,24,9,15,21,14,7,+2,-1,+3,86%,89%,83%,167,164,169,24%,22%,24%,4,0,4,2,1,1
427,https://vlr.gg/player/16842/mojer,2024-07-23 03:00:00,1.06,1.25,1.17,272,242,298,42,16,26,34,14,20,5,1,4,+7,-3,+10,86%,78%,92%,176,141,201,31%,33%,29%,11,1,10,4,4,0
428,https://vlr.gg/player/7749/nexi,2024-07-23 03:00:00,1.02,1.21,1.13,204,207,191,30,13,17,26,15,11,16,8,8,0,0,0,81%,83%,79%,137,140,135,36%,42%,32%,1,1,0,1,1,0
429,https://vlr.gg/player/9747/emman,2024-07-23 03:00:00,1.07,0.83,0.93,186,177,201,29,11,18,30,12,18,16,7,9,+6,+3,+3,76%,83%,71%,124,110,135,26%,26%,25%,8,4,4,2,1,1
430,https://vlr.gg/player/13220/ja,2024-07-23 03:00:00,0.18,1.23,0.78,156,67,219,24,4,20,29,15,14,9,1,8,-3,-5,+2,71%,56%,83%,94,40,135,20%,27%,19%,3,0,3,6,5,1
431,https://vlr.gg/player/612/mitch,2024-07-22 18:45:00,1.37,1.64,1.49,241,217,275,34,15,19,20,11,9,21,12,9,+5,+2,+3,95%,90%,100%,153,152,154,21%,23%,20%,5,2,3,0,0,0
432,https://vlr.gg/player/21668/verno,2024-07-22 18:45:00,1.59,1.16,1.38,227,237,212,29,16,13,19,7,12,18,8,10,+2,+1,+1,79%,80%,78%,147,155,138,31%,45%,20%,4,2,2,2,1,1
433,https://vlr.gg/player/8419/reduxx,2024-07-22 18:45:00,1.33,1.06,1.20,260,278,234,34,20,14,25,12,13,9,3,6,+3,0,+3,82%,70%,94%,164,165,164,25%,29%,21%,7,3,4,4,3,1
434,https://vlr.gg/player/454/dapr,2024-07-22 18:45:00,0.84,1.39,1.10,198,156,249,27,11,16,24,12,12,17,7,10,+2,-1,+3,84%,80%,89%,129,100,161,26%,24%,28%,5,1,4,3,2,1
435,https://vlr.gg/player/11118/skuba,2024-07-22 18:45:00,1.12,0.83,0.98,190,187,199,27,14,13,27,11,16,14,8,6,0,0,0,71%,80%,61%,124,113,136,27%,24%,30%,4,3,1,4,3,1
436,https://vlr.gg/player/8397/dip,2024-07-22 18:45:00,1.10,0.92,1.01,207,226,194,27,14,13,28,13,15,8,3,5,+3,+1,+2,63%,72%,55%,144,161,129,26%,21%,32%,6,1,5,3,0,3
437,https://vlr.gg/player/21886/furbsa,2024-07-22 18:45:00,0.87,0.72,0.79,156,177,139,19,11,8,30,14,16,6,3,3,-2,-1,-1,63%,72%,55%,111,126,98,33%,43%,26%,2,1,1,4,2,2
438,https://vlr.gg/player/6437/dark3st,2024-07-22 18:45:00,1.03,0.43,0.72,162,232,102,21,16,5,31,15,16,15,4,11,-3,-2,-1,63%,72%,55%,105,140,74,21%,26%,15%,0,0,0,3,2,1
439,https://vlr.gg/player/16757/cohburg,2024-07-22 18:45:00,0.77,0.68,0.72,182,215,149,24,14,10,31,16,15,6,2,4,-1,+1,-2,61%,61%,60%,116,134,100,27%,31%,24%,2,2,0,3,1,2
440,https://vlr.gg/player/15636/scarn,2024-07-22 18:45:00,0.15,1.14,0.65,181,103,254,24,7,17,31,17,14,1,1,0,-9,-9,0,58%,44%,70%,129,74,178,28%,22%,31%,3,0,3,12,9,3
441,https://vlr.gg/player/4807/bstrdd,2024-07-22 17:00:00,1.91,1.53,1.72,320,376,265,38,21,17,14,9,5,5,4,1,+3,0,+3,83%,80%,87%,192,231,154,24%,25%,23%,7,3,4,4,3,1
442,https://vlr.gg/player/12143/bizerra,2024-07-22 17:00:00,1.70,1.75,1.72,225,225,225,26,14,12,8,5,3,15,7,8,+1,-2,+3,90%,87%,93%,151,165,137,34%,33%,35%,3,0,3,2,2,0
443,https://vlr.gg/player/11232/daiki,2024-07-22 17:00:00,1.46,1.51,1.48,268,292,245,31,16,15,14,10,4,14,7,7,0,-1,+1,83%,80%,87%,168,178,159,35%,39%,31%,2,1,1,2,2,0
444,https://vlr.gg/player/15297/joojina,2024-07-22 17:00:00,1.13,1.72,1.43,223,170,276,23,9,14,13,8,5,18,8,10,+1,-1,+2,90%,87%,93%,146,110,182,21%,19%,22%,2,0,2,1,1,0
445,https://vlr.gg/player/14386/isaa,2024-07-22 17:00:00,0.56,1.62,1.09,178,119,238,20,7,13,15,11,4,12,5,7,+1,-1,+2,73%,60%,87%,111,77,146,46%,67%,39%,4,1,3,3,2,1
446,https://vlr.gg/player/11240/mittens,2024-07-22 17:00:00,0.64,0.75,0.70,161,129,192,17,6,11,28,14,14,7,3,4,+1,0,+1,53%,40%,67%,90,82,97,18%,15%,22%,4,1,3,3,1,2
447,https://vlr.gg/player/11247/misty,2024-07-22 17:00:00,0.47,0.64,0.53,135,103,168,11,4,7,28,14,14,8,4,4,-3,-2,-1,47%,33%,60%,92,75,109,39%,46%,36%,0,0,0,3,2,1
448,https://vlr.gg/player/21927/anninha,2024-07-22 17:00:00,0.37,0.66,0.52,120,82,158,10,4,6,27,14,13,6,0,6,-2,-3,+1,47%,33%,60%,89,58,121,20%,10%,28%,2,0,2,4,3,1
449,https://vlr.gg/player/43639/niivz,2024-07-22 17:00:00,0.32,0.83,0.50,154,108,201,15,4,11,27,14,13,5,3,2,-1,-4,+3,53%,47%,60%,104,81,126,23%,16%,35%,3,0,3,4,4,0
450,https://vlr.gg/player/12225/fer,2024-07-22 17:00:00,0.13,0.64,0.39,127,81,174,11,3,8,28,15,13,4,1,3,-1,-2,+1,47%,40%,53%,96,56,136,27%,27%,27%,3,1,2,4,3,1
451,https://vlr.gg/player/4828/nismo,2024-07-22 16:00:00,1.36,1.36,1.36,213,204,223,36,16,20,27,13,14,31,18,13,+2,-1,+3,83%,76%,88%,150,142,157,37%,44%,32%,6,0,6,4,1,3
452,https://vlr.gg/player/3722/koalanoob,2024-07-22 16:00:00,1.37,0.95,1.14,211,259,172,33,17,16,28,13,15,17,12,5,+3,+1,+2,74%,76%,72%,126,157,100,18%,25%,9%,7,3,4,4,2,2
453,https://vlr.gg/player/864/bcj,2024-07-22 16:00:00,1.04,1.11,1.08,212,196,233,36,15,21,34,16,18,21,11,10,-1,-2,+1,78%,76%,80%,136,124,146,23%,25%,21%,2,1,1,3,3,0
454,https://vlr.gg/player/6582/net,2024-07-22 16:00:00,0.74,1.34,1.06,218,187,253,38,13,25,32,18,14,6,4,2,0,-2,+2,72%,67%,76%,150,132,165,29%,32%,27%,3,0,3,3,2,1
455,https://vlr.gg/player/8082/zander,2024-07-22 16:00:00,0.90,1.17,1.05,221,188,240,32,14,18,30,15,15,23,8,15,0,-3,+3,80%,81%,80%,131,111,148,20%,29%,16%,7,3,4,7,6,1
456,https://vlr.gg/player/8376/seven,2024-07-22 16:00:00,0.84,1.48,1.13,236,171,319,36,14,22,34,18,16,12,2,10,+3,-2,+5,78%,68%,90%,162,114,218,33%,36%,31%,5,0,5,2,2,0
457,https://vlr.gg/player/740/aproto,2024-07-22 16:00:00,1.01,1.26,1.12,193,194,199,32,17,15,31,19,12,15,8,7,0,+1,-1,67%,56%,81%,133,126,141,36%,33%,41%,3,3,0,3,2,1
458,https://vlr.gg/player/64/gmd,2024-07-22 16:00:00,1.17,0.61,0.91,218,276,143,34,23,11,37,22,15,16,10,6,-3,-3,0,70%,68%,71%,131,169,86,23%,24%,22%,4,1,3,7,4,3
459,https://vlr.gg/player/3702/sym,2024-07-22 16:00:00,0.50,1.01,0.73,162,122,211,27,10,17,37,21,16,13,9,4,-4,-6,+2,70%,68%,71%,111,90,134,39%,31%,46%,6,2,4,10,8,2
460,https://vlr.gg/player/849/poised,2024-07-22 16:00:00,0.70,0.63,0.67,137,133,145,22,12,10,36,20,16,10,6,4,0,-1,+1,74%,64%,86%,96,93,100,22%,25%,18%,3,1,2,3,2,1
461,https://vlr.gg/player/12793/xeus,2024-07-22 13:00:00,1.23,1.38,1.31,298,279,295,70,31,39,49,22,27,14,4,10,+1,-3,+4,72%,69%,74%,197,192,201,34%,43%,28%,13,5,8,12,8,4
462,https://vlr.gg/player/22676/ventt,2024-07-22 13:00:00,0.82,1.38,1.14,213,176,246,53,17,36,44,21,23,25,14,11,+2,-2,+4,84%,83%,84%,142,119,159,36%,31%,40%,7,2,5,5,4,1
463,https://vlr.gg/player/12795/crewen,2024-07-22 13:00:00,1.20,1.02,1.10,187,218,173,47,22,25,42,18,24,13,7,6,+4,0,+4,67%,66%,68%,136,155,121,23%,17%,29%,9,2,7,5,2,3
464,https://vlr.gg/player/12774/anima,2024-07-22 13:00:00,1.40,0.79,1.06,200,230,174,46,24,22,46,16,30,31,16,15,0,0,0,75%,79%,71%,141,151,134,25%,23%,27%,3,1,2,3,1,2
465,https://vlr.gg/player/16483/gloomy,2024-07-22 13:00:00,1.26,0.77,0.98,180,219,143,40,24,16,42,17,25,21,11,10,+4,+2,+2,72%,79%,66%,112,131,98,21%,23%,20%,7,3,4,3,1,2
466,https://vlr.gg/player/10160/izzy,2024-07-22 13:00:00,1.03,1.18,1.09,232,221,253,55,29,26,52,29,23,6,2,4,+1,-2,+3,66%,63%,69%,150,146,157,34%,39%,28%,9,3,6,8,5,3
467,https://vlr.gg/player/3557/skylen,2024-07-22 13:00:00,1.04,1.06,1.05,209,204,228,53,29,24,50,27,23,16,8,8,-3,-2,-1,70%,68%,72%,150,140,163,35%,32%,40%,4,1,3,7,3,4
468,https://vlr.gg/player/40935/umu7,2024-07-22 13:00:00,0.84,0.85,0.85,187,178,193,44,24,20,51,28,23,12,8,4,-1,-1,0,70%,68%,72%,122,120,125,40%,42%,37%,6,4,2,7,5,2
469,https://vlr.gg/player/1399/sterben,2024-07-22 13:00:00,0.94,0.53,0.76,173,205,149,41,28,13,53,27,26,14,8,6,-5,-4,-1,55%,55%,55%,118,129,104,33%,32%,34%,5,2,3,10,6,4
470,https://vlr.gg/player/556/souhcni,2024-07-22 13:00:00,0.79,0.65,0.73,149,172,138,30,19,11,50,27,23,25,13,12,-3,-5,+2,63%,61%,66%,107,116,95,27%,28%,26%,4,2,2,7,7,0
471,https://vlr.gg/player/18677/ruxic,2024-07-22 09:30:00,0.94,1.34,1.13,218,202,243,41,18,23,37,23,14,20,12,8,-5,-2,-3,70%,66%,76%,148,127,173,25%,25%,25%,3,3,0,8,5,3
472,https://vlr.gg/player/5568/sociablee,2024-07-22 09:30:00,0.72,1.19,0.94,188,152,240,36,15,21,39,24,15,19,12,7,+3,0,+3,72%,69%,76%,118,91,150,27%,23%,30%,7,2,5,4,2,2
473,https://vlr.gg/player/568/turko,2024-07-22 09:30:00,0.82,1.01,0.91,179,154,199,32,16,16,41,24,17,23,8,15,+2,+1,+1,76%,69%,84%,108,93,124,33%,32%,33%,3,1,2,1,0,1
474,https://vlr.gg/player/4893/lauress,2024-07-22 09:30:00,0.52,1.34,0.90,208,159,285,42,15,27,43,26,17,4,1,3,-1,-4,+3,65%,52%,80%,144,101,194,28%,23%,32%,10,4,6,11,8,3
475,https://vlr.gg/player/12651/w0zzip,2024-07-22 09:30:00,0.64,0.69,0.67,128,141,124,25,14,11,39,24,15,9,2,7,-1,0,-1,65%,55%,76%,85,97,72,23%,29%,16%,3,2,1,4,2,2
476,https://vlr.gg/player/31305/lar0k,2024-07-22 09:30:00,1.28,1.23,1.25,226,246,205,42,21,21,33,17,16,29,11,18,+4,+3,+1,76%,80%,72%,135,160,115,20%,29%,13%,7,3,4,3,0,3
477,https://vlr.gg/player/31855/celasun,2024-07-22 09:30:00,0.93,1.40,1.18,213,169,250,42,14,28,31,18,13,4,2,2,-1,0,-1,74%,64%,83%,140,117,160,27%,27%,27%,2,1,1,3,1,2
478,https://vlr.gg/player/24344/loita,2024-07-22 09:30:00,0.77,1.49,1.16,216,173,261,40,14,26,36,21,15,24,8,16,-1,-2,+1,72%,56%,86%,143,109,173,34%,38%,32%,4,2,2,5,4,1
479,https://vlr.gg/player/40591/comeback,2024-07-22 09:30:00,0.96,1.09,1.03,263,247,251,47,21,26,42,23,19,6,4,2,+2,-1,+3,65%,60%,69%,155,156,154,32%,39%,22%,13,4,9,11,5,6
480,https://vlr.gg/player/5565/ros,2024-07-22 09:30:00,0.55,1.15,0.87,161,99,203,28,8,20,34,19,15,14,6,8,-2,-3,+1,70%,52%,86%,119,84,149,22%,26%,20%,2,1,1,4,4,0
481,https://vlr.gg/player/16634/kitkatwc,2024-07-22 07:00:00,1.06,1.34,1.20,254,224,284,58,24,34,46,23,23,32,14,18,+3,+2,+1,83%,85%,81%,163,144,180,28%,28%,28%,6,4,2,3,2,1
482,https://vlr.gg/player/26077/angela,2024-07-22 07:00:00,1.30,1.11,1.20,281,319,242,64,34,30,47,24,23,10,5,5,+6,+3,+3,72%,76%,69%,182,205,161,18%,21%,15%,21,12,9,15,9,6
483,https://vlr.gg/player/27012/felce,2024-07-22 07:00:00,0.78,1.33,1.07,187,158,210,48,19,29,43,24,19,14,7,7,+3,+1,+2,71%,64%,78%,117,94,138,30%,22%,36%,3,1,2,0,0,0
484,https://vlr.gg/player/16630/rosey,2024-07-22 07:00:00,0.94,1.17,1.06,190,135,236,45,15,30,43,21,22,27,18,9,+8,+1,+7,72%,70%,75%,129,99,156,23%,21%,23%,11,1,10,3,0,3
485,https://vlr.gg/player/16639/izze,2024-07-22 07:00:00,0.95,0.76,0.85,163,188,143,39,24,15,41,21,20,7,2,5,+1,0,+1,67%,58%,75%,110,116,104,12%,14%,10%,4,2,2,3,2,1
486,https://vlr.gg/player/39991/elfie,2024-07-22 07:00:00,1.28,1.18,1.24,246,266,231,58,31,27,51,27,24,20,12,8,+2,+1,+1,80%,78%,82%,156,163,148,27%,24%,31%,9,5,4,7,4,3
487,https://vlr.gg/player/36904/sampphire,2024-07-22 07:00:00,1.18,1.08,1.13,190,201,184,47,27,20,43,23,20,26,9,17,-2,0,-2,68%,64%,73%,121,129,112,27%,23%,33%,3,1,2,5,1,4
488,https://vlr.gg/player/9183/envious,2024-07-22 07:00:00,0.73,0.95,0.84,173,166,194,41,20,21,53,29,24,27,11,16,-8,-6,-2,67%,64%,70%,121,107,136,23%,21%,25%,4,2,2,12,8,4
489,https://vlr.gg/player/45078/kikowo,2024-07-22 07:00:00,0.55,0.91,0.72,180,154,216,40,18,22,57,31,26,14,3,11,-2,-3,+1,51%,47%,55%,122,94,152,21%,24%,19%,5,1,4,7,4,3
490,https://vlr.gg/player/18072/pigruto,2024-07-22 07:00:00,0.42,0.99,0.70,140,88,196,34,11,23,50,28,22,11,5,6,-11,-6,-5,58%,44%,73%,94,65,126,24%,27%,23%,3,2,1,14,8,6
491,https://vlr.gg/player/13220/ja,2024-07-22 05:30:00,1.31,1.20,1.26,253,249,263,57,31,26,41,19,22,6,2,4,+1,0,+1,74%,79%,68%,175,172,179,24%,24%,24%,7,4,3,6,4,2
492,https://vlr.gg/player/16842/mojer,2024-07-22 05:30:00,1.48,0.67,1.12,271,363,155,53,41,12,48,26,22,17,7,10,+1,+6,-5,76%,79%,71%,173,225,110,26%,28%,23%,12,10,2,11,4,7
493,https://vlr.gg/player/13219/papi,2024-07-22 05:30:00,1.00,1.06,1.03,182,169,197,43,24,19,41,21,20,12,7,5,+4,-3,+7,74%,74%,75%,123,112,138,22%,23%,21%,8,0,8,4,3,1
494,https://vlr.gg/player/9747/emman,2024-07-22 05:30:00,0.90,1.06,0.97,180,183,172,42,22,20,45,24,21,15,14,1,-3,-3,0,69%,74%,64%,132,132,131,36%,33%,38%,2,1,1,5,4,1
495,https://vlr.gg/player/7749/nexi,2024-07-22 05:30:00,0.85,0.76,0.81,168,174,165,37,22,15,45,21,24,11,3,8,-3,0,-3,66%,71%,61%,123,127,117,24%,18%,33%,2,2,0,5,2,3
496,https://vlr.gg/player/7746/kevzii,2024-07-22 05:30:00,1.58,1.30,1.43,269,280,258,59,30,29,42,16,26,15,5,10,+6,+2,+4,73%,79%,68%,180,186,175,37%,38%,37%,10,4,6,4,2,2
497,https://vlr.gg/player/16953/zynd,2024-07-22 05:30:00,0.84,1.34,1.12,232,183,282,51,18,33,45,18,27,17,7,10,+5,+2,+3,73%,86%,62%,163,123,195,27%,29%,26%,12,5,7,7,3,4
498,https://vlr.gg/player/13744/patmen,2024-07-22 05:30:00,1.20,0.60,0.87,206,270,161,45,28,17,49,19,30,12,2,10,+2,+1,+1,73%,79%,68%,135,180,98,36%,44%,28%,6,3,3,4,2,2
499,https://vlr.gg/player/21677/jeee,2024-07-22 05:30:00,0.95,0.54,0.73,158,195,128,34,19,15,48,19,29,25,14,11,-3,-1,-2,76%,79%,74%,102,117,89,19%,17%,23%,1,1,0,4,2,2
500,https://vlr.gg/player/9737/kakarot,2024-07-22 05:30:00,0.63,0.66,0.64,138,135,141,31,14,17,48,20,28,15,7,8,-10,-4,-6,61%,61%,62%,92,94,91,16%,16%,16%,2,1,1,12,5,7
0,https://vlr.gg/player/8176/enerii,2024-07-22 05:00:00,1.72,1.88,1.81,361,359,363,37,18,19,13,6,7,10,4,6,+6,+4,+2,90%,93%,87%,229,221,236,21%,26%,18%,7,4,3,1,0,1
1,https://vlr.gg/player/18091/shirazi,2024-07-22 05:00:00,1.63,1.69,1.66,270,225,310,31,13,18,11,4,7,10,3,7,+3,0,+3,100%,100%,100%,182,155,207,30%,32%,29%,4,1,3,1,1,0
2,https://vlr.gg/player/16621/alexy,2024-07-22 05:00:00,1.45,1.84,1.65,342,340,342,35,17,18,16,9,7,6,3,3,+8,+3,+5,76%,64%,87%,213,213,213,25%,33%,17%,11,5,6,3,2,1
3,https://vlr.gg/player/8492/tara,2024-07-22 05:00:00,1.40,1.06,1.22,183,228,144,20,12,8,12,6,6,9,2,7,+1,+1,0,79%,86%,73%,140,178,104,28%,33%,21%,1,1,0,0,0,0
4,https://vlr.gg/player/18093/kamiyu,2024-07-22 05:00:00,1.30,1.07,1.17,139,155,128,17,9,8,10,5,5,13,8,5,+1,0,+1,86%,100%,73%,86,103,71,19%,26%,12%,1,0,1,0,0,0
5,https://vlr.gg/player/45044/jelerak,2024-07-22 05:00:00,0.66,0.61,0.60,169,172,166,14,7,7,30,16,14,7,5,2,-5,-3,-2,55%,60%,50%,116,137,94,22%,29%,18%,1,1,0,6,4,2
6,https://vlr.gg/player/46860/mimo,2024-07-22 05:00:00,0.81,0.36,0.59,139,182,88,13,9,4,27,14,13,3,2,1,-1,0,-1,55%,67%,43%,92,115,67,33%,35%,27%,1,0,1,2,0,2
7,https://vlr.gg/player/17594/newky,2024-07-22 05:00:00,0.34,0.65,0.48,155,130,188,14,6,8,29,14,15,6,3,3,-4,-4,0,45%,33%,57%,95,74,117,19%,16%,21%,1,0,1,5,4,1
8,https://vlr.gg/player/19976/marpandyz,2024-07-22 05:00:00,0.40,0.42,0.40,103,110,99,10,6,4,26,13,13,4,1,3,-5,-3,-2,31%,20%,43%,64,62,67,13%,7%,19%,2,1,1,7,4,3
9,https://vlr.gg/player/46946/buubuucute,2024-07-22 05:00:00,0.30,0.46,0.37,131,91,173,11,4,7,28,14,14,3,1,2,-4,-1,-3,41%,47%,36%,80,58,105,3%,8%,0%,0,0,0,4,1,3
10,https://vlr.gg/player/7437/kellys,2024-07-22 03:00:00,1.36,1.54,1.45,297,286,316,53,25,28,35,18,17,27,15,12,+3,-1,+4,81%,78%,85%,200,178,222,25%,25%,25%,8,2,6,5,3,2
11,https://vlr.gg/player/10217/marky,2024-07-22 03:00:00,1.27,1.42,1.34,245,232,260,51,24,27,34,20,14,13,8,5,+7,+2,+5,81%,85%,78%,150,148,153,31%,38%,25%,13,6,7,6,4,2
12,https://vlr.gg/player/7754/xavi8k,2024-07-22 03:00:00,1.04,1.44,1.24,238,209,273,43,20,23,35,19,16,10,3,7,-1,-2,+1,81%,85%,78%,178,157,198,23%,32%,19%,4,0,4,5,2,3
13,https://vlr.gg/player/2679/dubstep,2024-07-22 03:00:00,0.87,1.04,0.96,164,167,160,31,15,16,31,19,12,20,10,10,-1,0,-1,78%,70%,85%,109,113,104,30%,40%,23%,2,2,0,3,2,1
14,https://vlr.gg/player/10782/witz,2024-07-22 03:00:00,0.66,0.93,0.80,164,175,148,30,14,16,37,23,14,20,14,6,-6,-4,-2,76%,70%,81%,114,125,103,21%,20%,24%,1,1,0,7,5,2
15,https://vlr.gg/player/33801/loydream,2024-07-22 03:00:00,1.35,1.09,1.22,243,266,222,48,26,22,41,20,21,7,3,4,+4,+1,+3,65%,59%,70%,157,175,139,24%,24%,25%,10,4,6,6,3,3
16,https://vlr.gg/player/24737/par-scofield,2024-07-22 03:00:00,0.81,1.30,1.05,230,170,283,41,15,26,41,21,20,7,3,4,+7,+2,+5,59%,44%,74%,153,109,196,29%,27%,30%,9,3,6,2,1,1
17,https://vlr.gg/player/26143/secondlove,2024-07-22 03:00:00,0.71,0.90,0.80,164,155,177,31,13,18,40,21,19,13,6,7,-4,-3,-1,65%,59%,70%,119,110,128,28%,29%,28%,2,1,1,6,4,2
18,https://vlr.gg/player/44246/repulsive,2024-07-22 03:00:00,0.42,0.94,0.68,149,113,190,26,9,17,42,23,19,15,3,12,0,-1,+1,63%,59%,67%,98,79,118,27%,21%,31%,5,2,3,5,3,2
19,https://vlr.gg/player/21793/syko,2024-07-22 03:00:00,0.29,0.83,0.56,142,113,172,26,10,16,44,25,19,14,7,7,-9,-6,-3,61%,52%,70%,92,75,108,34%,40%,31%,0,0,0,9,6,3
20,https://vlr.gg/player/7873/leaf,2024-07-21 17:00:00,1.20,0.98,1.08,208,261,178,70,39,31,74,39,35,28,12,16,+1,-1,+2,69%,67%,71%,145,173,120,18%,18%,18%,11,5,6,10,6,4
21,https://vlr.gg/player/3885/valyn,2024-07-21 17:00:00,0.67,1.18,0.94,203,148,240,65,23,42,77,40,37,43,20,23,+1,-7,+8,74%,72%,76%,115,85,141,21%,25%,19%,13,3,10,12,10,2
22,https://vlr.gg/player/4581/jonahp,2024-07-21 17:00:00,0.76,1.05,0.91,175,166,194,62,25,37,74,40,34,34,18,16,-5,-5,0,62%,63%,61%,120,111,127,21%,16%,26%,2,0,2,7,5,2
23,https://vlr.gg/player/8402/icy,2024-07-21 17:00:00,0.58,1.04,0.82,175,172,190,60,24,36,75,43,32,20,11,9,-4,-5,+1,65%,59%,71%,126,120,132,21%,20%,22%,14,4,10,18,9,9
24,https://vlr.gg/player/15500/trent,2024-07-21 17:00:00,0.58,0.84,0.70,145,126,170,45,20,25,74,38,36,41,16,25,-2,-4,+2,67%,61%,73%,103,86,118,20%,20%,20%,4,0,4,6,4,2
25,https://vlr.gg/player/7603/mazino,2024-07-21 17:00:00,1.07,1.57,1.31,261,219,316,90,36,54,64,35,29,43,22,21,+5,-1,+6,79%,76%,83%,171,142,203,33%,27%,37%,12,4,8,7,5,2
26,https://vlr.gg/player/8480/aspas,2024-07-21 17:00:00,1.01,1.29,1.14,239,213,259,81,39,42,65,38,27,22,11,11,+2,-6,+8,72%,65%,80%,151,131,172,17%,15%,19%,19,5,14,17,11,6
27,https://vlr.gg/player/619/c0m,2024-07-21 17:00:00,1.04,1.24,1.14,202,185,227,69,35,34,56,31,25,37,16,21,+2,-2,+4,85%,82%,87%,138,117,163,22%,28%,18%,7,3,4,5,5,0
28,https://vlr.gg/player/1818/tex,2024-07-21 17:00:00,1.01,1.13,1.07,192,193,193,69,35,34,58,33,25,21,12,9,-3,-4,+1,77%,75%,80%,131,129,134,31%,29%,33%,5,2,3,8,6,2
29,https://vlr.gg/player/8549/kingg,2024-07-21 17:00:00,0.95,1.19,1.06,190,168,202,65,29,36,59,34,25,47,22,25,+3,0,+3,79%,71%,89%,114,110,118,26%,28%,24%,10,5,5,7,5,2
30,https://vlr.gg/player/556/souhcni,2024-07-21 13:00:00,1.53,1.11,1.39,214,237,170,27,20,7,16,9,7,16,12,4,-1,+1,-2,78%,83%,67%,149,160,127,29%,27%,33%,1,1,0,2,0,2
31,https://vlr.gg/player/1399/sterben,2024-07-21 13:00:00,1.47,1.17,1.37,257,288,196,34,28,6,22,12,10,13,3,10,+4,+5,-1,81%,79%,83%,163,184,123,31%,35%,23%,7,6,1,3,1,2
32,https://vlr.gg/player/10160/izzy,2024-07-21 13:00:00,1.11,1.81,1.35,247,221,301,33,20,13,21,14,7,12,7,5,0,-2,+2,75%,79%,67%,155,147,171,30%,26%,39%,6,2,4,6,4,2
33,https://vlr.gg/player/3557/skylen,2024-07-21 13:00:00,1.32,1.42,1.35,244,218,299,34,21,13,17,10,7,6,2,4,0,0,0,81%,83%,75%,153,139,181,45%,42%,50%,2,2,0,2,2,0
34,https://vlr.gg/player/40935/umu7,2024-07-21 13:00:00,1.12,0.95,1.06,193,210,158,26,19,7,23,15,8,10,7,3,+3,+2,+1,75%,79%,67%,118,135,86,25%,31%,14%,5,4,1,2,2,0
35,https://vlr.gg/player/10163/cyderx,2024-07-21 13:00:00,0.79,0.82,0.81,167,159,171,22,8,14,26,8,18,4,1,3,-1,0,-1,64%,67%,63%,114,124,110,39%,38%,39%,0,0,0,1,0,1
36,https://vlr.gg/player/10152/padisah,2024-07-21 13:00:00,0.79,0.81,0.80,211,229,202,26,10,16,31,10,21,5,2,3,+2,-1,+3,67%,75%,63%,137,162,125,46%,38%,51%,5,1,4,3,2,1
37,https://vlr.gg/player/20144/lewn,2024-07-21 13:00:00,0.97,0.46,0.63,156,213,130,19,9,10,31,8,23,3,1,2,-1,+2,-3,47%,58%,42%,104,126,93,25%,20%,31%,4,3,1,5,1,4
38,https://vlr.gg/player/5500/docent,2024-07-21 13:00:00,0.49,0.53,0.52,154,143,159,16,6,10,33,10,23,9,1,8,0,0,0,53%,58%,50%,111,102,115,31%,21%,36%,4,1,3,4,1,3
39,https://vlr.gg/player/3549/touven,2024-07-21 13:00:00,0.36,0.36,0.36,124,109,129,15,5,10,34,12,22,8,3,5,-6,-1,-5,58%,67%,54%,79,55,91,27%,23%,28%,2,1,1,8,2,6
40,https://vlr.gg/player/1475/kamyk,2024-07-21 12:00:00,1.29,1.45,1.39,229,222,233,50,16,34,29,13,16,34,15,19,+1,+2,-1,86%,80%,89%,153,150,154,37%,27%,46%,4,2,2,3,0,3
41,https://vlr.gg/player/5893/robbiebk,2024-07-21 12:00:00,1.64,1.16,1.33,236,263,221,48,20,28,31,9,22,19,6,13,+3,+1,+2,79%,75%,81%,162,173,155,39%,32%,44%,6,2,4,3,1,2
42,https://vlr.gg/player/2700/jas,2024-07-21 12:00:00,0.63,1.52,1.20,258,188,296,52,12,40,37,18,19,12,5,7,+6,0,+6,73%,60%,81%,160,118,184,26%,31%,24%,16,5,11,10,5,5
43,https://vlr.gg/player/4308/magik,2024-07-21 12:00:00,1.38,1.02,1.15,221,248,208,48,20,28,36,13,23,18,7,11,0,-1,+1,73%,80%,69%,153,182,137,34%,34%,35%,3,0,3,3,1,2
44,https://vlr.gg/player/1284/mikee,2024-07-21 12:00:00,0.95,1.19,1.10,175,131,201,38,11,27,26,9,17,13,2,11,-2,0,-2,88%,85%,89%,124,82,147,34%,38%,33%,3,2,1,5,2,3
45,https://vlr.gg/player/2653/jesse,2024-07-21 12:00:00,1.00,1.10,1.04,226,222,238,47,29,18,46,31,15,16,10,6,-4,-3,-1,70%,72%,65%,139,140,137,39%,40%,36%,4,3,1,8,6,2
46,https://vlr.gg/player/6889/neskaas,2024-07-21 12:00:00,0.88,0.64,0.80,166,185,136,31,22,9,47,30,17,12,6,6,0,+1,-1,63%,58%,70%,113,125,91,22%,27%,14%,8,6,2,8,5,3
47,https://vlr.gg/player/8805/sacake,2024-07-21 12:00:00,0.60,0.87,0.70,157,143,183,28,16,12,47,32,15,14,6,8,-4,-2,-2,61%,50%,80%,105,95,123,18%,13%,26%,1,1,0,5,3,2
48,https://vlr.gg/player/314/ambi,2024-07-21 12:00:00,0.67,0.65,0.66,128,128,126,23,15,8,45,29,16,22,9,13,-2,-3,+1,59%,50%,75%,88,94,78,28%,37%,16%,3,1,2,5,4,1
49,https://vlr.gg/player/252/d3ffo,2024-07-21 12:00:00,0.47,0.84,0.60,169,143,219,30,15,15,51,35,16,10,6,4,+2,+1,+1,66%,61%,75%,107,92,133,25%,29%,20%,8,4,4,6,3,3
50,https://vlr.gg/player/13435/fragger,2024-07-21 10:00:00,1.75,1.48,1.56,247,264,243,50,15,35,21,5,16,19,9,10,+5,+1,+4,82%,79%,83%,168,162,170,34%,38%,32%,10,3,7,5,2,3
51,https://vlr.gg/player/15577/brk,2024-07-21 10:00:00,1.49,1.50,1.50,283,298,277,50,15,35,27,8,19,15,5,10,+16,+6,+10,86%,86%,86%,191,190,191,17%,13%,20%,18,6,12,2,0,2
52,https://vlr.gg/player/15376/grtw,2024-07-21 10:00:00,1.80,1.38,1.50,269,323,249,50,15,35,26,7,19,19,10,9,+4,+1,+3,82%,93%,78%,177,200,168,21%,13%,25%,5,1,4,1,0,1
53,https://vlr.gg/player/1378/addicted,2024-07-21 10:00:00,1.70,1.26,1.38,194,199,192,39,14,25,20,3,17,18,4,14,+4,0,+4,86%,93%,83%,133,133,133,25%,33%,21%,4,0,4,0,0,0
54,https://vlr.gg/player/29340/cunha20,2024-07-21 10:00:00,0.86,1.01,0.97,161,108,182,29,6,23,27,7,20,27,7,20,-3,-2,-1,84%,93%,81%,119,60,142,32%,31%,32%,1,0,1,4,2,2
55,https://vlr.gg/player/8590/killdream,2024-07-21 10:00:00,0.99,0.76,0.91,207,218,176,33,25,8,43,31,12,14,11,3,0,+1,-1,60%,64%,50%,140,151,112,26%,25%,28%,3,2,1,3,1,2
56,https://vlr.gg/player/7883/silenttt,2024-07-21 10:00:00,0.93,0.36,0.77,177,205,109,30,25,5,43,30,13,6,4,2,-1,0,-1,52%,58%,36%,115,130,75,28%,25%,46%,4,4,0,5,4,1
57,https://vlr.gg/player/1377/phatt,2024-07-21 10:00:00,0.69,0.80,0.72,131,118,168,22,14,8,41,29,12,13,11,2,-2,-3,+1,62%,64%,57%,86,79,106,29%,30%,28%,2,0,2,4,3,1
58,https://vlr.gg/player/26808/fainz,2024-07-21 10:00:00,0.43,0.50,0.40,132,129,132,22,16,6,46,32,14,7,6,1,-19,-15,-4,52%,56%,43%,87,88,86,30%,36%,18%,2,1,1,21,16,5
59,https://vlr.gg/player/16012/akira,2024-07-21 10:00:00,0.44,0.25,0.38,99,104,89,14,11,3,45,31,14,12,9,3,-4,-3,-1,52%,56%,43%,73,71,78,14%,14%,14%,1,1,0,5,4,1
60,https://vlr.gg/player/40591/comeback,2024-07-21 09:40:00,1.10,1.25,1.17,241,239,246,54,30,24,46,23,23,8,2,6,0,-4,+4,79%,84%,73%,166,156,177,27%,31%,24%,5,1,4,5,5,0
61,https://vlr.gg/player/31855/celasun,2024-07-21 09:40:00,1.33,0.86,1.10,192,221,164,46,27,19,40,18,22,11,8,3,+2,+1,+1,76%,75%,77%,132,159,103,28%,32%,22%,4,3,1,2,2,0
62,https://vlr.gg/player/31305/lar0k,2024-07-21 09:40:00,0.96,1.18,1.07,177,162,194,37,17,20,38,20,18,30,17,13,-6,-3,-3,74%,78%,70%,119,115,122,25%,26%,25%,2,0,2,8,3,5
63,https://vlr.gg/player/24344/loita,2024-07-21 09:40:00,1.05,1.06,1.05,224,239,214,46,26,20,44,24,20,19,8,11,+11,+3,+8,74%,75%,73%,147,152,143,33%,32%,35%,16,7,9,5,4,1
64,https://vlr.gg/player/5565/ros,2024-07-21 09:40:00,0.91,0.71,0.82,180,180,180,40,22,18,46,22,24,16,8,8,-3,-1,-2,73%,75%,70%,115,113,116,23%,23%,22%,6,3,3,9,4,5
65,https://vlr.gg/player/5517/masic,2024-07-21 09:40:00,1.20,1.40,1.30,226,220,236,52,24,28,39,19,20,23,13,10,+1,-3,+4,73%,77%,69%,143,141,146,36%,36%,36%,6,1,5,5,4,1
66,https://vlr.gg/player/6559/destruct1vee,2024-07-21 09:40:00,0.99,1.05,1.02,199,177,221,42,18,24,44,19,25,25,12,13,+3,+1,+2,74%,77%,72%,135,123,146,25%,23%,26%,6,3,3,3,2,1
67,https://vlr.gg/player/4962/lurzy0y0,2024-07-21 09:40:00,1.33,0.39,0.85,176,249,110,42,30,12,46,19,27,8,4,4,-3,0,-3,66%,77%,56%,115,162,72,31%,35%,25%,2,1,1,5,1,4
68,https://vlr.gg/player/10137/ip0tt,2024-07-21 09:40:00,0.96,0.76,0.85,203,219,189,41,23,18,48,22,26,14,7,7,-5,-3,-2,74%,83%,66%,141,150,132,33%,31%,34%,9,5,4,14,8,6
69,https://vlr.gg/player/7353/glovee,2024-07-21 09:40:00,0.52,1.03,0.77,158,95,214,37,12,25,46,22,24,16,7,9,0,-3,+3,71%,70%,72%,100,58,140,29%,19%,34%,6,1,5,6,4,2
70,https://vlr.gg/player/2489/munchkin,2024-07-21 04:00:00,1.14,1.25,1.20,203,196,226,70,29,41,58,24,34,55,23,32,+1,+2,-1,83%,89%,78%,133,118,146,19%,14%,24%,4,3,1,3,1,2
71,https://vlr.gg/player/34974/karon,2024-07-21 04:00:00,1.51,0.88,1.16,216,271,170,77,44,33,63,25,38,36,23,13,+3,+5,-2,78%,86%,70%,141,176,112,39%,45%,33%,9,6,3,6,1,5
72,https://vlr.gg/player/13039/meteor,2024-07-21 04:00:00,1.18,0.98,1.07,206,219,205,76,38,38,65,27,38,20,7,13,+4,-1,+5,73%,77%,70%,141,139,142,28%,29%,28%,12,3,9,8,4,4
73,https://vlr.gg/player/773/lakia,2024-07-21 04:00:00,0.95,1.14,1.05,201,154,232,68,24,44,63,28,35,44,29,15,+3,+2,+1,81%,84%,78%,126,103,146,27%,26%,27%,10,4,6,7,2,5
74,https://vlr.gg/player/9196/t3xture,2024-07-21 04:00:00,1.13,0.94,1.02,232,249,224,81,40,41,73,30,43,19,6,13,+12,+11,+1,66%,73%,61%,160,167,154,28%,32%,24%,26,16,10,14,5,9
75,https://vlr.gg/player/804/buzz,2024-07-21 04:00:00,1.01,1.17,1.08,238,252,238,84,46,38,78,44,34,14,13,1,-3,+1,-4,64%,69%,59%,165,176,150,20%,19%,22%,14,11,3,17,10,7
76,https://vlr.gg/player/35013/flashback,2024-07-21 04:00:00,1.15,0.77,0.98,192,210,173,68,42,26,69,34,35,23,7,16,-3,-2,-1,68%,72%,64%,125,141,106,30%,33%,26%,9,5,4,12,7,5
77,https://vlr.gg/player/4462/mako,2024-07-21 04:00:00,1.07,0.88,0.98,199,199,191,62,36,26,72,38,34,42,24,18,-8,-2,-6,69%,70%,68%,138,147,127,28%,31%,24%,2,1,1,10,3,7
78,https://vlr.gg/player/11600/foxy9,2024-07-21 04:00:00,0.90,0.71,0.81,168,180,162,58,36,22,77,40,37,34,20,14,0,+4,-4,67%,74%,59%,106,104,109,33%,36%,31%,9,7,2,9,3,6
79,https://vlr.gg/player/4678/beyn,2024-07-21 04:00:00,0.70,0.72,0.71,143,150,147,49,28,21,76,41,35,24,13,11,-9,-4,-5,66%,72%,59%,100,96,105,23%,22%,25%,3,1,2,12,5,7
80,https://vlr.gg/player/7603/mazino,2024-07-20 17:00:00,1.34,1.15,1.25,257,271,245,99,53,46,76,37,39,48,31,17,+4,+7,-3,86%,96%,75%,164,162,167,27%,29%,26%,10,9,1,6,2,4
81,https://vlr.gg/player/8480/aspas,2024-07-20 17:00:00,1.17,1.29,1.23,250,246,247,90,47,43,70,37,33,21,10,11,+17,+11,+6,76%,76%,76%,166,158,174,31%,27%,35%,24,13,11,7,2,5
82,https://vlr.gg/player/619/c0m,2024-07-20 17:00:00,1.14,0.95,1.05,186,189,192,66,38,28,66,30,36,33,13,20,-4,0,-4,80%,87%,73%,129,124,135,19%,18%,20%,7,4,3,11,4,7
83,https://vlr.gg/player/1818/tex,2024-07-20 17:00:00,1.22,0.79,1.01,201,242,149,75,47,28,68,34,34,22,16,6,+2,-1,+3,70%,69%,71%,133,165,98,33%,33%,31%,12,6,6,10,7,3
84,https://vlr.gg/player/8549/kingg,2024-07-20 17:00:00,1.00,0.90,0.95,180,158,208,68,33,35,71,31,40,38,16,22,+3,0,+3,82%,85%,78%,119,102,137,23%,20%,25%,11,4,7,8,4,4
85,https://vlr.gg/player/24007/shyy,2024-07-20 17:00:00,1.33,0.99,1.15,225,257,203,86,47,39,74,32,42,25,15,10,-6,-1,-5,65%,75%,56%,154,165,143,28%,33%,24%,6,5,1,12,6,6
86,https://vlr.gg/player/2462/keznit,2024-07-20 17:00:00,1.03,0.89,0.96,210,221,212,81,41,40,85,37,48,19,9,10,-4,0,-4,66%,71%,62%,141,144,139,19%,25%,13%,15,9,6,19,9,10
87,https://vlr.gg/player/8673/heat,2024-07-20 17:00:00,1.06,0.78,0.91,181,210,161,69,38,31,78,35,43,42,22,20,-5,-2,-3,70%,76%,64%,115,132,100,30%,26%,35%,8,4,4,13,6,7
88,https://vlr.gg/player/36169/mta,2024-07-20 17:00:00,0.74,0.82,0.78,173,163,186,64,30,34,84,39,45,15,5,10,0,0,0,65%,71%,60%,123,116,131,30%,32%,30%,9,3,6,9,3,6
89,https://vlr.gg/player/1311/melser,2024-07-20 17:00:00,0.80,0.69,0.74,143,162,130,50,27,23,78,37,41,46,29,17,-7,-2,-5,63%,73%,55%,92,101,84,30%,32%,29%,4,2,2,11,4,7
90,https://vlr.gg/player/458/chronicle,2024-07-20 12:00:00,1.31,1.38,1.35,236,249,231,70,29,41,44,20,24,30,11,19,+3,+2,+1,80%,76%,83%,164,166,163,24%,24%,24%,6,2,4,3,0,3
91,https://vlr.gg/player/9810/alfajer,2024-07-20 12:00:00,0.97,1.44,1.24,244,188,284,73,22,51,53,24,29,21,5,16,0,-5,+5,70%,58%,79%,157,117,185,32%,27%,35%,11,3,8,11,8,3
92,https://vlr.gg/player/5022/derke,2024-07-20 12:00:00,0.81,1.24,1.06,217,189,238,62,22,40,57,27,30,23,10,13,+2,-2,+4,78%,76%,79%,148,131,160,23%,28%,20%,12,2,10,10,4,6
93,https://vlr.gg/player/438/boaster,2024-07-20 12:00:00,0.88,1.16,1.05,189,151,201,53,19,34,47,21,26,39,7,32,+2,0,+2,74%,64%,81%,115,102,124,27%,28%,26%,10,4,6,8,4,4
94,https://vlr.gg/player/29867/hiro,2024-07-20 12:00:00,1.12,0.97,1.03,177,195,162,52,22,30,52,23,29,32,17,15,0,0,0,72%,64%,77%,120,128,114,30%,30%,31%,5,3,2,5,3,2
95,https://vlr.gg/player/2168/trexx,2024-07-20 12:00:00,0.94,0.96,0.95,185,194,177,51,30,21,61,39,22,25,16,9,-1,-1,0,62%,63%,61%,134,136,132,22%,23%,22%,3,2,1,4,3,1
96,https://vlr.gg/player/11134/kicks,2024-07-20 12:00:00,0.81,1.07,0.92,178,156,209,52,26,26,62,39,23,30,16,14,0,-2,+2,65%,63%,70%,114,99,137,28%,29%,27%,7,3,4,7,5,2
97,https://vlr.gg/player/312/sayf,2024-07-20 12:00:00,0.76,1.14,0.91,199,183,220,53,29,24,60,39,21,17,10,7,-7,-7,0,70%,63%,82%,136,131,142,22%,23%,20%,9,5,4,16,12,4
98,https://vlr.gg/player/21610/runner,2024-07-20 12:00:00,0.96,0.74,0.87,187,197,180,49,31,18,64,38,26,26,20,6,+6,+1,+5,67%,65%,70%,125,125,125,16%,15%,19%,11,4,7,5,3,2
99,https://vlr.gg/player/4321/cender,2024-07-20 12:00:00,0.55,1.11,0.78,155,132,196,47,23,24,64,41,23,28,14,14,-5,-3,-2,68%,69%,67%,101,84,124,26%,25%,27%,7,4,3,12,7,5
100,https://vlr.gg/player/10885/davih,2024-07-20 08:00:00,1.16,1.19,1.17,219,206,241,71,36,35,62,31,31,23,10,13,+3,+2,+1,73%,66%,80%,152,141,164,27%,29%,25%,6,3,3,3,1,2
101,https://vlr.gg/player/7490/anguist,2024-07-20 08:00:00,1.18,0.94,1.07,210,222,200,69,38,31,63,32,31,19,13,6,+3,+2,+1,68%,72%,63%,140,148,130,31%,31%,32%,11,7,4,8,5,3
102,https://vlr.gg/player/4329/vince,2024-07-20 08:00:00,0.96,0.81,0.89,164,175,150,53,31,22,60,31,29,28,13,15,+3,-1,+4,76%,77%,76%,108,114,100,29%,31%,27%,6,1,5,3,2,1
103,https://vlr.gg/player/1835/elllement,2024-07-20 08:00:00,0.49,1.32,0.88,200,137,277,57,21,36,65,38,27,18,9,9,-4,-8,+4,61%,51%,73%,135,92,185,20%,16%,22%,12,5,7,16,13,3
104,https://vlr.gg/player/2472/benny,2024-07-20 08:00:00,0.76,0.87,0.81,143,121,175,44,19,25,59,31,28,26,15,11,-3,-4,+1,63%,64%,61%,91,79,105,30%,29%,30%,10,3,7,13,7,6
105,https://vlr.gg/player/2658/xuss,2024-07-20 08:00:00,1.17,1.36,1.27,272,260,272,85,39,46,59,31,28,7,4,3,+5,-2,+7,72%,66%,77%,163,158,167,24%,25%,23%,19,7,12,14,9,5
106,https://vlr.gg/player/1616/starki,2024-07-20 08:00:00,1.16,1.10,1.13,202,220,183,64,34,30,55,29,26,38,19,19,-8,-8,0,73%,68%,77%,134,148,122,34%,36%,31%,6,1,5,14,9,5
107,https://vlr.gg/player/7660/fizzy,2024-07-20 08:00:00,1.06,1.11,1.09,207,199,217,64,28,36,58,28,30,21,10,11,+3,+1,+2,70%,68%,72%,143,142,144,32%,33%,31%,9,3,6,6,2,4
108,https://vlr.gg/player/3753/obnoks,2024-07-20 08:00:00,0.85,1.00,0.93,170,173,169,50,26,24,61,32,29,37,15,22,+3,+1,+2,68%,61%,74%,118,118,118,25%,27%,23%,4,2,2,1,1,0
109,https://vlr.gg/player/3674/iluri,2024-07-20 08:00:00,0.66,0.88,0.78,152,134,172,45,19,26,62,30,32,27,12,15,-5,-3,-2,67%,61%,72%,105,96,112,29%,20%,40%,5,2,3,10,5,5
110,https://vlr.gg/player/4742/smoggy,2024-07-20 04:30:00,,,,210,,,77,,,69,,,41,,,0,,,,,,143,,,27%,,,9,,,9,,
111,https://vlr.gg/player/15559/chichoo,2024-07-20 04:30:00,,,,206,,,80,,,75,,,22,,,-3,,,,,,130,,,35%,,,3,,,6,,
112,https://vlr.gg/player/13768/s1mon,2024-07-20 04:30:00,,,,205,,,79,,,68,,,34,,,+1,,,,,,136,,,37%,,,6,,,5,,
113,https://vlr.gg/player/3520/zmjjkk,2024-07-20 04:30:00,,,,204,,,77,,,82,,,20,,,-7,,,,,,131,,,24%,,,18,,,25,,
114,https://vlr.gg/player/3017/nobody,2024-07-20 04:30:00,,,,187,,,65,,,79,,,33,,,-9,,,,,,128,,,25%,,,8,,,17,,
115,https://vlr.gg/player/872/autumn,2024-07-20 04:30:00,,,,220,,,88,,,75,,,29,,,+8,,,,,,148,,,32%,,,11,,,3,,
116,https://vlr.gg/player/3028/life,2024-07-20 04:30:00,,,,214,,,76,,,80,,,16,,,+9,,,,,,132,,,28%,,,25,,,16,,
117,https://vlr.gg/player/19530/aaaay,2024-07-20 04:30:00,,,,200,,,77,,,76,,,34,,,+2,,,,,,129,,,43%,,,11,,,9,,
118,https://vlr.gg/player/37489/lysoar,2024-07-20 04:30:00,,,,183,,,67,,,69,,,34,,,-4,,,,,,121,,,24%,,,4,,,8,,
119,https://vlr.gg/player/7857/berlin,2024-07-20 04:30:00,,,,182,,,65,,,78,,,34,,,+3,,,,,,122,,,32%,,,11,,,8,,
120,https://vlr.gg/player/804/buzz,2024-07-20 04:00:00,1.08,1.22,1.15,237,213,261,92,43,49,75,40,35,11,5,6,0,-5,+5,72%,65%,78%,153,135,171,19%,22%,16%,14,5,9,14,10,4
121,https://vlr.gg/player/4462/mako,2024-07-20 04:00:00,0.68,1.48,1.08,213,168,261,79,31,48,74,44,30,40,12,28,+3,-4,+7,70%,58%,81%,136,111,163,26%,27%,26%,13,4,9,10,8,2
122,https://vlr.gg/player/35013/flashback,2024-07-20 04:00:00,0.89,1.19,1.04,205,195,217,78,35,43,73,42,31,21,7,14,+2,+2,0,69%,67%,70%,142,139,145,31%,32%,30%,12,7,5,10,5,5
123,https://vlr.gg/player/11600/foxy9,2024-07-20 04:00:00,0.85,1.06,0.96,193,182,206,70,33,37,80,44,36,51,21,30,0,+1,-1,72%,65%,80%,126,119,133,27%,27%,28%,8,3,5,8,2,6
124,https://vlr.gg/player/4678/beyn,2024-07-20 04:00:00,0.69,0.77,0.73,149,144,150,55,26,29,79,41,38,22,10,12,-4,-3,-1,67%,56%,78%,101,100,103,26%,25%,28%,8,4,4,12,7,5
125,https://vlr.gg/player/9801/f0rsaken,2024-07-20 04:00:00,0.86,1.42,1.14,237,202,272,88,34,54,79,44,35,54,28,26,+4,0,+4,72%,72%,73%,147,122,172,29%,27%,32%,13,5,8,9,5,4
126,https://vlr.gg/player/17086/something,2024-07-20 04:00:00,0.97,1.18,1.07,204,193,217,81,39,42,77,43,34,20,8,12,+6,+2,+4,70%,65%,75%,129,119,138,28%,30%,26%,17,6,11,11,4,7
127,https://vlr.gg/player/9803/d4v41,2024-07-20 04:00:00,0.87,1.16,1.02,189,172,205,69,31,38,71,38,33,50,21,29,-9,-5,-4,76%,72%,80%,132,118,147,26%,27%,25%,3,1,2,12,6,6
128,https://vlr.gg/player/9800/mindfreak,2024-07-20 04:00:00,0.87,1.07,0.97,172,171,175,70,33,37,70,40,30,35,16,19,+2,-3,+5,74%,72%,76%,108,110,106,33%,30%,37%,8,2,6,6,5,1
129,https://vlr.gg/player/7378/jinggg,2024-07-20 04:00:00,0.76,0.96,0.86,192,181,204,72,33,39,78,42,36,19,9,10,-4,-4,0,64%,57%,71%,130,119,141,22%,20%,24%,13,8,5,17,12,5
130,https://vlr.gg/player/1311/melser,2024-07-19 19:10:00,1.24,1.13,1.19,200,205,194,49,26,23,43,22,21,22,5,17,+6,+3,+3,74%,71%,78%,131,134,128,40%,35%,45%,8,4,4,2,1,1
131,https://vlr.gg/player/24007/shyy,2024-07-19 19:10:00,1.15,1.20,1.18,227,233,226,59,28,31,49,23,26,14,6,8,+2,+2,0,76%,71%,81%,162,165,159,32%,33%,30%,5,3,2,3,1,2
132,https://vlr.gg/player/8673/heat,2024-07-19 19:10:00,0.63,1.21,0.92,178,130,226,46,14,32,51,27,24,22,13,9,-1,-3,+2,70%,65%,75%,113,87,138,20%,16%,23%,5,1,4,6,4,2
133,https://vlr.gg/player/36169/mta,2024-07-19 19:10:00,0.69,1.04,0.87,171,140,204,42,16,26,48,23,25,20,10,10,-4,-2,-2,63%,62%,64%,116,94,136,29%,36%,26%,5,1,4,9,3,6
134,https://vlr.gg/player/2462/keznit,2024-07-19 19:10:00,0.71,1.03,0.87,201,172,229,46,21,25,55,27,28,17,4,13,+4,-2,+6,70%,62%,78%,138,128,148,30%,33%,28%,16,7,9,12,9,3
135,https://vlr.gg/player/4147/cryocells,2024-07-19 19:10:00,1.20,1.17,1.18,248,258,233,65,35,30,47,27,20,9,5,4,+3,+1,+2,70%,75%,65%,149,153,145,20%,23%,16%,15,8,7,12,7,5
136,https://vlr.gg/player/796/eeiu,2024-07-19 19:10:00,0.85,1.35,1.09,192,165,222,48,20,28,44,25,19,22,9,13,0,-1,+1,66%,56%,76%,122,101,144,30%,45%,23%,2,0,2,2,1,1
137,https://vlr.gg/player/3880/bang,2024-07-19 19:10:00,0.96,0.94,0.95,197,215,183,46,26,20,51,29,22,28,12,16,-4,-1,-3,77%,81%,74%,128,139,117,28%,29%,27%,3,1,2,7,2,5
138,https://vlr.gg/player/601/asuna,2024-07-19 19:10:00,0.64,1.23,0.92,186,151,223,41,16,25,49,28,21,34,18,16,-1,-3,+2,71%,61%,82%,129,105,155,19%,13%,24%,6,2,4,7,5,2
139,https://vlr.gg/player/604/boostio,2024-07-19 19:10:00,0.80,0.96,0.88,193,205,182,45,26,19,51,29,22,10,4,6,-5,-6,+1,70%,72%,68%,139,134,143,22%,25%,19%,5,2,3,10,8,2
140,https://vlr.gg/player/8549/kingg,2024-07-19 17:00:00,1.57,1.11,1.29,288,307,272,40,18,22,28,9,19,12,6,6,+5,+3,+2,80%,94%,71%,173,177,170,28%,35%,24%,7,3,4,2,0,2
141,https://vlr.gg/player/8480/aspas,2024-07-19 17:00:00,1.04,1.35,1.23,262,204,299,39,13,26,27,11,16,5,1,4,+2,0,+2,78%,69%,83%,158,134,174,24%,32%,20%,6,1,5,4,1,3
142,https://vlr.gg/player/1818/tex,2024-07-19 17:00:00,1.29,0.54,0.84,175,248,132,25,14,11,29,10,19,12,6,6,0,+3,-3,75%,81%,71%,119,161,90,30%,29%,31%,4,4,0,4,1,3
143,https://vlr.gg/player/7603/mazino,2024-07-19 17:00:00,0.56,0.71,0.65,176,178,175,23,10,13,36,14,22,17,6,11,+2,+1,+1,63%,63%,63%,120,117,123,29%,21%,36%,3,1,2,1,0,1
144,https://vlr.gg/player/619/c0m,2024-07-19 17:00:00,0.56,0.60,0.59,138,144,140,18,8,10,31,12,19,12,7,5,-1,-1,0,68%,69%,67%,91,87,93,17%,17%,16%,4,2,2,5,3,2
145,https://vlr.gg/player/4581/jonahp,2024-07-19 17:00:00,1.20,1.33,1.26,273,263,293,38,21,17,30,16,14,16,12,4,-2,0,-2,75%,79%,69%,171,162,184,27%,23%,36%,4,2,2,6,2,4
146,https://vlr.gg/player/8402/icy,2024-07-19 17:00:00,1.36,0.77,1.12,207,259,126,32,25,7,28,17,11,8,6,2,0,+1,-1,73%,83%,56%,140,166,102,23%,25%,18%,2,2,0,2,1,1
147,https://vlr.gg/player/3885/valyn,2024-07-19 17:00:00,0.97,1.19,1.06,207,196,217,31,18,13,28,17,11,13,8,5,-2,0,-2,75%,83%,63%,128,126,131,23%,21%,26%,3,1,2,5,1,4
148,https://vlr.gg/player/15500/trent,2024-07-19 17:00:00,0.80,1.00,0.88,154,119,210,22,11,11,27,14,13,12,5,7,-5,-4,-1,80%,79%,81%,104,84,134,39%,42%,36%,2,1,1,7,5,2
149,https://vlr.gg/player/7873/leaf,2024-07-19 17:00:00,1.01,0.62,0.86,206,239,159,28,20,8,32,18,14,9,4,5,+1,+1,0,63%,67%,56%,134,147,114,15%,14%,17%,5,5,0,4,4,0
150,https://vlr.gg/player/2168/trexx,2024-07-19 12:00:00,1.34,1.32,1.32,225,219,231,56,27,29,42,18,24,36,17,19,+1,-2,+3,84%,88%,80%,159,165,154,17%,19%,15%,7,1,6,6,3,3
151,https://vlr.gg/player/312/sayf,2024-07-19 12:00:00,1.28,1.28,1.28,269,288,246,73,34,39,49,24,25,15,7,8,+7,+3,+4,74%,76%,73%,174,185,165,24%,23%,24%,17,9,8,10,6,4
152,https://vlr.gg/player/21610/runner,2024-07-19 12:00:00,1.17,1.21,1.19,225,199,244,60,24,36,45,20,25,19,8,11,-2,-2,0,80%,79%,80%,149,139,157,25%,21%,28%,4,1,3,6,3,3
153,https://vlr.gg/player/4321/cender,2024-07-19 12:00:00,0.92,1.07,1.00,198,195,192,53,24,29,53,25,28,37,14,23,-7,-2,-5,70%,70%,71%,124,119,128,28%,31%,26%,5,2,3,12,4,8
154,https://vlr.gg/player/11134/kicks,2024-07-19 12:00:00,0.99,0.81,0.89,165,168,160,43,21,22,50,20,30,35,12,23,+1,0,+1,76%,76%,76%,112,111,112,22%,22%,22%,4,2,2,3,2,1
155,https://vlr.gg/player/21328/wo0t,2024-07-19 12:00:00,1.44,1.10,1.29,250,270,230,65,38,27,57,29,28,28,17,11,+11,+5,+6,77%,78%,76%,165,177,149,43%,39%,49%,11,5,6,0,0,0
156,https://vlr.gg/player/10971/riens,2024-07-19 12:00:00,0.92,1.08,0.98,200,191,217,53,27,26,55,31,24,27,15,12,-1,0,-1,74%,76%,73%,133,126,141,38%,44%,33%,5,3,2,6,3,3
157,https://vlr.gg/player/18350/miniboo,2024-07-19 12:00:00,0.63,1.05,0.82,210,171,250,50,23,27,65,37,28,24,9,15,-2,-2,0,74%,76%,73%,140,110,178,37%,43%,33%,12,8,4,14,10,4
158,https://vlr.gg/player/29873/benjyfishy,2024-07-19 12:00:00,0.91,0.66,0.79,123,145,102,38,24,14,50,25,25,8,5,3,-4,-2,-2,62%,68%,55%,91,103,76,39%,41%,36%,2,1,1,6,3,3
159,https://vlr.gg/player/1144/boo,2024-07-19 12:00:00,0.70,0.59,0.64,120,144,100,33,20,13,58,33,25,30,19,11,-4,-4,0,68%,63%,73%,84,100,64,39%,36%,44%,7,2,5,11,6,5
160,https://vlr.gg/player/1429/d0rf,2024-07-19 08:10:00,1.97,1.57,1.80,295,342,222,35,24,11,11,6,5,15,5,10,+1,+1,0,84%,83%,86%,192,227,147,29%,33%,21%,2,2,0,1,1,0
161,https://vlr.gg/player/8240/alyal,2024-07-19 08:10:00,1.72,1.28,1.53,279,272,291,34,19,15,16,6,10,11,7,4,-3,-2,-1,84%,83%,86%,179,173,186,40%,41%,39%,0,0,0,3,2,1
162,https://vlr.gg/player/8036/k1llers,2024-07-19 08:10:00,1.13,1.70,1.38,228,172,327,29,11,18,17,8,9,9,5,4,+6,+1,+5,88%,94%,79%,160,122,209,22%,16%,27%,9,3,6,3,2,1
163,https://vlr.gg/player/14207/viness,2024-07-19 08:10:00,1.20,0.93,1.08,204,208,189,21,12,9,19,10,9,16,11,5,+2,0,+2,81%,83%,79%,134,139,127,24%,20%,35%,5,2,3,3,2,1
164,https://vlr.gg/player/14213/ting2k5,2024-07-19 08:10:00,1.42,0.61,1.06,167,217,103,21,16,5,14,6,8,6,5,1,+2,+2,0,69%,83%,50%,103,130,69,23%,21%,30%,4,3,1,2,1,1
165,https://vlr.gg/player/44144/rageee,2024-07-19 08:10:00,1.04,0.87,0.94,229,221,227,24,11,13,27,10,17,4,2,2,-2,-1,-1,59%,71%,50%,140,134,145,35%,30%,39%,2,1,1,4,2,2
166,https://vlr.gg/player/14562/fuzzie,2024-07-19 08:10:00,0.93,0.74,0.81,174,188,154,18,10,8,28,12,16,5,2,3,+3,+1,+2,66%,71%,61%,112,123,103,23%,24%,22%,7,2,5,4,1,3
167,https://vlr.gg/player/37639/hyuse,2024-07-19 08:10:00,1.15,0.20,0.60,138,223,88,15,11,4,28,12,16,5,2,3,-2,-1,-1,53%,64%,44%,104,160,61,33%,33%,33%,2,1,1,4,2,2
168,https://vlr.gg/player/37638/shaun,2024-07-19 08:10:00,0.64,0.35,0.48,109,108,109,11,5,6,27,10,17,3,1,2,-1,-1,0,44%,50%,39%,81,80,81,31%,22%,39%,0,0,0,1,1,0
169,https://vlr.gg/player/16967/namgoku,2024-07-19 08:10:00,0.15,0.18,0.16,103,119,89,9,4,5,30,14,16,4,3,1,-6,-4,-2,41%,43%,39%,71,84,62,21%,17%,25%,1,0,1,7,4,3
170,https://vlr.gg/player/14674/kntz,2024-07-19 07:00:00,1.21,1.25,1.23,225,213,239,74,36,38,54,26,28,21,12,9,+3,+2,+1,77%,75%,79%,142,127,158,34%,40%,29%,6,2,4,3,0,3
171,https://vlr.gg/player/27244/seph1roth,2024-07-19 07:00:00,1.15,1.23,1.19,213,196,236,65,30,35,53,28,25,16,7,9,+4,+2,+2,70%,64%,76%,147,134,161,40%,41%,40%,11,4,7,7,2,5
172,https://vlr.gg/player/24679/cgrs,2024-07-19 07:00:00,1.15,1.13,1.14,207,205,210,62,32,30,53,28,25,21,11,10,+1,0,+1,78%,80%,76%,145,141,150,27%,25%,29%,1,0,1,0,0,0
173,https://vlr.gg/player/13784/killua,2024-07-19 07:00:00,1.02,1.02,1.02,258,258,257,79,40,39,66,34,32,10,6,4,0,-6,+6,59%,57%,62%,161,160,163,40%,37%,44%,12,3,9,12,9,3
174,https://vlr.gg/player/12098/kadoom,2024-07-19 07:00:00,0.75,0.76,0.73,190,212,154,54,32,22,66,36,30,18,8,10,-10,-6,-4,56%,55%,57%,117,136,97,25%,28%,21%,12,9,3,22,15,7
175,https://vlr.gg/player/3342/sushiboys,2024-07-19 07:00:00,0.92,1.05,0.99,205,197,215,61,30,31,66,33,33,23,12,11,+2,0,+2,72%,67%,77%,137,131,143,23%,17%,28%,5,2,3,3,2,1
176,https://vlr.gg/player/3401/ptc,2024-07-19 07:00:00,1.27,0.69,0.97,161,188,139,49,29,20,56,24,32,23,12,11,-2,-1,-1,65%,64%,66%,110,122,98,39%,41%,38%,5,2,3,7,3,4
177,https://vlr.gg/player/4377/johnolsen,2024-07-19 07:00:00,0.59,1.12,0.86,208,157,261,66,24,42,75,38,37,10,4,6,+4,-5,+9,63%,55%,70%,130,96,163,39%,52%,34%,16,4,12,12,9,3
178,https://vlr.gg/player/27254/leviathan,2024-07-19 07:00:00,0.92,0.79,0.85,200,215,192,62,32,30,73,36,37,19,12,7,-1,-4,+3,65%,67%,64%,133,139,127,32%,36%,29%,7,2,5,8,6,2
179,https://vlr.gg/player/6723/foxz,2024-07-19 07:00:00,0.74,0.85,0.80,175,175,175,54,26,28,68,36,32,14,7,7,-1,+4,-5,60%,57%,64%,122,119,124,28%,23%,34%,11,8,3,12,4,8
180,https://vlr.gg/player/23976/crus,2024-07-19 06:00:00,1.63,1.53,1.57,277,270,282,42,15,27,21,9,12,13,6,7,+5,+1,+4,90%,88%,92%,179,186,175,46%,43%,49%,7,2,5,2,1,1
181,https://vlr.gg/player/1437/yesican,2024-07-19 06:00:00,1.39,1.67,1.56,257,167,320,36,11,25,18,7,11,22,4,18,+5,+1,+4,90%,94%,88%,173,123,207,37%,32%,39%,6,1,5,1,0,1
182,https://vlr.gg/player/46463/twilight,2024-07-19 06:00:00,1.13,1.08,1.10,157,182,142,23,10,13,19,9,10,18,4,14,-1,+1,-2,80%,75%,83%,105,121,93,38%,45%,33%,2,2,0,3,1,2
183,https://vlr.gg/player/8225/f1cio,2024-07-19 06:00:00,0.62,1.38,1.07,229,171,266,32,10,22,26,14,12,15,4,11,0,-1,+1,80%,75%,83%,155,115,182,38%,40%,37%,4,2,2,4,3,1
184,https://vlr.gg/player/14254/gin,2024-07-19 06:00:00,0.59,1.18,0.94,195,181,201,27,10,17,27,16,11,5,2,3,+3,-2,+5,75%,50%,92%,125,114,132,36%,43%,31%,7,1,6,4,3,1
185,https://vlr.gg/player/14587/daft,2024-07-19 06:00:00,0.92,0.99,0.94,223,233,206,28,16,12,32,22,10,12,6,6,0,0,0,68%,67%,69%,151,162,134,29%,31%,25%,3,2,1,3,2,1
186,https://vlr.gg/player/44149/pr0digy,2024-07-19 06:00:00,0.89,0.87,0.88,195,174,224,24,13,11,31,19,12,6,5,1,-6,-5,-1,55%,50%,63%,122,114,136,25%,26%,24%,4,2,2,10,7,3
187,https://vlr.gg/player/14209/suka,2024-07-19 06:00:00,0.49,1.47,0.87,187,133,275,27,10,17,32,21,11,12,5,7,-3,-3,0,58%,46%,75%,123,87,175,24%,16%,32%,2,0,2,5,3,2
188,https://vlr.gg/player/23042/tripciew,2024-07-19 06:00:00,0.58,1.05,0.77,149,104,226,19,8,11,31,20,11,7,3,4,+1,0,+1,60%,50%,75%,106,71,157,30%,19%,39%,4,2,2,3,2,1
189,https://vlr.gg/player/14553/b-nhmj,2024-07-19 06:00:00,0.42,0.18,0.32,78,92,57,12,9,3,34,22,12,5,4,1,-4,-4,0,48%,42%,56%,49,55,39,26%,32%,20%,1,0,1,5,4,1
190,https://vlr.gg/player/44251/dignified,2024-07-19 05:00:00,1.27,1.41,1.35,231,220,238,34,13,21,27,10,17,20,7,13,+1,+1,0,73%,69%,75%,148,149,147,42%,35%,46%,2,1,1,1,0,1
191,https://vlr.gg/player/35027/owen-q-t,2024-07-19 05:00:00,1.50,0.71,1.02,210,287,161,31,18,13,30,11,19,11,2,9,-3,0,-3,75%,75%,75%,140,186,108,31%,29%,34%,2,1,1,5,1,4
192,https://vlr.gg/player/35020/aeonyx,2024-07-19 05:00:00,1.02,0.62,0.78,170,200,155,21,10,11,33,12,21,6,2,4,0,+1,-1,50%,63%,42%,123,140,111,22%,26%,19%,4,2,2,4,1,3
193,https://vlr.gg/player/35028/fallx,2024-07-19 05:00:00,0.24,1.09,0.69,167,65,239,24,3,21,33,14,19,5,3,2,-4,-2,-2,58%,50%,63%,114,57,152,25%,18%,27%,3,1,2,7,3,4
194,https://vlr.gg/player/44250/dizzyfps,2024-07-19 05:00:00,0.34,0.70,0.55,150,114,172,19,6,13,35,14,21,11,3,8,-4,-2,-2,60%,50%,67%,101,90,108,26%,19%,31%,4,2,2,8,4,4
195,https://vlr.gg/player/9737/kakarot,2024-07-19 05:00:00,1.28,1.62,1.42,301,293,313,41,24,17,26,16,10,14,6,8,+6,+4,+2,85%,83%,88%,193,188,201,28%,36%,19%,7,4,3,1,0,1
196,https://vlr.gg/player/16953/zynd,2024-07-19 05:00:00,1.33,0.96,1.18,255,308,177,36,26,10,28,17,11,8,4,4,+5,+6,-1,73%,71%,75%,160,187,119,38%,47%,25%,8,7,1,3,1,2
197,https://vlr.gg/player/13744/patmen,2024-07-19 05:00:00,1.10,1.12,1.11,253,263,231,37,23,14,28,18,10,10,4,6,-1,0,-1,73%,71%,75%,156,169,138,32%,33%,31%,5,4,1,6,4,2
198,https://vlr.gg/player/7746/kevzii,2024-07-19 05:00:00,1.03,1.22,1.11,175,171,179,24,14,10,22,14,8,16,10,6,0,-1,+1,83%,83%,81%,119,118,119,24%,20%,29%,2,0,2,2,1,1
199,https://vlr.gg/player/21677/jeee,2024-07-19 05:00:00,0.76,0.99,0.85,143,115,189,20,10,10,25,14,11,14,8,6,0,-1,+1,70%,71%,69%,88,71,114,13%,16%,10%,3,1,2,3,2,1
200,https://vlr.gg/player/37494/kai,2024-07-19 04:00:00,,,,255,,,104,,,79,,,10,,,+9,,,,,,162,,,27%,,,19,,,10,,
201,https://vlr.gg/player/4770/fengf,2024-07-19 04:00:00,,,,191,,,73,,,85,,,13,,,-1,,,,,,129,,,20%,,,14,,,15,,
202,https://vlr.gg/player/3045/luok1ng,2024-07-19 04:00:00,,,,171,,,66,,,72,,,43,,,-4,,,,,,107,,,29%,,,3,,,7,,
203,https://vlr.gg/player/4712/heybay,2024-07-19 04:00:00,,,,165,,,60,,,73,,,47,,,-2,,,,,,105,,,20%,,,9,,,11,,
204,https://vlr.gg/player/3021/biank,2024-07-19 04:00:00,,,,163,,,63,,,83,,,27,,,-5,,,,,,107,,,21%,,,8,,,13,,
205,https://vlr.gg/player/37489/lysoar,2024-07-19 04:00:00,,,,226,,,88,,,71,,,38,,,+5,,,,,,149,,,32%,,,9,,,4,,
206,https://vlr.gg/player/3028/life,2024-07-19 04:00:00,,,,217,,,83,,,80,,,18,,,+2,,,,,,141,,,36%,,,23,,,21,,
207,https://vlr.gg/player/19530/aaaay,2024-07-19 04:00:00,,,,207,,,82,,,69,,,32,,,-2,,,,,,143,,,45%,,,3,,,5,,
208,https://vlr.gg/player/872/autumn,2024-07-19 04:00:00,,,,184,,,68,,,74,,,26,,,+3,,,,,,119,,,33%,,,9,,,6,,
209,https://vlr.gg/player/7857/berlin,2024-07-19 04:00:00,,,,179,,,71,,,72,,,40,,,-5,,,,,,113,,,28%,,,12,,,17,,
210,https://vlr.gg/player/33801/loydream,2024-07-19 03:00:00,1.40,1.57,1.48,314,306,329,51,26,25,29,16,13,11,7,4,+7,+3,+4,84%,83%,85%,197,194,200,17%,17%,17%,11,4,7,4,1,3
211,https://vlr.gg/player/24737/par-scofield,2024-07-19 03:00:00,1.47,1.20,1.35,294,302,268,46,28,18,32,18,14,8,5,3,+3,+1,+2,80%,79%,80%,190,200,179,29%,27%,30%,7,4,3,4,3,1
212,https://vlr.gg/player/26143/secondlove,2024-07-19 03:00:00,0.59,1.91,1.19,216,162,289,35,14,21,28,19,9,14,8,6,-3,-3,0,73%,71%,75%,147,107,195,23%,15%,31%,1,1,0,4,4,0
213,https://vlr.gg/player/21793/syko,2024-07-19 03:00:00,0.94,0.93,0.93,184,185,189,27,14,13,32,18,14,22,14,8,0,0,0,77%,79%,75%,122,119,127,29%,29%,29%,2,1,1,2,1,1
214,https://vlr.gg/player/44246/repulsive,2024-07-19 03:00:00,1.16,0.59,0.90,162,221,90,21,17,4,29,15,14,31,18,13,+1,+3,-2,84%,88%,80%,106,141,65,17%,16%,19%,5,4,1,4,1,3
215,https://vlr.gg/player/44259/patrickwho,2024-07-19 03:00:00,0.91,1.38,1.17,286,247,323,44,18,26,38,17,21,7,1,6,-1,0,-1,68%,60%,75%,178,157,196,23%,22%,23%,6,2,4,7,2,5
216,https://vlr.gg/player/10249/uyen,2024-07-19 03:00:00,0.63,1.21,0.95,210,171,243,30,10,20,36,17,19,12,6,6,+3,+2,+1,61%,50%,71%,148,124,168,19%,17%,20%,6,3,3,3,1,2
217,https://vlr.gg/player/31398/ichisolo,2024-07-19 03:00:00,1.03,0.66,0.83,185,211,166,25,13,12,36,15,21,8,4,4,-2,+1,-3,64%,60%,67%,131,143,121,19%,20%,19%,2,2,0,4,1,3
218,https://vlr.gg/player/7435/astr0,2024-07-19 03:00:00,0.79,0.84,0.82,178,191,168,25,13,12,35,16,19,25,9,16,-3,-3,0,73%,70%,75%,119,131,108,27%,32%,23%,2,1,1,5,4,1
219,https://vlr.gg/player/37375/chanyboi,2024-07-19 03:00:00,0.58,0.99,0.80,167,121,206,25,10,15,35,16,19,21,3,18,-5,-4,-1,64%,50%,75%,118,83,147,31%,36%,29%,2,0,2,7,4,3
220,https://vlr.gg/player/15500/trent,2024-07-18 18:55:00,1.36,1.35,1.35,239,240,242,34,13,21,23,9,14,20,12,8,+4,+1,+3,88%,82%,92%,165,158,170,21%,28%,18%,7,3,4,3,2,1
221,https://vlr.gg/player/4581/jonahp,2024-07-18 18:55:00,1.38,1.27,1.32,263,231,270,39,16,23,26,11,15,8,3,5,+3,+2,+1,80%,82%,79%,162,129,186,33%,48%,28%,5,2,3,2,0,2
222,https://vlr.gg/player/3885/valyn,2024-07-18 18:55:00,1.07,1.46,1.30,216,165,253,33,11,22,25,11,14,17,6,11,+2,0,+2,88%,82%,92%,146,109,172,21%,18%,23%,2,0,2,0,0,0
223,https://vlr.gg/player/7873/leaf,2024-07-18 18:55:00,1.28,1.06,1.15,231,256,209,38,17,21,25,10,15,5,2,3,+3,+2,+1,73%,76%,71%,152,166,142,23%,18%,28%,4,3,1,1,1,0
224,https://vlr.gg/player/8402/icy,2024-07-18 18:55:00,0.67,0.68,0.68,160,157,170,22,9,13,32,13,19,11,3,8,-1,+1,-2,66%,59%,71%,106,96,113,11%,10%,12%,7,3,4,8,2,6
225,https://vlr.gg/player/3880/bang,2024-07-18 18:55:00,1.10,0.73,0.95,198,208,188,29,18,11,31,17,14,16,10,6,-1,0,-1,71%,71%,71%,130,132,127,36%,33%,41%,3,2,1,4,2,2
226,https://vlr.gg/player/604/boostio,2024-07-18 18:55:00,1.06,0.60,0.87,189,203,152,26,18,8,33,20,13,14,6,8,-2,-3,+1,59%,54%,65%,128,147,100,25%,29%,20%,5,3,2,7,6,1
227,https://vlr.gg/player/4147/cryocells,2024-07-18 18:55:00,0.72,1.07,0.86,237,216,290,35,17,18,36,22,14,5,5,0,-2,-2,0,66%,67%,65%,142,132,157,24%,23%,24%,4,1,3,6,3,3
228,https://vlr.gg/player/796/eeiu,2024-07-18 18:55:00,0.56,1.11,0.79,151,118,200,21,9,12,32,21,11,11,7,4,-1,0,-1,63%,54%,76%,101,80,130,33%,36%,30%,1,1,0,2,1,1
229,https://vlr.gg/player/601/asuna,2024-07-18 18:55:00,0.72,0.49,0.60,149,177,125,20,16,4,36,21,15,11,4,7,-5,0,-5,68%,71%,65%,104,110,97,26%,28%,23%,3,3,0,8,3,5
230,https://vlr.gg/player/8480/aspas,2024-07-18 17:00:00,1.91,1.62,1.69,330,411,301,40,13,27,15,4,11,6,1,5,+11,+4,+7,84%,88%,83%,215,256,201,33%,50%,26%,11,4,7,0,0,0
231,https://vlr.gg/player/1818/tex,2024-07-18 17:00:00,2.00,1.47,1.60,286,342,264,37,11,26,15,5,10,7,1,6,+4,+2,+2,97%,100%,96%,192,232,179,42%,48%,40%,6,2,4,2,0,2
232,https://vlr.gg/player/8549/kingg,2024-07-18 17:00:00,1.13,1.60,1.48,219,159,241,29,5,24,11,4,7,11,3,8,+1,0,+1,91%,88%,92%,142,87,161,30%,22%,33%,2,0,2,1,0,1
233,https://vlr.gg/player/619/c0m,2024-07-18 17:00:00,1.05,1.18,1.15,173,115,196,18,2,16,13,3,10,15,7,8,+2,-1,+3,88%,100%,83%,125,91,136,17%,25%,15%,3,0,3,1,1,0
234,https://vlr.gg/player/7603/mazino,2024-07-18 17:00:00,0.89,1.21,1.13,194,156,207,21,5,16,17,5,12,18,6,12,+2,-1,+3,88%,88%,88%,128,95,139,26%,25%,26%,4,0,4,2,1,1
235,https://vlr.gg/player/24007/shyy,2024-07-18 17:00:00,0.65,0.82,0.70,172,159,210,17,12,5,29,22,7,3,1,2,-3,-1,-2,56%,50%,75%,119,111,141,32%,34%,26%,1,1,0,4,2,2
236,https://vlr.gg/player/1311/melser,2024-07-18 17:00:00,0.72,0.59,0.69,151,153,145,15,11,4,28,21,7,12,9,3,-3,-2,-1,63%,63%,63%,101,97,112,29%,30%,25%,1,1,0,4,3,1
237,https://vlr.gg/player/2462/keznit,2024-07-18 17:00:00,0.64,0.65,0.64,191,192,191,19,14,5,30,23,7,5,4,1,-7,-7,0,56%,54%,63%,128,127,130,31%,36%,20%,4,2,2,11,9,2
238,https://vlr.gg/player/36169/mta,2024-07-18 17:00:00,0.57,0.58,0.56,102,105,96,11,8,3,28,21,7,5,4,1,-2,-1,-1,44%,50%,25%,70,73,63,31%,42%,0%,0,0,0,2,1,1
239,https://vlr.gg/player/8673/heat,2024-07-18 17:00:00,0.23,0.63,0.33,80,63,138,9,5,4,30,22,8,5,3,2,-5,-5,0,41%,33%,63%,63,44,118,22%,16%,31%,0,0,0,5,5,0
240,https://vlr.gg/player/37639/hyuse,2024-07-18 08:00:00,0.94,1.52,1.26,270,235,308,63,24,39,46,22,24,16,6,10,+2,+4,-2,71%,69%,72%,181,139,215,24%,28%,21%,15,11,4,13,7,6
241,https://vlr.gg/player/16967/namgoku,2024-07-18 08:00:00,1.15,0.79,0.95,203,219,180,47,23,24,49,21,28,16,11,5,-1,-1,0,71%,76%,67%,133,145,123,40%,39%,41%,5,2,3,6,3,3
242,https://vlr.gg/player/37638/shaun,2024-07-18 08:00:00,0.85,0.98,0.92,170,143,192,38,14,24,41,18,23,11,4,7,0,0,0,63%,52%,72%,112,99,122,26%,19%,33%,1,0,1,1,0,1
243,https://vlr.gg/player/44144/rageee,2024-07-18 08:00:00,1.06,0.81,0.92,201,240,160,49,26,23,46,22,24,12,2,10,-6,0,-6,65%,72%,58%,126,161,98,28%,30%,26%,5,3,2,11,3,8
244,https://vlr.gg/player/14562/fuzzie,2024-07-18 08:00:00,0.68,1.08,0.90,172,135,195,37,14,23,46,22,24,27,12,15,+4,0,+4,72%,62%,81%,108,96,117,25%,23%,26%,6,0,6,2,0,2
245,https://vlr.gg/player/1433/hyzee,2024-07-18 08:00:00,1.42,1.16,1.30,242,264,222,56,35,21,43,24,19,21,7,14,0,+2,-2,75%,78%,72%,161,179,139,28%,33%,21%,5,3,2,5,1,4
246,https://vlr.gg/player/1431/p1na,2024-07-18 08:00:00,1.05,1.27,1.15,225,223,222,51,28,23,46,28,18,22,13,9,-1,0,-1,74%,69%,79%,141,144,138,35%,38%,32%,4,4,0,5,4,1
247,https://vlr.gg/player/14227/nhatthong2k,2024-07-18 08:00:00,0.87,1.25,1.04,233,206,277,54,28,26,52,29,23,10,5,5,+5,+4,+1,71%,72%,69%,158,131,192,41%,35%,48%,15,10,5,10,6,4
248,https://vlr.gg/player/23041/louboutin,2024-07-18 08:00:00,0.79,0.81,0.80,168,183,149,38,22,16,47,27,20,10,6,4,-3,-2,-1,66%,64%,69%,116,127,104,26%,27%,25%,4,2,2,7,4,3
249,https://vlr.gg/player/14216/vizzz,2024-07-18 08:00:00,0.56,0.85,0.69,123,94,169,27,10,17,47,26,21,28,15,13,0,0,0,68%,72%,62%,91,70,117,30%,24%,35%,5,1,4,5,1,4
250,https://vlr.gg/player/7426/juicy,2024-07-18 07:00:00,1.79,1.29,1.56,272,317,225,65,41,24,34,18,16,24,15,9,+10,+6,+4,83%,82%,83%,168,199,134,20%,22%,17%,13,7,6,3,1,2
251,https://vlr.gg/player/34032/grumble,2024-07-18 07:00:00,1.17,1.56,1.35,272,208,337,64,27,37,40,19,21,11,6,5,+1,-2,+3,78%,79%,77%,180,141,225,39%,46%,34%,3,0,3,2,2,0
252,https://vlr.gg/player/24628/wayne,2024-07-18 07:00:00,0.95,1.35,1.14,198,163,238,47,21,26,36,21,15,21,12,9,+4,+1,+3,78%,79%,77%,139,121,159,26%,26%,26%,5,1,4,1,0,1
253,https://vlr.gg/player/11704/styron,2024-07-18 07:00:00,1.03,0.94,0.99,144,156,133,33,19,14,31,16,15,25,14,11,+3,+2,+1,78%,74%,83%,104,106,102,25%,25%,23%,6,3,3,3,1,2
254,https://vlr.gg/player/24653/vera,2024-07-18 07:00:00,1.03,0.64,0.85,212,284,130,45,33,12,47,26,21,12,6,6,-2,+3,-5,70%,71%,70%,131,166,92,20%,23%,16%,13,11,2,15,8,7
255,https://vlr.gg/player/7513/markl,2024-07-18 07:00:00,0.96,1.05,1.01,200,197,199,43,22,21,48,22,26,18,6,12,-4,-3,-1,67%,70%,65%,126,118,133,23%,24%,22%,1,1,0,5,4,1
256,https://vlr.gg/player/3480/thedoctorr,2024-07-18 07:00:00,0.87,0.96,0.92,176,160,191,42,17,25,49,21,28,16,7,9,-1,0,-1,63%,60%,65%,117,98,134,36%,33%,39%,6,3,3,7,3,4
257,https://vlr.gg/player/45876/fixy,2024-07-18 07:00:00,0.80,0.78,0.79,183,208,165,38,20,18,53,25,28,17,7,10,-1,+1,-2,58%,57%,59%,124,140,110,17%,19%,16%,11,5,6,12,4,8
258,https://vlr.gg/player/2378/subbey,2024-07-18 07:00:00,0.90,0.62,0.75,165,174,159,34,17,17,54,23,31,18,7,11,-2,0,-2,55%,57%,53%,103,106,100,26%,25%,27%,2,1,1,4,1,3
259,https://vlr.gg/player/21051/jans0n,2024-07-18 07:00:00,0.59,0.73,0.66,137,119,155,31,12,19,50,22,28,17,7,10,-8,-4,-4,59%,57%,62%,90,79,99,30%,35%,27%,4,2,2,12,6,6
260,https://vlr.gg/player/23930/potter,2024-07-18 07:00:00,1.40,0.90,1.15,268,335,202,95,59,36,80,39,41,13,8,5,+14,+13,+1,71%,78%,63%,167,208,126,27%,28%,24%,30,21,9,16,8,8
261,https://vlr.gg/player/2368/b3ta,2024-07-18 07:00:00,1.07,1.00,1.03,214,214,207,72,38,34,77,37,40,39,22,17,+4,-3,+7,72%,76%,67%,141,145,138,28%,24%,32%,10,2,8,6,5,1
262,https://vlr.gg/player/2366/alert,2024-07-18 07:00:00,1.10,0.77,0.93,181,219,149,63,40,23,71,33,38,19,3,16,-2,+1,-3,67%,71%,63%,126,150,102,27%,30%,24%,8,5,3,10,4,6
263,https://vlr.gg/player/10791/bnwgiggs,2024-07-18 07:00:00,0.73,1.10,0.92,173,121,224,61,20,41,73,35,38,51,32,19,+3,+3,0,70%,71%,69%,109,82,136,20%,15%,24%,5,3,2,2,0,2
264,https://vlr.gg/player/12289/siraww,2024-07-18 07:00:00,0.73,0.70,0.71,144,149,147,53,25,28,76,38,38,21,11,10,-11,-3,-8,59%,57%,61%,104,112,97,23%,20%,27%,2,0,2,13,3,10
265,https://vlr.gg/player/6723/foxz,2024-07-18 07:00:00,1.32,1.07,1.20,236,256,219,85,48,37,69,31,38,28,12,16,+1,0,+1,81%,82%,80%,159,165,153,30%,28%,32%,6,4,2,5,4,1
266,https://vlr.gg/player/3401/ptc,2024-07-18 07:00:00,1.21,1.08,1.15,210,214,213,79,40,39,65,31,34,26,13,13,+3,+6,-3,70%,71%,69%,140,137,143,35%,38%,32%,9,7,2,6,1,5
267,https://vlr.gg/player/27254/leviathan,2024-07-18 07:00:00,0.97,1.17,1.07,211,183,234,74,32,42,64,31,33,28,13,15,-3,+1,-4,78%,88%,69%,139,124,154,38%,47%,33%,10,5,5,13,4,9
268,https://vlr.gg/player/4377/johnolsen,2024-07-18 07:00:00,1.04,0.89,0.97,219,248,183,76,45,31,77,37,40,18,7,11,-7,-3,-4,69%,71%,67%,155,174,136,24%,28%,19%,15,9,6,22,12,10
269,https://vlr.gg/player/3342/sushiboys,2024-07-18 07:00:00,0.94,0.96,0.95,180,173,193,63,30,33,69,32,37,42,28,14,-2,-1,-1,70%,76%,63%,112,100,123,24%,18%,28%,7,2,5,9,3,6
270,https://vlr.gg/player/14213/ting2k5,2024-07-18 06:00:00,1.58,1.24,1.49,249,302,111,33,28,5,14,13,1,2,2,0,+1,0,+1,85%,79%,100%,168,202,79,32%,35%,0%,3,2,1,2,2,0
271,https://vlr.gg/player/14207/viness,2024-07-18 06:00:00,1.48,1.35,1.45,273,269,284,34,24,10,18,13,5,15,10,5,-2,-2,0,94%,92%,100%,175,176,174,28%,29%,25%,2,1,1,4,3,1
272,https://vlr.gg/player/1429/d0rf,2024-07-18 06:00:00,1.16,1.86,1.35,192,164,254,24,14,10,13,11,2,7,6,1,+2,+2,0,85%,79%,100%,132,123,156,36%,31%,45%,3,3,0,1,1,0
273,https://vlr.gg/player/8036/k1llers,2024-07-18 06:00:00,0.98,2.24,1.33,285,232,411,33,21,12,21,17,4,17,9,8,+2,-1,+3,85%,79%,100%,193,156,292,26%,27%,24%,6,3,3,4,4,0
274,https://vlr.gg/player/8240/alyal,2024-07-18 06:00:00,1.12,1.41,1.20,187,170,227,23,15,8,18,13,5,15,10,5,+2,+1,+1,85%,83%,89%,124,116,147,24%,32%,13%,5,3,2,3,2,1
275,https://vlr.gg/player/36101/acerola,2024-07-18 06:00:00,0.55,0.94,0.83,185,119,196,21,4,17,29,9,20,9,1,8,-3,-1,-2,61%,44%,67%,107,79,117,24%,23%,24%,0,0,0,3,1,2
276,https://vlr.gg/player/14228/moefcute,2024-07-18 06:00:00,0.32,0.81,0.66,160,123,183,18,3,15,29,9,20,8,2,6,-3,-3,0,61%,56%,63%,101,76,110,23%,11%,30%,6,2,4,9,5,4
277,https://vlr.gg/player/1432/ntk,2024-07-18 06:00:00,0.51,0.70,0.65,161,142,173,17,4,13,30,9,21,6,0,6,+2,0,+2,52%,33%,58%,112,98,118,13%,6%,16%,6,0,6,4,0,4
278,https://vlr.gg/player/14224/duct,2024-07-18 06:00:00,0.41,0.75,0.64,147,130,158,15,3,12,29,9,20,12,1,11,0,0,0,55%,44%,58%,102,96,104,41%,38%,42%,0,0,0,0,0,0
279,https://vlr.gg/player/3908/akashi,2024-07-18 06:00:00,0.22,0.68,0.53,117,84,144,13,3,10,30,9,21,12,0,12,-1,-1,0,52%,22%,63%,81,35,98,20%,11%,23%,2,0,2,3,1,2
280,https://vlr.gg/player/4475/benecia,2024-07-18 06:00:00,1.10,0.97,1.04,201,220,177,37,21,16,37,20,17,16,11,5,+1,-1,+2,68%,69%,67%,117,123,112,31%,25%,40%,5,2,3,4,3,1
281,https://vlr.gg/player/4657/moves,2024-07-18 06:00:00,0.91,0.98,0.94,196,176,221,33,17,16,37,18,19,21,10,11,0,0,0,76%,81%,71%,135,119,153,23%,18%,26%,3,1,2,3,1,2
282,https://vlr.gg/player/20879/sungjin,2024-07-18 06:00:00,1.00,0.87,0.94,194,219,169,19,10,9,20,10,10,5,3,2,-2,0,-2,64%,71%,57%,129,145,114,27%,29%,24%,1,1,0,3,1,2
283,https://vlr.gg/player/37535/jaebin,2024-07-18 06:00:00,0.96,0.85,0.91,197,230,167,33,19,14,39,21,18,15,8,7,+2,+5,-3,64%,73%,54%,136,159,111,23%,26%,18%,11,9,2,9,4,5
284,https://vlr.gg/player/13000/redlight,2024-07-18 06:00:00,0.87,0.91,0.89,190,172,210,33,16,17,41,19,22,7,5,2,+1,-1,+2,64%,65%,63%,128,121,135,28%,24%,33%,3,0,3,2,1,1
285,https://vlr.gg/player/9192/cloudy,2024-07-18 06:00:00,0.87,0.13,0.53,112,184,26,9,9,0,18,10,8,6,2,4,-4,-1,-3,68%,75%,60%,74,117,21,25%,29%,14%,1,1,0,5,2,3
286,https://vlr.gg/player/24979/cloy,2024-07-18 06:00:00,1.32,1.02,1.17,230,235,222,40,19,21,33,14,19,27,20,7,-1,+1,-2,84%,92%,77%,155,159,152,36%,31%,43%,2,1,1,3,0,3
287,https://vlr.gg/player/25081/yoman,2024-07-18 06:00:00,1.37,0.94,1.15,183,203,157,33,19,14,25,10,15,15,8,7,-4,+1,-5,84%,88%,81%,123,136,111,16%,19%,12%,2,1,1,6,0,6
288,https://vlr.gg/player/42772/xross,2024-07-18 06:00:00,1.13,1.14,1.13,187,175,208,36,16,20,31,13,18,29,15,14,-1,-2,+1,80%,92%,69%,123,121,126,28%,28%,29%,1,0,1,2,2,0
289,https://vlr.gg/player/25048/sid,2024-07-18 06:00:00,0.99,1.18,1.09,226,207,230,38,17,21,32,15,17,6,4,2,+3,0,+3,74%,79%,69%,144,133,155,22%,25%,20%,9,3,6,6,3,3
290,https://vlr.gg/player/28401/pkm,2024-07-18 06:00:00,1.17,0.94,1.05,261,279,256,45,23,22,43,20,23,15,6,9,+5,+4,+1,78%,75%,81%,160,171,150,28%,26%,30%,12,9,3,7,5,2
291,https://vlr.gg/player/872/autumn,2024-07-18 05:50:00,,,,270,,,61,,,40,,,22,,,+7,,,,,,174,,,34%,,,12,,,5,,
292,https://vlr.gg/player/3028/life,2024-07-18 05:50:00,,,,260,,,60,,,48,,,8,,,+13,,,,,,155,,,27%,,,18,,,5,,
293,https://vlr.gg/player/37489/lysoar,2024-07-18 05:50:00,,,,195,,,43,,,37,,,16,,,-1,,,,,,120,,,27%,,,5,,,6,,
294,https://vlr.gg/player/7857/berlin,2024-07-18 05:50:00,,,,193,,,42,,,42,,,25,,,-3,,,,,,134,,,27%,,,4,,,7,,
295,https://vlr.gg/player/19530/aaaay,2024-07-18 05:50:00,,,,170,,,42,,,40,,,21,,,-3,,,,,,122,,,40%,,,0,,,3,,
296,https://vlr.gg/player/4885/whzy,2024-07-18 05:50:00,,,,211,,,51,,,51,,,7,,,-2,,,,,,136,,,23%,,,13,,,15,,
297,https://vlr.gg/player/4705/flex1n,2024-07-18 05:50:00,,,,208,,,47,,,48,,,24,,,-3,,,,,,138,,,25%,,,3,,,6,,
298,https://vlr.gg/player/10698/nephh,2024-07-18 05:50:00,,,,173,,,39,,,51,,,32,,,-4,,,,,,112,,,23%,,,5,,,9,,
299,https://vlr.gg/player/4774/knight,2024-07-18 05:50:00,,,,158,,,35,,,46,,,29,,,0,,,,,,95,,,20%,,,2,,,2,,
300,https://vlr.gg/player/6022/yosemite,2024-07-18 05:50:00,,,,148,,,34,,,52,,,13,,,-4,,,,,,108,,,30%,,,3,,,7,,
301,https://vlr.gg/player/42542/ggonyak,2024-07-18 05:15:00,1.32,1.30,1.31,256,248,269,45,20,25,33,14,19,6,4,2,+6,+3,+3,69%,71%,68%,163,151,174,43%,42%,44%,10,5,5,4,2,2
302,https://vlr.gg/player/29287/dori,2024-07-18 05:15:00,1.52,0.69,1.10,191,235,149,35,22,13,34,12,22,23,11,12,-2,+1,-3,69%,79%,60%,127,160,95,24%,24%,24%,1,1,0,3,0,3
303,https://vlr.gg/player/39907/koyori,2024-07-18 05:15:00,1.16,0.85,1.00,190,212,164,31,18,13,36,17,19,32,13,19,-2,0,-2,84%,83%,84%,118,131,106,28%,27%,31%,2,2,0,4,2,2
304,https://vlr.gg/player/29273/len,2024-07-18 05:15:00,1.23,0.62,0.92,198,239,155,33,21,12,34,14,20,21,10,11,-2,+2,-4,65%,71%,60%,126,147,106,23%,26%,20%,4,4,0,6,2,4
305,https://vlr.gg/player/29281/onni,2024-07-18 05:15:00,0.75,0.95,0.85,174,141,216,30,11,19,39,17,22,12,6,6,-5,-4,-1,67%,67%,68%,127,103,149,25%,20%,29%,5,1,4,10,5,5
306,https://vlr.gg/player/29282/maripo,2024-07-18 05:15:00,1.75,0.90,1.33,252,288,217,47,28,19,31,12,19,14,8,6,-1,+2,-3,78%,84%,71%,180,223,136,23%,28%,17%,3,2,1,4,0,4
307,https://vlr.gg/player/29307/r4m,2024-07-18 05:15:00,1.39,0.91,1.16,218,256,181,38,24,14,35,17,18,24,14,10,+2,+1,+1,88%,96%,79%,135,152,118,22%,22%,21%,4,1,3,2,0,2
308,https://vlr.gg/player/30327/hakuna,2024-07-18 05:15:00,1.30,0.88,1.10,194,223,165,34,20,14,29,14,15,7,5,2,+5,+2,+3,76%,80%,71%,120,143,96,19%,15%,24%,6,3,3,1,1,0
309,https://vlr.gg/player/29308/zodiac,2024-07-18 05:15:00,0.66,0.69,0.67,180,181,176,29,15,14,40,21,19,9,7,2,+2,+2,0,59%,64%,54%,121,125,117,25%,22%,28%,10,7,3,8,5,3
310,https://vlr.gg/player/29297/hane,2024-07-18 05:15:00,0.71,0.63,0.67,171,156,187,28,15,13,39,18,21,21,9,12,-3,0,-3,76%,76%,75%,110,98,123,25%,28%,22%,4,3,1,7,3,4
311,https://vlr.gg/player/3021/biank,2024-07-18 04:00:00,,,,224,,,25,,,29,,,7,,,+2,,,,,,146,,,17%,,,6,,,4,,
312,https://vlr.gg/player/4770/fengf,2024-07-18 04:00:00,,,,216,,,22,,,28,,,11,,,0,,,,,,161,,,30%,,,3,,,3,,
313,https://vlr.gg/player/4712/heybay,2024-07-18 04:00:00,,,,149,,,18,,,29,,,4,,,+2,,,,,,98,,,30%,,,4,,,2,,
314,https://vlr.gg/player/37494/kai,2024-07-18 04:00:00,,,,123,,,12,,,30,,,11,,,-5,,,,,,90,,,36%,,,2,,,7,,
315,https://vlr.gg/player/3045/luok1ng,2024-07-18 04:00:00,,,,100,,,12,,,31,,,4,,,-2,,,,,,76,,,24%,,,0,,,2,,
316,https://vlr.gg/player/3520/zmjjkk,2024-07-18 04:00:00,,,,327,,,39,,,20,,,15,,,+4,,,,,,209,,,31%,,,11,,,7,,
317,https://vlr.gg/player/15559/chichoo,2024-07-18 04:00:00,,,,274,,,37,,,17,,,12,,,+5,,,,,,170,,,35%,,,5,,,0,,
318,https://vlr.gg/player/3017/nobody,2024-07-18 04:00:00,,,,225,,,27,,,18,,,14,,,-2,,,,,,152,,,35%,,,0,,,2,,
319,https://vlr.gg/player/4742/smoggy,2024-07-18 04:00:00,,,,185,,,26,,,15,,,11,,,-3,,,,,,136,,,30%,,,1,,,4,,
320,https://vlr.gg/player/13768/s1mon,2024-07-18 04:00:00,,,,166,,,18,,,19,,,19,,,-1,,,,,,105,,,19%,,,1,,,2,,
321,https://vlr.gg/player/25542/ash999,2024-07-18 02:30:00,1.07,1.14,1.11,250,252,260,51,26,25,50,26,24,13,8,5,-1,-1,0,70%,65%,76%,179,172,186,27%,23%,32%,8,6,2,9,7,2
322,https://vlr.gg/player/35965/yukxx,2024-07-18 02:30:00,0.91,0.87,0.89,236,239,234,49,27,22,57,27,30,15,7,8,-1,+3,-4,65%,65%,66%,160,154,166,34%,36%,33%,6,5,1,7,2,5
323,https://vlr.gg/player/32585/n1er,2024-07-18 02:30:00,0.87,0.73,0.80,184,190,186,39,21,18,51,26,25,9,8,1,+1,0,+1,63%,71%,55%,121,122,121,30%,33%,27%,8,3,5,7,3,4
324,https://vlr.gg/player/35026/chaze,2024-07-18 02:30:00,0.93,0.65,0.80,156,180,135,33,20,13,47,23,24,16,9,7,+2,+1,+1,77%,84%,69%,99,112,84,31%,33%,29%,2,1,1,0,0,0
325,https://vlr.gg/player/10192/chowdy,2024-07-18 02:30:00,0.56,0.39,0.48,108,86,131,21,9,12,49,23,26,11,5,6,-7,-2,-5,58%,58%,59%,75,63,89,35%,30%,39%,3,1,2,10,3,7
326,https://vlr.gg/player/13744/patmen,2024-07-18 02:30:00,1.57,1.36,1.46,298,332,278,64,35,29,37,20,17,23,16,7,+3,+3,0,82%,86%,77%,196,213,181,35%,33%,37%,11,7,4,8,4,4
327,https://vlr.gg/player/21677/jeee,2024-07-18 02:30:00,1.37,1.33,1.35,246,234,239,53,25,28,36,17,19,37,20,17,+3,+1,+2,83%,86%,81%,152,149,154,32%,34%,31%,6,2,4,3,1,2
328,https://vlr.gg/player/16953/zynd,2024-07-18 02:30:00,1.54,1.09,1.31,255,277,218,58,33,25,36,15,21,12,4,8,+3,+5,-2,73%,90%,58%,163,182,145,28%,30%,26%,9,6,3,6,1,5
329,https://vlr.gg/player/7746/kevzii,2024-07-18 02:30:00,1.53,1.06,1.29,230,249,218,47,24,23,37,15,22,30,20,10,-1,-2,+1,77%,83%,71%,163,178,149,35%,39%,32%,4,1,3,5,3,2
330,https://vlr.gg/player/9737/kakarot,2024-07-18 02:30:00,0.43,0.86,0.65,156,121,189,30,11,19,47,24,23,20,7,13,-2,0,-2,65%,66%,65%,112,86,136,23%,22%,24%,3,2,1,5,2,3
331,https://vlr.gg/player/10653/suzu,2024-07-18 02:18:00,1.36,1.52,1.44,282,253,308,60,27,33,39,19,20,14,8,6,+7,+6,+1,77%,72%,81%,192,179,204,24%,27%,22%,13,9,4,6,3,3
332,https://vlr.gg/player/29314/moco,2024-07-18 02:18:00,1.27,1.12,1.19,212,224,193,48,25,23,35,16,19,16,7,9,-1,-1,0,73%,72%,74%,138,142,134,23%,30%,16%,1,0,1,2,1,1
333,https://vlr.gg/player/39902/ur,2024-07-18 02:18:00,1.06,0.99,1.02,224,222,223,45,24,21,45,22,23,26,14,12,-3,-1,-2,73%,76%,71%,146,154,139,29%,31%,28%,3,2,1,6,3,3
334,https://vlr.gg/player/39904/serena,2024-07-18 02:18:00,0.71,1.29,1.01,198,136,247,41,12,29,38,20,18,16,7,9,-2,-2,0,65%,52%,77%,133,92,172,25%,17%,31%,5,1,4,7,3,4
335,https://vlr.gg/player/29316/aco,2024-07-18 02:18:00,1.20,0.70,0.94,169,218,123,35,23,12,40,18,22,32,11,21,-7,-1,-6,73%,72%,74%,107,145,71,16%,16%,18%,5,3,2,12,4,8
336,https://vlr.gg/player/37521/mint,2024-07-18 02:18:00,0.98,1.42,1.19,268,259,292,57,27,30,49,28,21,9,6,3,+7,+4,+3,72%,68%,76%,174,158,190,41%,38%,45%,14,8,6,7,4,3
337,https://vlr.gg/player/29315/romia,2024-07-18 02:18:00,1.00,0.94,0.97,177,187,173,36,20,16,42,21,21,11,5,6,+5,+4,+1,70%,77%,62%,121,118,124,29%,24%,34%,7,4,3,2,0,2
338,https://vlr.gg/player/25000/yamzzi,2024-07-18 02:18:00,0.91,0.72,0.82,175,192,156,39,22,17,46,23,23,14,8,6,0,0,0,68%,71%,66%,114,125,102,30%,30%,31%,3,2,1,3,2,1
339,https://vlr.gg/player/29290/pingsong,2024-07-18 02:18:00,0.73,0.81,0.77,158,156,167,32,17,15,46,24,22,26,9,17,-2,0,-2,65%,65%,66%,101,102,100,25%,27%,23%,7,4,3,9,4,5
340,https://vlr.gg/player/29274/curumi,2024-07-18 02:18:00,0.69,0.65,0.67,157,152,166,31,15,16,46,23,23,17,7,10,-4,-1,-3,57%,65%,48%,105,102,109,19%,20%,18%,2,1,1,6,2,4
341,https://vlr.gg/player/33576/margaret,2024-07-18 02:00:00,1.04,1.43,1.22,232,219,252,56,29,27,43,26,17,25,9,16,-1,0,-1,73%,69%,77%,147,129,168,29%,33%,27%,6,5,1,7,5,2
342,https://vlr.gg/player/4122/persia,2024-07-18 02:00:00,1.24,1.10,1.17,196,208,172,44,25,19,40,22,18,32,22,10,+3,+3,0,79%,86%,70%,136,152,117,27%,27%,27%,4,3,1,1,0,1
343,https://vlr.gg/player/31827/dambi,2024-07-18 02:00:00,0.84,1.33,1.07,216,181,256,49,22,27,43,25,18,13,8,5,+1,-5,+6,74%,75%,73%,152,127,182,20%,18%,22%,9,2,7,8,7,1
344,https://vlr.gg/player/31829/ivy,2024-07-18 02:00:00,1.11,0.93,1.03,193,235,156,47,30,17,45,27,18,18,8,10,+3,+3,0,76%,72%,80%,117,140,90,29%,31%,25%,11,6,5,8,3,5
345,https://vlr.gg/player/31828/francis,2024-07-18 02:00:00,0.97,1.07,1.01,203,183,224,44,23,21,45,24,21,20,10,10,-2,-3,+1,70%,69%,70%,129,120,140,24%,29%,19%,5,1,4,7,4,3
346,https://vlr.gg/player/17049/hermes,2024-07-18 02:00:00,1.02,1.06,1.04,202,188,212,44,19,25,47,21,26,31,15,16,0,-1,+1,77%,73%,81%,131,119,141,29%,25%,33%,6,1,5,6,2,4
347,https://vlr.gg/player/1916/free1ng,2024-07-18 02:00:00,0.89,1.14,1.03,209,184,233,49,19,30,47,21,26,13,4,9,0,-2,+2,67%,60%,72%,142,126,155,35%,31%,38%,6,3,3,6,5,1
348,https://vlr.gg/player/482/intro,2024-07-18 02:00:00,0.70,1.27,1.02,202,157,244,46,16,30,47,23,24,22,11,11,0,-1,+1,70%,67%,72%,141,108,168,31%,28%,32%,5,2,3,5,3,2
349,https://vlr.gg/player/476/exy,2024-07-18 02:00:00,1.06,0.79,0.91,174,188,160,42,22,20,47,20,27,19,7,12,-3,0,-3,70%,63%,75%,113,118,109,58%,63%,53%,3,2,1,6,2,4
350,https://vlr.gg/player/9221/kanade,2024-07-18 02:00:00,0.59,0.70,0.65,161,161,155,35,16,19,52,26,26,11,6,5,-1,-2,+1,65%,53%,75%,103,107,99,32%,35%,29%,11,4,7,12,6,6
351,https://vlr.gg/player/30327/hakuna,2024-07-17 23:35:00,1.49,1.46,1.48,293,279,260,48,28,20,28,16,12,10,6,4,+6,+3,+3,81%,74%,90%,180,178,182,28%,23%,34%,8,5,3,2,2,0
352,https://vlr.gg/player/29308/zodiac,2024-07-17 23:35:00,1.04,1.73,1.34,293,251,345,45,22,23,36,22,14,12,9,3,+6,-1,+7,83%,78%,90%,197,177,225,20%,18%,23%,11,4,7,5,5,0
353,https://vlr.gg/player/29282/maripo,2024-07-17 23:35:00,0.87,1.58,1.17,161,128,251,32,12,20,27,16,11,22,11,11,+2,+1,+1,85%,81%,90%,119,93,153,14%,14%,14%,2,1,1,0,0,0
354,https://vlr.gg/player/29297/hane,2024-07-17 23:35:00,1.19,0.94,1.09,211,226,177,35,23,12,31,18,13,30,14,16,-4,-2,-2,74%,70%,80%,141,153,125,32%,35%,29%,3,3,0,7,5,2
355,https://vlr.gg/player/29307/r4m,2024-07-17 23:35:00,1.23,0.65,0.98,169,215,128,32,22,10,28,15,13,23,12,11,-3,0,-3,77%,81%,70%,107,133,73,24%,22%,30%,3,1,2,6,1,5
356,https://vlr.gg/player/25391/bes,2024-07-17 23:35:00,1.00,0.94,0.97,178,182,185,30,12,18,37,16,21,15,7,8,+1,+2,-1,64%,65%,63%,126,129,125,29%,29%,29%,4,2,2,3,0,3
357,https://vlr.gg/player/29299/healing,2024-07-17 23:35:00,1.22,0.75,0.95,196,273,154,35,20,15,37,17,20,13,5,8,-1,-1,0,72%,75%,70%,128,165,100,16%,17%,15%,2,2,0,3,3,0
358,https://vlr.gg/player/29272/a1ka,2024-07-17 23:35:00,0.85,0.99,0.93,187,220,181,32,17,15,36,17,19,7,0,7,-2,-2,0,55%,45%,63%,144,144,144,30%,39%,26%,3,1,2,5,3,2
359,https://vlr.gg/player/43037/ache,2024-07-17 23:35:00,0.33,1.07,0.76,195,112,262,31,8,23,39,17,22,9,2,7,-6,-6,0,55%,45%,63%,121,74,156,30%,47%,25%,7,1,6,13,7,6
360,https://vlr.gg/player/29269/yome,2024-07-17 23:35:00,0.42,0.66,0.56,158,114,184,22,6,16,43,18,25,14,9,5,+1,+1,0,64%,65%,63%,104,77,123,26%,14%,33%,4,1,3,3,0,3
361,https://vlr.gg/player/29331/dia,2024-07-17 21:20:00,1.02,1.32,1.15,278,255,318,39,20,19,35,20,15,7,3,4,+5,+2,+3,67%,58%,78%,166,150,189,26%,22%,31%,15,10,5,10,8,2
362,https://vlr.gg/player/29267/krenn,2024-07-17 21:20:00,1.11,1.17,1.14,209,218,194,33,20,13,29,18,11,4,1,3,-3,-2,-1,69%,67%,72%,145,157,130,35%,45%,26%,1,1,0,4,3,1
363,https://vlr.gg/player/39913/yuzu,2024-07-17 21:20:00,0.91,0.96,0.93,190,160,239,27,13,14,31,17,14,11,7,4,+2,+1,+1,64%,67%,61%,128,104,159,22%,14%,30%,4,1,3,2,0,2
364,https://vlr.gg/player/29293/yunah,2024-07-17 21:20:00,0.92,0.70,0.82,167,189,138,24,15,9,32,19,13,14,11,3,-1,+1,-2,62%,67%,56%,108,117,95,36%,32%,40%,1,1,0,2,0,2
365,https://vlr.gg/player/46914/miya,2024-07-17 21:20:00,0.49,0.39,0.45,98,106,90,13,7,6,34,20,14,14,10,4,-3,0,-3,52%,54%,50%,70,70,71,40%,33%,55%,0,0,0,3,0,3
366,https://vlr.gg/player/29273/len,2024-07-17 21:20:00,1.92,0.90,1.33,264,398,174,37,24,13,28,12,16,22,6,16,+4,+3,+1,74%,72%,75%,167,255,102,25%,24%,27%,7,4,3,3,1,2
367,https://vlr.gg/player/29287/dori,2024-07-17 21:20:00,1.46,1.10,1.26,197,216,186,31,15,16,24,9,15,20,12,8,0,+1,-1,74%,72%,75%,129,123,133,42%,47%,39%,4,1,3,4,0,4
368,https://vlr.gg/player/29281/onni,2024-07-17 21:20:00,0.73,1.43,1.13,262,173,320,39,10,29,28,13,15,8,4,4,+5,+1,+4,76%,72%,79%,152,104,188,24%,31%,22%,8,4,4,3,3,0
369,https://vlr.gg/player/42542/ggonyak,2024-07-17 21:20:00,0.85,1.06,0.97,187,175,194,28,12,16,26,12,14,14,7,7,-6,-1,-5,71%,72%,71%,125,116,132,32%,28%,36%,0,0,0,6,1,5
370,https://vlr.gg/player/39907/koyori,2024-07-17 21:20:00,0.35,1.17,0.82,175,89,224,26,6,20,30,15,15,16,7,9,-3,-2,-1,69%,67%,71%,105,54,144,26%,46%,22%,2,1,1,5,3,2
371,https://vlr.gg/player/4004/zekken,2024-07-17 20:30:00,1.12,0.95,1.02,261,288,251,39,20,19,37,16,21,7,2,5,0,-1,+1,56%,58%,54%,162,170,156,40%,33%,49%,10,5,5,10,6,4
372,https://vlr.gg/player/9/tenz,2024-07-17 20:30:00,0.71,1.26,1.02,230,157,286,31,8,23,32,15,17,16,8,8,-2,-2,0,77%,74%,79%,146,111,174,32%,27%,35%,4,0,4,6,2,4
373,https://vlr.gg/player/659/sacy,2024-07-17 20:30:00,0.98,0.81,0.88,171,176,170,24,12,12,29,12,17,10,6,4,-5,-2,-3,72%,84%,63%,122,132,114,26%,21%,31%,1,0,1,6,2,4
374,https://vlr.gg/player/1265/johnqt,2024-07-17 20:30:00,0.98,0.76,0.86,187,221,156,28,15,13,34,15,19,8,4,4,-2,-2,0,72%,79%,67%,124,145,108,27%,32%,21%,1,0,1,3,2,1
375,https://vlr.gg/player/729/zellsis,2024-07-17 20:30:00,0.71,0.83,0.78,141,131,151,22,9,13,28,13,15,11,6,5,-2,-2,0,63%,63%,63%,93,80,103,26%,31%,24%,0,0,0,2,2,0
376,https://vlr.gg/player/3880/bang,2024-07-17 20:30:00,1.84,1.37,1.63,260,313,207,43,28,15,22,12,10,16,8,8,+5,+4,+1,77%,83%,68%,160,182,131,33%,33%,34%,6,4,2,1,0,1
377,https://vlr.gg/player/796/eeiu,2024-07-17 20:30:00,0.89,1.32,1.08,171,117,235,24,11,13,23,13,10,19,7,12,+2,0,+2,77%,67%,89%,121,81,172,19%,15%,21%,3,1,2,1,1,0
378,https://vlr.gg/player/4147/cryocells,2024-07-17 20:30:00,0.90,1.27,1.06,225,182,283,36,16,20,31,16,15,9,5,4,+4,-2,+6,77%,71%,84%,155,140,175,24%,30%,18%,7,1,6,3,3,0
379,https://vlr.gg/player/601/asuna,2024-07-17 20:30:00,1.00,1.11,1.05,223,212,231,36,19,17,32,18,14,20,12,8,+3,0,+3,79%,75%,84%,134,130,138,24%,26%,22%,7,4,3,4,4,0
380,https://vlr.gg/player/604/boostio,2024-07-17 20:30:00,0.67,0.51,0.59,158,184,115,21,15,6,36,21,15,14,5,9,-3,0,-3,65%,63%,68%,112,130,90,22%,20%,27%,4,3,1,7,3,4
381,https://vlr.gg/player/8673/heat,2024-07-17 17:00:00,1.44,1.69,1.57,244,212,281,65,27,38,36,15,21,32,12,20,+6,+3,+3,87%,84%,89%,164,146,179,40%,36%,43%,8,4,4,2,1,1
382,https://vlr.gg/player/1311/melser,2024-07-17 17:00:00,1.11,1.09,1.10,203,184,220,49,21,28,43,17,26,30,16,14,-1,-1,0,82%,87%,78%,133,118,147,33%,31%,35%,6,1,5,7,2,5
383,https://vlr.gg/player/24007/shyy,2024-07-17 17:00:00,0.89,1.23,1.07,215,185,238,49,20,29,45,21,24,25,13,12,+2,-1,+3,78%,77%,78%,147,121,169,31%,23%,36%,7,2,5,5,3,2
384,https://vlr.gg/player/2462/keznit,2024-07-17 17:00:00,1.55,0.64,1.06,223,295,162,51,34,17,45,17,28,17,5,12,0,+1,-1,69%,74%,64%,157,200,120,24%,25%,23%,13,8,5,13,7,6
385,https://vlr.gg/player/36169/mta,2024-07-17 17:00:00,0.94,0.85,0.89,192,186,184,46,22,24,47,20,27,8,6,2,0,-1,+1,75%,81%,69%,120,115,123,34%,39%,31%,3,1,2,3,2,1
386,https://vlr.gg/player/7458/moose,2024-07-17 17:00:00,0.98,1.03,1.00,196,207,182,47,28,19,47,25,22,4,3,1,+2,+1,+1,61%,64%,58%,132,139,122,32%,34%,29%,8,5,3,6,4,2
387,https://vlr.gg/player/7871/xeppaa,2024-07-17 17:00:00,1.29,0.58,0.96,183,243,122,42,31,11,51,24,27,29,17,12,-1,-1,0,75%,78%,71%,131,167,90,31%,32%,29%,1,0,1,2,1,1
388,https://vlr.gg/player/18796/oxy,2024-07-17 17:00:00,0.82,0.82,0.82,223,232,216,51,29,22,58,32,26,8,4,4,-4,-3,-1,67%,67%,68%,142,149,135,27%,31%,22%,11,6,5,15,9,6
389,https://vlr.gg/player/16003/runi,2024-07-17 17:00:00,0.89,0.67,0.79,187,182,190,40,22,18,53,28,25,17,12,5,+1,+1,0,70%,75%,65%,121,118,124,41%,39%,45%,5,2,3,4,1,3
390,https://vlr.gg/player/7870/vanity,2024-07-17 17:00:00,0.66,0.90,0.77,155,141,183,36,17,19,53,28,25,22,10,12,-5,-4,-1,61%,56%,68%,100,87,114,23%,22%,25%,5,2,3,10,6,4
391,https://vlr.gg/player/10971/riens,2024-07-17 14:15:00,0.87,1.76,1.31,224,175,274,38,15,23,28,18,10,22,10,12,+2,+1,+1,83%,75%,91%,147,111,185,36%,20%,55%,2,1,1,0,0,0
392,https://vlr.gg/player/21328/wo0t,2024-07-17 14:15:00,1.16,1.08,1.12,202,212,191,29,16,13,31,15,16,35,15,20,+5,+4,+1,83%,92%,74%,133,135,130,30%,30%,29%,6,4,2,1,0,1
393,https://vlr.gg/player/18350/miniboo,2024-07-17 14:15:00,0.73,1.45,1.08,241,198,286,39,15,24,34,18,16,8,2,6,-2,-1,-1,72%,67%,78%,163,129,199,28%,20%,35%,11,6,5,13,7,6
394,https://vlr.gg/player/1144/boo,2024-07-17 14:15:00,1.07,1.03,1.05,187,181,195,31,16,15,30,13,17,19,9,10,0,+1,-1,79%,83%,74%,125,113,138,29%,28%,30%,3,2,1,3,1,2
395,https://vlr.gg/player/29873/benjyfishy,2024-07-17 14:15:00,1.16,0.64,0.90,179,229,128,33,21,12,33,15,18,7,5,2,0,+1,-1,74%,83%,65%,116,146,85,47%,46%,48%,4,2,2,4,1,3
396,https://vlr.gg/player/8369/yetujey,2024-07-17 14:15:00,1.19,0.84,1.01,178,228,132,29,19,10,30,16,14,13,7,6,-1,+1,-2,64%,61%,67%,126,152,101,30%,29%,30%,1,1,0,2,0,2
397,https://vlr.gg/player/6510/atakaptan,2024-07-17 14:15:00,0.89,1.05,0.97,205,195,218,32,16,16,37,18,19,17,6,11,-1,+1,-2,77%,74%,79%,136,135,136,26%,44%,16%,6,4,2,7,3,4
398,https://vlr.gg/player/8044/mrfalin,2024-07-17 14:15:00,0.59,1.23,0.92,183,149,217,32,13,19,32,18,14,13,5,8,+1,0,+1,72%,65%,79%,110,89,131,23%,27%,20%,3,2,1,2,2,0
399,https://vlr.gg/player/1139/qraxs,2024-07-17 14:15:00,0.79,0.86,0.83,190,168,211,31,12,19,33,16,17,10,7,3,-2,-2,0,72%,78%,67%,125,112,138,31%,33%,30%,2,0,2,4,2,2
400,https://vlr.gg/player/573/cned,2024-07-17 14:15:00,0.81,0.77,0.79,203,213,192,32,17,15,38,19,19,6,3,3,-2,+1,-3,62%,57%,67%,140,149,132,22%,19%,28%,9,5,4,11,4,7
401,https://vlr.gg/player/312/sayf,2024-07-17 12:00:00,1.16,1.54,1.33,277,257,302,39,20,19,32,18,14,14,8,6,-4,-6,+2,63%,63%,63%,173,153,198,18%,19%,16%,5,1,4,9,7,2
402,https://vlr.gg/player/2168/trexx,2024-07-17 12:00:00,0.87,1.19,1.01,197,198,195,28,15,13,31,20,11,17,11,6,+2,-1,+3,72%,79%,63%,131,136,125,17%,16%,17%,5,1,4,3,2,1
403,https://vlr.gg/player/21610/runner,2024-07-17 12:00:00,0.98,0.89,0.94,179,167,203,26,13,13,30,16,14,14,8,6,-1,-1,0,65%,67%,63%,119,115,125,24%,20%,29%,4,1,3,5,2,3
404,https://vlr.gg/player/11134/kicks,2024-07-17 12:00:00,0.96,0.61,0.80,144,166,109,22,16,6,34,19,15,19,10,9,-1,-1,0,63%,58%,68%,86,100,68,17%,26%,8%,0,0,0,1,1,0
405,https://vlr.gg/player/4321/cender,2024-07-17 12:00:00,0.67,0.62,0.65,124,156,92,20,13,7,36,22,14,13,7,6,-7,-5,-2,60%,58%,63%,79,94,61,26%,33%,13%,2,2,0,9,7,2
406,https://vlr.gg/player/5022/derke,2024-07-17 12:00:00,1.11,1.38,1.26,245,230,266,41,16,25,29,11,18,8,3,5,+1,-2,+3,74%,63%,83%,163,154,169,26%,32%,23%,8,3,5,7,5,2
407,https://vlr.gg/player/458/chronicle,2024-07-17 12:00:00,1.18,1.29,1.24,248,265,233,36,17,19,27,15,12,20,9,11,+3,-1,+4,79%,74%,83%,165,179,154,31%,28%,34%,5,1,4,2,2,0
408,https://vlr.gg/player/29867/hiro,2024-07-17 12:00:00,0.92,1.34,1.16,210,153,258,35,12,23,25,11,14,14,2,12,+1,-2,+3,77%,68%,83%,143,114,166,30%,50%,23%,4,1,3,3,3,0
409,https://vlr.gg/player/9810/alfajer,2024-07-17 12:00:00,1.05,0.87,0.95,162,140,175,26,11,15,25,9,16,12,5,7,+1,+1,0,74%,79%,71%,121,94,142,26%,32%,22%,3,1,2,2,0,2
410,https://vlr.gg/player/438/boaster,2024-07-17 12:00:00,0.98,0.87,0.92,186,188,181,25,12,13,29,12,17,19,4,15,+5,+1,+4,72%,74%,71%,125,130,122,27%,20%,33%,7,2,5,2,1,1
411,https://vlr.gg/player/8240/alyal,2024-07-17 07:40:00,1.01,1.28,1.18,252,242,268,33,12,21,29,12,17,8,1,7,-1,0,-1,64%,53%,71%,177,173,180,31%,34%,28%,3,1,2,4,1,3
412,https://vlr.gg/player/1429/d0rf,2024-07-17 07:40:00,0.60,1.16,0.95,181,171,187,25,8,17,27,13,14,3,0,3,-4,-2,-2,69%,53%,79%,118,104,128,32%,33%,32%,0,0,0,4,2,2
413,https://vlr.gg/player/14213/ting2k5,2024-07-17 07:40:00,1.15,0.49,0.74,138,223,96,19,11,8,29,12,17,10,4,6,-3,+1,-4,56%,60%,54%,104,162,68,38%,40%,36%,2,1,1,5,0,5
414,https://vlr.gg/player/8036/k1llers,2024-07-17 07:40:00,0.34,1.01,0.74,169,88,206,19,3,16,33,13,20,10,3,7,-1,-3,+2,64%,60%,67%,112,60,145,15%,9%,18%,4,1,3,5,4,1
415,https://vlr.gg/player/14207/viness,2024-07-17 07:40:00,0.55,0.80,0.70,161,114,203,20,5,15,34,12,22,14,6,8,0,-3,+3,67%,53%,75%,112,86,128,30%,26%,31%,6,1,5,6,4,2
416,https://vlr.gg/player/14553/b-nhmj,2024-07-17 07:40:00,1.20,1.45,1.30,243,235,234,33,20,13,21,15,6,9,8,1,+5,+3,+2,79%,79%,80%,161,167,153,41%,37%,48%,6,4,2,1,1,0
417,https://vlr.gg/player/14587/daft,2024-07-17 07:40:00,1.09,1.38,1.20,260,232,283,37,22,15,26,16,10,7,1,6,0,0,0,74%,71%,80%,168,152,193,27%,27%,27%,8,6,2,8,6,2
418,https://vlr.gg/player/44149/pr0digy,2024-07-17 07:40:00,1.26,1.10,1.20,230,210,265,33,18,15,24,14,10,13,10,3,+4,+1,+3,77%,79%,73%,140,130,156,45%,43%,47%,6,1,5,2,0,2
419,https://vlr.gg/player/23042/tripciew,2024-07-17 07:40:00,0.83,1.43,1.06,187,176,202,24,13,11,21,16,5,17,11,6,0,-2,+2,82%,75%,93%,126,130,121,35%,33%,39%,3,1,2,3,3,0
420,https://vlr.gg/player/14209/suka,2024-07-17 07:40:00,0.97,1.05,1.00,162,183,135,25,17,8,24,16,8,17,10,7,0,0,0,82%,79%,87%,115,124,100,39%,38%,40%,1,1,0,1,1,0
421,https://vlr.gg/player/7430/youngpork,2024-07-17 07:15:00,0.83,0.82,0.82,180,169,186,23,11,12,32,14,18,6,1,5,-2,+1,-3,51%,47%,55%,118,107,127,34%,39%,31%,2,2,0,4,1,3
422,https://vlr.gg/player/46552/minori,2024-07-17 07:15:00,0.56,0.83,0.71,169,130,198,22,8,14,32,14,18,6,3,3,-3,-2,-1,54%,59%,50%,103,82,122,30%,27%,32%,2,1,1,5,3,2
423,https://vlr.gg/player/46471/hirenkyaku,2024-07-17 07:15:00,0.73,0.70,0.71,174,161,178,21,9,12,31,13,18,4,2,2,-2,0,-2,62%,71%,55%,102,101,103,32%,9%,56%,4,3,1,6,3,3
424,https://vlr.gg/player/46138/sanji,2024-07-17 07:15:00,1.03,0.07,0.49,126,225,49,15,14,1,33,14,19,7,3,4,-6,-2,-4,49%,65%,35%,81,127,42,38%,52%,9%,0,0,0,6,2,4
425,https://vlr.gg/player/7431/foods,2024-07-17 07:15:00,0.45,0.48,0.47,118,115,129,15,6,9,34,15,19,6,3,3,-2,0,-2,51%,65%,40%,84,70,96,27%,20%,33%,3,1,2,5,1,4
426,https://vlr.gg/player/13220/ja,2024-07-17 07:15:00,1.46,1.76,1.59,288,263,330,42,21,21,18,9,9,5,1,4,+7,+3,+4,81%,75%,88%,194,168,224,26%,25%,27%,8,4,4,1,1,0
427,https://vlr.gg/player/16842/mojer,2024-07-17 07:15:00,1.92,0.91,1.46,290,385,173,37,28,9,20,10,10,10,4,6,+7,+6,+1,86%,90%,82%,197,266,116,30%,33%,24%,9,6,3,2,0,2
428,https://vlr.gg/player/13219/papi,2024-07-17 07:15:00,1.23,1.49,1.35,181,133,242,25,10,15,15,7,8,16,11,5,0,+1,-1,97%,95%,100%,129,93,170,40%,60%,33%,1,1,0,1,0,1
429,https://vlr.gg/player/9747/emman,2024-07-17 07:15:00,1.33,1.03,1.19,240,238,242,33,18,15,23,11,12,11,7,4,0,0,0,81%,90%,71%,152,152,153,48%,44%,54%,4,2,2,4,2,2
430,https://vlr.gg/player/7749/nexi,2024-07-17 07:15:00,1.26,1.00,1.14,209,231,175,25,15,10,20,11,9,17,14,3,+1,+2,-1,78%,80%,76%,144,161,123,27%,27%,27%,4,3,1,3,1,2
431,https://vlr.gg/player/7443/riza,2024-07-17 07:00:00,1.27,1.08,1.18,244,233,254,106,55,51,82,38,44,26,17,9,+8,+5,+3,70%,71%,69%,152,141,163,33%,39%,28%,19,9,10,11,4,7
432,https://vlr.gg/player/27068/pudj,2024-07-17 07:00:00,1.18,0.97,1.08,202,233,175,85,49,36,77,40,37,26,14,12,-2,-3,+1,75%,79%,69%,148,170,123,29%,26%,34%,11,5,6,13,8,5
433,https://vlr.gg/player/5886/flaring,2024-07-17 07:00:00,0.90,1.02,0.96,197,180,211,79,39,40,89,46,43,54,31,23,-3,-5,+2,74%,75%,73%,121,113,130,26%,27%,24%,7,2,5,10,7,3
434,https://vlr.gg/player/16852/nakya,2024-07-17 07:00:00,0.92,0.91,0.91,222,222,223,97,50,47,93,48,45,14,9,5,+6,+1,+5,65%,63%,66%,142,136,149,31%,38%,25%,20,11,9,14,10,4
435,https://vlr.gg/player/7381/redkoh,2024-07-17 07:00:00,0.89,0.89,0.89,169,156,185,71,32,39,87,44,43,47,28,19,-1,+1,-2,72%,71%,73%,114,104,125,29%,26%,32%,8,4,4,9,3,6
436,https://vlr.gg/player/45876/fixy,2024-07-17 07:00:00,1.19,1.13,1.16,246,240,255,104,51,53,92,46,46,22,11,11,+5,+2,+3,71%,75%,68%,158,158,157,23%,26%,19%,27,11,16,22,9,13
437,https://vlr.gg/player/3480/thedoctorr,2024-07-17 07:00:00,1.07,0.97,1.02,189,196,181,81,40,41,83,39,44,43,20,23,-1,-1,0,66%,64%,67%,121,122,120,33%,35%,31%,8,4,4,9,5,4
438,https://vlr.gg/player/2378/subbey,2024-07-17 07:00:00,0.96,0.97,0.96,183,176,191,74,35,39,85,40,45,37,15,22,-4,-6,+2,70%,69%,71%,123,120,126,33%,33%,32%,3,0,3,7,6,1
439,https://vlr.gg/player/21051/jans0n,2024-07-17 07:00:00,0.80,1.11,0.96,196,172,220,81,34,47,89,45,44,51,14,37,-3,-1,-2,74%,68%,79%,124,109,139,34%,34%,34%,11,6,5,14,7,7
440,https://vlr.gg/player/7513/markl,2024-07-17 07:00:00,1.05,0.80,0.92,196,232,164,88,52,36,89,43,46,31,14,17,-5,-3,-2,67%,71%,63%,127,147,108,20%,20%,20%,8,4,4,13,7,6
441,https://vlr.gg/player/3520/zmjjkk,2024-07-17 06:10:00,,,,260,,,57,,,45,,,7,,,-3,,,,,,165,,,24%,,,11,,,14,,
442,https://vlr.gg/player/3017/nobody,2024-07-17 06:10:00,,,,237,,,50,,,45,,,21,,,+4,,,,,,161,,,36%,,,8,,,4,,
443,https://vlr.gg/player/4742/smoggy,2024-07-17 06:10:00,,,,216,,,48,,,40,,,18,,,+2,,,,,,141,,,36%,,,8,,,6,,
444,https://vlr.gg/player/15559/chichoo,2024-07-17 06:10:00,,,,192,,,41,,,38,,,20,,,-1,,,,,,123,,,22%,,,3,,,4,,
445,https://vlr.gg/player/13768/s1mon,2024-07-17 06:10:00,,,,127,,,30,,,38,,,24,,,-1,,,,,,88,,,27%,,,1,,,2,,
446,https://vlr.gg/player/4774/knight,2024-07-17 06:10:00,,,,241,,,53,,,44,,,24,,,0,,,,,,161,,,27%,,,4,,,4,,
447,https://vlr.gg/player/6022/yosemite,2024-07-17 06:10:00,,,,213,,,43,,,48,,,16,,,+2,,,,,,130,,,26%,,,7,,,5,,
448,https://vlr.gg/player/10698/nephh,2024-07-17 06:10:00,,,,192,,,40,,,48,,,23,,,+2,,,,,,126,,,18%,,,7,,,5,,
449,https://vlr.gg/player/4885/whzy,2024-07-17 06:10:00,,,,172,,,35,,,46,,,14,,,-2,,,,,,124,,,37%,,,10,,,12,,
450,https://vlr.gg/player/4705/flex1n,2024-07-17 06:10:00,,,,171,,,35,,,40,,,28,,,-3,,,,,,115,,,33%,,,2,,,5,,
451,https://vlr.gg/player/1437/yesican,2024-07-17 06:00:00,2.00,1.53,1.64,278,366,254,32,10,22,16,4,12,21,4,17,0,0,0,91%,88%,92%,176,242,154,28%,36%,25%,0,0,0,0,0,0
452,https://vlr.gg/player/8225/f1cio,2024-07-17 06:00:00,0.93,1.83,1.59,305,219,344,38,7,31,18,6,12,10,0,10,+3,-2,+5,84%,63%,92%,203,146,222,44%,50%,43%,6,1,5,3,3,0
453,https://vlr.gg/player/23976/crus,2024-07-17 06:00:00,0.72,1.79,1.52,243,95,280,29,3,26,13,5,8,20,5,15,0,-1,+1,88%,75%,92%,161,85,186,47%,43%,48%,3,0,3,3,1,2
454,https://vlr.gg/player/46463/twilight,2024-07-17 06:00:00,1.87,1.20,1.36,230,370,186,27,11,16,15,5,10,8,1,7,+2,+1,+1,88%,88%,88%,150,241,119,42%,37%,47%,4,1,3,2,0,2
455,https://vlr.gg/player/14254/gin,2024-07-17 06:00:00,0.88,1.23,1.14,233,191,244,27,6,21,18,6,12,3,0,3,+3,+2,+1,69%,63%,71%,158,103,177,45%,54%,42%,7,2,5,4,0,4
456,https://vlr.gg/player/44144/rageee,2024-07-17 06:00:00,0.69,1.02,0.77,188,156,282,20,12,8,29,21,8,7,7,0,-1,-1,0,63%,58%,75%,123,107,169,41%,43%,39%,2,1,1,3,2,1
457,https://vlr.gg/player/14562/fuzzie,2024-07-17 06:00:00,0.72,0.89,0.75,178,178,204,19,13,6,29,22,7,7,5,2,-1,-1,0,59%,63%,50%,112,114,109,28%,24%,50%,2,0,2,3,1,2
458,https://vlr.gg/player/37639/hyuse,2024-07-17 06:00:00,0.25,1.39,0.54,163,115,304,16,8,8,32,26,6,9,6,3,-2,-2,0,63%,58%,75%,106,75,201,28%,20%,39%,1,1,0,3,3,0
459,https://vlr.gg/player/37638/shaun,2024-07-17 06:00:00,0.48,0.16,0.34,113,141,35,12,11,1,31,23,8,2,0,2,-3,-2,-1,38%,38%,38%,75,90,30,33%,33%,33%,1,1,0,4,3,1
460,https://vlr.gg/player/16967/namgoku,2024-07-17 06:00:00,0.33,0.10,0.27,112,123,94,13,10,3,32,24,8,1,1,0,-1,-2,+1,47%,46%,50%,72,74,65,39%,45%,25%,6,5,1,7,7,0
461,https://vlr.gg/player/46134/denz,2024-07-17 05:25:00,0.87,1.35,1.01,251,231,300,29,19,10,31,23,8,3,0,3,+3,-1,+4,71%,58%,100%,165,156,187,41%,38%,48%,7,3,4,4,4,0
462,https://vlr.gg/player/46135/zeus,2024-07-17 05:25:00,1.13,0.67,0.99,235,257,191,26,20,6,31,22,9,5,3,2,+2,+1,+1,71%,63%,90%,160,172,133,34%,36%,30%,4,3,1,2,2,0
463,https://vlr.gg/player/11541/xty,2024-07-17 05:25:00,0.87,0.96,0.90,212,222,177,23,16,7,28,22,6,10,8,2,+1,+1,0,71%,71%,70%,131,142,103,31%,35%,24%,3,2,1,2,1,1
464,https://vlr.gg/player/44294/eur,2024-07-17 05:25:00,0.54,0.96,0.66,168,141,240,21,11,10,31,22,9,11,8,3,-3,-3,0,65%,63%,70%,105,89,144,29%,34%,23%,2,1,1,5,4,1
465,https://vlr.gg/player/36013/hydrakid,2024-07-17 05:25:00,0.47,0.60,0.51,127,121,147,14,9,5,30,22,8,16,12,4,-1,-2,+1,68%,63%,80%,79,71,98,24%,29%,11%,2,1,1,3,3,0
466,https://vlr.gg/player/24737/par-scofield,2024-07-17 05:25:00,1.49,1.55,1.53,332,363,318,41,12,29,23,9,14,6,1,5,+2,-2,+4,79%,60%,88%,198,227,186,35%,39%,33%,8,1,7,6,3,3
467,https://vlr.gg/player/21793/syko,2024-07-17 05:25:00,1.58,1.40,1.45,281,336,259,37,14,23,20,6,14,11,3,8,+1,-1,+2,88%,80%,92%,181,191,176,36%,46%,32%,3,0,3,2,1,1
468,https://vlr.gg/player/44246/repulsive,2024-07-17 05:25:00,1.49,0.92,1.09,231,237,229,28,7,21,24,6,18,19,12,7,+1,+1,0,79%,90%,75%,138,155,131,23%,20%,24%,4,1,3,3,0,3
469,https://vlr.gg/player/26143/secondlove,2024-07-17 05:25:00,0.25,1.43,1.07,199,84,245,25,3,22,22,9,13,10,2,8,-3,-2,-1,82%,70%,88%,135,69,162,44%,40%,45%,0,0,0,3,2,1
470,https://vlr.gg/player/33801/loydream,2024-07-17 05:25:00,0.53,0.92,0.80,162,95,189,20,4,16,24,8,16,10,0,10,-3,-2,-1,74%,60%,79%,121,77,139,13%,27%,11%,1,0,1,4,2,2
471,https://vlr.gg/player/25000/yamzzi,2024-07-17 05:00:00,1.04,1.49,1.28,228,205,259,40,17,23,35,17,18,29,9,20,0,-1,+1,80%,74%,85%,146,126,164,26%,20%,31%,5,2,3,5,3,2
472,https://vlr.gg/player/29274/curumi,2024-07-17 05:00:00,1.60,0.72,1.14,215,283,166,36,23,13,36,14,22,34,15,19,0,+2,-2,73%,74%,73%,136,175,102,19%,19%,18%,2,2,0,2,0,2
473,https://vlr.gg/player/37521/mint,2024-07-17 05:00:00,0.87,1.26,1.07,240,183,294,41,14,27,36,17,19,6,5,1,+7,+1,+6,73%,74%,73%,144,110,175,42%,29%,59%,16,7,9,9,6,3
474,https://vlr.gg/player/29290/pingsong,2024-07-17 05:00:00,0.95,1.12,1.04,187,183,180,31,15,16,32,17,15,13,7,6,-4,-1,-3,80%,78%,81%,127,116,137,30%,30%,30%,0,0,0,4,1,3
475,https://vlr.gg/player/29315/romia,2024-07-17 05:00:00,0.96,0.74,0.84,186,217,153,31,18,13,35,17,18,7,2,5,-4,0,-4,57%,61%,54%,121,136,108,29%,35%,25%,1,1,0,5,1,4
476,https://vlr.gg/player/39913/yuzu,2024-07-17 05:00:00,1.24,1.11,1.18,212,197,244,37,18,19,36,17,19,31,17,14,+3,0,+3,76%,73%,78%,138,120,158,28%,26%,29%,5,2,3,2,2,0
477,https://vlr.gg/player/46914/miya,2024-07-17 05:00:00,1.15,1.09,1.12,241,249,227,41,25,16,35,18,17,11,4,7,+2,+2,0,80%,73%,87%,167,170,163,31%,37%,25%,5,3,2,3,1,2
478,https://vlr.gg/player/29267/krenn,2024-07-17 05:00:00,0.86,0.83,0.85,183,162,208,32,16,16,33,17,16,6,4,2,-5,0,-5,69%,65%,74%,126,106,149,24%,29%,20%,1,1,0,6,1,5
479,https://vlr.gg/player/29293/yunah,2024-07-17 05:00:00,0.97,0.70,0.84,166,214,119,29,19,10,34,18,16,20,12,8,-2,-1,-1,76%,73%,78%,108,138,74,38%,36%,43%,2,1,1,4,2,2
480,https://vlr.gg/player/29331/dia,2024-07-17 05:00:00,0.60,1.05,0.81,219,192,246,35,15,20,42,22,20,12,6,6,+3,+1,+2,73%,73%,74%,147,124,174,28%,24%,33%,12,7,5,9,6,3
481,https://vlr.gg/player/25081/yoman,2024-07-17 04:40:00,1.48,1.62,1.55,251,232,264,33,15,18,18,8,10,16,9,7,+3,+2,+1,75%,79%,71%,157,149,166,33%,30%,35%,5,3,2,2,1,1
482,https://vlr.gg/player/25048/sid,2024-07-17 04:40:00,1.60,1.10,1.37,237,237,245,31,17,14,19,7,12,12,6,6,+2,+3,-1,78%,84%,71%,150,162,137,33%,44%,23%,6,4,2,4,1,3
483,https://vlr.gg/player/42772/xross,2024-07-17 04:40:00,1.23,1.18,1.21,222,220,219,30,17,13,20,10,10,6,2,4,+1,0,+1,72%,74%,71%,137,134,140,32%,27%,37%,3,2,1,2,2,0
484,https://vlr.gg/player/28401/pkm,2024-07-17 04:40:00,1.50,0.59,1.07,203,239,160,25,17,8,23,9,14,11,6,5,+1,0,+1,78%,79%,76%,136,159,109,39%,43%,32%,4,2,2,3,2,1
485,https://vlr.gg/player/24979/cloy,2024-07-17 04:40:00,0.87,1.04,0.95,156,159,158,20,11,9,21,11,10,10,4,6,-1,0,-1,67%,68%,65%,104,102,106,38%,40%,37%,3,1,2,4,1,3
486,https://vlr.gg/player/4054/secret,2024-07-17 04:40:00,1.41,0.82,1.10,222,254,200,28,15,13,24,9,15,6,6,0,+1,+1,0,64%,71%,58%,147,172,124,48%,61%,38%,4,2,2,3,1,2
487,https://vlr.gg/player/4051/hann,2024-07-17 04:40:00,1.17,0.45,0.79,191,281,113,23,16,7,29,14,15,4,3,1,-2,+1,-3,56%,65%,47%,121,180,69,30%,31%,27%,7,5,2,9,4,5
488,https://vlr.gg/player/4062/wavy,2024-07-17 04:40:00,0.71,0.57,0.63,140,146,137,16,9,7,29,13,16,6,2,4,-2,-2,0,53%,65%,42%,97,98,96,22%,21%,24%,1,0,1,3,2,1
489,https://vlr.gg/player/9236/manggong,2024-07-17 04:40:00,0.40,0.76,0.59,146,110,176,17,6,11,29,14,15,6,2,4,-1,-1,0,61%,65%,58%,90,78,100,40%,32%,48%,2,0,2,3,1,2
490,https://vlr.gg/player/4038/bangnan,2024-07-17 04:40:00,0.67,0.33,0.49,118,132,103,17,10,7,28,12,16,2,1,1,-2,0,-2,47%,65%,32%,76,83,70,48%,40%,62%,1,1,0,3,1,2
491,https://vlr.gg/player/872/autumn,2024-07-17 04:00:00,,,,202,,,28,,,34,,,14,,,+1,,,,,,130,,,29%,,,4,,,3,,
492,https://vlr.gg/player/7857/berlin,2024-07-17 04:00:00,,,,178,,,24,,,29,,,14,,,-2,,,,,,129,,,22%,,,0,,,2,,
493,https://vlr.gg/player/19530/aaaay,2024-07-17 04:00:00,,,,169,,,26,,,31,,,12,,,+3,,,,,,108,,,40%,,,4,,,1,,
494,https://vlr.gg/player/3028/life,2024-07-17 04:00:00,,,,162,,,19,,,37,,,5,,,-3,,,,,,105,,,27%,,,10,,,13,,
495,https://vlr.gg/player/37489/lysoar,2024-07-17 04:00:00,,,,155,,,22,,,32,,,25,,,-1,,,,,,103,,,47%,,,1,,,2,,
496,https://vlr.gg/player/3045/luok1ng,2024-07-17 04:00:00,,,,270,,,41,,,21,,,15,,,0,,,,,,172,,,35%,,,3,,,3,,
497,https://vlr.gg/player/37494/kai,2024-07-17 04:00:00,,,,250,,,39,,,25,,,7,,,+5,,,,,,154,,,21%,,,11,,,6,,
498,https://vlr.gg/player/3021/biank,2024-07-17 04:00:00,,,,247,,,29,,,25,,,16,,,-4,,,,,,140,,,15%,,,1,,,5,,
499,https://vlr.gg/player/4770/fengf,2024-07-17 04:00:00,,,,230,,,37,,,21,,,8,,,+1,,,,,,157,,,22%,,,3,,,2,,
500,https://vlr.gg/player/4712/heybay,2024-07-17 04:00:00,,,,117,,,17,,,27,,,22,,,0,,,,,,80,,,27%,,,3,,,3,,
0,https://vlr.gg/player/30327/hakuna,2024-07-17 02:30:00,0.79,1.10,0.99,185,128,210,23,4,19,27,10,17,7,4,3,-3,-1,-2,58%,50%,63%,129,99,146,24%,11%,33%,2,1,1,5,2,3
1,https://vlr.gg/player/29282/maripo,2024-07-17 02:30:00,0.93,0.88,0.90,233,236,232,28,12,16,36,13,23,11,1,10,-1,0,-1,68%,64%,71%,154,150,156,24%,29%,21%,4,2,2,5,2,3
2,https://vlr.gg/player/29308/zodiac,2024-07-17 02:30:00,0.90,0.88,0.89,212,187,216,26,7,19,31,11,20,7,6,1,+2,-1,+3,63%,64%,63%,148,148,148,25%,24%,25%,3,0,3,1,1,0
3,https://vlr.gg/player/29307/r4m,2024-07-17 02:30:00,0.56,0.94,0.80,190,164,209,24,8,16,30,13,17,8,3,5,-1,-2,+1,66%,64%,67%,132,116,142,24%,21%,25%,4,0,4,5,2,3
4,https://vlr.gg/player/29297/hane,2024-07-17 02:30:00,0.93,0.56,0.69,135,127,148,18,8,10,32,10,22,16,4,12,-1,-2,+1,66%,57%,71%,91,92,90,47%,42%,50%,4,1,3,5,3,2
5,https://vlr.gg/player/10653/suzu,2024-07-17 02:30:00,1.49,1.46,1.48,297,308,291,43,28,15,24,16,8,10,4,6,+3,+1,+2,84%,88%,79%,187,187,188,31%,28%,39%,10,6,4,7,5,2
6,https://vlr.gg/player/29314/moco,2024-07-17 02:30:00,1.10,1.79,1.36,185,161,245,29,16,13,18,13,5,17,11,6,+2,+1,+1,87%,79%,100%,121,106,146,14%,16%,12%,3,2,1,1,1,0
7,https://vlr.gg/player/39902/ur,2024-07-17 02:30:00,1.36,1.02,1.24,257,289,199,37,25,12,25,17,8,12,9,3,0,0,0,84%,88%,79%,155,180,112,19%,21%,18%,2,1,1,2,1,1
8,https://vlr.gg/player/29316/aco,2024-07-17 02:30:00,0.99,0.72,0.89,163,173,128,21,16,5,24,16,8,17,10,7,-1,-2,+1,87%,88%,86%,109,117,96,22%,24%,19%,2,1,1,3,3,0
9,https://vlr.gg/player/39904/serena,2024-07-17 02:30:00,0.67,0.96,0.77,198,177,215,25,14,11,28,18,10,8,4,4,0,-2,+2,84%,83%,86%,123,120,129,17%,16%,19%,4,1,3,4,3,1
10,https://vlr.gg/player/44259/patrickwho,2024-07-17 02:00:00,1.25,1.39,1.32,293,311,275,86,45,41,59,32,27,18,9,9,-1,-5,+4,77%,68%,85%,181,188,175,32%,34%,30%,9,5,4,10,10,0
11,https://vlr.gg/player/10249/uyen,2024-07-17 02:00:00,0.85,1.40,1.12,244,190,301,66,24,42,60,32,28,18,5,13,+7,+4,+3,69%,59%,80%,167,129,205,27%,20%,32%,16,7,9,9,3,6
12,https://vlr.gg/player/7435/astr0,2024-07-17 02:00:00,0.84,1.00,0.92,178,199,159,48,27,21,58,34,24,33,15,18,+4,0,+4,70%,68%,73%,121,136,106,31%,33%,30%,7,2,5,3,2,1
13,https://vlr.gg/player/31398/ichisolo,2024-07-17 02:00:00,0.69,1.15,0.92,165,146,185,48,20,28,54,32,22,13,5,8,-2,+1,-3,67%,61%,73%,114,102,127,35%,34%,35%,4,2,2,6,1,5
14,https://vlr.gg/player/37375/chanyboi,2024-07-17 02:00:00,0.63,0.88,0.75,143,120,171,37,15,22,58,31,27,44,17,27,-2,-2,0,70%,63%,78%,99,74,124,26%,26%,26%,7,3,4,9,5,4
15,https://vlr.gg/player/7437/kellys,2024-07-17 02:00:00,0.89,1.37,1.13,250,214,287,63,25,38,62,33,29,28,13,15,+8,+1,+7,72%,63%,80%,176,154,196,12%,12%,12%,16,7,9,8,6,2
16,https://vlr.gg/player/10782/witz,2024-07-17 02:00:00,0.96,1.28,1.12,217,192,242,61,29,32,56,31,25,38,13,25,-2,-2,0,72%,65%,78%,139,118,159,27%,29%,25%,6,2,4,8,4,4
17,https://vlr.gg/player/7754/xavi8k,2024-07-17 02:00:00,0.82,1.35,1.09,217,166,269,62,21,41,53,29,24,19,10,9,+1,0,+1,74%,70%,78%,148,119,175,24%,31%,21%,8,4,4,7,4,3
18,https://vlr.gg/player/10217/marky,2024-07-17 02:00:00,0.91,1.00,0.96,190,185,196,54,27,27,60,32,28,24,10,14,-4,-2,-2,80%,70%,90%,136,124,148,23%,23%,24%,6,2,4,10,4,6
19,https://vlr.gg/player/2679/dubstep,2024-07-17 02:00:00,0.91,0.88,0.90,160,180,138,49,26,23,54,29,25,29,12,17,-9,-5,-4,70%,68%,73%,106,120,92,35%,35%,35%,1,1,0,10,6,4
20,https://vlr.gg/player/20879/sungjin,2024-07-17 02:00:00,1.19,1.75,1.63,284,236,297,16,3,13,5,1,4,2,0,2,+3,0,+3,93%,100%,92%,195,204,193,41%,33%,42%,3,0,3,0,0,0
21,https://vlr.gg/player/4475/benecia,2024-07-17 02:00:00,1.09,1.50,1.34,237,192,263,35,11,24,24,11,13,26,9,17,+2,-1,+3,93%,88%,96%,147,111,170,23%,15%,27%,4,1,3,2,2,0
22,https://vlr.gg/player/9192/cloudy,2024-07-17 02:00:00,1.07,1.62,1.34,275,219,332,23,9,14,19,9,10,10,3,7,+3,0,+3,81%,85%,77%,181,135,228,29%,21%,35%,5,1,4,2,1,1
23,https://vlr.gg/player/37535/jaebin,2024-07-17 02:00:00,1.07,1.21,1.15,244,241,252,37,15,22,27,11,16,14,4,10,-1,-1,0,85%,75%,92%,148,120,165,13%,11%,14%,4,2,2,5,3,2
24,https://vlr.gg/player/13000/redlight,2024-07-17 02:00:00,0.62,1.35,1.07,201,172,220,31,9,22,27,13,14,7,3,4,+5,+1,+4,73%,56%,84%,134,112,148,27%,29%,26%,7,2,5,2,1,1
25,https://vlr.gg/player/4657/moves,2024-07-17 02:00:00,1.18,0.82,0.96,173,192,150,25,10,15,26,9,17,20,12,8,-1,-1,0,78%,81%,76%,100,122,87,20%,21%,19%,3,1,2,4,2,2
26,https://vlr.gg/player/985/efina,2024-07-17 02:00:00,0.85,1.43,1.08,198,186,264,31,16,15,30,21,9,5,3,2,+2,-1,+3,71%,56%,94%,148,137,166,33%,33%,32%,4,1,3,2,2,0
27,https://vlr.gg/player/5283/bunny,2024-07-17 02:00:00,0.71,1.16,0.88,234,217,265,32,17,15,36,24,12,9,6,3,-2,-4,+2,71%,68%,75%,143,130,164,17%,16%,18%,6,3,3,8,7,1
28,https://vlr.gg/player/4827/goddead,2024-07-17 02:00:00,0.57,0.99,0.73,165,168,198,24,13,11,35,23,12,15,9,6,-2,-4,+2,78%,80%,75%,122,116,131,36%,34%,39%,2,0,2,4,4,0
29,https://vlr.gg/player/5280/972,2024-07-17 02:00:00,0.76,0.61,0.70,148,176,125,24,16,8,34,22,12,8,4,4,-6,-5,-1,59%,52%,69%,108,117,96,30%,27%,36%,0,0,0,6,5,1
30,https://vlr.gg/player/9783/doenmo,2024-07-17 02:00:00,0.71,0.55,0.65,134,139,104,17,12,5,32,20,12,13,6,7,-3,+1,-4,54%,52%,56%,88,96,75,25%,26%,24%,3,2,1,6,1,5
31,https://vlr.gg/player/45423/neko,2024-07-17 00:00:00,1.12,0.95,1.05,227,229,222,31,18,13,29,17,12,7,2,5,-5,-3,-2,70%,70%,71%,146,148,144,18%,21%,15%,6,4,2,11,7,4
32,https://vlr.gg/player/39879/daf,2024-07-17 00:00:00,0.93,1.15,1.02,218,166,285,29,12,17,29,15,14,12,8,4,+3,+1,+2,70%,70%,71%,146,117,185,27%,20%,34%,6,3,3,3,2,1
33,https://vlr.gg/player/39905/meimei,2024-07-17 00:00:00,1.10,0.70,0.93,175,197,149,25,17,8,30,16,14,8,2,6,0,0,0,68%,70%,65%,111,120,99,21%,19%,23%,2,1,1,2,1,1
34,https://vlr.gg/player/39887/mochirrrr,2024-07-17 00:00:00,0.50,0.65,0.57,99,103,107,13,7,6,26,15,11,6,3,3,-1,0,-1,60%,52%,71%,82,79,86,10%,8%,12%,0,0,0,1,0,1
35,https://vlr.gg/player/39906/lucky,2024-07-17 00:00:00,0.60,0.41,0.52,120,133,103,16,11,5,31,17,14,15,6,9,-7,-3,-4,60%,52%,71%,74,82,62,10%,15%,4%,1,1,0,8,4,4
36,https://vlr.gg/player/25391/bes,2024-07-17 00:00:00,1.30,1.40,1.36,249,221,267,36,13,23,22,9,13,14,5,9,+4,+3,+1,73%,82%,65%,155,132,172,32%,32%,32%,6,3,3,2,0,2
37,https://vlr.gg/player/43037/ache,2024-07-17 00:00:00,1.17,1.50,1.36,257,248,266,38,16,22,24,12,12,8,3,5,+4,+1,+3,80%,82%,78%,173,169,175,31%,37%,24%,7,3,4,3,2,1
38,https://vlr.gg/player/29272/a1ka,2024-07-17 00:00:00,1.50,0.94,1.17,189,251,128,28,17,11,19,8,11,6,1,5,0,+1,-1,80%,88%,74%,131,184,92,25%,30%,20%,4,2,2,4,1,3
39,https://vlr.gg/player/29299/healing,2024-07-17 00:00:00,1.02,0.96,0.98,179,177,176,24,10,14,25,10,15,18,8,10,-2,-1,-1,78%,94%,65%,113,104,120,20%,18%,22%,3,2,1,5,3,2
40,https://vlr.gg/player/29269/yome,2024-07-17 00:00:00,0.86,0.92,0.89,145,152,140,19,9,10,24,10,14,17,6,11,+4,+1,+3,70%,71%,70%,94,102,88,36%,41%,32%,5,1,4,1,0,1
41,https://vlr.gg/player/29286/nekopanchi,2024-07-16 21:15:00,0.90,1.39,1.20,204,151,232,42,12,30,33,14,19,23,8,15,+1,+1,0,71%,77%,67%,128,105,142,40%,50%,36%,6,2,4,5,1,4
42,https://vlr.gg/player/29271/festival,2024-07-16 21:15:00,1.19,1.18,1.19,288,295,272,59,23,36,43,18,25,6,3,3,+12,+6,+6,78%,82%,75%,175,180,172,26%,30%,24%,16,7,9,4,1,3
43,https://vlr.gg/player/29280/merununtius,2024-07-16 21:15:00,1.31,0.72,0.94,160,205,134,33,16,17,41,15,26,25,13,12,+4,+1,+3,67%,73%,64%,107,160,74,27%,22%,36%,6,1,5,2,0,2
44,https://vlr.gg/player/39873/shiye,2024-07-16 21:15:00,1.10,0.82,0.93,195,202,189,37,16,21,40,15,25,15,3,12,+2,+2,0,69%,68%,69%,135,134,135,21%,34%,15%,4,3,1,2,1,1
45,https://vlr.gg/player/30315/fullmoon,2024-07-16 21:15:00,0.58,1.01,0.84,203,175,222,41,14,27,43,20,23,18,7,11,-1,-2,+1,72%,64%,78%,128,110,140,22%,39%,17%,6,2,4,7,4,3
46,https://vlr.gg/player/29281/onni,2024-07-16 21:15:00,1.10,1.45,1.23,241,214,314,50,27,23,44,26,18,18,10,8,0,-3,+3,62%,56%,73%,162,131,215,21%,16%,26%,11,4,7,11,7,4
47,https://vlr.gg/player/29287/dori,2024-07-16 21:15:00,1.15,0.96,1.07,204,222,182,44,28,16,42,26,16,12,9,3,-6,-3,-3,67%,64%,73%,132,144,112,36%,39%,32%,3,3,0,9,6,3
48,https://vlr.gg/player/29273/len,2024-07-16 21:15:00,0.92,1.04,0.97,203,211,194,41,26,15,44,29,15,19,10,9,0,+2,-2,59%,58%,59%,123,124,120,18%,18%,17%,4,4,0,4,2,2
49,https://vlr.gg/player/42542/ggonyak,2024-07-16 21:15:00,1.02,0.76,0.92,184,191,180,39,25,14,41,25,16,12,6,6,-8,-4,-4,62%,61%,64%,123,126,117,34%,36%,32%,2,2,0,10,6,4
50,https://vlr.gg/player/39907/koyori,2024-07-16 21:15:00,0.64,0.94,0.75,141,108,193,25,12,13,41,25,16,31,16,15,-4,-2,-2,71%,67%,77%,95,71,133,15%,13%,18%,0,0,0,4,2,2
51,https://vlr.gg/player/42867/ghoul33,2024-07-16 18:30:00,1.24,1.25,1.24,280,291,260,70,36,34,53,27,26,13,3,10,+5,+2,+3,72%,71%,74%,166,168,164,44%,38%,51%,14,8,6,9,6,3
52,https://vlr.gg/player/2486/pollo,2024-07-16 18:30:00,1.04,1.11,1.07,202,215,195,52,25,27,49,26,23,16,8,8,+3,+1,+2,72%,68%,76%,138,144,133,34%,31%,38%,7,3,4,4,2,2
53,https://vlr.gg/player/5722/prince,2024-07-16 18:30:00,0.96,1.18,1.07,206,192,223,47,22,25,45,23,22,29,11,18,0,+2,-2,79%,74%,85%,151,134,169,28%,31%,27%,4,2,2,4,0,4
54,https://vlr.gg/player/21251/blowz,2024-07-16 18:30:00,0.84,1.13,0.98,218,191,246,48,22,26,51,26,25,22,10,12,-4,-3,-1,72%,71%,74%,153,121,185,23%,21%,24%,7,3,4,11,6,5
55,https://vlr.gg/player/1578/shion,2024-07-16 18:30:00,0.60,1.26,0.93,169,111,226,37,11,26,44,23,21,28,9,19,+2,0,+2,68%,59%,76%,115,81,150,25%,17%,31%,5,2,3,3,2,1
56,https://vlr.gg/player/20240/xenom,2024-07-16 18:30:00,1.61,1.14,1.37,263,301,234,62,37,25,48,24,24,25,13,12,+5,+2,+3,79%,76%,82%,174,197,150,38%,42%,34%,7,2,5,2,0,2
57,https://vlr.gg/player/3424/siduzord,2024-07-16 18:30:00,0.95,1.16,1.05,198,187,210,50,23,27,44,24,20,8,4,4,-4,-1,-3,65%,65%,65%,134,138,130,31%,41%,24%,2,1,1,6,2,4
58,https://vlr.gg/player/13823/pxs,2024-07-16 18:30:00,0.83,1.08,0.95,221,220,223,48,22,26,53,30,23,19,9,10,-5,-4,-1,68%,68%,68%,158,153,162,24%,19%,29%,14,9,5,19,13,6
59,https://vlr.gg/player/6202/guuih,2024-07-16 18:30:00,0.75,0.87,0.81,194,193,196,47,25,22,55,29,26,9,3,6,+1,+2,-1,72%,76%,68%,133,123,143,40%,48%,34%,6,3,3,5,1,4
60,https://vlr.gg/player/23010/nicksz,2024-07-16 18:30:00,0.31,1.12,0.71,156,108,205,35,10,25,54,31,23,30,15,15,-3,-3,0,68%,59%,76%,105,77,134,21%,20%,21%,2,0,2,5,3,2
61,https://vlr.gg/player/34400/bao,2024-07-16 18:10:00,1.14,1.28,1.22,259,230,272,53,20,33,44,19,25,29,8,21,-1,0,-1,76%,73%,78%,158,143,169,24%,22%,25%,5,1,4,6,1,5
62,https://vlr.gg/player/26565/jas0n,2024-07-16 18:10:00,0.97,1.29,1.16,238,227,240,48,20,28,39,19,20,14,5,9,+5,+1,+4,77%,73%,81%,152,149,155,18%,25%,14%,13,6,7,8,5,3
63,https://vlr.gg/player/2171/cavern,2024-07-16 18:10:00,0.83,1.29,1.10,209,190,217,46,17,29,39,20,19,24,8,16,-1,-1,0,69%,65%,72%,126,114,134,18%,14%,22%,3,1,2,4,2,2
64,https://vlr.gg/player/5128/polkan,2024-07-16 18:10:00,0.95,0.98,0.97,197,155,210,41,13,28,40,15,25,18,6,12,-5,-2,-3,68%,58%,75%,123,107,135,42%,53%,36%,4,2,2,9,4,5
65,https://vlr.gg/player/39021/notexxd,2024-07-16 18:10:00,1.19,0.77,0.95,178,211,155,38,19,19,42,17,25,28,15,13,-2,-2,0,69%,54%,81%,118,133,108,38%,43%,34%,4,1,3,6,3,3
66,https://vlr.gg/player/2118/silenx,2024-07-16 18:10:00,1.24,0.89,1.09,214,235,201,46,29,17,49,28,21,35,24,11,+4,+2,+2,82%,83%,81%,138,142,134,30%,23%,46%,8,4,4,4,2,2
67,https://vlr.gg/player/3227/screwface,2024-07-16 18:10:00,0.80,1.37,1.04,189,155,247,42,19,23,41,25,16,20,6,14,+2,-1,+3,71%,61%,85%,122,100,152,30%,28%,32%,6,3,3,4,4,0
68,https://vlr.gg/player/9063/infiltrator,2024-07-16 18:10:00,0.81,1.07,0.92,216,222,221,44,26,18,48,30,18,12,6,6,-3,-2,-1,58%,56%,62%,145,141,149,28%,34%,21%,9,6,3,12,8,4
69,https://vlr.gg/player/765/jerk,2024-07-16 18:10:00,0.81,0.92,0.86,182,167,188,35,20,15,42,25,17,15,8,7,+1,0,+1,77%,72%,85%,115,108,123,18%,28%,12%,3,1,2,2,1,1
70,https://vlr.gg/player/17865/nahsie,2024-07-16 18:10:00,0.81,0.82,0.82,162,176,158,36,20,16,46,29,17,27,19,8,0,+1,-1,63%,67%,58%,100,106,92,24%,30%,16%,7,4,3,7,3,4
71,https://vlr.gg/player/6195/lz,2024-07-16 16:00:00,1.50,0.87,1.19,217,266,174,40,22,18,33,13,20,15,12,3,-2,-2,0,69%,77%,62%,144,173,114,44%,47%,40%,2,1,1,4,3,1
72,https://vlr.gg/player/662/pryze,2024-07-16 16:00:00,0.85,1.18,1.02,205,160,241,32,14,18,36,17,19,19,8,11,0,0,0,75%,77%,73%,136,109,163,30%,28%,31%,2,1,1,2,1,1
73,https://vlr.gg/player/3169/zap,2024-07-16 16:00:00,0.72,0.93,0.83,174,163,184,31,15,16,37,18,19,10,3,7,+5,+2,+3,63%,62%,65%,106,90,123,26%,26%,26%,10,5,5,5,3,2
74,https://vlr.gg/player/11921/silentzz,2024-07-16 16:00:00,0.79,0.73,0.76,169,177,160,31,17,14,39,19,20,4,2,2,0,+1,-1,73%,73%,73%,118,125,111,36%,46%,28%,4,2,2,4,1,3
75,https://vlr.gg/player/21661/spike,2024-07-16 16:00:00,0.87,0.57,0.72,151,171,133,26,14,12,38,18,20,19,12,7,-9,-3,-6,67%,77%,58%,92,99,85,29%,38%,19%,5,3,2,14,6,8
76,https://vlr.gg/player/1688/rood,2024-07-16 16:00:00,1.36,1.08,1.22,216,226,208,37,20,17,30,13,17,19,7,12,+2,0,+2,77%,81%,73%,141,149,133,23%,19%,27%,5,0,5,3,0,3
77,https://vlr.gg/player/21659/sato,2024-07-16 16:00:00,1.09,1.31,1.20,243,254,240,46,24,22,34,21,13,6,4,2,+7,+4,+3,79%,73%,85%,165,174,155,36%,35%,38%,13,10,3,6,6,0
78,https://vlr.gg/player/28716/lukxo,2024-07-16 16:00:00,1.40,0.90,1.15,199,251,150,37,24,13,30,15,15,17,6,11,0,+3,-3,69%,69%,69%,136,171,101,23%,22%,27%,4,4,0,4,1,3
79,https://vlr.gg/player/6238/urango,2024-07-16 16:00:00,1.05,0.94,0.99,185,187,184,34,18,16,33,15,18,13,9,4,-2,-1,-1,81%,85%,77%,114,118,111,32%,38%,28%,3,0,3,5,1,4
80,https://vlr.gg/player/1994/evilkyk,2024-07-16 16:00:00,0.81,0.97,0.89,156,121,185,29,12,17,33,14,19,12,8,4,-1,-2,+1,63%,73%,54%,101,84,118,35%,22%,52%,4,1,3,5,3,2
81,https://vlr.gg/player/71/drone,2024-07-16 16:00:00,1.07,0.98,1.02,216,245,205,30,13,17,31,12,19,10,5,5,-1,+1,-2,70%,81%,63%,141,156,131,48%,44%,52%,2,1,1,3,0,3
82,https://vlr.gg/player/3012/riku,2024-07-16 16:00:00,1.11,0.84,0.94,199,242,181,28,15,13,31,12,19,14,6,8,+2,+1,+1,68%,69%,67%,132,136,130,25%,30%,21%,6,2,4,4,1,3
83,https://vlr.gg/player/766/ange,2024-07-16 16:00:00,0.93,0.75,0.82,162,184,147,23,10,13,30,12,18,14,8,6,-1,-2,+1,70%,88%,58%,103,119,92,17%,17%,18%,4,1,3,5,3,2
84,https://vlr.gg/player/468/zachareee,2024-07-16 16:00:00,0.89,0.70,0.78,180,186,171,25,12,13,31,11,20,8,4,4,-5,-3,-2,53%,56%,50%,120,106,129,29%,33%,26%,2,1,1,7,4,3
85,https://vlr.gg/player/8118/precision,2024-07-16 16:00:00,0.54,0.62,0.59,135,109,151,18,6,12,32,11,21,11,2,9,-1,+1,-2,58%,56%,58%,92,85,98,31%,22%,39%,3,2,1,4,1,3
86,https://vlr.gg/player/2118/silenx,2024-07-16 16:00:00,1.60,1.01,1.36,254,271,220,35,22,13,25,12,13,20,15,5,+3,+1,+2,78%,79%,75%,162,179,137,31%,28%,38%,6,4,2,3,3,0
87,https://vlr.gg/player/9063/infiltrator,2024-07-16 16:00:00,1.18,1.51,1.31,265,257,284,40,23,17,27,16,11,7,5,2,+2,+2,0,75%,75%,75%,166,164,168,28%,31%,25%,9,6,3,7,4,3
88,https://vlr.gg/player/765/jerk,2024-07-16 16:00:00,1.46,0.88,1.23,207,237,163,28,22,6,23,13,10,11,5,6,0,+1,-1,68%,75%,56%,136,145,123,26%,25%,26%,1,1,0,1,0,1
89,https://vlr.gg/player/17865/nahsie,2024-07-16 16:00:00,0.94,1.36,1.11,199,181,228,30,16,14,25,16,9,15,12,3,-1,-1,0,70%,75%,63%,127,114,147,29%,22%,39%,2,1,1,3,2,1
90,https://vlr.gg/player/3227/screwface,2024-07-16 16:00:00,1.15,0.68,0.96,170,165,164,22,14,8,24,11,13,19,11,8,+2,+1,+1,68%,75%,56%,108,119,92,30%,34%,23%,5,2,3,3,1,2
91,https://vlr.gg/player/8044/mrfalin,2024-07-16 15:45:00,0.96,1.14,1.06,192,190,202,30,12,18,29,13,16,21,11,10,-1,0,-1,70%,60%,77%,131,123,137,28%,20%,36%,4,2,2,5,2,3
92,https://vlr.gg/player/8369/yetujey,2024-07-16 15:45:00,1.18,0.80,0.97,197,220,177,31,17,14,33,13,20,15,7,8,+3,0,+3,65%,60%,69%,118,120,117,19%,23%,16%,5,1,4,2,1,1
93,https://vlr.gg/player/1139/qraxs,2024-07-16 15:45:00,1.08,0.74,0.89,150,177,137,27,12,15,29,11,18,11,7,4,0,0,0,72%,80%,65%,91,108,79,26%,28%,24%,2,1,1,2,1,1
94,https://vlr.gg/player/573/cned,2024-07-16 15:45:00,0.77,0.81,0.80,195,217,187,27,13,14,37,16,21,10,3,7,-1,+1,-2,65%,65%,65%,146,147,146,24%,26%,22%,6,4,2,7,3,4
95,https://vlr.gg/player/6510/atakaptan,2024-07-16 15:45:00,0.85,0.70,0.77,155,166,150,27,12,15,34,13,21,12,6,6,-3,-3,0,63%,65%,62%,100,105,96,31%,37%,27%,5,1,4,8,4,4
96,https://vlr.gg/player/9810/alfajer,2024-07-16 15:45:00,1.36,1.44,1.39,276,236,283,44,22,22,28,14,14,8,4,4,+1,0,+1,76%,77%,75%,165,157,177,36%,30%,43%,3,1,2,2,1,1
97,https://vlr.gg/player/458/chronicle,2024-07-16 15:45:00,1.28,1.10,1.20,166,192,144,27,19,8,20,11,9,12,3,9,+4,+3,+1,78%,73%,85%,114,125,100,27%,32%,17%,4,3,1,0,0,0
98,https://vlr.gg/player/5022/derke,2024-07-16 15:45:00,0.89,1.29,1.07,219,201,259,34,18,16,34,20,14,5,3,2,+1,+2,-1,63%,69%,55%,152,128,183,25%,32%,21%,8,5,3,7,3,4
99,https://vlr.gg/player/29867/hiro,2024-07-16 15:45:00,1.13,0.79,0.98,198,229,172,31,21,10,29,15,14,10,7,3,-2,-4,+2,65%,69%,60%,138,152,121,36%,47%,24%,4,1,3,6,5,1
100,https://vlr.gg/player/438/boaster,2024-07-16 15:45:00,1.09,0.72,0.93,181,182,158,26,16,10,31,16,15,15,8,7,-2,-1,-1,65%,69%,60%,120,129,110,27%,28%,25%,5,3,2,7,4,3
101,https://vlr.gg/player/1144/boo,2024-07-16 12:00:00,1.22,1.37,1.29,219,219,220,60,30,30,47,26,21,30,16,14,0,-2,+2,76%,79%,73%,135,133,138,32%,28%,39%,5,2,3,5,4,1
102,https://vlr.gg/player/10971/riens,2024-07-16 12:00:00,1.12,1.03,1.08,207,214,204,50,26,24,48,25,23,27,14,13,-5,-3,-2,79%,82%,76%,140,144,136,34%,33%,34%,4,2,2,9,5,4
103,https://vlr.gg/player/29873/benjyfishy,2024-07-16 12:00:00,0.78,1.25,1.01,175,150,204,49,20,29,48,28,20,11,5,6,-2,-1,-1,65%,66%,65%,115,94,136,33%,29%,37%,4,1,3,6,2,4
104,https://vlr.gg/player/18350/miniboo,2024-07-16 12:00:00,0.71,1.08,0.89,218,203,231,55,26,29,59,33,26,19,8,11,+5,-3,+8,71%,66%,76%,138,129,147,28%,29%,28%,16,6,10,11,9,2
105,https://vlr.gg/player/21328/wo0t,2024-07-16 12:00:00,0.82,0.67,0.75,155,156,160,42,22,20,59,29,30,31,11,20,0,+1,-1,75%,71%,78%,105,101,109,30%,31%,30%,7,4,3,7,3,4
106,https://vlr.gg/player/2168/trexx,2024-07-16 12:00:00,1.21,1.41,1.31,236,210,265,59,26,33,46,22,24,36,16,20,-1,-3,+2,80%,76%,84%,166,150,182,19%,21%,17%,5,2,3,6,5,1
107,https://vlr.gg/player/312/sayf,2024-07-16 12:00:00,1.26,1.03,1.15,242,257,224,66,34,32,55,27,28,13,6,7,+2,-1,+3,65%,68%,63%,163,173,153,27%,27%,27%,11,5,6,9,6,3
108,https://vlr.gg/player/11134/kicks,2024-07-16 12:00:00,0.79,1.04,0.92,171,159,182,46,20,26,51,27,24,28,10,18,-3,-4,+1,71%,62%,79%,118,108,128,21%,18%,23%,4,1,3,7,5,2
109,https://vlr.gg/player/21610/runner,2024-07-16 12:00:00,0.79,1.03,0.92,188,179,200,47,21,26,52,27,25,30,15,15,+9,+4,+5,73%,65%,82%,123,110,136,15%,13%,16%,13,6,7,4,2,2
110,https://vlr.gg/player/4321/cender,2024-07-16 12:00:00,0.71,1.01,0.86,153,143,167,43,19,24,52,29,23,28,13,15,-5,-2,-3,72%,70%,74%,98,96,101,31%,32%,30%,5,1,4,10,3,7
111,https://vlr.gg/player/2381/divine,2024-07-16 10:45:00,1.40,1.35,1.37,244,226,255,58,25,33,36,17,19,22,9,13,-1,-1,0,82%,76%,86%,152,149,155,44%,53%,38%,4,1,3,5,2,3
112,https://vlr.gg/player/9158/hyk,2024-07-16 10:45:00,0.83,1.44,1.17,208,158,245,52,18,34,40,23,17,22,13,9,+3,+1,+2,75%,59%,89%,133,99,160,36%,52%,29%,5,2,3,2,1,1
113,https://vlr.gg/player/24654/tempz,2024-07-16 10:45:00,1.07,0.86,0.95,175,192,177,42,21,21,43,20,23,22,9,13,-1,-1,0,74%,76%,72%,124,121,126,29%,27%,30%,6,1,5,7,2,5
114,https://vlr.gg/player/11737/xan,2024-07-16 10:45:00,0.76,1.10,0.95,230,219,229,47,20,27,49,25,24,21,10,11,0,-4,+4,80%,76%,83%,154,157,150,17%,19%,16%,12,6,6,12,10,2
115,https://vlr.gg/player/8137/lenne,2024-07-16 10:45:00,0.92,0.98,0.95,220,209,215,44,18,26,48,22,26,31,12,19,+2,-2,+4,74%,72%,75%,141,144,138,21%,24%,19%,7,1,6,5,3,2
116,https://vlr.gg/player/3480/thedoctorr,2024-07-16 10:45:00,1.34,0.96,1.17,218,232,200,48,29,19,47,26,21,35,18,17,-3,-3,0,78%,78%,79%,148,164,128,40%,46%,33%,1,0,1,4,3,1
117,https://vlr.gg/player/45876/fixy,2024-07-16 10:45:00,1.07,0.79,0.95,201,237,166,47,31,16,51,29,22,9,3,6,-1,0,-1,65%,64%,66%,132,147,112,28%,36%,18%,11,6,5,12,6,6
118,https://vlr.gg/player/2378/subbey,2024-07-16 10:45:00,0.83,0.95,0.88,182,178,198,43,22,21,51,30,21,19,12,7,+3,-1,+4,68%,69%,66%,117,117,116,35%,33%,38%,7,2,5,4,3,1
119,https://vlr.gg/player/7513/markl,2024-07-16 10:45:00,0.55,1.27,0.87,165,124,220,41,16,25,47,28,19,8,3,5,-3,-2,-1,65%,47%,86%,112,80,152,23%,20%,27%,7,5,2,10,7,3
120,https://vlr.gg/player/21051/jans0n,2024-07-16 10:45:00,0.53,1.19,0.82,151,91,235,37,11,26,47,28,19,17,12,5,+1,-4,+5,69%,67%,72%,102,63,149,24%,24%,24%,5,0,5,4,4,0
121,https://vlr.gg/player/16852/nakya,2024-07-16 07:00:00,1.11,0.89,1.02,236,276,188,55,35,20,58,34,24,11,9,2,+3,+4,-1,61%,62%,61%,159,179,132,34%,32%,40%,15,12,3,12,8,4
122,https://vlr.gg/player/27068/pudj,2024-07-16 07:00:00,1.08,0.76,0.95,181,223,135,46,33,13,46,28,18,11,9,2,-5,-3,-2,64%,69%,57%,121,138,97,27%,24%,34%,5,3,2,10,6,4
123,https://vlr.gg/player/5886/flaring,2024-07-16 07:00:00,0.98,0.72,0.87,169,187,161,41,27,14,50,26,24,22,15,7,+1,-1,+2,67%,72%,61%,108,114,99,22%,19%,28%,5,1,4,4,2,2
124,https://vlr.gg/player/7443/riza,2024-07-16 07:00:00,0.81,0.94,0.86,174,157,206,42,23,19,50,29,21,10,6,4,-3,-1,-2,58%,59%,57%,123,113,136,23%,27%,19%,1,0,1,4,1,3
125,https://vlr.gg/player/7381/redkoh,2024-07-16 07:00:00,0.92,0.54,0.76,127,132,121,30,18,12,52,28,24,31,21,10,-3,-2,-1,63%,72%,50%,81,82,81,17%,20%,13%,4,2,2,7,4,3
126,https://vlr.gg/player/24628/wayne,2024-07-16 07:00:00,1.46,1.11,1.25,273,267,242,60,28,32,42,15,27,24,9,15,+6,+4,+2,75%,79%,72%,156,156,157,32%,40%,28%,11,6,5,5,2,3
127,https://vlr.gg/player/11704/styron,2024-07-16 07:00:00,1.17,1.11,1.13,182,170,195,44,18,26,36,12,24,26,8,18,-2,0,-2,72%,75%,69%,120,113,125,25%,27%,24%,4,2,2,6,2,4
128,https://vlr.gg/player/24653/vera,2024-07-16 07:00:00,1.25,1.03,1.12,251,251,254,58,26,32,50,20,30,14,5,9,+5,+3,+2,75%,79%,72%,163,168,159,18%,27%,14%,14,6,8,9,3,6
129,https://vlr.gg/player/34032/grumble,2024-07-16 07:00:00,1.38,0.89,1.10,219,258,186,52,27,25,42,15,27,20,10,10,-1,-1,0,79%,86%,74%,153,184,130,39%,35%,45%,2,0,2,3,1,2
130,https://vlr.gg/player/7426/juicy,2024-07-16 07:00:00,0.77,1.02,0.92,177,132,216,42,12,30,44,16,28,13,5,8,-1,-2,+1,73%,75%,72%,112,93,126,27%,29%,27%,6,2,4,7,4,3
131,https://vlr.gg/player/36415/viva,2024-07-16 06:25:00,,,,254,,,37,,,30,,,10,,,+2,,,,,,162,,,29%,,,3,,,1,,
132,https://vlr.gg/player/41029/z1yan,2024-07-16 06:25:00,,,,207,,,31,,,33,,,14,,,+3,,,,,,131,,,29%,,,5,,,2,,
133,https://vlr.gg/player/16924/stew,2024-07-16 06:25:00,,,,185,,,26,,,31,,,5,,,-7,,,,,,133,,,30%,,,3,,,10,,
134,https://vlr.gg/player/10486/yhchen,2024-07-16 06:25:00,,,,178,,,22,,,34,,,17,,,+2,,,,,,116,,,27%,,,5,,,3,,
135,https://vlr.gg/player/3519/jkuro,2024-07-16 06:25:00,,,,136,,,22,,,36,,,4,,,-2,,,,,,93,,,36%,,,4,,,6,,
136,https://vlr.gg/player/6022/yosemite,2024-07-16 06:25:00,,,,275,,,39,,,30,,,12,,,+2,,,,,,179,,,20%,,,6,,,4,,
137,https://vlr.gg/player/4885/whzy,2024-07-16 06:25:00,,,,268,,,40,,,31,,,10,,,0,,,,,,167,,,31%,,,9,,,9,,
138,https://vlr.gg/player/4774/knight,2024-07-16 06:25:00,,,,192,,,28,,,25,,,22,,,0,,,,,,122,,,27%,,,2,,,2,,
139,https://vlr.gg/player/10698/nephh,2024-07-16 06:25:00,,,,191,,,29,,,27,,,17,,,+1,,,,,,117,,,20%,,,1,,,0,,
140,https://vlr.gg/player/4705/flex1n,2024-07-16 06:25:00,,,,173,,,28,,,25,,,17,,,-1,,,,,,100,,,24%,,,4,,,5,,
141,https://vlr.gg/player/43037/ache,2024-07-16 04:40:00,0.88,1.60,1.23,263,221,309,60,25,35,43,25,18,11,4,7,+11,+3,+8,70%,61%,81%,179,152,208,21%,16%,29%,16,6,10,5,3,2
142,https://vlr.gg/player/25391/bes,2024-07-16 04:40:00,1.15,0.86,1.01,221,265,177,49,30,19,46,25,21,22,11,11,+1,-1,+2,72%,70%,74%,146,172,118,31%,30%,33%,7,3,4,6,4,2
143,https://vlr.gg/player/29299/healing,2024-07-16 04:40:00,0.83,1.20,1.01,219,175,266,44,18,26,48,25,23,36,18,18,+4,-2,+6,80%,76%,84%,139,122,156,17%,25%,13%,9,1,8,5,3,2
144,https://vlr.gg/player/29269/yome,2024-07-16 04:40:00,0.90,1.12,1.01,186,185,187,44,22,22,42,25,17,19,9,10,0,-1,+1,75%,70%,81%,122,123,120,31%,35%,27%,3,2,1,3,3,0
145,https://vlr.gg/player/29272/a1ka,2024-07-16 04:40:00,0.58,0.56,0.57,119,128,110,25,14,11,46,25,21,10,4,6,-4,-2,-2,64%,61%,68%,87,93,81,30%,32%,28%,3,3,0,7,5,2
146,https://vlr.gg/player/29293/yunah,2024-07-16 04:40:00,1.24,1.27,1.26,215,196,233,53,26,27,41,20,21,22,9,13,-1,-1,0,78%,77%,79%,131,109,151,29%,31%,28%,4,1,3,5,2,3
147,https://vlr.gg/player/39913/yuzu,2024-07-16 04:40:00,0.89,1.26,1.08,194,159,226,42,14,28,43,21,22,30,15,15,-1,-1,0,75%,71%,79%,120,102,137,20%,13%,28%,1,0,1,2,1,1
148,https://vlr.gg/player/29331/dia,2024-07-16 04:40:00,0.95,1.09,1.03,243,240,249,53,25,28,54,28,26,13,4,9,-4,-6,+2,69%,68%,70%,156,153,158,33%,33%,33%,17,7,10,21,13,8
149,https://vlr.gg/player/29267/krenn,2024-07-16 04:40:00,0.87,1.12,1.00,183,173,193,42,17,25,43,23,20,14,8,6,-6,-5,-1,70%,71%,70%,125,124,127,31%,28%,34%,2,0,2,8,5,3
150,https://vlr.gg/player/46914/miya,2024-07-16 04:40:00,0.80,1.05,0.93,155,153,155,34,17,17,41,22,19,22,7,15,0,-2,+2,72%,68%,76%,102,100,103,25%,37%,16%,2,0,2,2,2,0
151,https://vlr.gg/player/3021/biank,2024-07-16 04:00:00,,,,232,,,34,,,30,,,16,,,+1,,,,,,144,,,26%,,,6,,,5,,
152,https://vlr.gg/player/37494/kai,2024-07-16 04:00:00,,,,227,,,36,,,29,,,8,,,+1,,,,,,143,,,17%,,,5,,,4,,
153,https://vlr.gg/player/4770/fengf,2024-07-16 04:00:00,,,,226,,,35,,,29,,,8,,,+2,,,,,,153,,,26%,,,9,,,7,,
154,https://vlr.gg/player/4712/heybay,2024-07-16 04:00:00,,,,215,,,33,,,26,,,22,,,0,,,,,,126,,,25%,,,2,,,2,,
155,https://vlr.gg/player/3045/luok1ng,2024-07-16 04:00:00,,,,179,,,28,,,29,,,17,,,+1,,,,,,110,,,28%,,,2,,,1,,
156,https://vlr.gg/player/4881/spitfires,2024-07-16 04:00:00,,,,231,,,33,,,34,,,7,,,+3,,,,,,145,,,22%,,,11,,,8,,
157,https://vlr.gg/player/10821/delb,2024-07-16 04:00:00,,,,214,,,36,,,30,,,4,,,+3,,,,,,134,,,50%,,,4,,,1,,
158,https://vlr.gg/player/3049/sword9,2024-07-16 04:00:00,,,,180,,,26,,,33,,,12,,,-9,,,,,,120,,,26%,,,1,,,10,,
159,https://vlr.gg/player/14431/monk,2024-07-16 04:00:00,,,,166,,,24,,,37,,,14,,,-2,,,,,,103,,,27%,,,0,,,2,,
160,https://vlr.gg/player/25949/bunt,2024-07-16 04:00:00,,,,159,,,24,,,32,,,14,,,0,,,,,,108,,,26%,,,3,,,3,,
161,https://vlr.gg/player/29315/romia,2024-07-16 02:30:00,1.55,1.08,1.41,232,264,157,32,25,7,16,11,5,11,8,3,0,+1,-1,82%,88%,70%,158,179,110,23%,27%,13%,2,2,0,2,1,1
162,https://vlr.gg/player/37521/mint,2024-07-16 02:30:00,1.07,2.11,1.38,267,230,388,36,22,14,22,17,5,4,2,2,-1,-2,+1,74%,67%,90%,199,175,256,42%,53%,29%,6,4,2,7,6,1
163,https://vlr.gg/player/29274/curumi,2024-07-16 02:30:00,1.51,0.80,1.30,218,243,146,27,23,4,21,14,7,19,12,7,+2,+2,0,82%,83%,80%,131,149,87,23%,26%,15%,3,2,1,1,0,1
164,https://vlr.gg/player/29290/pingsong,2024-07-16 02:30:00,1.25,1.28,1.26,221,222,189,28,20,8,18,14,4,9,9,0,+6,+4,+2,76%,79%,70%,134,141,116,25%,21%,35%,7,5,2,1,1,0
165,https://vlr.gg/player/25000/yamzzi,2024-07-16 02:30:00,1.03,1.57,1.19,211,180,277,24,14,10,19,14,5,24,19,5,+1,-1,+2,82%,83%,80%,140,127,171,17%,18%,15%,3,1,2,2,2,0
166,https://vlr.gg/player/39887/mochirrrr,2024-07-16 02:30:00,1.03,0.98,1.00,195,211,191,22,8,14,28,8,20,17,4,13,-1,0,-1,79%,90%,75%,129,145,123,26%,43%,20%,0,0,0,1,0,1
167,https://vlr.gg/player/39906/lucky,2024-07-16 02:30:00,0.55,1.02,0.88,217,127,255,25,4,21,31,9,22,6,2,4,-2,-2,0,53%,40%,58%,140,94,160,18%,13%,20%,5,0,5,7,2,5
168,https://vlr.gg/player/39905/meimei,2024-07-16 02:30:00,1.04,0.43,0.61,157,249,127,17,8,9,30,8,22,10,2,8,0,0,0,59%,50%,63%,112,172,88,27%,39%,20%,3,1,2,3,1,2
169,https://vlr.gg/player/45423/neko,2024-07-16 02:30:00,0.26,0.80,0.61,166,101,198,19,3,16,30,9,21,3,0,3,-4,-3,-1,62%,40%,71%,115,85,127,13%,5%,16%,4,1,3,8,4,4
170,https://vlr.gg/player/39879/daf,2024-07-16 02:30:00,0.53,0.60,0.58,126,133,125,13,3,10,28,9,19,7,3,4,-1,+1,-2,59%,60%,58%,97,106,93,22%,20%,23%,1,1,0,2,0,2
171,https://vlr.gg/player/39904/serena,2024-07-16 00:00:00,1.58,1.32,1.44,281,339,230,40,23,17,24,13,11,6,3,3,+5,+4,+1,81%,80%,82%,187,212,163,23%,17%,33%,7,4,3,2,0,2
172,https://vlr.gg/player/39902/ur,2024-07-16 00:00:00,1.64,1.10,1.36,228,257,202,35,20,15,23,9,14,15,8,7,+1,-1,+2,74%,75%,73%,143,164,124,27%,27%,26%,3,0,3,2,1,1
173,https://vlr.gg/player/10653/suzu,2024-07-16 00:00:00,1.03,1.12,1.08,255,251,256,39,18,21,31,15,16,5,3,2,+4,+3,+1,69%,70%,68%,163,177,150,31%,33%,28%,10,5,5,6,2,4
174,https://vlr.gg/player/29314/moco,2024-07-16 00:00:00,1.02,1.00,1.01,163,190,140,26,14,12,23,12,11,16,6,10,0,0,0,64%,70%,59%,107,130,86,15%,15%,16%,2,1,1,2,1,1
175,https://vlr.gg/player/29316/aco,2024-07-16 00:00:00,0.51,1.16,0.85,181,132,224,25,8,17,30,15,15,22,12,10,-2,-2,0,71%,65%,77%,125,92,156,24%,19%,27%,3,2,1,5,4,1
176,https://vlr.gg/player/29281/onni,2024-07-16 00:00:00,1.20,1.63,1.40,284,255,314,38,18,20,32,17,15,19,10,9,-2,-1,-1,71%,68%,75%,176,158,196,22%,25%,20%,6,3,3,8,4,4
177,https://vlr.gg/player/42542/ggonyak,2024-07-16 00:00:00,0.97,0.99,0.98,226,260,190,35,19,16,34,18,16,11,6,5,+1,+2,-1,62%,64%,60%,143,173,109,30%,37%,21%,6,5,1,5,3,2
178,https://vlr.gg/player/29273/len,2024-07-16 00:00:00,0.75,0.81,0.78,134,103,167,18,7,11,30,14,16,15,10,5,0,-1,+1,57%,59%,55%,96,79,116,25%,26%,24%,3,0,3,3,1,2
179,https://vlr.gg/player/39907/koyori,2024-07-16 00:00:00,0.75,0.55,0.65,158,164,152,22,12,10,35,17,18,11,4,7,-5,-2,-3,64%,59%,70%,94,101,86,32%,32%,30%,1,1,0,6,3,3
180,https://vlr.gg/player/29287/dori,2024-07-16 00:00:00,0.66,0.48,0.57,129,132,130,18,11,7,34,16,18,18,7,11,-2,-2,0,62%,55%,70%,82,82,82,25%,38%,15%,1,0,1,3,2,1
181,https://vlr.gg/player/30315/fullmoon,2024-07-15 21:30:00,0.89,1.44,1.16,280,233,330,51,21,30,46,23,23,8,2,6,+5,+2,+3,62%,59%,65%,178,157,198,30%,41%,23%,13,7,6,8,5,3
182,https://vlr.gg/player/29280/merununtius,2024-07-15 21:30:00,0.83,0.91,0.87,179,198,152,31,16,15,40,22,18,19,7,12,-2,-2,0,68%,63%,73%,127,146,108,26%,20%,35%,2,0,2,4,2,2
183,https://vlr.gg/player/39873/shiye,2024-07-15 21:30:00,0.68,0.98,0.82,154,137,180,29,14,15,39,21,18,18,5,13,-3,-1,-2,62%,56%,69%,112,93,133,27%,44%,18%,2,0,2,5,1,4
184,https://vlr.gg/player/29271/festival,2024-07-15 21:30:00,0.57,1.07,0.82,176,180,170,33,16,17,39,24,15,4,3,1,-9,-6,-3,60%,52%,69%,115,114,117,28%,35%,21%,1,1,0,10,7,3
185,https://vlr.gg/player/29286/nekopanchi,2024-07-15 21:30:00,0.77,0.83,0.80,147,165,135,27,14,13,38,21,17,17,5,12,-4,0,-4,64%,67%,62%,95,103,87,29%,32%,26%,2,2,0,6,2,4
186,https://vlr.gg/player/29282/maripo,2024-07-15 21:30:00,1.20,1.49,1.35,241,239,246,45,21,24,30,16,14,13,6,7,+4,+1,+3,81%,81%,81%,162,157,167,24%,26%,22%,6,1,5,2,0,2
187,https://vlr.gg/player/29297/hane,2024-07-15 21:30:00,1.08,1.41,1.25,229,215,243,45,19,26,33,17,16,24,17,7,-1,-2,+1,77%,77%,78%,150,146,154,36%,39%,34%,3,1,2,4,3,1
188,https://vlr.gg/player/30327/hakuna,2024-07-15 21:30:00,1.02,1.04,1.03,182,158,203,31,14,17,32,17,15,24,13,11,+4,+5,-1,74%,69%,78%,132,108,155,24%,18%,28%,7,5,2,3,0,3
189,https://vlr.gg/player/29307/r4m,2024-07-15 21:30:00,0.89,1.12,1.01,219,198,225,40,18,22,39,20,19,18,7,11,+4,+2,+2,74%,77%,70%,132,115,148,34%,33%,35%,8,5,3,4,3,1
190,https://vlr.gg/player/29308/zodiac,2024-07-15 21:30:00,0.84,1.18,1.01,215,215,227,41,19,22,37,20,17,11,7,4,+2,0,+2,75%,69%,81%,145,150,141,22%,20%,24%,9,4,5,7,4,3
191,https://vlr.gg/player/27149/brinks,2024-07-15 19:15:00,0.96,0.93,0.95,209,196,239,28,17,11,33,18,15,15,8,7,-3,-3,0,76%,83%,67%,141,130,154,16%,20%,12%,1,0,1,4,3,1
192,https://vlr.gg/player/1567/bezn1,2024-07-15 19:15:00,0.78,1.13,0.93,204,171,232,28,14,14,31,18,13,8,1,7,-3,+1,-4,66%,65%,67%,121,97,151,25%,20%,32%,5,4,1,8,3,5
193,https://vlr.gg/player/1684/denaro,2024-07-15 19:15:00,1.04,0.64,0.86,165,179,159,21,13,8,33,17,16,14,12,2,-1,-1,0,73%,78%,67%,115,118,111,22%,17%,29%,1,1,0,2,2,0
194,https://vlr.gg/player/1566/prozin,2024-07-15 19:15:00,0.59,0.71,0.64,149,154,142,20,10,10,32,19,13,12,10,2,-5,-4,-1,56%,57%,56%,90,98,81,16%,16%,16%,3,1,2,8,5,3
195,https://vlr.gg/player/1999/rnd,2024-07-15 19:15:00,0.64,0.38,0.53,137,149,120,16,11,5,33,18,15,14,9,5,-4,-2,-2,68%,61%,78%,94,99,87,18%,26%,11%,2,1,1,6,3,3
196,https://vlr.gg/player/20240/xenom,2024-07-15 19:15:00,1.59,1.38,1.47,228,255,216,37,17,20,17,7,10,11,6,5,+3,+2,+1,85%,78%,91%,159,177,145,34%,36%,32%,4,2,2,1,0,1
197,https://vlr.gg/player/3424/siduzord,2024-07-15 19:15:00,1.23,1.35,1.30,269,259,255,38,17,21,24,12,12,19,6,13,+1,+1,0,83%,83%,83%,162,149,172,35%,36%,35%,6,3,3,5,2,3
198,https://vlr.gg/player/23010/nicksz,2024-07-15 19:15:00,1.08,1.42,1.27,224,172,254,32,11,21,22,9,13,18,8,10,+4,0,+4,90%,94%,87%,135,116,149,27%,22%,31%,5,0,5,1,0,1
199,https://vlr.gg/player/6202/guuih,2024-07-15 19:15:00,1.06,0.94,0.99,142,134,163,20,9,11,20,7,13,14,3,11,+2,0,+2,88%,89%,87%,101,91,108,29%,41%,23%,3,1,2,1,1,0
200,https://vlr.gg/player/13823/pxs,2024-07-15 19:15:00,0.99,0.87,0.92,250,281,226,35,18,17,30,13,17,12,3,9,+6,+4,+2,83%,72%,91%,157,163,152,22%,24%,21%,10,6,4,4,2,2
201,https://vlr.gg/player/34400/bao,2024-07-15 18:55:00,1.30,0.79,1.10,222,271,142,31,25,6,29,18,11,9,5,4,+1,0,+1,74%,75%,73%,146,166,114,36%,42%,26%,4,2,2,3,2,1
202,https://vlr.gg/player/2171/cavern,2024-07-15 18:55:00,0.60,1.21,0.84,159,137,201,23,10,13,28,19,9,14,11,3,-1,-2,+1,72%,71%,73%,105,92,125,21%,19%,25%,2,1,1,3,3,0
203,https://vlr.gg/player/39021/notexxd,2024-07-15 18:55:00,0.60,1.13,0.80,178,138,238,23,11,12,31,20,11,15,10,5,-3,-2,-1,72%,71%,73%,111,85,153,33%,32%,34%,3,3,0,6,5,1
204,https://vlr.gg/player/5128/polkan,2024-07-15 18:55:00,0.90,0.54,0.76,137,152,127,19,14,5,31,18,13,17,9,8,0,+1,-1,67%,71%,60%,95,100,88,36%,42%,26%,3,2,1,3,1,2
205,https://vlr.gg/player/26565/jas0n,2024-07-15 18:55:00,0.65,0.72,0.68,153,155,162,19,12,7,31,19,12,14,7,7,-8,-5,-3,74%,71%,80%,103,103,102,27%,34%,15%,2,0,2,10,5,5
206,https://vlr.gg/player/13084/smiley,2024-07-15 18:55:00,1.43,1.54,1.50,249,231,261,36,13,23,18,7,11,17,6,11,+6,+2,+4,77%,73%,79%,168,159,173,32%,30%,33%,7,2,5,1,0,1
207,https://vlr.gg/player/30470/kyu,2024-07-15 18:55:00,1.32,1.19,1.24,202,170,210,26,9,17,19,6,13,24,6,18,+2,+1,+1,79%,87%,75%,118,104,127,25%,21%,27%,2,1,1,0,0,0
208,https://vlr.gg/player/24865/acrian,2024-07-15 18:55:00,1.17,1.12,1.14,200,196,214,27,10,17,22,8,14,10,8,2,+1,0,+1,69%,60%,75%,147,153,143,30%,33%,28%,2,0,2,1,0,1
209,https://vlr.gg/player/29076/satellite,2024-07-15 18:55:00,1.17,0.93,1.02,223,259,201,32,14,18,29,12,17,4,2,2,+1,0,+1,69%,67%,71%,144,171,128,28%,37%,23%,9,4,5,8,4,4
210,https://vlr.gg/player/20364/roompa,2024-07-15 18:55:00,0.71,1.17,1.00,211,164,226,28,9,19,27,11,16,12,3,9,+1,0,+1,74%,80%,71%,131,95,153,30%,17%,37%,5,2,3,4,2,2
211,https://vlr.gg/player/3227/screwface,2024-07-15 16:15:00,1.45,0.58,1.09,194,218,152,29,21,8,27,12,15,8,5,3,0,+1,-1,66%,83%,41%,132,156,99,37%,50%,20%,3,2,1,3,1,2
212,https://vlr.gg/player/2118/silenx,2024-07-15 16:15:00,1.28,0.64,1.01,215,270,132,32,24,8,30,16,14,8,5,3,+2,+1,+1,73%,79%,65%,138,175,85,43%,33%,100%,4,2,2,2,1,1
213,https://vlr.gg/player/9063/infiltrator,2024-07-15 16:15:00,1.15,0.21,0.76,214,303,96,30,26,4,36,20,16,2,1,1,-1,+4,-5,59%,63%,53%,133,182,65,25%,29%,14%,9,8,1,10,4,6
214,https://vlr.gg/player/765/jerk,2024-07-15 16:15:00,0.59,0.47,0.50,117,124,118,13,9,4,32,17,15,13,7,6,0,-1,+1,59%,71%,41%,85,89,78,19%,18%,19%,1,0,1,1,1,0
215,https://vlr.gg/player/17865/nahsie,2024-07-15 16:15:00,0.38,0.60,0.45,151,123,197,19,11,8,38,21,17,13,6,7,0,+1,-1,63%,67%,59%,103,86,126,24%,26%,23%,4,3,1,4,2,2
216,https://vlr.gg/player/30470/kyu,2024-07-15 16:15:00,1.70,1.13,1.37,251,277,220,36,18,18,23,7,16,16,6,10,+3,+4,-1,80%,94%,71%,160,186,142,24%,31%,18%,4,4,0,1,0,1
217,https://vlr.gg/player/24865/acrian,2024-07-15 16:15:00,1.68,1.14,1.36,230,231,225,35,17,18,19,4,15,4,1,3,-1,0,-1,78%,76%,79%,138,141,136,24%,29%,21%,2,1,1,3,1,2
218,https://vlr.gg/player/20364/roompa,2024-07-15 16:15:00,1.24,1.05,1.13,216,193,226,33,12,21,26,8,18,13,8,5,-3,-1,-2,78%,88%,71%,139,133,143,42%,23%,60%,2,0,2,5,1,4
219,https://vlr.gg/player/13084/smiley,2024-07-15 16:15:00,1.50,0.80,1.09,193,198,190,27,12,15,24,5,19,14,8,6,-1,+3,-4,80%,88%,75%,121,123,120,31%,31%,31%,4,3,1,5,0,5
220,https://vlr.gg/player/29076/satellite,2024-07-15 16:15:00,1.26,0.72,0.95,224,283,191,31,17,14,31,9,22,6,2,4,+1,-1,+2,68%,71%,67%,151,193,121,19%,33%,12%,8,3,5,7,4,3
221,https://vlr.gg/player/3157/gaabxx,2024-07-15 16:00:00,1.43,0.91,1.15,207,268,161,50,30,20,45,19,26,28,13,15,-2,+1,-3,79%,87%,73%,138,174,109,27%,25%,29%,2,1,1,4,0,4
222,https://vlr.gg/player/3455/zanatsu,2024-07-15 16:00:00,0.92,1.37,1.14,271,227,323,62,24,38,54,25,29,16,8,8,+8,-1,+9,74%,61%,84%,168,146,187,24%,20%,27%,21,7,14,13,8,5
223,https://vlr.gg/player/5395/cortezia,2024-07-15 16:00:00,1.13,1.08,1.10,229,249,218,59,29,30,48,22,26,21,9,12,-2,0,-2,79%,81%,78%,152,148,155,42%,37%,46%,5,4,1,7,4,3
224,https://vlr.gg/player/3433/ctc,2024-07-15 16:00:00,0.99,0.57,0.76,154,181,140,39,21,18,49,19,30,14,9,5,-2,+1,-3,65%,71%,59%,99,114,86,22%,23%,21%,4,3,1,6,2,4
225,https://vlr.gg/player/1586/v1nny,2024-07-15 16:00:00,0.51,0.91,0.73,165,124,186,36,13,23,51,23,28,19,5,14,0,-2,+2,74%,68%,78%,113,92,130,33%,47%,28%,3,0,3,3,2,1
226,https://vlr.gg/player/21659/sato,2024-07-15 16:00:00,1.75,1.06,1.44,311,376,229,73,48,25,49,25,24,6,6,0,-2,-2,0,59%,68%,48%,201,251,141,33%,38%,24%,9,4,5,11,6,5
227,https://vlr.gg/player/28716/lukxo,2024-07-15 16:00:00,1.28,0.99,1.15,229,243,195,55,35,20,48,24,24,23,10,13,0,+1,-1,69%,76%,61%,136,150,121,30%,29%,31%,4,2,2,4,1,3
228,https://vlr.gg/player/1994/evilkyk,2024-07-15 16:00:00,0.87,1.11,0.98,157,125,214,39,17,22,45,22,23,25,14,11,+1,+1,0,74%,73%,74%,100,73,132,34%,36%,33%,4,2,2,3,1,2
229,https://vlr.gg/player/6238/urango,2024-07-15 16:00:00,0.70,0.93,0.80,204,162,234,43,19,24,54,27,27,20,13,7,+3,0,+3,62%,62%,61%,132,115,151,26%,32%,22%,11,6,5,8,6,2
230,https://vlr.gg/player/1688/rood,2024-07-15 16:00:00,0.64,0.97,0.79,162,159,167,37,20,17,50,31,19,24,11,13,-4,-3,-1,60%,54%,68%,112,108,116,19%,21%,18%,5,3,2,9,6,3
231,https://vlr.gg/player/3012/riku,2024-07-15 16:00:00,1.25,0.93,1.11,258,283,224,51,33,18,46,26,20,14,8,6,-3,-2,-1,70%,76%,63%,168,188,140,16%,17%,13%,5,4,1,8,6,2
232,https://vlr.gg/player/766/ange,2024-07-15 16:00:00,1.12,0.94,1.04,224,234,220,43,27,16,45,25,20,24,13,11,+3,0,+3,72%,67%,79%,145,149,138,24%,25%,24%,8,4,4,5,4,1
233,https://vlr.gg/player/71/drone,2024-07-15 16:00:00,0.95,0.92,0.94,168,162,179,35,20,15,39,21,18,16,9,7,0,0,0,67%,70%,63%,119,108,134,38%,34%,43%,3,1,2,3,1,2
234,https://vlr.gg/player/468/zachareee,2024-07-15 16:00:00,0.87,0.94,0.90,201,187,222,39,22,17,42,25,17,11,6,5,-2,-3,+1,61%,58%,67%,130,118,147,23%,22%,24%,6,3,3,8,6,2
235,https://vlr.gg/player/8118/precision,2024-07-15 16:00:00,0.73,0.35,0.56,124,146,101,26,18,8,46,24,22,18,12,6,-5,0,-5,60%,67%,50%,81,91,66,35%,36%,33%,3,2,1,8,2,6
236,https://vlr.gg/player/26565/jas0n,2024-07-15 16:00:00,1.43,1.39,1.41,281,277,295,57,23,34,36,13,23,6,2,4,+4,+3,+1,77%,79%,76%,186,181,189,25%,31%,22%,11,6,5,7,3,4
237,https://vlr.gg/player/39021/notexxd,2024-07-15 16:00:00,1.38,1.31,1.34,259,232,269,51,21,30,38,13,25,24,7,17,+4,-1,+5,77%,79%,76%,168,155,177,37%,39%,36%,7,1,6,3,2,1
238,https://vlr.gg/player/34400/bao,2024-07-15 16:00:00,1.42,0.94,1.14,219,291,172,46,27,19,39,15,24,19,8,11,+3,0,+3,77%,88%,70%,137,175,110,33%,42%,24%,8,3,5,5,3,2
239,https://vlr.gg/player/5128/polkan,2024-07-15 16:00:00,1.08,0.76,0.89,161,166,148,32,15,17,40,15,25,31,16,15,0,+1,-1,77%,75%,79%,99,92,104,35%,33%,36%,4,1,3,4,0,4
240,https://vlr.gg/player/2171/cavern,2024-07-15 16:00:00,0.62,0.85,0.75,165,141,184,32,11,21,41,18,23,22,12,10,-4,-1,-3,67%,63%,70%,107,87,121,20%,22%,20%,2,2,0,6,3,3
241,https://vlr.gg/player/9810/alfajer,2024-07-15 14:50:00,1.16,1.10,1.13,222,235,206,55,34,21,46,25,21,10,2,8,+5,+3,+2,78%,82%,72%,140,140,140,27%,22%,36%,8,4,4,3,1,2
242,https://vlr.gg/player/29867/hiro,2024-07-15 14:50:00,1.12,1.05,1.09,188,196,205,50,30,20,42,24,18,15,7,8,-8,-5,-3,63%,55%,72%,123,116,133,38%,45%,32%,3,1,2,11,6,5
243,https://vlr.gg/player/458/chronicle,2024-07-15 14:50:00,0.83,1.18,0.98,202,178,230,44,21,23,44,25,19,23,13,10,0,+1,-1,78%,74%,83%,132,120,148,32%,33%,31%,2,1,1,2,0,2
244,https://vlr.gg/player/438/boaster,2024-07-15 14:50:00,0.84,0.96,0.89,180,172,187,42,22,20,48,29,19,24,12,12,-8,-5,-3,67%,61%,76%,122,119,126,28%,24%,33%,3,2,1,11,7,4
245,https://vlr.gg/player/5022/derke,2024-07-15 14:50:00,0.57,1.19,0.84,197,173,225,45,22,23,49,32,17,8,3,5,-2,-4,+2,63%,53%,76%,127,113,145,21%,21%,21%,11,6,5,13,10,3
246,https://vlr.gg/player/36245/n4rrate,2024-07-15 14:50:00,1.22,1.33,1.28,278,276,264,63,28,35,49,24,25,21,10,11,+7,+3,+4,84%,90%,79%,172,171,174,23%,22%,25%,11,6,5,4,3,1
247,https://vlr.gg/player/2625/sh1n,2024-07-15 14:50:00,1.04,1.11,1.08,191,202,193,45,19,26,45,21,24,24,13,11,+7,+2,+5,76%,79%,74%,127,133,122,27%,29%,26%,10,4,6,3,2,1
248,https://vlr.gg/player/10307/marteen,2024-07-15 14:50:00,0.88,1.13,1.02,204,181,221,52,21,31,48,21,27,13,3,10,+1,+1,0,75%,72%,76%,133,127,138,37%,47%,30%,10,5,5,9,4,5
249,https://vlr.gg/player/19691/tomaszy,2024-07-15 14:50:00,0.85,0.82,0.83,159,159,161,38,17,21,46,21,25,12,2,10,-3,-1,-2,72%,69%,74%,105,97,111,33%,36%,31%,2,1,1,5,2,3
250,https://vlr.gg/player/2173/magnum,2024-07-15 14:50:00,0.53,0.86,0.72,133,95,173,31,9,22,48,20,28,22,6,16,+1,-2,+3,73%,66%,79%,92,69,109,30%,36%,27%,7,0,7,6,2,4
251,https://vlr.gg/player/2168/trexx,2024-07-15 12:00:00,1.49,1.06,1.32,250,273,213,53,35,18,35,21,14,20,11,9,-5,-3,-2,80%,78%,83%,168,184,144,26%,30%,19%,3,2,1,8,5,3
252,https://vlr.gg/player/11134/kicks,2024-07-15 12:00:00,1.42,1.09,1.29,231,248,203,48,32,16,35,21,14,34,23,11,+4,+3,+1,78%,81%,74%,146,153,135,19%,22%,14%,6,4,2,2,1,1
253,https://vlr.gg/player/312/sayf,2024-07-15 12:00:00,1.11,1.53,1.27,251,219,296,53,27,26,38,24,14,9,7,2,-4,-8,+4,68%,61%,78%,162,151,179,32%,34%,28%,7,2,5,11,10,1
254,https://vlr.gg/player/4321/cender,2024-07-15 12:00:00,0.91,1.01,0.95,165,152,182,31,18,13,37,23,14,28,15,13,-1,-2,+1,78%,72%,87%,100,94,109,28%,27%,30%,6,3,3,7,5,2
255,https://vlr.gg/player/21610/runner,2024-07-15 12:00:00,0.74,0.87,0.79,158,147,180,37,21,16,39,26,13,8,4,4,+1,-2,+3,73%,69%,78%,102,98,109,19%,23%,16%,5,1,4,4,3,1
256,https://vlr.gg/player/384/shao,2024-07-15 12:00:00,1.35,0.88,1.07,213,226,208,47,21,26,44,15,29,13,1,12,0,-2,+2,75%,65%,81%,150,146,153,36%,51%,28%,6,1,5,6,3,3
257,https://vlr.gg/player/11/zyppan,2024-07-15 12:00:00,1.07,0.90,0.97,221,238,212,44,19,25,46,18,28,19,5,14,+1,-2,+3,68%,70%,67%,145,153,140,27%,28%,26%,8,1,7,7,3,4
258,https://vlr.gg/player/98/ardiis,2024-07-15 12:00:00,0.52,1.24,0.96,176,141,205,36,9,27,43,20,23,21,9,12,+3,-2,+5,71%,74%,69%,116,100,126,15%,16%,15%,7,2,5,4,4,0
259,https://vlr.gg/player/2858/suygetsu,2024-07-15 12:00:00,0.88,0.91,0.90,143,135,150,33,12,21,41,17,24,11,5,6,0,0,0,63%,65%,61%,92,87,95,32%,38%,28%,3,1,2,3,1,2
260,https://vlr.gg/player/109/ange1,2024-07-15 12:00:00,0.50,0.51,0.50,118,97,131,24,8,16,48,19,29,13,6,7,+1,-1,+2,59%,61%,58%,79,61,91,34%,32%,36%,8,3,5,7,4,3
261,https://vlr.gg/player/1265/johnqt,2024-07-14 20:00:00,0.97,1.24,1.08,177,155,213,29,15,14,27,16,11,8,3,5,0,0,0,71%,67%,76%,110,103,122,24%,33%,17%,2,1,1,2,1,1
262,https://vlr.gg/player/9/tenz,2024-07-14 20:00:00,1.03,0.86,0.96,177,214,136,25,18,7,31,19,12,13,5,8,-2,-1,-1,71%,75%,65%,116,131,93,23%,29%,16%,3,2,1,5,3,2
263,https://vlr.gg/player/4004/zekken,2024-07-14 20:00:00,0.74,0.74,0.74,218,214,214,29,17,12,36,21,15,5,3,2,-1,-2,+1,63%,58%,71%,140,138,141,21%,21%,20%,7,4,3,8,6,2
264,https://vlr.gg/player/659/sacy,2024-07-14 20:00:00,0.70,0.73,0.70,142,154,132,17,11,6,30,18,12,16,12,4,-4,-2,-2,68%,75%,59%,107,111,101,28%,47%,14%,1,0,1,5,2,3
265,https://vlr.gg/player/729/zellsis,2024-07-14 20:00:00,0.65,0.65,0.65,189,169,211,25,13,12,34,19,15,10,6,4,-4,-3,-1,68%,71%,65%,113,110,118,22%,22%,22%,2,1,1,6,4,2
266,https://vlr.gg/player/8402/icy,2024-07-14 20:00:00,0.92,1.66,1.35,261,217,294,41,12,29,26,11,15,5,2,3,+3,0,+3,73%,65%,79%,172,132,201,28%,27%,29%,7,2,5,4,2,2
267,https://vlr.gg/player/15500/trent,2024-07-14 20:00:00,1.55,1.12,1.30,195,205,190,29,13,16,23,7,16,23,9,14,+2,+1,+1,80%,82%,79%,132,140,126,20%,21%,19%,4,2,2,2,1,1
268,https://vlr.gg/player/4581/jonahp,2024-07-14 20:00:00,1.68,1.04,1.30,226,265,198,32,18,14,24,8,16,21,9,12,+4,+1,+3,83%,88%,79%,136,155,122,27%,31%,24%,7,2,5,3,1,2
269,https://vlr.gg/player/7873/leaf,2024-07-14 20:00:00,0.63,1.33,1.04,212,164,245,29,8,21,28,13,15,15,6,9,+3,+1,+2,78%,71%,83%,142,108,166,21%,20%,22%,4,2,2,1,1,0
270,https://vlr.gg/player/3885/valyn,2024-07-14 20:00:00,1.05,0.90,0.96,175,208,144,27,14,13,24,12,12,16,4,12,-1,0,-1,76%,76%,75%,94,113,80,18%,35%,5%,4,2,2,5,2,3
271,https://vlr.gg/player/683/pancada,2024-07-14 17:00:00,0.90,1.73,1.23,221,175,312,46,19,27,38,27,11,24,14,10,0,-1,+1,78%,71%,87%,143,114,187,40%,42%,38%,4,1,3,4,2,2
272,https://vlr.gg/player/727/saadhak,2024-07-14 17:00:00,0.98,1.33,1.12,212,202,230,45,26,19,41,28,13,21,9,12,-1,-3,+2,72%,66%,83%,142,134,154,29%,31%,28%,3,0,3,4,3,1
273,https://vlr.gg/player/8447/less,2024-07-14 17:00:00,0.72,1.17,0.90,154,160,185,34,21,13,42,29,13,18,5,13,-1,-4,+3,53%,40%,74%,118,107,133,30%,35%,25%,6,2,4,7,6,1
274,https://vlr.gg/player/6193/cauanzin,2024-07-14 17:00:00,0.76,0.97,0.84,178,175,190,35,18,17,44,29,15,16,8,8,+1,+1,0,64%,57%,74%,120,119,121,28%,25%,32%,5,3,2,4,2,2
275,https://vlr.gg/player/2408/tuyz,2024-07-14 17:00:00,0.68,0.76,0.71,129,153,126,28,18,10,42,29,13,10,4,6,-5,-6,+1,59%,57%,61%,95,99,88,21%,23%,16%,8,5,3,13,11,2
276,https://vlr.gg/player/4147/cryocells,2024-07-14 17:00:00,0.87,1.52,1.26,259,152,290,51,12,39,36,17,19,15,7,8,+5,-1,+6,76%,61%,86%,144,88,181,28%,41%,23%,10,1,9,5,2,3
277,https://vlr.gg/player/601/asuna,2024-07-14 17:00:00,1.21,1.15,1.17,257,277,230,51,23,28,40,19,21,16,1,15,+5,+4,+1,78%,74%,80%,150,154,147,17%,12%,21%,9,5,4,4,1,3
278,https://vlr.gg/player/796/eeiu,2024-07-14 17:00:00,1.07,1.13,1.10,173,188,177,37,14,23,33,15,18,14,5,9,+1,0,+1,78%,65%,86%,125,135,119,32%,31%,32%,3,1,2,2,1,1
279,https://vlr.gg/player/3880/bang,2024-07-14 17:00:00,0.67,1.13,0.94,186,129,223,37,10,27,36,16,20,20,6,14,-5,-6,+1,72%,61%,80%,112,75,137,36%,24%,42%,4,0,4,9,6,3
280,https://vlr.gg/player/604/boostio,2024-07-14 17:00:00,0.35,0.91,0.69,169,103,202,31,6,25,43,19,24,11,7,4,0,-4,+4,69%,65%,71%,116,90,133,18%,17%,18%,6,1,5,6,5,1
281,https://vlr.gg/player/41207/jade,2024-07-14 15:45:00,1.29,1.44,1.36,252,226,289,65,30,35,51,23,28,38,21,17,0,-3,+3,78%,76%,81%,168,145,192,26%,24%,27%,6,0,6,6,3,3
282,https://vlr.gg/player/17318/blossi,2024-07-14 15:45:00,1.22,0.78,1.01,199,234,163,51,32,19,54,27,27,34,21,13,-2,-2,0,74%,74%,75%,136,153,119,25%,25%,24%,4,2,2,6,4,2
283,https://vlr.gg/player/30042/harmonee,2024-07-14 15:45:00,0.96,1.04,1.00,205,195,217,55,27,28,55,29,26,17,7,10,-7,-3,-4,70%,74%,67%,137,135,140,28%,35%,21%,4,2,2,11,5,6
284,https://vlr.gg/player/19373/ginger,2024-07-14 15:45:00,0.93,0.93,0.93,199,210,191,52,27,25,55,27,28,20,9,11,-2,+1,-3,73%,71%,75%,130,131,129,17%,22%,13%,4,3,1,6,2,4
285,https://vlr.gg/player/37969/ellie,2024-07-14 15:45:00,0.89,0.83,0.86,205,214,188,51,28,23,60,30,30,12,4,8,+5,+5,0,70%,74%,67%,137,145,128,33%,36%,29%,16,11,5,11,6,5
286,https://vlr.gg/player/43744/akita,2024-07-14 15:45:00,0.97,1.20,1.09,287,274,308,72,33,39,65,33,32,11,8,3,+12,+7,+5,74%,78%,71%,187,179,196,29%,27%,32%,28,14,14,16,7,9
287,https://vlr.gg/player/17331/pinkalie,2024-07-14 15:45:00,0.97,1.07,1.02,202,183,219,54,24,30,52,24,28,38,17,21,-1,-4,+3,80%,78%,82%,126,124,128,31%,32%,30%,4,0,4,5,4,1
288,https://vlr.gg/player/41197/thuy,2024-07-14 15:45:00,1.15,0.86,1.00,200,216,180,49,28,21,54,25,29,34,15,19,-2,+1,-3,76%,86%,66%,128,140,117,18%,19%,17%,3,3,0,5,2,3
289,https://vlr.gg/player/38036/lenka,2024-07-14 15:45:00,0.93,1.06,1.00,180,171,196,52,25,27,50,24,26,13,7,6,-2,-3,+1,72%,67%,76%,131,124,137,28%,31%,26%,2,0,2,4,3,1
290,https://vlr.gg/player/16078/loupiote,2024-07-14 15:45:00,1.16,0.70,0.93,183,216,147,48,29,19,53,24,29,20,9,11,-1,+3,-4,74%,81%,68%,123,142,104,20%,15%,28%,3,3,0,4,0,4
291,https://vlr.gg/player/5554/profek,2024-07-14 14:00:00,1.42,1.33,1.38,266,286,235,59,36,23,39,22,17,23,10,13,+3,+2,+1,83%,85%,79%,172,178,166,35%,37%,33%,7,3,4,4,1,3
292,https://vlr.gg/player/562/zeek,2024-07-14 14:00:00,1.45,0.98,1.23,217,250,184,48,29,19,38,17,21,21,13,8,+6,+5,+1,83%,91%,72%,149,165,131,32%,32%,33%,9,6,3,3,1,2
293,https://vlr.gg/player/23169/minny,2024-07-14 14:00:00,1.00,0.92,0.97,187,163,213,40,20,20,42,18,24,19,11,8,-1,0,-1,70%,85%,52%,129,112,149,28%,21%,36%,3,1,2,4,1,3
294,https://vlr.gg/player/25906/alexiiik,2024-07-14 14:00:00,1.06,0.80,0.94,231,233,217,52,31,21,49,23,26,5,1,4,-1,+4,-5,68%,76%,59%,142,139,147,32%,30%,34%,12,10,2,13,6,7
295,https://vlr.gg/player/1155/buld,2024-07-14 14:00:00,0.82,0.99,0.90,166,167,145,37,20,17,40,23,17,19,13,6,0,+1,-1,71%,74%,69%,105,109,100,28%,28%,28%,4,3,1,4,2,2
296,https://vlr.gg/player/21216/f4ngeer,2024-07-14 14:00:00,1.15,1.18,1.17,228,278,218,53,26,27,46,23,23,12,8,4,-6,+2,-8,71%,72%,71%,171,185,159,35%,38%,33%,7,7,0,13,5,8
297,https://vlr.gg/player/21609/danda,2024-07-14 14:00:00,0.99,1.15,1.08,206,162,230,46,17,29,49,19,30,23,10,13,+3,+3,0,71%,79%,65%,129,110,146,31%,30%,32%,4,3,1,1,0,1
298,https://vlr.gg/player/4537/tajrex,2024-07-14 14:00:00,1.23,0.76,0.98,209,245,186,45,26,19,47,18,29,15,4,11,0,+1,-1,73%,79%,68%,145,168,124,22%,33%,14%,6,2,4,6,1,5
299,https://vlr.gg/player/29575/luckymrj,2024-07-14 14:00:00,1.20,0.55,0.85,170,223,138,36,22,14,47,18,29,18,5,13,-1,+2,-3,68%,79%,59%,114,146,86,33%,32%,35%,6,3,3,7,1,6
300,https://vlr.gg/player/29742/anxios,2024-07-14 14:00:00,0.61,0.70,0.66,137,145,137,28,14,14,47,22,25,34,20,14,-3,-3,0,73%,69%,76%,83,84,82,18%,16%,20%,5,2,3,8,5,3
301,https://vlr.gg/player/1524/h1ber,2024-07-14 12:00:00,1.42,1.62,1.51,285,232,342,45,21,24,24,12,12,29,12,17,+3,+2,+1,89%,85%,95%,172,137,215,23%,24%,22%,5,3,2,2,1,1
302,https://vlr.gg/player/1493/starkk,2024-07-14 12:00:00,1.54,1.39,1.47,224,238,214,39,22,17,19,10,9,21,13,8,+1,0,+1,91%,88%,95%,148,167,123,26%,27%,25%,5,3,2,4,3,1
303,https://vlr.gg/player/4277/n-a-i-s,2024-07-14 12:00:00,1.18,1.51,1.33,218,189,253,41,19,22,23,14,9,11,8,3,0,-1,+1,79%,73%,86%,154,139,172,27%,29%,25%,3,2,1,3,3,0
304,https://vlr.gg/player/18400/bipo,2024-07-14 12:00:00,1.07,1.57,1.29,257,251,265,45,24,21,27,18,9,14,6,8,-1,-4,+3,83%,77%,90%,168,172,163,24%,28%,19%,6,1,5,7,5,2
305,https://vlr.gg/player/23347/alannn,2024-07-14 12:00:00,1.16,1.35,1.24,239,224,246,42,23,19,27,17,10,7,5,2,+4,+1,+3,85%,81%,90%,151,139,166,40%,42%,37%,8,3,5,4,2,2
306,https://vlr.gg/player/33358/shinnok,2024-07-14 12:00:00,0.80,1.15,0.99,210,180,242,36,13,23,40,20,20,2,0,2,+4,+3,+1,62%,57%,65%,146,117,170,29%,24%,33%,5,3,2,1,0,1
307,https://vlr.gg/player/7706/morphiw0w,2024-07-14 12:00:00,0.73,0.82,0.78,190,187,188,29,12,17,43,20,23,12,4,8,+1,-1,+2,62%,62%,62%,126,125,127,24%,25%,23%,4,0,4,3,1,2
308,https://vlr.gg/player/4846/nekoj,2024-07-14 12:00:00,0.46,0.57,0.51,113,123,103,18,10,8,40,20,20,7,0,7,-2,-1,-1,47%,38%,54%,73,70,75,27%,43%,17%,4,2,2,6,3,3
309,https://vlr.gg/player/33501/sword,2024-07-14 12:00:00,0.23,0.67,0.47,132,118,147,18,6,12,44,21,23,11,5,6,+1,-2,+3,47%,52%,42%,95,87,102,17%,9%,25%,6,1,5,5,3,2
310,https://vlr.gg/player/5854/z3ro,2024-07-14 12:00:00,0.35,0.55,0.45,139,132,138,19,8,11,45,22,23,17,8,9,-11,-8,-3,62%,57%,65%,93,95,92,17%,22%,13%,1,0,1,12,8,4
311,https://vlr.gg/player/41207/jade,2024-07-14 12:00:00,1.10,0.67,0.97,211,237,135,27,21,6,30,21,9,11,9,2,-1,0,-1,71%,79%,55%,117,135,79,44%,52%,25%,0,0,0,1,0,1
312,https://vlr.gg/player/30042/harmonee,2024-07-14 12:00:00,1.08,0.73,0.97,219,232,186,26,19,7,30,21,9,6,5,1,-4,-2,-2,66%,71%,55%,139,147,120,39%,36%,50%,0,0,0,4,2,2
313,https://vlr.gg/player/17318/blossi,2024-07-14 12:00:00,0.46,0.78,0.56,127,112,168,12,7,5,32,22,10,15,9,6,-8,-5,-3,57%,58%,55%,96,81,131,23%,25%,21%,1,1,0,9,6,3
314,https://vlr.gg/player/19373/ginger,2024-07-14 12:00:00,0.38,0.62,0.45,112,100,140,13,7,6,30,21,9,4,4,0,-1,-1,0,49%,50%,45%,72,70,75,23%,17%,38%,3,2,1,4,3,1
315,https://vlr.gg/player/37969/ellie,2024-07-14 12:00:00,0.47,0.39,0.44,110,130,82,13,11,2,33,22,11,5,3,2,-9,-8,-1,49%,54%,36%,82,86,73,27%,30%,21%,2,1,1,11,9,2
316,https://vlr.gg/player/24071/liza,2024-07-14 12:00:00,2.34,1.54,1.79,347,418,309,46,17,29,18,4,14,6,2,4,+10,+3,+7,89%,91%,88%,214,275,187,36%,33%,38%,13,5,8,3,2,1
317,https://vlr.gg/player/20098/mel,2024-07-14 12:00:00,1.40,1.29,1.32,230,226,231,29,10,19,19,5,14,25,6,19,+2,+1,+1,89%,91%,88%,144,130,150,46%,47%,46%,3,1,2,1,0,1
318,https://vlr.gg/player/38142/dream,2024-07-14 12:00:00,0.94,1.48,1.31,241,190,268,32,9,23,17,6,11,6,0,6,+4,+1,+3,86%,82%,88%,167,120,189,26%,38%,23%,5,1,4,1,0,1
319,https://vlr.gg/player/22792/jiex,2024-07-14 12:00:00,1.21,1.12,1.15,198,184,213,26,6,20,19,5,14,16,6,10,+5,+1,+4,83%,73%,88%,135,137,133,29%,23%,32%,6,1,5,1,0,1
320,https://vlr.gg/player/17394/ninou,2024-07-14 12:00:00,1.00,1.19,1.13,169,132,184,22,6,16,18,6,12,26,6,20,+2,+1,+1,83%,82%,83%,113,102,118,17%,20%,16%,2,1,1,0,0,0
321,https://vlr.gg/player/8808/pyrolll,2024-07-14 11:00:00,1.39,1.35,1.37,233,227,254,53,30,23,33,17,16,19,12,7,+4,+2,+2,82%,80%,84%,159,140,184,30%,27%,33%,7,4,3,3,2,1
322,https://vlr.gg/player/321/chiwa,2024-07-14 11:00:00,1.01,1.39,1.17,218,173,266,49,24,25,36,19,17,10,7,3,+4,0,+4,72%,71%,72%,141,119,171,23%,25%,21%,8,4,4,4,4,0
323,https://vlr.gg/player/1374/alive,2024-07-14 11:00:00,1.18,1.00,1.11,240,262,196,52,34,18,42,25,17,17,10,7,-7,-4,-3,77%,77%,76%,168,191,136,28%,27%,28%,3,1,2,10,5,5
324,https://vlr.gg/player/32351/cullumx,2024-07-14 11:00:00,1.19,0.72,0.99,223,262,164,47,33,14,46,25,21,18,9,9,+2,+2,0,68%,71%,64%,153,173,125,44%,45%,42%,7,5,2,5,3,2
325,https://vlr.gg/player/4325/musashi,2024-07-14 11:00:00,0.82,0.57,0.69,132,153,94,26,19,7,39,22,17,15,9,6,-5,-3,-2,67%,77%,52%,86,103,62,32%,30%,36%,4,2,2,9,5,4
326,https://vlr.gg/player/34684/westside,2024-07-14 11:00:00,1.36,0.93,1.11,201,210,205,47,21,26,42,15,27,11,6,5,+4,+2,+2,75%,84%,69%,141,155,131,39%,33%,45%,7,3,4,3,1,2
327,https://vlr.gg/player/8593/grmekista,2024-07-14 11:00:00,1.36,0.77,1.02,178,234,143,39,21,18,42,16,26,26,15,11,0,+3,-3,70%,76%,66%,123,150,103,24%,24%,25%,5,3,2,5,0,5
328,https://vlr.gg/player/5490/xitsha,2024-07-14 11:00:00,0.85,1.07,0.98,190,183,207,41,16,25,47,20,27,20,10,10,0,-2,+2,67%,68%,66%,134,124,141,38%,37%,38%,7,2,5,7,4,3
329,https://vlr.gg/player/24424/pa1ze,2024-07-14 11:00:00,0.88,0.94,0.90,212,213,219,45,19,26,48,19,29,7,2,5,+1,-3,+4,67%,68%,66%,136,128,142,31%,23%,37%,10,4,6,9,7,2
330,https://vlr.gg/player/3839/prti,2024-07-14 11:00:00,0.67,0.49,0.56,103,116,110,24,11,13,48,17,31,19,10,9,-3,-1,-2,60%,60%,60%,89,91,87,17%,16%,18%,2,0,2,5,1,4
331,https://vlr.gg/player/440/akumaaaaa,2024-07-14 10:00:00,1.09,1.14,1.12,232,231,230,99,46,53,87,41,46,27,4,23,-2,0,-2,70%,60%,78%,151,141,160,39%,39%,38%,12,6,6,14,6,8
332,https://vlr.gg/player/13439/soon,2024-07-14 10:00:00,1.01,1.13,1.07,192,182,211,58,25,33,53,27,26,16,5,11,-4,0,-4,69%,62%,76%,135,127,141,29%,28%,29%,5,4,1,9,4,5
333,https://vlr.gg/player/13258/cyvoph,2024-07-14 10:00:00,0.73,1.17,0.99,183,131,213,27,8,19,27,12,15,15,2,13,+3,-1,+4,68%,56%,75%,118,83,141,31%,41%,28%,6,1,5,3,2,1
334,https://vlr.gg/player/2098/thebigfiz,2024-07-14 10:00:00,0.76,1.12,0.96,189,152,240,80,26,54,88,41,47,38,15,23,-6,-7,+1,70%,64%,75%,145,111,173,29%,30%,28%,9,1,8,15,8,7
335,https://vlr.gg/player/2621/goaster,2024-07-14 10:00:00,0.52,1.30,0.95,217,165,248,87,29,58,95,48,47,31,12,19,+3,-3,+6,69%,64%,74%,145,111,172,24%,23%,25%,17,6,11,14,9,5
336,https://vlr.gg/player/113/hyp,2024-07-14 10:00:00,0.77,0.95,0.87,171,165,178,70,31,39,85,42,43,32,9,23,+4,+4,0,66%,60%,71%,110,105,114,20%,28%,16%,9,5,4,5,1,4
337,https://vlr.gg/player/2653/jesse,2024-07-14 10:00:00,1.20,1.20,1.20,234,231,233,101,55,46,81,47,34,40,24,16,+2,-1,+3,71%,72%,70%,156,156,157,39%,33%,48%,12,3,9,10,4,6
338,https://vlr.gg/player/252/d3ffo,2024-07-14 10:00:00,0.92,1.29,1.09,254,252,267,105,54,51,91,56,35,17,7,10,+1,-1,+2,73%,68%,79%,168,162,176,27%,32%,22%,26,16,10,25,17,8
339,https://vlr.gg/player/314/ambi,2024-07-14 10:00:00,0.83,1.20,0.99,183,177,201,80,40,40,83,53,30,39,20,19,-3,-2,-1,75%,74%,77%,120,113,129,26%,25%,27%,5,3,2,8,5,3
340,https://vlr.gg/player/6889/neskaas,2024-07-14 10:00:00,0.72,1.28,0.97,201,178,225,88,42,46,84,53,31,18,6,12,+1,+1,0,66%,55%,79%,132,115,152,26%,24%,29%,11,7,4,10,6,4
341,https://vlr.gg/player/8805/sacake,2024-07-14 10:00:00,0.86,0.85,0.86,161,157,173,61,33,28,82,47,35,50,27,23,+1,-2,+3,71%,66%,77%,111,110,113,24%,27%,20%,6,1,5,5,3,2
342,https://vlr.gg/player/17086/something,2024-07-14 07:15:00,1.35,2.01,1.68,293,192,394,36,12,24,15,7,8,9,6,3,+5,+1,+4,88%,81%,94%,198,144,252,30%,28%,31%,6,1,5,1,0,1
343,https://vlr.gg/player/9801/f0rsaken,2024-07-14 07:15:00,1.24,1.50,1.37,249,244,255,31,14,17,20,10,10,17,9,8,-1,-1,0,91%,81%,100%,155,154,157,29%,28%,30%,2,1,1,3,2,1
344,https://vlr.gg/player/9803/d4v41,2024-07-14 07:15:00,1.49,1.17,1.33,231,264,199,28,16,12,16,8,8,15,10,5,+1,0,+1,81%,81%,81%,151,161,140,26%,29%,23%,4,2,2,3,2,1
345,https://vlr.gg/player/7378/jinggg,2024-07-14 07:15:00,1.47,1.06,1.27,257,303,212,31,18,13,19,9,10,9,7,2,0,0,0,78%,81%,75%,168,186,149,15%,15%,15%,3,2,1,3,2,1
346,https://vlr.gg/player/9800/mindfreak,2024-07-14 07:15:00,0.81,1.21,1.01,146,135,159,18,9,9,16,10,6,13,3,10,-3,-2,-1,88%,81%,94%,96,83,110,49%,42%,56%,2,1,1,5,3,2
347,https://vlr.gg/player/25255/primmie,2024-07-14 07:15:00,0.88,0.81,0.84,191,213,170,22,12,10,29,15,14,6,2,4,0,0,0,59%,56%,63%,134,139,130,45%,50%,40%,5,3,2,5,3,2
348,https://vlr.gg/player/13788/jitboys,2024-07-14 07:15:00,0.83,0.80,0.81,197,219,176,22,13,9,30,16,14,5,2,3,-1,0,-1,63%,63%,63%,125,135,115,31%,36%,27%,1,1,0,2,1,1
349,https://vlr.gg/player/5129/ban,2024-07-14 07:15:00,0.41,0.85,0.63,152,113,191,13,5,8,29,15,14,12,4,8,0,0,0,56%,50%,63%,111,89,134,27%,30%,25%,2,1,1,2,1,1
350,https://vlr.gg/player/3980/governor,2024-07-14 07:15:00,0.58,0.64,0.61,127,121,133,15,7,8,27,14,13,2,2,0,0,-2,+2,63%,63%,63%,87,83,92,28%,22%,33%,5,0,5,5,2,3
351,https://vlr.gg/player/3977/crws,2024-07-14 07:15:00,0.43,0.62,0.49,161,143,180,14,5,9,29,15,14,5,2,3,-1,-2,+1,50%,44%,56%,113,110,115,20%,19%,21%,2,1,1,3,3,0
352,https://vlr.gg/player/5796/kr1stal,2024-07-14 04:30:00,,,,,,,,,,,,,,,,,,,,,,,,,,,,,,,,,
353,https://vlr.gg/player/22047/rarga,2024-07-14 04:30:00,,,,,,,,,,,,,,,,,,,,,,,,,,,,,,,,,
354,https://vlr.gg/player/37927/happywei,2024-07-14 04:30:00,,,,,,,,,,,,,,,,,,,,,,,,,,,,,,,,,
355,https://vlr.gg/player/46532/satoshi,2024-07-14 04:30:00,,,,,,,,,,,,,,,,,,,,,,,,,,,,,,,,,
356,https://vlr.gg/player/37674/mrcani,2024-07-14 04:30:00,,,,,,,,,,,,,,,,,,,,,,,,,,,,,,,,,
357,https://vlr.gg/player/41053/snail,2024-07-14 04:30:00,,,,,,,,,,,,,,,,,,,,,,,,,,,,,,,,,
358,https://vlr.gg/player/320/dimasick,2024-07-14 04:30:00,,,,,,,,,,,,,,,,,,,,,,,,,,,,,,,,,
359,https://vlr.gg/player/5927/anoxai,2024-07-14 04:30:00,,,,,,,,,,,,,,,,,,,,,,,,,,,,,,,,,
360,https://vlr.gg/player/4404/suyjing,2024-07-14 04:30:00,,,,,,,,,,,,,,,,,,,,,,,,,,,,,,,,,
361,https://vlr.gg/player/1924/ace,2024-07-14 04:30:00,,,,,,,,,,,,,,,,,,,,,,,,,,,,,,,,,
362,https://vlr.gg/player/34974/karon,2024-07-14 04:00:00,1.20,1.40,1.31,220,192,251,54,20,34,35,18,17,28,15,13,+5,+1,+4,77%,79%,75%,142,116,162,36%,41%,32%,7,1,6,2,0,2
363,https://vlr.gg/player/2489/munchkin,2024-07-14 04:00:00,0.87,1.53,1.24,210,135,268,41,10,31,35,20,15,40,21,19,+2,0,+2,80%,75%,83%,131,86,167,14%,20%,13%,7,3,4,5,3,2
364,https://vlr.gg/player/13039/meteor,2024-07-14 04:00:00,0.85,1.29,1.10,208,187,217,45,19,26,39,21,18,12,2,10,0,-3,+3,70%,54%,83%,132,116,143,30%,34%,28%,7,2,5,7,5,2
365,https://vlr.gg/player/9196/t3xture,2024-07-14 04:00:00,0.78,1.07,0.94,181,197,171,41,19,22,37,21,16,10,4,6,+1,-2,+3,66%,50%,78%,113,118,109,25%,30%,21%,10,5,5,9,7,2
366,https://vlr.gg/player/773/lakia,2024-07-14 04:00:00,1.16,0.75,0.93,166,205,136,37,21,16,38,17,21,12,6,6,-2,0,-2,70%,68%,72%,115,133,101,38%,38%,38%,4,1,3,6,1,5
367,https://vlr.gg/player/4678/beyn,2024-07-14 04:00:00,0.83,1.32,1.05,171,132,235,39,17,22,41,25,16,11,4,7,+1,+1,0,69%,61%,79%,118,85,160,27%,26%,27%,4,3,1,3,2,1
368,https://vlr.gg/player/35013/flashback,2024-07-14 04:00:00,0.93,0.93,0.93,179,175,186,37,20,17,44,25,19,11,4,7,+3,-2,+5,58%,58%,57%,121,119,124,26%,23%,31%,8,3,5,5,5,0
369,https://vlr.gg/player/4462/mako,2024-07-14 04:00:00,0.81,1.00,0.89,178,181,184,39,20,19,43,28,15,15,9,6,-1,+2,-3,61%,61%,61%,120,117,125,38%,30%,51%,7,4,3,8,2,6
370,https://vlr.gg/player/804/buzz,2024-07-14 04:00:00,0.75,0.84,0.79,173,160,184,37,20,17,47,26,21,12,7,5,-3,-8,+5,66%,64%,68%,114,110,118,24%,23%,25%,8,2,6,11,10,1
371,https://vlr.gg/player/11600/foxy9,2024-07-14 04:00:00,0.51,1.09,0.77,127,80,196,32,10,22,43,25,18,25,13,12,-6,-3,-3,66%,64%,68%,81,47,124,35%,20%,48%,2,1,1,8,4,4
372,https://vlr.gg/player/8480/aspas,2024-07-13 19:10:00,2.10,1.24,1.67,308,389,226,42,26,16,18,9,9,10,8,2,+4,0,+4,79%,84%,74%,197,258,136,32%,34%,25%,8,3,5,4,3,1
373,https://vlr.gg/player/619/c0m,2024-07-13 19:10:00,1.33,1.35,1.34,221,214,229,31,16,15,20,10,10,10,4,6,-1,-1,0,76%,74%,79%,160,150,170,29%,32%,27%,2,1,1,3,2,1
374,https://vlr.gg/player/8549/kingg,2024-07-13 19:10:00,1.26,1.10,1.18,190,235,145,25,15,10,21,12,9,14,8,6,-1,+2,-3,82%,84%,79%,125,151,98,26%,40%,13%,4,2,2,5,0,5
375,https://vlr.gg/player/1818/tex,2024-07-13 19:10:00,0.86,1.10,0.98,215,203,227,31,16,15,26,14,12,3,1,2,-1,-2,+1,68%,63%,74%,142,122,162,29%,31%,27%,4,2,2,5,4,1
376,https://vlr.gg/player/7603/mazino,2024-07-13 19:10:00,0.56,1.32,0.94,174,110,239,25,7,18,25,14,11,13,8,5,-1,-2,+1,74%,68%,79%,118,74,162,27%,28%,27%,1,0,1,2,2,0
377,https://vlr.gg/player/725/nzr,2024-07-13 19:10:00,0.79,1.41,1.10,199,144,256,26,9,17,27,14,13,7,3,4,+2,+1,+1,76%,74%,79%,151,118,183,29%,30%,28%,2,1,1,0,0,0
378,https://vlr.gg/player/939/mwzera,2024-07-13 19:10:00,0.62,1.16,0.89,244,199,288,32,12,20,34,18,16,4,2,2,-2,-2,0,63%,58%,68%,155,130,180,20%,23%,19%,5,2,3,7,4,3
379,https://vlr.gg/player/8706/havoc,2024-07-13 19:10:00,0.84,0.50,0.67,165,192,139,21,14,7,32,15,17,6,1,5,+2,+3,-1,58%,63%,53%,110,126,93,39%,40%,38%,6,4,2,4,1,3
380,https://vlr.gg/player/681/xand,2024-07-13 19:10:00,0.66,0.45,0.56,140,127,154,17,9,8,31,14,17,6,2,4,-3,-4,+1,58%,53%,63%,105,96,114,41%,32%,50%,3,0,3,6,4,2
381,https://vlr.gg/player/1711/khalil,2024-07-13 19:10:00,0.63,0.27,0.45,107,116,98,14,7,7,30,13,17,6,4,2,+1,-1,+2,61%,63%,58%,72,84,59,31%,32%,29%,3,1,2,2,2,0
382,https://vlr.gg/player/1533/derrek,2024-07-13 17:00:00,1.47,0.96,1.14,220,286,198,30,14,16,28,9,19,11,3,8,+1,0,+1,70%,77%,67%,154,182,139,44%,48%,42%,2,0,2,1,0,1
383,https://vlr.gg/player/3993/jawgemo,2024-07-13 17:00:00,0.81,1.10,1.00,229,192,267,30,9,21,30,11,19,3,1,2,-6,-5,-1,68%,62%,71%,151,126,165,21%,8%,28%,2,0,2,8,5,3
384,https://vlr.gg/player/826/supamen,2024-07-13 17:00:00,1.05,0.95,0.99,204,211,209,26,9,17,29,10,19,12,6,6,-3,0,-3,73%,77%,71%,136,127,141,44%,35%,51%,4,2,2,7,2,5
385,https://vlr.gg/player/4927/nature,2024-07-13 17:00:00,0.75,0.55,0.62,153,175,136,18,8,10,31,11,20,7,2,5,0,0,0,62%,77%,54%,105,130,92,25%,28%,23%,2,0,2,2,0,2
386,https://vlr.gg/player/5188/apoth,2024-07-13 17:00:00,0.02,0.53,0.30,70,18,102,8,0,8,29,11,18,5,2,3,-7,-4,-3,43%,38%,46%,53,16,73,23%,0%,26%,1,0,1,8,4,4
387,https://vlr.gg/player/5957/artzin,2024-07-13 17:00:00,1.14,1.83,1.39,234,189,314,31,17,14,21,15,6,13,6,7,+4,0,+4,81%,75%,92%,157,137,193,22%,25%,20%,5,1,4,1,1,0
388,https://vlr.gg/player/2567/liazzi,2024-07-13 17:00:00,1.46,0.94,1.28,213,227,207,30,20,10,18,9,9,9,4,5,+3,0,+3,76%,71%,85%,140,152,118,33%,33%,32%,5,2,3,2,2,0
389,https://vlr.gg/player/11105/rich,2024-07-13 17:00:00,0.96,1.50,1.15,195,161,248,25,13,12,21,15,6,18,13,5,0,0,0,76%,75%,77%,136,113,179,32%,30%,34%,1,1,0,1,1,0
390,https://vlr.gg/player/8872/mazin,2024-07-13 17:00:00,1.41,0.67,1.15,201,225,130,28,21,7,22,13,9,15,12,3,+4,+3,+1,73%,79%,62%,124,150,74,32%,43%,16%,4,3,1,0,0,0
391,https://vlr.gg/player/15681/palla,2024-07-13 17:00:00,1.03,0.94,1.00,263,280,200,33,24,9,30,20,10,7,5,2,+4,+3,+1,76%,79%,69%,161,179,127,30%,35%,19%,11,8,3,7,5,2
392,https://vlr.gg/player/40004/globex,2024-07-13 12:40:00,1.01,1.15,1.07,247,234,261,38,18,20,38,18,20,9,6,3,+3,+3,0,66%,67%,65%,161,169,153,22%,26%,18%,10,5,5,7,2,5
393,https://vlr.gg/player/38424/zachkappa,2024-07-13 12:40:00,1.14,0.93,1.04,201,220,182,34,19,15,33,15,18,9,5,4,-2,+1,-3,70%,75%,65%,138,151,125,36%,33%,42%,3,3,0,5,2,3
394,https://vlr.gg/player/28948/ninja,2024-07-13 12:40:00,1.25,0.45,0.86,173,220,124,31,22,9,34,13,21,12,6,6,-1,-1,0,62%,67%,57%,109,134,82,26%,21%,43%,2,0,2,3,1,2
395,https://vlr.gg/player/164/bzt,2024-07-13 12:40:00,1.00,0.68,0.84,152,158,148,23,13,10,31,13,18,19,11,8,-1,+2,-3,66%,79%,52%,104,98,110,25%,19%,33%,3,3,0,4,1,3
396,https://vlr.gg/player/18162/serial,2024-07-13 12:40:00,0.64,0.95,0.79,177,150,203,29,13,16,35,17,18,6,4,2,-6,-5,-1,57%,54%,61%,116,108,124,54%,46%,63%,2,1,1,8,6,2
397,https://vlr.gg/player/29575/luckymrj,2024-07-13 12:40:00,1.53,1.20,1.36,221,267,177,39,23,16,27,12,15,17,8,9,+2,+1,+1,74%,83%,67%,138,166,112,30%,29%,31%,3,2,1,1,1,0
398,https://vlr.gg/player/21609/danda,2024-07-13 12:40:00,1.28,0.94,1.11,196,227,170,35,21,14,28,11,17,15,5,10,0,+1,-1,74%,91%,58%,136,160,112,39%,40%,37%,5,2,3,5,1,4
399,https://vlr.gg/player/29742/anxios,2024-07-13 12:40:00,1.29,0.79,1.04,177,200,154,28,17,11,32,12,20,27,12,15,0,0,0,72%,91%,54%,115,129,103,21%,25%,16%,2,1,1,2,1,1
400,https://vlr.gg/player/21216/f4ngeer,2024-07-13 12:40:00,0.88,1.12,1.00,229,238,224,35,19,16,33,17,16,10,4,6,+5,+2,+3,72%,78%,67%,155,155,155,25%,31%,19%,10,5,5,5,3,2
401,https://vlr.gg/player/4537/tajrex,2024-07-13 12:40:00,0.83,1.11,0.97,225,217,230,34,15,19,35,18,17,12,6,6,0,+3,-3,66%,65%,67%,143,147,139,21%,20%,22%,7,5,2,7,2,5
402,https://vlr.gg/player/4521/unfake,2024-07-13 12:00:00,0.95,1.21,1.09,217,211,223,58,25,33,54,26,28,14,6,8,-3,-2,-1,71%,71%,71%,133,134,131,27%,29%,25%,5,1,4,8,3,5
403,https://vlr.gg/player/3563/babax,2024-07-13 12:00:00,1.00,0.81,0.89,149,132,171,38,15,23,53,19,34,29,16,13,-2,-2,0,67%,68%,67%,107,100,112,27%,28%,26%,3,1,2,5,3,2
404,https://vlr.gg/player/2256/jady,2024-07-13 12:00:00,1.11,0.70,0.88,170,201,154,46,24,22,53,22,31,12,6,6,0,0,0,63%,68%,60%,120,148,98,47%,64%,34%,10,4,6,10,4,6
405,https://vlr.gg/player/14612/lux9,2024-07-13 12:00:00,0.97,0.81,0.88,203,232,183,53,28,25,62,28,34,18,4,14,+4,+2,+2,61%,56%,64%,129,149,113,31%,36%,26%,14,7,7,10,5,5
406,https://vlr.gg/player/12928/veqaj,2024-07-13 12:00:00,0.88,0.81,0.84,177,173,170,46,20,26,53,21,32,20,12,8,-1,-2,+1,66%,74%,60%,111,111,112,24%,22%,25%,5,2,3,6,4,2
407,https://vlr.gg/player/1475/kamyk,2024-07-13 12:00:00,1.08,1.20,1.13,239,220,252,68,35,33,54,29,25,19,12,7,+1,0,+1,74%,69%,79%,142,136,150,29%,31%,27%,7,3,4,6,3,3
408,https://vlr.gg/player/4308/magik,2024-07-13 12:00:00,1.22,0.92,1.09,212,240,175,57,37,20,45,24,21,22,11,11,-2,0,-2,72%,79%,65%,148,163,129,29%,32%,26%,3,1,2,5,1,4
409,https://vlr.gg/player/2700/jas,2024-07-13 12:00:00,1.00,1.13,1.06,222,225,224,60,34,26,52,30,22,10,4,6,+5,0,+5,72%,76%,68%,139,135,144,30%,31%,29%,20,11,9,15,11,4
410,https://vlr.gg/player/1284/mikee,2024-07-13 12:00:00,1.09,0.99,1.04,179,202,151,46,28,18,45,24,21,21,9,12,0,-2,+2,70%,69%,71%,123,138,105,28%,29%,27%,5,2,3,5,4,1
411,https://vlr.gg/player/5893/robbiebk,2024-07-13 12:00:00,1.02,0.89,0.97,158,169,146,43,25,18,46,23,23,22,10,12,-2,0,-2,76%,76%,76%,107,112,100,37%,39%,35%,4,3,1,6,3,3
412,https://vlr.gg/player/21216/f4ngeer,2024-07-13 11:00:00,2.27,0.84,1.53,300,424,186,44,32,12,21,9,12,8,3,5,+1,+3,-2,82%,95%,70%,191,262,125,28%,35%,17%,4,3,1,3,0,3
413,https://vlr.gg/player/4537/tajrex,2024-07-13 11:00:00,1.20,1.75,1.48,300,235,365,41,15,26,25,13,12,8,5,3,+3,-3,+6,74%,74%,75%,190,170,210,22%,18%,26%,10,2,8,7,5,2
414,https://vlr.gg/player/29575/luckymrj,2024-07-13 11:00:00,1.21,1.35,1.28,218,214,221,30,15,15,21,10,11,10,4,6,-1,-1,0,77%,68%,85%,140,133,145,30%,31%,29%,3,2,1,4,3,1
415,https://vlr.gg/player/21609/danda,2024-07-13 11:00:00,0.87,1.21,1.04,167,132,202,23,10,13,21,10,11,12,5,7,-3,-1,-2,67%,63%,70%,111,93,129,34%,45%,29%,0,0,0,3,1,2
416,https://vlr.gg/player/29742/anxios,2024-07-13 11:00:00,0.88,0.89,0.88,161,173,147,21,11,10,27,14,13,23,10,13,+1,+1,0,79%,84%,75%,102,110,94,17%,10%,27%,3,2,1,2,1,1
417,https://vlr.gg/player/10448/kozok,2024-07-13 11:00:00,1.08,1.03,1.06,204,183,226,28,14,14,29,13,16,8,3,5,0,-1,+1,67%,65%,68%,129,115,144,27%,27%,26%,3,0,3,3,1,2
418,https://vlr.gg/player/15064/kajuks,2024-07-13 11:00:00,0.62,1.19,0.90,198,116,285,27,9,18,30,15,15,9,6,3,+4,+2,+2,72%,55%,89%,127,77,179,30%,17%,40%,5,2,3,1,0,1
419,https://vlr.gg/player/39682/wanzeru,2024-07-13 11:00:00,0.75,0.58,0.67,198,235,161,25,15,10,34,17,17,8,3,5,-1,0,-1,56%,60%,53%,135,165,104,22%,23%,20%,8,6,2,9,6,3
420,https://vlr.gg/player/33732/nunmeister,2024-07-13 11:00:00,0.69,0.48,0.59,136,140,129,19,10,9,33,16,17,9,6,3,-1,-1,0,46%,50%,42%,92,98,86,37%,46%,28%,3,1,2,4,2,2
421,https://vlr.gg/player/259/arch,2024-07-13 11:00:00,0.85,0.29,0.58,129,158,101,15,11,4,33,15,18,10,4,6,-3,-2,-1,44%,45%,42%,102,115,88,23%,22%,24%,0,0,0,3,2,1
422,https://vlr.gg/player/164/bzt,2024-07-13 09:00:00,1.10,1.09,1.10,197,189,203,26,11,15,26,7,19,14,4,10,0,-1,+1,79%,80%,79%,142,134,148,31%,21%,39%,2,0,2,2,1,1
423,https://vlr.gg/player/28948/ninja,2024-07-13 09:00:00,1.20,0.84,0.98,186,201,179,27,12,15,26,8,18,10,4,6,-3,-1,-2,79%,87%,75%,124,140,114,37%,30%,42%,1,0,1,4,1,3
424,https://vlr.gg/player/18162/serial,2024-07-13 09:00:00,0.75,1.07,0.94,221,192,243,31,11,20,30,11,19,7,3,4,-5,-3,-2,67%,67%,67%,141,129,148,41%,38%,43%,4,1,3,9,4,5
425,https://vlr.gg/player/40004/globex,2024-07-13 09:00:00,1.14,0.62,0.82,207,309,142,26,15,11,34,13,21,13,8,5,+1,+6,-5,77%,87%,71%,144,223,95,21%,25%,18%,7,6,1,6,0,6
426,https://vlr.gg/player/38424/zachkappa,2024-07-13 09:00:00,0.73,0.63,0.67,148,160,140,20,8,12,29,10,19,0,0,0,-2,0,-2,54%,67%,46%,104,122,93,39%,32%,48%,1,1,0,3,1,2
427,https://vlr.gg/player/5490/xitsha,2024-07-13 09:00:00,1.90,1.09,1.59,288,371,153,41,33,8,21,13,8,8,6,2,0,+3,-3,79%,92%,60%,189,241,105,32%,34%,24%,4,3,1,4,0,4
428,https://vlr.gg/player/8593/grmekista,2024-07-13 09:00:00,1.22,0.94,1.12,188,183,197,26,16,10,24,11,13,12,9,3,+2,+2,0,77%,83%,67%,134,133,137,24%,18%,34%,3,3,0,1,1,0
429,https://vlr.gg/player/34684/westside,2024-07-13 09:00:00,0.97,1.20,1.05,180,161,212,25,14,11,24,13,11,11,7,4,0,0,0,74%,75%,73%,126,116,142,38%,33%,45%,2,1,1,2,1,1
430,https://vlr.gg/player/24424/pa1ze,2024-07-13 09:00:00,0.82,1.07,0.92,256,252,261,35,22,13,33,20,13,4,2,2,+6,+4,+2,72%,71%,73%,158,161,154,38%,42%,32%,12,7,5,6,3,3
431,https://vlr.gg/player/3839/prti,2024-07-13 09:00:00,0.70,0.75,0.72,130,141,113,18,11,7,28,16,12,12,6,6,+1,+1,0,64%,67%,60%,100,112,82,31%,27%,40%,3,3,0,2,2,0
432,https://vlr.gg/player/35013/flashback,2024-07-13 06:05:00,1.28,1.48,1.39,234,236,222,35,16,19,20,11,9,10,3,7,+2,0,+2,68%,53%,81%,145,165,129,32%,33%,30%,3,1,2,1,1,0
433,https://vlr.gg/player/804/buzz,2024-07-13 06:05:00,1.64,1.18,1.38,274,315,239,39,20,19,24,10,14,8,5,3,+4,+4,0,76%,82%,71%,167,193,145,20%,15%,28%,9,5,4,5,1,4
434,https://vlr.gg/player/4462/mako,2024-07-13 06:05:00,0.82,1.49,1.19,233,225,241,31,12,19,25,14,11,19,11,8,+5,+2,+3,92%,88%,95%,161,153,167,22%,19%,23%,6,2,4,1,0,1
435,https://vlr.gg/player/4678/beyn,2024-07-13 06:05:00,0.82,1.02,0.93,193,179,205,26,11,15,26,13,13,11,2,9,0,-2,+2,76%,76%,76%,134,136,132,26%,36%,20%,4,1,3,4,3,1
436,https://vlr.gg/player/11600/foxy9,2024-07-13 06:05:00,0.41,0.89,0.68,149,129,168,19,8,11,29,15,14,16,5,11,-3,-1,-2,74%,65%,81%,102,79,122,23%,35%,18%,1,1,0,4,2,2
437,https://vlr.gg/player/25255/primmie,2024-07-13 06:05:00,1.51,0.89,1.23,268,344,165,33,23,10,30,17,13,10,8,2,-1,0,-1,71%,76%,65%,181,233,118,51%,50%,53%,6,4,2,7,4,3
438,https://vlr.gg/player/13788/jitboys,2024-07-13 06:05:00,0.70,1.28,0.96,211,170,249,30,12,18,30,18,12,9,6,3,-1,-1,0,74%,67%,82%,132,112,156,43%,43%,43%,1,0,1,2,1,1
439,https://vlr.gg/player/5129/ban,2024-07-13 06:05:00,0.75,1.16,0.94,189,148,262,26,11,15,30,16,14,7,4,3,+1,+1,0,63%,62%,65%,134,104,171,39%,42%,38%,2,2,0,1,1,0
440,https://vlr.gg/player/3980/governor,2024-07-13 06:05:00,0.61,1.00,0.78,159,128,212,21,9,12,29,16,13,15,8,7,-4,-5,+1,68%,71%,65%,107,82,138,29%,36%,24%,3,1,2,7,6,1
441,https://vlr.gg/player/3977/crws,2024-07-13 06:05:00,0.46,0.58,0.48,114,76,174,14,6,8,31,16,15,9,2,7,-3,0,-3,61%,57%,65%,82,47,125,13%,21%,11%,3,1,2,6,1,5
442,https://vlr.gg/player/46750/yeoj,2024-07-13 05:30:00,,,,,,,,,,,,,,,,,,,,,,,,,,,,,,,,,
443,https://vlr.gg/player/30520/9st,2024-07-13 05:30:00,,,,,,,,,,,,,,,,,,,,,,,,,,,,,,,,,
444,https://vlr.gg/player/4777/yuk1no,2024-07-13 05:30:00,,,,,,,,,,,,,,,,,,,,,,,,,,,,,,,,,
445,https://vlr.gg/player/3534/cxy0714,2024-07-13 05:30:00,,,,,,,,,,,,,,,,,,,,,,,,,,,,,,,,,
446,https://vlr.gg/player/3536/k1te,2024-07-13 05:30:00,,,,,,,,,,,,,,,,,,,,,,,,,,,,,,,,,
447,https://vlr.gg/player/41053/snail,2024-07-13 05:30:00,,,,,,,,,,,,,,,,,,,,,,,,,,,,,,,,,
448,https://vlr.gg/player/320/dimasick,2024-07-13 05:30:00,,,,,,,,,,,,,,,,,,,,,,,,,,,,,,,,,
449,https://vlr.gg/player/5927/anoxai,2024-07-13 05:30:00,,,,,,,,,,,,,,,,,,,,,,,,,,,,,,,,,
450,https://vlr.gg/player/4404/suyjing,2024-07-13 05:30:00,,,,,,,,,,,,,,,,,,,,,,,,,,,,,,,,,
451,https://vlr.gg/player/1924/ace,2024-07-13 05:30:00,,,,,,,,,,,,,,,,,,,,,,,,,,,,,,,,,
452,https://vlr.gg/player/9801/f0rsaken,2024-07-13 04:00:00,0.96,0.87,0.92,194,192,189,27,15,12,32,20,12,18,14,4,-4,-4,0,66%,67%,65%,121,117,126,29%,20%,41%,3,0,3,7,4,3
453,https://vlr.gg/player/7378/jinggg,2024-07-13 04:00:00,1.31,0.37,0.92,207,279,112,28,22,6,34,19,15,4,4,0,-1,+3,-4,56%,63%,47%,128,165,77,25%,31%,12%,5,5,0,6,2,4
454,https://vlr.gg/player/9803/d4v41,2024-07-13 04:00:00,0.73,0.99,0.84,138,149,132,16,10,6,29,20,9,10,6,4,0,-2,+2,59%,58%,59%,106,117,90,14%,16%,11%,2,0,2,2,2,0
455,https://vlr.gg/player/9800/mindfreak,2024-07-13 04:00:00,0.67,1.06,0.83,147,136,168,21,10,11,29,21,8,10,7,3,+1,-1,+2,71%,67%,76%,100,97,104,40%,38%,43%,3,1,2,2,2,0
456,https://vlr.gg/player/17086/something,2024-07-13 04:00:00,0.34,0.95,0.59,119,94,164,18,7,11,33,23,10,7,6,1,-5,-4,-1,56%,50%,65%,80,59,110,27%,25%,29%,3,2,1,8,6,2
457,https://vlr.gg/player/9196/t3xture,2024-07-13 04:00:00,1.27,1.50,1.40,285,290,275,44,18,26,23,12,11,5,3,2,+7,-1,+8,78%,65%,88%,178,180,176,31%,38%,22%,10,2,8,3,3,0
458,https://vlr.gg/player/2489/munchkin,2024-07-13 04:00:00,1.10,1.57,1.37,257,146,334,35,8,27,23,8,15,30,11,19,-1,+1,-2,83%,76%,88%,180,90,243,28%,18%,31%,3,2,1,4,1,3
459,https://vlr.gg/player/13039/meteor,2024-07-13 04:00:00,1.30,1.09,1.18,214,246,171,32,15,17,21,10,11,5,3,2,+2,+1,+1,80%,71%,88%,144,172,125,21%,15%,29%,4,3,1,2,2,0
460,https://vlr.gg/player/34974/karon,2024-07-13 04:00:00,1.00,1.14,1.08,180,102,236,27,6,21,24,8,16,18,9,9,+2,-1,+3,78%,71%,83%,115,60,154,28%,29%,28%,7,1,6,5,2,3
461,https://vlr.gg/player/773/lakia,2024-07-13 04:00:00,0.93,1.01,0.97,141,130,157,19,7,12,19,8,11,11,1,10,-1,+1,-2,71%,71%,71%,106,96,114,17%,16%,18%,1,1,0,2,0,2
462,https://vlr.gg/player/5796/kr1stal,2024-07-13 03:00:00,,,,,,,,,,,,,,,,,,,,,,,,,,,,,,,,,
463,https://vlr.gg/player/22047/rarga,2024-07-13 03:00:00,,,,,,,,,,,,,,,,,,,,,,,,,,,,,,,,,
464,https://vlr.gg/player/37927/happywei,2024-07-13 03:00:00,,,,,,,,,,,,,,,,,,,,,,,,,,,,,,,,,
465,https://vlr.gg/player/46532/satoshi,2024-07-13 03:00:00,,,,,,,,,,,,,,,,,,,,,,,,,,,,,,,,,
466,https://vlr.gg/player/37674/mrcani,2024-07-13 03:00:00,,,,,,,,,,,,,,,,,,,,,,,,,,,,,,,,,
467,https://vlr.gg/player/5241/maple,2024-07-13 03:00:00,,,,,,,,,,,,,,,,,,,,,,,,,,,,,,,,,
468,https://vlr.gg/player/24236/zoomer,2024-07-13 03:00:00,,,,,,,,,,,,,,,,,,,,,,,,,,,,,,,,,
469,https://vlr.gg/player/46756/deep9,2024-07-13 03:00:00,,,,,,,,,,,,,,,,,,,,,,,,,,,,,,,,,
470,https://vlr.gg/player/34181/green,2024-07-13 03:00:00,,,,,,,,,,,,,,,,,,,,,,,,,,,,,,,,,
471,https://vlr.gg/player/29184/kawentw,2024-07-13 03:00:00,,,,,,,,,,,,,,,,,,,,,,,,,,,,,,,,,
472,https://vlr.gg/player/18796/oxy,2024-07-12 20:00:00,1.25,0.98,1.10,270,283,257,39,19,20,38,16,22,8,4,4,-3,-1,-2,67%,74%,63%,179,187,173,31%,36%,27%,7,3,4,10,4,6
473,https://vlr.gg/player/7458/moose,2024-07-12 20:00:00,0.76,1.09,0.94,193,169,214,29,11,18,31,15,16,3,1,2,+3,+3,0,60%,58%,63%,129,108,146,25%,22%,27%,6,4,2,3,1,2
474,https://vlr.gg/player/7870/vanity,2024-07-12 20:00:00,0.96,0.72,0.83,152,153,149,22,10,12,30,12,18,10,5,5,+1,0,+1,58%,63%,54%,101,87,112,16%,11%,20%,3,1,2,2,1,1
475,https://vlr.gg/player/7871/xeppaa,2024-07-12 20:00:00,0.79,0.78,0.79,155,120,185,21,7,14,33,12,21,18,10,8,-1,-1,0,70%,74%,67%,118,103,131,27%,26%,27%,3,1,2,4,2,2
476,https://vlr.gg/player/16003/runi,2024-07-12 20:00:00,0.44,0.66,0.56,99,94,109,12,5,7,31,15,16,10,3,7,-1,0,-1,65%,53%,75%,70,71,69,17%,11%,22%,2,1,1,3,1,2
477,https://vlr.gg/player/2462/keznit,2024-07-12 20:00:00,1.38,1.45,1.41,279,293,258,41,23,18,25,16,9,10,7,3,+6,+6,0,81%,79%,84%,190,189,191,19%,21%,17%,10,8,2,4,2,2
478,https://vlr.gg/player/36169/mta,2024-07-12 20:00:00,1.25,1.21,1.23,208,218,203,34,20,14,22,12,10,7,4,3,-1,-2,+1,79%,79%,79%,153,147,161,55%,49%,64%,2,1,1,3,3,0
479,https://vlr.gg/player/24007/shyy,2024-07-12 20:00:00,1.04,1.17,1.10,196,190,194,30,17,13,25,14,11,12,5,7,0,-1,+1,70%,75%,63%,145,150,139,27%,27%,26%,3,1,2,3,2,1
480,https://vlr.gg/player/8673/heat,2024-07-12 20:00:00,0.94,1.25,1.07,196,161,232,32,16,16,28,16,12,13,4,9,-1,-1,0,79%,75%,84%,122,108,141,31%,39%,25%,3,1,2,4,2,2
481,https://vlr.gg/player/1311/melser,2024-07-12 20:00:00,1.15,0.89,1.03,175,196,153,26,17,9,23,13,10,14,8,6,-3,0,-3,74%,79%,68%,110,121,96,32%,38%,26%,4,2,2,7,2,5
482,https://vlr.gg/player/28948/ninja,2024-07-12 13:05:00,1.23,1.50,1.36,247,226,279,62,30,32,42,24,18,20,9,11,+2,+1,+1,77%,71%,84%,160,136,187,37%,43%,33%,10,5,5,8,4,4
483,https://vlr.gg/player/38424/zachkappa,2024-07-12 13:05:00,1.19,1.20,1.20,219,246,192,53,31,22,41,23,18,12,6,6,+3,+1,+2,77%,71%,84%,153,166,138,42%,51%,34%,5,3,2,2,2,0
484,https://vlr.gg/player/164/bzt,2024-07-12 13:05:00,0.96,1.15,1.05,195,187,201,45,23,22,44,24,20,20,8,12,+1,+1,0,80%,83%,77%,139,139,138,25%,25%,24%,4,2,2,3,1,2
485,https://vlr.gg/player/40004/globex,2024-07-12 13:05:00,0.48,1.28,0.86,205,154,265,44,18,26,50,29,21,16,5,11,0,-2,+2,71%,60%,84%,135,107,167,18%,21%,16%,11,5,6,11,7,4
486,https://vlr.gg/player/18162/serial,2024-07-12 13:05:00,0.88,0.82,0.85,180,174,180,41,22,19,48,26,22,17,9,8,-2,0,-2,70%,66%,74%,118,121,115,38%,41%,33%,5,3,2,7,3,4
487,https://vlr.gg/player/29575/luckymrj,2024-07-12 13:05:00,1.03,1.32,1.18,208,188,227,49,20,29,44,22,22,21,10,11,+3,0,+3,65%,58%,71%,130,118,142,29%,23%,34%,8,3,5,5,3,2
488,https://vlr.gg/player/21216/f4ngeer,2024-07-12 13:05:00,0.89,1.25,1.08,238,234,251,59,28,31,50,26,24,10,2,8,-6,-7,+1,67%,65%,69%,159,150,168,31%,30%,32%,10,3,7,16,10,6
489,https://vlr.gg/player/4537/tajrex,2024-07-12 13:05:00,0.76,0.99,0.88,212,184,223,42,17,25,51,25,26,17,5,12,+4,+4,0,68%,61%,74%,136,138,135,23%,24%,23%,6,4,2,2,0,2
490,https://vlr.gg/player/21609/danda,2024-07-12 13:05:00,0.71,0.89,0.80,155,128,180,37,15,22,46,22,24,22,7,15,-2,-1,-1,73%,65%,80%,101,75,123,25%,20%,28%,3,1,2,5,2,3
491,https://vlr.gg/player/29742/anxios,2024-07-12 13:05:00,0.81,0.68,0.74,176,208,158,38,19,19,54,26,28,34,19,15,-3,+1,-4,71%,68%,74%,119,131,109,21%,24%,18%,4,3,1,7,2,5
492,https://vlr.gg/player/3839/prti,2024-07-12 11:00:00,1.57,1.11,1.37,261,283,234,39,23,16,27,13,14,19,12,7,-6,-2,-4,77%,79%,74%,170,192,142,31%,27%,41%,1,0,1,7,2,5
493,https://vlr.gg/player/5490/xitsha,2024-07-12 11:00:00,1.29,1.14,1.22,197,178,221,33,17,16,27,12,15,13,8,5,+1,-1,+2,86%,92%,79%,145,139,154,35%,38%,31%,3,1,2,2,2,0
494,https://vlr.gg/player/24424/pa1ze,2024-07-12 11:00:00,1.16,1.19,1.17,260,268,243,38,23,15,32,16,16,13,4,9,+2,+2,0,67%,67%,68%,161,166,154,26%,27%,24%,11,7,4,9,5,4
495,https://vlr.gg/player/34684/westside,2024-07-12 11:00:00,1.21,0.79,1.02,193,231,146,32,22,10,28,15,13,6,2,4,+1,+3,-2,74%,79%,68%,131,157,99,36%,40%,30%,4,4,0,3,1,2
496,https://vlr.gg/player/8593/grmekista,2024-07-12 11:00:00,0.69,0.96,0.81,167,135,208,22,10,12,33,17,16,25,12,13,+3,+2,+1,88%,96%,79%,119,94,151,18%,15%,20%,3,2,1,0,0,0
497,https://vlr.gg/player/10448/kozok,2024-07-12 11:00:00,1.32,1.18,1.24,239,237,253,37,16,21,29,10,19,9,5,4,+1,+1,0,77%,84%,71%,172,173,170,28%,33%,25%,5,1,4,4,0,4
498,https://vlr.gg/player/15064/kajuks,2024-07-12 11:00:00,0.91,1.31,1.13,235,192,276,37,14,23,33,15,18,14,8,6,0,0,0,72%,74%,71%,152,137,164,27%,19%,33%,2,1,1,2,1,1
499,https://vlr.gg/player/39682/wanzeru,2024-07-12 11:00:00,1.07,0.54,0.77,244,300,187,32,20,12,40,18,22,8,4,4,+3,+6,-3,63%,79%,50%,147,179,122,19%,21%,16%,12,8,4,9,2,7
500,https://vlr.gg/player/259/arch,2024-07-12 11:00:00,0.92,0.63,0.76,133,158,121,24,13,11,29,11,18,13,9,4,-3,-2,-1,56%,68%,46%,85,98,75,30%,36%,24%,1,1,0,4,3,1
501,https://vlr.gg/player/33732/nunmeister,2024-07-12 11:00:00,0.85,0.36,0.58,121,181,77,17,11,6,33,15,18,22,15,7,-2,-2,0,72%,89%,58%,79,120,47,32%,34%,28%,1,0,1,3,2,1
0,https://vlr.gg/player/2334/jessievash,2024-07-12 06:15:00,1.02,1.50,1.26,226,184,268,36,16,20,29,15,14,10,3,7,+5,+2,+3,71%,75%,67%,159,133,184,24%,33%,20%,7,3,4,2,1,1
1,https://vlr.gg/player/7405/jremy,2024-07-12 06:15:00,1.20,0.76,0.98,204,242,165,35,20,15,34,17,17,8,2,6,+3,+1,+2,75%,71%,79%,138,153,123,30%,38%,21%,10,7,3,7,6,1
2,https://vlr.gg/player/8504/invy,2024-07-12 06:15:00,0.76,1.14,0.95,179,163,196,29,15,14,36,17,19,26,10,16,-2,0,-2,79%,83%,75%,128,108,148,25%,19%,30%,2,1,1,4,1,3
3,https://vlr.gg/player/9740/wild0reoo,2024-07-12 06:15:00,0.89,1.00,0.94,185,179,191,34,16,18,34,16,18,17,7,10,-4,-2,-2,75%,71%,79%,121,110,132,40%,40%,40%,2,0,2,6,2,4
4,https://vlr.gg/player/9735/2ge,2024-07-12 06:15:00,0.67,1.07,0.87,171,150,194,29,12,17,34,17,17,15,10,5,-4,-2,-2,69%,71%,67%,120,110,129,28%,26%,30%,3,1,2,7,3,4
5,https://vlr.gg/player/25255/primmie,2024-07-12 06:15:00,1.15,1.27,1.21,305,301,310,52,25,27,42,23,19,8,5,3,+5,+3,+2,75%,71%,79%,195,198,191,41%,37%,47%,8,4,4,3,1,2
6,https://vlr.gg/player/13788/jitboys,2024-07-12 06:15:00,1.28,1.02,1.15,183,218,148,31,19,12,31,16,15,24,14,10,+2,+2,0,83%,88%,79%,125,141,110,44%,45%,42%,4,2,2,2,0,2
7,https://vlr.gg/player/3980/governor,2024-07-12 06:15:00,0.82,1.18,1.00,188,173,204,31,14,17,31,17,14,8,3,5,0,0,0,65%,63%,67%,120,107,133,26%,27%,26%,6,5,1,6,5,1
8,https://vlr.gg/player/5129/ban,2024-07-12 06:15:00,0.62,1.05,0.83,149,143,156,26,12,14,31,17,14,6,3,3,-2,-2,0,63%,67%,58%,106,103,110,34%,23%,50%,3,1,2,5,3,2
9,https://vlr.gg/player/3977/crws,2024-07-12 06:15:00,0.90,0.74,0.82,148,156,142,24,13,11,29,14,15,14,8,6,-3,-2,-1,71%,71%,71%,98,104,92,22%,31%,16%,3,0,3,6,2,4
10,https://vlr.gg/player/34974/karon,2024-07-12 04:00:00,1.41,1.33,1.37,255,248,256,43,20,23,28,13,15,21,10,11,+3,+1,+2,87%,86%,88%,150,139,160,35%,73%,23%,3,1,2,0,0,0
11,https://vlr.gg/player/2489/munchkin,2024-07-12 04:00:00,0.73,1.40,1.09,180,92,255,26,6,20,24,12,12,20,7,13,+6,-1,+7,76%,71%,79%,121,71,165,22%,15%,24%,7,0,7,1,1,0
12,https://vlr.gg/player/9196/t3xture,2024-07-12 04:00:00,0.99,1.11,1.06,221,252,191,36,18,18,31,17,14,6,3,3,+4,+3,+1,64%,57%,71%,143,159,130,25%,24%,27%,10,6,4,6,3,3
13,https://vlr.gg/player/13039/meteor,2024-07-12 04:00:00,1.05,1.00,1.03,198,186,220,35,15,20,28,12,16,4,0,4,-1,0,-1,69%,71%,67%,132,128,135,39%,45%,35%,5,2,3,6,2,4
14,https://vlr.gg/player/773/lakia,2024-07-12 04:00:00,0.96,0.57,0.75,120,148,96,19,10,9,28,11,17,18,8,10,+1,0,+1,64%,62%,67%,74,103,48,18%,26%,8%,4,3,1,3,3,0
15,https://vlr.gg/player/24895/jemkin,2024-07-12 04:00:00,1.09,1.03,1.06,214,251,178,35,21,14,32,19,13,11,4,7,0,-1,+1,69%,71%,67%,141,160,120,34%,37%,31%,6,3,3,6,4,2
16,https://vlr.gg/player/25025/estrella,2024-07-12 04:00:00,1.00,1.02,1.01,165,157,179,25,12,13,29,16,13,21,13,8,-2,-1,-1,67%,67%,67%,105,103,107,29%,20%,43%,2,1,1,4,2,2
17,https://vlr.gg/player/4871/xffero,2024-07-12 04:00:00,0.95,0.93,0.94,186,191,184,28,15,13,33,18,15,13,8,5,-3,-3,0,71%,71%,71%,121,128,112,40%,40%,39%,1,0,1,4,3,1
18,https://vlr.gg/player/8497/monyet,2024-07-12 04:00:00,0.84,0.87,0.86,181,181,188,27,14,13,35,19,16,16,10,6,-6,-5,-1,64%,67%,62%,122,115,130,21%,16%,28%,3,1,2,9,6,3
19,https://vlr.gg/player/7764/lmemore,2024-07-12 04:00:00,0.84,0.85,0.84,166,161,164,24,12,12,30,18,12,10,6,4,-2,0,-2,58%,50%,67%,102,102,102,33%,29%,38%,4,2,2,6,2,4
20,https://vlr.gg/player/17433/v1c,2024-07-11 18:00:00,1.29,1.42,1.35,260,262,263,48,22,26,34,18,16,24,10,14,-1,-3,+2,80%,76%,85%,171,174,168,27%,26%,28%,5,1,4,6,4,2
21,https://vlr.gg/player/5132/mada,2024-07-11 18:00:00,0.68,1.72,1.21,250,165,328,42,13,29,38,20,18,16,7,9,+8,+3,+5,84%,88%,81%,153,97,207,25%,12%,32%,12,6,6,4,3,1
22,https://vlr.gg/player/2172/brawk,2024-07-11 18:00:00,0.77,1.08,0.93,184,178,192,29,13,16,37,21,16,19,10,9,-1,0,-1,69%,68%,69%,131,136,125,14%,22%,6%,1,0,1,2,0,2
23,https://vlr.gg/player/3685/flyuh,2024-07-11 18:00:00,1.09,0.75,0.92,163,200,132,31,19,12,35,17,18,27,12,15,-1,0,-1,80%,84%,77%,99,117,82,17%,24%,9%,4,2,2,5,2,3
24,https://vlr.gg/player/1851/oderus,2024-07-11 18:00:00,1.17,0.50,0.83,151,181,122,29,18,11,36,14,22,12,5,7,-6,-3,-3,63%,72%,54%,99,115,84,35%,38%,31%,3,2,1,9,5,4
25,https://vlr.gg/player/864/bcj,2024-07-11 18:00:00,1.14,1.25,1.19,227,207,242,34,16,18,32,16,16,24,12,12,-3,-1,-2,75%,69%,80%,163,156,171,17%,16%,18%,3,2,1,6,3,3
26,https://vlr.gg/player/6582/net,2024-07-11 18:00:00,0.94,1.07,1.00,190,200,174,35,19,16,34,19,15,8,0,8,+1,+3,-2,59%,50%,68%,130,132,127,35%,41%,30%,4,3,1,3,0,3
27,https://vlr.gg/player/8082/zander,2024-07-11 18:00:00,0.90,0.92,0.91,203,210,204,37,19,18,37,20,17,18,11,7,-4,-3,-1,69%,77%,60%,141,142,140,33%,40%,27%,4,2,2,8,5,3
28,https://vlr.gg/player/3722/koalanoob,2024-07-11 18:00:00,0.85,0.95,0.90,210,220,204,40,20,20,38,20,18,9,7,2,+5,0,+5,76%,77%,76%,133,136,129,19%,21%,16%,9,4,5,4,4,0
29,https://vlr.gg/player/4828/nismo,2024-07-11 18:00:00,0.77,0.91,0.84,175,153,207,34,16,18,38,19,19,17,9,8,+2,-1,+3,67%,62%,72%,109,104,114,41%,42%,41%,6,1,5,4,2,2
30,https://vlr.gg/player/1023/xxif,2024-07-11 17:40:00,1.26,2.01,1.58,325,269,387,47,21,26,28,19,9,23,17,6,+7,+2,+5,86%,83%,89%,204,173,245,27%,27%,26%,7,2,5,0,0,0
31,https://vlr.gg/player/754/nerve,2024-07-11 17:40:00,1.26,0.88,1.10,172,198,124,24,16,8,24,14,10,23,16,7,-1,-1,0,76%,79%,72%,112,129,90,32%,28%,43%,1,1,0,2,2,0
32,https://vlr.gg/player/13831/zeldris,2024-07-11 17:40:00,0.77,1.45,1.06,233,219,256,34,18,16,29,19,10,9,4,5,+4,+1,+3,71%,67%,78%,145,134,160,14%,17%,12%,11,7,4,7,6,1
33,https://vlr.gg/player/3007/tdawgg,2024-07-11 17:40:00,1.07,0.96,1.02,194,208,168,32,20,12,28,18,10,6,5,1,+1,-1,+2,71%,67%,78%,119,125,110,32%,30%,34%,3,0,3,2,1,1
34,https://vlr.gg/player/21878/snarly,2024-07-11 17:40:00,0.96,0.94,0.96,139,149,135,21,12,9,25,15,10,20,11,9,-3,-3,0,71%,67%,78%,91,92,89,41%,39%,44%,3,1,2,6,4,2
35,https://vlr.gg/player/3227/screwface,2024-07-11 17:40:00,0.43,1.79,1.21,215,92,302,34,6,28,29,15,14,8,2,6,+1,-4,+5,76%,67%,83%,135,53,196,29%,20%,31%,6,1,5,5,5,0
36,https://vlr.gg/player/765/jerk,2024-07-11 17:40:00,1.04,0.81,0.91,192,204,185,28,14,14,28,12,16,12,3,9,-1,0,-1,79%,83%,75%,114,119,111,12%,17%,7%,2,0,2,3,0,3
37,https://vlr.gg/player/9063/infiltrator,2024-07-11 17:40:00,0.88,0.90,0.89,230,240,227,30,13,17,35,15,20,12,6,6,-1,0,-1,64%,72%,58%,151,161,144,29%,31%,27%,7,3,4,8,3,5
38,https://vlr.gg/player/2118/silenx,2024-07-11 17:40:00,0.78,0.69,0.73,150,161,142,21,10,11,32,15,17,16,9,7,-5,-5,0,64%,56%,71%,95,94,95,30%,53%,18%,2,0,2,7,5,2
39,https://vlr.gg/player/17865/nahsie,2024-07-11 17:40:00,0.57,0.61,0.60,147,104,180,21,6,15,34,14,20,17,5,12,-2,-1,-1,67%,67%,67%,89,64,108,13%,13%,13%,0,0,0,2,1,1
40,https://vlr.gg/player/8422/spaz,2024-07-11 16:00:00,1.77,1.50,1.64,223,220,217,30,17,13,10,3,7,12,7,5,0,0,0,83%,100%,63%,149,147,151,27%,20%,37%,3,1,2,3,1,2
41,https://vlr.gg/player/3874/teague,2024-07-11 16:00:00,1.87,0.90,1.42,224,285,134,29,22,7,17,7,10,32,17,15,-1,-1,0,86%,100%,69%,131,176,78,29%,33%,23%,0,0,0,1,1,0
42,https://vlr.gg/player/29688/mikee,2024-07-11 16:00:00,1.41,1.40,1.41,278,289,274,35,20,15,23,13,10,5,2,3,+9,+6,+3,83%,89%,75%,181,182,180,37%,36%,39%,10,6,4,1,0,1
43,https://vlr.gg/player/4385/monsi,2024-07-11 16:00:00,1.18,1.18,1.18,202,227,185,28,16,12,20,11,9,14,6,8,+2,+3,-1,86%,84%,88%,127,148,103,23%,35%,12%,4,4,0,2,1,1
44,https://vlr.gg/player/8373/okeanos,2024-07-11 16:00:00,0.96,0.58,0.78,201,214,181,25,15,10,25,12,13,7,5,2,+3,+1,+2,74%,74%,75%,129,147,107,30%,33%,24%,7,3,4,4,2,2
45,https://vlr.gg/player/468/zachareee,2024-07-11 16:00:00,1.08,0.74,0.90,199,226,180,21,11,10,28,11,17,11,6,5,-2,-1,-1,71%,69%,74%,145,162,131,29%,32%,26%,2,1,1,4,2,2
46,https://vlr.gg/player/766/ange,2024-07-11 16:00:00,1.02,0.63,0.81,186,198,176,20,10,10,29,11,18,14,9,5,-4,-1,-3,60%,75%,47%,117,127,110,24%,32%,19%,3,1,2,7,2,5
47,https://vlr.gg/player/71/drone,2024-07-11 16:00:00,0.98,0.58,0.76,150,165,139,20,10,10,29,11,18,6,4,2,0,+1,-1,69%,88%,53%,100,98,101,48%,45%,50%,1,1,0,1,0,1
48,https://vlr.gg/player/8118/precision,2024-07-11 16:00:00,0.74,0.59,0.65,157,141,163,19,10,9,31,12,19,6,2,4,0,-1,+1,60%,69%,53%,90,75,102,31%,23%,38%,2,0,2,2,1,1
49,https://vlr.gg/player/3012/riku,2024-07-11 16:00:00,0.70,0.26,0.46,128,150,113,15,8,7,30,12,18,3,3,0,-7,-2,-5,51%,69%,37%,85,95,77,27%,35%,21%,3,3,0,10,5,5
50,https://vlr.gg/player/3450/woddy,2024-07-11 16:00:00,0.49,1.75,1.07,195,137,273,49,16,33,43,32,11,7,3,4,+1,0,+1,66%,49%,87%,125,85,172,33%,24%,37%,4,3,1,3,3,0
51,https://vlr.gg/player/1607/ntk,2024-07-11 16:00:00,0.71,0.88,0.79,181,172,192,36,18,18,53,32,21,21,9,12,-3,-5,+2,65%,57%,73%,119,113,126,18%,20%,17%,5,1,4,8,6,2
52,https://vlr.gg/player/32717/maestr0,2024-07-11 16:00:00,0.52,1.09,0.78,168,126,220,37,14,23,55,32,23,25,9,16,-1,-3,+2,66%,51%,83%,113,98,131,23%,26%,21%,2,0,2,3,3,0
53,https://vlr.gg/player/32718/kenkayyy,2024-07-11 16:00:00,0.59,0.98,0.77,175,152,201,42,20,22,52,31,21,10,5,5,+4,-3,+7,54%,46%,63%,111,89,135,25%,19%,31%,10,1,9,6,4,2
54,https://vlr.gg/player/22964/forbanz,2024-07-11 16:00:00,0.52,0.93,0.71,177,152,205,36,15,21,55,33,22,12,5,7,-10,-10,0,58%,49%,70%,124,111,140,19%,16%,23%,7,2,5,17,12,5
55,https://vlr.gg/player/20240/xenom,2024-07-11 16:00:00,1.56,1.44,1.50,272,302,236,67,35,32,37,21,16,20,11,9,+2,0,+2,78%,70%,86%,165,181,151,37%,36%,38%,7,2,5,5,2,3
56,https://vlr.gg/player/3424/siduzord,2024-07-11 16:00:00,0.91,1.42,1.18,215,208,223,50,20,30,38,24,14,31,15,16,-2,-3,+1,83%,70%,94%,140,139,141,20%,24%,16%,2,0,2,4,3,1
57,https://vlr.gg/player/13823/pxs,2024-07-11 16:00:00,0.74,1.53,1.16,244,191,293,55,20,35,46,26,20,18,5,13,+5,-6,+11,75%,60%,89%,157,125,185,30%,35%,27%,17,4,13,12,10,2
58,https://vlr.gg/player/6202/guuih,2024-07-11 16:00:00,0.64,1.54,1.12,190,130,241,44,11,33,37,23,14,24,12,12,+4,-1,+5,83%,73%,91%,122,84,155,20%,15%,23%,6,1,5,2,2,0
59,https://vlr.gg/player/23010/nicksz,2024-07-11 16:00:00,0.72,1.27,1.02,181,129,231,42,12,30,42,23,19,37,17,20,0,-2,+2,72%,60%,83%,120,85,150,25%,31%,22%,5,2,3,5,4,1
60,https://vlr.gg/player/2168/trexx,2024-07-11 15:10:00,1.26,1.27,1.27,232,194,266,48,21,27,43,16,27,32,11,21,+2,+5,-3,78%,83%,74%,154,124,179,20%,20%,20%,9,5,4,7,0,7
61,https://vlr.gg/player/312/sayf,2024-07-11 15:10:00,1.20,1.22,1.21,230,272,201,57,29,28,40,22,18,5,3,2,+4,+2,+2,72%,70%,74%,142,161,126,21%,23%,17%,7,5,2,3,3,0
62,https://vlr.gg/player/11134/kicks,2024-07-11 15:10:00,0.97,1.34,1.17,214,161,252,48,16,32,44,21,23,33,18,15,+1,0,+1,85%,83%,86%,134,102,162,22%,22%,22%,6,2,4,5,2,3
63,https://vlr.gg/player/4321/cender,2024-07-11 15:10:00,1.00,0.88,0.94,173,197,154,42,22,20,45,21,24,19,7,12,-5,-5,0,68%,70%,66%,115,131,101,28%,25%,32%,7,2,5,12,7,5
64,https://vlr.gg/player/21610/runner,2024-07-11 15:10:00,0.67,0.98,0.84,163,127,173,34,13,21,46,22,24,16,5,11,-1,-2,+1,72%,73%,71%,99,81,114,24%,21%,26%,4,1,3,5,3,2
65,https://vlr.gg/player/36245/n4rrate,2024-07-11 15:10:00,1.41,0.96,1.20,244,284,197,55,37,18,43,22,21,23,9,14,+5,+4,+1,77%,77%,77%,156,171,138,18%,19%,15%,14,9,5,9,5,4
66,https://vlr.gg/player/10307/marteen,2024-07-11 15:10:00,0.95,0.94,0.95,189,191,196,46,24,22,47,27,20,12,8,4,0,+1,-1,77%,80%,73%,134,131,138,29%,31%,27%,4,3,1,4,2,2
67,https://vlr.gg/player/2173/magnum,2024-07-11 15:10:00,0.65,1.17,0.89,178,148,219,39,17,22,45,26,19,25,13,12,-5,-5,0,72%,71%,73%,120,101,143,26%,23%,28%,4,0,4,9,5,4
68,https://vlr.gg/player/2625/sh1n,2024-07-11 15:10:00,0.97,0.79,0.89,184,206,165,43,25,18,49,26,23,25,13,12,-1,-1,0,72%,74%,70%,119,141,94,26%,27%,25%,5,2,3,6,3,3
69,https://vlr.gg/player/19691/tomaszy,2024-07-11 15:10:00,0.49,1.00,0.72,149,122,180,35,13,22,45,27,18,13,7,6,0,0,0,63%,60%,67%,99,84,117,30%,23%,39%,5,3,2,5,3,2
70,https://vlr.gg/player/2858/suygetsu,2024-07-11 12:00:00,1.40,0.92,1.16,215,230,204,54,30,24,44,18,26,14,7,7,+1,+1,0,75%,81%,70%,145,149,142,30%,29%,31%,6,2,4,5,1,4
71,https://vlr.gg/player/98/ardiis,2024-07-11 12:00:00,1.23,1.09,1.16,222,250,195,55,30,25,45,21,24,24,15,9,+9,+6,+3,75%,81%,70%,141,154,128,23%,28%,19%,10,7,3,1,1,0
72,https://vlr.gg/player/109/ange1,2024-07-11 12:00:00,0.99,1.08,1.04,196,181,211,46,21,25,44,19,25,22,13,9,+2,+1,+1,83%,81%,85%,125,120,130,29%,23%,38%,10,5,5,8,4,4
73,https://vlr.gg/player/384/shao,2024-07-11 12:00:00,0.77,0.96,0.86,167,135,197,36,15,21,48,23,25,21,15,6,+4,+2,+2,69%,78%,61%,124,103,144,34%,30%,37%,5,3,2,1,1,0
74,https://vlr.gg/player/11/zyppan,2024-07-11 12:00:00,0.76,0.76,0.76,189,199,177,40,22,18,53,26,27,17,6,11,-9,-4,-5,74%,72%,76%,130,141,119,22%,24%,19%,5,2,3,14,6,8
75,https://vlr.gg/player/20871/k4davra,2024-07-11 12:00:00,1.61,1.01,1.31,240,298,178,60,39,21,40,20,20,21,11,10,+1,+2,-1,72%,76%,69%,144,176,110,33%,34%,30%,5,2,3,4,0,4
76,https://vlr.gg/player/5004/natank,2024-07-11 12:00:00,1.18,1.07,1.13,246,249,240,54,31,23,49,24,25,23,8,15,-1,+2,-3,78%,76%,81%,157,151,164,22%,26%,20%,8,6,2,9,4,5
77,https://vlr.gg/player/19522/wailers,2024-07-11 12:00:00,0.91,1.20,1.05,202,175,226,47,21,26,43,21,22,13,8,5,+3,+1,+2,71%,73%,69%,131,103,161,38%,31%,43%,6,3,3,3,2,1
78,https://vlr.gg/player/220/beyaz,2024-07-11 12:00:00,0.66,0.99,0.82,166,126,210,35,12,23,47,22,25,27,11,16,-3,-2,-1,72%,70%,75%,107,89,126,20%,14%,26%,1,1,0,4,3,1
79,https://vlr.gg/player/301/takas,2024-07-11 12:00:00,0.81,0.62,0.71,177,213,143,38,24,14,52,26,26,13,7,6,-7,-4,-3,60%,58%,63%,123,147,98,28%,26%,30%,9,4,5,16,8,8
80,https://vlr.gg/player/45876/fixy,2024-07-11 10:35:00,0.98,1.48,1.23,267,221,332,54,21,33,41,22,19,10,4,6,-2,-4,+2,70%,59%,82%,180,145,216,21%,24%,19%,8,3,5,10,7,3
81,https://vlr.gg/player/7513/markl,2024-07-11 10:35:00,1.24,1.11,1.17,238,256,204,46,26,20,40,23,17,15,5,10,0,+1,-1,74%,66%,82%,157,174,139,27%,29%,24%,7,4,3,7,3,4
82,https://vlr.gg/player/3480/thedoctorr,2024-07-11 10:35:00,0.80,1.29,1.04,222,182,256,44,18,26,43,24,19,13,6,7,+4,-2,+6,74%,72%,75%,148,118,180,36%,30%,41%,8,1,7,4,3,1
83,https://vlr.gg/player/21051/jans0n,2024-07-11 10:35:00,0.66,1.38,1.01,199,165,239,39,14,25,37,22,15,21,11,10,-2,-4,+2,72%,55%,89%,136,121,151,40%,35%,46%,4,1,3,6,5,1
84,https://vlr.gg/player/2378/subbey,2024-07-11 10:35:00,0.81,0.79,0.80,149,140,151,30,15,15,40,22,18,15,7,8,-1,0,-1,72%,62%,82%,105,104,107,21%,23%,19%,1,1,0,2,1,1
85,https://vlr.gg/player/16942/reverie,2024-07-11 10:35:00,0.99,1.24,1.12,215,212,228,42,19,23,40,23,17,14,6,8,+1,0,+1,68%,68%,69%,144,140,147,26%,25%,27%,4,1,3,3,1,2
86,https://vlr.gg/player/7007/shinsei,2024-07-11 10:35:00,0.66,1.42,1.05,248,178,323,53,19,34,45,25,20,2,0,2,-2,-6,+4,56%,43%,69%,165,122,207,41%,58%,33%,16,6,10,18,12,6
87,https://vlr.gg/player/27073/esmonde,2024-07-11 10:35:00,0.86,1.11,0.99,180,191,175,36,17,19,40,24,16,20,10,10,+1,0,+1,72%,68%,76%,126,124,128,17%,13%,22%,2,1,1,1,1,0
88,https://vlr.gg/player/19126/kayle,2024-07-11 10:35:00,0.58,1.07,0.83,198,140,231,36,14,22,44,24,20,14,6,8,+2,-2,+4,70%,57%,83%,127,105,149,22%,28%,18%,5,1,4,3,3,0
89,https://vlr.gg/player/3477/evo,2024-07-11 10:35:00,0.95,0.68,0.81,183,200,154,34,19,15,44,23,21,15,6,9,-1,0,-1,63%,61%,66%,125,143,108,25%,24%,27%,2,1,1,3,1,2
90,https://vlr.gg/player/24679/cgrs,2024-07-11 10:15:00,1.11,1.57,1.33,246,192,302,63,26,37,42,21,21,17,7,10,+1,+1,0,77%,73%,82%,155,126,187,24%,22%,26%,5,1,4,4,0,4
91,https://vlr.gg/player/27244/seph1roth,2024-07-11 10:15:00,1.13,1.48,1.30,250,223,275,63,30,33,46,25,21,10,3,7,+10,+2,+8,75%,65%,85%,160,153,169,39%,41%,37%,13,4,9,3,2,1
92,https://vlr.gg/player/14674/kntz,2024-07-11 10:15:00,1.15,0.73,0.95,164,176,152,43,24,19,48,22,26,27,11,16,-2,0,-2,77%,78%,76%,110,117,102,35%,35%,36%,3,1,2,5,1,4
93,https://vlr.gg/player/13784/killua,2024-07-11 10:15:00,0.79,1.05,0.91,185,177,198,50,23,27,52,28,24,12,7,5,0,0,0,73%,73%,74%,126,114,138,33%,30%,37%,6,4,2,6,4,2
94,https://vlr.gg/player/12098/kadoom,2024-07-11 10:15:00,0.78,1.03,0.90,214,220,211,52,31,21,55,31,24,11,3,8,-4,-2,-2,68%,59%,76%,144,137,153,25%,31%,21%,11,9,2,15,11,4
95,https://vlr.gg/player/12289/siraww,2024-07-11 10:15:00,1.16,0.91,1.03,205,231,189,55,30,25,53,25,28,16,7,9,+1,-1,+2,75%,79%,70%,135,157,115,38%,40%,35%,5,1,4,4,2,2
96,https://vlr.gg/player/23930/potter,2024-07-11 10:15:00,0.49,1.44,0.98,234,170,295,57,19,38,56,31,25,16,7,9,-1,-3,+2,72%,59%,84%,157,117,194,24%,21%,25%,14,6,8,15,9,6
97,https://vlr.gg/player/10791/bnwgiggs,2024-07-11 10:15:00,0.87,0.97,0.93,214,209,219,52,24,28,57,28,29,30,15,15,0,+1,-1,73%,65%,81%,130,124,135,19%,13%,26%,5,3,2,5,2,3
98,https://vlr.gg/player/2366/alert,2024-07-11 10:15:00,0.80,0.91,0.85,190,201,181,44,22,22,52,26,26,16,4,12,-3,-2,-1,72%,74%,70%,125,129,122,26%,39%,19%,5,2,3,8,4,4
99,https://vlr.gg/player/2368/b3ta,2024-07-11 10:15:00,0.73,0.65,0.69,137,165,118,34,20,14,54,29,25,21,8,13,-2,+1,-3,66%,62%,70%,97,114,81,25%,32%,18%,4,3,1,6,2,4
100,https://vlr.gg/player/46134/denz,2024-07-11 07:00:00,1.30,1.24,1.27,257,264,249,44,23,21,34,15,19,6,3,3,0,-1,+1,56%,58%,54%,178,166,189,29%,31%,28%,6,4,2,6,5,1
101,https://vlr.gg/player/44294/eur,2024-07-11 07:00:00,1.12,0.91,1.01,183,195,171,31,17,14,32,15,17,26,13,13,+5,+1,+4,67%,67%,67%,119,117,121,30%,22%,40%,7,3,4,2,2,0
102,https://vlr.gg/player/46135/zeus,2024-07-11 07:00:00,1.11,0.78,0.95,227,226,230,36,20,16,38,15,23,12,5,7,-4,-2,-2,65%,75%,54%,160,155,164,24%,24%,24%,4,0,4,8,2,6
103,https://vlr.gg/player/36013/hydrakid,2024-07-11 07:00:00,1.13,0.66,0.89,170,210,131,28,17,11,35,16,19,11,8,3,+2,+1,+1,65%,71%,58%,115,141,89,30%,25%,40%,6,3,3,4,2,2
104,https://vlr.gg/player/11541/xty,2024-07-11 07:00:00,0.85,0.34,0.60,149,212,87,25,19,6,40,18,22,12,7,5,-1,-1,0,58%,71%,46%,106,148,65,25%,36%,9%,2,1,1,3,2,1
105,https://vlr.gg/player/13220/ja,2024-07-11 07:00:00,1.38,1.35,1.36,315,306,325,52,27,25,36,15,21,12,4,8,-2,-6,+4,77%,75%,79%,209,214,204,25%,30%,20%,8,0,8,10,6,4
106,https://vlr.gg/player/7749/nexi,2024-07-11 07:00:00,1.65,0.59,1.12,228,299,158,39,28,11,33,12,21,15,9,6,+2,+2,0,77%,88%,67%,150,200,101,30%,31%,28%,4,3,1,2,1,1
107,https://vlr.gg/player/13219/papi,2024-07-11 07:00:00,1.18,1.00,1.09,183,195,172,31,15,16,32,13,19,26,15,11,0,0,0,88%,96%,79%,116,130,102,36%,29%,47%,0,0,0,0,0,0
108,https://vlr.gg/player/9747/emman,2024-07-11 07:00:00,1.15,0.92,1.04,180,182,178,34,18,16,29,12,17,6,4,2,+3,+3,0,69%,75%,63%,124,129,119,34%,38%,29%,8,4,4,5,1,4
109,https://vlr.gg/player/16842/mojer,2024-07-11 07:00:00,0.71,0.67,0.69,148,155,142,23,12,11,34,16,18,4,1,3,-5,-3,-2,65%,71%,58%,97,95,99,17%,21%,14%,3,3,0,8,6,2
110,https://vlr.gg/player/37673/yanli,2024-07-11 07:00:00,1.14,1.26,1.19,225,214,249,69,37,32,55,33,22,30,14,16,+4,+2,+2,76%,73%,81%,149,136,165,35%,39%,31%,8,4,4,4,2,2
111,https://vlr.gg/player/42932/ngk,2024-07-11 07:00:00,0.93,1.17,1.03,187,171,205,29,13,16,28,16,12,17,13,4,+1,-2,+3,73%,67%,80%,121,119,124,23%,22%,25%,5,1,4,4,3,1
112,https://vlr.gg/player/24305/xyus,2024-07-11 07:00:00,0.95,1.09,1.01,247,247,245,72,39,33,68,42,26,11,6,5,+7,+3,+4,67%,73%,59%,157,158,156,22%,29%,16%,22,14,8,15,11,4
113,https://vlr.gg/player/7861/w1nner,2024-07-11 07:00:00,0.64,1.17,0.87,172,145,213,53,25,28,57,37,20,20,9,11,0,-4,+4,68%,58%,81%,111,94,133,26%,33%,21%,8,3,5,8,7,1
114,https://vlr.gg/player/24301/kino,2024-07-11 07:00:00,0.97,0.62,0.81,133,150,114,11,7,4,15,8,7,6,4,2,-1,-1,0,68%,75%,60%,88,98,76,35%,33%,36%,1,0,1,2,1,1
115,https://vlr.gg/player/1906/ra1ny,2024-07-11 07:00:00,0.76,0.85,0.80,138,125,150,41,21,20,58,34,24,26,13,13,+1,-1,+2,68%,65%,73%,92,90,95,23%,21%,24%,3,0,3,2,1,1
116,https://vlr.gg/player/10870/secret,2024-07-11 07:00:00,0.43,0.82,0.57,144,138,157,9,5,4,17,12,5,6,5,1,-1,-1,0,63%,58%,71%,93,92,94,24%,22%,25%,1,0,1,2,1,1
117,https://vlr.gg/player/24304/kiuuuu,2024-07-11 07:00:00,1.04,1.27,1.17,225,215,238,70,27,43,62,30,32,35,14,21,+3,-1,+4,69%,68%,71%,145,142,148,37%,36%,38%,8,2,6,5,3,2
118,https://vlr.gg/player/12365/coconut,2024-07-11 07:00:00,1.13,1.17,1.15,224,221,227,65,29,36,55,25,30,24,3,21,-6,-5,-1,68%,54%,79%,147,143,151,31%,37%,27%,6,1,5,12,6,6
119,https://vlr.gg/player/37421/riyabtw,2024-07-11 07:00:00,0.64,1.52,1.14,237,160,295,73,20,53,59,31,28,16,7,9,-7,-7,0,71%,59%,79%,149,104,184,26%,25%,27%,8,2,6,15,9,6
120,https://vlr.gg/player/24302/chimei,2024-07-11 07:00:00,0.84,0.98,0.92,159,136,177,45,16,29,55,24,31,33,16,17,0,-2,+2,73%,76%,71%,101,78,120,17%,16%,17%,4,0,4,4,2,2
121,https://vlr.gg/player/7851/uta,2024-07-11 07:00:00,1.00,0.82,0.90,152,191,123,45,24,21,53,27,26,25,12,13,-1,0,-1,72%,70%,73%,99,128,77,33%,31%,36%,11,6,5,12,6,6
122,https://vlr.gg/player/2381/divine,2024-07-11 07:00:00,1.10,1.06,1.08,191,178,210,46,21,25,40,19,21,17,9,8,-2,-2,0,69%,59%,78%,127,122,132,35%,38%,33%,4,1,3,6,3,3
123,https://vlr.gg/player/24654/tempz,2024-07-11 07:00:00,0.92,1.22,1.07,177,154,201,42,18,24,37,20,17,21,10,11,-2,-1,-1,77%,69%,84%,117,96,138,28%,26%,29%,6,3,3,8,4,4
124,https://vlr.gg/player/8137/lenne,2024-07-11 07:00:00,0.96,1.09,1.02,196,186,212,43,20,23,44,24,20,19,11,8,0,0,0,67%,63%,72%,144,134,153,23%,29%,18%,5,3,2,5,3,2
125,https://vlr.gg/player/9158/hyk,2024-07-11 07:00:00,0.82,1.11,0.97,189,170,210,43,19,24,49,26,23,23,10,13,+3,-1,+4,69%,59%,78%,126,112,140,21%,24%,20%,5,0,5,2,1,1
126,https://vlr.gg/player/11737/xan,2024-07-11 07:00:00,0.87,0.92,0.90,214,212,220,45,24,21,51,25,26,18,5,13,-3,-6,+3,72%,63%,81%,145,137,152,22%,25%,19%,10,4,6,13,10,3
127,https://vlr.gg/player/36685/splash,2024-07-11 07:00:00,1.12,1.23,1.18,263,258,267,57,27,30,46,26,20,18,13,5,+3,-1,+4,80%,78%,81%,169,172,165,20%,23%,17%,12,6,6,9,7,2
128,https://vlr.gg/player/44919/aplycs,2024-07-11 07:00:00,0.94,1.19,1.07,205,174,236,42,19,23,45,24,21,36,21,15,+1,-1,+2,77%,75%,78%,135,104,166,25%,26%,24%,6,1,5,5,2,3
129,https://vlr.gg/player/2377/aduka,2024-07-11 07:00:00,0.73,1.36,1.04,200,140,261,48,17,31,42,24,18,22,12,10,-1,-4,+3,77%,69%,84%,126,95,156,20%,21%,19%,7,2,5,8,6,2
130,https://vlr.gg/player/36704/impecunity,2024-07-11 07:00:00,0.74,1.10,0.92,161,139,183,40,17,23,41,22,19,10,5,5,-2,-2,0,64%,59%,69%,116,103,128,24%,23%,24%,3,0,3,5,2,3
131,https://vlr.gg/player/8156/mojo,2024-07-11 07:00:00,1.24,0.40,0.82,158,233,84,34,27,7,45,21,24,31,20,11,+3,+2,+1,73%,81%,66%,97,137,57,18%,22%,9%,6,4,2,3,2,1
132,https://vlr.gg/player/19150/niffy,2024-07-11 07:00:00,0.87,1.73,1.31,276,216,335,61,23,38,46,27,19,7,6,1,-4,-10,+6,70%,58%,81%,182,148,215,27%,19%,33%,10,2,8,14,12,2
133,https://vlr.gg/player/6733/xze,2024-07-11 07:00:00,1.07,0.84,0.95,190,205,179,44,24,20,47,23,24,18,9,9,+1,+1,0,70%,74%,66%,124,125,122,43%,50%,37%,6,3,3,5,2,3
134,https://vlr.gg/player/1910/acetics,2024-07-11 07:00:00,0.62,0.88,0.75,181,153,208,39,17,22,51,27,24,9,5,4,+1,0,+1,65%,61%,69%,112,93,130,40%,43%,38%,5,1,4,4,1,3
135,https://vlr.gg/player/23918/reality,2024-07-11 07:00:00,0.66,0.80,0.73,173,173,175,36,17,19,51,27,24,18,11,7,-3,-2,-1,63%,65%,63%,114,113,115,21%,26%,16%,3,2,1,6,4,2
136,https://vlr.gg/player/2390/pinocchios,2024-07-11 07:00:00,0.64,0.70,0.67,131,151,113,28,16,12,48,25,23,23,9,14,-6,-4,-2,67%,68%,66%,87,95,79,19%,13%,29%,2,0,2,8,4,4
137,https://vlr.gg/player/27254/leviathan,2024-07-11 07:00:00,1.67,1.15,1.41,274,328,215,61,39,22,39,21,18,33,15,18,+4,+1,+3,81%,75%,87%,173,212,132,35%,39%,29%,8,3,5,4,2,2
138,https://vlr.gg/player/3401/ptc,2024-07-11 07:00:00,1.25,1.40,1.33,239,230,252,56,27,29,36,19,17,33,17,16,+1,-2,+3,81%,75%,87%,149,141,158,33%,33%,33%,5,1,4,4,3,1
139,https://vlr.gg/player/4377/johnolsen,2024-07-11 07:00:00,0.83,1.27,1.05,239,211,271,54,23,31,50,27,23,12,6,6,+6,+2,+4,73%,66%,81%,156,128,185,30%,26%,32%,12,7,5,6,5,1
140,https://vlr.gg/player/3342/sushiboys,2024-07-11 07:00:00,0.75,1.34,1.04,176,126,222,36,11,25,38,21,17,25,14,11,-2,-3,+1,71%,72%,71%,116,87,147,23%,16%,27%,5,2,3,7,5,2
141,https://vlr.gg/player/6723/foxz,2024-07-11 07:00:00,0.60,1.02,0.81,170,121,224,36,14,22,46,24,22,20,8,12,+2,-2,+4,65%,59%,71%,121,89,155,22%,16%,27%,7,1,6,5,3,2
142,https://vlr.gg/player/1916/free1ng,2024-07-11 06:00:00,1.27,1.49,1.40,264,272,257,41,18,23,23,12,11,2,1,1,+3,+3,0,79%,78%,79%,172,175,170,37%,38%,36%,5,4,1,2,1,1
143,https://vlr.gg/player/17049/hermes,2024-07-11 06:00:00,0.80,1.56,1.23,230,196,253,29,11,18,24,14,10,38,12,26,-1,-1,0,83%,89%,79%,145,120,164,16%,6%,23%,1,0,1,2,1,1
144,https://vlr.gg/player/482/intro,2024-07-11 06:00:00,1.10,1.14,1.12,183,168,192,27,11,16,22,9,13,22,5,17,0,-1,+1,76%,67%,83%,115,104,123,26%,27%,26%,3,1,2,3,2,1
145,https://vlr.gg/player/9221/kanade,2024-07-11 06:00:00,1.04,1.17,1.11,226,198,242,31,13,18,29,13,16,10,3,7,+3,-3,+6,79%,78%,79%,153,128,172,29%,35%,26%,10,2,8,7,5,2
146,https://vlr.gg/player/476/exy,2024-07-11 06:00:00,1.44,0.83,1.09,205,229,194,32,16,16,25,8,17,12,4,8,-1,+2,-3,69%,83%,58%,140,154,130,45%,52%,39%,4,2,2,5,0,5
147,https://vlr.gg/player/4657/moves,2024-07-11 06:00:00,1.05,1.07,1.06,240,237,253,33,18,15,35,21,14,15,11,4,0,+1,-1,67%,67%,67%,160,153,170,25%,23%,27%,5,3,2,5,2,3
148,https://vlr.gg/player/13000/redlight,2024-07-11 06:00:00,1.30,0.81,1.06,227,259,193,17,10,7,17,8,9,5,2,3,+2,0,+2,52%,67%,36%,157,187,125,35%,41%,26%,4,2,2,2,2,0
149,https://vlr.gg/player/9192/cloudy,2024-07-11 06:00:00,0.79,0.99,0.86,142,109,199,10,5,5,14,9,5,5,3,2,0,-1,+1,58%,42%,86%,92,82,109,40%,38%,42%,1,0,1,1,1,0
150,https://vlr.gg/player/37535/jaebin,2024-07-11 06:00:00,0.65,1.01,0.81,164,134,203,25,12,13,32,18,14,4,1,3,-2,-1,-1,52%,50%,56%,97,79,122,11%,11%,11%,5,3,2,7,4,3
151,https://vlr.gg/player/4475/benecia,2024-07-11 06:00:00,0.93,0.58,0.78,147,159,132,20,14,6,32,17,15,13,4,9,+1,+1,0,55%,54%,56%,89,93,83,31%,34%,26%,3,2,1,2,1,1
152,https://vlr.gg/player/20879/sungjin,2024-07-11 06:00:00,0.49,0.80,0.62,133,111,159,18,8,10,30,18,12,9,7,2,-5,-4,-1,57%,46%,72%,87,73,106,29%,16%,44%,1,0,1,6,4,2
153,https://vlr.gg/player/19938/twirly,2024-07-11 05:30:00,1.19,1.17,1.18,243,234,249,56,25,31,43,18,25,11,1,10,-3,-2,-1,72%,69%,75%,170,165,173,29%,30%,29%,5,3,2,8,5,3
154,https://vlr.gg/player/16642/casper,2024-07-11 05:30:00,1.00,1.30,1.16,200,187,219,49,19,30,43,23,20,34,22,12,+3,+1,+2,83%,86%,81%,133,121,142,32%,29%,34%,7,3,4,4,2,2
155,https://vlr.gg/player/15712/lunah,2024-07-11 05:30:00,1.21,1.09,1.14,227,239,219,53,26,27,41,18,23,19,6,13,0,+1,-1,83%,83%,83%,149,153,147,28%,26%,31%,5,2,3,5,1,4
156,https://vlr.gg/player/19962/eluwu,2024-07-11 05:30:00,1.20,1.04,1.11,248,255,232,51,25,26,47,19,28,16,3,13,+6,-3,+9,80%,76%,83%,158,155,160,26%,30%,22%,17,4,13,11,7,4
157,https://vlr.gg/player/19492/amy,2024-07-11 05:30:00,0.85,1.09,0.99,173,160,184,39,14,25,40,19,21,28,16,12,-1,0,-1,77%,79%,75%,110,111,110,22%,26%,19%,1,1,0,2,1,1
158,https://vlr.gg/player/16644/muffinloop,2024-07-11 05:30:00,1.10,1.33,1.20,234,207,267,55,26,29,47,26,21,20,15,5,+3,+1,+2,69%,69%,69%,152,136,172,34%,30%,38%,7,3,4,4,2,2
159,https://vlr.gg/player/29484/rose,2024-07-11 05:30:00,1.26,0.83,1.07,202,251,137,42,30,12,45,25,20,29,16,13,0,0,0,74%,83%,62%,126,150,98,23%,23%,24%,1,1,0,1,1,0
160,https://vlr.gg/player/8506/meow16k,2024-07-11 05:30:00,0.75,1.05,0.88,229,211,258,51,25,26,56,33,23,9,4,5,-1,-3,+2,68%,64%,72%,146,136,159,13%,16%,10%,14,8,6,15,11,4
161,https://vlr.gg/player/19408/crescents,2024-07-11 05:30:00,0.79,0.93,0.85,171,171,168,38,20,18,48,27,21,29,18,11,-6,-4,-2,72%,67%,79%,113,115,110,22%,21%,23%,2,1,1,8,5,3
162,https://vlr.gg/player/17494/skyelyse,2024-07-11 05:30:00,0.64,0.56,0.60,129,131,130,28,16,12,52,28,24,21,7,14,-1,-2,+1,63%,56%,72%,88,91,85,12%,12%,11%,6,1,5,7,3,4
163,https://vlr.gg/player/2348/famouz,2024-07-11 05:10:00,1.75,1.25,1.51,362,396,315,50,30,20,29,15,14,7,2,5,+5,+2,+3,75%,71%,79%,219,248,187,17%,23%,8%,11,5,6,6,3,3
164,https://vlr.gg/player/4874/berserx,2024-07-11 05:10:00,1.09,1.05,1.07,187,174,200,26,13,13,23,12,11,9,5,4,0,+1,-1,75%,71%,79%,141,148,134,25%,22%,29%,1,1,0,1,0,1
165,https://vlr.gg/player/2380/zesbeew,2024-07-11 05:10:00,0.77,1.36,1.05,165,151,179,26,10,16,23,14,9,16,11,5,-2,-2,0,80%,76%,84%,105,90,121,23%,23%,24%,1,1,0,3,3,0
166,https://vlr.gg/player/7043/ncslasher,2024-07-11 05:10:00,1.05,0.99,1.02,183,182,182,27,15,12,26,14,12,16,8,8,+2,-2,+4,80%,76%,84%,110,108,111,39%,43%,36%,5,1,4,3,3,0
167,https://vlr.gg/player/10739/shiro,2024-07-11 05:10:00,0.89,1.02,0.95,223,194,264,32,15,17,33,19,14,19,13,6,-1,0,-1,83%,86%,79%,146,119,176,24%,38%,17%,4,2,2,5,2,3
168,https://vlr.gg/player/37057/woody,2024-07-11 05:10:00,1.32,1.06,1.19,226,265,199,33,18,15,31,15,16,24,8,16,+1,+2,-1,78%,79%,76%,142,158,128,34%,52%,23%,2,2,0,1,0,1
169,https://vlr.gg/player/9279/kylee,2024-07-11 05:10:00,0.85,0.99,0.92,192,148,236,26,10,16,33,14,19,10,3,7,+5,+2,+3,73%,63%,81%,124,96,148,37%,36%,37%,6,2,4,1,0,1
170,https://vlr.gg/player/34100/scar,2024-07-11 05:10:00,0.85,0.94,0.90,189,188,195,28,13,15,32,17,15,13,4,9,-4,-3,-1,75%,74%,76%,127,127,126,37%,44%,32%,2,0,2,6,3,3
171,https://vlr.gg/player/34096/faustao,2024-07-11 05:10:00,0.95,0.80,0.87,185,217,155,26,15,11,31,16,15,7,3,4,-2,-1,-1,58%,68%,48%,118,128,110,21%,28%,14%,5,3,2,7,4,3
172,https://vlr.gg/player/23717/nythan,2024-07-11 05:10:00,0.17,0.79,0.50,146,76,209,20,4,16,34,16,18,7,5,2,-4,-5,+1,63%,47%,76%,101,59,139,26%,26%,26%,3,0,3,7,5,2
173,https://vlr.gg/player/10089/andy,2024-07-11 04:30:00,1.25,1.33,1.29,232,242,231,69,30,39,51,24,27,29,15,14,+4,+1,+3,78%,75%,81%,157,159,155,20%,21%,20%,12,5,7,8,4,4
174,https://vlr.gg/player/31589/murza,2024-07-11 04:30:00,1.34,1.26,1.29,275,298,253,81,38,43,57,27,30,14,7,7,+10,+2,+8,73%,72%,74%,177,191,167,23%,26%,21%,17,7,10,7,5,2
175,https://vlr.gg/player/31593/kiss,2024-07-11 04:30:00,1.25,1.04,1.13,208,226,187,57,28,29,54,23,31,42,22,20,+7,+5,+2,77%,78%,77%,143,156,134,29%,35%,25%,12,6,6,5,1,4
176,https://vlr.gg/player/26316/ramen,2024-07-11 04:30:00,0.97,1.03,1.00,180,172,186,56,25,31,50,23,27,15,4,11,+1,-1,+2,71%,69%,72%,126,110,139,24%,24%,24%,4,1,3,3,2,1
177,https://vlr.gg/player/26310/ikana,2024-07-11 04:30:00,0.97,0.85,0.91,165,154,165,49,22,27,52,21,31,28,14,14,-7,-3,-4,66%,69%,64%,107,102,111,21%,28%,18%,4,1,3,11,4,7
178,https://vlr.gg/player/31254/feta,2024-07-11 04:30:00,1.00,1.12,1.05,216,208,234,65,35,30,62,34,28,10,5,5,+1,+1,0,60%,57%,64%,139,132,149,28%,33%,23%,15,8,7,14,7,7
179,https://vlr.gg/player/29821/sinaway,2024-07-11 04:30:00,0.77,1.36,1.03,217,165,302,64,28,36,64,37,27,10,6,4,-4,-3,-1,69%,62%,78%,153,118,198,33%,32%,33%,4,2,2,8,5,3
180,https://vlr.gg/player/22828/milky,2024-07-11 04:30:00,1.21,0.63,0.96,186,228,131,51,35,16,60,32,28,36,19,17,+3,+2,+1,65%,70%,58%,127,151,96,24%,24%,25%,5,4,1,2,2,0
181,https://vlr.gg/player/14170/mckinley,2024-07-11 04:30:00,0.90,0.70,0.81,154,159,148,42,25,17,59,30,29,21,10,11,-4,-4,0,63%,60%,67%,107,108,106,20%,20%,19%,5,3,2,9,7,2
182,https://vlr.gg/player/31255/biggiecheese,2024-07-11 04:30:00,0.67,0.59,0.64,157,148,169,42,23,19,67,36,31,21,11,10,-11,-7,-4,57%,60%,53%,103,101,106,21%,19%,22%,5,1,4,16,8,8
183,https://vlr.gg/player/700/million,2024-07-11 04:30:00,1.15,1.04,1.09,204,210,203,34,18,16,35,17,18,30,12,18,+1,0,+1,82%,83%,81%,138,120,154,19%,21%,19%,2,0,2,1,0,1
184,https://vlr.gg/player/1003/reita,2024-07-11 04:30:00,0.60,1.45,1.05,202,104,288,35,9,26,34,16,18,12,5,7,+2,-2,+4,69%,61%,77%,136,73,193,23%,22%,23%,6,1,5,4,3,1
185,https://vlr.gg/player/34776/absol,2024-07-11 04:30:00,1.16,0.93,1.04,263,303,216,44,22,22,38,19,19,10,6,4,-2,+1,-3,69%,78%,62%,159,193,129,16%,18%,14%,12,8,4,14,7,7
186,https://vlr.gg/player/686/tonbo,2024-07-11 04:30:00,0.58,0.90,0.75,159,141,181,28,12,16,39,19,20,10,5,5,-1,0,-1,69%,65%,73%,110,90,128,26%,24%,27%,2,2,0,3,2,1
187,https://vlr.gg/player/20465/biju,2024-07-11 04:30:00,0.73,0.63,0.63,162,168,177,27,13,14,41,19,22,23,14,9,-1,0,-1,76%,78%,73%,115,94,133,20%,13%,27%,2,0,2,3,0,3
188,https://vlr.gg/player/12990/syouta,2024-07-11 04:30:00,1.34,1.51,1.42,316,300,340,53,28,25,36,19,17,13,5,8,0,0,0,84%,77%,91%,212,215,210,27%,26%,29%,7,2,5,7,2,5
189,https://vlr.gg/player/6673/gon,2024-07-11 04:30:00,1.28,1.34,1.31,217,241,200,39,20,19,30,18,12,33,19,14,0,+1,-1,84%,88%,78%,128,149,105,39%,48%,29%,3,2,1,3,1,2
190,https://vlr.gg/player/2615/clz,2024-07-11 04:30:00,1.29,0.74,1.03,186,202,175,31,20,11,33,15,18,26,12,14,-5,-3,-2,80%,85%,74%,126,135,116,28%,29%,27%,1,1,0,6,4,2
191,https://vlr.gg/player/25221/xdll,2024-07-11 04:30:00,0.79,1.31,1.03,209,176,246,37,15,22,35,20,15,11,8,3,+4,+1,+3,71%,69%,74%,137,113,165,21%,25%,19%,6,3,3,2,2,0
192,https://vlr.gg/player/1395/tennn,2024-07-11 04:30:00,0.50,0.96,0.72,154,156,140,27,14,13,34,22,12,6,3,3,+2,+1,+1,69%,54%,87%,100,104,94,30%,40%,21%,8,5,3,6,4,2
193,https://vlr.gg/player/21793/syko,2024-07-11 04:20:00,1.27,1.33,1.30,226,235,214,51,30,21,37,22,15,19,8,11,+5,+4,+1,83%,82%,83%,149,150,149,32%,28%,39%,7,6,1,2,2,0
194,https://vlr.gg/player/26143/secondlove,2024-07-11 04:20:00,1.43,1.07,1.28,212,243,165,46,32,14,34,19,15,24,12,12,-2,+1,-3,71%,76%,63%,137,153,113,33%,36%,29%,3,2,1,5,1,4
195,https://vlr.gg/player/33801/loydream,2024-07-11 04:20:00,1.03,1.43,1.20,273,244,306,55,32,23,43,23,20,19,9,10,+1,-2,+3,84%,82%,88%,182,162,211,23%,21%,25%,7,2,5,6,4,2
196,https://vlr.gg/player/44246/repulsive,2024-07-11 04:20:00,1.11,0.91,1.03,176,185,173,37,23,14,34,18,16,35,20,15,-4,-2,-2,86%,88%,83%,109,111,106,25%,21%,29%,3,2,1,7,4,3
197,https://vlr.gg/player/24737/par-scofield,2024-07-11 04:20:00,0.71,1.02,0.84,237,230,248,45,25,20,48,30,18,19,14,5,-2,-3,+1,69%,65%,75%,159,150,172,30%,30%,30%,8,4,4,10,7,3
198,https://vlr.gg/player/35965/yukxx,2024-07-11 04:20:00,1.59,0.92,1.19,239,301,209,49,25,24,46,17,29,22,12,10,-1,-2,+1,72%,71%,74%,167,205,140,33%,30%,37%,6,1,5,7,3,4
199,https://vlr.gg/player/10192/chowdy,2024-07-11 04:20:00,0.99,1.13,1.07,204,182,223,44,16,28,46,18,28,17,9,8,0,-1,+1,78%,79%,76%,138,117,153,36%,33%,38%,5,1,4,5,2,3
200,https://vlr.gg/player/32585/n1er,2024-07-11 04:20:00,0.56,1.15,0.91,209,153,247,41,13,28,48,21,27,7,4,3,+4,+2,+2,60%,63%,59%,137,90,170,20%,13%,25%,11,5,6,7,3,4
201,https://vlr.gg/player/25542/ash999,2024-07-11 04:20:00,0.78,0.79,0.79,180,175,184,36,16,20,48,19,29,12,4,8,+1,-1,+2,64%,71%,59%,122,121,123,24%,32%,20%,5,2,3,4,3,1
202,https://vlr.gg/player/35026/chaze,2024-07-11 04:20:00,0.74,0.60,0.66,147,174,132,25,13,12,47,19,28,30,11,19,-2,+2,-4,76%,79%,74%,102,107,99,19%,11%,29%,3,3,0,5,1,4
203,https://vlr.gg/player/7807/valdyn,2024-07-11 03:00:00,1.03,1.03,1.03,205,183,222,35,16,19,35,15,20,10,4,6,+2,+1,+1,71%,83%,60%,139,126,151,37%,41%,34%,4,1,3,2,0,2
204,https://vlr.gg/player/2346/cud,2024-07-11 03:00:00,1.05,0.92,0.98,196,217,182,35,20,15,34,15,19,8,0,8,+1,+1,0,67%,65%,68%,123,137,109,41%,42%,40%,5,2,3,4,1,3
205,https://vlr.gg/player/4866/kushy,2024-07-11 03:00:00,0.90,0.86,0.88,216,223,204,32,16,16,38,19,19,15,12,3,+1,0,+1,73%,83%,64%,155,159,151,38%,38%,38%,5,1,4,4,1,3
206,https://vlr.gg/player/23710/gotten,2024-07-11 03:00:00,0.78,0.73,0.76,169,171,165,28,14,14,37,18,19,18,13,5,+2,0,+2,75%,74%,76%,109,107,110,35%,45%,28%,5,2,3,3,2,1
207,https://vlr.gg/player/11666/ray4c,2024-07-11 03:00:00,0.59,0.72,0.66,180,211,156,29,17,12,42,22,20,8,3,5,-4,-1,-3,58%,57%,60%,118,129,108,10%,16%,4%,6,6,0,10,7,3
208,https://vlr.gg/player/7804/severine,2024-07-11 03:00:00,1.35,1.37,1.36,222,233,205,39,21,18,29,14,15,19,8,11,+4,+4,0,75%,76%,74%,157,166,149,25%,25%,24%,6,4,2,2,0,2
209,https://vlr.gg/player/4872/frostmind,2024-07-11 03:00:00,1.11,1.62,1.35,211,159,276,36,14,22,27,12,15,25,12,13,+1,+1,0,88%,80%,96%,138,103,177,31%,27%,33%,3,2,1,2,1,1
210,https://vlr.gg/player/7783/zhar,2024-07-11 03:00:00,1.29,1.35,1.31,269,249,287,48,25,23,32,16,16,12,5,7,+5,+3,+2,73%,76%,70%,165,151,180,27%,36%,21%,7,4,3,2,1,1
211,https://vlr.gg/player/7048/budimeister,2024-07-11 03:00:00,1.44,0.89,1.18,230,268,189,38,24,14,31,13,18,17,7,10,-2,-2,0,85%,84%,87%,150,176,121,26%,42%,12%,4,1,3,6,3,3
212,https://vlr.gg/player/9717/lilo,2024-07-11 03:00:00,0.55,0.72,0.63,171,163,186,25,13,12,40,21,19,12,5,7,-10,-7,-3,79%,76%,83%,118,112,125,20%,19%,21%,3,1,2,13,8,5
213,https://vlr.gg/player/29841/caedye,2024-07-11 02:30:00,1.94,1.46,1.71,303,340,264,45,26,19,18,8,10,2,1,1,+4,+1,+3,78%,84%,72%,191,205,178,37%,36%,39%,8,3,5,4,2,2
214,https://vlr.gg/player/10584/seoldam,2024-07-11 02:30:00,1.32,1.58,1.45,294,307,280,39,22,17,22,13,9,14,4,10,+4,0,+4,78%,84%,72%,191,188,194,30%,36%,24%,8,3,5,4,3,1
215,https://vlr.gg/player/4663/joxjo,2024-07-11 02:30:00,1.19,1.24,1.21,215,198,238,27,13,14,21,11,10,21,10,11,+2,0,+2,86%,89%,83%,143,140,146,30%,31%,30%,4,2,2,2,2,0
216,https://vlr.gg/player/43064/aace,2024-07-11 02:30:00,0.78,1.18,0.97,155,118,193,22,8,14,20,11,9,16,11,5,-1,-1,0,78%,84%,72%,95,70,120,35%,26%,41%,1,0,1,2,1,1
217,https://vlr.gg/player/29843/yatsuka,2024-07-11 02:30:00,0.89,1.01,0.95,145,133,158,19,8,11,20,11,9,9,5,4,-2,-1,-1,73%,63%,83%,102,96,109,19%,19%,20%,1,1,0,3,2,1
218,https://vlr.gg/player/40726/gwangboong,2024-07-11 02:30:00,1.10,0.92,1.01,226,236,218,28,14,14,29,15,14,2,1,1,+3,0,+3,65%,61%,68%,142,143,141,23%,20%,29%,7,3,4,4,3,1
219,https://vlr.gg/player/10769/nobita,2024-07-11 02:30:00,0.82,0.73,0.77,168,184,153,22,12,10,29,14,15,8,5,3,0,-1,+1,54%,50%,58%,96,98,94,27%,35%,21%,3,1,2,3,2,1
220,https://vlr.gg/player/37664/gatorada,2024-07-11 02:30:00,0.65,0.78,0.71,181,160,203,20,9,11,33,16,17,20,11,9,-3,-2,-1,65%,61%,68%,119,100,138,20%,21%,19%,4,1,3,7,3,4
221,https://vlr.gg/player/4052/jinboong,2024-07-11 02:30:00,0.48,0.83,0.66,135,110,159,15,4,11,29,15,14,7,5,2,-5,-3,-2,57%,56%,58%,105,93,116,22%,9%,34%,1,0,1,6,3,3
222,https://vlr.gg/player/10628/misaya,2024-07-11 02:30:00,0.52,0.49,0.50,119,123,118,16,8,8,32,15,17,2,0,2,-2,-2,0,49%,50%,47%,73,72,75,11%,15%,8%,0,0,0,2,2,0
223,https://vlr.gg/player/10190/gabbydiz,2024-07-11 02:00:00,1.07,1.09,1.08,193,204,183,33,18,15,35,17,18,21,12,9,-3,0,-3,70%,83%,58%,127,129,126,25%,24%,26%,0,0,0,3,0,3
224,https://vlr.gg/player/27173/sovano,2024-07-11 02:00:00,1.30,0.83,1.06,243,294,194,40,24,16,39,18,21,6,3,3,-5,-1,-4,74%,87%,63%,156,200,115,28%,32%,22%,5,3,2,10,4,6
225,https://vlr.gg/player/27172/jacobbb,2024-07-11 02:00:00,0.95,0.81,0.88,191,213,169,32,17,15,36,16,20,5,3,2,0,0,0,62%,74%,50%,132,147,117,23%,23%,23%,4,2,2,4,2,2
226,https://vlr.gg/player/27171/grooovy,2024-07-11 02:00:00,0.66,0.93,0.80,169,165,173,26,14,12,38,19,19,16,7,9,-2,-3,+1,66%,78%,54%,112,96,128,22%,23%,20%,3,0,3,5,3,2
227,https://vlr.gg/player/9738/erz4h,2024-07-11 02:00:00,0.71,0.52,0.61,155,171,141,22,13,9,40,19,21,25,13,12,-5,-3,-2,70%,87%,54%,101,99,104,18%,17%,19%,4,3,1,9,6,3
228,https://vlr.gg/player/44259/patrickwho,2024-07-11 02:00:00,1.60,1.71,1.65,389,390,391,65,34,31,37,18,19,8,3,5,+9,+3,+6,85%,83%,87%,240,244,235,35%,36%,35%,13,6,7,4,3,1
229,https://vlr.gg/player/7435/astr0,2024-07-11 02:00:00,1.11,1.44,1.27,219,199,238,36,16,20,28,13,15,31,15,16,-3,-2,-1,87%,88%,87%,151,149,153,44%,50%,38%,1,0,1,4,2,2
230,https://vlr.gg/player/31398/ichisolo,2024-07-11 02:00:00,1.46,0.82,1.15,234,249,218,39,23,16,29,10,19,9,5,4,+11,+7,+4,72%,83%,61%,149,156,142,29%,30%,28%,13,7,6,2,0,2
231,https://vlr.gg/player/44286/gabo,2024-07-11 02:00:00,0.93,0.92,0.92,165,163,166,27,13,14,27,12,15,9,6,3,+1,+2,-1,79%,83%,74%,116,116,116,34%,28%,42%,4,3,1,3,1,2
232,https://vlr.gg/player/37375/chanyboi,2024-07-11 02:00:00,1.15,0.63,0.90,154,181,129,21,13,8,32,14,18,37,26,11,-3,-2,-1,81%,83%,78%,101,112,89,33%,39%,26%,0,0,0,3,2,1
233,https://vlr.gg/player/31827/dambi,2024-07-11 02:00:00,1.72,0.81,1.30,273,336,191,63,45,18,47,21,26,8,3,5,+6,+7,-1,80%,86%,73%,174,219,122,25%,25%,25%,11,8,3,5,1,4
234,https://vlr.gg/player/33576/margaret,2024-07-11 02:00:00,1.21,0.94,1.09,230,242,226,55,32,23,44,22,22,13,9,4,0,+2,-2,71%,74%,67%,147,153,140,36%,38%,33%,9,5,4,9,3,6
235,https://vlr.gg/player/31829/ivy,2024-07-11 02:00:00,0.67,1.50,1.05,184,116,270,43,13,30,39,19,20,21,13,8,-1,0,-1,75%,74%,77%,126,84,174,35%,27%,40%,3,1,2,4,1,3
236,https://vlr.gg/player/4122/persia,2024-07-11 02:00:00,1.04,0.94,1.00,180,173,181,41,22,19,41,20,21,22,11,11,+3,+1,+2,72%,71%,73%,127,119,138,34%,34%,34%,7,4,3,4,3,1
237,https://vlr.gg/player/31828/francis,2024-07-11 02:00:00,0.98,0.87,0.93,177,179,168,39,20,19,44,20,24,26,16,10,+3,+3,0,75%,74%,77%,110,111,109,21%,16%,27%,8,6,2,5,3,2
238,https://vlr.gg/player/24979/cloy,2024-07-11 02:00:00,1.13,0.99,1.05,190,229,166,48,25,23,45,21,24,19,9,10,-1,+4,-5,68%,77%,60%,116,133,101,42%,46%,38%,6,5,1,7,1,6
239,https://vlr.gg/player/28401/pkm,2024-07-11 02:00:00,0.87,1.01,0.94,200,210,193,47,22,25,50,24,26,8,5,3,-1,0,-1,66%,63%,69%,139,150,129,27%,27%,27%,9,5,4,10,5,5
240,https://vlr.gg/player/25048/sid,2024-07-11 02:00:00,0.81,0.95,0.89,200,177,216,45,22,23,52,24,28,15,7,8,-6,-3,-3,66%,73%,60%,131,107,151,34%,47%,28%,4,2,2,10,5,5
241,https://vlr.gg/player/25081/yoman,2024-07-11 02:00:00,1.15,0.64,0.87,174,217,135,38,22,16,45,20,25,24,18,6,-1,+1,-2,68%,77%,60%,116,147,88,22%,23%,22%,5,3,2,6,2,4
242,https://vlr.gg/player/42772/xross,2024-07-11 02:00:00,0.85,0.58,0.71,162,190,144,36,22,14,51,22,29,21,7,14,-2,0,-2,69%,70%,69%,103,112,95,9%,16%,5%,3,1,2,5,1,4
243,https://vlr.gg/player/20538/linlin,2024-07-10 21:20:00,1.18,1.74,1.44,242,224,264,44,21,23,26,16,10,18,6,12,-2,-3,+1,84%,75%,95%,156,146,167,35%,45%,27%,2,0,2,4,3,1
244,https://vlr.gg/player/12055/mmonch,2024-07-10 21:20:00,1.55,1.25,1.41,262,311,205,43,29,14,30,19,11,8,4,4,+1,-1,+2,82%,75%,90%,161,186,133,42%,48%,34%,3,1,2,2,2,0
245,https://vlr.gg/player/20491/ivy,2024-07-10 21:20:00,0.71,1.30,0.99,204,160,254,33,13,20,31,18,13,20,10,10,-1,-1,0,76%,63%,90%,132,105,164,42%,32%,50%,4,1,3,5,2,3
246,https://vlr.gg/player/20539/juw,2024-07-10 21:20:00,0.36,1.50,0.89,224,158,300,35,11,24,35,24,11,8,4,4,-3,-5,+2,71%,58%,86%,143,105,187,30%,38%,26%,7,3,4,10,8,2
247,https://vlr.gg/player/20537/andrehs,2024-07-10 21:20:00,0.69,0.98,0.83,179,185,174,26,14,12,34,22,12,20,12,8,+6,+2,+4,76%,71%,81%,119,121,116,30%,26%,34%,7,3,4,1,1,0
248,https://vlr.gg/player/26032/panday,2024-07-10 21:20:00,1.13,1.51,1.33,255,216,290,43,17,26,32,17,15,13,3,10,0,-1,+1,69%,62%,75%,175,153,194,30%,20%,38%,2,0,2,2,1,1
249,https://vlr.gg/player/17982/lunafox,2024-07-10 21:20:00,0.69,1.46,1.10,236,173,290,36,12,24,36,19,17,14,5,9,+2,-3,+5,64%,52%,75%,159,120,193,34%,35%,33%,8,2,6,6,5,1
250,https://vlr.gg/player/39565/ellie,2024-07-10 21:20:00,0.70,1.06,0.89,211,190,231,33,12,21,38,19,19,19,11,8,+6,+2,+4,76%,71%,79%,139,120,156,32%,33%,31%,6,2,4,0,0,0
251,https://vlr.gg/player/28387/fire,2024-07-10 21:20:00,0.73,0.65,0.69,152,151,151,22,10,12,36,18,18,13,6,7,0,+1,-1,67%,57%,75%,105,111,100,24%,28%,20%,2,1,1,2,0,2
252,https://vlr.gg/player/36737/alexaishot,2024-07-10 21:20:00,0.15,0.77,0.48,147,105,185,22,6,16,39,20,19,5,2,3,-9,-8,-1,62%,57%,67%,101,73,125,26%,29%,24%,4,1,3,13,9,4
253,https://vlr.gg/player/1688/rood,2024-07-10 18:30:00,1.45,1.27,1.40,261,282,203,32,24,8,20,13,7,7,6,1,+6,+3,+3,83%,79%,91%,165,184,124,29%,26%,40%,7,4,3,1,1,0
254,https://vlr.gg/player/21659/sato,2024-07-10 18:30:00,1.55,1.04,1.39,263,302,179,33,26,7,20,13,7,8,5,3,+5,+3,+2,77%,79%,73%,168,185,130,26%,21%,44%,7,5,2,2,2,0
255,https://vlr.gg/player/28716/lukxo,2024-07-10 18:30:00,1.61,0.72,1.33,265,300,191,35,28,7,20,11,9,12,8,4,-1,0,-1,83%,88%,73%,188,217,126,27%,25%,31%,3,2,1,4,2,2
256,https://vlr.gg/player/6238/urango,2024-07-10 18:30:00,1.04,1.55,1.20,254,246,279,34,21,13,25,19,6,16,14,2,+1,+2,-1,77%,79%,73%,164,141,214,31%,24%,50%,6,5,1,5,3,2
257,https://vlr.gg/player/1994/evilkyk,2024-07-10 18:30:00,0.79,1.62,1.05,124,68,254,17,6,11,14,9,5,8,5,3,0,0,0,80%,79%,82%,92,61,160,49%,35%,67%,0,0,0,0,0,0
258,https://vlr.gg/player/32718/kenkayyy,2024-07-10 18:30:00,1.41,0.73,0.94,218,302,206,26,12,14,32,10,22,10,4,6,-1,+1,-2,66%,73%,63%,158,212,133,29%,26%,31%,4,2,2,5,1,4
259,https://vlr.gg/player/22964/forbanz,2024-07-10 18:30:00,0.02,1.20,0.79,182,35,253,22,1,21,29,10,19,3,1,2,-6,-5,-1,57%,45%,63%,128,22,177,24%,0%,27%,2,0,2,8,5,3
260,https://vlr.gg/player/3450/woddy,2024-07-10 18:30:00,0.82,0.60,0.67,175,196,168,20,7,13,31,9,22,9,5,4,+1,0,+1,66%,82%,58%,113,126,107,23%,12%,30%,2,0,2,1,0,1
261,https://vlr.gg/player/1607/ntk,2024-07-10 18:30:00,0.99,0.47,0.63,160,232,128,18,9,9,30,9,21,11,3,8,-2,+1,-3,66%,82%,58%,104,146,85,11%,11%,11%,2,1,1,4,0,4
262,https://vlr.gg/player/32717/maestr0,2024-07-10 18:30:00,0.68,0.56,0.60,130,124,128,13,5,8,29,8,21,12,3,9,-3,0,-3,57%,64%,54%,83,78,85,27%,18%,32%,2,1,1,5,1,4
263,https://vlr.gg/player/42378/nicky,2024-07-10 18:00:00,1.35,1.21,1.27,216,229,206,54,26,28,40,18,22,22,11,11,+4,0,+4,82%,83%,81%,142,148,138,35%,39%,31%,6,1,5,2,1,1
264,https://vlr.gg/player/33177/none,2024-07-10 18:00:00,1.37,1.11,1.23,279,315,251,64,32,32,50,22,28,17,10,7,+4,-2,+6,72%,76%,69%,175,197,157,17%,15%,18%,18,7,11,14,9,5
265,https://vlr.gg/player/21108/ponix,2024-07-10 18:00:00,0.79,1.32,1.08,203,133,262,48,14,34,43,21,22,26,11,15,-1,-1,0,78%,72%,83%,129,84,166,25%,26%,25%,4,1,3,5,2,3
266,https://vlr.gg/player/21548/adenina,2024-07-10 18:00:00,0.96,1.14,1.06,212,200,224,47,18,29,46,22,24,37,18,19,+1,+1,0,75%,76%,75%,133,125,140,17%,16%,18%,3,2,1,2,1,1
267,https://vlr.gg/player/24770/babzzz,2024-07-10 18:00:00,0.75,0.94,0.85,186,176,195,45,20,25,48,23,25,12,4,8,-5,-3,-2,72%,66%,78%,125,119,130,23%,25%,22%,3,1,2,8,4,4
268,https://vlr.gg/player/20675/flossie,2024-07-10 18:00:00,1.01,1.40,1.18,264,230,294,55,25,30,49,28,21,14,10,4,+2,-2,+4,75%,72%,79%,175,158,196,24%,17%,34%,4,0,4,2,2,0
269,https://vlr.gg/player/20977/lynn,2024-07-10 18:00:00,1.19,1.14,1.16,259,277,254,57,34,23,53,30,23,14,8,6,0,-1,+1,69%,67%,72%,183,182,183,21%,18%,25%,12,7,5,12,8,4
270,https://vlr.gg/player/25356/reshi,2024-07-10 18:00:00,0.95,0.67,0.82,167,190,148,37,24,13,50,28,22,24,14,10,-1,-1,0,72%,78%,66%,123,132,113,26%,31%,21%,5,2,3,6,3,3
271,https://vlr.gg/player/19256/frantastic,2024-07-10 18:00:00,0.65,0.87,0.75,157,164,160,36,18,18,52,32,20,26,17,9,-1,-1,0,69%,69%,69%,107,117,95,19%,16%,23%,4,1,3,5,2,3
272,https://vlr.gg/player/21091/azul,2024-07-10 18:00:00,0.69,0.81,0.74,180,163,202,42,20,22,54,30,24,22,15,7,-3,-3,0,66%,67%,66%,113,97,132,31%,28%,33%,6,4,2,9,7,2
273,https://vlr.gg/player/8742/jakee,2024-07-10 16:00:00,0.93,1.05,0.99,200,192,205,28,12,16,32,15,17,19,8,11,+1,+1,0,67%,65%,70%,129,121,137,21%,25%,18%,4,2,2,3,1,2
274,https://vlr.gg/player/1411/will,2024-07-10 16:00:00,0.87,1.00,0.94,193,183,198,29,12,17,31,13,18,11,5,6,+1,-1,+2,79%,75%,83%,114,109,119,15%,15%,16%,2,0,2,1,1,0
275,https://vlr.gg/player/69/thief,2024-07-10 16:00:00,1.02,0.84,0.93,190,212,173,31,16,15,32,14,18,5,0,5,-2,0,-2,65%,75%,57%,122,130,116,29%,32%,27%,4,2,2,6,2,4
276,https://vlr.gg/player/7716/penny,2024-07-10 16:00:00,0.50,0.97,0.75,183,163,207,27,11,16,34,17,17,6,1,5,-1,-1,0,53%,55%,52%,122,111,132,25%,29%,23%,10,5,5,11,6,5
277,https://vlr.gg/player/739/fiziq,2024-07-10 16:00:00,0.62,0.74,0.69,143,120,164,19,8,11,34,15,19,12,2,10,-2,-1,-1,70%,65%,74%,109,86,129,23%,27%,21%,0,0,0,2,1,1
278,https://vlr.gg/player/849/poised,2024-07-10 16:00:00,1.45,1.17,1.32,206,222,188,32,20,12,23,12,11,21,9,12,+5,+5,0,88%,96%,80%,138,139,138,27%,25%,30%,5,5,0,0,0,0
279,https://vlr.gg/player/740/aproto,2024-07-10 16:00:00,1.03,1.48,1.24,213,212,219,36,18,18,22,14,8,8,4,4,+3,-1,+4,81%,83%,80%,132,145,117,33%,33%,32%,4,0,4,1,1,0
280,https://vlr.gg/player/64/gmd,2024-07-10 16:00:00,1.06,1.38,1.21,221,217,225,34,18,16,26,16,10,19,11,8,0,-2,+2,79%,83%,75%,142,143,140,28%,26%,32%,4,0,4,4,2,2
281,https://vlr.gg/player/8376/seven,2024-07-10 16:00:00,1.16,1.25,1.20,217,183,253,31,16,15,28,14,14,25,9,16,-1,-1,0,81%,78%,85%,149,127,175,14%,13%,15%,3,1,2,4,2,2
282,https://vlr.gg/player/3702/sym,2024-07-10 16:00:00,0.88,0.75,0.82,205,234,165,30,17,13,35,19,16,9,5,4,-4,0,-4,63%,65%,60%,124,144,101,23%,25%,20%,7,6,1,11,6,5
283,https://vlr.gg/player/1581/guhrvn,2024-07-10 16:00:00,0.62,1.70,1.12,211,126,306,33,9,24,32,19,13,12,7,5,-1,-2,+1,62%,50%,76%,141,92,197,27%,22%,30%,5,1,4,6,3,3
284,https://vlr.gg/player/25743/raafa,2024-07-10 16:00:00,1.10,1.03,1.07,213,203,224,33,18,15,33,17,16,13,7,6,0,-2,+2,71%,63%,81%,133,117,152,17%,18%,16%,4,0,4,4,2,2
285,https://vlr.gg/player/8873/dgzin,2024-07-10 16:00:00,0.62,1.05,0.82,207,171,251,34,13,21,39,21,18,5,3,2,-4,-2,-2,69%,63%,76%,136,115,159,24%,28%,21%,6,5,1,10,7,3
286,https://vlr.gg/player/20238/askia,2024-07-10 16:00:00,0.46,0.71,0.58,100,77,126,14,6,8,34,18,16,12,5,7,-4,-1,-3,64%,54%,76%,75,53,101,28%,17%,38%,0,0,0,4,1,3
287,https://vlr.gg/player/660/pancc,2024-07-10 16:00:00,0.47,0.68,0.57,124,97,157,17,7,10,36,19,17,7,2,5,-2,-1,-1,49%,42%,57%,86,64,111,20%,35%,14%,2,2,0,4,3,1
288,https://vlr.gg/player/20240/xenom,2024-07-10 16:00:00,1.06,1.76,1.44,242,210,273,39,15,24,20,14,6,16,8,8,+4,0,+4,78%,71%,83%,161,139,179,45%,53%,40%,5,1,4,1,1,0
289,https://vlr.gg/player/23010/nicksz,2024-07-10 16:00:00,1.42,1.27,1.34,252,274,233,42,21,21,28,15,13,19,14,5,+7,+4,+3,87%,86%,88%,155,181,132,29%,33%,26%,8,4,4,1,0,1
290,https://vlr.gg/player/3424/siduzord,2024-07-10 16:00:00,1.04,1.20,1.13,221,216,223,31,16,15,28,17,11,17,7,10,+3,+1,+2,82%,71%,92%,150,154,147,20%,36%,12%,4,1,3,1,0,1
291,https://vlr.gg/player/13823/pxs,2024-07-10 16:00:00,0.86,1.07,0.97,218,213,223,36,17,19,29,15,14,5,2,3,-1,-1,0,73%,67%,79%,139,133,144,33%,43%,21%,10,5,5,11,6,5
292,https://vlr.gg/player/6202/guuih,2024-07-10 16:00:00,0.64,1.07,0.87,169,166,170,26,11,15,26,17,9,8,4,4,-2,-1,-1,71%,67%,75%,116,116,115,30%,35%,26%,1,1,0,3,2,1
293,https://vlr.gg/player/5022/derke,2024-07-10 15:20:00,1.55,1.41,1.46,308,290,301,42,15,27,22,7,15,12,3,9,+1,-2,+3,76%,77%,75%,195,187,199,33%,41%,29%,6,1,5,5,3,2
294,https://vlr.gg/player/458/chronicle,2024-07-10 15:20:00,1.32,1.32,1.32,219,210,235,29,11,18,19,6,13,12,3,9,0,0,0,81%,69%,88%,159,139,170,27%,23%,29%,3,1,2,3,1,2
295,https://vlr.gg/player/9810/alfajer,2024-07-10 15:20:00,0.90,1.44,1.25,222,143,273,29,6,23,19,7,12,6,3,3,+3,0,+3,73%,77%,71%,152,103,179,32%,19%,40%,4,0,4,1,0,1
296,https://vlr.gg/player/29867/hiro,2024-07-10 15:20:00,1.40,1.15,1.23,206,263,164,29,12,17,20,8,12,10,6,4,+3,+2,+1,84%,85%,83%,130,151,118,37%,36%,37%,6,3,3,3,1,2
297,https://vlr.gg/player/438/boaster,2024-07-10 15:20:00,1.15,1.14,1.14,162,175,141,19,7,12,15,7,8,21,12,9,+2,+1,+1,86%,77%,92%,114,120,111,24%,23%,25%,4,2,2,2,1,1
298,https://vlr.gg/player/457/nats,2024-07-10 15:20:00,0.79,0.80,0.79,166,164,160,21,14,7,29,19,10,4,2,2,-2,-3,+1,65%,63%,69%,105,108,100,24%,32%,16%,2,1,1,4,4,0
299,https://vlr.gg/player/114/enzo,2024-07-10 15:20:00,0.58,1.14,0.78,144,99,257,18,7,11,28,19,9,7,6,1,-2,-2,0,49%,54%,38%,97,58,170,9%,4%,11%,1,0,1,3,2,1
300,https://vlr.gg/player/11494/keiko,2024-07-10 15:20:00,1.02,0.43,0.78,195,241,112,24,19,5,30,19,11,6,5,1,-2,-1,-1,68%,71%,62%,127,154,77,41%,42%,38%,5,4,1,7,5,2
301,https://vlr.gg/player/1457/mistic,2024-07-10 15:20:00,0.52,0.96,0.63,110,91,169,17,8,9,29,19,10,4,1,3,-2,-1,-1,62%,50%,85%,73,55,107,26%,35%,17%,4,3,1,6,4,2
302,https://vlr.gg/player/9780/jamppi,2024-07-10 15:20:00,0.57,0.49,0.54,135,150,99,15,12,3,32,21,11,9,3,6,-1,-1,0,51%,50%,54%,80,88,65,33%,63%,10%,2,0,2,3,1,2
303,https://vlr.gg/player/29873/benjyfishy,2024-07-10 12:00:00,1.46,1.00,1.22,222,266,178,57,34,23,42,20,22,11,6,5,+5,+5,0,70%,79%,61%,146,166,127,44%,49%,39%,7,5,2,2,0,2
304,https://vlr.gg/player/21328/wo0t,2024-07-10 12:00:00,1.03,0.95,0.99,201,214,191,49,25,24,48,21,27,11,3,8,-1,+2,-3,70%,70%,69%,133,140,127,38%,37%,40%,9,5,4,10,3,7
305,https://vlr.gg/player/18350/miniboo,2024-07-10 12:00:00,0.76,1.18,0.98,209,161,254,49,17,32,54,25,29,18,10,8,+2,0,+2,65%,67%,64%,148,122,173,27%,31%,25%,9,5,4,7,5,2
306,https://vlr.gg/player/10971/riens,2024-07-10 12:00:00,0.94,0.81,0.88,163,175,156,40,22,18,48,23,25,17,7,10,-2,+2,-4,71%,73%,69%,114,119,110,33%,31%,35%,4,2,2,6,0,6
307,https://vlr.gg/player/1144/boo,2024-07-10 12:00:00,0.74,0.93,0.84,143,122,160,33,14,19,44,21,23,25,10,15,-3,-4,+1,72%,73%,72%,94,80,106,26%,24%,28%,6,2,4,9,6,3
308,https://vlr.gg/player/5550/grubinho,2024-07-10 12:00:00,1.34,1.26,1.30,247,240,254,62,32,30,43,22,21,26,10,16,-4,0,-4,70%,64%,76%,152,149,156,25%,23%,28%,4,3,1,8,3,5
309,https://vlr.gg/player/1428/sheydos,2024-07-10 12:00:00,1.16,1.25,1.20,210,191,233,54,27,27,41,20,21,17,8,9,+1,+1,0,75%,75%,76%,132,112,154,22%,18%,25%,5,4,1,4,3,1
310,https://vlr.gg/player/565/starxo,2024-07-10 12:00:00,0.93,0.93,0.93,145,142,147,36,19,17,40,22,18,39,19,20,-1,0,-1,77%,75%,79%,96,97,95,18%,26%,13%,3,2,1,4,2,2
311,https://vlr.gg/player/14681/kamo,2024-07-10 12:00:00,1.08,0.67,0.88,216,270,161,48,32,16,54,27,27,16,12,4,+4,+4,0,71%,75%,67%,153,184,119,25%,23%,30%,14,7,7,10,3,7
312,https://vlr.gg/player/451/shadow,2024-07-10 12:00:00,0.67,0.82,0.74,155,141,173,36,17,19,51,25,26,24,13,11,-1,-1,0,62%,61%,64%,103,99,107,24%,17%,30%,8,4,4,9,5,4
313,https://vlr.gg/player/11704/styron,2024-07-10 09:30:00,1.56,1.79,1.66,274,276,254,33,19,14,13,9,4,14,7,7,0,-1,+1,91%,84%,100%,178,192,161,20%,23%,14%,2,1,1,2,2,0
314,https://vlr.gg/player/24653/vera,2024-07-10 09:30:00,1.68,1.33,1.52,328,327,335,40,23,17,23,12,11,13,6,7,+2,-1,+3,76%,74%,80%,225,214,239,26%,25%,28%,6,2,4,4,3,1
315,https://vlr.gg/player/34032/grumble,2024-07-10 09:30:00,1.01,1.32,1.15,189,210,157,26,16,10,16,11,5,10,5,5,+3,+1,+2,82%,84%,80%,114,126,100,33%,42%,22%,3,1,2,0,0,0
316,https://vlr.gg/player/24628/wayne,2024-07-10 09:30:00,0.88,1.41,1.11,188,135,256,25,9,16,19,12,7,15,12,3,+1,-1,+2,79%,74%,87%,125,86,174,32%,31%,33%,2,0,2,1,1,0
317,https://vlr.gg/player/7426/juicy,2024-07-10 09:30:00,0.59,1.18,0.85,159,163,155,21,11,10,21,15,6,6,2,4,-2,-1,-1,65%,63%,67%,106,101,113,23%,35%,11%,6,4,2,8,5,3
318,https://vlr.gg/player/8137/lenne,2024-07-10 09:30:00,0.55,1.75,1.22,252,119,346,29,6,23,26,13,13,7,2,5,+4,0,+4,62%,47%,74%,147,87,195,17%,32%,14%,6,1,5,2,1,1
319,https://vlr.gg/player/11737/xan,2024-07-10 09:30:00,1.00,0.77,0.87,196,228,180,23,11,12,30,13,17,5,2,3,+2,+1,+1,62%,67%,58%,127,143,114,36%,57%,21%,6,3,3,4,2,2
320,https://vlr.gg/player/24654/tempz,2024-07-10 09:30:00,0.59,0.63,0.61,142,143,149,16,7,9,31,13,18,15,4,11,-5,-5,0,53%,47%,58%,97,102,93,41%,30%,53%,2,0,2,7,5,2
321,https://vlr.gg/player/2381/divine,2024-07-10 09:30:00,0.54,0.52,0.52,107,120,106,11,5,6,31,15,16,17,8,9,0,0,0,50%,47%,53%,74,74,75,27%,17%,35%,0,0,0,0,0,0
322,https://vlr.gg/player/9158/hyk,2024-07-10 09:30:00,0.36,0.59,0.49,122,91,136,13,4,9,27,13,14,3,2,1,-5,-3,-2,41%,33%,47%,75,63,84,30%,26%,33%,1,0,1,6,3,3
323,https://vlr.gg/player/4377/johnolsen,2024-07-10 09:15:00,1.05,1.07,1.06,221,233,209,34,18,16,34,19,15,11,7,4,-1,-2,+1,73%,71%,76%,155,163,145,37%,35%,40%,9,6,3,10,8,2
324,https://vlr.gg/player/6723/foxz,2024-07-10 09:15:00,0.96,1.01,0.98,207,183,234,34,16,18,33,17,16,13,6,7,+1,0,+1,69%,63%,76%,131,127,136,27%,22%,33%,2,0,2,1,0,1
325,https://vlr.gg/player/27254/leviathan,2024-07-10 09:15:00,1.11,0.80,0.97,226,261,188,36,23,13,35,19,16,10,3,7,0,0,0,76%,67%,86%,134,148,118,29%,34%,24%,4,2,2,4,2,2
326,https://vlr.gg/player/3401/ptc,2024-07-10 09:15:00,1.14,0.57,0.87,163,196,125,27,18,9,32,16,16,22,15,7,-6,-1,-5,76%,96%,52%,105,123,85,30%,31%,30%,1,1,0,7,2,5
327,https://vlr.gg/player/3342/sushiboys,2024-07-10 09:15:00,0.79,0.51,0.66,145,153,134,22,13,9,33,16,17,12,9,3,-5,-3,-2,62%,63%,62%,101,109,91,19%,15%,26%,1,0,1,6,3,3
328,https://vlr.gg/player/23930/potter,2024-07-10 09:15:00,1.65,1.40,1.52,300,367,240,50,28,22,31,16,15,7,3,4,+5,+4,+1,67%,67%,67%,191,219,167,39%,38%,39%,11,7,4,6,3,3
329,https://vlr.gg/player/2366/alert,2024-07-10 09:15:00,1.36,0.86,1.09,225,248,204,36,20,16,30,12,18,8,5,3,+7,+4,+3,76%,86%,67%,147,160,136,37%,51%,27%,11,5,6,4,1,3
330,https://vlr.gg/player/10791/bnwgiggs,2024-07-10 09:15:00,0.83,1.16,1.01,194,150,235,31,10,21,31,14,17,20,15,5,+2,-2,+4,71%,67%,75%,117,95,137,24%,22%,25%,5,1,4,3,3,0
331,https://vlr.gg/player/12289/siraww,2024-07-10 09:15:00,1.25,0.74,0.97,153,163,146,26,13,13,28,10,18,8,5,3,+1,0,+1,69%,81%,58%,114,124,105,33%,30%,36%,1,0,1,0,0,0
332,https://vlr.gg/player/2368/b3ta,2024-07-10 09:15:00,0.96,0.75,0.85,158,144,171,24,9,15,33,13,20,22,16,6,-4,-1,-3,71%,76%,67%,107,97,116,29%,28%,30%,0,0,0,4,1,3
333,https://vlr.gg/player/10459/sway,2024-07-10 07:40:00,0.99,1.16,1.07,249,253,246,38,21,17,35,20,15,18,9,9,-4,-3,-1,65%,56%,76%,160,156,166,20%,19%,20%,10,7,3,14,10,4
334,https://vlr.gg/player/17513/japips,2024-07-10 07:40:00,1.07,1.05,1.06,197,213,174,30,16,14,32,18,14,20,14,6,0,+1,-1,76%,76%,76%,125,131,117,23%,19%,29%,2,1,1,2,0,2
335,https://vlr.gg/player/16645/britsy,2024-07-10 07:40:00,1.04,0.78,0.93,196,224,167,33,21,12,37,20,17,17,10,7,-1,-3,+2,76%,76%,76%,124,134,112,24%,31%,16%,4,0,4,5,3,2
336,https://vlr.gg/player/17637/kiri,2024-07-10 07:40:00,0.99,0.86,0.93,170,158,187,26,14,12,30,14,16,10,5,5,-1,-1,0,65%,64%,67%,124,108,142,13%,13%,13%,2,1,1,3,2,1
337,https://vlr.gg/player/17127/zini,2024-07-10 07:40:00,0.98,0.83,0.91,207,226,184,31,18,13,36,19,17,16,8,8,+2,+1,+1,72%,80%,62%,140,165,111,19%,22%,14%,3,1,2,1,0,1
338,https://vlr.gg/player/16644/muffinloop,2024-07-10 07:40:00,1.26,1.30,1.28,275,248,296,41,17,24,32,13,19,17,11,6,+8,+3,+5,78%,81%,76%,172,155,187,27%,22%,31%,10,3,7,2,0,2
339,https://vlr.gg/player/8506/meow16k,2024-07-10 07:40:00,1.06,1.45,1.27,291,251,327,45,18,27,34,16,18,13,6,7,+1,-1,+2,76%,76%,76%,175,150,195,19%,14%,22%,10,4,6,9,5,4
340,https://vlr.gg/player/19408/crescents,2024-07-10 07:40:00,1.30,0.91,1.08,184,213,159,33,17,16,29,12,17,29,10,19,-4,0,-4,72%,71%,72%,115,123,108,32%,30%,34%,2,2,0,6,2,4
341,https://vlr.gg/player/29484/rose,2024-07-10 07:40:00,1.08,0.99,1.03,162,163,161,27,14,13,27,11,16,27,10,17,0,-1,+1,76%,81%,72%,107,110,105,25%,24%,25%,1,0,1,1,1,0
342,https://vlr.gg/player/17494/skyelyse,2024-07-10 07:40:00,0.71,0.53,0.61,158,185,129,24,13,11,36,16,20,8,4,4,-1,-2,+1,61%,62%,60%,104,118,93,14%,11%,19%,2,1,1,3,3,0
343,https://vlr.gg/player/40912/123,2024-07-10 07:00:00,1.32,1.01,1.15,240,301,208,68,36,32,62,27,35,12,6,6,-1,+2,-3,60%,62%,58%,169,196,147,28%,24%,35%,13,7,6,14,5,9
344,https://vlr.gg/player/44930/nex1sphix,2024-07-10 07:00:00,1.09,0.71,0.88,181,216,170,50,28,22,61,24,37,29,20,9,-6,-3,-3,68%,81%,58%,126,128,125,26%,23%,29%,4,2,2,10,5,5
345,https://vlr.gg/player/40891/be,2024-07-10 07:00:00,0.94,0.78,0.85,166,161,179,52,24,28,63,24,39,21,12,9,0,0,0,66%,70%,62%,108,102,113,45%,35%,56%,8,3,5,8,3,5
346,https://vlr.gg/player/46043/answerz,2024-07-10 07:00:00,0.73,0.70,0.71,145,156,154,43,21,22,67,28,39,18,7,11,-2,+2,-4,57%,68%,49%,106,107,106,25%,22%,28%,6,3,3,8,1,7
347,https://vlr.gg/player/40901/orgil,2024-07-10 07:00:00,0.71,0.67,0.67,166,168,167,42,20,22,68,29,39,20,9,11,+3,+4,-1,62%,65%,60%,108,109,107,27%,25%,29%,7,6,1,4,2,2
348,https://vlr.gg/player/12365/coconut,2024-07-10 07:00:00,1.25,1.51,1.37,264,247,258,76,42,34,47,26,21,17,8,9,+3,-1,+4,85%,82%,89%,167,159,177,33%,33%,32%,6,2,4,3,3,0
349,https://vlr.gg/player/15817/gghuiii,2024-07-10 07:00:00,1.37,1.17,1.27,255,280,231,32,18,14,22,10,12,7,1,6,+4,+3,+1,79%,76%,82%,171,183,159,26%,26%,26%,6,4,2,2,1,1
350,https://vlr.gg/player/7851/uta,2024-07-10 07:00:00,1.46,0.99,1.25,236,291,195,70,46,24,51,25,26,27,13,14,-2,+5,-7,74%,78%,70%,156,180,127,27%,36%,17%,12,10,2,14,5,9
351,https://vlr.gg/player/37421/riyabtw,2024-07-10 07:00:00,1.16,1.23,1.19,254,236,271,73,39,34,54,25,29,9,7,2,+3,+3,0,72%,78%,65%,169,162,178,25%,27%,23%,14,8,6,11,5,6
352,https://vlr.gg/player/24304/kiuuuu,2024-07-10 07:00:00,1.00,0.83,0.93,134,145,129,24,15,9,28,15,13,21,12,9,0,0,0,77%,75%,80%,93,100,84,30%,31%,28%,1,1,0,1,1,0
353,https://vlr.gg/player/24302/chimei,2024-07-10 07:00:00,1.13,0.59,0.89,183,193,142,46,30,16,55,26,29,35,27,8,-2,+1,-3,71%,84%,54%,114,126,100,18%,18%,16%,5,3,2,7,2,5
354,https://vlr.gg/player/27068/pudj,2024-07-10 07:00:00,1.48,1.11,1.30,234,267,201,36,22,14,32,17,15,19,9,10,0,0,0,80%,75%,86%,151,169,132,21%,20%,21%,1,1,0,1,1,0
355,https://vlr.gg/player/16852/nakya,2024-07-10 07:00:00,0.85,1.60,1.21,282,226,344,45,19,26,37,21,16,8,5,3,-3,-4,+1,63%,58%,68%,189,146,236,29%,27%,31%,10,4,6,13,8,5
356,https://vlr.gg/player/5886/flaring,2024-07-10 07:00:00,1.12,0.95,1.04,204,196,210,32,15,17,33,16,17,23,14,9,-1,-1,0,83%,83%,82%,140,136,144,30%,33%,27%,3,1,2,4,2,2
357,https://vlr.gg/player/7381/redkoh,2024-07-10 07:00:00,1.09,0.89,0.99,173,170,171,28,14,14,32,15,17,21,11,10,+3,+1,+2,74%,75%,73%,105,102,109,42%,46%,39%,4,2,2,1,1,0
358,https://vlr.gg/player/7443/riza,2024-07-10 07:00:00,0.96,0.89,0.92,176,161,195,31,15,16,35,17,18,9,6,3,-3,-2,-1,74%,67%,82%,115,107,124,30%,31%,29%,3,1,2,6,3,3
359,https://vlr.gg/player/3480/thedoctorr,2024-07-10 07:00:00,1.26,1.09,1.17,267,261,269,42,20,22,36,17,19,22,11,11,-1,-1,0,74%,68%,79%,162,157,166,37%,46%,31%,3,1,2,4,2,2
360,https://vlr.gg/player/21051/jans0n,2024-07-10 07:00:00,0.88,0.89,0.88,184,190,184,30,15,15,36,18,18,18,10,8,+1,0,+1,78%,82%,75%,120,117,122,26%,23%,30%,2,1,1,1,1,0
361,https://vlr.gg/player/7513/markl,2024-07-10 07:00:00,0.73,1.00,0.87,205,191,217,35,16,19,35,19,16,5,2,3,+1,-2,+3,72%,73%,71%,132,118,145,24%,22%,26%,6,2,4,5,4,1
362,https://vlr.gg/player/2378/subbey,2024-07-10 07:00:00,1.05,0.69,0.86,192,240,151,29,19,10,33,16,17,19,12,7,+5,+2,+3,80%,95%,67%,120,138,103,21%,14%,32%,6,2,4,1,0,1
363,https://vlr.gg/player/45876/fixy,2024-07-10 07:00:00,0.66,0.95,0.81,196,183,205,32,14,18,34,18,16,3,2,1,-2,-1,-1,70%,73%,67%,122,121,122,28%,29%,26%,8,4,4,10,5,5
364,https://vlr.gg/player/27244/seph1roth,2024-07-10 07:00:00,1.06,1.49,1.25,248,190,324,43,18,25,29,15,14,9,2,7,-1,-3,+2,78%,76%,81%,160,129,197,39%,36%,41%,5,2,3,6,5,1
365,https://vlr.gg/player/12098/kadoom,2024-07-10 07:00:00,0.82,1.61,1.18,288,250,327,44,20,24,34,22,12,11,8,3,+4,0,+4,78%,72%,86%,183,165,204,24%,28%,21%,11,5,6,7,5,2
366,https://vlr.gg/player/13784/killua,2024-07-10 07:00:00,1.38,0.71,1.07,237,289,148,38,26,12,33,17,16,8,6,2,-3,-1,-2,65%,72%,57%,157,200,105,38%,34%,50%,4,3,1,7,4,3
367,https://vlr.gg/player/14674/kntz,2024-07-10 07:00:00,1.27,0.78,1.05,158,179,146,31,19,12,27,12,15,17,8,9,-2,0,-2,85%,88%,81%,99,109,87,28%,32%,23%,1,0,1,3,0,3
368,https://vlr.gg/player/24679/cgrs,2024-07-10 07:00:00,1.10,0.95,1.03,184,199,171,31,19,12,29,17,12,15,10,5,0,+1,-1,78%,76%,81%,127,137,115,22%,24%,20%,1,1,0,1,0,1
369,https://vlr.gg/player/19150/niffy,2024-07-10 07:00:00,0.88,1.14,1.02,261,246,269,39,17,22,40,18,22,11,5,6,+5,+1,+4,78%,76%,80%,156,146,164,21%,16%,27%,12,4,8,7,3,4
370,https://vlr.gg/player/1910/acetics,2024-07-10 07:00:00,0.90,0.94,0.92,208,221,211,32,15,17,38,18,20,12,6,6,-3,-2,-1,80%,76%,84%,142,141,142,33%,33%,33%,4,2,2,7,4,3
371,https://vlr.gg/player/6733/xze,2024-07-10 07:00:00,0.66,1.12,0.91,168,140,203,30,11,19,38,19,19,20,8,12,-1,-2,+1,65%,57%,72%,116,91,136,65%,55%,72%,2,1,1,3,3,0
372,https://vlr.gg/player/2390/pinocchios,2024-07-10 07:00:00,1.24,0.64,0.91,168,201,147,29,16,13,35,14,21,20,10,10,+2,+2,0,78%,86%,72%,109,120,101,25%,23%,27%,4,2,2,2,0,2
373,https://vlr.gg/player/23918/reality,2024-07-10 07:00:00,0.80,0.64,0.72,150,157,139,22,10,12,36,16,20,13,7,6,-1,0,-1,65%,71%,60%,98,109,88,23%,21%,24%,2,1,1,3,1,2
374,https://vlr.gg/player/44251/dignified,2024-07-10 06:45:00,1.18,1.32,1.26,208,177,238,45,19,26,32,16,16,20,6,14,+4,+2,+2,80%,81%,79%,135,116,152,47%,41%,51%,5,2,3,1,0,1
375,https://vlr.gg/player/35028/fallx,2024-07-10 06:45:00,1.33,1.16,1.24,261,275,241,52,25,27,39,19,20,13,7,6,0,+3,-3,65%,65%,66%,167,181,154,38%,40%,35%,12,8,4,12,5,7
376,https://vlr.gg/player/35020/aeonyx,2024-07-10 06:45:00,1.05,1.14,1.10,203,192,215,38,18,20,38,19,19,15,7,8,0,-1,+1,75%,65%,83%,138,138,138,35%,48%,27%,5,2,3,5,3,2
377,https://vlr.gg/player/35027/owen-q-t,2024-07-10 06:45:00,1.01,0.97,0.99,192,189,194,37,17,20,41,19,22,29,12,17,0,-1,+1,73%,73%,72%,124,142,108,27%,23%,35%,3,0,3,3,1,2
378,https://vlr.gg/player/44250/dizzyfps,2024-07-10 06:45:00,0.46,1.07,0.78,163,133,194,30,10,20,39,23,16,14,8,6,-1,-1,0,67%,58%,76%,117,100,132,29%,24%,34%,4,2,2,5,3,2
379,https://vlr.gg/player/7746/kevzii,2024-07-10 06:45:00,1.04,1.33,1.18,215,182,259,42,19,23,38,21,17,17,7,10,0,0,0,80%,76%,85%,139,120,160,26%,35%,21%,4,2,2,4,2,2
380,https://vlr.gg/player/13744/patmen,2024-07-10 06:45:00,0.89,1.49,1.18,246,202,296,48,21,27,39,23,16,24,12,12,-1,-3,+2,75%,72%,77%,156,122,193,30%,32%,28%,4,1,3,5,4,1
381,https://vlr.gg/player/16953/zynd,2024-07-10 06:45:00,0.98,1.03,1.00,201,192,216,41,19,22,37,20,17,7,5,2,+1,+1,0,65%,62%,69%,133,123,144,33%,36%,31%,4,2,2,3,1,2
382,https://vlr.gg/player/13223/micr0,2024-07-10 06:45:00,0.96,0.61,0.80,174,201,141,29,19,10,43,22,21,24,9,15,-1,+2,-3,67%,72%,62%,111,129,91,18%,23%,11%,3,3,0,4,1,3
383,https://vlr.gg/player/9737/kakarot,2024-07-10 06:45:00,0.49,0.83,0.65,170,170,172,29,15,14,45,27,18,13,4,9,-2,-1,-1,64%,52%,77%,114,109,120,16%,15%,16%,11,6,5,13,7,6
384,https://vlr.gg/player/2348/famouz,2024-07-10 06:00:00,1.52,1.77,1.66,342,324,355,51,21,30,24,11,13,11,2,9,+6,+4,+2,98%,94%,100%,228,201,247,28%,35%,24%,7,4,3,1,0,1
385,https://vlr.gg/player/10739/shiro,2024-07-10 06:00:00,1.39,1.44,1.42,229,267,203,35,16,19,23,10,13,22,7,15,+1,0,+1,85%,88%,83%,165,174,158,31%,30%,32%,4,2,2,3,2,1
386,https://vlr.gg/player/4874/berserx,2024-07-10 06:00:00,1.28,1.43,1.37,238,230,242,36,14,22,21,10,11,8,3,5,+5,+1,+4,88%,82%,92%,153,150,154,22%,23%,22%,6,2,4,1,1,0
387,https://vlr.gg/player/7043/ncslasher,2024-07-10 06:00:00,0.92,1.05,0.99,199,150,235,29,10,19,27,10,17,17,5,12,+7,+1,+6,83%,82%,83%,118,89,138,15%,23%,11%,8,2,6,1,1,0
388,https://vlr.gg/player/2380/zesbeew,2024-07-10 06:00:00,0.87,0.88,0.88,164,140,179,25,9,16,28,11,17,31,14,17,-2,-1,-1,76%,76%,75%,98,82,109,24%,30%,20%,4,1,3,6,2,4
389,https://vlr.gg/player/10738/heynf,2024-07-10 06:00:00,0.83,1.34,1.04,179,158,214,26,14,12,31,20,11,24,14,10,-5,-4,-1,76%,79%,71%,113,86,152,25%,27%,23%,1,1,0,6,5,1
390,https://vlr.gg/player/10807/dragy,2024-07-10 06:00:00,0.79,1.02,0.89,187,170,214,26,14,12,35,21,14,16,10,6,-1,+1,-2,66%,67%,65%,110,95,131,27%,22%,31%,2,1,1,3,0,3
391,https://vlr.gg/player/23709/jefz,2024-07-10 06:00:00,0.90,0.54,0.75,205,240,153,27,18,9,36,22,14,12,8,4,-8,-5,-3,68%,67%,71%,140,170,98,7%,7%,6%,4,2,2,12,7,5
392,https://vlr.gg/player/15678/reeq,2024-07-10 06:00:00,0.55,0.83,0.67,172,157,196,24,12,12,36,22,14,7,5,2,-4,-4,0,63%,58%,71%,121,107,141,21%,24%,19%,2,0,2,6,4,2
393,https://vlr.gg/player/4867/onigiri,2024-07-10 06:00:00,0.78,0.40,0.62,149,166,129,20,13,7,38,21,17,6,4,2,+1,0,+1,51%,58%,41%,102,111,90,33%,33%,33%,3,2,1,2,2,0
394,https://vlr.gg/player/4657/moves,2024-07-10 05:50:00,1.13,1.37,1.24,249,224,284,39,20,19,34,18,16,24,10,14,-5,-2,-3,80%,88%,71%,167,149,189,22%,22%,23%,2,0,2,7,2,5
395,https://vlr.gg/player/20879/sungjin,2024-07-10 05:50:00,1.01,1.41,1.20,228,201,253,39,18,21,29,18,11,12,7,5,+4,+3,+1,80%,71%,90%,148,126,173,35%,33%,38%,5,4,1,1,1,0
396,https://vlr.gg/player/9192/cloudy,2024-07-10 05:50:00,1.43,0.86,1.15,217,266,170,17,11,6,16,7,9,14,7,7,-3,0,-3,71%,75%,67%,139,169,110,24%,17%,37%,1,1,0,4,1,3
397,https://vlr.gg/player/13000/redlight,2024-07-10 05:50:00,1.01,1.25,1.12,169,164,176,14,8,6,13,7,6,8,2,6,-2,-1,-1,62%,50%,78%,114,104,128,20%,33%,12%,1,1,0,3,2,1
398,https://vlr.gg/player/4475/benecia,2024-07-10 05:50:00,1.42,0.70,1.08,206,247,153,31,21,10,31,14,17,21,15,6,0,-2,+2,78%,88%,67%,138,164,110,32%,30%,34%,3,1,2,3,3,0
399,https://vlr.gg/player/37535/jaebin,2024-07-10 05:50:00,0.84,1.08,0.95,211,214,211,33,17,16,32,18,14,11,7,4,-1,0,-1,71%,71%,71%,138,148,128,17%,19%,15%,7,4,3,8,4,4
400,https://vlr.gg/player/4054/secret,2024-07-10 05:50:00,1.49,1.09,1.28,263,282,254,43,22,21,34,14,20,18,11,7,+2,-1,+3,67%,81%,54%,163,177,151,28%,28%,29%,7,1,6,5,2,3
401,https://vlr.gg/player/4038/bangnan,2024-07-10 05:50:00,1.05,1.32,1.20,209,156,260,36,13,23,29,12,17,17,7,10,0,-1,+1,73%,76%,71%,134,106,158,37%,36%,38%,2,0,2,2,1,1
402,https://vlr.gg/player/9236/manggong,2024-07-10 05:50:00,0.63,0.84,0.75,160,131,185,24,10,14,35,16,19,15,5,10,+3,+3,0,67%,67%,67%,102,85,117,42%,42%,42%,4,3,1,1,0,1
403,https://vlr.gg/player/17063/vow,2024-07-10 05:50:00,0.51,0.96,0.75,169,147,184,24,10,14,36,17,19,14,6,8,-1,-2,+1,71%,71%,71%,110,97,123,20%,21%,20%,4,1,3,5,3,2
404,https://vlr.gg/player/42749/godsb,2024-07-10 05:50:00,0.99,0.45,0.70,193,274,120,27,18,9,39,19,20,11,7,4,+3,+6,-3,71%,81%,63%,137,184,95,25%,26%,24%,9,8,1,6,2,4
405,https://vlr.gg/player/46557/junebug,2024-07-10 05:30:00,1.19,0.40,0.91,194,226,130,26,20,6,30,17,13,6,5,1,+4,+2,+2,59%,63%,54%,117,138,80,27%,34%,14%,5,3,2,1,1,0
406,https://vlr.gg/player/19963/juno,2024-07-10 05:30:00,0.63,1.03,0.77,186,167,247,24,14,10,31,20,11,13,6,7,-1,-1,0,62%,58%,69%,122,104,154,16%,13%,19%,1,0,1,2,1,1
407,https://vlr.gg/player/45164/krys,2024-07-10 05:30:00,0.96,0.39,0.76,143,161,110,19,14,5,28,16,12,4,2,2,+1,+2,-1,65%,75%,46%,104,123,69,31%,35%,19%,6,5,1,5,3,2
408,https://vlr.gg/player/17435/enn,2024-07-10 05:30:00,0.72,0.65,0.70,176,197,156,21,15,6,32,21,11,9,7,2,-2,-1,-1,65%,75%,46%,134,140,125,23%,22%,23%,4,3,1,6,4,2
409,https://vlr.gg/player/46567/m1rai,2024-07-10 05:30:00,0.48,1.29,0.68,166,151,212,8,5,3,14,12,2,5,2,3,-1,-1,0,63%,58%,75%,124,109,170,20%,17%,25%,1,1,0,2,2,0
410,https://vlr.gg/player/39484/ven,2024-07-10 05:30:00,0.59,0.67,0.62,162,109,233,12,5,7,17,8,9,7,5,2,0,-1,+1,67%,67%,67%,95,66,133,33%,27%,38%,2,0,2,2,1,1
411,https://vlr.gg/player/19962/eluwu,2024-07-10 05:30:00,1.89,1.58,1.69,336,318,328,43,14,29,20,5,15,6,3,3,+5,+2,+3,84%,85%,83%,216,208,220,31%,28%,33%,8,3,5,3,1,2
412,https://vlr.gg/player/16642/casper,2024-07-10 05:30:00,1.73,1.11,1.33,209,318,168,30,15,15,22,8,14,20,9,11,-1,+1,-2,78%,85%,75%,143,205,109,32%,25%,41%,3,2,1,4,1,3
413,https://vlr.gg/player/15712/lunah,2024-07-10 05:30:00,1.84,1.05,1.33,240,270,219,33,16,17,22,5,17,14,2,12,0,-1,+1,78%,85%,75%,173,183,167,34%,58%,24%,4,0,4,4,1,3
414,https://vlr.gg/player/19938/twirly,2024-07-10 05:30:00,0.69,1.56,1.26,217,160,249,30,7,23,22,10,12,9,5,4,-1,-2,+1,73%,62%,79%,153,120,170,31%,40%,28%,3,1,2,4,3,1
415,https://vlr.gg/player/19492/amy,2024-07-10 05:30:00,0.79,0.77,0.78,140,140,134,16,6,10,24,9,15,24,9,15,-4,-1,-3,76%,77%,75%,100,98,101,24%,21%,26%,0,0,0,4,1,3
416,https://vlr.gg/player/4477/lob,2024-07-10 05:20:00,0.91,1.25,1.09,190,143,233,38,15,23,40,19,21,19,8,11,-1,0,-1,71%,64%,77%,128,102,152,23%,33%,19%,0,0,0,1,0,1
417,https://vlr.gg/player/7888/blackwiz,2024-07-10 05:20:00,1.04,0.94,0.99,203,219,191,44,23,21,44,22,22,17,7,10,-3,-1,-2,69%,68%,71%,132,141,123,27%,31%,25%,2,1,1,5,2,3
418,https://vlr.gg/player/34727/kayle,2024-07-10 05:20:00,0.99,0.96,0.97,194,200,190,38,18,20,46,23,23,16,10,6,+2,+1,+1,69%,79%,61%,135,142,128,29%,29%,30%,3,2,1,1,1,0
419,https://vlr.gg/player/7718/xnfri,2024-07-10 05:20:00,1.24,0.68,0.95,182,205,164,38,21,17,44,19,25,13,6,7,+2,-1,+3,61%,71%,52%,122,141,105,20%,20%,20%,7,1,6,5,2,3
420,https://vlr.gg/player/687/zepher,2024-07-10 05:20:00,0.34,0.88,0.62,173,132,211,34,12,22,48,26,22,9,4,5,-11,-7,-4,51%,39%,61%,114,86,140,15%,16%,13%,12,6,6,23,13,10
421,https://vlr.gg/player/12990/syouta,2024-07-10 05:20:00,1.01,1.51,1.25,248,201,299,52,23,29,38,21,17,7,2,5,+6,+1,+5,75%,68%,82%,159,130,191,24%,26%,22%,13,6,7,7,5,2
422,https://vlr.gg/player/25221/xdll,2024-07-10 05:20:00,1.37,0.90,1.15,257,288,224,53,31,22,43,22,21,21,11,10,+7,+5,+2,73%,77%,68%,180,207,150,28%,33%,22%,11,7,4,4,2,2
423,https://vlr.gg/player/1395/tennn,2024-07-10 05:20:00,1.20,1.07,1.14,193,190,198,44,23,21,35,18,17,19,7,12,-4,-2,-2,73%,68%,79%,130,130,130,51%,54%,49%,2,0,2,6,2,4
424,https://vlr.gg/player/6673/gon,2024-07-10 05:20:00,0.96,1.17,1.06,192,163,227,40,18,22,36,19,17,27,12,15,0,+1,-1,76%,71%,82%,115,99,133,36%,33%,38%,3,2,1,3,1,2
425,https://vlr.gg/player/2615/clz,2024-07-10 05:20:00,0.91,0.94,0.92,166,184,145,33,18,15,40,23,17,27,20,7,+2,-2,+4,80%,77%,82%,117,128,104,23%,22%,24%,6,2,4,4,4,0
426,https://vlr.gg/player/29821/sinaway,2024-07-10 04:30:00,1.91,1.92,1.91,328,334,329,48,25,23,18,10,8,10,4,6,0,+1,-1,84%,80%,89%,214,229,197,43%,42%,44%,3,2,1,3,1,2
427,https://vlr.gg/player/31254/feta,2024-07-10 04:30:00,0.77,2.07,1.38,281,165,409,39,12,27,25,15,10,8,4,4,+6,0,+6,84%,80%,89%,189,112,275,35%,47%,30%,10,3,7,4,3,1
428,https://vlr.gg/player/14170/mckinley,2024-07-10 04:30:00,1.18,1.14,1.16,214,226,197,28,15,13,23,12,11,19,10,9,+2,+4,-2,89%,95%,83%,134,143,125,18%,24%,13%,5,4,1,3,0,3
429,https://vlr.gg/player/31255/biggiecheese,2024-07-10 04:30:00,0.70,0.87,0.78,149,160,137,19,10,9,24,15,9,14,8,6,0,0,0,74%,65%,83%,93,96,90,15%,15%,15%,2,1,1,2,1,1
430,https://vlr.gg/player/22828/milky,2024-07-10 04:30:00,0.54,0.95,0.73,113,93,133,16,7,9,23,13,10,14,5,9,-2,-3,+1,74%,65%,83%,72,56,90,15%,15%,15%,2,1,1,4,4,0
431,https://vlr.gg/player/1771/myth,2024-07-10 04:30:00,0.94,0.91,0.92,195,199,193,25,12,13,30,15,15,20,7,13,-4,-1,-3,79%,72%,85%,116,117,115,30%,28%,32%,0,0,0,4,1,3
432,https://vlr.gg/player/31580/vizsla,2024-07-10 04:30:00,0.52,1.27,0.91,226,166,278,26,7,19,31,16,15,9,6,3,+5,0,+5,63%,56%,70%,151,118,181,26%,21%,28%,8,2,6,3,2,1
433,https://vlr.gg/player/22816/blessed,2024-07-10 04:30:00,0.65,1.02,0.84,179,173,182,24,11,13,29,16,13,9,3,6,-1,-2,+1,61%,56%,65%,113,107,118,39%,31%,48%,3,1,2,4,3,1
434,https://vlr.gg/player/36747/bonobo,2024-07-10 04:30:00,0.73,0.71,0.72,155,196,124,21,12,9,30,17,13,4,2,2,-5,0,-5,71%,67%,75%,109,122,98,21%,19%,22%,2,2,0,7,2,5
435,https://vlr.gg/player/15081/maishiu,2024-07-10 04:30:00,0.38,0.93,0.66,144,121,164,17,6,11,30,17,13,7,3,4,-1,-1,0,58%,44%,70%,103,95,110,25%,36%,20%,3,2,1,4,3,1
436,https://vlr.gg/player/25542/ash999,2024-07-10 04:05:00,0.85,1.27,1.06,221,235,204,34,17,17,37,23,14,16,5,11,+1,+1,0,72%,63%,83%,154,171,136,30%,38%,22%,4,3,1,3,2,1
437,https://vlr.gg/player/35965/yukxx,2024-07-10 04:05:00,1.04,1.01,1.03,227,211,243,39,19,20,39,19,20,8,4,4,-1,0,-1,68%,58%,78%,141,125,158,30%,33%,28%,8,4,4,9,4,5
438,https://vlr.gg/player/10192/chowdy,2024-07-10 04:05:00,0.74,0.99,0.86,145,147,144,25,11,14,35,20,15,19,12,7,0,+1,-1,70%,67%,74%,106,102,110,31%,27%,35%,2,2,0,2,1,1
439,https://vlr.gg/player/35026/chaze,2024-07-10 04:05:00,0.80,0.88,0.84,160,162,159,25,13,12,33,19,14,12,8,4,+1,-2,+3,64%,63%,65%,110,109,110,28%,35%,22%,4,1,3,3,3,0
440,https://vlr.gg/player/32585/n1er,2024-07-10 04:05:00,0.63,0.89,0.76,185,148,225,33,13,20,39,20,19,6,4,2,0,0,0,62%,46%,78%,119,93,147,31%,31%,32%,6,2,4,6,2,4
441,https://vlr.gg/player/13219/papi,2024-07-10 04:05:00,1.44,1.43,1.44,226,240,213,39,19,20,26,14,12,11,6,5,+1,0,+1,83%,83%,83%,141,156,127,32%,38%,27%,2,0,2,1,0,1
442,https://vlr.gg/player/9747/emman,2024-07-10 04:05:00,1.04,1.42,1.24,249,234,264,43,19,24,30,17,13,10,4,6,+1,+1,0,81%,78%,83%,173,148,196,42%,43%,41%,4,2,2,3,1,2
443,https://vlr.gg/player/13220/ja,2024-07-10 04:05:00,1.13,1.15,1.14,272,270,276,44,21,23,34,17,17,8,4,4,+3,+1,+2,72%,57%,88%,171,167,174,34%,46%,25%,9,4,5,6,3,3
444,https://vlr.gg/player/7749/nexi,2024-07-10 04:05:00,0.61,1.12,0.87,174,120,228,29,9,20,34,17,17,17,9,8,-6,-4,-2,83%,78%,88%,121,82,158,30%,29%,30%,1,0,1,7,4,3
445,https://vlr.gg/player/16842/mojer,2024-07-10 04:05:00,0.65,0.89,0.77,176,175,177,28,14,14,32,18,14,7,1,6,0,+1,-1,66%,70%,63%,121,112,130,20%,24%,17%,7,5,2,7,4,3
446,https://vlr.gg/player/23671/mas,2024-07-10 03:00:00,1.18,1.18,1.18,238,189,279,51,21,30,43,17,26,24,11,13,-1,+1,-2,83%,77%,88%,156,126,184,17%,16%,18%,2,2,0,3,1,2
447,https://vlr.gg/player/46046/iceyyy,2024-07-10 03:00:00,1.13,1.07,1.10,263,274,250,59,30,29,50,22,28,11,5,6,0,-3,+3,71%,70%,73%,166,167,164,19%,17%,21%,15,6,9,15,9,6
448,https://vlr.gg/player/9280/padangrice,2024-07-10 03:00:00,1.34,0.85,1.08,190,223,169,44,25,19,40,15,25,20,13,7,+2,+2,0,81%,87%,76%,141,156,128,29%,31%,28%,5,3,2,3,1,2
449,https://vlr.gg/player/46045/aderrr,2024-07-10 03:00:00,0.88,1.08,0.98,193,174,210,42,18,24,46,22,24,20,13,7,-4,0,-4,65%,73%,58%,130,118,141,31%,30%,33%,2,1,1,6,1,5
450,https://vlr.gg/player/8257/limitado,2024-07-10 03:00:00,1.12,0.54,0.81,189,231,155,43,25,18,51,23,28,13,7,6,0,+4,-4,68%,80%,58%,117,140,95,40%,43%,34%,6,5,1,6,1,5
451,https://vlr.gg/player/7805/rizkymd,2024-07-10 03:00:00,1.09,1.22,1.15,237,205,280,51,23,28,47,23,24,42,23,19,-2,-1,-1,78%,79%,77%,153,131,176,26%,20%,32%,4,2,2,6,3,3
452,https://vlr.gg/player/26829/damaraa,2024-07-10 03:00:00,1.21,1.02,1.12,268,311,218,62,37,25,51,27,24,7,4,3,+4,+4,0,71%,76%,67%,163,190,134,26%,32%,19%,10,7,3,6,3,3
453,https://vlr.gg/player/12207/rapheleen,2024-07-10 03:00:00,1.14,0.89,1.02,212,237,192,49,29,20,49,25,24,21,11,10,+6,+6,0,75%,85%,63%,131,142,120,25%,25%,23%,13,9,4,7,3,4
454,https://vlr.gg/player/9278/x-v-y,2024-07-10 03:00:00,1.13,0.62,0.89,177,201,146,40,26,14,44,19,25,10,3,7,-3,0,-3,71%,82%,60%,119,136,101,30%,33%,27%,3,2,1,6,2,4
455,https://vlr.gg/player/11458/kuroza,2024-07-10 03:00:00,0.77,0.68,0.72,139,150,130,28,16,12,48,26,22,29,19,10,-2,-2,0,68%,79%,57%,95,98,91,26%,20%,31%,3,0,3,5,2,3
456,https://vlr.gg/player/25258/lumo,2024-07-10 02:30:00,1.57,1.12,1.37,249,254,247,49,28,21,35,17,18,29,12,17,-1,-1,0,86%,87%,85%,157,167,146,27%,25%,29%,2,1,1,3,2,1
457,https://vlr.gg/player/12979/mrtenzouez,2024-07-10 02:30:00,1.04,1.37,1.19,221,205,240,50,24,26,34,20,14,10,5,5,-5,0,-5,72%,68%,77%,148,139,158,38%,37%,39%,3,2,1,8,2,6
458,https://vlr.gg/player/7745/yoshiii,2024-07-10 02:30:00,0.75,1.35,1.02,220,171,274,42,17,25,40,24,16,14,8,6,+1,-1,+2,79%,74%,85%,144,112,181,36%,27%,45%,8,4,4,7,5,2
459,https://vlr.gg/player/12968/tixx,2024-07-10 02:30:00,0.96,0.85,0.91,160,143,189,34,16,18,36,19,17,26,17,9,-4,-4,0,79%,74%,85%,110,97,125,33%,48%,23%,3,1,2,7,5,2
460,https://vlr.gg/player/20657/yotaa,2024-07-10 02:30:00,0.97,0.80,0.89,208,220,163,37,24,13,40,22,18,12,3,9,+4,+1,+3,74%,68%,81%,133,146,118,22%,29%,12%,10,5,5,6,4,2
461,https://vlr.gg/player/686/tonbo,2024-07-10 02:30:00,1.16,1.07,1.11,193,197,205,39,18,21,35,16,19,15,9,6,-1,-1,0,72%,73%,71%,138,130,146,24%,24%,23%,2,0,2,3,1,2
462,https://vlr.gg/player/20465/biju,2024-07-10 02:30:00,1.19,0.92,1.05,189,243,154,39,21,18,41,20,21,24,15,9,+3,+1,+2,77%,77%,77%,128,164,97,25%,18%,36%,5,2,3,2,1,1
463,https://vlr.gg/player/34776/absol,2024-07-10 02:30:00,0.81,1.20,1.02,214,190,264,47,17,30,45,22,23,14,6,8,+7,+2,+5,72%,73%,71%,141,121,158,19%,16%,23%,14,7,7,7,5,2
464,https://vlr.gg/player/700/million,2024-07-10 02:30:00,0.65,0.98,0.83,178,148,191,32,13,19,45,22,23,29,12,17,-1,-1,0,68%,69%,68%,115,88,137,20%,12%,26%,5,2,3,6,3,3
465,https://vlr.gg/player/1003/reita,2024-07-10 02:30:00,0.58,0.62,0.60,145,164,155,28,14,14,46,23,23,10,3,7,-3,-1,-2,61%,62%,61%,103,101,104,19%,15%,22%,5,2,3,8,3,5
466,https://vlr.gg/player/46135/zeus,2024-07-10 02:00:00,1.30,1.13,1.20,271,283,266,40,18,22,35,14,21,6,1,5,+1,0,+1,74%,94%,58%,178,175,179,29%,31%,28%,7,3,4,6,3,3
467,https://vlr.gg/player/36013/hydrakid,2024-07-10 02:00:00,1.31,0.83,1.03,198,223,184,29,15,14,31,12,19,16,9,7,-4,-3,-1,64%,72%,58%,145,172,125,23%,31%,16%,5,2,3,9,5,4
468,https://vlr.gg/player/44294/eur,2024-07-10 02:00:00,0.69,1.17,0.96,206,176,226,30,11,19,36,16,20,10,5,5,-3,-3,0,67%,72%,63%,137,117,151,40%,37%,42%,0,0,0,3,3,0
469,https://vlr.gg/player/46132/sly,2024-07-10 02:00:00,0.40,0.93,0.70,165,143,182,22,8,14,35,17,18,9,3,6,-3,-2,-1,64%,50%,75%,115,89,135,26%,15%,35%,2,0,2,5,2,3
470,https://vlr.gg/player/11541/xty,2024-07-10 02:00:00,0.72,0.56,0.63,137,168,112,18,9,9,35,16,19,13,7,6,-3,0,-3,60%,89%,38%,86,104,72,21%,18%,23%,1,0,1,4,0,4
471,https://vlr.gg/player/10217/marky,2024-07-10 02:00:00,1.39,1.21,1.32,273,285,252,42,25,17,28,15,13,13,7,6,+7,+3,+4,86%,83%,89%,173,188,153,26%,25%,30%,11,6,5,4,3,1
472,https://vlr.gg/player/7754/xavi8k,2024-07-10 02:00:00,1.13,1.31,1.21,235,233,235,35,19,16,25,15,10,13,11,2,+3,+3,0,86%,92%,78%,161,163,158,23%,22%,23%,5,4,1,2,1,1
473,https://vlr.gg/player/7437/kellys,2024-07-10 02:00:00,1.07,1.20,1.13,212,208,225,35,19,16,28,17,11,21,12,9,0,0,0,88%,96%,78%,135,132,140,25%,26%,24%,2,2,0,2,2,0
474,https://vlr.gg/player/10782/witz,2024-07-10 02:00:00,1.20,0.82,1.04,226,245,206,32,21,11,29,15,14,18,14,4,0,0,0,76%,83%,67%,149,154,143,14%,13%,17%,3,1,2,3,1,2
475,https://vlr.gg/player/2679/dubstep,2024-07-10 02:00:00,0.82,1.16,0.96,190,141,252,28,13,15,29,16,13,19,9,10,+2,-2,+4,81%,79%,83%,116,92,147,30%,34%,27%,6,1,5,4,3,1
476,https://vlr.gg/player/28401/pkm,2024-07-10 02:00:00,0.99,1.25,1.12,236,240,236,56,30,26,43,26,17,11,7,4,+2,-2,+4,71%,61%,81%,147,149,145,24%,33%,16%,10,5,5,8,7,1
477,https://vlr.gg/player/24979/cloy,2024-07-10 02:00:00,0.97,1.19,1.08,181,170,196,43,19,24,39,23,16,19,13,6,+3,+1,+2,82%,70%,94%,122,121,123,40%,42%,38%,6,2,4,3,1,2
478,https://vlr.gg/player/42772/xross,2024-07-10 02:00:00,0.91,1.15,1.03,200,182,217,48,22,26,45,26,19,15,7,8,-3,-3,0,75%,64%,88%,138,129,148,23%,18%,27%,6,2,4,9,5,4
479,https://vlr.gg/player/25048/sid,2024-07-10 02:00:00,0.80,1.23,1.01,238,182,293,53,20,33,51,26,25,17,6,11,+3,+2,+1,72%,73%,72%,157,125,190,26%,21%,31%,9,5,4,6,3,3
480,https://vlr.gg/player/25081/yoman,2024-07-10 02:00:00,0.67,1.07,0.87,162,142,185,36,14,22,43,26,17,24,11,13,0,-1,+1,66%,64%,69%,109,98,120,14%,17%,11%,4,1,3,4,2,2
481,https://vlr.gg/player/985/efina,2024-07-10 02:00:00,1.12,1.31,1.22,233,229,235,50,24,26,44,24,20,15,6,9,+1,+1,0,68%,59%,76%,163,160,167,29%,29%,29%,10,4,6,9,3,6
482,https://vlr.gg/player/5283/bunny,2024-07-10 02:00:00,0.80,1.22,1.01,210,203,221,50,21,29,50,29,21,12,7,5,-4,-4,0,74%,66%,82%,142,142,141,23%,26%,21%,6,2,4,10,6,4
483,https://vlr.gg/player/9783/doenmo,2024-07-10 02:00:00,0.93,1.05,0.99,169,158,184,41,20,21,43,24,19,16,5,11,0,-2,+2,71%,59%,82%,117,111,123,24%,36%,17%,5,2,3,5,4,1
484,https://vlr.gg/player/4827/goddead,2024-07-10 02:00:00,0.59,1.34,0.97,189,124,252,47,13,34,50,27,23,23,9,14,+2,0,+2,72%,56%,88%,121,78,162,27%,18%,32%,5,2,3,3,2,1
485,https://vlr.gg/player/5280/972,2024-07-10 02:00:00,0.58,0.71,0.65,133,128,137,32,15,17,49,28,21,17,9,8,-4,-3,-1,65%,63%,67%,78,76,79,23%,31%,17%,4,2,2,8,5,3
486,https://vlr.gg/player/2139/neptune,2024-07-09 19:10:00,1.14,1.45,1.33,273,228,308,59,20,39,40,15,25,32,10,22,+6,-1,+7,79%,80%,78%,171,148,186,36%,30%,40%,10,0,10,4,1,3
487,https://vlr.gg/player/8375/bones,2024-07-09 19:10:00,0.88,1.59,1.30,262,173,312,52,14,38,35,16,19,21,6,15,+2,-1,+3,84%,72%,92%,170,119,205,17%,21%,15%,9,5,4,7,6,1
488,https://vlr.gg/player/3687/jonaaa6,2024-07-09 19:10:00,1.38,1.20,1.27,215,257,192,50,23,27,33,15,18,16,3,13,+1,0,+1,79%,84%,76%,149,176,131,32%,32%,33%,5,2,3,4,2,2
489,https://vlr.gg/player/2164/paincakes,2024-07-09 19:10:00,1.66,1.01,1.27,270,338,217,59,31,28,45,17,28,26,9,17,+2,+4,-2,79%,84%,76%,161,208,128,29%,39%,22%,11,6,5,9,2,7
490,https://vlr.gg/player/818/mummay,2024-07-09 19:10:00,0.82,1.15,1.02,137,123,152,34,11,23,34,18,16,32,12,20,+1,-1,+2,77%,64%,86%,89,77,97,25%,22%,28%,2,0,2,1,1,0
491,https://vlr.gg/player/260/corey,2024-07-09 19:10:00,1.13,1.12,1.13,228,248,214,49,31,18,47,28,19,10,5,5,+4,+1,+3,66%,70%,60%,161,161,161,23%,22%,25%,12,7,5,8,6,2
492,https://vlr.gg/player/844/bdog,2024-07-09 19:10:00,0.66,1.04,0.81,181,148,230,36,16,20,49,30,19,24,18,6,+1,-1,+2,68%,62%,76%,120,107,139,21%,27%,15%,5,1,4,4,2,2
493,https://vlr.gg/player/1856/wedid,2024-07-09 19:10:00,0.86,0.69,0.78,205,224,204,42,25,17,59,35,24,18,13,5,-3,-3,0,61%,62%,60%,139,139,140,25%,23%,28%,4,2,2,7,5,2
494,https://vlr.gg/player/4931/add3r,2024-07-09 19:10:00,0.62,0.74,0.67,126,119,143,32,17,15,48,30,18,9,5,4,-6,-4,-2,58%,51%,68%,86,85,87,31%,21%,56%,3,2,1,9,6,3
495,https://vlr.gg/player/733/stellar,2024-07-09 19:10:00,0.66,0.61,0.63,142,149,126,28,17,11,51,32,19,21,13,8,-8,-4,-4,65%,65%,64%,95,104,83,20%,19%,20%,1,1,0,9,5,4
496,https://vlr.gg/player/22964/forbanz,2024-07-09 19:10:00,1.14,1.41,1.25,308,279,299,68,38,30,46,27,19,16,11,5,0,-4,+4,74%,68%,81%,188,188,189,25%,25%,25%,11,5,6,11,9,2
497,https://vlr.gg/player/32717/maestr0,2024-07-09 19:10:00,1.10,1.47,1.25,213,176,254,49,24,25,38,20,18,33,13,20,-2,-1,-1,83%,79%,89%,134,126,146,26%,22%,32%,2,0,2,4,1,3
498,https://vlr.gg/player/3450/woddy,2024-07-09 19:10:00,1.34,0.84,1.14,206,242,169,50,32,18,39,20,19,12,8,4,+1,+2,-1,72%,76%,67%,136,155,107,31%,32%,29%,7,6,1,6,4,2
499,https://vlr.gg/player/32718/kenkayyy,2024-07-09 19:10:00,1.17,1.06,1.12,215,232,198,51,32,19,42,23,19,19,8,11,+3,+2,+1,71%,76%,63%,134,141,125,22%,20%,24%,8,6,2,5,4,1
500,https://vlr.gg/player/1607/ntk,2024-07-09 19:10:00,0.95,0.94,0.94,172,157,198,36,21,15,43,22,21,31,12,19,+1,-1,+2,72%,76%,67%,118,103,139,22%,19%,24%,6,1,5,5,2,3
501,https://vlr.gg/player/20240/xenom,2024-07-09 19:10:00,1.19,1.08,1.13,195,229,202,50,23,27,47,19,28,18,6,12,+4,-1,+5,63%,70%,58%,146,165,132,35%,36%,34%,6,0,6,2,1,1
502,https://vlr.gg/player/3424/siduzord,2024-07-09 19:10:00,1.10,1.02,1.05,215,247,203,49,22,27,50,22,28,15,7,8,+2,+1,+1,63%,74%,55%,150,169,137,26%,22%,30%,6,3,3,4,2,2
503,https://vlr.gg/player/13823/pxs,2024-07-09 19:10:00,0.77,0.93,0.86,228,219,238,51,21,30,56,23,33,7,2,5,-3,-3,0,63%,63%,63%,150,137,159,27%,32%,25%,12,5,7,15,8,7
504,https://vlr.gg/player/6202/guuih,2024-07-09 19:10:00,0.97,0.74,0.83,160,204,138,37,21,16,48,20,28,14,6,8,+1,0,+1,58%,59%,58%,117,146,96,24%,24%,24%,6,3,3,5,3,2
505,https://vlr.gg/player/23010/nicksz,2024-07-09 19:10:00,0.47,0.57,0.52,106,109,110,21,9,12,53,23,30,25,11,14,-7,-2,-5,63%,63%,63%,78,83,75,19%,28%,14%,1,0,1,8,2,6
0,https://vlr.gg/player/612/mitch,2024-07-09 16:00:00,1.33,1.32,1.33,237,262,219,51,26,25,35,18,17,38,11,27,+1,+1,0,85%,89%,82%,156,171,144,29%,26%,33%,6,2,4,5,1,4
1,https://vlr.gg/player/11118/skuba,2024-07-09 16:00:00,1.06,1.21,1.14,224,200,240,49,19,30,42,20,22,26,14,12,-2,-1,-1,81%,79%,82%,144,134,152,30%,24%,35%,3,0,3,5,1,4
2,https://vlr.gg/player/454/dapr,2024-07-09 16:00:00,1.05,1.07,1.06,189,208,176,45,22,23,38,20,18,11,5,6,+2,-2,+4,73%,71%,74%,130,145,117,27%,33%,23%,9,5,4,7,7,0
3,https://vlr.gg/player/8419/reduxx,2024-07-09 16:00:00,0.88,1.14,1.02,227,215,232,48,21,27,46,21,25,13,7,6,0,-6,+6,73%,71%,74%,145,133,155,23%,23%,23%,9,1,8,9,7,2
4,https://vlr.gg/player/21668/verno,2024-07-09 16:00:00,1.12,0.94,1.02,170,180,162,38,18,20,36,17,19,20,11,9,+3,+2,+1,79%,79%,79%,112,116,108,34%,45%,26%,6,3,3,3,1,2
5,https://vlr.gg/player/6437/dark3st,2024-07-09 16:00:00,1.02,0.97,0.99,175,169,184,37,20,17,43,22,21,25,9,16,-2,-1,-1,71%,65%,79%,112,106,120,27%,28%,26%,2,1,1,4,2,2
6,https://vlr.gg/player/8397/dip,2024-07-09 16:00:00,0.85,1.12,0.97,173,138,213,34,15,19,43,23,20,20,14,6,0,-1,+1,77%,74%,82%,125,96,161,28%,28%,29%,2,0,2,2,1,1
7,https://vlr.gg/player/16757/cohburg,2024-07-09 16:00:00,0.90,0.88,0.89,175,159,202,40,20,20,46,23,23,24,14,10,-6,-7,+1,61%,59%,64%,111,98,127,27%,30%,24%,4,1,3,10,8,2
8,https://vlr.gg/player/15636/scarn,2024-07-09 16:00:00,0.70,1.07,0.87,194,187,204,41,20,21,49,29,20,11,5,6,-1,-5,+4,68%,68%,68%,135,131,140,20%,19%,21%,10,4,6,11,9,2
9,https://vlr.gg/player/21886/furbsa,2024-07-09 16:00:00,0.91,0.78,0.85,198,206,192,45,26,19,50,28,22,10,3,7,+5,+4,+1,66%,59%,75%,128,131,124,38%,44%,33%,11,6,5,6,2,4
10,https://vlr.gg/player/8873/dgzin,2024-07-09 16:00:00,1.05,1.55,1.31,290,245,331,71,28,43,49,25,24,11,2,9,+14,+4,+10,76%,72%,81%,175,142,204,24%,27%,23%,22,11,11,8,7,1
11,https://vlr.gg/player/1581/guhrvn,2024-07-09 16:00:00,1.08,1.09,1.08,198,184,210,47,22,25,45,21,24,22,10,12,0,0,0,74%,75%,72%,130,122,137,28%,29%,27%,4,3,1,4,3,1
12,https://vlr.gg/player/20238/askia,2024-07-09 16:00:00,1.02,0.84,0.93,175,207,148,42,22,20,48,24,24,27,17,10,0,-1,+1,74%,88%,61%,112,129,97,17%,17%,18%,2,0,2,2,1,1
13,https://vlr.gg/player/660/pancc,2024-07-09 16:00:00,0.60,1.07,0.85,183,123,238,42,13,29,49,24,25,14,6,8,-6,-3,-3,63%,63%,64%,126,86,163,27%,27%,27%,5,1,4,11,4,7
14,https://vlr.gg/player/25743/raafa,2024-07-09 16:00:00,0.88,0.65,0.76,146,174,121,32,18,14,49,23,26,27,17,10,-4,0,-4,69%,75%,64%,94,111,78,17%,18%,15%,3,1,2,7,1,6
15,https://vlr.gg/player/21659/sato,2024-07-09 16:00:00,1.15,1.40,1.27,266,275,258,67,34,33,48,29,19,7,5,2,+3,+2,+1,71%,69%,72%,169,180,157,32%,35%,28%,13,8,5,10,6,4
16,https://vlr.gg/player/1688/rood,2024-07-09 16:00:00,1.21,1.27,1.24,209,211,206,51,28,23,40,22,18,19,7,12,+1,+1,0,72%,72%,72%,138,138,137,18%,26%,11%,4,3,1,3,2,1
17,https://vlr.gg/player/28716/lukxo,2024-07-09 16:00:00,1.14,1.00,1.07,207,226,187,51,30,21,47,26,21,18,10,8,-2,-4,+2,69%,67%,72%,149,170,126,27%,33%,21%,4,0,4,6,4,2
18,https://vlr.gg/player/6238/urango,2024-07-09 16:00:00,0.62,1.14,0.87,204,147,267,47,18,29,52,28,24,22,9,13,+2,-2,+4,71%,64%,78%,132,94,174,18%,21%,16%,10,4,6,8,6,2
19,https://vlr.gg/player/1994/evilkyk,2024-07-09 16:00:00,0.67,0.57,0.62,107,109,108,24,13,11,47,26,21,22,16,6,-8,-1,-7,68%,75%,59%,74,78,70,23%,26%,20%,1,1,0,9,2,7
20,https://vlr.gg/player/6510/atakaptan,2024-07-09 14:00:00,1.66,1.50,1.57,309,313,310,41,20,21,21,10,11,8,2,6,+2,-1,+3,75%,71%,79%,194,186,201,38%,32%,43%,6,1,5,4,2,2
21,https://vlr.gg/player/8369/yetujey,2024-07-09 14:00:00,0.85,1.76,1.33,233,163,290,29,9,20,19,12,7,18,5,13,+2,0,+2,89%,76%,100%,147,108,183,26%,45%,21%,4,1,3,2,1,1
22,https://vlr.gg/player/573/cned,2024-07-09 14:00:00,1.16,1.48,1.33,241,233,250,34,15,19,20,11,9,1,0,1,0,-2,+2,69%,59%,79%,154,142,163,29%,35%,23%,6,3,3,6,5,1
23,https://vlr.gg/player/8044/mrfalin,2024-07-09 14:00:00,0.58,1.68,1.16,155,97,208,20,4,16,17,12,5,24,9,15,-1,-4,+3,69%,41%,95%,99,71,124,14%,10%,17%,3,0,3,4,4,0
24,https://vlr.gg/player/1139/qraxs,2024-07-09 14:00:00,0.39,1.03,0.73,129,95,159,18,7,11,23,13,10,13,2,11,-1,0,-1,75%,59%,89%,89,61,113,26%,32%,24%,0,0,0,1,0,1
25,https://vlr.gg/player/1885/purp0,2024-07-09 14:00:00,0.32,1.73,0.99,185,102,289,24,6,18,27,18,9,8,4,4,-1,-4,+3,58%,47%,71%,125,82,173,43%,30%,49%,5,1,4,6,5,1
26,https://vlr.gg/player/2690/hoody,2024-07-09 14:00:00,0.68,0.96,0.82,184,174,191,22,11,11,27,16,11,7,2,5,+1,-1,+2,69%,68%,71%,111,107,115,38%,38%,37%,4,1,3,3,2,1
27,https://vlr.gg/player/16209/famsii,2024-07-09 14:00:00,0.90,0.71,0.81,160,199,121,18,11,7,28,17,11,9,6,3,0,-1,+1,67%,58%,76%,115,140,86,22%,19%,28%,3,2,1,3,3,0
28,https://vlr.gg/player/4181/cloud,2024-07-09 14:00:00,0.41,1.05,0.71,153,103,212,18,5,13,30,18,12,15,6,9,-2,-1,-1,58%,42%,76%,110,76,148,17%,17%,17%,2,1,1,4,2,2
29,https://vlr.gg/player/292/fit1nho,2024-07-09 14:00:00,0.44,0.73,0.58,141,137,149,18,9,9,30,18,12,6,2,4,0,-2,+2,53%,37%,71%,83,80,85,38%,29%,46%,3,0,3,3,2,1
30,https://vlr.gg/player/44930/nex1sphix,2024-07-09 09:15:00,1.23,1.11,1.17,218,214,230,53,24,29,44,19,25,23,9,14,+3,+1,+2,79%,71%,86%,147,139,153,37%,35%,39%,6,2,4,3,1,2
31,https://vlr.gg/player/40891/be,2024-07-09 09:15:00,1.09,0.91,0.99,181,195,174,47,23,24,45,21,24,19,7,12,0,+2,-2,72%,71%,72%,119,130,109,38%,42%,34%,6,4,2,6,2,4
32,https://vlr.gg/player/46043/answerz,2024-07-09 09:15:00,0.69,1.08,0.90,185,152,216,42,16,26,51,24,27,15,3,12,+4,+1,+3,72%,58%,83%,133,104,159,25%,26%,24%,7,2,5,3,1,2
33,https://vlr.gg/player/40912/123,2024-07-09 09:15:00,0.58,1.12,0.87,205,152,252,47,16,31,53,26,27,11,5,6,-6,-4,-2,72%,65%,78%,135,101,165,27%,26%,28%,6,2,4,12,6,6
34,https://vlr.gg/player/40901/orgil,2024-07-09 09:15:00,0.65,0.63,0.64,150,176,131,32,18,14,53,25,28,28,11,17,-4,-1,-3,61%,61%,61%,98,107,91,28%,37%,18%,7,5,2,11,6,5
35,https://vlr.gg/player/1906/ra1ny,2024-07-09 09:15:00,1.46,1.01,1.25,207,227,191,50,29,21,40,19,21,29,15,14,+3,+2,+1,78%,78%,77%,140,148,130,31%,33%,29%,4,2,2,1,0,1
36,https://vlr.gg/player/37673/yanli,2024-07-09 09:15:00,1.12,1.31,1.21,229,217,240,51,25,26,45,26,19,34,21,13,-2,0,-2,76%,75%,77%,152,148,156,35%,28%,43%,4,2,2,6,2,4
37,https://vlr.gg/player/7861/w1nner,2024-07-09 09:15:00,1.05,1.35,1.19,217,232,204,52,28,24,43,27,16,13,8,5,+5,+3,+2,72%,72%,71%,148,155,139,30%,33%,26%,10,7,3,5,4,1
38,https://vlr.gg/player/10870/secret,2024-07-09 09:15:00,1.21,0.94,1.09,203,216,182,33,21,12,28,17,11,9,5,4,+2,0,+2,72%,71%,74%,132,146,116,29%,40%,18%,4,2,2,2,2,0
39,https://vlr.gg/player/24305/xyus,2024-07-09 09:15:00,0.75,1.10,0.91,211,181,247,47,22,25,47,27,20,12,7,5,-5,-3,-2,61%,64%,58%,137,128,147,21%,30%,14%,11,6,5,16,9,7
40,https://vlr.gg/player/42932/ngk,2024-07-09 09:15:00,0.79,0.89,0.84,154,133,177,13,6,7,18,8,10,10,4,6,0,0,0,88%,83%,92%,100,88,113,23%,17%,29%,2,0,2,2,0,2
41,https://vlr.gg/player/31753/spiritz1,2024-07-09 07:00:00,1.83,0.99,1.44,325,410,230,51,34,17,34,16,18,11,7,4,+1,+3,-2,86%,91%,80%,205,257,145,34%,32%,38%,7,4,3,6,1,5
42,https://vlr.gg/player/46527/cangshu,2024-07-09 07:00:00,1.31,0.62,0.99,209,240,171,29,18,11,34,15,19,15,11,4,+2,+3,-1,63%,70%,55%,146,164,127,34%,41%,24%,5,4,1,3,1,2
43,https://vlr.gg/player/46038/b1ngxun,2024-07-09 07:00:00,0.78,1.07,0.91,183,143,220,27,12,15,30,14,16,12,6,6,-1,-3,+2,72%,78%,65%,121,103,142,33%,31%,35%,2,0,2,3,3,0
44,https://vlr.gg/player/34182/roud,2024-07-09 07:00:00,0.79,0.57,0.69,131,138,117,18,13,5,33,16,17,23,11,12,-3,-1,-2,77%,87%,65%,91,95,85,35%,52%,19%,2,1,1,5,2,3
45,https://vlr.gg/player/34183/rab1q,2024-07-09 07:00:00,0.80,0.42,0.62,143,174,117,22,14,8,37,18,19,7,5,2,-2,+1,-3,60%,74%,45%,91,107,74,20%,23%,17%,4,4,0,6,3,3
46,https://vlr.gg/player/12365/coconut,2024-07-09 07:00:00,1.55,1.10,1.31,232,272,201,36,20,16,26,10,16,15,9,6,+2,+1,+1,72%,80%,65%,164,190,141,28%,24%,35%,3,1,2,1,0,1
47,https://vlr.gg/player/24302/chimei,2024-07-09 07:00:00,1.68,0.68,1.15,200,256,146,29,18,11,27,8,19,21,12,9,+2,+2,0,84%,95%,74%,118,146,94,13%,20%,7%,4,2,2,2,0,2
48,https://vlr.gg/player/24304/kiuuuu,2024-07-09 07:00:00,1.23,1.06,1.14,211,205,215,36,18,18,28,10,18,10,6,4,-2,-1,-1,74%,75%,74%,147,133,159,51%,52%,50%,1,0,1,3,1,2
49,https://vlr.gg/player/37421/riyabtw,2024-07-09 07:00:00,0.90,1.31,1.12,247,191,288,37,14,23,34,15,19,6,3,3,+4,+2,+2,74%,80%,70%,162,133,188,32%,28%,36%,7,4,3,3,2,1
50,https://vlr.gg/player/7851/uta,2024-07-09 07:00:00,1.12,0.47,0.77,195,270,135,30,19,11,32,13,19,7,5,2,-3,+2,-5,70%,85%,57%,137,180,100,25%,27%,23%,8,6,2,11,4,7
51,https://vlr.gg/player/1533/derrek,2024-07-08 17:00:00,1.47,0.87,1.15,196,225,166,49,28,21,46,16,30,24,14,10,+2,0,+2,82%,90%,74%,126,144,110,34%,32%,36%,4,1,3,2,1,1
52,https://vlr.gg/player/826/supamen,2024-07-08 17:00:00,1.21,0.99,1.09,227,228,229,53,24,29,46,19,27,19,13,6,-1,0,-1,70%,74%,66%,136,143,130,39%,44%,35%,5,2,3,6,2,4
53,https://vlr.gg/player/4927/nature,2024-07-08 17:00:00,0.98,1.06,1.02,197,202,193,46,22,24,51,22,29,27,15,12,-1,-1,0,74%,74%,74%,123,122,124,34%,30%,37%,5,2,3,6,3,3
54,https://vlr.gg/player/3993/jawgemo,2024-07-08 17:00:00,0.94,0.53,0.72,194,234,167,41,25,16,57,25,32,16,8,8,-7,-2,-5,56%,61%,51%,135,153,118,21%,20%,23%,9,5,4,16,7,9
55,https://vlr.gg/player/5188/apoth,2024-07-08 17:00:00,0.62,0.81,0.72,156,137,177,34,15,19,50,24,26,19,11,8,-3,-2,-1,64%,58%,69%,112,99,123,36%,40%,34%,5,3,2,8,5,3
56,https://vlr.gg/player/796/eeiu,2024-07-08 17:00:00,1.54,1.07,1.32,242,259,225,57,34,23,41,17,24,30,15,15,+3,+1,+2,83%,86%,81%,161,168,154,34%,37%,31%,4,2,2,1,1,0
57,https://vlr.gg/player/4147/cryocells,2024-07-08 17:00:00,1.19,1.09,1.14,219,248,178,56,35,21,43,23,20,15,10,5,+8,+3,+5,77%,86%,68%,131,142,118,28%,27%,29%,12,7,5,4,4,0
58,https://vlr.gg/player/3880/bang,2024-07-08 17:00:00,0.83,1.43,1.11,216,153,291,50,19,31,43,21,22,26,10,16,-5,-5,0,73%,71%,74%,139,94,190,29%,24%,33%,4,0,4,9,5,4
59,https://vlr.gg/player/601/asuna,2024-07-08 17:00:00,1.26,0.87,1.08,216,260,166,48,33,15,46,24,22,39,21,18,+3,+5,-2,80%,89%,71%,139,162,113,15%,19%,9%,13,9,4,10,4,6
60,https://vlr.gg/player/604/boostio,2024-07-08 17:00:00,0.90,0.72,0.82,177,190,164,39,23,16,50,24,26,24,17,7,+1,+1,0,77%,86%,68%,118,122,114,18%,22%,15%,5,2,3,4,1,3
61,https://vlr.gg/player/24424/pa1ze,2024-07-08 14:00:00,0.96,0.93,0.95,232,227,222,28,16,12,30,16,14,3,0,3,-2,-2,0,62%,65%,59%,155,139,175,34%,31%,38%,5,3,2,7,5,2
62,https://vlr.gg/player/5490/xitsha,2024-07-08 14:00:00,0.71,1.12,0.90,179,142,230,21,9,12,30,15,15,17,8,9,-4,-2,-2,57%,60%,53%,121,92,156,28%,19%,35%,1,1,0,5,3,2
63,https://vlr.gg/player/8593/grmekista,2024-07-08 14:00:00,1.07,0.66,0.88,156,180,129,19,12,7,29,14,15,12,7,5,+2,+1,+1,51%,50%,53%,100,119,78,31%,40%,19%,5,3,2,3,2,1
64,https://vlr.gg/player/34684/westside,2024-07-08 14:00:00,0.68,0.80,0.73,165,142,197,20,10,10,31,16,15,5,3,2,+1,-2,+3,57%,50%,65%,117,97,140,47%,50%,45%,4,0,4,3,2,1
65,https://vlr.gg/player/3839/prti,2024-07-08 14:00:00,0.88,0.38,0.64,122,160,80,15,10,5,31,16,15,8,4,4,-4,-1,-3,54%,65%,41%,81,106,53,22%,27%,15%,0,0,0,4,1,3
66,https://vlr.gg/player/5554/profek,2024-07-08 14:00:00,2.24,1.03,1.59,256,319,210,38,23,15,18,5,13,14,6,8,+3,+1,+2,81%,94%,70%,177,240,124,27%,31%,21%,4,1,3,1,0,1
67,https://vlr.gg/player/562/zeek,2024-07-08 14:00:00,1.41,1.35,1.38,211,223,203,31,15,16,18,8,10,20,9,11,+1,0,+1,86%,88%,85%,137,146,129,21%,31%,15%,2,0,2,1,0,1
68,https://vlr.gg/player/1155/buld,2024-07-08 14:00:00,0.85,1.43,1.16,245,162,316,33,11,22,22,10,12,8,2,6,+5,+2,+3,78%,71%,85%,157,103,203,17%,27%,13%,9,3,6,4,1,3
69,https://vlr.gg/player/23169/minny,2024-07-08 14:00:00,1.09,0.96,1.02,186,243,139,25,14,11,19,9,10,5,2,3,-1,0,-1,76%,71%,80%,124,152,100,33%,32%,34%,3,3,0,4,3,1
70,https://vlr.gg/player/25906/alexiiik,2024-07-08 14:00:00,0.67,0.83,0.76,184,190,171,24,11,13,26,14,12,6,4,2,-1,-2,+1,73%,71%,75%,113,120,107,27%,32%,22%,4,2,2,5,4,1
71,https://vlr.gg/player/4894/jn3v1ce,2024-07-08 12:30:00,1.71,0.71,1.16,235,337,160,33,21,12,31,12,19,12,8,4,0,+1,-1,65%,83%,50%,152,220,95,31%,38%,21%,3,2,1,3,1,2
72,https://vlr.gg/player/1401/sasuke,2024-07-08 12:30:00,0.80,0.92,0.86,165,137,189,21,9,12,31,14,17,17,7,10,+3,-1,+4,65%,67%,64%,107,87,123,26%,27%,25%,5,0,5,2,1,1
73,https://vlr.gg/player/18657/wasp,2024-07-08 12:30:00,0.59,1.01,0.82,205,161,238,25,9,16,34,16,18,13,7,6,0,+1,-1,65%,67%,64%,142,108,170,44%,47%,43%,5,3,2,5,2,3
74,https://vlr.gg/player/3604/mojj,2024-07-08 12:30:00,0.74,0.56,0.64,122,152,93,17,10,7,30,14,16,7,3,4,-4,-3,-1,55%,61%,50%,87,104,74,29%,42%,20%,1,1,0,5,4,1
75,https://vlr.gg/player/15735/krostaly,2024-07-08 12:30:00,0.65,0.56,0.60,169,175,162,21,10,11,39,17,22,7,3,4,-1,0,-1,60%,56%,64%,117,126,109,35%,38%,32%,5,2,3,6,2,4
76,https://vlr.gg/player/10160/izzy,2024-07-08 12:30:00,1.21,1.64,1.40,297,236,363,45,21,24,26,14,12,5,5,0,+4,0,+4,78%,73%,83%,188,152,233,31%,25%,38%,9,4,5,5,4,1
77,https://vlr.gg/player/3557/skylen,2024-07-08 12:30:00,1.35,1.46,1.40,262,243,283,39,19,20,23,12,11,8,5,3,+2,+1,+1,83%,77%,89%,172,160,188,41%,28%,61%,4,3,1,2,2,0
78,https://vlr.gg/player/1399/sterben,2024-07-08 12:30:00,1.72,0.87,1.34,232,297,161,34,25,9,20,8,12,13,5,8,-1,0,-1,83%,86%,78%,156,197,106,29%,32%,22%,4,2,2,5,2,3
79,https://vlr.gg/player/5510/oxmann,2024-07-08 12:30:00,1.10,1.03,1.07,205,207,207,29,16,13,23,11,12,9,5,4,0,0,0,75%,82%,67%,142,140,144,42%,42%,42%,1,0,1,1,0,1
80,https://vlr.gg/player/556/souhcni,2024-07-08 12:30:00,0.86,0.56,0.72,126,146,102,18,11,7,25,13,12,10,7,3,-3,-1,-2,73%,73%,72%,84,98,67,22%,23%,20%,3,2,1,6,3,3
81,https://vlr.gg/player/42702/krizz,2024-07-08 11:00:00,1.14,1.26,1.21,219,227,217,57,29,28,47,26,21,10,6,4,+6,+3,+3,76%,63%,89%,149,145,153,24%,24%,23%,8,4,4,2,1,1
82,https://vlr.gg/player/2696/ajmerito,2024-07-08 11:00:00,1.03,0.99,1.01,203,195,182,46,25,21,49,25,24,28,11,17,-4,-3,-1,67%,63%,70%,120,117,123,25%,22%,30%,6,2,4,10,5,5
83,https://vlr.gg/player/2656/snikk,2024-07-08 11:00:00,0.67,1.30,0.99,193,149,221,49,19,30,50,28,22,25,9,16,0,0,0,68%,60%,76%,130,104,154,34%,25%,41%,4,0,4,4,0,4
84,https://vlr.gg/player/10378/almo,2024-07-08 11:00:00,0.88,1.07,0.98,205,205,226,53,24,29,53,30,23,14,7,7,0,-1,+1,64%,57%,70%,142,134,151,20%,22%,18%,10,5,5,10,6,4
85,https://vlr.gg/player/2669/kenobi,2024-07-08 11:00:00,0.38,1.09,0.75,174,125,212,41,13,28,56,31,25,19,9,10,-2,-6,+4,65%,60%,70%,112,81,142,25%,30%,22%,8,3,5,10,9,1
86,https://vlr.gg/player/39682/wanzeru,2024-07-08 11:00:00,0.76,1.50,1.12,248,195,312,63,23,40,53,31,22,10,5,5,+3,-2,+5,69%,65%,74%,161,132,192,26%,26%,25%,17,9,8,14,11,3
87,https://vlr.gg/player/33732/nunmeister,2024-07-08 11:00:00,1.13,1.08,1.10,220,217,214,55,28,27,48,24,24,33,15,18,-1,+1,-2,71%,68%,74%,139,140,139,25%,26%,24%,7,5,2,8,4,4
88,https://vlr.gg/player/15064/kajuks,2024-07-08 11:00:00,0.98,1.24,1.10,203,198,234,51,23,28,48,27,21,35,14,21,+1,-2,+3,75%,73%,77%,134,132,136,26%,25%,28%,6,1,5,5,3,2
89,https://vlr.gg/player/10448/kozok,2024-07-08 11:00:00,1.00,1.18,1.09,207,189,217,54,25,29,47,27,20,12,9,3,-4,-2,-2,71%,76%,66%,136,126,147,24%,24%,23%,2,0,2,6,2,4
90,https://vlr.gg/player/259/arch,2024-07-08 11:00:00,0.61,0.86,0.73,134,120,150,31,15,16,50,28,22,23,12,11,+1,-2,+3,65%,54%,77%,99,88,111,23%,26%,21%,4,0,4,3,2,1
91,https://vlr.gg/player/10137/ip0tt,2024-07-08 10:30:00,1.19,2.13,1.67,325,221,422,40,13,27,19,9,10,12,8,4,+4,0,+4,86%,88%,83%,208,149,264,30%,22%,38%,6,1,5,2,1,1
92,https://vlr.gg/player/4962/lurzy0y0,2024-07-08 10:30:00,1.24,1.32,1.28,209,210,209,29,13,16,19,9,10,8,5,3,+1,-1,+2,74%,71%,78%,128,133,124,31%,31%,30%,4,1,3,3,2,1
93,https://vlr.gg/player/6559/destruct1vee,2024-07-08 10:30:00,1.68,0.57,1.11,197,310,90,26,21,5,19,7,12,12,5,7,0,+1,-1,71%,88%,56%,121,177,68,27%,30%,22%,3,3,0,3,2,1
94,https://vlr.gg/player/7353/glovee,2024-07-08 10:30:00,1.30,0.88,1.09,178,173,185,19,9,10,18,6,12,14,8,6,0,+1,-1,80%,82%,78%,124,113,135,32%,35%,30%,1,1,0,1,0,1
95,https://vlr.gg/player/5517/masic,2024-07-08 10:30:00,0.90,1.01,0.96,158,128,188,20,9,11,16,7,9,5,1,4,+2,+2,0,77%,76%,78%,103,87,117,15%,22%,9%,7,4,3,5,2,3
96,https://vlr.gg/player/19776/jrayn,2024-07-08 10:30:00,0.98,0.62,0.81,173,187,158,20,12,8,27,13,14,8,3,5,0,0,0,63%,67%,59%,112,114,110,25%,23%,28%,2,1,1,2,1,1
97,https://vlr.gg/player/5564/deadink,2024-07-08 10:30:00,0.68,0.93,0.80,162,149,178,18,8,10,25,13,12,4,4,0,-2,-3,+1,66%,67%,65%,114,109,118,14%,15%,13%,4,1,3,6,4,2
98,https://vlr.gg/player/5563/cacan,2024-07-08 10:30:00,0.94,0.44,0.70,183,204,158,21,13,8,29,14,15,3,3,0,-2,0,-2,54%,67%,41%,116,128,104,27%,20%,44%,4,1,3,6,1,5
99,https://vlr.gg/player/12226/sturnn,2024-07-08 10:30:00,0.61,0.69,0.64,116,113,123,14,7,7,24,13,11,6,3,3,-3,-2,-1,54%,56%,53%,84,73,95,22%,22%,21%,1,1,0,4,3,1
100,https://vlr.gg/player/31307/yigox,2024-07-08 10:30:00,0.68,0.46,0.58,143,196,83,18,13,5,29,16,13,2,0,2,0,+1,-1,54%,61%,47%,84,121,45,32%,32%,31%,3,3,0,3,2,1
101,https://vlr.gg/player/4545/sayaplayer,2024-07-08 04:00:00,1.09,1.37,1.23,229,224,232,59,31,28,43,28,15,11,2,9,+3,-1,+4,79%,68%,91%,155,155,156,33%,33%,32%,10,4,6,7,5,2
102,https://vlr.gg/player/485/stax,2024-07-08 04:00:00,1.00,1.27,1.13,214,192,239,49,23,26,44,24,20,36,15,21,-1,-1,0,84%,74%,94%,131,113,149,28%,27%,29%,2,0,2,3,1,2
103,https://vlr.gg/player/29833/izu,2024-07-08 04:00:00,0.70,1.40,1.04,255,220,287,54,22,32,52,33,19,15,7,8,+7,-1,+8,73%,68%,79%,162,145,179,18%,20%,16%,13,3,10,6,4,2
104,https://vlr.gg/player/31207/carpe,2024-07-08 04:00:00,0.77,1.06,0.92,204,195,218,48,21,27,51,30,21,27,13,14,0,0,0,76%,74%,79%,127,117,138,26%,29%,24%,8,5,3,8,5,3
105,https://vlr.gg/player/10816/xccurate,2024-07-08 04:00:00,0.60,1.23,0.91,164,147,186,41,15,26,45,29,16,31,19,12,-8,-5,-3,76%,65%,88%,107,94,121,20%,17%,23%,1,1,0,9,6,3
106,https://vlr.gg/player/4382/sscary,2024-07-08 04:00:00,1.08,1.26,1.17,221,207,237,53,24,29,47,26,21,30,12,18,+2,0,+2,78%,70%,85%,148,133,163,31%,31%,32%,3,0,3,1,0,1
107,https://vlr.gg/player/9152/deryeon,2024-07-08 04:00:00,0.77,1.37,1.07,247,216,275,57,22,35,53,30,23,14,6,8,-2,-4,+2,66%,52%,79%,157,134,179,32%,37%,27%,11,7,4,13,11,2
108,https://vlr.gg/player/2361/retla,2024-07-08 04:00:00,0.87,1.08,0.97,182,155,207,46,18,28,48,26,22,12,5,7,-1,0,-1,67%,52%,82%,121,113,129,27%,35%,22%,4,2,2,5,2,3
109,https://vlr.gg/player/772/zest,2024-07-08 04:00:00,0.62,1.07,0.85,171,117,224,40,14,26,50,27,23,17,8,9,+8,+1,+7,67%,55%,79%,111,75,145,32%,27%,34%,9,2,7,1,1,0
110,https://vlr.gg/player/1430/crazyguy,2024-07-08 04:00:00,0.45,1.09,0.77,169,117,217,39,13,26,53,30,23,24,10,14,-8,-6,-2,64%,52%,76%,115,82,146,21%,28%,18%,6,1,5,14,7,7
111,https://vlr.gg/player/4164/s0m,2024-07-07 19:15:00,1.55,0.85,1.25,243,297,176,56,38,18,40,20,20,29,16,13,+2,+2,0,77%,84%,68%,152,186,108,25%,26%,22%,7,4,3,5,2,3
112,https://vlr.gg/player/11225/ethan,2024-07-07 19:15:00,1.41,0.81,1.15,199,238,141,45,31,14,41,22,19,33,22,11,-2,-1,-1,78%,86%,68%,127,158,87,24%,29%,16%,2,1,1,4,2,2
113,https://vlr.gg/player/817/finesse,2024-07-07 19:15:00,0.84,1.19,0.99,203,177,238,45,24,21,48,26,22,28,10,18,+5,+2,+3,74%,73%,75%,132,110,160,17%,20%,15%,7,4,3,2,2,0
114,https://vlr.gg/player/261/victor,2024-07-07 19:15:00,0.80,1.09,0.92,209,166,255,48,22,26,46,26,20,10,5,5,+2,-1,+3,71%,76%,64%,129,112,153,23%,24%,22%,15,9,6,13,10,3
115,https://vlr.gg/player/4/crashies,2024-07-07 19:15:00,0.81,0.98,0.88,170,146,202,37,18,19,42,22,20,22,13,9,-4,-3,-1,80%,81%,79%,110,90,136,25%,20%,30%,3,0,3,7,3,4
116,https://vlr.gg/player/18796/oxy,2024-07-07 19:15:00,1.12,1.32,1.23,265,257,290,64,26,38,52,23,29,10,3,7,+3,+1,+2,75%,75%,76%,175,162,185,26%,34%,22%,13,7,6,10,6,4
117,https://vlr.gg/player/7870/vanity,2024-07-07 19:15:00,1.20,0.91,1.03,210,203,227,49,20,29,46,17,29,20,10,10,-2,-2,0,77%,79%,76%,146,144,146,23%,23%,23%,8,2,6,10,4,6
118,https://vlr.gg/player/7458/moose,2024-07-07 19:15:00,1.13,0.75,0.91,156,193,139,36,19,17,41,17,24,10,4,6,+4,0,+4,69%,75%,65%,109,127,95,21%,24%,19%,6,1,5,2,1,1
119,https://vlr.gg/player/7871/xeppaa,2024-07-07 19:15:00,0.86,0.81,0.83,165,167,148,31,17,14,45,19,26,22,6,16,-5,-2,-3,74%,79%,70%,105,101,108,25%,33%,22%,2,0,2,7,2,5
120,https://vlr.gg/player/16003/runi,2024-07-07 19:15:00,0.88,0.77,0.82,153,188,135,37,19,18,47,22,25,16,10,6,-3,-1,-2,65%,71%,59%,104,115,95,33%,44%,25%,2,2,0,5,3,2
121,https://vlr.gg/player/5957/artzin,2024-07-07 17:00:00,1.51,0.95,1.26,259,290,224,42,27,15,31,16,15,4,3,1,+2,-1,+3,63%,58%,68%,168,188,142,33%,28%,43%,6,3,3,4,4,0
122,https://vlr.gg/player/11105/rich,2024-07-07 17:00:00,0.94,0.78,0.87,212,208,216,31,16,15,36,20,16,13,9,4,-3,-1,-2,74%,79%,68%,129,130,127,29%,34%,24%,4,1,3,7,2,5
123,https://vlr.gg/player/15681/palla,2024-07-07 17:00:00,0.52,0.98,0.72,201,175,234,27,13,14,36,21,15,5,1,4,-4,-3,-1,58%,42%,79%,128,110,149,26%,36%,17%,5,3,2,9,6,3
124,https://vlr.gg/player/2567/liazzi,2024-07-07 17:00:00,0.52,0.87,0.68,139,102,193,21,8,13,34,20,14,11,7,4,-3,-3,0,58%,42%,79%,92,76,112,39%,35%,42%,0,0,0,3,3,0
125,https://vlr.gg/player/8872/mazin,2024-07-07 17:00:00,0.26,0.86,0.52,116,64,182,17,4,13,34,20,14,7,3,4,+3,0,+3,60%,50%,74%,82,51,121,31%,29%,31%,4,1,3,1,1,0
126,https://vlr.gg/player/1711/khalil,2024-07-07 17:00:00,1.61,1.67,1.65,292,323,264,47,23,24,26,14,12,16,9,7,+3,+1,+2,86%,89%,83%,192,205,182,34%,24%,44%,4,1,3,1,0,1
127,https://vlr.gg/player/8706/havoc,2024-07-07 17:00:00,1.62,0.89,1.21,226,285,185,35,20,15,26,10,16,10,4,6,0,-2,+2,65%,79%,54%,159,191,133,34%,35%,33%,7,3,4,7,5,2
128,https://vlr.gg/player/939/mwzera,2024-07-07 17:00:00,0.30,1.74,1.11,252,137,341,38,8,30,30,18,12,10,3,7,+3,-1,+4,77%,53%,96%,164,87,225,25%,32%,22%,8,3,5,5,4,1
129,https://vlr.gg/player/681/xand,2024-07-07 17:00:00,0.91,1.02,0.97,177,190,173,28,13,15,30,15,15,22,8,14,0,0,0,79%,74%,83%,118,124,113,21%,29%,16%,4,1,3,4,1,3
130,https://vlr.gg/player/725/nzr,2024-07-07 17:00:00,0.87,0.99,0.94,153,138,158,23,10,13,26,13,13,10,5,5,-1,-1,0,74%,68%,79%,111,106,114,21%,19%,23%,1,0,1,2,1,1
131,https://vlr.gg/player/440/akumaaaaa,2024-07-07 14:45:00,1.47,1.28,1.36,293,281,292,68,30,38,50,21,29,27,16,11,+5,+2,+3,74%,81%,69%,182,175,188,39%,40%,38%,11,3,8,6,1,5
132,https://vlr.gg/player/13439/soon,2024-07-07 14:45:00,1.46,1.10,1.26,189,227,153,35,20,15,25,12,13,18,7,11,-3,-1,-2,84%,82%,85%,139,163,119,38%,43%,33%,1,1,0,4,2,2
133,https://vlr.gg/player/2621/goaster,2024-07-07 14:45:00,1.04,1.22,1.15,229,247,219,31,13,18,26,12,14,7,1,6,+5,+3,+2,73%,75%,71%,162,157,165,26%,45%,16%,9,6,3,4,3,1
134,https://vlr.gg/player/2098/thebigfiz,2024-07-07 14:45:00,1.12,1.09,1.10,203,188,212,52,21,31,43,17,26,24,11,13,+2,-2,+4,76%,74%,77%,122,116,127,21%,28%,18%,6,0,6,4,2,2
135,https://vlr.gg/player/13258/cyvoph,2024-07-07 14:45:00,0.75,1.21,0.99,245,204,287,44,17,27,39,20,19,6,3,3,-2,-3,+1,76%,75%,78%,161,132,187,26%,27%,25%,8,3,5,10,6,4
136,https://vlr.gg/player/113/hyp,2024-07-07 14:45:00,0.82,0.70,0.75,118,126,122,28,13,15,44,19,25,21,11,10,-3,0,-3,71%,84%,62%,84,79,89,18%,16%,19%,2,2,0,5,2,3
137,https://vlr.gg/player/8217/memset,2024-07-07 14:45:00,1.44,1.00,1.24,239,261,213,64,39,25,46,25,21,8,4,4,+3,+3,0,73%,79%,65%,161,181,135,35%,38%,29%,5,4,1,2,1,1
138,https://vlr.gg/player/2114/kinguyen,2024-07-07 14:45:00,0.92,0.99,0.95,197,203,220,50,26,24,52,29,23,14,11,3,-1,-3,+2,74%,67%,84%,140,138,143,27%,32%,23%,14,6,8,15,9,6
139,https://vlr.gg/player/1387/apo,2024-07-07 14:45:00,0.93,0.81,0.88,176,190,158,43,26,17,53,30,23,24,15,9,+1,-1,+2,69%,72%,65%,122,133,110,34%,28%,47%,4,1,3,3,2,1
140,https://vlr.gg/player/12579/darklight,2024-07-07 14:45:00,0.89,0.85,0.87,171,160,180,40,22,18,50,27,23,19,12,7,-2,-3,+1,71%,77%,65%,113,112,115,19%,18%,22%,4,1,3,6,4,2
141,https://vlr.gg/player/11322/sevire,2024-07-07 14:45:00,0.48,0.65,0.55,132,117,153,30,13,17,57,33,24,24,18,6,-5,-1,-4,64%,72%,55%,86,75,99,29%,21%,39%,6,5,1,11,6,5
142,https://vlr.gg/player/9508/leosen,2024-07-07 14:40:00,0.99,1.57,1.27,248,205,296,67,27,40,49,30,19,12,7,5,-1,-4,+3,73%,68%,77%,171,137,208,27%,17%,38%,12,5,7,13,9,4
143,https://vlr.gg/player/7865/xanarchy,2024-07-07 14:40:00,1.20,1.18,1.19,204,197,213,56,28,28,46,26,20,27,19,8,+2,-3,+5,78%,76%,80%,130,127,135,31%,30%,33%,5,0,5,3,3,0
144,https://vlr.gg/player/122/luckerrr,2024-07-07 14:40:00,0.68,1.13,0.90,199,198,209,49,24,25,52,33,19,15,7,8,+4,+1,+3,78%,76%,80%,131,130,133,20%,19%,22%,9,4,5,5,3,2
145,https://vlr.gg/player/30750/enes,2024-07-07 14:40:00,0.71,1.03,0.86,173,149,199,43,19,24,57,34,23,32,21,11,0,-2,+2,63%,58%,69%,108,91,127,21%,16%,25%,7,3,4,7,5,2
146,https://vlr.gg/player/4969/shazeon,2024-07-07 14:40:00,0.98,0.74,0.86,159,177,136,41,24,17,51,28,23,19,12,7,-6,-2,-4,68%,68%,69%,106,112,99,30%,34%,25%,3,2,1,9,4,5
147,https://vlr.gg/player/1616/starki,2024-07-07 14:40:00,1.05,1.21,1.13,232,219,248,57,24,33,51,26,25,26,16,10,+1,0,+1,77%,71%,82%,149,137,160,28%,22%,33%,6,2,4,5,2,3
148,https://vlr.gg/player/7660/fizzy,2024-07-07 14:40:00,0.81,1.38,1.11,228,167,285,60,22,38,50,27,23,15,6,9,+2,+1,+1,74%,63%,84%,146,103,185,33%,34%,32%,9,4,5,7,3,4
149,https://vlr.gg/player/3674/iluri,2024-07-07 14:40:00,0.97,1.07,1.02,178,188,182,46,23,23,48,26,22,27,9,18,-3,-3,0,70%,57%,82%,122,126,117,44%,43%,45%,5,2,3,8,5,3
150,https://vlr.gg/player/3753/obnoks,2024-07-07 14:40:00,1.07,0.81,0.93,183,186,183,48,23,25,50,23,27,14,7,7,0,-2,+2,70%,63%,76%,122,124,120,27%,25%,29%,5,0,5,5,2,3
151,https://vlr.gg/player/2658/xuss,2024-07-07 14:40:00,0.37,1.01,0.71,166,125,211,43,12,31,57,32,25,11,7,4,+1,-5,+6,67%,54%,79%,117,87,144,15%,20%,12%,12,5,7,11,10,1
152,https://vlr.gg/player/8808/pyrolll,2024-07-07 14:20:00,1.13,1.68,1.42,249,199,296,59,22,37,37,23,14,21,9,12,-1,-3,+2,71%,53%,86%,163,126,196,29%,30%,29%,6,1,5,7,4,3
153,https://vlr.gg/player/321/chiwa,2024-07-07 14:20:00,0.83,1.60,1.24,227,171,274,56,17,39,39,24,15,15,6,9,0,-1,+1,75%,66%,83%,152,125,176,30%,36%,27%,1,0,1,1,1,0
154,https://vlr.gg/player/32351/cullumx,2024-07-07 14:20:00,0.69,1.17,0.94,185,132,220,43,15,28,45,25,20,22,7,15,0,-4,+4,68%,53%,81%,123,89,154,34%,21%,45%,9,3,6,9,7,2
155,https://vlr.gg/player/1374/alive,2024-07-07 14:20:00,0.78,1.06,0.92,172,162,183,42,17,25,46,25,21,8,5,3,+6,-2,+8,71%,50%,89%,122,111,132,25%,28%,21%,13,2,11,7,4,3
156,https://vlr.gg/player/4325/musashi,2024-07-07 14:20:00,0.73,0.99,0.87,189,166,207,44,18,26,48,26,22,15,4,11,-5,-2,-3,68%,56%,78%,132,114,149,31%,47%,24%,5,4,1,10,6,4
157,https://vlr.gg/player/29575/luckymrj,2024-07-07 14:20:00,1.14,1.04,1.09,209,236,173,50,31,19,45,29,16,19,5,14,+3,+1,+2,75%,69%,81%,133,145,120,29%,31%,27%,7,2,5,4,1,3
158,https://vlr.gg/player/21216/f4ngeer,2024-07-07 14:20:00,0.70,1.47,1.06,222,173,293,56,20,36,50,32,18,13,9,4,+2,-4,+6,71%,67%,75%,147,112,187,27%,28%,27%,15,7,8,13,11,2
159,https://vlr.gg/player/4537/tajrex,2024-07-07 14:20:00,0.45,1.39,0.89,179,97,277,45,12,33,50,31,19,8,4,4,-3,-7,+4,65%,50%,81%,123,75,177,28%,28%,28%,8,2,6,11,9,2
160,https://vlr.gg/player/21609/danda,2024-07-07 14:20:00,0.61,1.00,0.80,160,136,186,37,16,21,51,32,19,21,11,10,0,-1,+1,65%,56%,75%,95,82,110,25%,25%,25%,3,1,2,3,2,1
161,https://vlr.gg/player/29742/anxios,2024-07-07 14:20:00,0.53,0.83,0.67,124,117,130,27,13,14,48,31,17,22,9,13,-2,-1,-1,63%,56%,72%,81,82,79,18%,14%,25%,1,0,1,3,1,2
162,https://vlr.gg/player/20144/lewn,2024-07-07 13:40:00,1.02,1.28,1.15,252,223,282,43,20,23,35,17,18,1,1,0,+3,0,+3,66%,63%,70%,155,138,173,42%,40%,44%,12,8,4,9,8,1
163,https://vlr.gg/player/10152/padisah,2024-07-07 13:40:00,1.20,0.67,0.94,173,199,147,29,18,11,33,15,18,5,3,2,-2,0,-2,60%,71%,48%,111,121,101,22%,17%,29%,3,1,2,5,1,4
164,https://vlr.gg/player/10163/cyderx,2024-07-07 13:40:00,0.76,0.99,0.87,161,132,191,25,9,16,32,17,15,13,11,2,-3,-1,-2,70%,71%,70%,107,96,120,43%,41%,44%,0,0,0,3,1,2
165,https://vlr.gg/player/3549/touven,2024-07-07 13:40:00,0.98,0.46,0.73,139,180,98,22,15,7,33,16,17,13,6,7,-5,-1,-4,66%,79%,52%,90,117,62,22%,17%,32%,3,1,2,8,2,6
166,https://vlr.gg/player/5500/docent,2024-07-07 13:40:00,0.75,0.62,0.69,158,165,154,22,11,11,38,18,20,20,13,7,0,0,0,70%,75%,65%,105,110,100,28%,29%,26%,2,1,1,2,1,1
167,https://vlr.gg/player/12226/sturnn,2024-07-07 13:40:00,1.45,0.91,1.17,199,245,155,36,22,14,25,12,13,12,7,5,+1,+1,0,79%,70%,88%,129,151,109,30%,25%,38%,1,1,0,0,0,0
168,https://vlr.gg/player/31307/yigox,2024-07-07 13:40:00,1.11,1.08,1.10,207,227,185,34,18,16,28,14,14,10,4,6,+2,+3,-1,72%,74%,71%,132,141,123,35%,35%,36%,7,5,2,5,2,3
169,https://vlr.gg/player/5564/deadink,2024-07-07 13:40:00,0.97,1.14,1.06,234,206,264,38,17,21,31,15,16,7,3,4,+4,0,+4,72%,65%,79%,147,129,163,17%,27%,9%,12,5,7,8,5,3
170,https://vlr.gg/player/19776/jrayn,2024-07-07 13:40:00,0.94,1.08,1.01,169,150,187,31,14,17,28,14,14,14,8,6,-2,-2,0,74%,65%,83%,109,97,120,34%,48%,27%,0,0,0,2,2,0
171,https://vlr.gg/player/5563/cacan,2024-07-07 13:40:00,1.17,0.79,0.98,186,198,177,32,17,15,29,13,16,9,7,2,+2,+3,-1,74%,87%,63%,115,116,114,27%,24%,31%,7,3,4,5,0,5
172,https://vlr.gg/player/7104/juseu,2024-07-07 12:00:00,1.17,1.65,1.48,285,229,309,58,17,41,36,15,21,5,1,4,+5,-2,+7,80%,65%,89%,170,127,193,25%,29%,24%,11,2,9,6,4,2
173,https://vlr.gg/player/3579/marctylinho,2024-07-07 12:00:00,0.78,1.33,1.14,233,166,248,46,13,33,39,17,22,20,3,17,+1,-1,+2,66%,60%,69%,140,109,157,23%,23%,22%,3,0,3,2,1,1
174,https://vlr.gg/player/6828/pa1ka,2024-07-07 12:00:00,0.63,1.29,1.04,194,149,232,37,8,29,38,18,20,18,4,14,-3,-4,+1,66%,50%,75%,134,111,147,38%,41%,35%,6,1,5,9,5,4
175,https://vlr.gg/player/2525/szimpli,2024-07-07 12:00:00,1.01,1.04,1.03,202,255,189,41,16,25,43,18,25,13,4,9,-1,-2,+1,73%,70%,75%,142,161,132,31%,32%,29%,6,2,4,7,4,3
176,https://vlr.gg/player/2841/foxie,2024-07-07 12:00:00,0.45,0.74,0.64,131,109,126,23,7,16,38,17,21,15,3,12,-2,-1,-1,68%,60%,72%,82,83,82,23%,24%,22%,2,0,2,4,1,3
177,https://vlr.gg/player/257/bramz,2024-07-07 12:00:00,0.83,1.39,1.03,217,203,258,44,26,18,38,29,9,7,3,4,+1,-1,+2,79%,72%,90%,139,128,158,25%,26%,24%,6,3,3,5,4,1
178,https://vlr.gg/player/3769/killu,2024-07-07 12:00:00,0.88,1.09,0.94,195,192,199,38,23,15,41,29,12,20,11,9,+2,+2,0,70%,69%,70%,123,123,125,23%,22%,24%,3,2,1,1,0,1
179,https://vlr.gg/player/9135/oniby,2024-07-07 12:00:00,0.75,1.26,0.94,190,162,264,39,19,20,41,28,13,19,12,7,-1,-5,+4,64%,56%,80%,131,117,156,36%,44%,29%,5,0,5,6,5,1
180,https://vlr.gg/player/219/tidus,2024-07-07 12:00:00,0.76,0.93,0.82,154,151,171,36,22,14,40,27,13,10,4,6,-2,-2,0,71%,67%,80%,101,93,115,31%,35%,27%,1,0,1,3,2,1
181,https://vlr.gg/player/7173/soren,2024-07-07 12:00:00,0.51,1.06,0.71,184,164,234,37,19,18,45,31,14,4,2,2,0,-4,+4,59%,50%,75%,115,104,135,39%,38%,41%,13,8,5,13,12,1
182,https://vlr.gg/player/11013/balli,2024-07-07 12:00:00,1.13,1.34,1.23,221,209,234,54,27,27,44,25,19,24,11,13,+3,-1,+4,77%,78%,76%,152,151,153,42%,34%,50%,7,2,5,4,3,1
183,https://vlr.gg/player/10375/braso,2024-07-07 12:00:00,0.85,1.40,1.12,242,171,319,60,21,39,51,27,24,15,8,7,+7,+2,+5,66%,53%,79%,158,116,202,34%,33%,35%,12,4,8,5,2,3
184,https://vlr.gg/player/33627/dok,2024-07-07 12:00:00,0.93,1.01,0.97,174,171,181,41,20,21,46,25,21,36,14,22,-6,-4,-2,74%,75%,74%,118,109,128,33%,36%,30%,2,0,2,8,4,4
185,https://vlr.gg/player/4973/otom,2024-07-07 12:00:00,0.95,0.97,0.96,201,226,177,49,27,22,51,30,21,21,11,10,0,0,0,73%,69%,76%,129,141,117,26%,24%,30%,11,8,3,11,8,3
186,https://vlr.gg/player/11122/byron,2024-07-07 12:00:00,0.55,1.26,0.90,167,113,223,41,14,27,49,29,20,25,9,16,-4,-3,-1,66%,58%,74%,119,78,161,32%,25%,36%,3,1,2,7,4,3
187,https://vlr.gg/player/33358/shinnok,2024-07-07 12:00:00,0.94,1.36,1.15,194,172,216,49,21,28,44,26,18,19,5,14,+2,-1,+3,77%,65%,89%,135,118,152,32%,43%,26%,4,1,3,2,2,0
188,https://vlr.gg/player/5854/z3ro,2024-07-07 12:00:00,0.79,1.42,1.12,199,155,243,51,18,33,46,26,20,35,14,21,-7,-6,-1,63%,53%,72%,129,91,165,28%,33%,25%,6,2,4,13,8,5
189,https://vlr.gg/player/16447/d3mur,2024-07-07 12:00:00,1.12,0.99,1.05,252,285,224,62,32,30,56,30,26,12,5,7,+2,+2,0,63%,56%,69%,169,197,143,29%,36%,22%,16,9,7,14,7,7
190,https://vlr.gg/player/33501/sword,2024-07-07 12:00:00,0.58,1.41,1.01,193,130,253,44,14,30,48,28,20,25,9,16,+3,-1,+4,77%,68%,86%,131,86,173,26%,24%,27%,6,1,5,3,2,1
191,https://vlr.gg/player/7706/morphiw0w,2024-07-07 12:00:00,0.85,0.78,0.81,151,159,144,35,20,15,51,26,25,35,13,22,0,0,0,70%,65%,75%,97,100,94,29%,34%,25%,3,1,2,3,1,2
192,https://vlr.gg/player/6925/chadi,2024-07-07 11:00:00,0.98,1.75,1.35,276,219,336,70,28,42,47,27,20,10,4,6,+4,-1,+5,77%,69%,85%,177,136,221,21%,22%,20%,15,7,8,11,8,3
193,https://vlr.gg/player/26404/zneva,2024-07-07 11:00:00,1.00,1.31,1.15,237,240,238,59,30,29,50,30,20,17,4,13,+3,+1,+2,80%,75%,85%,150,159,141,28%,26%,30%,10,5,5,7,4,3
194,https://vlr.gg/player/3649/litshii,2024-07-07 11:00:00,0.82,1.41,1.11,187,142,238,46,18,28,43,26,17,35,13,22,0,-3,+3,80%,72%,88%,128,99,158,23%,21%,25%,3,0,3,3,3,0
195,https://vlr.gg/player/7185/nero,2024-07-07 11:00:00,0.88,0.94,0.91,183,176,189,43,21,22,51,29,22,35,13,22,+1,0,+1,76%,69%,82%,122,119,126,27%,40%,20%,6,2,4,5,2,3
196,https://vlr.gg/player/12673/bard0lf,2024-07-07 11:00:00,0.85,0.87,0.86,145,101,191,13,3,10,16,7,9,12,10,2,-1,0,-1,75%,75%,75%,99,70,129,44%,13%,91%,1,0,1,2,0,2
197,https://vlr.gg/player/29006/g-i-l,2024-07-07 11:00:00,0.44,1.17,0.79,142,87,197,22,6,16,34,21,13,27,12,15,-3,-3,0,72%,67%,77%,87,63,113,25%,29%,23%,2,1,1,5,4,1
198,https://vlr.gg/player/4525/stix,2024-07-07 11:00:00,1.07,1.52,1.30,220,192,247,56,23,33,41,24,17,16,9,7,+4,+1,+3,79%,74%,83%,149,136,161,30%,30%,30%,7,2,5,3,1,2
199,https://vlr.gg/player/37840/msh,2024-07-07 11:00:00,0.85,1.22,1.04,230,193,269,56,23,33,51,28,23,7,3,4,-1,-3,+2,63%,59%,67%,152,121,181,39%,47%,34%,8,2,6,9,5,4
200,https://vlr.gg/player/9143/darkosek,2024-07-07 11:00:00,0.64,1.29,0.97,217,191,246,56,22,34,55,32,23,12,4,8,-1,-2,+1,73%,65%,81%,143,125,159,44%,39%,48%,7,2,5,8,4,4
201,https://vlr.gg/player/5487/adm1k,2024-07-07 11:00:00,0.74,0.73,0.73,151,183,123,37,22,15,54,33,21,18,3,15,-2,0,-2,66%,53%,78%,95,109,82,19%,18%,20%,5,4,1,7,4,3
202,https://vlr.gg/player/9556/demek,2024-07-07 11:00:00,0.34,0.98,0.67,153,123,184,36,11,25,53,31,22,12,7,5,-4,-6,+2,60%,47%,72%,105,84,124,18%,22%,16%,6,2,4,10,8,2
203,https://vlr.gg/player/2658/xuss,2024-07-07 11:00:00,1.17,1.45,1.30,273,265,291,71,36,35,53,30,23,7,4,3,+7,+5,+2,76%,74%,79%,178,170,187,27%,22%,34%,14,9,5,7,4,3
204,https://vlr.gg/player/7660/fizzy,2024-07-07 11:00:00,1.11,0.89,1.01,187,202,163,48,28,20,48,25,23,10,3,7,-2,-1,-1,63%,61%,67%,122,129,114,34%,32%,37%,5,3,2,7,4,3
205,https://vlr.gg/player/3753/obnoks,2024-07-07 11:00:00,0.71,1.01,0.85,179,158,218,43,20,23,53,29,24,15,9,6,-9,-2,-7,65%,66%,64%,126,111,143,24%,23%,25%,4,2,2,13,4,9
206,https://vlr.gg/player/1616/starki,2024-07-07 11:00:00,0.77,0.86,0.81,144,150,151,35,19,16,49,27,22,27,15,12,-1,0,-1,65%,66%,64%,104,104,105,29%,30%,28%,4,2,2,5,2,3
207,https://vlr.gg/player/3674/iluri,2024-07-07 11:00:00,0.76,0.81,0.79,140,143,131,35,19,16,47,26,21,19,14,5,-6,-4,-2,69%,68%,70%,89,89,90,40%,37%,44%,3,2,1,9,6,3
208,https://vlr.gg/player/4244/yaboilewis,2024-07-07 11:00:00,1.46,0.93,1.18,247,295,203,58,32,26,49,22,27,21,12,9,+4,+6,-2,82%,91%,74%,160,196,129,43%,49%,37%,15,8,7,11,2,9
209,https://vlr.gg/player/10338/lime,2024-07-07 11:00:00,0.99,1.30,1.16,220,216,242,58,25,33,45,23,22,22,14,8,-1,-1,0,70%,61%,79%,146,135,155,36%,26%,46%,9,4,5,10,5,5
210,https://vlr.gg/player/5292/al0rante,2024-07-07 11:00:00,0.76,1.41,1.10,212,144,268,54,17,37,45,20,25,11,2,9,0,-1,+1,72%,67%,76%,146,97,189,39%,47%,35%,5,2,3,5,3,2
211,https://vlr.gg/player/217/seider,2024-07-07 11:00:00,0.91,1.05,0.99,172,161,173,42,18,24,43,22,21,23,14,9,+5,+4,+1,75%,70%,79%,117,105,127,39%,35%,42%,8,6,2,3,2,1
212,https://vlr.gg/player/8834/bucher,2024-07-07 11:00:00,0.89,0.76,0.82,154,163,138,38,21,17,50,23,27,32,17,15,+3,+1,+2,69%,73%,66%,97,95,98,31%,37%,25%,4,1,3,1,0,1
213,https://vlr.gg/player/31305/lar0k,2024-07-07 10:35:00,0.91,1.45,1.20,203,152,241,45,15,30,36,19,17,19,9,10,+3,0,+3,83%,78%,88%,129,103,152,28%,24%,31%,5,1,4,2,1,1
214,https://vlr.gg/player/40591/comeback,2024-07-07 10:35:00,1.02,1.28,1.16,263,260,271,55,25,30,43,20,23,8,0,8,+12,+5,+7,71%,63%,78%,176,163,187,28%,38%,22%,17,9,8,5,4,1
215,https://vlr.gg/player/5565/ros,2024-07-07 10:35:00,1.18,1.04,1.10,209,188,211,40,16,24,39,15,24,20,11,9,0,+1,-1,83%,81%,84%,138,131,144,26%,22%,29%,5,2,3,5,1,4
216,https://vlr.gg/player/24344/loita,2024-07-07 10:35:00,1.02,1.08,1.05,174,165,179,37,16,21,36,17,19,23,10,13,-6,-2,-4,71%,67%,75%,118,113,122,34%,38%,31%,4,3,1,10,5,5
217,https://vlr.gg/player/31855/celasun,2024-07-07 10:35:00,1.21,0.80,0.99,190,186,180,38,17,21,38,14,24,13,5,8,0,+1,-1,73%,81%,66%,123,121,125,27%,24%,30%,3,1,2,3,0,3
218,https://vlr.gg/player/39675/sh1va,2024-07-07 10:35:00,1.09,1.10,1.10,214,245,189,48,29,19,41,25,16,13,8,5,0,-2,+2,76%,78%,74%,149,157,138,35%,35%,35%,5,1,4,5,3,2
219,https://vlr.gg/player/10114/baha,2024-07-07 10:35:00,0.96,1.00,0.98,180,163,206,40,20,20,42,24,18,23,14,9,-6,-5,-1,73%,72%,74%,123,109,140,36%,35%,37%,1,0,1,7,5,2
220,https://vlr.gg/player/21584/deminatix,2024-07-07 10:35:00,0.87,0.96,0.91,220,232,223,48,27,21,47,30,17,8,4,4,+3,+1,+2,64%,59%,70%,138,135,142,31%,34%,26%,13,8,5,10,7,3
221,https://vlr.gg/player/11516/drky,2024-07-07 10:35:00,0.98,0.70,0.85,167,180,137,31,19,12,39,22,17,27,17,10,-3,0,-3,76%,81%,70%,105,116,92,31%,44%,16%,2,2,0,5,2,3
222,https://vlr.gg/player/21865/merz,2024-07-07 10:35:00,0.57,0.66,0.61,139,119,178,25,12,13,46,25,21,23,11,12,-3,+2,-5,64%,66%,63%,99,82,119,17%,22%,13%,4,3,1,7,1,6
223,https://vlr.gg/player/7883/silenttt,2024-07-07 10:00:00,0.89,1.69,1.47,251,189,271,33,6,27,17,7,10,7,3,4,+3,0,+3,85%,78%,88%,168,124,185,40%,32%,43%,5,1,4,2,1,1
224,https://vlr.gg/player/26808/fainz,2024-07-07 10:00:00,0.64,1.67,1.39,269,142,314,32,4,28,23,7,16,9,4,5,+3,-2,+5,76%,56%,83%,185,105,214,25%,18%,27%,6,1,5,3,3,0
225,https://vlr.gg/player/8590/killdream,2024-07-07 10:00:00,1.67,1.21,1.34,282,308,273,33,11,22,20,4,16,12,1,11,+5,+2,+3,85%,89%,83%,188,192,187,24%,28%,23%,7,2,5,2,0,2
226,https://vlr.gg/player/1377/phatt,2024-07-07 10:00:00,1.14,1.17,1.16,156,146,164,21,6,15,15,4,11,12,3,9,-1,0,-1,85%,78%,88%,102,89,107,39%,36%,40%,1,0,1,2,0,2
227,https://vlr.gg/player/16012/akira,2024-07-07 10:00:00,1.43,0.95,1.09,211,212,203,25,8,17,19,4,15,14,2,12,+1,+1,0,85%,67%,92%,136,143,134,46%,44%,47%,3,1,2,2,0,2
228,https://vlr.gg/player/9557/nefi,2024-07-07 10:00:00,0.81,1.09,0.89,212,221,206,23,17,6,29,23,6,10,6,4,0,-1,+1,70%,67%,78%,146,137,171,36%,38%,32%,3,1,2,3,2,1
229,https://vlr.gg/player/6101/999kvmil,2024-07-07 10:00:00,0.78,1.10,0.87,236,232,220,24,18,6,29,22,7,6,3,3,-1,-1,0,70%,63%,89%,153,152,159,25%,28%,19%,4,4,0,5,5,0
230,https://vlr.gg/player/15487/aqua,2024-07-07 10:00:00,0.76,0.37,0.65,131,151,63,17,15,2,27,20,7,4,2,2,-4,-4,0,52%,54%,44%,90,104,51,38%,34%,60%,0,0,0,4,4,0
231,https://vlr.gg/player/22495/mochi,2024-07-07 10:00:00,0.52,0.93,0.63,138,132,170,17,10,7,29,22,7,4,4,0,+1,+1,0,61%,58%,67%,88,86,94,19%,23%,12%,2,2,0,1,1,0
232,https://vlr.gg/player/1353/dext,2024-07-07 10:00:00,0.40,0.50,0.41,128,112,188,13,8,5,30,22,8,5,5,0,-7,-5,-2,39%,42%,33%,91,73,139,20%,17%,25%,2,0,2,9,5,4
233,https://vlr.gg/player/23220/jesmu,2024-07-07 10:00:00,0.57,1.33,1.08,215,130,257,28,6,22,27,10,17,12,1,11,-1,-2,+1,75%,58%,83%,135,77,165,26%,24%,27%,4,1,3,5,3,2
234,https://vlr.gg/player/23174/snowi,2024-07-07 10:00:00,0.72,1.10,0.98,184,173,190,23,6,17,27,10,17,16,8,8,-2,-1,-1,72%,75%,71%,132,121,138,24%,13%,30%,1,0,1,3,1,2
235,https://vlr.gg/player/1620/ale,2024-07-07 10:00:00,0.75,1.09,0.98,221,183,240,27,8,19,30,11,19,8,3,5,0,0,0,69%,58%,75%,136,110,149,14%,9%,17%,4,2,2,4,2,2
236,https://vlr.gg/player/2571/feeqn,2024-07-07 10:00:00,0.79,0.72,0.74,175,198,164,20,7,13,29,10,19,6,3,3,+3,0,+3,56%,50%,58%,119,146,105,19%,22%,17%,3,0,3,0,0,0
237,https://vlr.gg/player/1365/nixoon,2024-07-07 10:00:00,0.25,0.47,0.40,145,139,148,16,5,11,37,13,24,20,4,16,-2,+1,-3,64%,75%,58%,86,87,86,15%,16%,14%,5,2,3,7,1,6
238,https://vlr.gg/player/24428/harambe,2024-07-07 10:00:00,1.40,1.57,1.46,328,326,333,43,28,15,26,19,7,10,7,3,+8,+6,+2,72%,75%,67%,192,193,192,24%,21%,31%,9,6,3,1,0,1
239,https://vlr.gg/player/31350/deqadz,2024-07-07 10:00:00,1.39,1.17,1.32,226,241,198,28,21,7,19,12,7,21,15,6,-2,-1,-1,83%,88%,75%,140,149,121,16%,14%,19%,3,2,1,5,3,2
240,https://vlr.gg/player/30901/ianto,2024-07-07 10:00:00,0.98,1.42,1.13,213,219,200,28,18,10,23,17,6,11,7,4,0,+1,-1,75%,71%,83%,135,143,117,22%,23%,21%,4,4,0,4,3,1
241,https://vlr.gg/player/12372/szoren,2024-07-07 10:00:00,1.00,1.00,1.00,200,221,158,27,20,7,25,18,7,15,11,4,-2,-1,-1,83%,88%,75%,135,146,115,29%,28%,32%,0,0,0,2,1,1
242,https://vlr.gg/player/6873/geni,2024-07-07 10:00:00,0.55,1.77,0.96,176,112,304,24,9,15,21,16,5,4,3,1,-2,-5,+3,72%,63%,92%,111,74,187,27%,16%,35%,3,0,3,5,5,0
243,https://vlr.gg/player/5568/sociablee,2024-07-07 08:00:00,1.43,1.56,1.49,301,277,322,46,27,19,28,15,13,22,11,11,+1,+2,-1,91%,92%,89%,192,177,212,30%,31%,29%,4,3,1,3,1,2
244,https://vlr.gg/player/568/turko,2024-07-07 08:00:00,1.44,1.05,1.28,201,233,166,37,24,13,24,12,12,8,7,1,-2,-1,-1,69%,73%,63%,146,172,110,33%,34%,31%,2,1,1,4,2,2
245,https://vlr.gg/player/18677/ruxic,2024-07-07 08:00:00,1.27,0.96,1.14,225,235,211,35,22,13,27,15,12,25,13,12,+7,+5,+2,82%,85%,79%,147,161,128,21%,20%,24%,11,7,4,4,2,2
246,https://vlr.gg/player/12651/w0zzip,2024-07-07 08:00:00,1.21,0.87,1.06,203,201,183,33,20,13,28,13,15,14,12,2,+2,-1,+3,73%,85%,58%,127,133,120,33%,29%,39%,4,1,3,2,2,0
247,https://vlr.gg/player/4890/l7,2024-07-07 08:00:00,0.89,0.68,0.80,171,168,171,26,15,11,30,16,14,6,4,2,+1,+3,-2,67%,73%,58%,123,124,122,17%,14%,22%,6,5,1,5,2,3
248,https://vlr.gg/player/22676/ventt,2024-07-07 08:00:00,1.72,0.67,1.11,197,324,140,33,22,11,33,11,22,24,11,13,0,-1,+1,80%,95%,69%,145,210,98,23%,21%,28%,3,2,1,3,3,0
249,https://vlr.gg/player/12774/anima,2024-07-07 08:00:00,0.89,1.16,1.05,195,167,233,32,12,20,33,12,21,12,4,8,-3,0,-3,71%,79%,65%,142,111,164,25%,22%,27%,3,2,1,6,2,4
250,https://vlr.gg/player/12793/xeus,2024-07-07 08:00:00,0.88,0.93,0.91,244,213,236,33,15,18,38,16,22,10,2,8,-1,0,-1,69%,74%,65%,150,149,151,30%,44%,22%,6,2,4,7,2,5
251,https://vlr.gg/player/12795/crewen,2024-07-07 08:00:00,0.72,0.69,0.70,132,145,130,23,10,13,36,14,22,13,6,7,0,0,0,64%,79%,54%,91,93,89,31%,23%,38%,1,0,1,1,0,1
252,https://vlr.gg/player/16483/gloomy,2024-07-07 08:00:00,0.46,0.62,0.55,125,136,119,16,7,9,37,16,21,16,7,9,-5,0,-5,67%,74%,62%,86,106,72,11%,15%,8%,5,3,2,10,3,7
253,https://vlr.gg/player/9803/d4v41,2024-07-07 07:00:00,1.37,1.31,1.34,226,220,229,51,24,27,31,11,20,29,15,14,0,0,0,83%,86%,81%,140,140,140,28%,28%,29%,3,1,2,3,1,2
254,https://vlr.gg/player/9801/f0rsaken,2024-07-07 07:00:00,1.26,1.24,1.25,256,230,276,51,24,27,40,15,25,30,12,18,+2,+2,0,83%,83%,84%,176,158,193,31%,32%,30%,7,3,4,5,1,4
255,https://vlr.gg/player/7378/jinggg,2024-07-07 07:00:00,1.57,0.74,1.14,252,323,184,50,33,17,42,17,25,22,11,11,+8,+3,+5,80%,83%,77%,156,194,120,20%,23%,16%,13,5,8,5,2,3
256,https://vlr.gg/player/17086/something,2024-07-07 07:00:00,1.33,0.67,0.99,212,276,157,48,31,17,43,17,26,12,5,7,+3,+1,+2,70%,76%,65%,151,189,116,36%,37%,35%,11,8,3,8,7,1
257,https://vlr.gg/player/9800/mindfreak,2024-07-07 07:00:00,0.98,0.93,0.95,172,132,208,40,16,24,37,12,25,21,9,12,+1,-1,+2,78%,83%,74%,104,80,127,41%,50%,36%,3,0,3,2,1,1
258,https://vlr.gg/player/999/laz,2024-07-07 07:00:00,1.64,0.83,1.24,217,284,158,47,33,14,43,18,25,20,11,9,-3,-3,0,67%,87%,45%,142,174,109,39%,49%,24%,4,2,2,7,5,2
259,https://vlr.gg/player/10588/hiroronn,2024-07-07 07:00:00,0.95,0.87,0.90,189,201,186,39,22,17,47,23,24,10,7,3,+2,0,+2,62%,71%,52%,136,141,131,28%,27%,28%,7,3,4,5,3,2
260,https://vlr.gg/player/29840/yuran,2024-07-07 07:00:00,1.01,0.66,0.84,163,161,175,34,19,15,46,20,26,20,15,5,-6,-2,-4,63%,81%,45%,109,96,122,26%,21%,29%,1,0,1,7,2,5
261,https://vlr.gg/player/424/dep,2024-07-07 07:00:00,0.77,0.68,0.73,210,227,198,42,25,17,55,27,28,8,3,5,-3,-1,-2,68%,74%,62%,134,138,131,29%,34%,24%,10,5,5,13,6,7
262,https://vlr.gg/player/6668/sugarz3ro,2024-07-07 07:00:00,0.91,0.49,0.71,150,188,92,31,22,9,49,24,25,16,9,7,-4,-3,-1,65%,81%,48%,104,131,76,38%,43%,33%,1,1,0,5,4,1
263,https://vlr.gg/player/3547/ninebody,2024-07-07 07:00:00,,,,273,,,60,,,41,,,14,,,+4,,,,,,180,,,22%,,,11,,,7,,
264,https://vlr.gg/player/14444/eren,2024-07-07 07:00:00,,,,215,,,50,,,41,,,13,,,-3,,,,,,158,,,26%,,,4,,,7,,
265,https://vlr.gg/player/7135/hfmi0dzjc9z7,2024-07-07 07:00:00,,,,181,,,41,,,41,,,14,,,-1,,,,,,114,,,28%,,,7,,,8,,
266,https://vlr.gg/player/39485/scales,2024-07-07 07:00:00,,,,171,,,33,,,40,,,31,,,0,,,,,,106,,,29%,,,5,,,5,,
267,https://vlr.gg/player/3020/coldfish,2024-07-07 07:00:00,,,,163,,,34,,,45,,,22,,,+3,,,,,,111,,,23%,,,5,,,2,,
268,https://vlr.gg/player/37489/lysoar,2024-07-07 07:00:00,,,,212,,,43,,,43,,,17,,,+4,,,,,,142,,,42%,,,5,,,1,,
269,https://vlr.gg/player/3028/life,2024-07-07 07:00:00,,,,212,,,43,,,46,,,3,,,-7,,,,,,134,,,35%,,,10,,,17,,
270,https://vlr.gg/player/19530/aaaay,2024-07-07 07:00:00,,,,204,,,47,,,43,,,22,,,+2,,,,,,144,,,35%,,,5,,,3,,
271,https://vlr.gg/player/872/autumn,2024-07-07 07:00:00,,,,186,,,41,,,42,,,17,,,+3,,,,,,131,,,30%,,,6,,,3,,
272,https://vlr.gg/player/7857/berlin,2024-07-07 07:00:00,,,,179,,,34,,,44,,,21,,,-5,,,,,,123,,,35%,,,3,,,8,,
273,https://vlr.gg/player/36415/viva,2024-07-07 05:00:00,,,,309,,,41,,,17,,,14,,,+5,,,,,,190,,,34%,,,6,,,1,,
274,https://vlr.gg/player/16924/stew,2024-07-07 05:00:00,,,,235,,,33,,,18,,,3,,,+3,,,,,,143,,,18%,,,6,,,3,,
275,https://vlr.gg/player/41029/z1yan,2024-07-07 05:00:00,,,,219,,,27,,,25,,,25,,,-2,,,,,,149,,,34%,,,3,,,5,,
276,https://vlr.gg/player/10486/yhchen,2024-07-07 05:00:00,,,,195,,,26,,,21,,,18,,,-5,,,,,,130,,,20%,,,1,,,6,,
277,https://vlr.gg/player/3519/jkuro,2024-07-07 05:00:00,,,,191,,,26,,,20,,,13,,,0,,,,,,129,,,24%,,,3,,,3,,
278,https://vlr.gg/player/14431/monk,2024-07-07 05:00:00,,,,211,,,25,,,30,,,14,,,-2,,,,,,137,,,31%,,,2,,,4,,
279,https://vlr.gg/player/4881/spitfires,2024-07-07 05:00:00,,,,182,,,22,,,32,,,4,,,0,,,,,,126,,,28%,,,9,,,9,,
280,https://vlr.gg/player/25949/bunt,2024-07-07 05:00:00,,,,155,,,20,,,30,,,9,,,-1,,,,,,100,,,23%,,,2,,,3,,
281,https://vlr.gg/player/3049/sword9,2024-07-07 05:00:00,,,,143,,,17,,,30,,,9,,,0,,,,,,106,,,28%,,,2,,,2,,
282,https://vlr.gg/player/10821/delb,2024-07-07 05:00:00,,,,140,,,17,,,31,,,6,,,+2,,,,,,91,,,37%,,,3,,,1,,
283,https://vlr.gg/player/34974/karon,2024-07-07 04:00:00,1.26,1.05,1.14,195,225,174,45,23,22,45,20,25,39,21,18,+2,0,+2,77%,82%,73%,133,146,123,30%,33%,28%,5,1,4,3,1,2
284,https://vlr.gg/player/773/lakia,2024-07-07 04:00:00,1.28,0.98,1.11,218,207,213,49,24,25,46,16,30,18,5,13,-3,-1,-2,69%,79%,62%,138,135,139,23%,25%,22%,3,1,2,6,2,4
285,https://vlr.gg/player/2489/munchkin,2024-07-07 04:00:00,0.94,1.06,1.01,200,169,224,41,15,26,48,19,29,30,15,15,+3,+1,+2,75%,86%,68%,127,114,137,19%,27%,14%,7,1,6,4,0,4
286,https://vlr.gg/player/9196/t3xture,2024-07-07 04:00:00,0.88,1.11,1.01,226,206,246,50,18,32,49,24,25,12,6,6,0,-3,+3,71%,64%,76%,153,148,157,24%,23%,26%,11,6,5,11,9,2
287,https://vlr.gg/player/13039/meteor,2024-07-07 04:00:00,0.50,0.93,0.75,151,108,188,36,9,27,47,22,25,12,6,6,-3,-3,0,63%,64%,62%,105,79,125,28%,22%,32%,6,2,4,9,5,4
288,https://vlr.gg/player/9735/2ge,2024-07-07 04:00:00,1.29,0.93,1.14,212,247,157,48,35,13,41,24,17,23,11,12,0,0,0,75%,78%,71%,137,157,109,29%,36%,20%,4,2,2,4,2,2
289,https://vlr.gg/player/8504/invy,2024-07-07 04:00:00,1.10,1.19,1.14,222,197,266,49,24,25,45,24,21,26,12,14,+4,+1,+3,78%,76%,82%,152,137,172,24%,24%,24%,6,2,4,2,1,1
290,https://vlr.gg/player/2334/jessievash,2024-07-07 04:00:00,1.03,1.11,1.07,202,217,168,47,29,18,40,26,14,9,7,2,-4,-4,0,74%,70%,79%,137,149,121,34%,36%,32%,3,1,2,7,5,2
291,https://vlr.gg/player/9740/wild0reoo,2024-07-07 04:00:00,0.85,1.26,1.03,197,168,251,47,21,26,46,26,20,24,14,10,+5,+2,+3,75%,70%,82%,135,114,163,35%,34%,36%,7,3,4,2,1,1
292,https://vlr.gg/player/7405/jremy,2024-07-07 04:00:00,0.74,0.92,0.81,206,215,189,43,25,18,49,32,17,12,8,4,-4,-4,0,72%,65%,82%,130,136,122,25%,28%,20%,13,8,5,17,12,5
293,https://vlr.gg/player/36897/ferret,2024-07-07 00:00:00,1.38,1.29,1.34,279,267,280,73,38,35,51,26,25,33,12,21,+6,+1,+5,78%,70%,86%,174,174,174,35%,38%,31%,12,5,7,6,4,2
294,https://vlr.gg/player/31579/emi,2024-07-07 00:00:00,1.19,1.47,1.32,231,242,216,63,36,27,43,27,16,25,10,15,+6,+1,+5,76%,75%,78%,159,162,154,23%,22%,23%,9,3,6,3,2,1
295,https://vlr.gg/player/26100/rosa,2024-07-07 00:00:00,0.87,1.26,1.05,223,210,226,60,28,32,55,33,22,20,10,10,+5,+1,+4,72%,65%,81%,137,143,131,15%,17%,11%,12,6,6,7,5,2
296,https://vlr.gg/player/26102/bethany,2024-07-07 00:00:00,0.92,1.13,1.02,179,175,186,50,25,25,48,28,20,37,19,18,-5,-4,-1,76%,78%,75%,115,108,123,19%,21%,17%,5,1,4,10,5,5
297,https://vlr.gg/player/32533/alannah,2024-07-07 00:00:00,0.66,1.38,1.00,189,137,231,54,20,34,47,27,20,20,8,12,-4,-3,-1,72%,63%,83%,123,93,157,23%,23%,24%,4,3,1,8,6,2
298,https://vlr.gg/player/41957/tiff,2024-07-07 00:00:00,0.89,1.57,1.25,267,216,329,67,24,43,57,30,27,30,11,19,+9,-1,+10,71%,58%,83%,175,135,211,21%,22%,21%,14,3,11,5,4,1
299,https://vlr.gg/player/26122/soko,2024-07-07 00:00:00,1.11,0.98,1.04,220,263,178,57,32,25,59,32,27,12,4,8,-2,0,-2,62%,61%,63%,147,162,134,27%,27%,26%,4,3,1,6,3,3
300,https://vlr.gg/player/41881/yumi,2024-07-07 00:00:00,0.60,1.12,0.87,187,148,226,51,17,34,63,31,32,22,11,11,-1,-1,0,66%,56%,75%,120,95,143,24%,19%,28%,5,2,3,6,3,3
301,https://vlr.gg/player/41926/blue,2024-07-07 00:00:00,0.55,1.02,0.80,157,133,186,42,16,26,57,30,27,20,9,11,-8,-8,0,70%,58%,80%,115,94,135,31%,31%,31%,5,1,4,13,9,4
302,https://vlr.gg/player/41958/silv,2024-07-07 00:00:00,0.55,0.40,0.45,108,121,109,27,14,13,64,30,34,23,10,13,-6,-2,-4,62%,56%,68%,81,90,74,28%,25%,30%,6,3,3,12,5,7
303,https://vlr.gg/player/6193/cauanzin,2024-07-06 20:35:00,1.10,0.93,1.02,242,240,238,34,19,15,35,20,15,9,4,5,+4,+4,0,60%,54%,68%,155,161,147,34%,43%,26%,8,5,3,4,1,3
304,https://vlr.gg/player/683/pancada,2024-07-06 20:35:00,0.92,1.03,0.97,185,202,176,28,17,11,34,21,13,15,3,12,+3,+3,0,60%,54%,68%,121,122,120,34%,39%,29%,5,4,1,2,1,1
305,https://vlr.gg/player/8447/less,2024-07-06 20:35:00,0.69,1.02,0.84,154,135,181,26,12,14,34,21,13,7,3,4,+2,+2,0,63%,54%,74%,102,91,115,36%,38%,34%,4,2,2,2,0,2
306,https://vlr.gg/player/2408/tuyz,2024-07-06 20:35:00,0.29,1.32,0.75,173,83,286,23,5,18,35,22,13,12,8,4,-1,-3,+2,74%,67%,84%,107,49,179,22%,20%,23%,5,1,4,6,4,2
307,https://vlr.gg/player/727/saadhak,2024-07-06 20:35:00,0.36,0.86,0.58,124,107,142,17,7,10,34,21,13,18,10,8,-3,-2,-1,60%,50%,74%,78,64,97,25%,32%,19%,2,2,0,5,4,1
308,https://vlr.gg/player/1818/tex,2024-07-06 20:35:00,0.90,1.61,1.29,247,169,310,42,13,29,27,14,13,7,1,6,-3,0,-3,79%,74%,83%,161,119,194,32%,40%,30%,2,2,0,5,2,3
309,https://vlr.gg/player/8549/kingg,2024-07-06 20:35:00,1.08,1.33,1.22,197,173,216,34,12,22,22,12,10,14,5,9,-1,0,-1,81%,79%,83%,122,112,129,38%,38%,39%,2,1,1,3,1,2
310,https://vlr.gg/player/8480/aspas,2024-07-06 20:35:00,0.97,1.33,1.17,263,236,262,37,15,22,27,14,13,12,5,7,-1,+1,-2,79%,68%,88%,162,169,156,30%,30%,29%,8,5,3,9,4,5
311,https://vlr.gg/player/7603/mazino,2024-07-06 20:35:00,1.15,1.01,1.07,199,215,183,31,15,16,27,13,14,21,9,12,-4,0,-4,77%,84%,71%,134,158,116,26%,30%,22%,1,1,0,5,1,4
312,https://vlr.gg/player/619/c0m,2024-07-06 20:35:00,0.87,1.18,1.04,179,184,195,28,12,16,25,15,10,13,9,4,+4,-2,+6,81%,79%,83%,121,123,119,17%,23%,14%,6,0,6,2,2,0
313,https://vlr.gg/player/4581/jonahp,2024-07-06 17:00:00,0.90,1.34,1.13,205,182,241,50,20,30,44,22,22,29,16,13,+5,+3,+2,72%,75%,70%,124,103,144,18%,20%,16%,9,6,3,4,3,1
314,https://vlr.gg/player/3885/valyn,2024-07-06 17:00:00,1.11,0.87,0.99,216,216,203,47,25,22,50,23,27,22,10,12,0,+1,-1,83%,88%,79%,135,136,134,23%,21%,25%,5,2,3,5,1,4
315,https://vlr.gg/player/8402/icy,2024-07-06 17:00:00,1.00,0.87,0.93,213,243,192,49,28,21,52,24,28,13,8,5,-7,-4,-3,75%,75%,76%,142,158,126,28%,29%,28%,6,2,4,13,6,7
316,https://vlr.gg/player/15500/trent,2024-07-06 17:00:00,0.98,0.87,0.92,171,215,151,40,23,17,47,23,24,25,13,12,-6,-3,-3,68%,72%,64%,121,137,105,16%,24%,9%,1,0,1,7,3,4
317,https://vlr.gg/player/7873/leaf,2024-07-06 17:00:00,0.79,0.93,0.86,201,195,219,42,20,22,54,26,28,17,6,11,-1,-1,0,65%,63%,67%,143,138,148,19%,23%,16%,7,4,3,8,5,3
318,https://vlr.gg/player/2462/keznit,2024-07-06 17:00:00,1.22,1.34,1.28,304,286,310,66,32,34,45,23,22,13,6,7,+8,+2,+6,77%,76%,78%,184,183,185,22%,30%,15%,14,6,8,6,4,2
319,https://vlr.gg/player/1311/melser,2024-07-06 17:00:00,1.30,1.03,1.16,229,249,203,55,31,24,43,21,22,22,9,13,-2,+1,-3,74%,76%,72%,153,153,152,32%,32%,32%,6,4,2,8,3,5
320,https://vlr.gg/player/24007/shyy,2024-07-06 17:00:00,0.93,1.11,1.02,213,201,235,54,27,27,46,22,24,8,2,6,-3,-1,-2,72%,73%,72%,152,147,157,24%,33%,18%,3,1,2,6,2,4
321,https://vlr.gg/player/8673/heat,2024-07-06 17:00:00,0.83,0.99,0.91,167,158,182,39,19,20,45,23,22,32,18,14,0,-1,+1,77%,85%,69%,107,97,116,31%,36%,28%,5,3,2,5,4,1
322,https://vlr.gg/player/36169/mta,2024-07-06 17:00:00,0.95,0.60,0.78,162,181,139,33,20,13,49,23,26,32,14,18,+6,+4,+2,74%,76%,72%,106,121,89,28%,31%,25%,9,5,4,3,1,2
323,https://vlr.gg/player/253/sp1ke,2024-07-06 14:50:00,1.48,0.81,1.12,229,321,153,30,19,11,28,13,15,4,2,2,-3,-1,-2,64%,65%,63%,147,202,98,22%,29%,12%,3,2,1,6,3,3
324,https://vlr.gg/player/15969/yuta,2024-07-06 14:50:00,0.63,0.83,0.73,153,156,151,20,10,10,30,15,15,7,2,5,-2,-1,-1,58%,59%,58%,111,113,110,40%,36%,44%,3,2,1,5,3,2
325,https://vlr.gg/player/226/roden,2024-07-06 14:50:00,0.68,0.75,0.72,156,145,166,20,9,11,30,14,16,11,7,4,-1,0,-1,61%,65%,58%,103,102,104,26%,50%,12%,0,0,0,1,0,1
326,https://vlr.gg/player/24439/yohpa,2024-07-06 14:50:00,0.69,0.63,0.66,153,160,151,19,9,10,30,15,15,7,4,3,-5,0,-5,58%,71%,47%,109,112,105,18%,19%,16%,1,1,0,6,1,5
327,https://vlr.gg/player/126/nowaxxzang,2024-07-06 14:50:00,0.30,0.76,0.54,166,131,194,20,7,13,32,16,16,4,3,1,-1,-1,0,53%,65%,42%,104,83,124,26%,33%,22%,5,2,3,6,3,3
328,https://vlr.gg/player/2653/jesse,2024-07-06 14:50:00,1.37,1.48,1.42,245,228,270,35,18,17,20,10,10,14,7,7,+2,+1,+1,83%,89%,76%,164,147,183,41%,41%,41%,5,2,3,3,1,2
329,https://vlr.gg/player/314/ambi,2024-07-06 14:50:00,1.39,1.29,1.34,277,283,270,35,18,17,23,11,12,9,4,5,+6,+7,-1,78%,79%,76%,196,200,193,24%,21%,27%,8,8,0,2,1,1
330,https://vlr.gg/player/8805/sacake,2024-07-06 14:50:00,1.21,1.26,1.23,227,219,238,32,16,16,24,12,12,6,2,4,+3,+2,+1,89%,95%,82%,147,154,139,27%,26%,28%,4,2,2,1,0,1
331,https://vlr.gg/player/6889/neskaas,2024-07-06 14:50:00,1.27,0.88,1.09,200,229,170,26,16,10,22,11,11,12,6,6,+5,+1,+4,83%,84%,82%,120,134,103,29%,25%,36%,6,2,4,1,1,0
332,https://vlr.gg/player/252/d3ffo,2024-07-06 14:50:00,0.81,1.34,1.06,177,134,217,22,9,13,20,11,9,9,6,3,-4,-2,-2,75%,84%,65%,130,99,164,25%,18%,31%,1,0,1,5,2,3
333,https://vlr.gg/player/10160/izzy,2024-07-06 14:00:00,1.79,1.74,1.76,377,405,330,53,22,31,22,11,11,5,2,3,+13,+7,+6,87%,93%,83%,230,264,208,30%,28%,31%,13,7,6,0,0,0
334,https://vlr.gg/player/1399/sterben,2024-07-06 14:00:00,1.16,1.44,1.33,210,202,214,30,11,19,20,9,11,24,9,15,+2,-1,+3,82%,67%,92%,137,136,137,21%,28%,17%,3,0,3,1,1,0
335,https://vlr.gg/player/3557/skylen,2024-07-06 14:00:00,0.77,1.30,1.10,171,100,225,25,6,19,20,9,11,12,2,10,+4,0,+4,72%,47%,88%,113,81,133,40%,29%,44%,5,0,5,1,0,1
336,https://vlr.gg/player/5510/oxmann,2024-07-06 14:00:00,1.09,0.88,0.96,175,180,184,26,9,17,25,9,16,11,5,6,+1,0,+1,72%,73%,71%,129,119,135,38%,29%,44%,4,1,3,3,1,2
337,https://vlr.gg/player/556/souhcni,2024-07-06 14:00:00,0.40,1.12,0.84,168,67,210,22,3,19,24,11,13,11,6,5,-5,-3,-2,67%,53%,75%,107,47,144,30%,29%,31%,2,1,1,7,4,3
338,https://vlr.gg/player/31305/lar0k,2024-07-06 14:00:00,1.21,0.98,1.12,192,224,140,27,18,9,29,19,10,6,4,2,0,+1,-1,62%,54%,73%,122,139,95,34%,35%,33%,2,2,0,2,1,1
339,https://vlr.gg/player/31855/celasun,2024-07-06 14:00:00,0.55,1.27,0.81,118,89,209,19,8,11,28,19,9,5,2,3,0,-1,+1,54%,46%,67%,86,64,122,24%,29%,21%,2,0,2,2,1,1
340,https://vlr.gg/player/24344/loita,2024-07-06 14:00:00,0.77,0.83,0.79,177,190,178,26,16,10,31,20,11,8,3,5,-5,-5,0,54%,50%,60%,115,127,97,46%,48%,42%,4,1,3,9,6,3
341,https://vlr.gg/player/5565/ros,2024-07-06 14:00:00,0.50,0.94,0.67,143,131,167,18,10,8,33,23,10,15,8,7,-5,-3,-2,56%,54%,60%,96,83,115,31%,31%,31%,0,0,0,5,3,2
342,https://vlr.gg/player/40591/comeback,2024-07-06 14:00:00,0.38,0.91,0.58,171,143,238,21,10,11,35,24,11,9,3,6,-5,-4,-1,62%,50%,80%,121,93,165,16%,15%,17%,4,3,1,9,7,2
343,https://vlr.gg/player/10338/lime,2024-07-06 13:35:00,1.39,1.88,1.59,326,314,339,47,25,22,22,14,8,11,7,4,+5,+3,+2,86%,76%,100%,199,201,196,35%,33%,39%,9,6,3,4,3,1
344,https://vlr.gg/player/8834/bucher,2024-07-06 13:35:00,1.59,1.00,1.35,215,249,164,33,22,11,21,12,9,20,15,5,-1,+1,-2,76%,76%,76%,148,163,126,49%,49%,50%,3,2,1,4,1,3
345,https://vlr.gg/player/5292/al0rante,2024-07-06 13:35:00,1.27,1.18,1.23,248,223,274,37,20,17,27,15,12,11,7,4,+5,+4,+1,81%,80%,82%,153,146,163,45%,40%,52%,7,4,3,2,0,2
346,https://vlr.gg/player/4244/yaboilewis,2024-07-06 13:35:00,1.09,1.24,1.15,187,174,215,27,16,11,26,13,13,25,7,18,0,-2,+2,71%,60%,88%,118,110,130,42%,44%,41%,5,3,2,5,5,0
347,https://vlr.gg/player/217/seider,2024-07-06 13:35:00,0.85,1.12,0.96,148,118,213,25,13,12,21,13,8,10,4,6,+1,-1,+2,76%,72%,82%,102,80,135,41%,39%,43%,2,0,2,1,1,0
348,https://vlr.gg/player/30754/karma,2024-07-06 13:35:00,0.66,1.13,0.94,191,185,224,31,12,19,33,15,18,4,0,4,+1,0,+1,64%,65%,64%,145,115,165,31%,26%,33%,5,1,4,4,1,3
349,https://vlr.gg/player/7987/kovaq,2024-07-06 13:35:00,0.85,0.94,0.88,182,168,204,27,11,16,31,13,18,7,2,5,-4,-1,-3,52%,53%,52%,131,117,141,31%,50%,25%,4,2,2,8,3,5
350,https://vlr.gg/player/7968/stavinci,2024-07-06 13:35:00,1.14,0.58,0.81,163,244,120,26,15,11,33,14,19,12,9,3,-2,-2,0,67%,76%,60%,105,147,76,35%,35%,34%,2,0,2,4,2,2
351,https://vlr.gg/player/20302/jini,2024-07-06 13:35:00,0.58,0.66,0.63,136,119,140,18,7,11,35,15,20,12,8,4,-2,-2,0,52%,53%,52%,83,72,90,23%,22%,23%,1,0,1,3,2,1
352,https://vlr.gg/player/4630/magnus,2024-07-06 13:35:00,0.36,0.46,0.42,118,124,110,15,5,10,37,16,21,9,6,3,-3,0,-3,64%,71%,60%,81,92,72,18%,23%,13%,4,3,1,7,3,4
353,https://vlr.gg/player/2656/snikk,2024-07-06 13:10:00,0.84,1.11,0.97,177,179,178,26,13,13,28,18,10,3,2,1,+1,0,+1,65%,57%,74%,117,123,111,31%,26%,37%,3,1,2,2,1,1
354,https://vlr.gg/player/2669/kenobi,2024-07-06 13:10:00,0.51,1.18,0.81,155,107,209,22,8,14,28,17,11,6,2,4,+1,0,+1,65%,57%,74%,103,79,130,31%,25%,36%,1,0,1,0,0,0
355,https://vlr.gg/player/10378/almo,2024-07-06 13:10:00,0.58,1.05,0.80,218,188,251,29,13,16,34,20,14,6,2,4,-3,-4,+1,60%,57%,63%,143,128,159,36%,46%,26%,8,3,5,11,7,4
356,https://vlr.gg/player/7242/freyy,2024-07-06 13:10:00,0.93,0.58,0.76,176,209,135,22,14,8,33,18,15,12,5,7,-6,-3,-3,58%,62%,53%,120,150,87,32%,36%,28%,1,1,0,7,4,3
357,https://vlr.gg/player/42702/krizz,2024-07-06 13:10:00,0.23,0.98,0.58,135,98,177,17,6,11,33,21,12,6,4,2,-1,-4,+3,58%,52%,63%,92,70,116,19%,14%,23%,3,0,3,4,4,0
358,https://vlr.gg/player/18162/serial,2024-07-06 13:10:00,1.17,1.43,1.30,237,218,257,37,16,21,23,13,10,3,1,2,0,-3,+3,70%,68%,71%,154,147,160,57%,73%,49%,3,0,3,3,3,0
359,https://vlr.gg/player/28948/ninja,2024-07-06 13:10:00,0.85,1.70,1.29,243,135,334,36,9,27,24,11,13,14,8,6,+7,+1,+6,80%,74%,86%,139,83,189,22%,19%,23%,7,1,6,0,0,0
360,https://vlr.gg/player/40004/globex,2024-07-06 13:10:00,1.24,1.32,1.28,267,282,252,37,18,19,26,14,12,10,3,7,+5,+2,+3,78%,68%,86%,175,188,163,16%,23%,10%,11,6,5,6,4,2
361,https://vlr.gg/player/38424/zachkappa,2024-07-06 13:10:00,0.89,1.36,1.14,182,147,213,26,10,16,21,11,10,11,1,10,+1,-1,+2,73%,58%,86%,125,100,148,29%,32%,27%,3,1,2,2,2,0
362,https://vlr.gg/player/164/bzt,2024-07-06 13:10:00,0.69,0.83,0.76,133,130,138,20,9,11,22,13,9,8,4,4,-5,-2,-3,70%,68%,71%,85,77,92,39%,40%,39%,0,0,0,5,2,3
363,https://vlr.gg/player/31350/deqadz,2024-07-06 12:30:00,0.73,2.02,1.31,252,192,340,37,13,24,23,18,5,11,5,6,+6,+1,+5,79%,67%,94%,158,127,196,20%,16%,25%,6,1,5,0,0,0
364,https://vlr.gg/player/30901/ianto,2024-07-06 12:30:00,1.15,1.50,1.31,254,245,266,37,19,18,23,16,7,9,5,4,0,-2,+2,74%,67%,82%,163,161,165,27%,32%,22%,5,2,3,5,4,1
365,https://vlr.gg/player/42371/t0ba,2024-07-06 12:30:00,1.20,1.30,1.25,204,195,214,28,14,14,20,13,7,14,9,5,-1,0,-1,76%,67%,88%,142,146,137,26%,20%,38%,1,1,0,2,1,1
366,https://vlr.gg/player/12372/szoren,2024-07-06 12:30:00,1.00,1.45,1.20,232,232,228,31,16,15,22,15,7,15,8,7,+3,+2,+1,82%,71%,94%,152,163,138,33%,47%,21%,5,3,2,2,1,1
367,https://vlr.gg/player/24428/harambe,2024-07-06 12:30:00,0.84,1.14,0.97,199,197,187,24,15,9,23,16,7,8,1,7,-2,-2,0,71%,57%,88%,129,129,130,21%,32%,11%,5,3,2,7,5,2
368,https://vlr.gg/player/8838/chanformer,2024-07-06 12:30:00,0.80,1.39,1.13,206,180,232,28,9,19,27,15,12,8,3,5,+1,-1,+2,66%,47%,81%,134,114,150,25%,30%,23%,4,1,3,3,2,1
369,https://vlr.gg/player/15491/maximn,2024-07-06 12:30:00,0.83,0.88,0.86,164,176,160,23,10,13,29,15,14,5,1,4,+1,+1,0,61%,47%,71%,113,108,117,30%,36%,26%,3,2,1,2,1,1
370,https://vlr.gg/player/7972/reqz,2024-07-06 12:30:00,0.36,1.11,0.78,161,97,220,19,4,15,33,16,17,18,3,15,-3,-3,0,58%,41%,71%,110,68,144,27%,19%,30%,2,0,2,5,3,2
371,https://vlr.gg/player/10270/dev0,2024-07-06 12:30:00,0.11,1.27,0.74,186,83,270,23,3,20,34,17,17,12,5,7,-3,-5,+2,61%,41%,76%,118,65,161,15%,10%,18%,5,0,5,8,5,3
372,https://vlr.gg/player/18384/bully,2024-07-06 12:30:00,0.39,0.71,0.57,140,120,166,18,7,11,34,17,17,15,5,10,-2,+1,-3,66%,65%,67%,95,73,114,25%,30%,23%,2,2,0,4,1,3
373,https://vlr.gg/player/12928/veqaj,2024-07-06 12:00:00,1.32,1.13,1.23,228,235,229,47,24,23,40,18,22,30,15,15,+1,+1,0,78%,86%,70%,153,159,148,22%,29%,17%,5,3,2,4,2,2
374,https://vlr.gg/player/2256/jady,2024-07-06 12:00:00,1.27,1.04,1.15,250,261,237,49,27,22,43,19,24,23,10,13,+7,+1,+6,75%,79%,70%,165,165,166,34%,34%,33%,9,2,7,2,1,1
375,https://vlr.gg/player/14612/lux9,2024-07-06 12:00:00,0.87,1.30,1.09,244,233,258,49,21,28,45,26,19,11,7,4,+12,+7,+5,75%,76%,73%,167,159,175,33%,32%,34%,17,10,7,5,3,2
376,https://vlr.gg/player/3563/babax,2024-07-06 12:00:00,1.12,0.78,0.95,168,190,128,35,21,14,38,19,19,21,12,9,-1,-1,0,69%,76%,63%,98,116,80,19%,20%,17%,3,1,2,4,2,2
377,https://vlr.gg/player/4521/unfake,2024-07-06 12:00:00,0.82,0.76,0.79,122,139,114,31,16,15,39,19,20,9,6,3,-6,-5,-1,66%,72%,60%,84,92,76,39%,42%,35%,2,0,2,8,5,3
378,https://vlr.gg/player/1284/mikee,2024-07-06 12:00:00,1.33,1.17,1.25,247,244,250,52,27,25,37,17,20,9,4,5,-1,-2,+1,71%,67%,76%,165,161,170,25%,31%,21%,8,3,5,9,5,4
379,https://vlr.gg/player/4308/magik,2024-07-06 12:00:00,1.07,0.96,1.01,219,200,230,43,23,20,43,19,24,25,7,18,-5,-3,-2,78%,77%,79%,143,135,151,33%,26%,41%,2,1,1,7,4,3
380,https://vlr.gg/player/1475/kamyk,2024-07-06 12:00:00,1.01,1.01,1.01,185,177,205,40,19,21,39,18,21,16,9,7,+1,0,+1,73%,73%,72%,118,115,122,35%,43%,28%,2,1,1,1,1,0
381,https://vlr.gg/player/5893/robbiebk,2024-07-06 12:00:00,0.83,1.06,0.93,200,181,213,43,20,23,46,23,23,12,4,8,-1,0,-1,68%,67%,69%,131,122,141,35%,47%,27%,5,2,3,6,2,4
382,https://vlr.gg/player/2700/jas,2024-07-06 12:00:00,0.55,0.64,0.58,129,147,118,27,15,12,46,25,21,11,4,7,-7,-5,-2,68%,67%,69%,84,92,75,20%,23%,17%,6,3,3,13,8,5
383,https://vlr.gg/player/5199/guardy,2024-07-06 12:00:00,1.09,1.34,1.22,219,187,249,85,35,50,73,38,35,36,10,26,+2,0,+2,74%,62%,84%,144,118,169,27%,26%,28%,8,4,4,6,4,2
384,https://vlr.gg/player/20271/vorwenn,2024-07-06 12:00:00,1.19,1.08,1.13,212,236,191,81,42,39,75,42,33,36,14,22,+7,+1,+6,77%,74%,81%,143,161,127,31%,34%,28%,12,4,8,5,3,2
385,https://vlr.gg/player/7220/saiz,2024-07-06 12:00:00,0.85,1.16,1.01,209,176,239,84,35,49,81,43,38,20,4,16,+5,0,+5,67%,60%,74%,139,119,158,35%,33%,36%,12,3,9,7,3,4
386,https://vlr.gg/player/21959/kpzet,2024-07-06 12:00:00,0.67,1.13,0.91,168,135,195,64,24,40,75,41,34,42,21,21,-8,-7,-1,72%,62%,81%,114,87,139,37%,35%,38%,5,2,3,13,9,4
387,https://vlr.gg/player/2701/maniek,2024-07-06 12:00:00,0.50,1.25,0.89,211,146,270,82,24,58,83,45,38,23,11,12,-4,-9,+5,66%,53%,79%,140,107,170,20%,21%,20%,19,6,13,23,15,8
388,https://vlr.gg/player/16209/famsii,2024-07-06 12:00:00,1.05,1.29,1.17,265,242,295,110,47,63,85,49,36,20,6,14,-1,-2,+1,78%,70%,87%,174,161,188,34%,38%,31%,20,11,9,21,13,8
389,https://vlr.gg/player/4629/azury,2024-07-06 12:00:00,1.04,1.20,1.12,201,218,182,77,43,34,74,47,27,51,26,25,-6,-5,-1,78%,74%,83%,125,129,120,30%,30%,29%,6,2,4,12,7,5
390,https://vlr.gg/player/8502/olizera,2024-07-06 12:00:00,0.67,1.22,0.94,192,153,235,74,27,47,79,48,31,32,22,10,+1,-4,+5,68%,58%,79%,132,113,153,25%,21%,28%,10,3,7,9,7,2
391,https://vlr.gg/player/6959/flickless,2024-07-06 12:00:00,0.82,1.00,0.91,166,158,178,59,27,32,77,46,31,61,36,25,+1,-6,+7,76%,72%,81%,110,106,113,16%,16%,16%,9,0,9,8,6,2
392,https://vlr.gg/player/341/quick,2024-07-06 12:00:00,0.76,0.97,0.86,166,164,170,66,33,33,81,47,34,31,11,20,+3,0,+3,72%,63%,81%,110,111,108,29%,30%,28%,9,4,5,6,4,2
393,https://vlr.gg/player/7162/wackie,2024-07-06 12:00:00,1.54,1.31,1.41,236,272,213,55,27,28,32,13,19,15,5,10,+6,-2,+8,82%,77%,86%,171,192,155,34%,35%,33%,8,0,8,2,2,0
394,https://vlr.gg/player/8226/waddle,2024-07-06 12:00:00,1.28,1.20,1.24,203,214,186,43,19,24,34,14,20,26,8,18,+2,+2,0,79%,73%,83%,129,142,120,25%,24%,26%,7,4,3,5,2,3
395,https://vlr.gg/player/4544/filu,2024-07-06 12:00:00,1.20,1.18,1.19,251,212,271,54,20,34,46,16,30,20,10,10,+1,-2,+3,79%,81%,78%,165,147,178,25%,26%,24%,7,2,5,6,4,2
396,https://vlr.gg/player/1944/cayden,2024-07-06 12:00:00,1.18,1.13,1.15,198,188,208,45,17,28,37,14,23,28,16,12,+3,-1,+4,77%,77%,78%,129,112,141,21%,22%,20%,7,1,6,4,2,2
397,https://vlr.gg/player/12474/tag,2024-07-06 12:00:00,0.85,0.99,0.92,181,167,188,43,16,27,40,19,21,17,6,11,-6,-3,-3,73%,62%,81%,128,110,141,35%,36%,35%,5,3,2,11,6,5
398,https://vlr.gg/player/18400/bipo,2024-07-06 12:00:00,0.87,1.01,0.91,182,191,198,42,24,18,47,28,19,13,6,7,-5,-5,0,63%,67%,58%,123,121,126,27%,30%,24%,9,6,3,14,11,3
399,https://vlr.gg/player/1493/starkk,2024-07-06 12:00:00,1.01,0.77,0.89,169,191,152,38,26,12,47,26,21,17,6,11,+5,+1,+4,74%,78%,69%,115,123,103,23%,26%,19%,6,1,5,1,0,1
400,https://vlr.gg/player/1524/h1ber,2024-07-06 12:00:00,1.02,0.60,0.84,199,225,156,39,27,12,52,29,23,25,14,11,+6,+1,+5,71%,72%,69%,129,145,106,30%,31%,26%,9,3,6,3,2,1
401,https://vlr.gg/player/4277/n-a-i-s,2024-07-06 12:00:00,0.71,1.02,0.84,164,147,205,39,19,20,47,28,19,12,8,4,-3,-2,-1,66%,61%,73%,110,95,132,22%,24%,20%,4,2,2,7,4,3
402,https://vlr.gg/player/23347/alannn,2024-07-06 12:00:00,0.49,0.83,0.63,154,148,160,31,17,14,47,30,17,11,7,4,-9,-7,-2,63%,64%,62%,101,92,113,34%,33%,34%,0,0,0,9,7,2
403,https://vlr.gg/player/20032/treelover,2024-07-06 11:00:00,1.05,1.25,1.17,257,259,270,40,16,24,34,14,20,12,6,6,-5,-2,-3,79%,88%,73%,184,197,176,34%,35%,33%,4,2,2,9,4,5
404,https://vlr.gg/player/2189/qxv,2024-07-06 11:00:00,0.71,0.91,0.83,176,170,193,27,10,17,36,15,21,8,2,6,+3,+1,+2,65%,65%,65%,134,129,137,28%,29%,27%,4,1,3,1,0,1
405,https://vlr.gg/player/4543/nyczu,2024-07-06 11:00:00,0.51,0.89,0.74,167,159,181,23,9,14,35,15,20,10,3,7,-2,-1,-1,74%,65%,81%,118,111,123,33%,27%,38%,3,1,2,5,2,3
406,https://vlr.gg/player/3746/hitch,2024-07-06 11:00:00,0.62,0.70,0.66,130,144,141,18,7,11,37,15,22,23,10,13,-2,0,-2,65%,76%,58%,90,78,97,17%,6%,25%,1,1,0,3,1,2
407,https://vlr.gg/player/22179/shy,2024-07-06 11:00:00,0.53,0.68,0.62,186,159,178,24,9,15,38,15,23,6,2,4,-1,+1,-2,53%,53%,54%,124,116,129,26%,32%,21%,6,3,3,7,2,5
408,https://vlr.gg/player/15064/kajuks,2024-07-06 11:00:00,1.22,1.71,1.42,236,232,272,38,21,17,23,14,9,17,11,6,+2,+1,+1,81%,81%,82%,170,154,195,25%,26%,23%,3,1,2,1,0,1
409,https://vlr.gg/player/39682/wanzeru,2024-07-06 11:00:00,1.36,1.34,1.35,337,339,297,50,33,17,32,21,11,8,4,4,+2,+4,-2,77%,81%,71%,193,197,188,21%,25%,13%,12,10,2,10,6,4
410,https://vlr.gg/player/10448/kozok,2024-07-06 11:00:00,1.37,1.03,1.24,205,223,156,31,21,10,23,13,10,23,15,8,-1,0,-1,84%,85%,82%,136,156,105,30%,25%,40%,2,1,1,3,1,2
411,https://vlr.gg/player/259/arch,2024-07-06 11:00:00,1.12,1.08,1.10,198,200,172,32,20,12,27,16,11,7,5,2,+2,+1,+1,67%,69%,65%,120,134,99,30%,34%,26%,4,2,2,2,1,1
412,https://vlr.gg/player/33732/nunmeister,2024-07-06 11:00:00,0.77,1.56,1.08,200,132,307,29,11,18,27,17,10,15,8,7,+2,0,+2,74%,65%,88%,148,112,203,29%,22%,37%,4,2,2,2,2,0
413,https://vlr.gg/player/10137/ip0tt,2024-07-06 10:30:00,0.69,1.56,1.11,252,182,318,63,24,39,53,32,21,10,3,7,+4,0,+4,68%,51%,86%,165,122,210,32%,29%,33%,12,5,7,8,5,3
414,https://vlr.gg/player/5517/masic,2024-07-06 10:30:00,1.28,0.88,1.09,208,253,165,56,34,22,48,27,21,4,3,1,+4,+2,+2,71%,86%,54%,140,170,108,27%,26%,29%,15,8,7,11,6,5
415,https://vlr.gg/player/7353/glovee,2024-07-06 10:30:00,0.86,1.05,0.95,186,178,197,45,21,24,53,30,23,33,20,13,-1,-1,0,71%,76%,66%,126,119,133,24%,16%,34%,6,3,3,7,4,3
416,https://vlr.gg/player/6559/destruct1vee,2024-07-06 10:30:00,1.02,0.71,0.87,178,219,140,44,29,15,51,29,22,30,18,12,+5,+2,+3,74%,78%,69%,116,142,89,30%,34%,25%,8,4,4,3,2,1
417,https://vlr.gg/player/4962/lurzy0y0,2024-07-06 10:30:00,0.83,0.75,0.79,159,180,142,41,23,18,50,28,22,25,12,13,-2,0,-2,82%,84%,80%,106,120,92,28%,32%,22%,0,0,0,2,0,2
418,https://vlr.gg/player/18677/ruxic,2024-07-06 10:30:00,1.35,1.40,1.37,262,251,270,67,32,35,42,21,21,19,10,9,+2,0,+2,74%,69%,78%,165,162,168,29%,40%,21%,9,5,4,7,5,2
419,https://vlr.gg/player/5568/sociablee,2024-07-06 10:30:00,0.92,1.40,1.17,220,184,255,57,21,36,49,25,24,23,8,15,-5,-3,-2,75%,66%,84%,148,119,175,25%,21%,29%,2,1,1,7,4,3
420,https://vlr.gg/player/568/turko,2024-07-06 10:30:00,0.92,1.07,1.00,196,162,228,48,19,29,52,25,27,27,13,14,+3,+2,+1,72%,69%,76%,120,100,140,35%,46%,30%,7,3,4,4,1,3
421,https://vlr.gg/player/12651/w0zzip,2024-07-06 10:30:00,0.83,0.86,0.84,158,119,197,38,13,25,49,21,28,19,8,11,-6,-2,-4,69%,66%,73%,107,84,129,28%,33%,24%,4,0,4,10,2,8
422,https://vlr.gg/player/4890/l7,2024-07-06 10:30:00,0.88,0.64,0.76,184,206,161,45,24,21,57,26,31,7,2,5,-4,-4,0,67%,69%,65%,122,125,119,22%,21%,24%,9,5,4,13,9,4
423,https://vlr.gg/player/16012/akira,2024-07-06 10:00:00,0.92,0.64,0.82,172,184,149,22,15,7,30,19,11,10,5,5,-5,-2,-3,68%,58%,85%,111,112,109,24%,26%,21%,0,0,0,5,2,3
424,https://vlr.gg/player/1377/phatt,2024-07-06 10:00:00,0.78,0.78,0.78,161,190,107,20,15,5,29,21,8,15,11,4,+2,+2,0,62%,63%,62%,104,124,67,30%,34%,20%,4,2,2,2,0,2
425,https://vlr.gg/player/8590/killdream,2024-07-06 10:00:00,0.77,0.50,0.67,156,170,131,21,15,6,31,20,11,10,7,3,-2,-1,-1,62%,67%,54%,108,118,89,26%,29%,19%,2,2,0,4,3,1
426,https://vlr.gg/player/7883/silenttt,2024-07-06 10:00:00,0.48,1.04,0.67,166,121,253,18,9,9,32,22,10,14,8,6,0,0,0,68%,58%,85%,110,80,165,21%,17%,24%,2,2,0,2,2,0
427,https://vlr.gg/player/26808/fainz,2024-07-06 10:00:00,0.43,1.04,0.64,176,148,231,22,10,12,33,22,11,4,2,2,+2,-1,+3,54%,46%,69%,113,97,143,25%,23%,30%,9,5,4,7,6,1
428,https://vlr.gg/player/1378/addicted,2024-07-06 10:00:00,1.56,1.65,1.62,272,247,286,37,13,24,16,5,11,10,1,9,0,-1,+1,86%,69%,96%,172,155,181,35%,45%,31%,3,1,2,3,2,1
429,https://vlr.gg/player/13435/fragger,2024-07-06 10:00:00,1.35,1.59,1.50,245,218,262,34,10,24,20,8,12,28,10,18,-3,0,-3,84%,85%,83%,163,143,174,25%,21%,27%,2,0,2,5,0,5
430,https://vlr.gg/player/15376/grtw,2024-07-06 10:00:00,0.97,1.48,1.30,252,244,257,34,12,22,23,11,12,14,5,9,+2,-1,+3,81%,69%,88%,162,146,171,38%,36%,39%,6,2,4,4,3,1
431,https://vlr.gg/player/15577/brk,2024-07-06 10:00:00,1.30,1.16,1.21,247,247,246,33,12,21,25,10,15,8,2,6,+3,+3,0,76%,85%,71%,165,178,158,19%,32%,13%,8,4,4,5,1,4
432,https://vlr.gg/player/29340/cunha20,2024-07-06 10:00:00,1.01,0.94,0.97,133,109,145,17,4,13,20,6,14,20,8,12,+1,0,+1,81%,77%,83%,93,74,103,35%,46%,31%,1,0,1,0,0,0
433,https://vlr.gg/player/4969/shazeon,2024-07-06 10:00:00,1.12,1.17,1.15,224,221,238,60,31,29,51,28,23,16,11,5,+1,+1,0,73%,71%,75%,153,149,157,28%,26%,31%,8,5,3,7,4,3
434,https://vlr.gg/player/122/luckerrr,2024-07-06 10:00:00,0.89,1.30,1.08,217,194,232,51,24,27,50,30,20,21,10,11,+1,-1,+2,74%,68%,81%,137,127,150,25%,25%,26%,9,4,5,8,5,3
435,https://vlr.gg/player/9508/leosen,2024-07-06 10:00:00,0.91,1.23,1.05,218,201,278,60,28,32,54,30,24,12,3,9,-5,-6,+1,64%,68%,59%,145,126,167,23%,26%,21%,9,3,6,14,9,5
436,https://vlr.gg/player/7865/xanarchy,2024-07-06 10:00:00,0.72,0.96,0.83,130,114,155,30,14,16,46,26,20,31,15,16,+2,0,+2,76%,74%,78%,89,81,97,20%,21%,19%,5,2,3,3,2,1
437,https://vlr.gg/player/30750/enes,2024-07-06 10:00:00,0.98,0.61,0.81,176,221,114,42,31,11,55,31,24,26,11,15,-3,-2,-1,73%,79%,66%,120,150,84,22%,24%,19%,2,1,1,5,3,2
438,https://vlr.gg/player/2658/xuss,2024-07-06 10:00:00,1.50,1.62,1.57,311,300,310,77,34,43,43,21,22,10,5,5,+11,+5,+6,76%,69%,82%,192,198,187,30%,38%,24%,16,6,10,5,1,4
439,https://vlr.gg/player/1616/starki,2024-07-06 10:00:00,0.89,1.26,1.09,222,187,265,53,20,33,49,24,25,28,13,15,+6,0,+6,76%,69%,82%,148,127,165,24%,23%,25%,12,4,8,6,4,2
440,https://vlr.gg/player/3753/obnoks,2024-07-06 10:00:00,1.03,0.87,0.95,191,201,186,49,23,26,50,23,27,22,11,11,-5,-3,-2,71%,72%,71%,129,135,124,30%,31%,29%,2,2,0,7,5,2
441,https://vlr.gg/player/7660/fizzy,2024-07-06 10:00:00,0.96,0.80,0.87,190,203,176,49,24,25,51,22,29,17,10,7,-4,-3,-1,71%,75%,68%,122,136,111,34%,36%,31%,6,1,5,10,4,6
442,https://vlr.gg/player/3674/iluri,2024-07-06 10:00:00,0.50,0.77,0.65,129,98,139,28,10,18,50,25,25,27,13,14,-4,-3,-1,70%,66%,74%,84,68,97,34%,21%,44%,1,1,0,5,4,1
443,https://vlr.gg/player/2571/feeqn,2024-07-06 10:00:00,0.72,1.55,1.22,199,132,265,31,7,24,22,11,11,8,2,6,+1,-1,+2,78%,69%,83%,142,93,174,26%,14%,33%,3,0,3,2,1,1
444,https://vlr.gg/player/1620/ale,2024-07-06 10:00:00,0.59,1.60,1.19,212,135,251,29,6,23,22,12,10,8,1,7,+1,-3,+4,65%,50%,75%,142,101,169,23%,17%,27%,9,2,7,8,5,3
445,https://vlr.gg/player/23174/snowi,2024-07-06 10:00:00,1.25,1.11,1.16,202,241,168,29,14,15,24,11,13,20,6,14,+1,0,+1,70%,63%,75%,120,153,99,31%,36%,28%,3,1,2,2,1,1
446,https://vlr.gg/player/23220/jesmu,2024-07-06 10:00:00,1.00,1.26,1.15,252,218,257,34,13,21,27,13,14,16,5,11,+3,0,+3,85%,81%,88%,156,144,163,20%,18%,21%,4,1,3,1,1,0
447,https://vlr.gg/player/1365/nixoon,2024-07-06 10:00:00,1.00,0.76,0.85,199,257,165,28,14,14,33,14,19,13,6,7,0,0,0,73%,81%,67%,131,166,109,26%,23%,29%,4,2,2,4,2,2
448,https://vlr.gg/player/42549/ozzytk,2024-07-06 10:00:00,0.80,1.56,1.10,242,226,298,33,16,17,31,21,10,11,4,7,-3,-2,-1,68%,54%,88%,172,147,209,40%,32%,50%,4,3,1,7,5,2
449,https://vlr.gg/player/5481/melo,2024-07-06 10:00:00,0.96,0.98,0.97,213,236,173,29,20,9,30,20,10,10,1,9,0,-1,+1,70%,67%,75%,135,154,106,39%,46%,27%,4,2,2,4,3,1
450,https://vlr.gg/player/28480/marky,2024-07-06 10:00:00,0.67,1.37,0.95,206,154,269,27,10,17,28,18,10,8,6,2,-2,-5,+3,73%,63%,88%,128,111,153,17%,13%,22%,4,0,4,6,5,1
451,https://vlr.gg/player/31298/luca,2024-07-06 10:00:00,0.72,1.09,0.87,155,134,192,22,11,11,29,18,11,6,2,4,+3,+1,+2,70%,58%,88%,114,103,131,24%,32%,16%,5,2,3,2,1,1
452,https://vlr.gg/player/22110/rivenary,2024-07-06 10:00:00,0.53,0.46,0.50,118,109,130,17,10,7,33,20,13,5,1,4,-4,-3,-1,50%,46%,56%,73,69,78,21%,41%,10%,0,0,0,4,3,1
453,https://vlr.gg/player/4742/smoggy,2024-07-06 08:20:00,,,,242,,,35,,,27,,,18,,,-2,,,,,,160,,,26%,,,3,,,5,,
454,https://vlr.gg/player/13768/s1mon,2024-07-06 08:20:00,,,,227,,,38,,,30,,,17,,,-1,,,,,,153,,,48%,,,2,,,3,,
455,https://vlr.gg/player/3520/zmjjkk,2024-07-06 08:20:00,,,,223,,,37,,,34,,,9,,,0,,,,,,126,,,15%,,,8,,,8,,
456,https://vlr.gg/player/3017/nobody,2024-07-06 08:20:00,,,,212,,,37,,,29,,,7,,,0,,,,,,140,,,42%,,,5,,,5,,
457,https://vlr.gg/player/15559/chichoo,2024-07-06 08:20:00,,,,164,,,27,,,27,,,8,,,-2,,,,,,110,,,25%,,,2,,,4,,
458,https://vlr.gg/player/10698/nephh,2024-07-06 08:20:00,,,,233,,,38,,,32,,,15,,,-2,,,,,,142,,,19%,,,3,,,5,,
459,https://vlr.gg/player/4885/whzy,2024-07-06 08:20:00,,,,230,,,35,,,38,,,9,,,+7,,,,,,146,,,25%,,,13,,,6,,
460,https://vlr.gg/player/6022/yosemite,2024-07-06 08:20:00,,,,184,,,28,,,37,,,19,,,+4,,,,,,128,,,28%,,,6,,,2,,
461,https://vlr.gg/player/4705/flex1n,2024-07-06 08:20:00,,,,178,,,28,,,22,,,17,,,-3,,,,,,106,,,26%,,,1,,,4,,
462,https://vlr.gg/player/4774/knight,2024-07-06 08:20:00,,,,144,,,18,,,35,,,10,,,-1,,,,,,114,,,15%,,,2,,,3,,
463,https://vlr.gg/player/10114/baha,2024-07-06 08:00:00,1.31,0.87,1.07,210,241,197,33,18,15,33,12,21,9,3,6,-2,-2,0,72%,63%,79%,140,159,125,38%,44%,32%,3,1,2,5,3,2
464,https://vlr.gg/player/11516/drky,2024-07-06 08:00:00,1.09,0.92,1.00,213,231,205,33,16,17,34,15,19,15,5,10,-1,+1,-2,74%,74%,75%,143,149,139,28%,32%,25%,1,1,0,2,0,2
465,https://vlr.gg/player/21865/merz,2024-07-06 08:00:00,0.96,0.66,0.79,172,201,154,23,13,10,36,14,22,23,12,11,-2,-3,+1,67%,79%,58%,119,125,115,31%,33%,29%,2,0,2,4,3,1
466,https://vlr.gg/player/39675/sh1va,2024-07-06 08:00:00,0.40,1.08,0.78,153,109,189,23,6,17,31,15,16,6,4,2,-3,-4,+1,65%,58%,71%,109,92,123,27%,21%,31%,2,0,2,5,4,1
467,https://vlr.gg/player/21584/deminatix,2024-07-06 08:00:00,0.94,0.51,0.70,169,220,138,26,15,11,35,14,21,6,4,2,-5,-3,-2,51%,63%,42%,115,143,93,35%,29%,43%,7,2,5,12,5,7
468,https://vlr.gg/player/5566/jeyj7y,2024-07-06 08:00:00,1.61,1.16,1.41,239,241,244,37,22,15,23,10,13,19,10,9,+6,+3,+3,86%,88%,84%,162,163,161,27%,27%,27%,7,3,4,1,0,1
469,https://vlr.gg/player/4893/lauress,2024-07-06 08:00:00,1.21,0.97,1.10,242,267,210,37,26,11,31,15,16,12,7,5,+6,+2,+4,84%,88%,79%,148,161,131,25%,20%,36%,8,4,4,2,2,0
470,https://vlr.gg/player/11531/patrui,2024-07-06 08:00:00,1.18,0.93,1.07,195,168,216,30,15,15,27,12,15,22,15,7,+3,+1,+2,70%,79%,58%,121,110,134,23%,22%,23%,5,2,3,2,1,1
471,https://vlr.gg/player/18615/batujnax,2024-07-06 08:00:00,1.22,0.83,1.05,228,282,149,35,25,10,31,17,14,6,4,2,+2,0,+2,79%,83%,74%,139,172,98,17%,21%,9%,6,4,2,4,4,0
472,https://vlr.gg/player/2107/russ,2024-07-06 08:00:00,0.76,1.34,1.02,197,161,254,30,13,17,28,16,12,12,7,5,-4,-4,0,72%,75%,68%,142,120,169,22%,17%,27%,2,0,2,6,4,2
473,https://vlr.gg/player/7987/kovaq,2024-07-06 08:00:00,1.31,1.54,1.46,262,208,292,32,9,23,21,6,15,16,4,12,+1,+2,-1,84%,77%,88%,188,148,210,28%,35%,25%,3,2,1,2,0,2
474,https://vlr.gg/player/30754/karma,2024-07-06 08:00:00,0.97,1.14,1.08,178,158,191,23,7,16,21,7,14,10,3,7,+2,+1,+1,86%,77%,92%,125,106,135,23%,23%,24%,4,1,3,2,0,2
475,https://vlr.gg/player/7968/stavinci,2024-07-06 08:00:00,0.79,1.23,1.07,233,189,262,31,9,22,26,9,17,18,3,15,0,0,0,78%,69%,83%,144,120,158,29%,24%,32%,4,2,2,4,2,2
476,https://vlr.gg/player/20302/jini,2024-07-06 08:00:00,1.11,0.97,1.02,188,193,178,26,10,16,24,7,17,18,3,15,-3,0,-3,73%,69%,75%,115,122,111,37%,33%,40%,1,0,1,4,0,4
477,https://vlr.gg/player/4630/magnus,2024-07-06 08:00:00,1.11,0.94,1.00,224,265,195,31,12,19,27,11,16,4,1,3,+3,+4,-1,70%,69%,71%,135,173,114,25%,32%,18%,8,5,3,5,1,4
478,https://vlr.gg/player/1466/exampl,2024-07-06 08:00:00,1.38,1.97,1.59,341,302,410,42,24,18,27,19,8,10,7,3,+3,+3,0,76%,75%,77%,221,199,262,31%,40%,21%,4,3,1,1,0,1
479,https://vlr.gg/player/28098/linus,2024-07-06 08:00:00,0.86,0.78,0.83,164,171,152,21,14,7,29,19,10,14,12,2,-2,-2,0,65%,63%,69%,110,121,88,31%,28%,37%,2,0,2,4,2,2
480,https://vlr.gg/player/11330/mcd,2024-07-06 08:00:00,0.89,0.51,0.76,124,143,85,17,14,3,25,16,9,3,0,3,+1,+2,-1,59%,71%,38%,86,102,55,38%,56%,13%,3,3,0,2,1,1
481,https://vlr.gg/player/22180/spmak,2024-07-06 08:00:00,0.67,0.71,0.69,151,155,143,18,12,6,31,21,10,20,11,9,-2,+3,-5,65%,67%,62%,90,95,81,26%,23%,33%,3,3,0,5,0,5
482,https://vlr.gg/player/29951/ziad,2024-07-06 08:00:00,0.70,0.53,0.64,166,202,123,21,15,6,31,21,10,9,8,1,-3,-2,-1,59%,67%,46%,116,135,80,15%,15%,18%,5,5,0,8,7,1
483,https://vlr.gg/player/999/laz,2024-07-06 06:45:00,1.17,1.42,1.31,246,214,270,53,21,32,36,19,17,21,9,12,+6,+2,+4,69%,64%,73%,163,155,170,36%,34%,37%,8,2,6,2,0,2
484,https://vlr.gg/player/424/dep,2024-07-06 06:45:00,1.06,1.29,1.19,258,232,275,54,23,31,40,19,21,11,7,4,+7,-4,+11,69%,57%,79%,159,145,172,26%,23%,28%,16,3,13,9,7,2
485,https://vlr.gg/player/6668/sugarz3ro,2024-07-06 06:45:00,1.25,1.03,1.13,201,222,187,45,21,24,36,18,18,24,15,9,0,-1,+1,74%,86%,64%,131,152,114,32%,27%,39%,3,1,2,3,2,1
486,https://vlr.gg/player/10588/hiroronn,2024-07-06 06:45:00,0.77,1.09,0.94,193,172,210,41,16,25,42,22,20,12,4,8,+2,0,+2,67%,57%,76%,133,126,138,27%,20%,32%,6,3,3,4,3,1
487,https://vlr.gg/player/29840/yuran,2024-07-06 06:45:00,0.61,0.96,0.80,143,136,149,29,13,16,40,22,18,36,9,27,-6,-5,-1,79%,75%,82%,99,99,100,23%,23%,22%,2,1,1,8,6,2
488,https://vlr.gg/player/13788/jitboys,2024-07-06 06:45:00,1.17,1.04,1.11,219,243,198,44,27,17,43,25,18,22,9,13,-3,-4,+1,69%,64%,75%,138,148,126,42%,46%,38%,5,2,3,8,6,2
489,https://vlr.gg/player/5129/ban,2024-07-06 06:45:00,0.91,1.06,0.98,196,172,228,42,20,22,45,24,21,11,6,5,-2,-2,0,61%,55%,68%,138,111,169,38%,38%,38%,6,2,4,8,4,4
490,https://vlr.gg/player/3980/governor,2024-07-06 06:45:00,0.56,1.30,0.90,197,153,249,43,18,25,49,31,18,10,5,5,+1,-5,+6,72%,64%,82%,130,103,161,25%,23%,27%,12,4,8,11,9,2
491,https://vlr.gg/player/3977/crws,2024-07-06 06:45:00,0.67,1.05,0.85,156,130,182,32,14,18,42,25,17,19,9,10,-3,-2,-1,64%,58%,71%,112,94,134,29%,26%,31%,1,0,1,4,2,2
492,https://vlr.gg/player/23062/surf,2024-07-06 06:45:00,0.66,0.89,0.76,149,127,176,33,15,18,43,23,20,10,5,5,-2,-4,+2,62%,61%,64%,97,85,112,34%,37%,31%,2,0,2,4,4,0
493,https://vlr.gg/player/4770/fengf,2024-07-06 05:00:00,,,,243,,,55,,,48,,,16,,,+2,,,,,,169,,,23%,,,12,,,10,,
494,https://vlr.gg/player/37494/kai,2024-07-06 05:00:00,,,,220,,,57,,,47,,,12,,,+3,,,,,,143,,,30%,,,6,,,3,,
495,https://vlr.gg/player/3045/luok1ng,2024-07-06 05:00:00,,,,186,,,45,,,53,,,25,,,-1,,,,,,117,,,39%,,,6,,,7,,
496,https://vlr.gg/player/4712/heybay,2024-07-06 05:00:00,,,,182,,,44,,,48,,,28,,,+3,,,,,,124,,,34%,,,4,,,1,,
497,https://vlr.gg/player/3021/biank,2024-07-06 05:00:00,,,,181,,,44,,,52,,,27,,,-3,,,,,,112,,,17%,,,8,,,11,,
498,https://vlr.gg/player/488/rb,2024-07-06 05:00:00,,,,265,,,63,,,55,,,14,,,+3,,,,,,173,,,21%,,,10,,,7,,
499,https://vlr.gg/player/5011/abo,2024-07-06 05:00:00,,,,201,,,47,,,51,,,13,,,-3,,,,,,133,,,28%,,,13,,,16,,
500,https://vlr.gg/player/30526/b1ack,2024-07-06 05:00:00,,,,198,,,49,,,47,,,26,,,+1,,,,,,115,,,31%,,,6,,,5,,
501,https://vlr.gg/player/14445/ac,2024-07-06 05:00:00,,,,195,,,49,,,45,,,31,,,-1,,,,,,127,,,28%,,,2,,,3,,
502,https://vlr.gg/player/25339/lockm,2024-07-06 05:00:00,,,,171,,,40,,,47,,,21,,,-4,,,,,,121,,,35%,,,1,,,5,,
0,https://vlr.gg/player/35013/flashback,2024-07-06 04:00:00,1.31,1.17,1.25,273,252,304,53,30,23,37,17,20,13,7,6,-2,0,-2,72%,69%,77%,171,162,184,25%,25%,25%,5,3,2,7,3,4
1,https://vlr.gg/player/4462/mako,2024-07-06 04:00:00,1.39,0.95,1.21,196,196,184,37,23,14,31,16,15,29,19,10,+1,+2,-1,83%,88%,77%,118,123,111,33%,39%,26%,4,3,1,3,1,2
2,https://vlr.gg/player/4678/beyn,2024-07-06 04:00:00,1.05,0.90,0.99,183,179,166,33,19,14,33,18,15,16,13,3,+1,+2,-1,72%,78%,64%,113,112,114,35%,39%,32%,4,3,1,3,1,2
3,https://vlr.gg/player/804/buzz,2024-07-06 04:00:00,1.03,0.84,0.95,220,252,172,38,26,12,40,25,15,10,8,2,+6,+5,+1,78%,78%,77%,137,159,105,29%,25%,40%,12,10,2,6,5,1
4,https://vlr.gg/player/11600/foxy9,2024-07-06 04:00:00,0.80,0.57,0.70,144,153,140,28,18,10,37,21,16,20,15,5,0,-1,+1,72%,81%,59%,97,96,98,35%,40%,30%,5,1,4,5,2,3
5,https://vlr.gg/player/1970/neth,2024-07-06 04:00:00,1.23,1.15,1.18,214,214,216,42,17,25,36,15,21,24,15,9,+1,+1,0,76%,91%,66%,129,124,132,26%,32%,23%,2,1,1,1,0,1
6,https://vlr.gg/player/6700/anthem,2024-07-06 04:00:00,1.36,0.73,0.99,189,244,152,37,21,16,37,13,24,10,6,4,-3,-1,-2,74%,77%,72%,118,144,100,27%,23%,31%,2,1,1,5,2,3
7,https://vlr.gg/player/21438/ssees,2024-07-06 04:00:00,0.90,0.86,0.88,151,116,177,26,8,18,36,12,24,28,11,17,-1,0,-1,72%,77%,69%,99,78,114,32%,17%,42%,3,1,2,4,1,3
8,https://vlr.gg/player/6672/meiy,2024-07-06 04:00:00,1.11,0.73,0.87,204,251,186,40,19,21,43,17,26,7,5,2,-4,+1,-5,69%,86%,56%,130,157,110,19%,28%,11%,10,7,3,14,6,8
9,https://vlr.gg/player/993/medusa,2024-07-06 04:00:00,0.94,0.80,0.86,171,180,165,33,16,17,37,16,21,8,4,4,+1,+1,0,69%,77%,63%,117,133,105,30%,29%,31%,7,2,5,6,1,5
10,https://vlr.gg/player/41958/silv,2024-07-06 01:00:00,1.58,1.19,1.35,284,294,281,45,21,24,28,8,20,14,3,11,+7,+1,+6,85%,75%,92%,171,170,171,34%,43%,29%,8,2,6,1,1,0
11,https://vlr.gg/player/26122/soko,2024-07-06 01:00:00,1.34,1.24,1.28,250,237,261,35,13,22,29,11,18,13,7,6,+5,-1,+6,78%,88%,71%,171,162,176,34%,33%,35%,9,3,6,4,4,0
12,https://vlr.gg/player/41926/blue,2024-07-06 01:00:00,1.56,1.05,1.25,247,311,205,34,17,17,24,9,15,7,3,4,+3,0,+3,83%,88%,79%,172,213,144,46%,43%,49%,5,2,3,2,2,0
13,https://vlr.gg/player/41881/yumi,2024-07-06 01:00:00,1.34,0.99,1.13,198,205,191,30,12,18,24,7,17,13,9,4,+3,+1,+2,80%,88%,75%,137,136,137,29%,20%,37%,4,1,3,1,0,1
14,https://vlr.gg/player/41957/tiff,2024-07-06 01:00:00,1.32,0.89,1.06,181,189,172,26,12,14,21,5,16,12,2,10,+2,+1,+1,83%,88%,79%,125,131,121,26%,33%,22%,4,1,3,2,0,2
15,https://vlr.gg/player/45885/lynx,2024-07-06 01:00:00,1.19,0.71,0.99,197,214,171,31,21,10,32,16,16,5,3,2,-4,-7,+3,75%,92%,50%,119,131,100,17%,16%,18%,4,0,4,8,7,1
16,https://vlr.gg/player/45884/shiny,2024-07-06 01:00:00,1.17,0.53,0.92,208,250,149,28,20,8,33,18,15,10,5,5,0,+2,-2,70%,75%,63%,140,165,102,35%,31%,48%,3,2,1,3,0,3
17,https://vlr.gg/player/45882/starlys,2024-07-06 01:00:00,0.94,0.66,0.83,190,202,177,26,17,9,35,20,15,11,6,5,-5,-6,+1,78%,88%,63%,122,126,115,23%,28%,18%,1,0,1,6,6,0
18,https://vlr.gg/player/45883/jess,2024-07-06 01:00:00,0.69,0.82,0.74,166,165,169,23,13,10,34,20,14,10,6,4,-4,-4,0,60%,58%,63%,114,117,111,34%,29%,42%,2,1,1,6,5,1
19,https://vlr.gg/player/45887/jaydiebabie,2024-07-06 01:00:00,0.68,0.15,0.45,143,183,84,18,15,3,36,21,15,10,7,3,-7,-3,-4,63%,71%,50%,94,113,65,23%,26%,19%,0,0,0,7,3,4
20,https://vlr.gg/player/28596/wanheda,2024-07-05 22:00:00,1.12,0.96,1.01,213,194,222,27,10,17,32,9,23,16,4,12,-1,0,-1,67%,67%,67%,140,129,147,23%,15%,28%,4,1,3,5,1,4
21,https://vlr.gg/player/28598/chloe,2024-07-05 22:00:00,0.77,0.81,0.80,209,233,194,28,12,16,34,13,21,5,3,2,-2,+3,-5,59%,73%,50%,122,133,115,16%,15%,16%,8,6,2,10,3,7
22,https://vlr.gg/player/35839/vefa,2024-07-05 22:00:00,0.70,0.82,0.77,155,139,175,20,7,13,32,11,21,11,5,6,-1,0,-1,56%,60%,54%,100,81,111,35%,23%,41%,1,0,1,2,0,2
23,https://vlr.gg/player/21476/cami,2024-07-05 22:00:00,1.26,0.37,0.71,183,296,121,24,16,8,36,11,25,13,6,7,-2,0,-2,62%,87%,46%,125,187,86,32%,49%,17%,1,1,0,3,1,2
24,https://vlr.gg/player/44473/romii,2024-07-05 22:00:00,0.89,0.40,0.59,109,151,82,16,9,7,31,9,22,7,3,4,-3,0,-3,49%,60%,42%,68,93,53,25%,22%,29%,1,1,0,4,1,3
25,https://vlr.gg/player/39565/ellie,2024-07-05 22:00:00,1.57,1.34,1.48,262,252,256,36,22,14,21,10,11,12,8,4,+5,+3,+2,85%,92%,73%,165,170,157,28%,32%,23%,7,4,3,2,1,1
26,https://vlr.gg/player/17982/lunafox,2024-07-05 22:00:00,1.35,1.30,1.33,220,224,240,35,22,13,20,10,10,10,5,5,0,0,0,77%,88%,60%,161,161,162,42%,47%,35%,3,2,1,3,2,1
27,https://vlr.gg/player/26032/panday,2024-07-05 22:00:00,1.26,1.28,1.27,259,251,249,35,22,13,23,14,9,14,9,5,+1,+3,-2,85%,96%,67%,168,160,180,28%,33%,20%,4,3,1,3,0,3
28,https://vlr.gg/player/36737/alexaishot,2024-07-05 22:00:00,1.36,0.82,1.15,283,340,171,39,30,9,28,16,12,9,6,3,+7,+7,0,79%,88%,67%,176,214,116,13%,16%,7%,10,9,1,3,2,1
29,https://vlr.gg/player/28387/fire,2024-07-05 22:00:00,1.16,0.38,0.86,138,177,83,20,16,4,23,11,12,13,11,2,-4,-1,-3,72%,79%,60%,88,112,49,17%,21%,6%,0,0,0,4,1,3
30,https://vlr.gg/player/35660/tok1o,2024-07-05 20:00:00,1.29,1.56,1.42,280,271,291,79,41,38,51,31,20,13,2,11,+7,+1,+6,75%,67%,84%,178,166,192,27%,40%,17%,16,8,8,9,7,2
31,https://vlr.gg/player/45468/bae,2024-07-05 20:00:00,0.89,1.13,1.00,186,174,211,54,26,28,53,33,20,16,9,7,-3,-3,0,76%,67%,86%,129,119,140,31%,29%,34%,4,1,3,7,4,3
32,https://vlr.gg/player/35867/saikiwi,2024-07-05 20:00:00,0.70,1.07,0.87,201,168,251,57,25,32,65,36,29,15,4,11,-2,-4,+2,66%,58%,76%,135,108,167,32%,35%,31%,8,2,6,10,6,4
33,https://vlr.gg/player/35860/vossu,2024-07-05 20:00:00,0.65,0.95,0.78,170,155,187,29,14,15,37,24,13,9,6,3,-1,-2,+1,66%,61%,73%,107,107,107,29%,26%,33%,3,1,2,4,3,1
34,https://vlr.gg/player/36082/asia,2024-07-05 20:00:00,0.63,0.93,0.77,145,142,169,44,21,23,60,35,25,21,7,14,-6,-4,-2,61%,49%,76%,106,98,116,28%,30%,26%,3,2,1,9,6,3
35,https://vlr.gg/player/43958/yuna,2024-07-05 20:00:00,0.31,1.03,0.67,134,84,184,15,5,10,24,13,11,11,6,5,-3,-3,0,70%,60%,80%,89,58,121,45%,38%,48%,2,0,2,5,3,2
36,https://vlr.gg/player/42378/nicky,2024-07-05 20:00:00,1.29,1.33,1.31,247,222,275,70,29,41,53,25,28,31,15,16,+6,-1,+7,80%,76%,84%,156,138,172,36%,26%,45%,9,1,8,3,2,1
37,https://vlr.gg/player/21108/ponix,2024-07-05 20:00:00,0.89,1.27,1.09,187,182,200,53,23,30,52,29,23,28,14,14,+4,+2,+2,74%,73%,74%,134,118,147,26%,30%,24%,6,3,3,2,1,1
38,https://vlr.gg/player/33177/none,2024-07-05 20:00:00,0.67,1.29,1.01,254,206,299,70,24,46,65,33,32,9,6,3,+6,-2,+8,70%,62%,77%,164,134,190,29%,32%,27%,20,8,12,14,10,4
39,https://vlr.gg/player/21548/adenina,2024-07-05 20:00:00,0.85,1.01,0.94,186,187,176,51,24,27,53,30,23,34,16,18,-1,+1,-2,79%,81%,77%,112,109,114,21%,16%,25%,6,3,3,7,2,5
40,https://vlr.gg/player/24770/babzzz,2024-07-05 20:00:00,0.63,0.98,0.82,175,144,183,46,18,28,55,29,26,16,6,10,-7,-7,0,59%,51%,65%,109,96,121,18%,17%,18%,3,0,3,10,7,3
41,https://vlr.gg/player/17694/prask,2024-07-05 19:00:00,1.35,1.12,1.22,210,242,186,60,28,32,44,20,24,24,12,12,-2,-5,+3,74%,71%,77%,143,170,122,36%,43%,29%,4,0,4,6,5,1
42,https://vlr.gg/player/593/fresht,2024-07-05 19:00:00,1.18,1.14,1.16,240,234,233,60,28,32,51,22,29,20,6,14,+3,+2,+1,77%,68%,85%,157,150,162,27%,27%,27%,9,4,5,6,2,4
43,https://vlr.gg/player/42199/rei,2024-07-05 19:00:00,0.96,1.30,1.15,184,175,220,56,20,36,43,20,23,16,6,10,+4,-1,+5,79%,74%,82%,130,111,145,31%,43%,24%,12,5,7,8,6,2
44,https://vlr.gg/player/15924/winter,2024-07-05 19:00:00,1.25,0.99,1.10,176,220,160,48,23,25,40,18,22,22,12,10,+1,+1,0,77%,81%,74%,122,150,100,28%,32%,24%,4,2,2,3,1,2
45,https://vlr.gg/player/7639/ezznap,2024-07-05 19:00:00,0.86,1.10,0.99,192,166,217,48,16,32,47,23,24,38,16,22,-6,-4,-2,77%,77%,77%,125,118,130,16%,21%,14%,4,1,3,10,5,5
46,https://vlr.gg/player/17669/pompz,2024-07-05 19:00:00,1.22,1.16,1.19,220,211,249,54,28,26,53,27,26,34,16,18,+4,-1,+5,76%,79%,71%,157,135,186,28%,31%,26%,7,1,6,3,2,1
47,https://vlr.gg/player/2995/maka,2024-07-05 19:00:00,1.06,1.07,1.06,213,209,240,56,29,27,56,28,28,39,18,21,+4,+2,+2,74%,72%,77%,128,119,138,23%,26%,20%,8,4,4,4,2,2
48,https://vlr.gg/player/35567/toro,2024-07-05 19:00:00,0.88,0.72,0.81,136,146,128,38,22,16,50,26,24,17,10,7,-3,-2,-1,63%,67%,58%,89,95,82,31%,39%,24%,2,0,2,5,2,3
49,https://vlr.gg/player/1328/javiierh,2024-07-05 19:00:00,0.68,0.74,0.71,180,180,180,30,15,15,41,22,19,17,7,10,-2,0,-2,67%,63%,70%,123,121,126,23%,22%,24%,3,2,1,5,2,3
50,https://vlr.gg/player/21993/gonchz,2024-07-05 19:00:00,0.50,0.86,0.66,155,148,199,41,19,22,59,31,28,7,5,2,-3,-5,+2,66%,72%,58%,107,99,118,27%,25%,30%,12,7,5,15,12,3
51,https://vlr.gg/player/17675/monsoo,2024-07-05 19:00:00,0.37,0.34,0.36,39,17,108,6,0,6,13,6,7,4,2,2,0,-1,+1,50%,50%,50%,28,17,60,29%,0%,67%,1,0,1,1,1,0
52,https://vlr.gg/player/26214/cidzzz,2024-07-05 18:15:00,0.64,1.48,1.01,207,174,263,28,13,15,28,19,9,9,5,4,-3,-2,-1,72%,75%,69%,133,111,160,18%,23%,15%,0,0,0,3,2,1
53,https://vlr.gg/player/14950/gobera,2024-07-05 18:15:00,0.78,1.01,0.88,179,177,189,21,11,10,28,17,11,10,4,6,0,+2,-2,67%,60%,75%,125,123,127,19%,18%,19%,6,4,2,6,2,4
54,https://vlr.gg/player/945/drakonz,2024-07-05 18:15:00,1.09,0.48,0.82,169,216,107,20,15,5,30,17,13,11,6,5,-2,0,-2,69%,75%,63%,115,140,85,39%,47%,30%,1,1,0,3,1,2
55,https://vlr.gg/player/15361/swag,2024-07-05 18:15:00,0.58,1.03,0.78,208,158,278,26,10,16,30,16,14,7,3,4,+2,-2,+4,61%,45%,81%,136,114,164,29%,20%,40%,5,1,4,3,3,0
56,https://vlr.gg/player/36106/skz,2024-07-05 18:15:00,0.52,0.54,0.52,149,148,150,16,8,8,31,18,13,11,8,3,-3,0,-3,69%,70%,69%,99,96,102,22%,21%,23%,3,3,0,6,3,3
57,https://vlr.gg/player/1586/v1nny,2024-07-05 18:15:00,1.34,1.45,1.40,232,215,234,30,12,18,16,7,9,24,7,17,+1,+1,0,81%,81%,80%,140,136,143,33%,32%,34%,2,1,1,1,0,1
58,https://vlr.gg/player/3455/zanatsu,2024-07-05 18:15:00,1.14,1.45,1.31,307,255,343,35,14,21,30,13,17,16,5,11,+5,+1,+4,78%,75%,80%,204,176,227,22%,30%,18%,12,5,7,7,4,3
59,https://vlr.gg/player/5395/cortezia,2024-07-05 18:15:00,0.82,1.66,1.29,284,261,305,36,14,22,27,16,11,17,7,10,+2,+3,-1,92%,88%,95%,189,164,210,34%,32%,36%,6,4,2,4,1,3
60,https://vlr.gg/player/3157/gaabxx,2024-07-05 18:15:00,1.55,1.01,1.25,175,206,150,22,12,10,18,7,11,25,12,13,-1,0,-1,81%,81%,80%,110,113,108,27%,23%,32%,1,0,1,2,0,2
61,https://vlr.gg/player/3433/ctc,2024-07-05 18:15:00,0.57,1.18,0.91,136,114,155,24,8,16,20,11,9,6,3,3,-1,-1,0,72%,63%,80%,85,75,92,38%,24%,50%,0,0,0,1,1,0
62,https://vlr.gg/player/1607/ntk,2024-07-05 16:00:00,1.08,1.16,1.13,229,238,237,33,15,18,33,14,19,18,7,11,+1,+2,-1,69%,83%,58%,150,149,152,27%,31%,25%,5,3,2,4,1,3
63,https://vlr.gg/player/32717/maestr0,2024-07-05 16:00:00,0.95,1.02,0.99,204,223,194,30,14,16,31,14,17,10,7,3,+5,+2,+3,76%,83%,71%,140,154,129,30%,27%,33%,7,2,5,2,0,2
64,https://vlr.gg/player/3450/woddy,2024-07-05 16:00:00,1.40,0.55,0.92,189,291,127,29,18,11,32,13,19,14,10,4,-2,-1,-1,71%,78%,67%,135,199,86,36%,31%,48%,2,1,1,4,2,2
65,https://vlr.gg/player/32718/kenkayyy,2024-07-05 16:00:00,0.76,0.96,0.88,179,144,201,26,10,16,31,12,19,9,1,8,-1,-1,0,71%,72%,71%,111,95,123,19%,23%,17%,1,0,1,2,1,1
66,https://vlr.gg/player/22964/forbanz,2024-07-05 16:00:00,0.64,0.66,0.65,193,206,180,27,12,15,37,17,20,7,4,3,+3,+2,+1,64%,56%,71%,117,124,112,22%,21%,23%,9,5,4,6,3,3
67,https://vlr.gg/player/1684/denaro,2024-07-05 16:00:00,1.55,1.39,1.48,222,227,233,36,20,16,22,10,12,17,12,5,-2,-3,+1,90%,92%,89%,146,145,148,27%,25%,30%,2,0,2,4,3,1
68,https://vlr.gg/player/1567/bezn1,2024-07-05 16:00:00,1.60,0.86,1.28,266,323,156,38,28,10,27,14,13,14,5,9,+1,+3,-2,74%,88%,56%,165,216,97,28%,30%,25%,4,4,0,3,1,2
69,https://vlr.gg/player/1999/rnd,2024-07-05 16:00:00,0.84,1.14,0.97,250,240,273,37,20,17,37,21,16,9,4,5,-4,-4,0,79%,75%,83%,155,142,172,21%,28%,14%,7,4,3,11,8,3
70,https://vlr.gg/player/27149/brinks,2024-07-05 16:00:00,0.84,1.15,0.97,224,165,288,33,15,18,31,17,14,14,9,5,-2,+1,-3,71%,79%,61%,147,129,172,31%,42%,24%,2,1,1,4,0,4
71,https://vlr.gg/player/1566/prozin,2024-07-05 16:00:00,0.89,0.74,0.82,137,142,133,20,11,9,28,14,14,14,8,6,+1,+1,0,81%,83%,78%,100,96,107,34%,33%,34%,3,2,1,2,1,1
72,https://vlr.gg/player/1835/elllement,2024-07-05 15:20:00,1.22,1.30,1.25,264,280,226,58,36,22,42,28,14,12,8,4,-5,-2,-3,76%,81%,70%,167,183,147,28%,32%,23%,9,7,2,14,9,5
73,https://vlr.gg/player/4329/vince,2024-07-05 15:20:00,1.09,1.02,1.06,177,171,190,40,22,18,41,23,18,25,13,12,-2,-3,+1,62%,58%,67%,122,129,114,25%,28%,23%,2,0,2,4,3,1
74,https://vlr.gg/player/7490/anguist,2024-07-05 15:20:00,1.08,0.96,1.03,211,223,199,50,32,18,44,26,18,7,4,3,+3,+3,0,83%,83%,81%,144,153,133,38%,34%,44%,8,5,3,5,2,3
75,https://vlr.gg/player/2472/benny,2024-07-05 15:20:00,0.77,1.24,0.97,210,166,272,47,22,25,44,26,18,12,6,6,-6,-6,0,60%,64%,56%,130,102,167,25%,24%,26%,4,1,3,10,7,3
76,https://vlr.gg/player/10885/davih,2024-07-05 15:20:00,0.98,0.94,0.96,182,189,163,40,24,16,42,26,16,16,10,6,-1,-2,+1,67%,61%,74%,130,147,107,27%,35%,17%,3,0,3,4,2,2
77,https://vlr.gg/player/9508/leosen,2024-07-05 15:20:00,1.29,0.95,1.10,238,273,215,54,29,25,47,21,26,11,4,7,+4,+1,+3,79%,85%,75%,164,190,144,23%,27%,17%,13,5,8,9,4,5
78,https://vlr.gg/player/4969/shazeon,2024-07-05 15:20:00,0.72,1.31,1.06,228,164,278,50,14,36,46,19,27,15,3,12,+6,+1,+5,73%,63%,81%,138,99,168,28%,24%,29%,12,4,8,6,3,3
79,https://vlr.gg/player/7865/xanarchy,2024-07-05 15:20:00,0.56,1.12,0.88,180,123,223,42,12,30,49,22,27,13,6,7,+1,-2,+3,63%,63%,64%,121,95,141,27%,28%,26%,4,0,4,3,2,1
80,https://vlr.gg/player/30750/enes,2024-07-05 15:20:00,1.04,0.71,0.85,160,167,157,35,17,18,48,18,30,22,11,11,+3,+2,+1,76%,81%,72%,103,105,102,23%,38%,16%,4,2,2,1,0,1
81,https://vlr.gg/player/122/luckerrr,2024-07-05 15:20:00,0.76,0.82,0.79,158,144,173,32,12,20,45,19,26,28,13,15,-3,-1,-2,68%,67%,69%,103,83,118,22%,22%,22%,4,3,1,7,4,3
82,https://vlr.gg/player/29873/benjyfishy,2024-07-05 15:00:00,1.27,1.16,1.21,202,216,189,48,25,23,33,17,16,9,2,7,+6,+2,+4,77%,79%,75%,139,143,136,34%,35%,34%,8,3,5,2,1,1
83,https://vlr.gg/player/1144/boo,2024-07-05 15:00:00,1.02,1.23,1.13,195,174,211,40,17,23,33,17,16,30,17,13,+4,+3,+1,85%,83%,88%,125,101,146,24%,25%,23%,6,3,3,2,0,2
84,https://vlr.gg/player/18350/miniboo,2024-07-05 15:00:00,0.58,1.49,1.06,220,141,286,48,13,35,43,23,20,18,11,7,+3,-4,+7,79%,69%,88%,141,95,182,41%,46%,38%,10,2,8,7,6,1
85,https://vlr.gg/player/21328/wo0t,2024-07-05 15:00:00,0.69,1.33,1.02,167,122,214,38,12,26,34,19,15,21,9,12,+2,-1,+3,74%,66%,81%,113,82,140,24%,16%,30%,9,4,5,7,5,2
86,https://vlr.gg/player/10971/riens,2024-07-05 15:00:00,1.06,0.99,1.02,202,235,171,43,23,20,38,20,18,17,6,11,+2,+1,+1,75%,76%,75%,127,147,109,29%,37%,21%,6,3,3,4,2,2
87,https://vlr.gg/player/301/takas,2024-07-05 15:00:00,0.45,1.55,0.96,188,120,266,41,13,28,43,28,15,13,4,9,-8,-9,+1,57%,34%,83%,126,86,170,23%,38%,18%,5,1,4,13,10,3
88,https://vlr.gg/player/20871/k4davra,2024-07-05 15:00:00,0.85,1.03,0.94,172,176,173,37,19,18,42,25,17,13,5,8,-4,-4,0,62%,53%,72%,112,114,109,25%,26%,24%,4,2,2,8,6,2
89,https://vlr.gg/player/5004/natank,2024-07-05 15:00:00,0.83,1.08,0.94,228,209,256,44,21,23,48,27,21,18,7,11,-3,-2,-1,66%,56%,76%,147,133,163,23%,21%,25%,7,3,4,10,5,5
90,https://vlr.gg/player/19522/wailers,2024-07-05 15:00:00,0.89,0.91,0.89,143,154,131,32,18,14,40,24,16,7,6,1,0,0,0,75%,81%,69%,107,109,105,30%,30%,30%,2,1,1,2,1,1
91,https://vlr.gg/player/220/beyaz,2024-07-05 15:00:00,0.76,0.79,0.77,140,140,150,27,14,13,44,23,21,27,9,18,-2,-1,-1,70%,69%,72%,94,91,97,19%,17%,21%,4,1,3,6,2,4
92,https://vlr.gg/player/16459/elite,2024-07-05 12:00:00,1.08,1.18,1.13,209,236,179,49,26,23,38,23,15,10,5,5,+3,+1,+2,71%,68%,75%,143,160,127,49%,50%,48%,7,4,3,4,3,1
93,https://vlr.gg/player/8041/brave,2024-07-05 12:00:00,0.69,1.56,1.13,235,157,311,54,18,36,47,27,20,21,9,12,+4,-3,+7,67%,55%,78%,162,110,213,38%,37%,38%,13,2,11,9,5,4
94,https://vlr.gg/player/10161/qutionerx,2024-07-05 12:00:00,0.93,1.01,0.97,205,229,178,46,24,22,46,27,19,9,5,4,+4,+6,-2,68%,61%,75%,122,136,108,25%,36%,16%,9,7,2,5,1,4
95,https://vlr.gg/player/569/paura,2024-07-05 12:00:00,0.56,1.26,0.91,160,105,214,33,9,24,42,25,17,29,13,16,-2,-5,+3,60%,45%,75%,106,70,141,30%,29%,31%,3,0,3,5,5,0
96,https://vlr.gg/player/10146/reazy,2024-07-05 12:00:00,0.76,0.88,0.82,154,144,168,31,14,17,42,22,20,25,12,13,+6,+2,+4,73%,68%,78%,107,97,118,31%,39%,26%,7,3,4,1,1,0
97,https://vlr.gg/player/2168/trexx,2024-07-05 12:00:00,0.92,1.75,1.33,260,184,335,55,19,36,41,23,18,25,10,15,+5,0,+5,86%,84%,87%,164,125,203,13%,17%,12%,6,1,5,1,1,0
98,https://vlr.gg/player/312/sayf,2024-07-05 12:00:00,1.03,1.44,1.23,255,245,277,59,27,32,43,25,18,10,4,6,-10,-8,-2,67%,59%,74%,170,146,194,23%,22%,24%,7,4,3,17,12,5
99,https://vlr.gg/player/11134/kicks,2024-07-05 12:00:00,0.69,1.46,1.07,188,129,243,42,14,28,41,24,17,34,9,25,-1,-2,+1,78%,69%,87%,119,89,150,18%,16%,20%,5,1,4,6,3,3
100,https://vlr.gg/player/21610/runner,2024-07-05 12:00:00,0.81,0.83,0.82,154,140,168,34,16,18,42,22,20,12,6,6,-5,-3,-2,68%,59%,77%,94,95,93,19%,23%,15%,3,0,3,8,3,5
101,https://vlr.gg/player/4321/cender,2024-07-05 12:00:00,0.70,0.68,0.69,119,150,90,25,15,10,46,28,18,24,11,13,-4,-1,-3,65%,59%,71%,78,93,62,29%,39%,20%,3,3,0,7,4,3
102,https://vlr.gg/player/2658/xuss,2024-07-05 12:00:00,1.16,1.74,1.48,259,234,280,64,26,38,35,20,15,6,3,3,+13,+4,+9,82%,73%,89%,169,148,186,29%,33%,26%,15,5,10,2,1,1
103,https://vlr.gg/player/1616/starki,2024-07-05 12:00:00,0.87,1.03,0.96,184,181,186,41,18,23,44,23,21,37,17,20,-1,-2,+1,74%,70%,78%,120,110,127,33%,46%,26%,6,2,4,7,4,3
104,https://vlr.gg/player/7660/fizzy,2024-07-05 12:00:00,1.06,0.75,0.89,178,210,155,43,22,21,43,19,24,7,5,2,+4,+1,+3,65%,67%,64%,118,147,93,35%,51%,21%,11,4,7,7,3,4
105,https://vlr.gg/player/3753/obnoks,2024-07-05 12:00:00,0.87,0.91,0.89,182,174,190,41,19,22,48,22,26,22,7,15,+2,0,+2,73%,63%,81%,118,107,127,34%,40%,31%,6,3,3,4,3,1
106,https://vlr.gg/player/3674/iluri,2024-07-05 12:00:00,0.64,1.09,0.88,151,122,175,39,14,25,43,23,20,25,12,13,0,-3,+3,65%,57%,72%,103,79,123,49%,52%,48%,4,1,3,4,4,0
107,https://vlr.gg/player/10338/lime,2024-07-05 12:00:00,1.08,1.10,1.09,211,222,201,49,27,22,43,26,17,13,11,2,-9,-7,-2,62%,58%,67%,148,156,139,36%,39%,32%,7,3,4,16,10,6
108,https://vlr.gg/player/4244/yaboilewis,2024-07-05 12:00:00,0.93,1.23,1.07,189,176,209,45,22,23,45,26,19,18,7,11,-2,-2,0,67%,61%,73%,135,125,146,46%,52%,42%,3,2,1,5,4,1
109,https://vlr.gg/player/217/seider,2024-07-05 12:00:00,0.77,1.28,1.01,192,157,230,47,21,26,47,27,20,12,4,8,+2,0,+2,61%,58%,63%,111,88,140,40%,36%,44%,8,4,4,6,4,2
110,https://vlr.gg/player/5292/al0rante,2024-07-05 12:00:00,0.83,0.94,0.88,175,167,185,41,23,18,47,26,21,6,0,6,-5,-7,+2,58%,50%,67%,121,119,122,40%,43%,37%,3,0,3,8,7,1
111,https://vlr.gg/player/8834/bucher,2024-07-05 12:00:00,0.77,0.78,0.77,141,108,183,31,13,18,46,24,22,26,18,8,-4,-2,-2,67%,67%,67%,92,72,116,42%,45%,40%,3,0,3,7,2,5
112,https://vlr.gg/player/773/lakia,2024-07-05 07:00:00,1.53,1.62,1.59,221,216,228,28,9,19,11,4,7,15,1,14,-2,-1,-1,88%,78%,92%,152,161,149,21%,50%,16%,3,1,2,5,2,3
113,https://vlr.gg/player/13039/meteor,2024-07-05 07:00:00,1.24,1.65,1.54,326,319,320,38,10,28,18,6,12,7,2,5,+3,+1,+2,82%,67%,88%,212,226,207,31%,38%,28%,3,1,2,0,0,0
114,https://vlr.gg/player/2489/munchkin,2024-07-05 07:00:00,1.59,1.24,1.34,215,258,200,25,9,16,17,5,12,21,4,17,-1,0,-1,82%,78%,83%,146,181,133,27%,30%,26%,3,0,3,4,0,4
115,https://vlr.gg/player/9196/t3xture,2024-07-05 07:00:00,1.00,1.42,1.31,249,234,245,32,8,24,17,6,11,4,2,2,+4,+2,+2,82%,89%,79%,146,144,147,25%,38%,20%,7,3,4,3,1,2
116,https://vlr.gg/player/34974/karon,2024-07-05 07:00:00,1.00,1.24,1.18,171,177,174,23,6,17,16,5,11,13,3,10,+1,+1,0,85%,89%,83%,109,109,109,35%,43%,32%,3,1,2,2,0,2
117,https://vlr.gg/player/3626/lightningfast,2024-07-05 07:00:00,0.71,0.73,0.72,154,134,209,18,12,6,30,21,9,12,8,4,-2,0,-2,61%,54%,78%,100,94,114,36%,50%,23%,1,1,0,3,1,2
118,https://vlr.gg/player/1839/polvi,2024-07-05 07:00:00,0.60,0.93,0.67,176,181,205,21,15,6,30,21,9,4,1,3,-1,-1,0,52%,46%,67%,125,117,144,31%,36%,23%,10,8,2,11,9,2
119,https://vlr.gg/player/9802/benkai,2024-07-05 07:00:00,0.62,0.81,0.67,121,102,191,13,8,5,27,19,8,11,8,3,-1,0,-1,64%,63%,67%,92,73,142,38%,55%,24%,0,0,0,1,0,1
120,https://vlr.gg/player/1743/blazek1ng,2024-07-05 07:00:00,0.64,0.45,0.59,136,150,97,16,13,3,29,21,8,2,1,1,-1,-1,0,52%,50%,56%,88,97,64,40%,42%,36%,1,1,0,2,2,0
121,https://vlr.gg/player/1162/russ,2024-07-05 07:00:00,0.25,0.88,0.42,99,79,178,11,5,6,30,22,8,11,8,3,0,0,0,61%,58%,67%,64,50,100,44%,35%,63%,2,1,1,2,1,1
122,https://vlr.gg/player/3741/vo0kashu,2024-07-05 07:00:00,,,,183,,,25,,,34,,,8,,,+3,,,,,,128,,,28%,,,5,,,2,,
123,https://vlr.gg/player/7841/tvirusluke,2024-07-05 07:00:00,,,,183,,,23,,,34,,,7,,,-2,,,,,,122,,,31%,,,4,,,6,,
124,https://vlr.gg/player/41774/shion7,2024-07-05 07:00:00,,,,167,,,20,,,33,,,9,,,-1,,,,,,112,,,31%,,,4,,,5,,
125,https://vlr.gg/player/11524/nicc,2024-07-05 07:00:00,,,,162,,,19,,,34,,,22,,,-7,,,,,,106,,,37%,,,1,,,8,,
126,https://vlr.gg/player/4880/nizhaotzh,2024-07-05 07:00:00,,,,137,,,18,,,31,,,12,,,-2,,,,,,88,,,32%,,,1,,,3,,
127,https://vlr.gg/player/11218/yuicaw,2024-07-05 07:00:00,,,,291,,,45,,,22,,,10,,,+8,,,,,,188,,,25%,,,9,,,1,,
128,https://vlr.gg/player/871/pl1xx,2024-07-05 07:00:00,,,,256,,,33,,,23,,,28,,,+2,,,,,,162,,,19%,,,5,,,3,,
129,https://vlr.gg/player/14441/aluba,2024-07-05 07:00:00,,,,204,,,32,,,21,,,14,,,+1,,,,,,124,,,24%,,,3,,,2,,
130,https://vlr.gg/player/14125/spring,2024-07-05 07:00:00,,,,203,,,28,,,21,,,7,,,-2,,,,,,138,,,28%,,,5,,,7,,
131,https://vlr.gg/player/7849/siufatbb,2024-07-05 07:00:00,,,,194,,,28,,,18,,,16,,,0,,,,,,128,,,29%,,,2,,,2,,
132,https://vlr.gg/player/7135/hfmi0dzjc9z7,2024-07-05 05:00:00,,,,192,,,22,,,29,,,6,,,-3,,,,,,141,,,28%,,,3,,,6,,
133,https://vlr.gg/player/3547/ninebody,2024-07-05 05:00:00,,,,188,,,22,,,31,,,8,,,+1,,,,,,134,,,15%,,,6,,,5,,
134,https://vlr.gg/player/14444/eren,2024-07-05 05:00:00,,,,185,,,22,,,33,,,5,,,-2,,,,,,119,,,38%,,,1,,,3,,
135,https://vlr.gg/player/3020/coldfish,2024-07-05 05:00:00,,,,150,,,19,,,28,,,8,,,-1,,,,,,100,,,25%,,,2,,,3,,
136,https://vlr.gg/player/39485/scales,2024-07-05 05:00:00,,,,90,,,13,,,31,,,11,,,-3,,,,,,84,,,14%,,,2,,,5,,
137,https://vlr.gg/player/41029/z1yan,2024-07-05 05:00:00,,,,302,,,40,,,16,,,15,,,+2,,,,,,188,,,38%,,,2,,,0,,
138,https://vlr.gg/player/36415/viva,2024-07-05 05:00:00,,,,243,,,33,,,17,,,12,,,+2,,,,,,158,,,30%,,,5,,,3,,
139,https://vlr.gg/player/10486/yhchen,2024-07-05 05:00:00,,,,239,,,29,,,21,,,12,,,+2,,,,,,142,,,25%,,,5,,,3,,
140,https://vlr.gg/player/3519/jkuro,2024-07-05 05:00:00,,,,211,,,26,,,22,,,10,,,+3,,,,,,152,,,23%,,,4,,,1,,
141,https://vlr.gg/player/16924/stew,2024-07-05 05:00:00,,,,180,,,24,,,22,,,6,,,-1,,,,,,116,,,28%,,,6,,,7,,
142,https://vlr.gg/player/9803/d4v41,2024-07-05 04:00:00,1.39,1.27,1.33,233,230,239,53,26,27,41,20,21,23,13,10,+5,+1,+4,79%,81%,77%,157,157,158,32%,29%,36%,7,2,5,2,1,1
143,https://vlr.gg/player/17086/something,2024-07-05 04:00:00,1.13,1.06,1.10,206,218,194,50,25,25,42,22,20,13,7,6,+5,+2,+3,75%,75%,74%,132,147,116,30%,34%,25%,11,6,5,6,4,2
144,https://vlr.gg/player/7378/jinggg,2024-07-05 04:00:00,0.82,1.08,0.95,250,197,299,52,21,31,57,27,30,30,12,18,+8,+1,+7,81%,75%,87%,163,138,188,17%,19%,15%,15,5,10,7,4,3
145,https://vlr.gg/player/9800/mindfreak,2024-07-05 04:00:00,0.80,0.88,0.84,156,144,168,35,18,17,42,21,21,28,12,16,-1,-1,0,67%,63%,71%,105,93,116,27%,34%,21%,2,1,1,3,2,1
146,https://vlr.gg/player/9801/f0rsaken,2024-07-05 04:00:00,0.43,1.13,0.77,154,100,217,36,11,25,47,24,23,23,7,16,-2,-3,+1,71%,63%,81%,98,62,135,31%,31%,31%,4,2,2,6,5,1
147,https://vlr.gg/player/4871/xffero,2024-07-05 04:00:00,1.32,1.18,1.25,255,293,214,57,32,25,45,24,21,17,10,7,0,-2,+2,81%,87%,75%,168,202,134,39%,40%,39%,5,0,5,5,2,3
148,https://vlr.gg/player/24895/jemkin,2024-07-05 04:00:00,0.68,1.56,1.13,222,181,268,50,19,31,42,27,15,16,7,9,-2,-7,+5,81%,71%,91%,153,124,182,33%,35%,32%,8,2,6,10,9,1
149,https://vlr.gg/player/8497/monyet,2024-07-05 04:00:00,1.17,0.82,0.99,206,238,176,45,28,17,50,26,24,29,11,18,-6,-1,-5,76%,71%,81%,131,137,125,33%,33%,33%,5,4,1,11,5,6
150,https://vlr.gg/player/7764/lmemore,2024-07-05 04:00:00,0.93,0.85,0.89,186,183,189,41,22,19,45,23,22,12,5,7,-4,-2,-2,70%,68%,72%,124,118,131,27%,26%,28%,4,2,2,8,4,4
151,https://vlr.gg/player/25025/estrella,2024-07-05 04:00:00,0.70,1.00,0.85,164,144,182,36,14,22,44,25,19,28,16,12,-3,-3,0,78%,74%,81%,106,100,113,30%,27%,33%,2,0,2,5,3,2
152,https://vlr.gg/player/20238/askia,2024-07-04 19:00:00,1.31,1.37,1.34,237,258,235,57,31,26,45,24,21,30,10,20,+4,0,+4,71%,70%,71%,169,174,164,25%,31%,20%,5,1,4,1,1,0
153,https://vlr.gg/player/1581/guhrvn,2024-07-04 19:00:00,1.03,1.15,1.09,196,202,199,46,23,23,44,23,21,29,11,18,-2,-2,0,74%,73%,74%,136,137,134,25%,23%,26%,3,0,3,5,2,3
154,https://vlr.gg/player/8873/dgzin,2024-07-04 19:00:00,0.68,1.40,1.05,258,181,313,57,19,38,52,27,25,13,8,5,-1,-5,+4,65%,55%,74%,156,117,193,24%,21%,26%,16,6,10,17,11,6
155,https://vlr.gg/player/660/pancc,2024-07-04 19:00:00,0.71,0.71,0.71,158,170,137,39,21,18,50,26,24,8,3,5,-4,0,-4,68%,67%,69%,109,110,109,33%,36%,30%,5,4,1,9,4,5
156,https://vlr.gg/player/25743/raafa,2024-07-04 19:00:00,0.52,0.76,0.64,140,126,147,31,14,17,52,27,25,21,9,12,+1,0,+1,63%,58%,69%,94,93,95,20%,27%,15%,4,2,2,3,2,1
157,https://vlr.gg/player/3169/zap,2024-07-04 19:00:00,1.18,1.30,1.24,224,228,225,52,27,25,44,24,20,21,8,13,+3,+1,+2,71%,69%,73%,156,158,155,36%,28%,50%,7,4,3,4,3,1
158,https://vlr.gg/player/11921/silentzz,2024-07-04 19:00:00,1.01,1.32,1.16,276,248,307,69,32,37,51,27,24,6,3,3,+9,+3,+6,76%,71%,82%,179,163,197,32%,35%,30%,16,8,8,7,5,2
159,https://vlr.gg/player/21661/spike,2024-07-04 19:00:00,1.06,1.20,1.13,234,223,231,52,27,25,46,25,21,13,6,7,-5,-5,0,69%,66%,73%,156,150,162,32%,30%,34%,7,3,4,12,8,4
160,https://vlr.gg/player/662/pryze,2024-07-04 19:00:00,0.70,0.99,0.84,152,147,160,37,17,20,45,24,21,19,13,6,-2,-2,0,72%,71%,73%,93,88,99,37%,32%,43%,3,0,3,5,2,3
161,https://vlr.gg/player/6195/lz,2024-07-04 19:00:00,0.73,0.88,0.80,142,111,163,33,13,20,44,22,22,19,13,6,-3,-2,-1,72%,71%,73%,95,81,109,29%,24%,33%,2,0,2,5,2,3
162,https://vlr.gg/player/21659/sato,2024-07-04 16:00:00,1.07,1.78,1.33,273,239,331,58,33,25,41,28,13,5,2,3,+1,-1,+2,77%,67%,95%,172,148,215,43%,43%,43%,10,8,2,9,9,0
163,https://vlr.gg/player/1688/rood,2024-07-04 16:00:00,1.26,0.60,1.02,215,243,167,44,34,10,40,23,17,16,8,8,+4,+2,+2,84%,89%,75%,148,165,117,20%,19%,21%,7,3,4,3,1,2
164,https://vlr.gg/player/1994/evilkyk,2024-07-04 16:00:00,0.77,1.31,0.97,182,148,249,37,18,19,40,27,13,16,12,4,-1,-1,0,82%,86%,75%,122,95,171,30%,36%,24%,3,2,1,4,3,1
165,https://vlr.gg/player/28716/lukxo,2024-07-04 16:00:00,0.85,1.07,0.93,218,214,231,40,25,15,45,30,15,20,11,9,+3,-1,+4,73%,72%,75%,144,142,146,29%,33%,24%,6,1,5,3,2,1
166,https://vlr.gg/player/6238/urango,2024-07-04 16:00:00,0.97,0.49,0.80,174,212,106,33,26,7,43,28,15,25,16,9,-5,-1,-4,77%,78%,75%,121,145,77,23%,22%,25%,3,3,0,8,4,4
167,https://vlr.gg/player/36433/phc,2024-07-04 16:00:00,1.30,1.39,1.36,258,233,273,56,19,37,41,15,26,18,8,10,0,0,0,80%,75%,83%,158,131,173,35%,39%,33%,4,0,4,4,0,4
168,https://vlr.gg/player/23001/zaninzs,2024-07-04 16:00:00,0.64,1.37,1.11,216,157,249,45,12,33,40,17,23,12,4,8,+2,-2,+4,73%,60%,81%,145,106,166,30%,32%,30%,5,0,5,3,2,1
169,https://vlr.gg/player/36110/lewa,2024-07-04 16:00:00,1.02,0.87,0.92,178,171,183,39,14,25,40,13,27,10,1,9,-3,-2,-1,70%,75%,67%,114,123,108,28%,27%,29%,3,1,2,6,3,3
170,https://vlr.gg/player/15395/gbz,2024-07-04 16:00:00,1.25,0.73,0.92,197,248,169,35,17,18,43,14,29,33,11,22,-2,+2,-4,77%,90%,69%,141,163,128,25%,25%,25%,4,4,0,6,2,4
171,https://vlr.gg/player/9266/tisora,2024-07-04 16:00:00,0.60,0.69,0.66,190,177,196,34,11,23,48,17,31,14,6,8,+1,-2,+3,70%,75%,67%,123,120,124,24%,22%,25%,11,3,8,10,5,5
172,https://vlr.gg/player/3424/siduzord,2024-07-04 16:00:00,0.67,1.57,1.01,213,168,341,47,21,26,48,32,16,12,7,5,+2,-1,+3,73%,70%,77%,155,112,227,28%,27%,29%,5,2,3,3,3,0
173,https://vlr.gg/player/13823/pxs,2024-07-04 16:00:00,0.83,0.98,0.89,172,186,187,35,22,13,47,32,15,14,7,7,-3,-3,0,64%,59%,73%,131,128,137,17%,18%,17%,11,6,5,14,9,5
174,https://vlr.gg/player/20240/xenom,2024-07-04 16:00:00,0.93,0.71,0.85,129,139,119,28,18,10,42,27,15,17,11,6,-1,0,-1,63%,59%,68%,82,86,76,35%,30%,43%,3,1,2,4,1,3
175,https://vlr.gg/player/6202/guuih,2024-07-04 16:00:00,0.54,1.28,0.82,171,117,257,36,15,21,42,29,13,12,3,9,0,-1,+1,64%,54%,82%,111,79,165,26%,33%,21%,3,2,1,3,3,0
176,https://vlr.gg/player/23010/nicksz,2024-07-04 16:00:00,0.74,0.96,0.81,158,159,186,36,20,16,44,28,16,14,6,8,-3,-6,+3,49%,41%,64%,104,96,119,25%,20%,33%,5,2,3,8,8,0
177,https://vlr.gg/player/5722/prince,2024-07-04 16:00:00,1.16,1.39,1.31,213,233,215,44,18,26,32,15,17,31,9,22,+6,0,+6,75%,73%,76%,154,167,147,29%,35%,26%,8,2,6,2,2,0
178,https://vlr.gg/player/1578/shion,2024-07-04 16:00:00,1.18,1.19,1.19,188,226,176,39,18,21,33,16,17,24,6,18,-1,-1,0,73%,64%,78%,128,147,116,26%,42%,18%,1,0,1,2,1,1
179,https://vlr.gg/player/21251/blowz,2024-07-04 16:00:00,0.85,1.34,1.16,280,178,312,54,12,42,43,18,25,9,5,4,+5,-2,+7,69%,59%,76%,186,131,219,33%,23%,38%,11,2,9,6,4,2
180,https://vlr.gg/player/42867/ghoul33,2024-07-04 16:00:00,0.51,1.44,1.09,238,161,264,50,12,38,40,21,19,10,4,6,-2,-2,0,73%,68%,76%,155,108,183,40%,48%,37%,7,2,5,9,4,5
181,https://vlr.gg/player/2486/pollo,2024-07-04 16:00:00,0.82,0.95,0.88,162,173,143,36,15,21,34,16,18,11,4,7,-3,-1,-2,68%,68%,68%,102,105,101,26%,44%,17%,5,2,3,8,3,5
182,https://vlr.gg/player/11494/keiko,2024-07-04 14:05:00,1.33,1.29,1.31,255,250,310,40,24,16,28,15,13,5,1,4,+1,-2,+3,82%,71%,100%,183,169,206,31%,37%,23%,4,1,3,3,3,0
183,https://vlr.gg/player/1457/mistic,2024-07-04 14:05:00,1.29,1.22,1.26,206,189,226,28,16,12,22,13,9,25,20,5,0,-1,+1,92%,92%,93%,123,120,127,32%,33%,31%,3,0,3,3,1,2
184,https://vlr.gg/player/114/enzo,2024-07-04 14:05:00,1.59,0.63,1.22,274,310,156,34,26,8,24,12,12,17,12,5,+3,+3,0,74%,79%,67%,148,183,91,24%,28%,15%,4,3,1,1,0,1
185,https://vlr.gg/player/457/nats,2024-07-04 14:05:00,1.05,1.44,1.20,257,244,282,35,19,16,25,16,9,15,10,5,+1,-2,+3,77%,71%,87%,160,153,173,27%,27%,26%,8,5,3,7,7,0
186,https://vlr.gg/player/9780/jamppi,2024-07-04 14:05:00,0.90,1.48,1.12,183,180,182,27,16,11,21,15,6,11,5,6,-4,-2,-2,74%,67%,87%,112,103,125,38%,30%,48%,1,1,0,5,3,2
187,https://vlr.gg/player/2625/sh1n,2024-07-04 14:05:00,1.06,0.92,0.98,195,241,200,29,12,17,33,13,20,16,8,8,0,0,0,72%,80%,67%,130,151,116,33%,30%,36%,2,1,1,2,1,1
188,https://vlr.gg/player/36245/n4rrate,2024-07-04 14:05:00,1.10,0.77,0.89,221,249,195,27,13,14,33,12,21,15,9,6,-2,-2,0,69%,93%,54%,145,156,139,23%,22%,25%,3,1,2,5,3,2
189,https://vlr.gg/player/10307/marteen,2024-07-04 14:05:00,0.86,0.90,0.89,153,161,168,24,9,15,29,11,18,6,3,3,+4,-1,+5,64%,60%,67%,105,92,112,49%,45%,52%,7,1,6,3,2,1
190,https://vlr.gg/player/2173/magnum,2024-07-04 14:05:00,0.68,0.72,0.71,183,162,184,22,8,14,33,12,21,8,2,6,-3,-2,-1,64%,53%,71%,121,119,122,39%,43%,37%,3,0,3,6,2,4
191,https://vlr.gg/player/19691/tomaszy,2024-07-04 14:05:00,0.26,0.61,0.48,135,114,154,18,7,11,36,15,21,11,2,9,0,0,0,49%,40%,54%,89,64,106,27%,36%,24%,4,2,2,4,2,2
192,https://vlr.gg/player/1428/sheydos,2024-07-04 12:00:00,1.58,0.90,1.29,196,240,156,32,23,9,23,11,12,7,2,5,0,+1,-1,88%,92%,83%,145,170,112,37%,42%,29%,1,1,0,1,0,1
193,https://vlr.gg/player/451/shadow,2024-07-04 12:00:00,1.28,1.22,1.25,245,248,237,35,21,14,27,14,13,19,9,10,-3,-2,-1,76%,75%,78%,155,158,151,15%,16%,15%,1,1,0,4,3,1
194,https://vlr.gg/player/5550/grubinho,2024-07-04 12:00:00,0.96,1.21,1.07,156,139,186,26,12,14,24,13,11,9,8,1,-3,-2,-1,69%,71%,67%,102,94,113,41%,32%,55%,1,1,0,4,3,1
195,https://vlr.gg/player/14681/kamo,2024-07-04 12:00:00,0.97,1.13,1.04,283,259,293,39,21,18,35,18,17,10,3,7,+3,+1,+2,67%,75%,56%,173,172,174,33%,33%,33%,13,7,6,10,6,4
196,https://vlr.gg/player/565/starxo,2024-07-04 12:00:00,0.88,0.76,0.83,149,149,144,22,13,9,30,16,14,16,9,7,-3,+2,-5,60%,63%,56%,94,88,103,15%,17%,14%,2,2,0,5,0,5
197,https://vlr.gg/player/2858/suygetsu,2024-07-04 12:00:00,0.81,1.06,0.95,191,181,196,28,11,17,29,13,16,12,7,5,+2,+2,0,69%,67%,71%,127,121,132,31%,21%,40%,4,3,1,2,1,1
198,https://vlr.gg/player/109/ange1,2024-07-04 12:00:00,1.13,0.80,0.94,195,221,184,29,14,15,33,13,20,11,7,4,+7,+3,+4,74%,83%,67%,132,148,121,26%,26%,26%,9,3,6,2,0,2
199,https://vlr.gg/player/384/shao,2024-07-04 12:00:00,1.06,0.86,0.94,164,174,158,24,11,13,27,10,17,16,7,9,-3,-2,-1,69%,78%,63%,110,127,98,19%,16%,24%,1,0,1,4,2,2
200,https://vlr.gg/player/11/zyppan,2024-07-04 12:00:00,0.73,0.92,0.83,212,195,224,32,14,18,34,15,19,7,2,5,+2,+2,0,69%,78%,63%,137,125,145,30%,31%,30%,4,2,2,2,0,2
201,https://vlr.gg/player/98/ardiis,2024-07-04 12:00:00,1.12,0.58,0.81,177,254,132,26,17,9,31,13,18,10,6,4,-2,+1,-3,67%,83%,54%,112,148,85,15%,23%,7%,6,4,2,8,3,5
202,https://vlr.gg/player/3401/ptc,2024-07-04 09:15:00,0.97,1.54,1.27,221,152,287,35,10,25,28,14,14,25,13,12,+1,-1,+2,87%,95%,80%,139,91,181,21%,15%,23%,3,0,3,2,1,1
203,https://vlr.gg/player/6723/foxz,2024-07-04 09:15:00,1.34,1.11,1.22,224,234,225,42,19,23,31,14,17,17,8,9,-1,0,-1,77%,73%,80%,151,151,151,25%,23%,26%,0,0,0,1,0,1
204,https://vlr.gg/player/3342/sushiboys,2024-07-04 09:15:00,0.79,1.44,1.13,182,151,204,31,13,18,26,15,11,14,4,10,+1,-2,+3,79%,64%,92%,120,91,145,23%,18%,26%,5,2,3,4,4,0
205,https://vlr.gg/player/27254/leviathan,2024-07-04 09:15:00,1.31,0.95,1.12,226,247,202,37,19,18,29,13,16,18,11,7,0,+1,-1,77%,77%,76%,142,152,133,36%,32%,41%,5,2,3,5,1,4
206,https://vlr.gg/player/4377/johnolsen,2024-07-04 09:15:00,1.09,0.96,1.02,246,249,240,39,20,19,37,18,19,9,4,5,-2,-2,0,81%,77%,84%,165,172,158,21%,24%,19%,10,5,5,12,7,5
207,https://vlr.gg/player/23930/potter,2024-07-04 09:15:00,0.64,1.32,0.96,222,189,272,33,14,19,38,23,15,8,3,5,-1,-1,0,68%,60%,77%,167,136,202,25%,22%,29%,6,5,1,7,6,1
208,https://vlr.gg/player/12289/siraww,2024-07-04 09:15:00,1.03,0.85,0.95,189,204,173,29,17,12,36,20,16,22,9,13,-1,0,-1,72%,68%,77%,117,123,109,29%,32%,26%,3,1,2,4,1,3
209,https://vlr.gg/player/2366/alert,2024-07-04 09:15:00,0.67,1.21,0.92,212,174,246,32,13,19,34,20,14,10,6,4,-1,-2,+1,70%,68%,73%,143,130,159,25%,29%,23%,4,2,2,5,4,1
210,https://vlr.gg/player/2368/b3ta,2024-07-04 09:15:00,0.99,0.75,0.88,186,196,184,31,18,13,38,20,18,16,8,8,+2,0,+2,72%,72%,73%,128,129,128,33%,30%,37%,6,2,4,4,2,2
211,https://vlr.gg/player/10791/bnwgiggs,2024-07-04 09:15:00,0.88,0.71,0.80,171,174,164,26,15,11,38,20,18,17,9,8,+2,0,+2,70%,72%,68%,110,115,103,24%,20%,29%,5,1,4,3,1,2
212,https://vlr.gg/player/24628/wayne,2024-07-04 09:15:00,0.77,1.41,1.11,212,131,272,52,16,36,48,23,25,24,13,11,+4,-1,+5,77%,66%,87%,129,89,164,28%,24%,31%,5,0,5,1,1,0
213,https://vlr.gg/player/11704/styron,2024-07-04 09:15:00,1.22,1.02,1.11,206,205,202,53,25,28,47,20,27,20,8,12,+3,+3,0,77%,77%,77%,130,130,131,25%,35%,17%,6,3,3,3,0,3
214,https://vlr.gg/player/7426/juicy,2024-07-04 09:15:00,1.05,1.04,1.04,219,226,221,57,28,29,53,26,27,13,6,7,+7,+5,+2,68%,69%,67%,147,156,139,33%,41%,25%,15,9,6,8,4,4
215,https://vlr.gg/player/34032/grumble,2024-07-04 09:15:00,1.13,0.78,0.95,204,234,178,53,31,22,57,26,31,18,4,14,+1,+1,0,69%,74%,64%,139,157,122,46%,46%,47%,6,3,3,5,2,3
216,https://vlr.gg/player/24653/vera,2024-07-04 09:15:00,0.62,1.00,0.82,187,170,216,49,18,31,56,28,28,12,8,4,-9,-7,-2,65%,54%,74%,127,116,138,21%,23%,20%,8,3,5,17,10,7
217,https://vlr.gg/player/2378/subbey,2024-07-04 09:15:00,1.40,1.02,1.22,245,270,215,67,40,27,52,27,25,24,15,9,-1,+4,-5,73%,74%,71%,154,170,136,29%,31%,27%,6,5,1,7,1,6
218,https://vlr.gg/player/3480/thedoctorr,2024-07-04 09:15:00,1.25,1.17,1.21,258,247,252,64,35,29,55,28,27,28,14,14,+3,0,+3,77%,79%,74%,158,171,143,34%,32%,37%,9,2,7,6,2,4
219,https://vlr.gg/player/45876/fixy,2024-07-04 09:15:00,0.71,1.21,0.95,221,205,225,54,26,28,55,34,21,16,11,5,-6,-4,-2,61%,54%,69%,139,131,149,23%,22%,24%,8,4,4,14,8,6
220,https://vlr.gg/player/7513/markl,2024-07-04 09:15:00,0.70,0.96,0.82,168,163,183,43,20,23,52,29,23,16,9,7,-2,-5,+3,70%,64%,77%,109,109,109,23%,26%,18%,7,2,5,9,7,2
221,https://vlr.gg/player/21051/jans0n,2024-07-04 09:15:00,0.78,0.79,0.78,132,138,129,33,18,15,51,28,23,33,18,15,0,0,0,69%,69%,69%,83,86,79,21%,23%,20%,4,4,0,4,4,0
222,https://vlr.gg/player/8582/laz,2024-07-04 07:00:00,1.57,1.73,1.65,277,263,292,44,22,22,24,13,11,10,4,6,+2,-1,+3,79%,76%,81%,173,165,181,31%,28%,35%,3,0,3,1,1,0
223,https://vlr.gg/player/18035/garnets,2024-07-04 07:00:00,1.08,1.27,1.17,252,268,236,36,18,18,28,18,10,8,5,3,+2,+2,0,83%,81%,86%,169,179,158,28%,47%,14%,9,5,4,7,3,4
224,https://vlr.gg/player/5687/alonefillz,2024-07-04 07:00:00,0.67,1.49,1.08,210,160,260,29,10,19,27,16,11,17,8,9,+3,-1,+4,79%,62%,95%,151,119,182,23%,25%,22%,5,1,4,2,2,0
225,https://vlr.gg/player/16977/socools0da,2024-07-04 07:00:00,0.49,1.28,0.88,196,128,265,29,8,21,30,17,13,15,5,10,+1,-1,+2,76%,71%,81%,123,84,163,33%,29%,36%,3,0,3,2,1,1
226,https://vlr.gg/player/12291/arpoom,2024-07-04 07:00:00,0.86,0.71,0.78,151,178,126,24,13,11,30,17,13,14,7,7,-2,0,-2,67%,52%,81%,101,116,86,42%,38%,50%,4,4,0,6,4,2
227,https://vlr.gg/player/4376/santagolf,2024-07-04 07:00:00,0.81,1.82,1.31,236,167,305,37,12,25,29,18,11,15,8,7,+1,0,+1,76%,67%,86%,144,104,184,22%,28%,18%,1,0,1,0,0,0
228,https://vlr.gg/player/1908/kongared,2024-07-04 07:00:00,0.81,1.27,1.04,213,180,247,31,13,18,32,18,14,13,4,9,-3,-2,-1,71%,62%,81%,150,126,174,26%,32%,21%,1,0,1,4,2,2
229,https://vlr.gg/player/37547/tbloy,2024-07-04 07:00:00,0.94,0.50,0.72,176,194,160,26,16,10,36,18,18,6,1,5,+2,+1,+1,67%,67%,67%,113,122,104,23%,28%,16%,6,4,2,4,3,1
230,https://vlr.gg/player/8581/raigard,2024-07-04 07:00:00,0.58,0.85,0.71,148,137,160,19,7,12,31,18,13,18,10,8,-4,-2,-2,64%,57%,71%,101,100,102,27%,24%,31%,2,0,2,6,2,4
231,https://vlr.gg/player/40511/niz,2024-07-04 07:00:00,0.45,0.95,0.70,178,152,205,26,10,16,34,19,15,5,1,4,-2,-4,+2,60%,43%,76%,112,101,122,24%,22%,25%,8,3,5,10,7,3
232,https://vlr.gg/player/5011/abo,2024-07-04 07:00:00,,,,261,,,40,,,24,,,8,,,+5,,,,,,170,,,30%,,,8,,,3,,
233,https://vlr.gg/player/488/rb,2024-07-04 07:00:00,,,,226,,,33,,,33,,,9,,,-2,,,,,,143,,,38%,,,10,,,12,,
234,https://vlr.gg/player/14445/ac,2024-07-04 07:00:00,,,,209,,,30,,,24,,,19,,,-2,,,,,,133,,,27%,,,2,,,4,,
235,https://vlr.gg/player/30526/b1ack,2024-07-04 07:00:00,,,,197,,,30,,,24,,,15,,,0,,,,,,122,,,34%,,,1,,,1,,
236,https://vlr.gg/player/25339/lockm,2024-07-04 07:00:00,,,,139,,,22,,,21,,,11,,,0,,,,,,101,,,44%,,,0,,,0,,
237,https://vlr.gg/player/3028/life,2024-07-04 07:00:00,,,,248,,,35,,,33,,,3,,,+2,,,,,,154,,,37%,,,11,,,9,,
238,https://vlr.gg/player/19530/aaaay,2024-07-04 07:00:00,,,,198,,,29,,,29,,,11,,,+1,,,,,,123,,,29%,,,4,,,3,,
239,https://vlr.gg/player/7857/berlin,2024-07-04 07:00:00,,,,188,,,25,,,31,,,18,,,-3,,,,,,121,,,33%,,,4,,,7,,
240,https://vlr.gg/player/37489/lysoar,2024-07-04 07:00:00,,,,157,,,22,,,31,,,17,,,0,,,,,,107,,,23%,,,0,,,0,,
241,https://vlr.gg/player/872/autumn,2024-07-04 07:00:00,,,,126,,,15,,,31,,,9,,,-1,,,,,,86,,,36%,,,1,,,2,,
242,https://vlr.gg/player/7448/toy,2024-07-04 07:00:00,1.28,1.04,1.12,226,271,203,33,14,19,28,8,20,8,4,4,-1,0,-1,68%,69%,67%,136,165,120,32%,37%,29%,2,2,0,3,2,1
243,https://vlr.gg/player/3023/moosey,2024-07-04 07:00:00,1.62,0.40,0.83,175,263,138,21,12,9,30,7,23,12,6,6,-3,0,-3,62%,85%,50%,131,193,97,27%,48%,15%,1,0,1,4,0,4
244,https://vlr.gg/player/26965/haeart,2024-07-04 07:00:00,0.78,0.82,0.80,220,189,233,25,9,16,33,10,23,11,3,8,+5,+1,+4,78%,85%,75%,149,142,153,28%,32%,26%,10,3,7,5,2,3
245,https://vlr.gg/player/36687/miz,2024-07-04 07:00:00,0.76,0.82,0.80,182,140,204,24,7,17,28,7,21,4,2,2,+1,-1,+2,59%,77%,50%,124,102,136,34%,35%,34%,3,0,3,2,1,1
246,https://vlr.gg/player/26969/adept,2024-07-04 07:00:00,0.91,0.65,0.74,139,166,134,18,8,10,26,7,19,6,0,6,-3,-1,-2,70%,92%,58%,103,110,99,33%,50%,24%,2,1,1,5,2,3
247,https://vlr.gg/player/34031/inf,2024-07-04 07:00:00,1.41,0.96,1.25,284,327,171,37,29,8,28,18,10,4,3,1,+3,+3,0,73%,79%,62%,179,217,110,22%,26%,11%,6,6,0,3,3,0
248,https://vlr.gg/player/7418/bryce,2024-07-04 07:00:00,1.32,1.08,1.23,193,203,172,29,20,9,19,11,8,3,3,0,0,0,0,70%,75%,62%,136,143,123,41%,33%,71%,3,2,1,3,2,1
249,https://vlr.gg/player/10703/shiba,2024-07-04 07:00:00,1.28,0.68,1.07,170,200,125,24,19,5,21,12,9,15,10,5,0,0,0,78%,88%,62%,104,122,72,21%,20%,22%,2,1,1,2,1,1
250,https://vlr.gg/player/7417/joshh,2024-07-04 07:00:00,1.18,0.79,1.04,170,181,160,23,17,6,23,12,11,14,9,5,-3,-1,-2,78%,83%,69%,113,116,108,31%,34%,24%,0,0,0,3,1,2
251,https://vlr.gg/player/42389/persona11,2024-07-04 07:00:00,1.02,1.06,1.03,255,248,258,32,21,11,30,18,12,9,5,4,+1,-2,+3,81%,79%,85%,158,157,159,25%,25%,25%,8,3,5,7,5,2
252,https://vlr.gg/player/37421/riyabtw,2024-07-04 07:00:00,1.76,1.84,1.79,331,339,317,41,22,19,16,10,6,3,2,1,+8,+4,+4,88%,78%,100%,217,218,216,40%,48%,30%,8,4,4,0,0,0
253,https://vlr.gg/player/7851/uta,2024-07-04 07:00:00,1.47,1.96,1.69,291,298,264,36,19,17,14,11,3,6,3,3,+3,+1,+2,91%,89%,93%,188,173,206,27%,24%,30%,5,3,2,2,2,0
254,https://vlr.gg/player/24302/chimei,2024-07-04 07:00:00,0.73,1.66,1.15,170,104,255,20,6,14,16,11,5,24,9,15,-4,-3,-1,88%,78%,100%,119,64,185,14%,14%,14%,0,0,0,4,3,1
255,https://vlr.gg/player/12365/coconut,2024-07-04 07:00:00,0.97,1.27,1.11,205,219,195,25,15,10,19,13,6,11,5,6,-2,-2,0,82%,78%,87%,130,138,121,31%,31%,32%,2,0,2,4,2,2
256,https://vlr.gg/player/24304/kiuuuu,2024-07-04 07:00:00,0.92,1.07,0.99,195,175,221,24,12,12,22,12,10,7,4,3,+2,0,+2,67%,61%,73%,125,112,140,40%,41%,38%,5,2,3,3,2,1
257,https://vlr.gg/player/42994/nasty,2024-07-04 07:00:00,0.35,1.15,0.79,190,120,244,21,5,16,30,15,15,3,1,2,+2,0,+2,45%,40%,50%,125,86,157,24%,27%,22%,3,1,2,1,1,0
258,https://vlr.gg/player/31853/n11,2024-07-04 07:00:00,0.62,0.75,0.68,145,138,163,16,7,9,29,14,15,7,1,6,-1,-1,0,52%,40%,61%,117,103,128,53%,67%,43%,2,0,2,3,1,2
259,https://vlr.gg/player/46327/ethan,2024-07-04 07:00:00,0.53,0.79,0.66,165,142,187,19,7,12,28,14,14,1,0,1,-2,0,-2,48%,33%,61%,109,87,127,34%,14%,55%,5,2,3,7,2,5
260,https://vlr.gg/player/2371/popoman4q,2024-07-04 07:00:00,0.45,0.69,0.58,130,127,137,15,6,9,27,14,13,5,3,2,-1,-2,+1,61%,47%,72%,95,96,95,27%,30%,23%,1,0,1,2,2,0
261,https://vlr.gg/player/46462/shu,2024-07-04 07:00:00,0.34,0.62,0.49,148,115,172,16,5,11,32,15,17,5,2,3,-5,-4,-1,61%,47%,72%,113,92,130,28%,27%,28%,2,1,1,7,5,2
262,https://vlr.gg/player/15081/maishiu,2024-07-04 06:40:00,0.98,1.44,1.22,241,173,291,57,18,39,46,23,23,32,17,15,+7,+1,+6,77%,76%,78%,146,126,164,20%,20%,19%,12,3,9,5,2,3
263,https://vlr.gg/player/36747/bonobo,2024-07-04 06:40:00,1.12,1.08,1.10,230,240,207,53,28,25,49,23,26,17,6,11,+1,+3,-2,73%,64%,81%,151,159,145,25%,26%,24%,11,8,3,10,5,5
264,https://vlr.gg/player/1771/myth,2024-07-04 06:40:00,0.95,1.18,1.07,189,166,193,45,20,25,43,23,20,32,12,20,0,0,0,70%,61%,78%,114,110,118,25%,32%,21%,2,1,1,2,1,1
265,https://vlr.gg/player/31580/vizsla,2024-07-04 06:40:00,0.74,1.33,1.05,231,165,294,54,18,36,49,26,23,19,7,12,-2,-3,+1,71%,61%,81%,153,110,192,29%,23%,33%,6,2,4,8,5,3
266,https://vlr.gg/player/22816/blessed,2024-07-04 06:40:00,0.74,0.82,0.78,128,169,104,34,19,15,46,26,20,30,14,16,-4,-2,-2,73%,76%,70%,82,102,65,33%,39%,25%,5,2,3,9,4,5
267,https://vlr.gg/player/1175/signed,2024-07-04 06:40:00,1.25,1.31,1.28,238,240,279,62,30,32,47,26,21,18,10,8,+10,+5,+5,73%,70%,76%,156,142,171,39%,27%,56%,12,5,7,2,0,2
268,https://vlr.gg/player/1062/lew,2024-07-04 06:40:00,1.19,1.10,1.15,215,241,185,49,29,20,44,26,18,15,8,7,+3,+2,+1,73%,70%,76%,152,166,137,23%,27%,19%,8,5,3,5,3,2
269,https://vlr.gg/player/6659/dragon,2024-07-04 06:40:00,0.82,1.47,1.13,212,160,275,55,20,35,48,28,20,27,18,9,-5,-2,-3,69%,68%,70%,136,93,184,44%,39%,49%,3,2,1,8,4,4
270,https://vlr.gg/player/5228/minimise,2024-07-04 06:40:00,0.53,0.86,0.68,129,112,152,31,14,17,49,29,20,29,13,16,-8,-6,-2,64%,62%,67%,80,73,87,22%,26%,19%,5,2,3,13,8,5
271,https://vlr.gg/player/2993/rdeew,2024-07-04 06:40:00,0.50,0.77,0.62,151,136,158,35,18,17,55,32,23,13,3,10,-2,-2,0,54%,38%,73%,103,94,113,17%,23%,13%,6,3,3,8,5,3
272,https://vlr.gg/player/25017/ash,2024-07-04 06:00:00,1.10,1.18,1.14,249,242,258,52,28,24,42,24,18,9,6,3,+2,0,+2,71%,60%,86%,157,150,167,31%,30%,32%,12,8,4,10,8,2
273,https://vlr.gg/player/1963/hate,2024-07-04 06:00:00,1.20,0.97,1.10,227,242,208,51,29,22,48,26,22,15,11,4,-4,-1,-3,75%,80%,68%,155,171,135,31%,31%,32%,5,3,2,9,4,5
274,https://vlr.gg/player/4479/jeong-hi,2024-07-04 06:00:00,0.98,1.22,1.08,166,143,203,37,18,19,40,21,19,35,19,16,+2,+2,0,67%,71%,61%,112,92,136,26%,29%,24%,3,2,1,1,0,1
275,https://vlr.gg/player/7483/nakji,2024-07-04 06:00:00,1.11,0.65,0.91,175,203,139,39,26,13,43,21,22,20,11,9,-3,-1,-2,71%,74%,68%,117,144,82,32%,33%,30%,5,1,4,8,2,6
276,https://vlr.gg/player/24977/beomjun,2024-07-04 06:00:00,0.95,0.65,0.82,184,207,153,36,24,12,49,27,22,36,23,13,-2,-1,-1,71%,77%,64%,113,122,103,21%,28%,15%,4,3,1,6,4,2
277,https://vlr.gg/player/5280/972,2024-07-04 06:00:00,1.12,1.33,1.24,242,207,272,55,22,33,46,20,26,31,13,18,+5,+1,+4,78%,75%,80%,166,149,181,28%,28%,28%,7,2,5,2,1,1
278,https://vlr.gg/player/4827/goddead,2024-07-04 06:00:00,1.38,0.99,1.16,192,219,169,47,24,23,38,15,23,26,14,12,0,+2,-2,68%,82%,57%,128,140,119,24%,20%,28%,2,2,0,2,0,2
279,https://vlr.gg/player/5283/bunny,2024-07-04 06:00:00,1.27,0.89,1.06,208,242,178,47,25,22,45,18,27,17,8,9,+7,+5,+2,71%,82%,63%,133,147,122,19%,21%,17%,13,6,7,6,1,5
280,https://vlr.gg/player/985/efina,2024-07-04 06:00:00,1.12,0.72,0.90,158,186,141,36,20,16,42,16,26,15,4,11,-2,0,-2,76%,86%,69%,116,133,103,22%,27%,18%,6,2,4,8,2,6
281,https://vlr.gg/player/9783/doenmo,2024-07-04 06:00:00,0.49,1.14,0.85,183,129,229,37,12,25,44,21,23,24,6,18,-5,-4,-1,65%,57%,71%,120,83,150,15%,25%,13%,6,4,2,11,8,3
282,https://vlr.gg/player/27171/grooovy,2024-07-04 06:00:00,1.25,0.64,1.08,251,284,174,14,11,3,16,11,5,9,8,1,0,0,0,76%,75%,80%,174,206,98,26%,29%,15%,1,1,0,1,1,0
283,https://vlr.gg/player/9738/erz4h,2024-07-04 06:00:00,0.79,1.41,0.97,166,128,260,9,4,5,13,9,4,12,10,2,-1,-1,0,76%,75%,80%,103,85,147,30%,33%,27%,0,0,0,1,1,0
284,https://vlr.gg/player/10190/gabbydiz,2024-07-04 06:00:00,0.83,0.46,0.73,150,177,84,8,7,1,16,11,5,18,14,4,-1,-1,0,76%,83%,60%,82,90,61,3%,0%,17%,0,0,0,1,1,0
285,https://vlr.gg/player/27173/sovano,2024-07-04 06:00:00,0.92,0.03,0.64,171,208,85,11,10,1,14,9,5,1,0,1,-8,-4,-4,53%,58%,40%,117,132,80,29%,36%,11%,1,1,0,9,5,4
286,https://vlr.gg/player/27172/jacobbb,2024-07-04 06:00:00,0.62,0.48,0.58,165,169,157,10,7,3,16,11,5,3,3,0,-3,-2,-1,76%,75%,80%,114,112,120,33%,37%,27%,0,0,0,3,2,1
287,https://vlr.gg/player/19975/yort,2024-07-04 06:00:00,,,,,,,,,,,,,,,,,,,,,,,,,,,,,,,,,
288,https://vlr.gg/player/9737/kakarot,2024-07-04 06:00:00,0.77,1.92,1.58,265,185,299,19,4,15,9,4,5,1,1,0,+4,+2,+2,88%,80%,92%,168,102,195,16%,18%,15%,4,2,2,0,0,0
289,https://vlr.gg/player/16953/zynd,2024-07-04 06:00:00,1.81,1.25,1.42,232,217,238,16,6,10,8,1,7,5,1,4,+4,0,+4,94%,100%,92%,144,138,146,23%,20%,24%,4,0,4,0,0,0
290,https://vlr.gg/player/13744/patmen,2024-07-04 06:00:00,1.57,1.26,1.35,285,316,273,18,5,13,14,4,10,9,5,4,+1,0,+1,82%,100%,75%,200,218,192,31%,29%,32%,1,0,1,0,0,0
291,https://vlr.gg/player/7746/kevzii,2024-07-04 06:00:00,1.65,1.04,1.22,230,308,198,11,5,6,11,3,8,14,5,9,+3,+3,0,82%,100%,75%,175,214,158,18%,27%,15%,4,3,1,1,0,1
292,https://vlr.gg/player/13223/micr0,2024-07-04 06:00:00,1.68,0.82,1.08,188,198,185,11,4,7,10,1,9,10,4,6,+1,0,+1,82%,100%,75%,125,136,120,24%,23%,25%,2,0,2,1,0,1
293,https://vlr.gg/player/10739/shiro,2024-07-04 04:45:00,1.31,1.54,1.45,299,320,286,20,9,11,14,6,8,13,4,9,+2,0,+2,95%,88%,100%,187,194,182,19%,23%,18%,4,1,3,2,1,1
294,https://vlr.gg/player/2348/famouz,2024-07-04 04:45:00,0.82,1.76,1.38,317,209,390,23,6,17,15,6,9,8,4,4,0,+1,-1,80%,63%,92%,196,131,240,17%,9%,23%,4,3,1,4,2,2
295,https://vlr.gg/player/7043/ncslasher,2024-07-04 04:45:00,1.84,0.91,1.28,237,253,227,18,8,10,11,2,9,8,3,5,-2,0,-2,90%,100%,83%,143,151,137,24%,21%,26%,0,0,0,2,0,2
296,https://vlr.gg/player/2380/zesbeew,2024-07-04 04:45:00,1.73,0.93,1.25,228,307,176,18,10,8,11,3,8,7,2,5,-3,-1,-2,70%,75%,67%,139,181,110,26%,26%,25%,0,0,0,3,1,2
297,https://vlr.gg/player/4874/berserx,2024-07-04 04:45:00,0.87,0.64,0.73,130,128,133,10,5,5,13,4,9,5,1,4,+1,0,+1,75%,88%,67%,92,82,99,34%,30%,36%,1,0,1,0,0,0
298,https://vlr.gg/player/4866/kushy,2024-07-04 04:45:00,0.80,1.09,0.92,243,226,271,17,10,7,19,11,8,7,3,4,+1,-1,+2,75%,67%,88%,149,136,168,57%,63%,50%,3,1,2,2,2,0
299,https://vlr.gg/player/2346/cud,2024-07-04 04:45:00,0.98,0.66,0.85,185,215,141,13,9,4,17,10,7,8,6,2,+2,+2,0,60%,67%,50%,110,120,96,33%,27%,45%,2,2,0,0,0,0
300,https://vlr.gg/player/7807/valdyn,2024-07-04 04:45:00,0.84,0.78,0.81,179,176,186,12,7,5,18,11,7,6,4,2,0,-2,+2,70%,75%,63%,131,128,134,48%,67%,27%,2,0,2,2,2,0
301,https://vlr.gg/player/11666/ray4c,2024-07-04 04:45:00,1.07,0.26,0.75,186,249,93,13,11,2,17,9,8,3,1,2,-1,+2,-3,85%,83%,88%,119,152,70,18%,16%,29%,3,3,0,4,1,3
302,https://vlr.gg/player/9296/roseau,2024-07-04 04:45:00,0.61,0.39,0.53,119,142,87,9,6,3,18,10,8,1,0,1,0,+1,-1,60%,75%,38%,81,95,61,15%,18%,11%,1,1,0,1,0,1
303,https://vlr.gg/player/23710/gotten,2024-07-04 04:45:00,,,,,,,,,,,,,,,,,,,,,,,,,,,,,,,,,
304,https://vlr.gg/player/14170/mckinley,2024-07-04 04:30:00,1.06,0.82,0.96,204,229,179,27,18,9,32,21,11,8,6,2,-4,-3,-1,68%,71%,64%,152,161,135,38%,38%,38%,0,0,0,4,3,1
305,https://vlr.gg/player/31254/feta,2024-07-04 04:30:00,0.71,0.94,0.79,187,178,196,24,14,10,31,21,10,4,1,3,-2,-3,+1,58%,50%,71%,126,122,133,23%,21%,25%,5,2,3,7,5,2
306,https://vlr.gg/player/31255/biggiecheese,2024-07-04 04:30:00,0.56,1.09,0.76,180,159,197,22,11,11,32,23,9,11,8,3,0,+2,-2,58%,54%,64%,109,98,129,31%,33%,30%,5,4,1,5,2,3
307,https://vlr.gg/player/22828/milky,2024-07-04 04:30:00,0.50,0.94,0.66,141,100,230,19,9,10,32,20,12,13,8,5,-2,-2,0,53%,42%,71%,96,64,149,18%,19%,18%,0,0,0,2,2,0
308,https://vlr.gg/player/29821/sinaway,2024-07-04 04:30:00,0.59,0.61,0.60,166,173,140,18,12,6,34,23,11,7,3,4,-2,0,-2,50%,50%,50%,112,125,92,25%,27%,22%,4,3,1,6,3,3
309,https://vlr.gg/player/31589/murza,2024-07-04 04:30:00,1.25,1.72,1.55,280,218,310,40,11,29,18,8,10,5,3,2,+1,-1,+2,79%,79%,79%,183,157,198,17%,21%,14%,4,1,3,3,2,1
310,https://vlr.gg/player/26310/ikana,2024-07-04 04:30:00,1.05,1.59,1.39,240,257,233,36,14,22,20,10,10,17,2,15,+5,+1,+4,74%,64%,79%,148,136,155,20%,23%,18%,5,1,4,0,0,0
311,https://vlr.gg/player/31593/kiss,2024-07-04 04:30:00,1.30,1.31,1.31,232,243,228,32,12,20,23,10,13,19,4,15,+1,+2,-1,84%,86%,83%,152,152,151,34%,33%,34%,6,3,3,5,1,4
312,https://vlr.gg/player/10089/andy,2024-07-04 04:30:00,1.25,1.15,1.19,248,234,257,34,12,22,27,10,17,9,2,7,+3,+2,+1,84%,71%,92%,166,160,170,21%,15%,23%,6,3,3,3,1,2
313,https://vlr.gg/player/26316/ramen,2024-07-04 04:30:00,0.66,0.94,0.84,166,90,187,19,4,15,22,8,14,10,3,7,0,0,0,74%,71%,75%,101,61,124,19%,14%,22%,3,1,2,3,1,2
314,https://vlr.gg/player/35020/aeonyx,2024-07-04 03:40:00,1.00,1.20,1.09,218,176,265,34,15,19,32,13,19,7,4,3,+3,+2,+1,68%,74%,62%,145,115,179,21%,21%,22%,5,2,3,2,0,2
315,https://vlr.gg/player/35028/fallx,2024-07-04 03:40:00,1.00,0.92,0.96,239,264,206,36,22,14,37,18,19,7,5,2,+2,+5,-3,70%,87%,52%,149,156,141,30%,37%,23%,9,8,1,7,3,4
316,https://vlr.gg/player/44250/dizzyfps,2024-07-04 03:40:00,1.29,0.44,0.89,191,243,134,29,22,7,33,14,19,12,9,3,+2,+4,-2,68%,83%,52%,127,147,104,28%,38%,15%,6,5,1,4,1,3
317,https://vlr.gg/player/24794/exotic,2024-07-04 03:40:00,1.37,0.20,0.76,166,262,79,14,10,4,19,6,13,2,2,0,0,+1,-1,65%,91%,42%,112,184,46,36%,42%,20%,3,2,1,3,1,2
318,https://vlr.gg/player/35027/owen-q-t,2024-07-04 03:40:00,1.18,0.27,0.75,153,209,90,22,19,3,33,13,20,13,5,8,-3,0,-3,64%,78%,48%,111,147,72,19%,25%,9%,0,0,0,3,0,3
319,https://vlr.gg/player/44251/dignified,2024-07-04 03:40:00,0.75,0.55,0.67,151,161,140,10,6,4,18,10,8,8,7,1,-2,-1,-1,71%,75%,67%,96,99,91,34%,28%,45%,0,0,0,2,1,1
320,https://vlr.gg/player/24737/par-scofield,2024-07-04 03:40:00,1.71,1.29,1.49,296,343,256,49,27,22,30,12,18,12,9,3,+5,+5,0,82%,95%,70%,178,204,155,28%,38%,20%,9,6,3,4,1,3
321,https://vlr.gg/player/26143/secondlove,2024-07-04 03:40:00,1.71,1.07,1.38,264,291,239,42,25,17,26,7,19,8,5,3,-1,+2,-3,70%,81%,61%,182,192,173,26%,32%,22%,3,3,0,4,1,3
322,https://vlr.gg/player/44246/repulsive,2024-07-04 03:40:00,1.23,0.92,1.06,192,188,196,25,11,14,25,9,16,32,22,10,-3,0,-3,80%,95%,65%,122,118,125,17%,19%,16%,1,1,0,4,1,3
323,https://vlr.gg/player/21793/syko,2024-07-04 03:40:00,1.48,0.47,0.95,174,228,120,24,16,8,30,9,21,26,17,9,-2,+3,-5,66%,90%,43%,124,160,91,33%,30%,41%,4,3,1,6,0,6
324,https://vlr.gg/player/33801/loydream,2024-07-04 03:40:00,1.14,0.74,0.93,203,228,177,32,19,13,34,14,20,12,6,6,-1,-1,0,68%,81%,57%,147,179,118,21%,24%,18%,4,2,2,5,3,2
325,https://vlr.gg/player/34096/faustao,2024-07-04 03:00:00,1.32,1.73,1.59,329,304,336,42,14,28,23,10,13,8,3,5,+5,-1,+6,84%,69%,92%,212,190,224,30%,28%,32%,9,3,6,4,4,0
326,https://vlr.gg/player/37057/woody,2024-07-04 03:00:00,1.92,1.31,1.52,300,363,274,39,17,22,24,8,16,19,11,8,+1,+1,0,86%,100%,79%,195,221,181,39%,45%,35%,4,1,3,3,0,3
327,https://vlr.gg/player/9279/kylee,2024-07-04 03:00:00,1.65,1.24,1.38,263,267,264,37,14,23,21,6,15,2,0,2,+3,+2,+1,84%,100%,75%,169,174,167,44%,47%,43%,6,2,4,3,0,3
328,https://vlr.gg/player/23717/nythan,2024-07-04 03:00:00,0.75,1.02,0.92,158,108,181,23,5,18,22,8,14,13,7,6,-2,-3,+1,78%,69%,83%,102,73,118,23%,20%,24%,2,0,2,4,3,1
329,https://vlr.gg/player/34100/scar,2024-07-04 03:00:00,0.95,0.77,0.84,120,173,92,14,7,7,24,10,14,21,9,12,+2,0,+2,76%,85%,71%,84,120,65,17%,19%,16%,2,0,2,0,0,0
330,https://vlr.gg/player/10807/dragy,2024-07-04 03:00:00,1.00,1.10,1.04,207,202,234,28,17,11,29,19,10,12,4,8,+2,+1,+1,65%,67%,62%,138,132,150,32%,29%,37%,2,1,1,0,0,0
331,https://vlr.gg/player/23709/jefz,2024-07-04 03:00:00,0.89,0.95,0.91,205,196,228,26,16,10,30,18,12,9,5,4,-7,-7,0,62%,58%,69%,156,144,177,15%,16%,14%,6,3,3,13,10,3
332,https://vlr.gg/player/15678/reeq,2024-07-04 03:00:00,0.82,0.66,0.76,195,184,213,22,14,8,33,20,13,22,13,9,+2,0,+2,65%,63%,69%,116,114,121,24%,30%,18%,4,2,2,2,2,0
333,https://vlr.gg/player/4867/onigiri,2024-07-04 03:00:00,0.77,0.36,0.62,160,201,82,20,16,4,32,21,11,5,4,1,-6,-3,-3,65%,71%,54%,99,125,53,33%,33%,33%,0,0,0,6,3,3
334,https://vlr.gg/player/10738/heynf,2024-07-04 03:00:00,0.44,0.59,0.49,121,109,140,17,9,8,31,20,11,4,4,0,0,-1,+1,54%,54%,54%,79,74,88,29%,33%,24%,2,1,1,2,2,0
335,https://vlr.gg/player/42793/kally,2024-07-04 02:00:00,1.33,1.13,1.24,218,208,232,52,29,23,39,18,21,20,12,8,+4,+4,0,78%,78%,79%,139,134,144,38%,36%,40%,5,5,0,1,1,0
336,https://vlr.gg/player/4127/felix,2024-07-04 02:00:00,1.16,1.26,1.20,225,194,244,49,26,23,39,20,19,27,13,14,-3,-2,-1,74%,69%,79%,144,123,168,29%,30%,28%,5,3,2,8,5,3
337,https://vlr.gg/player/25089/cabeza,2024-07-04 02:00:00,1.41,0.89,1.18,228,259,179,50,34,16,41,19,22,24,10,14,+3,+3,0,80%,83%,76%,145,167,118,28%,29%,26%,7,5,2,4,2,2
338,https://vlr.gg/player/46472/sasuke,2024-07-04 02:00:00,1.00,1.08,1.04,237,246,231,56,33,23,48,26,22,14,8,6,-1,-1,0,74%,75%,72%,163,163,162,22%,23%,21%,11,5,6,12,6,6
339,https://vlr.gg/player/42716/doyou,2024-07-04 02:00:00,0.88,0.60,0.75,169,184,157,40,23,17,46,22,24,12,8,4,0,0,0,69%,75%,62%,114,121,104,29%,27%,31%,6,2,4,6,2,4
340,https://vlr.gg/player/9236/manggong,2024-07-04 02:00:00,1.37,0.96,1.14,211,240,202,52,28,24,47,18,29,20,5,15,-2,+1,-3,66%,83%,53%,137,150,126,29%,40%,22%,5,3,2,7,2,5
341,https://vlr.gg/player/42749/godsb,2024-07-04 02:00:00,1.32,0.98,1.13,269,326,227,61,35,26,52,22,30,11,6,5,+9,+5,+4,71%,76%,67%,168,197,145,27%,26%,28%,16,8,8,7,3,4
342,https://vlr.gg/player/4054/secret,2024-07-04 02:00:00,1.01,0.74,0.86,145,153,144,31,16,15,44,17,27,33,19,14,-3,-2,-1,65%,72%,58%,96,100,93,28%,46%,18%,1,0,1,4,2,2
343,https://vlr.gg/player/17063/vow,2024-07-04 02:00:00,0.73,0.75,0.74,153,150,155,34,15,19,52,22,30,19,12,7,-6,-1,-5,65%,69%,61%,99,96,102,34%,30%,38%,4,3,1,10,4,6
344,https://vlr.gg/player/4038/bangnan,2024-07-04 02:00:00,0.55,0.73,0.65,158,143,168,35,15,20,53,23,30,15,6,9,-1,-2,+1,58%,52%,64%,101,92,108,44%,37%,49%,5,1,4,6,3,3
345,https://vlr.gg/player/7435/astr0,2024-07-04 02:00:00,1.15,1.91,1.41,283,242,354,37,21,16,23,17,6,23,14,9,+1,0,+1,86%,83%,92%,169,148,210,35%,30%,44%,4,2,2,3,2,1
346,https://vlr.gg/player/31398/ichisolo,2024-07-04 02:00:00,1.26,1.48,1.33,241,223,285,32,19,13,19,13,6,6,5,1,+4,+2,+2,92%,88%,100%,159,145,189,24%,22%,28%,4,2,2,0,0,0
347,https://vlr.gg/player/10249/uyen,2024-07-04 02:00:00,1.18,1.61,1.32,202,197,224,27,17,10,18,14,4,10,7,3,-1,-1,0,86%,83%,92%,146,132,175,34%,30%,40%,0,0,0,1,1,0
348,https://vlr.gg/player/37375/chanyboi,2024-07-04 02:00:00,1.40,1.03,1.27,202,254,107,28,24,4,18,13,5,20,11,9,-2,-1,-1,86%,83%,92%,127,157,66,27%,31%,16%,1,1,0,3,2,1
349,https://vlr.gg/player/44259/patrickwho,2024-07-04 02:00:00,1.10,1.57,1.26,291,279,302,38,24,14,25,19,6,6,4,2,+4,0,+4,75%,71%,83%,185,174,208,35%,34%,37%,12,7,5,8,7,1
350,https://vlr.gg/player/46471/hirenkyaku,2024-07-04 02:00:00,0.75,1.15,0.99,227,184,255,30,8,22,32,11,21,8,2,6,-5,-5,0,61%,50%,67%,143,122,153,29%,26%,30%,2,0,2,7,5,2
351,https://vlr.gg/player/46552/minori,2024-07-04 02:00:00,0.61,0.79,0.73,140,106,156,19,5,14,30,10,20,7,4,3,-1,0,-1,53%,50%,54%,88,51,107,23%,20%,23%,1,0,1,2,0,2
352,https://vlr.gg/player/7430/youngpork,2024-07-04 02:00:00,0.30,0.80,0.63,187,114,227,22,4,18,35,12,23,4,1,3,+3,+1,+2,58%,42%,67%,132,83,157,29%,18%,33%,5,2,3,2,1,1
353,https://vlr.gg/player/7429/cms,2024-07-04 02:00:00,0.60,0.63,0.62,168,171,171,17,7,10,32,12,20,9,1,8,-3,-1,-2,64%,67%,63%,125,121,127,30%,37%,27%,3,1,2,6,2,4
354,https://vlr.gg/player/7431/foods,2024-07-04 02:00:00,0.28,0.62,0.51,137,89,160,15,3,12,33,12,21,9,4,5,0,-1,+1,56%,58%,54%,93,68,105,29%,29%,29%,4,0,4,4,1,3
355,https://vlr.gg/player/39565/ellie,2024-07-03 21:35:00,1.09,1.01,1.06,211,208,208,30,17,13,30,18,12,16,11,5,+2,0,+2,69%,75%,61%,124,119,132,28%,43%,16%,3,1,2,1,1,0
356,https://vlr.gg/player/17982/lunafox,2024-07-03 21:35:00,0.81,1.38,1.06,229,189,281,31,15,16,33,19,14,17,7,10,0,-3,+3,69%,71%,67%,151,126,186,35%,40%,30%,4,0,4,4,3,1
357,https://vlr.gg/player/36737/alexaishot,2024-07-03 21:35:00,0.95,1.06,1.00,234,244,222,31,17,14,34,22,12,8,6,2,-3,-3,0,69%,63%,78%,151,166,132,20%,19%,21%,7,5,2,10,8,2
358,https://vlr.gg/player/28387/fire,2024-07-03 21:35:00,0.59,0.73,0.65,113,104,125,15,7,8,29,17,12,12,7,5,-3,-3,0,64%,71%,56%,71,68,75,21%,9%,39%,0,0,0,3,3,0
359,https://vlr.gg/player/26032/panday,2024-07-03 21:35:00,0.83,0.43,0.62,146,199,77,21,17,4,32,20,12,7,3,4,-10,-3,-7,60%,63%,56%,90,118,53,18%,23%,8%,0,0,0,10,3,7
360,https://vlr.gg/player/25741/lied,2024-07-03 21:35:00,1.64,1.20,1.39,326,350,314,48,23,25,30,11,19,8,3,5,+12,+4,+8,76%,72%,79%,208,219,200,23%,27%,20%,15,6,9,3,2,1
361,https://vlr.gg/player/29223/tura,2024-07-03 21:35:00,1.42,0.91,1.13,193,193,189,28,14,14,24,10,14,26,10,16,-1,-1,0,83%,78%,88%,118,109,124,23%,31%,19%,2,1,1,3,2,1
362,https://vlr.gg/player/35927/dano,2024-07-03 21:35:00,0.37,1.66,1.11,199,73,290,29,3,26,27,13,14,20,11,9,-1,-2,+1,71%,67%,75%,124,48,181,20%,33%,18%,2,0,2,3,2,1
363,https://vlr.gg/player/40338/natas,2024-07-03 21:35:00,1.11,1.03,1.06,175,172,178,27,11,16,22,9,13,12,5,7,0,0,0,79%,72%,83%,112,116,110,24%,28%,23%,3,1,2,3,1,2
364,https://vlr.gg/player/35547/raquinuki,2024-07-03 21:35:00,0.97,0.94,0.95,165,176,161,26,11,15,25,12,13,8,5,3,+4,+1,+3,67%,61%,71%,126,123,129,47%,40%,53%,6,2,4,2,1,1
365,https://vlr.gg/player/4164/s0m,2024-07-03 19:05:00,1.41,1.06,1.24,243,254,232,54,31,23,40,19,21,27,16,11,+5,+3,+2,82%,82%,83%,152,154,149,31%,34%,28%,6,3,3,1,0,1
366,https://vlr.gg/player/4/crashies,2024-07-03 19:05:00,1.11,1.10,1.10,210,220,197,45,24,21,37,21,16,20,10,10,+2,0,+2,79%,73%,86%,141,156,123,23%,25%,21%,4,2,2,2,2,0
367,https://vlr.gg/player/11225/ethan,2024-07-03 19:05:00,0.96,1.20,1.07,232,196,278,50,23,27,45,24,21,25,12,13,+8,+2,+6,82%,79%,86%,142,121,166,19%,22%,16%,11,4,7,3,2,1
368,https://vlr.gg/player/261/victor,2024-07-03 19:05:00,0.78,1.13,0.94,237,236,239,52,27,25,46,27,19,7,2,5,+1,0,+1,68%,67%,69%,148,153,143,23%,26%,20%,15,8,7,14,8,6
369,https://vlr.gg/player/817/finesse,2024-07-03 19:05:00,0.94,0.78,0.86,162,183,138,37,22,15,39,21,18,14,9,5,+2,+2,0,74%,70%,79%,112,117,107,20%,21%,19%,4,3,1,2,1,1
370,https://vlr.gg/player/24007/shyy,2024-07-03 19:05:00,1.07,1.07,1.07,185,179,192,44,20,24,43,19,24,16,8,8,-2,-2,0,68%,72%,64%,130,127,132,39%,35%,42%,1,0,1,3,2,1
371,https://vlr.gg/player/1311/melser,2024-07-03 19:05:00,1.24,0.84,1.03,206,205,210,45,21,24,48,20,28,15,11,4,-1,0,-1,79%,83%,76%,134,138,131,36%,33%,38%,6,1,5,7,1,6
372,https://vlr.gg/player/8673/heat,2024-07-03 19:05:00,1.03,1.03,1.03,213,204,222,46,21,25,50,23,27,23,6,17,-7,-5,-2,69%,66%,73%,138,134,141,30%,25%,35%,4,1,3,11,6,5
373,https://vlr.gg/player/2462/keznit,2024-07-03 19:05:00,0.90,0.99,0.95,228,240,217,47,23,24,49,24,25,15,5,10,-5,-3,-2,68%,66%,70%,148,154,143,26%,33%,21%,9,6,3,14,9,5
374,https://vlr.gg/player/36169/mta,2024-07-03 19:05:00,0.41,0.86,0.65,121,103,139,25,10,15,49,26,23,13,5,8,-3,-1,-2,66%,59%,73%,78,65,90,32%,31%,32%,2,1,1,5,2,3
375,https://vlr.gg/player/33177/none,2024-07-03 18:00:00,1.03,1.48,1.28,302,261,353,72,28,44,53,26,27,12,4,8,+9,+3,+6,75%,70%,78%,195,157,227,25%,24%,25%,20,10,10,11,7,4
376,https://vlr.gg/player/42378/nicky,2024-07-03 18:00:00,1.26,0.93,1.08,198,216,174,49,24,25,42,17,25,27,19,8,+4,+2,+2,79%,87%,73%,118,130,108,28%,37%,21%,8,2,6,4,0,4
377,https://vlr.gg/player/24770/babzzz,2024-07-03 18:00:00,1.09,1.04,1.06,233,255,201,52,26,26,45,22,23,12,5,7,-6,0,-6,67%,70%,65%,146,168,128,25%,25%,25%,2,1,1,8,1,7
378,https://vlr.gg/player/21548/adenina,2024-07-03 18:00:00,1.18,0.83,0.98,182,206,162,42,21,21,44,18,26,36,17,19,+2,+1,+1,84%,83%,84%,123,142,107,22%,27%,18%,3,2,1,1,1,0
379,https://vlr.gg/player/21108/ponix,2024-07-03 18:00:00,0.73,0.92,0.84,143,114,165,32,12,20,40,19,21,30,12,18,-4,-4,0,73%,70%,76%,90,71,105,20%,24%,17%,3,1,2,7,5,2
380,https://vlr.gg/player/35907/naxa,2024-07-03 18:00:00,1.01,1.30,1.14,237,204,279,54,25,29,50,27,23,21,13,8,-2,0,-2,72%,68%,77%,158,132,190,28%,25%,31%,4,2,2,6,2,4
381,https://vlr.gg/player/35876/tconda,2024-07-03 18:00:00,1.05,1.17,1.11,237,243,231,55,29,26,49,28,21,9,7,2,-3,-2,-1,63%,62%,63%,160,168,149,34%,38%,30%,11,7,4,14,9,5
382,https://vlr.gg/player/35873/gelatycat,2024-07-03 18:00:00,1.00,1.03,1.02,174,158,194,42,22,20,47,26,21,25,14,11,+4,0,+4,78%,81%,73%,115,107,124,38%,43%,33%,7,3,4,3,3,0
383,https://vlr.gg/player/28222/panchill,2024-07-03 18:00:00,1.10,0.81,0.97,183,223,144,42,29,13,49,27,22,11,3,8,+1,0,+1,63%,65%,60%,136,155,113,22%,28%,15%,5,2,3,4,2,2
384,https://vlr.gg/player/21003/miwa,2024-07-03 18:00:00,0.72,0.53,0.64,150,149,146,30,17,13,52,28,24,24,14,10,-5,-1,-4,63%,65%,60%,102,108,94,27%,24%,30%,4,3,1,9,4,5
385,https://vlr.gg/player/15681/palla,2024-07-03 17:00:00,0.72,1.36,0.94,228,197,286,29,16,13,32,22,10,6,3,3,+1,+1,0,62%,63%,62%,148,132,177,27%,28%,26%,8,6,2,7,5,2
386,https://vlr.gg/player/11105/rich,2024-07-03 17:00:00,0.83,1.12,0.93,175,147,220,24,13,11,29,20,9,5,3,2,+4,+1,+3,73%,75%,69%,120,99,159,46%,38%,57%,4,1,3,0,0,0
387,https://vlr.gg/player/8872/mazin,2024-07-03 17:00:00,0.82,0.46,0.70,131,158,81,14,12,2,28,19,9,12,5,7,-4,-2,-2,54%,54%,54%,87,101,62,37%,35%,42%,1,1,0,5,3,2
388,https://vlr.gg/player/2567/liazzi,2024-07-03 17:00:00,0.37,1.05,0.61,156,125,217,19,9,10,32,23,9,9,4,5,0,-2,+2,73%,63%,92%,101,79,140,24%,17%,33%,4,2,2,4,4,0
389,https://vlr.gg/player/5957/artzin,2024-07-03 17:00:00,0.23,1.01,0.50,139,102,212,17,8,9,33,24,9,10,3,7,0,0,0,65%,54%,85%,91,76,119,19%,35%,11%,2,1,1,2,1,1
390,https://vlr.gg/player/796/eeiu,2024-07-03 17:00:00,1.53,2.03,1.85,300,255,327,43,12,31,14,6,8,9,2,7,+3,+1,+2,97%,92%,100%,193,163,209,34%,45%,30%,3,1,2,0,0,0
391,https://vlr.gg/player/604/boostio,2024-07-03 17:00:00,0.58,1.73,1.33,242,150,291,33,7,26,21,10,11,18,7,11,0,-2,+2,89%,77%,96%,170,109,203,34%,16%,42%,3,0,3,3,2,1
392,https://vlr.gg/player/601/asuna,2024-07-03 17:00:00,1.17,1.08,1.11,180,180,180,24,9,15,20,8,12,15,3,12,-2,-1,-1,84%,69%,92%,120,111,125,17%,25%,15%,4,2,2,6,3,3
393,https://vlr.gg/player/3880/bang,2024-07-03 17:00:00,0.88,1.14,1.05,218,184,238,27,9,18,24,10,14,12,4,8,+2,0,+2,73%,62%,79%,136,103,153,39%,47%,36%,7,1,6,5,1,4
394,https://vlr.gg/player/4147/cryocells,2024-07-03 17:00:00,0.87,1.00,0.96,192,226,173,27,10,17,25,11,14,9,3,6,-4,-1,-3,76%,54%,88%,124,157,107,39%,40%,38%,1,1,0,5,2,3
395,https://vlr.gg/player/6510/atakaptan,2024-07-03 15:25:00,1.43,1.40,1.41,247,238,254,37,17,20,22,10,12,19,7,12,0,-1,+1,84%,82%,86%,159,152,164,28%,29%,27%,3,1,2,3,2,1
396,https://vlr.gg/player/8369/yetujey,2024-07-03 15:25:00,1.01,1.55,1.31,243,197,278,36,12,24,20,10,10,3,2,1,+3,+2,+1,74%,76%,71%,142,122,159,24%,25%,24%,3,2,1,0,0,0
397,https://vlr.gg/player/8044/mrfalin,2024-07-03 15:25:00,1.04,1.26,1.16,199,211,183,24,12,12,22,12,10,23,7,16,-1,0,-1,76%,76%,76%,130,134,127,21%,21%,20%,2,1,1,3,1,2
398,https://vlr.gg/player/573/cned,2024-07-03 15:25:00,0.97,1.24,1.11,231,221,252,30,13,17,26,12,14,7,2,5,+2,0,+2,71%,65%,76%,162,146,175,24%,27%,23%,9,4,5,7,4,3
399,https://vlr.gg/player/1139/qraxs,2024-07-03 15:25:00,1.08,0.83,0.94,148,163,133,21,10,11,20,9,11,10,3,7,-6,0,-6,74%,76%,71%,108,127,93,26%,30%,22%,1,1,0,7,1,6
400,https://vlr.gg/player/5004/natank,2024-07-03 15:25:00,1.23,0.97,1.11,210,257,146,27,18,9,26,17,9,8,4,4,+6,+4,+2,63%,57%,71%,147,185,100,37%,37%,38%,7,5,2,1,1,0
401,https://vlr.gg/player/20871/k4davra,2024-07-03 15:25:00,0.59,1.09,0.82,208,160,274,25,10,15,33,18,15,12,5,7,+6,+2,+4,71%,67%,76%,139,108,178,25%,20%,29%,6,2,4,0,0,0
402,https://vlr.gg/player/301/takas,2024-07-03 15:25:00,0.71,0.87,0.78,196,173,225,24,11,13,34,18,16,13,7,6,-8,-3,-5,68%,67%,71%,133,123,145,15%,17%,12%,5,3,2,13,6,7
403,https://vlr.gg/player/220/beyaz,2024-07-03 15:25:00,0.62,0.77,0.69,144,121,170,19,8,11,28,15,13,15,7,8,0,+1,-1,61%,52%,71%,97,90,106,27%,19%,36%,1,1,0,1,0,1
404,https://vlr.gg/player/19522/wailers,2024-07-03 15:25:00,0.69,0.47,0.59,115,140,94,15,10,5,27,16,11,9,4,5,-2,-1,-1,63%,62%,65%,77,87,65,45%,45%,44%,1,1,0,3,2,1
405,https://vlr.gg/player/29873/benjyfishy,2024-07-03 12:00:00,1.51,1.07,1.28,229,268,203,63,36,27,48,20,28,16,8,8,+4,0,+4,75%,76%,74%,153,182,128,41%,42%,41%,8,3,5,4,3,1
406,https://vlr.gg/player/10971/riens,2024-07-03 12:00:00,1.51,1.04,1.26,216,236,197,57,31,26,45,17,28,33,16,17,+6,+1,+5,76%,85%,68%,139,161,120,35%,35%,35%,8,2,6,2,1,1
407,https://vlr.gg/player/21328/wo0t,2024-07-03 12:00:00,1.13,0.84,0.97,197,222,188,49,26,23,51,21,30,13,6,7,-3,-1,-2,71%,82%,61%,133,144,123,48%,50%,46%,7,5,2,10,6,4
408,https://vlr.gg/player/1144/boo,2024-07-03 12:00:00,1.26,0.59,0.91,159,182,131,39,21,18,47,16,31,33,24,9,-5,0,-5,71%,88%,55%,97,114,82,24%,21%,29%,3,1,2,8,1,7
409,https://vlr.gg/player/18350/miniboo,2024-07-03 12:00:00,0.50,0.82,0.67,167,159,172,40,20,20,58,29,29,16,5,11,-4,-2,-2,65%,65%,66%,117,103,130,25%,21%,29%,9,5,4,13,7,6
410,https://vlr.gg/player/292/fit1nho,2024-07-03 12:00:00,1.30,0.87,1.10,209,228,197,54,31,23,47,22,25,24,16,8,+1,-2,+3,75%,82%,68%,147,162,130,29%,33%,25%,5,0,5,4,2,2
411,https://vlr.gg/player/4181/cloud,2024-07-03 12:00:00,1.07,1.09,1.08,218,193,244,54,28,26,52,24,28,28,13,15,0,0,0,79%,79%,79%,152,141,164,24%,23%,26%,7,4,3,7,4,3
412,https://vlr.gg/player/2690/hoody,2024-07-03 12:00:00,1.08,0.86,0.98,179,184,178,43,24,19,47,21,26,21,10,11,-7,-2,-5,75%,84%,65%,125,124,127,25%,23%,28%,2,2,0,9,4,5
413,https://vlr.gg/player/16209/famsii,2024-07-03 12:00:00,1.27,0.52,0.92,179,227,139,49,33,16,51,22,29,21,15,6,+2,0,+2,74%,82%,65%,131,161,98,30%,26%,38%,7,3,4,5,3,2
414,https://vlr.gg/player/1885/purp0,2024-07-03 12:00:00,1.04,0.61,0.84,194,217,162,49,30,19,51,25,26,10,5,5,+6,+4,+2,69%,74%,65%,118,135,98,41%,42%,39%,16,10,6,10,6,4
415,https://vlr.gg/player/7381/redkoh,2024-07-03 10:25:00,0.94,1.47,1.21,230,178,263,49,20,29,39,22,17,31,8,23,+1,-3,+4,82%,70%,94%,143,128,158,35%,43%,30%,6,0,6,5,3,2
416,https://vlr.gg/player/5886/flaring,2024-07-03 10:25:00,1.15,1.16,1.16,200,228,187,46,25,21,38,22,16,28,9,19,0,-1,+1,82%,83%,81%,137,150,125,29%,35%,23%,4,1,3,4,2,2
417,https://vlr.gg/player/27068/pudj,2024-07-03 10:25:00,0.65,1.27,0.96,171,140,207,39,13,26,40,24,16,23,15,8,+4,-1,+5,72%,67%,77%,110,95,124,22%,18%,26%,7,2,5,3,3,0
418,https://vlr.gg/player/16852/nakya,2024-07-03 10:25:00,0.83,1.07,0.95,245,230,269,54,23,31,47,26,21,11,5,6,+3,+1,+2,67%,60%,74%,164,150,176,24%,25%,24%,15,9,6,12,8,4
419,https://vlr.gg/player/7443/riza,2024-07-03 10:25:00,0.68,1.00,0.85,166,144,189,37,16,21,42,24,18,13,6,7,+3,0,+3,69%,67%,71%,107,94,119,24%,25%,23%,4,1,3,1,1,0
420,https://vlr.gg/player/2381/divine,2024-07-03 10:25:00,1.23,0.89,1.06,213,241,179,48,29,19,46,24,22,19,5,14,-4,-3,-1,66%,58%,73%,135,150,120,35%,34%,35%,5,2,3,9,5,4
421,https://vlr.gg/player/11737/xan,2024-07-03 10:25:00,0.74,1.33,1.03,218,187,252,45,18,27,46,27,19,10,5,5,-3,-5,+2,72%,61%,83%,136,118,155,18%,22%,15%,11,5,6,14,10,4
422,https://vlr.gg/player/24654/tempz,2024-07-03 10:25:00,0.74,1.30,1.02,175,136,215,38,13,25,43,26,17,31,15,16,-2,-2,0,70%,61%,80%,113,93,134,27%,36%,23%,3,1,2,5,3,2
423,https://vlr.gg/player/9158/hyk,2024-07-03 10:25:00,0.82,1.07,0.94,180,159,205,37,16,21,43,24,19,17,6,11,-1,-2,+1,67%,58%,77%,135,124,147,31%,24%,41%,3,0,3,4,2,2
424,https://vlr.gg/player/8137/lenne,2024-07-03 10:25:00,0.60,1.19,0.89,194,135,254,38,12,26,47,27,20,18,8,10,-1,-3,+2,66%,55%,77%,135,104,167,22%,26%,21%,3,0,3,4,3,1
425,https://vlr.gg/player/13784/killua,2024-07-03 10:20:00,1.38,1.14,1.28,247,270,215,36,23,13,26,15,11,9,6,3,+6,+4,+2,78%,79%,75%,156,165,143,43%,38%,54%,6,4,2,0,0,0
426,https://vlr.gg/player/27244/seph1roth,2024-07-03 10:20:00,1.22,1.12,1.18,221,212,240,32,19,13,26,14,12,13,8,5,+2,+1,+1,75%,75%,75%,139,130,153,29%,20%,46%,5,3,2,3,2,1
427,https://vlr.gg/player/14674/kntz,2024-07-03 10:20:00,1.33,0.62,1.05,196,224,146,30,21,9,25,13,12,14,10,4,-2,-1,-1,85%,92%,75%,123,142,94,39%,35%,50%,0,0,0,2,1,1
428,https://vlr.gg/player/24679/cgrs,2024-07-03 10:20:00,1.14,0.82,1.01,155,170,120,21,14,7,21,12,9,9,6,3,-1,+2,-3,73%,75%,69%,109,123,88,32%,29%,36%,2,2,0,3,0,3
429,https://vlr.gg/player/12098/kadoom,2024-07-03 10:20:00,0.78,1.22,0.95,235,226,245,32,19,13,29,17,12,6,3,3,+7,+2,+5,70%,75%,63%,156,146,172,26%,31%,20%,13,7,6,6,5,1
430,https://vlr.gg/player/31495/umaruchans,2024-07-03 10:20:00,0.92,1.24,1.11,210,165,237,32,11,21,28,10,18,5,2,3,-1,+1,-2,70%,69%,71%,140,117,156,53%,67%,49%,1,1,0,2,0,2
431,https://vlr.gg/player/31507/mad22d,2024-07-03 10:20:00,0.95,0.95,0.95,213,219,214,28,12,16,33,14,19,10,3,7,-2,-2,0,75%,88%,67%,140,144,138,29%,34%,25%,7,4,3,9,6,3
432,https://vlr.gg/player/31497/allr1ghtt,2024-07-03 10:20:00,0.89,0.82,0.85,170,159,174,23,9,14,29,10,19,7,1,6,-1,+1,-2,78%,88%,71%,106,89,117,27%,21%,30%,2,1,1,3,0,3
433,https://vlr.gg/player/27225/d4rf,2024-07-03 10:20:00,1.09,0.55,0.77,185,260,142,27,15,12,33,12,21,11,5,6,-2,-2,0,65%,69%,63%,119,164,88,36%,37%,36%,4,0,4,6,2,4
434,https://vlr.gg/player/23896/itaoearth,2024-07-03 10:20:00,0.98,0.45,0.66,135,169,110,17,9,8,29,10,19,8,6,2,-6,-2,-4,65%,81%,54%,86,107,72,23%,30%,18%,0,0,0,6,2,4
435,https://vlr.gg/player/24305/xyus,2024-07-03 10:10:00,1.42,1.56,1.47,318,324,322,42,14,28,22,9,13,4,2,2,+6,+1,+5,78%,83%,75%,198,204,195,22%,23%,21%,10,2,8,4,1,3
436,https://vlr.gg/player/1906/ra1ny,2024-07-03 10:10:00,1.15,1.37,1.30,237,220,241,31,10,21,22,8,14,11,2,9,-1,-2,+1,83%,75%,88%,158,146,164,27%,29%,26%,1,0,1,2,2,0
437,https://vlr.gg/player/7861/w1nner,2024-07-03 10:10:00,1.79,1.03,1.28,203,259,179,28,13,15,17,5,12,8,3,5,+4,+1,+3,81%,83%,79%,132,163,117,31%,33%,29%,5,2,3,1,1,0
438,https://vlr.gg/player/37673/yanli,2024-07-03 10:10:00,1.25,1.04,1.11,214,257,184,26,10,16,22,8,14,13,7,6,-3,-1,-2,78%,92%,71%,133,160,120,34%,24%,45%,2,0,2,5,1,4
439,https://vlr.gg/player/10870/secret,2024-07-03 10:10:00,2.36,0.59,1.03,162,323,109,10,6,4,8,1,7,3,0,3,+1,0,+1,75%,100%,67%,109,214,74,27%,45%,9%,1,0,1,0,0,0
440,https://vlr.gg/player/42932/ngk,2024-07-03 10:10:00,0.60,1.09,0.90,166,110,203,13,3,10,12,4,8,5,2,3,+1,-1,+2,60%,50%,67%,105,61,133,31%,22%,35%,3,1,2,2,2,0
441,https://vlr.gg/player/46038/b1ngxun,2024-07-03 10:10:00,1.28,1.21,1.26,262,267,244,32,22,10,27,17,10,4,2,2,0,+1,-1,67%,75%,50%,175,174,177,38%,44%,27%,2,1,1,2,0,2
442,https://vlr.gg/player/31753/spiritz1,2024-07-03 10:10:00,0.98,0.92,0.96,243,242,270,33,22,11,32,20,12,3,1,2,-1,-5,+4,64%,54%,83%,154,148,165,45%,54%,33%,9,5,4,10,10,0
443,https://vlr.gg/player/34183/rab1q,2024-07-03 10:10:00,0.74,0.32,0.60,128,118,145,13,9,4,29,17,12,10,7,3,-1,-1,0,61%,67%,50%,94,87,109,14%,17%,10%,1,0,1,2,1,1
444,https://vlr.gg/player/46527/cangshu,2024-07-03 10:10:00,0.57,0.23,0.45,124,144,82,14,10,4,31,20,11,12,10,2,-5,-4,-1,67%,75%,50%,76,89,49,21%,23%,18%,0,0,0,5,4,1
445,https://vlr.gg/player/34182/roud,2024-07-03 10:10:00,0.38,0.55,0.44,90,71,138,11,5,6,31,20,11,13,9,4,-1,-1,0,56%,54%,58%,59,44,89,35%,26%,44%,2,1,1,3,2,1
446,https://vlr.gg/player/46135/zeus,2024-07-03 08:00:00,1.56,2.25,1.91,403,339,468,44,18,26,17,10,7,7,5,2,+6,+2,+4,83%,87%,80%,255,219,291,36%,37%,36%,8,3,5,2,1,1
447,https://vlr.gg/player/36013/hydrakid,2024-07-03 08:00:00,1.11,1.54,1.33,230,210,252,25,11,14,14,9,5,17,10,7,+1,0,+1,87%,87%,87%,145,128,161,24%,33%,17%,2,1,1,1,1,0
448,https://vlr.gg/player/46134/denz,2024-07-03 08:00:00,1.66,0.90,1.28,202,281,124,22,15,7,12,5,7,5,3,2,+1,+1,0,80%,80%,80%,127,166,87,37%,32%,50%,5,3,2,4,2,2
449,https://vlr.gg/player/44294/eur,2024-07-03 08:00:00,1.04,1.39,1.22,174,147,201,20,9,11,14,8,6,13,8,5,-1,-2,+1,83%,80%,87%,135,115,155,35%,29%,39%,3,1,2,4,3,1
450,https://vlr.gg/player/11541/xty,2024-07-03 08:00:00,1.30,0.91,1.10,194,227,162,24,14,10,18,9,9,11,5,6,-1,0,-1,93%,93%,93%,129,154,103,46%,50%,40%,0,0,0,1,0,1
451,https://vlr.gg/player/7431/foods,2024-07-03 08:00:00,0.59,1.01,0.80,200,156,245,21,7,14,26,14,12,2,2,0,-2,-3,+1,53%,47%,60%,135,107,163,38%,29%,44%,2,0,2,4,3,1
452,https://vlr.gg/player/7430/youngpork,2024-07-03 08:00:00,0.81,0.65,0.73,177,208,146,17,10,7,26,13,13,2,0,2,0,-1,+1,60%,53%,67%,117,132,102,20%,20%,20%,3,2,1,3,3,0
453,https://vlr.gg/player/46552/minori,2024-07-03 08:00:00,0.51,0.63,0.57,143,120,168,15,7,8,29,14,15,4,1,3,+1,-1,+2,50%,47%,53%,86,72,100,27%,64%,16%,3,1,2,2,2,0
454,https://vlr.gg/player/46471/hirenkyaku,2024-07-03 08:00:00,0.65,0.45,0.49,136,164,108,13,8,5,28,14,14,2,2,0,-2,+1,-3,50%,47%,53%,88,98,78,20%,27%,13%,3,2,1,5,1,4
455,https://vlr.gg/player/7429/cms,2024-07-03 08:00:00,0.31,0.50,0.37,91,48,135,9,2,7,26,13,13,4,2,2,-3,-1,-2,53%,53%,53%,68,42,95,23%,9%,30%,1,0,1,4,1,3
456,https://vlr.gg/player/1062/lew,2024-07-03 07:30:00,1.61,1.17,1.49,300,324,253,36,28,8,20,14,6,8,5,3,+2,+2,0,85%,83%,89%,201,219,153,33%,32%,33%,5,4,1,3,2,1
457,https://vlr.gg/player/2993/rdeew,2024-07-03 07:30:00,1.40,1.68,1.48,314,315,303,39,28,11,20,16,4,9,7,2,+7,+7,0,76%,75%,78%,185,177,206,30%,26%,41%,9,8,1,2,1,1
458,https://vlr.gg/player/1175/signed,2024-07-03 07:30:00,1.45,1.13,1.36,224,244,159,28,22,6,17,12,5,8,6,2,0,+1,-1,76%,79%,67%,146,168,89,47%,44%,58%,1,1,0,1,0,1
459,https://vlr.gg/player/5228/minimise,2024-07-03 07:30:00,0.52,1.60,0.81,131,104,216,16,9,7,21,16,5,19,13,6,-4,-4,0,85%,88%,78%,92,64,168,34%,19%,56%,3,2,1,7,6,1
460,https://vlr.gg/player/6659/dragon,2024-07-03 07:30:00,0.44,1.16,0.64,155,136,195,18,12,6,23,18,5,3,1,2,+2,0,+2,64%,58%,78%,94,83,121,30%,52%,13%,2,0,2,0,0,0
461,https://vlr.gg/player/27550/exirst,2024-07-03 07:30:00,0.87,1.11,1.05,255,239,257,28,7,21,29,8,21,5,1,4,-7,-2,-5,58%,56%,58%,156,147,159,25%,13%,31%,4,1,3,11,3,8
462,https://vlr.gg/player/29790/zauqk,2024-07-03 07:30:00,0.66,1.08,0.94,221,188,241,25,5,20,27,7,20,4,1,3,-1,-1,0,67%,67%,67%,148,130,155,37%,36%,38%,1,0,1,2,1,1
463,https://vlr.gg/player/11106/m1ke,2024-07-03 07:30:00,0.35,1.04,0.85,182,101,215,21,3,18,27,8,19,3,1,2,+4,0,+4,61%,33%,71%,116,66,135,30%,38%,29%,4,0,4,0,0,0
464,https://vlr.gg/player/1176/nozz,2024-07-03 07:30:00,0.66,0.72,0.70,169,181,160,18,5,13,28,8,20,9,0,9,-2,+2,-4,58%,44%,63%,107,119,103,25%,26%,24%,3,3,0,5,1,4
465,https://vlr.gg/player/1174/crunchy,2024-07-03 07:30:00,0.66,0.33,0.42,97,146,78,9,5,4,26,7,19,6,1,5,-1,0,-1,58%,67%,54%,68,91,59,26%,83%,15%,1,0,1,2,0,2
466,https://vlr.gg/player/15902/xcool3,2024-07-03 07:00:00,1.33,1.30,1.31,222,254,197,68,38,30,43,25,18,11,6,5,+1,+1,0,70%,67%,73%,156,174,137,27%,30%,24%,5,3,2,4,2,2
467,https://vlr.gg/player/18037/fluky,2024-07-03 07:00:00,1.07,1.30,1.18,252,238,264,69,34,35,52,27,25,14,5,9,+5,+2,+3,67%,67%,68%,164,159,168,35%,34%,37%,15,8,7,10,6,4
468,https://vlr.gg/player/6721/pedio,2024-07-03 07:00:00,0.76,1.14,0.94,181,154,209,44,21,23,56,30,26,32,9,23,-5,-3,-2,68%,67%,70%,131,114,148,25%,23%,26%,5,3,2,10,6,4
469,https://vlr.gg/player/41702/canady,2024-07-03 07:00:00,0.76,1.10,0.93,194,160,227,49,20,29,55,29,26,19,11,8,-3,-5,+2,66%,62%,70%,139,110,169,23%,32%,17%,9,2,7,12,7,5
470,https://vlr.gg/player/27248/earthy,2024-07-03 07:00:00,0.64,0.78,0.71,117,102,135,29,13,16,52,28,24,32,14,18,-2,0,-2,64%,59%,70%,79,65,93,24%,30%,19%,2,1,1,4,1,3
471,https://vlr.gg/player/6733/xze,2024-07-03 07:00:00,1.36,0.77,1.06,185,254,128,49,33,16,51,25,26,26,11,15,0,+2,-2,70%,73%,67%,118,156,82,53%,53%,52%,6,3,3,6,1,5
472,https://vlr.gg/player/15891/krx,2024-07-03 07:00:00,0.57,1.51,1.05,235,149,309,58,16,42,55,30,25,25,17,8,+2,0,+2,75%,68%,82%,148,95,198,30%,23%,36%,12,5,7,10,5,5
473,https://vlr.gg/player/19150/niffy,2024-07-03 07:00:00,0.82,1.27,1.05,195,177,216,53,21,32,48,27,21,11,6,5,-1,-1,0,70%,57%,82%,137,127,147,24%,24%,23%,7,4,3,8,5,3
474,https://vlr.gg/player/2390/pinocchios,2024-07-03 07:00:00,1.13,0.91,1.02,201,226,176,56,32,24,52,25,27,20,10,10,+3,+2,+1,75%,81%,69%,126,132,121,27%,25%,29%,5,3,2,2,1,1
475,https://vlr.gg/player/23918/reality,2024-07-03 07:00:00,0.68,0.98,0.83,168,132,198,42,17,25,53,26,27,15,3,12,0,-4,+4,61%,51%,69%,115,94,135,26%,29%,24%,10,3,7,10,7,3
476,https://vlr.gg/player/3049/sword9,2024-07-03 07:00:00,,,,236,,,29,,,31,,,4,,,-2,,,,,,142,,,31%,,,3,,,5,,
477,https://vlr.gg/player/10821/delb,2024-07-03 07:00:00,,,,196,,,27,,,27,,,6,,,-4,,,,,,132,,,49%,,,0,,,4,,
478,https://vlr.gg/player/4881/spitfires,2024-07-03 07:00:00,,,,165,,,20,,,28,,,8,,,-5,,,,,,120,,,25%,,,4,,,9,,
479,https://vlr.gg/player/25949/bunt,2024-07-03 07:00:00,,,,156,,,20,,,29,,,14,,,-1,,,,,,92,,,27%,,,3,,,4,,
480,https://vlr.gg/player/14431/monk,2024-07-03 07:00:00,,,,116,,,10,,,33,,,20,,,-2,,,,,,83,,,28%,,,1,,,3,,
481,https://vlr.gg/player/37494/kai,2024-07-03 07:00:00,,,,342,,,43,,,25,,,13,,,+8,,,,,,219,,,34%,,,12,,,4,,
482,https://vlr.gg/player/3021/biank,2024-07-03 07:00:00,,,,235,,,28,,,20,,,15,,,-1,,,,,,155,,,17%,,,3,,,4,,
483,https://vlr.gg/player/4712/heybay,2024-07-03 07:00:00,,,,225,,,30,,,21,,,21,,,+1,,,,,,140,,,30%,,,1,,,0,,
484,https://vlr.gg/player/4770/fengf,2024-07-03 07:00:00,,,,190,,,27,,,19,,,3,,,+4,,,,,,129,,,31%,,,5,,,1,,
485,https://vlr.gg/player/3045/luok1ng,2024-07-03 07:00:00,,,,160,,,20,,,21,,,19,,,+2,,,,,,91,,,29%,,,4,,,2,,
486,https://vlr.gg/player/2377/aduka,2024-07-03 07:00:00,1.35,1.17,1.26,234,257,213,56,32,24,45,24,21,20,9,11,0,-1,+1,77%,77%,76%,154,171,137,37%,39%,35%,8,3,5,8,4,4
487,https://vlr.gg/player/36704/impecunity,2024-07-03 07:00:00,1.14,1.31,1.22,229,239,221,56,28,28,43,26,17,9,8,1,-3,-4,+1,72%,71%,74%,154,168,141,36%,37%,34%,5,1,4,8,5,3
488,https://vlr.gg/player/44919/aplycs,2024-07-03 07:00:00,0.90,0.83,0.87,156,167,146,38,22,16,52,27,25,31,13,18,-1,-1,0,70%,74%,65%,98,106,90,22%,25%,19%,3,1,2,4,2,2
489,https://vlr.gg/player/36685/splash,2024-07-03 07:00:00,0.72,0.95,0.84,200,199,201,50,25,25,53,29,24,11,3,8,-12,-11,-1,64%,57%,71%,118,111,124,28%,31%,26%,8,3,5,20,14,6
490,https://vlr.gg/player/8156/mojo,2024-07-03 07:00:00,0.55,0.81,0.68,143,122,165,33,14,19,53,28,25,21,7,14,-1,0,-1,65%,60%,71%,95,84,105,24%,27%,22%,2,1,1,3,1,2
491,https://vlr.gg/player/16942/reverie,2024-07-03 07:00:00,1.11,1.54,1.33,272,211,332,67,25,42,43,20,23,14,8,6,+2,+1,+1,83%,76%,89%,188,145,229,37%,27%,45%,5,2,3,3,1,2
492,https://vlr.gg/player/7007/shinsei,2024-07-03 07:00:00,1.30,0.96,1.13,292,312,275,69,38,31,57,25,32,11,3,8,+11,+4,+7,65%,65%,66%,184,192,177,31%,34%,29%,20,10,10,9,6,3
493,https://vlr.gg/player/19126/kayle,2024-07-03 07:00:00,0.93,1.14,1.04,207,198,216,50,24,26,45,24,21,12,3,9,+5,-1,+6,71%,76%,66%,136,132,141,17%,18%,16%,11,3,8,6,4,2
494,https://vlr.gg/player/27073/esmonde,2024-07-03 07:00:00,0.85,0.82,0.84,136,123,150,32,14,18,43,20,23,29,16,13,-2,-2,0,77%,79%,74%,90,79,101,22%,21%,23%,3,1,2,5,3,2
495,https://vlr.gg/player/3477/evo,2024-07-03 07:00:00,0.66,0.87,0.77,116,108,125,28,11,17,45,23,22,30,13,17,+1,-2,+3,72%,68%,77%,78,65,91,23%,19%,27%,4,1,3,3,3,0
496,https://vlr.gg/player/7851/uta,2024-07-03 07:00:00,1.05,1.27,1.15,229,239,234,49,26,23,45,28,17,15,11,4,+9,+5,+4,69%,64%,75%,158,156,161,21%,18%,26%,11,7,4,2,2,0
497,https://vlr.gg/player/24304/kiuuuu,2024-07-03 07:00:00,0.98,1.14,1.06,205,185,229,47,23,24,42,25,17,13,8,5,-3,-5,+2,64%,61%,68%,141,131,153,38%,36%,41%,3,0,3,6,5,1
498,https://vlr.gg/player/12365/coconut,2024-07-03 07:00:00,0.78,1.32,1.03,233,186,291,50,20,30,48,28,20,11,6,5,0,-2,+2,62%,55%,71%,158,130,191,35%,43%,28%,6,3,3,6,5,1
499,https://vlr.gg/player/37421/riyabtw,2024-07-03 07:00:00,0.87,0.82,0.85,182,181,175,36,20,16,46,26,20,10,5,5,-4,-4,0,59%,64%,54%,124,128,120,32%,35%,29%,6,1,5,10,5,5
500,https://vlr.gg/player/24302/chimei,2024-07-03 07:00:00,0.57,0.63,0.60,111,102,124,21,10,11,45,26,19,22,10,12,-7,-1,-6,66%,64%,68%,75,67,84,23%,15%,32%,2,2,0,9,3,6
501,https://vlr.gg/player/40912/123,2024-07-03 07:00:00,1.29,1.22,1.25,276,274,273,59,28,31,45,22,23,12,4,8,+4,-1,+5,70%,68%,73%,180,184,177,28%,30%,26%,11,2,9,7,3,4
502,https://vlr.gg/player/44930/nex1sphix,2024-07-03 07:00:00,1.18,1.17,1.18,198,216,182,48,23,25,38,20,18,19,9,10,0,-1,+1,69%,61%,76%,126,128,124,34%,37%,31%,5,3,2,5,4,1
503,https://vlr.gg/player/46043/answerz,2024-07-03 07:00:00,0.90,1.32,1.13,220,157,270,46,15,31,38,20,18,13,4,9,+1,+2,-1,72%,61%,82%,145,106,177,24%,20%,26%,10,6,4,9,4,5
504,https://vlr.gg/player/40901/orgil,2024-07-03 07:00:00,0.71,1.33,1.05,213,166,249,45,15,30,41,22,19,17,10,7,+1,-2,+3,70%,57%,82%,149,117,176,31%,27%,34%,4,1,3,3,3,0
505,https://vlr.gg/player/40891/be,2024-07-03 07:00:00,0.68,0.65,0.66,125,123,123,28,12,16,41,20,21,7,5,2,-1,0,-1,66%,64%,67%,81,81,81,35%,43%,30%,3,1,2,4,1,3
0,https://vlr.gg/player/7807/valdyn,2024-07-03 06:25:00,1.52,1.20,1.36,310,296,313,44,21,23,30,11,19,19,9,10,0,+1,-1,79%,85%,73%,197,196,198,33%,36%,30%,3,1,2,3,0,3
1,https://vlr.gg/player/4866/kushy,2024-07-03 06:25:00,0.96,1.62,1.31,261,170,346,41,13,28,27,12,15,12,7,5,-1,-1,0,74%,75%,73%,176,133,216,40%,38%,42%,5,1,4,6,2,4
2,https://vlr.gg/player/2346/cud,2024-07-03 06:25:00,1.12,1.25,1.19,209,201,218,34,16,18,26,12,14,5,2,3,-2,0,-2,81%,80%,82%,139,125,152,29%,31%,27%,2,2,0,4,2,2
3,https://vlr.gg/player/23710/gotten,2024-07-03 06:25:00,1.43,0.79,1.09,183,206,161,25,15,10,25,9,16,35,17,18,-3,-1,-2,83%,90%,77%,120,129,112,31%,25%,40%,2,1,1,5,2,3
4,https://vlr.gg/player/11666/ray4c,2024-07-03 06:25:00,1.16,0.51,0.82,176,242,121,25,16,9,30,13,17,7,4,3,0,+1,-1,67%,75%,59%,112,151,76,7%,10%,3%,6,5,1,6,4,2
5,https://vlr.gg/player/7042/eeyore,2024-07-03 06:25:00,1.13,1.18,1.15,240,229,264,35,18,17,32,18,14,11,6,5,+2,+2,0,76%,82%,70%,169,146,195,31%,33%,28%,5,2,3,3,0,3
6,https://vlr.gg/player/12207/rapheleen,2024-07-03 06:25:00,0.83,1.15,0.99,222,198,251,32,16,16,35,19,16,8,3,5,+4,+1,+3,79%,91%,65%,142,123,162,13%,15%,11%,7,3,4,3,2,1
7,https://vlr.gg/player/11458/kuroza,2024-07-03 06:25:00,1.01,0.75,0.89,152,181,121,23,15,8,32,16,16,24,12,12,-1,+1,-2,79%,91%,65%,99,115,81,24%,28%,19%,1,1,0,2,0,2
8,https://vlr.gg/player/7805/rizkymd,2024-07-03 06:25:00,1.08,0.50,0.80,171,218,119,24,17,7,34,17,17,20,11,9,-1,-1,0,67%,73%,60%,101,125,75,21%,23%,17%,4,2,2,5,3,2
9,https://vlr.gg/player/26829/damaraa,2024-07-03 06:25:00,0.81,0.69,0.75,189,209,161,24,15,9,36,18,18,13,6,7,+2,+3,-1,62%,68%,55%,130,143,116,19%,28%,12%,7,6,1,5,3,2
10,https://vlr.gg/player/4122/persia,2024-07-03 05:00:00,0.95,1.87,1.40,206,139,286,40,14,26,26,14,12,20,7,13,+2,+1,+1,73%,72%,75%,129,88,172,36%,36%,36%,3,1,2,1,0,1
11,https://vlr.gg/player/31827/dambi,2024-07-03 05:00:00,1.75,0.72,1.25,299,405,185,46,33,13,38,18,20,21,12,9,+7,+7,0,76%,80%,71%,190,248,130,25%,27%,21%,12,10,2,5,3,2
12,https://vlr.gg/player/31828/francis,2024-07-03 05:00:00,1.38,1.03,1.21,238,246,231,43,24,19,35,14,21,19,7,12,+1,0,+1,78%,80%,75%,148,156,140,34%,22%,61%,5,1,4,4,1,3
13,https://vlr.gg/player/31829/ivy,2024-07-03 05:00:00,1.10,1.16,1.13,196,194,190,35,17,18,28,14,14,17,8,9,+1,+1,0,84%,88%,79%,135,130,141,35%,25%,47%,3,2,1,2,1,1
14,https://vlr.gg/player/33576/margaret,2024-07-03 05:00:00,0.56,1.03,0.79,163,92,238,25,7,18,31,15,16,16,6,10,-2,-4,+2,76%,64%,88%,106,68,146,22%,24%,21%,6,1,5,8,5,3
15,https://vlr.gg/player/20879/sungjin,2024-07-03 05:00:00,1.25,0.94,1.09,225,251,203,19,11,8,17,8,9,3,2,1,+1,0,+1,65%,82%,50%,158,163,153,38%,42%,36%,1,0,1,0,0,0
16,https://vlr.gg/player/4657/moves,2024-07-03 05:00:00,0.94,0.97,0.96,186,186,184,32,16,16,35,17,18,12,6,6,-5,-2,-3,65%,67%,64%,126,124,129,26%,37%,18%,3,2,1,8,4,4
17,https://vlr.gg/player/9192/cloudy,2024-07-03 05:00:00,0.66,1.20,0.93,195,153,237,18,7,11,20,11,9,11,7,4,0,0,0,77%,92%,62%,114,94,134,28%,17%,39%,4,2,2,4,2,2
18,https://vlr.gg/player/37535/jaebin,2024-07-03 05:00:00,0.45,1.27,0.87,233,184,282,38,14,24,42,22,20,9,3,6,+1,-1,+2,76%,75%,76%,162,120,203,14%,6%,23%,5,3,2,4,4,0
19,https://vlr.gg/player/4475/benecia,2024-07-03 05:00:00,1.08,0.57,0.82,158,210,112,24,17,7,37,18,19,26,16,10,-4,-1,-3,76%,92%,60%,104,136,74,29%,31%,26%,2,1,1,6,2,4
20,https://vlr.gg/player/13000/redlight,2024-07-03 05:00:00,1.01,0.55,0.77,164,206,122,27,18,9,38,18,20,13,8,5,-2,0,-2,67%,67%,68%,113,134,92,28%,36%,20%,5,2,3,7,2,5
21,https://vlr.gg/player/15081/maishiu,2024-07-03 04:30:00,1.19,1.43,1.30,259,266,250,55,29,26,38,23,15,15,10,5,+2,+1,+1,74%,74%,73%,160,170,148,44%,47%,41%,8,4,4,6,3,3
22,https://vlr.gg/player/31580/vizsla,2024-07-03 04:30:00,1.06,1.21,1.13,232,200,267,48,24,24,38,21,17,9,6,3,+2,0,+2,70%,74%,65%,153,132,178,27%,26%,28%,5,2,3,3,2,1
23,https://vlr.gg/player/1771/myth,2024-07-03 04:30:00,0.78,1.04,0.90,150,133,175,27,12,15,36,20,16,26,15,11,-4,-3,-1,81%,90%,69%,103,94,115,22%,23%,20%,3,1,2,7,4,3
24,https://vlr.gg/player/36747/bonobo,2024-07-03 04:30:00,1.06,0.69,0.89,191,217,158,39,25,14,41,19,22,10,4,6,-3,-3,0,67%,65%,69%,130,144,113,20%,21%,19%,6,3,3,9,6,3
25,https://vlr.gg/player/22816/blessed,2024-07-03 04:30:00,1.01,0.64,0.83,191,236,138,37,25,12,43,24,19,18,12,6,0,0,0,70%,77%,62%,118,141,91,29%,32%,24%,5,3,2,5,3,2
26,https://vlr.gg/player/26322/lg1c,2024-07-03 04:30:00,1.23,1.14,1.18,265,270,263,54,24,30,42,18,24,10,4,6,+3,+3,0,74%,77%,71%,161,165,157,31%,35%,28%,12,7,5,9,4,5
27,https://vlr.gg/player/31583/maine,2024-07-03 04:30:00,1.08,1.14,1.11,226,201,248,42,18,24,42,18,24,23,8,15,+5,0,+5,70%,65%,74%,140,116,160,22%,18%,26%,8,1,7,3,1,2
28,https://vlr.gg/player/26321/songry,2024-07-03 04:30:00,0.96,1.19,1.08,221,204,238,42,19,23,37,17,20,16,5,11,-3,-3,0,70%,58%,81%,145,125,161,27%,27%,27%,1,0,1,4,3,1
29,https://vlr.gg/player/34221/phi,2024-07-03 04:30:00,0.88,0.64,0.75,158,185,140,33,17,16,45,20,25,22,11,11,-3,-1,-2,63%,62%,65%,104,112,97,26%,22%,31%,4,2,2,7,3,4
30,https://vlr.gg/player/31238/alucard,2024-07-03 04:30:00,0.72,0.72,0.72,118,117,121,25,11,14,40,18,22,24,10,14,+1,-1,+2,68%,65%,71%,74,78,70,24%,24%,24%,5,2,3,4,3,1
31,https://vlr.gg/player/10192/chowdy,2024-07-03 04:00:00,1.02,1.12,1.08,209,194,232,44,16,28,45,19,26,19,8,11,-3,-3,0,65%,58%,69%,147,125,161,32%,29%,34%,3,0,3,6,3,3
32,https://vlr.gg/player/32585/n1er,2024-07-03 04:00:00,0.85,1.04,0.97,199,186,213,43,15,28,48,20,28,11,5,6,+5,0,+5,73%,67%,78%,145,128,156,29%,33%,26%,7,2,5,2,2,0
33,https://vlr.gg/player/25542/ash999,2024-07-03 04:00:00,0.89,0.82,0.85,184,175,184,37,15,22,47,20,27,16,7,9,+1,-2,+3,63%,63%,64%,115,103,123,32%,39%,29%,9,3,6,8,5,3
34,https://vlr.gg/player/35965/yukxx,2024-07-03 04:00:00,0.83,0.67,0.73,167,193,157,37,16,21,52,22,30,9,3,6,-1,-2,+1,60%,63%,58%,115,127,106,42%,42%,41%,5,1,4,6,3,3
35,https://vlr.gg/player/10257/irismonstah,2024-07-03 04:00:00,0.58,0.70,0.65,148,133,163,31,11,20,50,20,30,19,7,12,-2,-3,+1,57%,50%,61%,110,105,114,29%,43%,23%,6,1,5,8,4,4
36,https://vlr.gg/player/7437/kellys,2024-07-03 04:00:00,1.50,1.38,1.46,312,326,313,66,39,27,40,24,16,20,12,8,-2,-3,+1,80%,83%,75%,220,216,226,19%,20%,16%,2,1,1,4,4,0
37,https://vlr.gg/player/7754/xavi8k,2024-07-03 04:00:00,1.32,1.39,1.35,245,257,215,55,32,23,33,22,11,19,13,6,+5,+1,+4,75%,64%,92%,143,159,120,25%,28%,20%,9,4,5,4,3,1
38,https://vlr.gg/player/2679/dubstep,2024-07-03 04:00:00,0.98,1.25,1.09,203,172,251,47,26,21,41,26,15,28,17,11,0,-2,+2,70%,75%,63%,128,116,148,23%,27%,19%,8,3,5,8,5,3
39,https://vlr.gg/player/10217/marky,2024-07-03 04:00:00,0.96,1.08,1.01,186,166,201,36,20,16,37,23,14,18,8,10,0,-2,+2,83%,81%,88%,121,106,145,22%,18%,27%,7,3,4,7,5,2
40,https://vlr.gg/player/10782/witz,2024-07-03 04:00:00,1.05,0.95,1.01,207,199,198,38,24,14,41,24,17,27,13,14,-3,-4,+1,73%,69%,79%,140,135,149,19%,23%,15%,4,2,2,7,6,1
41,https://vlr.gg/player/34096/faustao,2024-07-03 03:00:00,1.06,1.33,1.20,254,255,253,62,29,33,51,27,24,13,5,8,+1,-2,+3,71%,71%,72%,165,168,163,26%,28%,25%,13,7,6,12,9,3
42,https://vlr.gg/player/37057/woody,2024-07-03 03:00:00,1.25,1.13,1.19,221,239,207,58,33,25,47,23,24,27,10,17,-1,0,-1,79%,76%,81%,147,152,144,30%,30%,31%,2,0,2,3,0,3
43,https://vlr.gg/player/34100/scar,2024-07-03 03:00:00,1.25,0.87,1.05,206,218,196,50,26,24,49,22,27,26,14,12,-4,-2,-2,73%,76%,69%,133,130,136,40%,36%,43%,5,2,3,9,4,5
44,https://vlr.gg/player/23717/nythan,2024-07-03 03:00:00,0.84,1.12,0.98,188,160,215,47,18,29,48,25,23,15,8,7,0,0,0,70%,65%,75%,129,113,144,31%,34%,28%,5,2,3,5,2,3
45,https://vlr.gg/player/9279/kylee,2024-07-03 03:00:00,0.54,1.07,0.80,171,121,220,43,15,28,53,27,26,9,4,5,-4,-4,0,61%,56%,67%,114,77,149,58%,56%,59%,6,2,4,10,6,4
46,https://vlr.gg/player/9290/madelyn,2024-07-03 03:00:00,1.36,1.25,1.31,236,251,221,60,33,27,46,24,22,22,9,13,0,+1,-1,74%,69%,79%,154,161,148,24%,30%,19%,5,4,1,5,3,2
47,https://vlr.gg/player/7802/flynch,2024-07-03 03:00:00,0.80,0.98,0.89,197,193,203,46,21,25,54,30,24,16,14,2,+8,+2,+6,67%,67%,68%,132,139,125,28%,27%,30%,13,5,8,5,3,2
48,https://vlr.gg/player/7049/natz,2024-07-03 03:00:00,0.91,0.87,0.89,214,224,203,53,29,24,54,29,25,12,5,7,-2,-2,0,64%,58%,71%,141,150,130,37%,45%,30%,7,2,5,9,4,5
49,https://vlr.gg/player/10749/k1ngkappa,2024-07-03 03:00:00,0.69,1.00,0.84,194,167,223,48,21,27,55,30,25,16,7,9,-1,-1,0,69%,64%,74%,127,114,140,36%,33%,38%,9,6,3,10,7,3
50,https://vlr.gg/player/7046/no1syboy,2024-07-03 03:00:00,0.75,0.88,0.82,157,138,179,41,20,21,51,26,25,18,8,10,+3,0,+3,66%,56%,76%,104,88,121,23%,25%,22%,5,1,4,2,1,1
51,https://vlr.gg/player/17049/hermes,2024-07-03 02:00:00,1.39,1.13,1.26,232,239,226,36,19,17,31,14,17,28,17,11,+3,+2,+1,81%,83%,78%,153,160,147,24%,24%,25%,5,3,2,2,1,1
52,https://vlr.gg/player/1916/free1ng,2024-07-03 02:00:00,1.66,0.60,1.14,230,323,136,40,29,11,33,15,18,4,2,2,+1,+3,-2,77%,88%,65%,157,209,102,28%,30%,25%,5,4,1,4,1,3
53,https://vlr.gg/player/9221/kanade,2024-07-03 02:00:00,0.96,1.17,1.06,227,211,242,40,19,21,35,19,16,7,5,2,+3,-1,+4,70%,71%,70%,151,141,161,21%,22%,21%,10,4,6,7,5,2
54,https://vlr.gg/player/482/intro,2024-07-03 02:00:00,0.49,1.07,0.77,147,113,186,24,8,16,35,20,15,12,8,4,-1,-3,+2,68%,63%,74%,103,78,129,32%,23%,39%,3,0,3,4,3,1
55,https://vlr.gg/player/476/exy,2024-07-03 02:00:00,0.53,0.65,0.59,133,104,163,21,9,12,37,18,19,21,11,10,-3,-3,0,72%,75%,70%,92,68,117,31%,18%,41%,2,0,2,5,3,2
56,https://vlr.gg/player/24979/cloy,2024-07-03 02:00:00,1.44,1.06,1.25,241,263,224,43,22,21,32,15,17,13,9,4,-1,0,-1,74%,78%,71%,161,177,145,37%,39%,34%,3,1,2,4,1,3
57,https://vlr.gg/player/42772/xross,2024-07-03 02:00:00,1.32,1.15,1.23,200,168,230,34,15,19,26,10,16,14,5,9,+3,+1,+2,77%,74%,79%,137,113,159,23%,31%,19%,4,1,3,1,0,1
58,https://vlr.gg/player/25048/sid,2024-07-03 02:00:00,1.02,1.08,1.05,234,233,234,34,17,17,34,17,17,19,7,12,+3,+1,+2,77%,74%,79%,161,172,151,25%,22%,27%,7,4,3,4,3,1
59,https://vlr.gg/player/25081/yoman,2024-07-03 02:00:00,1.09,0.86,0.97,177,188,165,32,17,15,32,15,17,22,13,9,-4,-2,-2,64%,70%,58%,111,120,103,19%,14%,23%,3,1,2,7,3,4
60,https://vlr.gg/player/28401/pkm,2024-07-03 02:00:00,0.69,1.00,0.85,207,203,210,28,14,14,37,20,17,15,4,11,-4,-5,+1,77%,70%,83%,136,121,150,16%,15%,17%,5,2,3,9,7,2
61,https://vlr.gg/player/44250/dizzyfps,2024-07-03 02:00:00,1.21,0.92,1.03,232,330,175,15,7,8,16,7,9,2,0,2,-2,0,-2,58%,57%,58%,159,217,125,34%,41%,29%,1,0,1,3,0,3
62,https://vlr.gg/player/44251/dignified,2024-07-03 02:00:00,1.64,0.40,1.02,203,317,90,18,14,4,18,8,10,4,2,2,+1,0,+1,67%,83%,50%,133,206,59,32%,41%,14%,1,0,1,0,0,0
63,https://vlr.gg/player/24794/exotic,2024-07-03 02:00:00,0.76,0.85,0.81,223,193,253,33,14,19,40,18,22,7,4,3,+3,0,+3,63%,58%,67%,153,131,171,40%,40%,39%,5,0,5,2,0,2
64,https://vlr.gg/player/35028/fallx,2024-07-03 02:00:00,0.49,0.92,0.73,198,172,214,28,11,17,35,17,18,7,2,5,-4,-3,-1,65%,53%,75%,132,113,147,31%,40%,26%,4,2,2,8,5,3
65,https://vlr.gg/player/35027/owen-q-t,2024-07-03 02:00:00,0.60,0.72,0.66,165,165,167,23,10,13,37,16,21,13,2,11,-2,-1,-1,63%,53%,71%,108,110,106,29%,33%,26%,5,4,1,7,5,2
66,https://vlr.gg/player/35020/aeonyx,2024-07-03 02:00:00,0.20,0.86,0.53,150,75,217,23,4,19,39,18,21,7,2,5,+3,+1,+2,56%,42%,67%,98,49,137,28%,17%,33%,5,2,3,2,1,1
67,https://vlr.gg/player/13219/papi,2024-07-03 02:00:00,1.60,1.68,1.63,245,249,237,44,25,19,21,12,9,17,7,10,+1,+1,0,88%,88%,89%,163,172,153,24%,22%,28%,1,1,0,0,0,0
68,https://vlr.gg/player/7749/nexi,2024-07-03 02:00:00,1.04,1.87,1.41,248,168,340,36,13,23,25,15,10,23,12,11,0,-1,+1,86%,83%,89%,157,119,206,24%,30%,20%,3,1,2,3,2,1
69,https://vlr.gg/player/13220/ja,2024-07-03 02:00:00,1.44,1.22,1.35,300,314,292,45,26,19,30,17,13,6,4,2,+3,+1,+2,77%,79%,74%,197,199,195,23%,22%,24%,9,4,5,6,3,3
70,https://vlr.gg/player/9747/emman,2024-07-03 02:00:00,1.21,1.05,1.14,211,221,201,32,19,13,31,17,14,22,13,9,+1,0,+1,86%,83%,89%,136,140,132,38%,43%,32%,3,1,2,2,1,1
71,https://vlr.gg/player/16842/mojer,2024-07-03 02:00:00,0.92,0.76,0.85,203,236,161,28,18,10,33,19,14,9,7,2,-4,-3,-1,79%,75%,84%,140,160,115,22%,25%,18%,6,4,2,10,7,3
72,https://vlr.gg/player/683/pancada,2024-07-02 19:15:00,1.24,1.21,1.23,236,241,238,58,30,28,46,22,24,19,7,12,+1,0,+1,74%,74%,74%,154,154,155,44%,46%,42%,6,3,3,5,3,2
73,https://vlr.gg/player/6193/cauanzin,2024-07-02 19:15:00,0.95,0.99,0.97,215,224,210,54,26,28,52,25,27,10,4,6,+4,0,+4,61%,53%,69%,138,138,137,25%,26%,25%,10,4,6,6,4,2
74,https://vlr.gg/player/2408/tuyz,2024-07-02 19:15:00,1.01,0.75,0.88,173,194,151,42,24,18,49,24,25,25,13,12,-3,-3,0,72%,79%,66%,113,126,101,34%,36%,32%,3,0,3,6,3,3
75,https://vlr.gg/player/8447/less,2024-07-02 19:15:00,0.66,1.09,0.87,185,152,218,44,18,26,51,26,25,11,2,9,+2,+1,+1,61%,53%,69%,131,106,156,27%,22%,31%,7,4,3,5,3,2
76,https://vlr.gg/player/727/saadhak,2024-07-02 19:15:00,0.84,0.82,0.83,186,195,178,36,20,16,53,26,27,25,13,12,-7,-4,-3,67%,71%,63%,128,128,128,20%,23%,18%,7,3,4,14,7,7
77,https://vlr.gg/player/939/mwzera,2024-07-02 19:15:00,1.33,1.26,1.29,295,317,271,71,40,31,52,25,27,16,4,12,+6,+2,+4,81%,77%,85%,190,198,181,16%,16%,16%,13,7,6,7,5,2
78,https://vlr.gg/player/1711/khalil,2024-07-02 19:15:00,1.25,1.17,1.21,202,207,197,50,25,25,40,20,20,27,14,13,0,-1,+1,77%,83%,71%,131,134,129,30%,26%,34%,5,1,4,5,2,3
79,https://vlr.gg/player/8706/havoc,2024-07-02 19:15:00,0.93,1.34,1.13,229,201,257,54,24,30,47,24,23,14,5,9,+3,0,+3,74%,74%,74%,159,129,191,37%,38%,36%,11,5,6,8,5,3
80,https://vlr.gg/player/725/nzr,2024-07-02 19:15:00,1.00,0.84,0.92,171,188,154,42,24,18,45,21,24,27,10,17,-2,-1,-1,68%,71%,65%,129,145,112,24%,23%,26%,1,0,1,3,1,2
81,https://vlr.gg/player/681/xand,2024-07-02 19:15:00,0.59,0.85,0.72,128,119,139,34,15,19,50,26,24,25,12,13,-4,-3,-1,71%,71%,71%,83,69,97,27%,32%,24%,6,3,3,10,6,4
82,https://vlr.gg/player/1533/derrek,2024-07-02 17:00:00,0.89,1.24,1.03,189,163,250,29,14,15,30,16,14,7,4,3,-3,-3,0,71%,67%,76%,139,114,173,45%,35%,54%,1,0,1,4,3,1
83,https://vlr.gg/player/3993/jawgemo,2024-07-02 17:00:00,0.88,0.71,0.81,184,217,141,26,18,8,35,21,14,16,7,9,-4,-4,0,71%,67%,76%,126,145,100,31%,35%,25%,2,0,2,6,4,2
84,https://vlr.gg/player/5188/apoth,2024-07-02 17:00:00,0.92,0.52,0.75,167,196,125,22,16,6,33,18,15,10,4,6,-2,-2,0,51%,50%,53%,121,142,90,53%,56%,48%,4,2,2,6,4,2
85,https://vlr.gg/player/826/supamen,2024-07-02 17:00:00,0.83,0.57,0.72,194,212,179,28,18,10,39,24,15,6,2,4,-2,0,-2,68%,67%,71%,133,140,123,43%,40%,50%,7,5,2,9,5,4
86,https://vlr.gg/player/4927/nature,2024-07-02 17:00:00,0.61,0.59,0.60,124,121,136,18,9,9,32,19,13,13,11,2,-2,-1,-1,66%,63%,71%,80,78,83,33%,28%,38%,0,0,0,2,1,1
87,https://vlr.gg/player/8480/aspas,2024-07-02 17:00:00,1.50,1.71,1.62,327,347,308,48,20,28,25,12,13,7,5,2,+6,+2,+4,83%,82%,83%,210,223,200,34%,36%,31%,9,4,5,3,2,1
88,https://vlr.gg/player/7603/mazino,2024-07-02 17:00:00,1.57,1.39,1.46,269,250,273,41,16,25,24,9,15,18,9,9,+3,+1,+2,85%,88%,83%,161,148,170,33%,32%,33%,7,2,5,4,1,3
89,https://vlr.gg/player/8549/kingg,2024-07-02 17:00:00,1.62,1.24,1.40,224,244,204,33,16,17,19,7,12,21,6,15,+2,+1,+1,83%,94%,75%,147,159,139,31%,34%,30%,3,2,1,1,1,0
90,https://vlr.gg/player/619/c0m,2024-07-02 17:00:00,1.06,0.94,0.99,186,161,200,25,11,14,25,9,16,14,6,8,-1,-1,0,85%,88%,83%,136,126,143,26%,26%,27%,2,0,2,3,1,2
91,https://vlr.gg/player/1818/tex,2024-07-02 17:00:00,0.62,0.64,0.63,157,144,175,22,8,14,30,11,19,11,4,7,+3,0,+3,66%,71%,63%,97,78,111,20%,24%,18%,6,2,4,3,2,1
92,https://vlr.gg/player/34684/westside,2024-07-02 13:45:00,0.87,1.46,1.24,207,193,217,30,11,19,20,10,10,13,2,11,+5,+1,+4,87%,87%,88%,131,111,144,21%,23%,20%,5,1,4,0,0,0
93,https://vlr.gg/player/5490/xitsha,2024-07-02 13:45:00,1.25,1.16,1.20,250,250,246,38,15,23,26,10,16,10,4,6,-4,-3,-1,77%,87%,71%,150,161,143,41%,55%,33%,2,0,2,6,3,3
94,https://vlr.gg/player/24424/pa1ze,2024-07-02 13:45:00,1.09,1.27,1.20,263,286,254,35,14,21,26,11,15,10,2,8,+4,+2,+2,74%,73%,75%,154,167,145,24%,27%,23%,12,6,6,8,4,4
95,https://vlr.gg/player/8593/grmekista,2024-07-02 13:45:00,1.27,1.13,1.18,192,204,179,25,12,13,20,8,12,14,2,12,-3,-1,-2,77%,73%,79%,138,163,123,19%,24%,16%,0,0,0,3,1,2
96,https://vlr.gg/player/3839/prti,2024-07-02 13:45:00,0.74,1.30,1.09,180,148,200,28,8,20,20,10,10,12,5,7,-1,0,-1,85%,100%,75%,117,107,123,37%,41%,36%,1,0,1,2,0,2
97,https://vlr.gg/player/7242/freyy,2024-07-02 13:45:00,0.98,1.26,1.09,212,199,230,28,15,13,30,19,11,10,6,4,+7,+5,+2,69%,63%,80%,135,130,142,21%,22%,19%,7,5,2,0,0,0
98,https://vlr.gg/player/42702/krizz,2024-07-02 13:45:00,0.85,0.77,0.82,162,148,178,21,13,8,29,17,12,4,2,2,-1,0,-1,64%,58%,73%,113,101,132,20%,20%,20%,1,0,1,2,0,2
99,https://vlr.gg/player/2656/snikk,2024-07-02 13:45:00,0.68,0.99,0.80,147,141,164,20,11,9,31,20,11,12,8,4,-2,-2,0,64%,63%,67%,103,100,108,27%,26%,28%,1,1,0,3,3,0
100,https://vlr.gg/player/10378/almo,2024-07-02 13:45:00,0.71,0.62,0.68,189,195,180,24,15,9,35,21,14,6,4,2,0,-2,+2,62%,58%,67%,133,140,122,20%,27%,11%,9,5,4,9,7,2
101,https://vlr.gg/player/2669/kenobi,2024-07-02 13:45:00,0.55,0.75,0.62,142,124,167,19,9,10,31,19,12,13,10,3,-5,-3,-2,56%,54%,60%,95,88,107,40%,32%,48%,1,0,1,6,3,3
102,https://vlr.gg/player/12372/szoren,2024-07-02 13:15:00,1.14,1.47,1.31,247,193,284,63,24,39,43,20,23,22,14,8,-1,0,-1,75%,80%,70%,158,128,186,33%,26%,38%,3,2,1,4,2,2
103,https://vlr.gg/player/31350/deqadz,2024-07-02 13:15:00,1.64,0.86,1.24,252,263,214,59,33,26,44,17,27,37,27,10,+1,0,+1,75%,80%,70%,150,163,137,15%,15%,16%,6,2,4,5,2,3
104,https://vlr.gg/player/24428/harambe,2024-07-02 13:15:00,1.24,1.25,1.24,256,267,237,63,32,31,49,26,23,15,9,6,+10,+5,+5,79%,77%,81%,170,172,168,24%,21%,27%,17,11,6,7,6,1
105,https://vlr.gg/player/42371/t0ba,2024-07-02 13:15:00,1.21,0.83,1.02,188,232,158,52,29,23,45,21,24,15,10,5,+3,+3,0,75%,80%,70%,133,157,110,27%,27%,26%,10,4,6,7,1,6
106,https://vlr.gg/player/30901/ianto,2024-07-02 13:15:00,0.87,0.67,0.77,148,136,143,31,17,14,46,20,26,27,10,17,-5,-3,-2,74%,80%,68%,98,96,99,20%,26%,15%,4,1,3,9,4,5
107,https://vlr.gg/player/16188/tempo,2024-07-02 13:15:00,1.27,0.88,1.08,195,236,203,57,32,25,53,24,29,11,5,6,0,+3,-3,68%,76%,60%,138,150,126,32%,39%,25%,8,5,3,8,2,6
108,https://vlr.gg/player/33994/creamydreamy,2024-07-02 13:15:00,1.11,0.84,0.98,194,226,153,47,28,19,55,28,27,35,19,16,0,+1,-1,68%,73%,63%,126,141,109,33%,34%,31%,5,4,1,5,3,2
109,https://vlr.gg/player/12519/ticey,2024-07-02 13:15:00,0.92,0.92,0.92,194,200,206,48,26,22,54,28,26,17,6,11,-7,-5,-2,61%,62%,60%,138,132,144,23%,26%,21%,8,4,4,15,9,6
110,https://vlr.gg/player/29628/famzzam,2024-07-02 13:15:00,0.77,0.91,0.83,160,131,199,36,14,22,53,26,27,26,16,10,+2,0,+2,71%,70%,71%,106,85,129,22%,14%,31%,8,4,4,6,4,2
111,https://vlr.gg/player/2182/hearthbeat,2024-07-02 13:15:00,0.97,0.63,0.81,146,179,124,39,23,16,53,27,26,26,17,9,-3,-2,-1,64%,68%,60%,95,111,79,28%,28%,29%,3,0,3,6,2,4
112,https://vlr.gg/player/22676/ventt,2024-07-02 12:45:00,1.93,1.25,1.54,248,327,198,41,24,17,22,10,12,26,9,17,0,-1,+1,76%,78%,75%,159,205,125,30%,45%,18%,1,0,1,1,1,0
113,https://vlr.gg/player/12793/xeus,2024-07-02 12:45:00,1.00,1.54,1.31,265,228,281,40,16,24,26,13,13,7,3,4,0,-4,+4,67%,44%,83%,164,141,180,26%,41%,18%,11,3,8,11,7,4
114,https://vlr.gg/player/12774/anima,2024-07-02 12:45:00,1.02,1.28,1.17,223,193,230,29,11,18,25,12,13,22,8,14,+4,0,+4,79%,72%,83%,136,121,147,11%,8%,13%,5,0,5,1,0,1
115,https://vlr.gg/player/12795/crewen,2024-07-02 12:45:00,0.72,1.43,1.13,207,175,236,34,12,22,26,14,12,14,3,11,+1,-1,+2,81%,72%,88%,129,98,152,35%,48%,30%,4,2,2,3,3,0
116,https://vlr.gg/player/16483/gloomy,2024-07-02 12:45:00,0.54,0.97,0.79,135,113,150,14,2,12,27,14,13,21,10,11,-3,-2,-1,71%,56%,83%,101,96,105,17%,18%,17%,1,0,1,4,2,2
117,https://vlr.gg/player/10137/ip0tt,2024-07-02 12:45:00,0.94,0.95,0.94,182,195,178,28,15,13,28,18,10,13,7,6,-1,+1,-2,69%,67%,72%,119,123,114,35%,46%,27%,3,2,1,4,1,3
118,https://vlr.gg/player/6559/destruct1vee,2024-07-02 12:45:00,0.75,1.05,0.88,162,139,207,23,12,11,31,18,13,14,5,9,-2,-5,+3,62%,58%,67%,126,100,161,31%,30%,33%,4,0,4,6,5,1
119,https://vlr.gg/player/7353/glovee,2024-07-02 12:45:00,0.77,1.00,0.87,170,150,207,25,13,12,33,19,14,16,4,12,-2,-3,+1,64%,58%,72%,129,119,143,18%,21%,15%,2,1,1,4,4,0
120,https://vlr.gg/player/5517/masic,2024-07-02 12:45:00,0.77,0.93,0.84,180,169,186,26,14,12,32,19,13,7,3,4,+2,-1,+3,64%,54%,78%,118,114,124,18%,21%,13%,6,3,3,4,4,0
121,https://vlr.gg/player/4962/lurzy0y0,2024-07-02 12:45:00,0.45,1.05,0.71,158,118,230,23,8,15,34,20,14,14,10,4,+1,-2,+3,60%,54%,67%,110,79,150,27%,30%,26%,5,1,4,4,3,1
122,https://vlr.gg/player/29575/luckymrj,2024-07-02 12:15:00,1.81,1.35,1.61,276,323,205,37,26,11,18,11,7,15,5,10,+3,+2,+1,83%,85%,81%,174,206,135,29%,30%,28%,4,3,1,1,1,0
123,https://vlr.gg/player/21216/f4ngeer,2024-07-02 12:15:00,1.17,2.04,1.56,323,266,383,43,19,24,22,16,6,11,5,6,+8,+2,+6,75%,70%,81%,196,178,218,40%,42%,38%,10,4,6,2,2,0
124,https://vlr.gg/player/4537/tajrex,2024-07-02 12:15:00,1.02,1.83,1.38,270,211,372,34,14,20,24,15,9,10,3,7,+6,+2,+4,81%,70%,94%,200,148,264,22%,24%,21%,8,4,4,2,2,0
125,https://vlr.gg/player/21609/danda,2024-07-02 12:15:00,0.94,1.27,1.09,174,150,206,22,10,12,19,12,7,19,11,8,-1,-2,+1,86%,80%,94%,108,82,140,26%,11%,44%,1,0,1,2,2,0
126,https://vlr.gg/player/29742/anxios,2024-07-02 12:15:00,0.93,0.81,0.88,134,158,97,15,9,6,19,12,7,17,13,4,0,0,0,69%,70%,69%,92,124,53,23%,30%,11%,3,1,2,3,1,2
127,https://vlr.gg/player/20032/treelover,2024-07-02 12:15:00,0.80,0.95,0.88,198,159,227,23,8,15,30,14,16,11,4,7,-2,-2,0,56%,44%,65%,136,111,155,42%,43%,41%,3,1,2,5,3,2
128,https://vlr.gg/player/22179/shy,2024-07-02 12:15:00,0.66,0.95,0.82,188,178,211,25,9,16,29,15,14,8,4,4,-4,-3,-1,67%,56%,75%,127,122,131,16%,25%,8%,3,1,2,7,4,3
129,https://vlr.gg/player/3746/hitch,2024-07-02 12:15:00,0.70,0.85,0.79,189,157,206,21,8,13,33,15,18,12,4,8,-3,-1,-2,67%,56%,75%,125,107,139,21%,19%,23%,0,0,0,3,1,2
130,https://vlr.gg/player/4543/nyczu,2024-07-02 12:15:00,0.36,0.85,0.63,148,113,170,17,6,11,30,15,15,7,2,5,-2,-2,0,42%,38%,45%,98,74,118,29%,19%,38%,3,0,3,5,2,3
131,https://vlr.gg/player/2189/qxv,2024-07-02 12:15:00,0.40,0.78,0.61,124,88,156,16,5,11,29,14,15,11,6,5,-5,-4,-1,64%,63%,65%,87,62,107,49%,60%,44%,1,0,1,6,4,2
132,https://vlr.gg/player/2701/maniek,2024-07-02 12:00:00,0.93,1.34,1.13,238,206,269,93,39,54,80,41,39,22,14,8,-5,-6,+1,70%,73%,66%,155,143,167,26%,25%,26%,19,9,10,24,15,9
133,https://vlr.gg/player/7220/saiz,2024-07-02 12:00:00,1.05,1.02,1.04,208,207,210,82,44,38,78,38,40,21,6,15,-1,+3,-4,72%,68%,77%,135,137,133,39%,46%,32%,11,6,5,12,3,9
134,https://vlr.gg/player/21959/kpzet,2024-07-02 12:00:00,1.10,0.85,0.98,187,220,161,73,42,31,79,39,40,42,21,21,+2,+3,-1,74%,73%,75%,123,145,100,37%,38%,36%,10,6,4,8,3,5
135,https://vlr.gg/player/20271/vorwenn,2024-07-02 12:00:00,0.90,0.86,0.88,173,187,162,72,37,35,81,40,41,22,11,11,-8,-4,-4,71%,77%,66%,115,123,108,28%,25%,32%,3,2,1,11,6,5
136,https://vlr.gg/player/5199/guardy,2024-07-02 12:00:00,0.92,0.75,0.84,148,159,148,57,33,24,81,38,43,49,26,23,-6,-4,-2,69%,66%,71%,102,100,105,36%,36%,36%,4,1,3,10,5,5
137,https://vlr.gg/player/251/b1sk,2024-07-02 12:00:00,1.24,1.17,1.20,265,271,264,105,55,50,82,38,44,20,9,11,+12,+7,+5,74%,75%,73%,179,179,179,22%,20%,24%,27,16,11,15,9,6
138,https://vlr.gg/player/33902/sayonara,2024-07-02 12:00:00,1.11,1.21,1.16,227,206,240,89,43,46,77,37,40,40,22,18,+7,+4,+3,76%,80%,71%,156,147,165,34%,36%,33%,13,6,7,6,2,4
139,https://vlr.gg/player/2894/kiles,2024-07-02 12:00:00,0.98,1.15,1.06,183,179,197,76,38,38,71,35,36,36,16,20,+1,-1,+2,79%,80%,77%,124,121,128,25%,25%,24%,6,1,5,5,2,3
140,https://vlr.gg/player/402/insider,2024-07-02 12:00:00,0.88,0.89,0.89,175,158,186,71,32,39,73,33,40,17,6,11,+1,+1,0,71%,79%,64%,119,112,127,35%,38%,33%,9,4,5,8,3,5
141,https://vlr.gg/player/443/zeddy,2024-07-02 12:00:00,0.92,0.81,0.87,160,185,139,58,35,23,75,40,35,46,19,27,-3,-1,-2,77%,77%,77%,108,123,93,29%,27%,31%,10,6,4,13,7,6
142,https://vlr.gg/player/3604/mojj,2024-07-02 10:30:00,1.29,1.34,1.31,255,246,263,41,19,22,26,16,10,10,6,4,+1,+1,0,81%,82%,81%,186,190,181,44%,40%,48%,5,3,2,4,2,2
143,https://vlr.gg/player/4894/jn3v1ce,2024-07-02 10:30:00,1.05,1.44,1.24,220,165,278,31,13,18,28,14,14,35,18,17,+2,0,+2,79%,77%,81%,138,107,171,27%,24%,29%,3,1,2,1,1,0
144,https://vlr.gg/player/15735/krostaly,2024-07-02 10:30:00,1.24,1.07,1.16,235,268,201,36,21,15,30,17,13,5,2,3,-3,0,-3,70%,68%,71%,145,151,140,32%,31%,33%,6,4,2,9,4,5
145,https://vlr.gg/player/18657/wasp,2024-07-02 10:30:00,0.94,1.38,1.15,220,186,258,34,14,20,30,16,14,13,9,4,-2,-3,+1,84%,77%,90%,145,119,173,41%,35%,47%,3,1,2,5,4,1
146,https://vlr.gg/player/1401/sasuke,2024-07-02 10:30:00,1.18,1.11,1.15,174,183,164,25,14,11,23,13,10,26,14,12,+3,0,+3,84%,82%,86%,116,120,113,30%,41%,21%,5,1,4,2,1,1
147,https://vlr.gg/player/5568/sociablee,2024-07-02 10:30:00,1.25,0.84,1.04,206,252,162,33,20,13,31,15,16,8,5,3,+2,0,+2,65%,62%,68%,133,147,120,27%,24%,33%,3,1,2,1,1,0
148,https://vlr.gg/player/568/turko,2024-07-02 10:30:00,0.90,0.91,0.91,179,171,191,28,13,15,31,15,16,9,7,2,-1,0,-1,60%,62%,59%,117,103,129,27%,42%,20%,3,2,1,4,2,2
149,https://vlr.gg/player/18677/ruxic,2024-07-02 10:30:00,0.63,1.00,0.82,180,142,216,25,9,16,35,18,17,17,6,11,+1,+1,0,72%,62%,82%,119,99,138,33%,30%,35%,5,3,2,4,2,2
150,https://vlr.gg/player/12651/w0zzip,2024-07-02 10:30:00,0.82,0.64,0.73,159,193,130,25,14,11,34,19,15,18,8,10,0,+1,-1,67%,67%,68%,102,116,89,32%,44%,23%,3,2,1,3,1,2
151,https://vlr.gg/player/10125/qw1,2024-07-02 10:30:00,0.19,1.11,0.66,185,77,286,26,5,21,36,19,17,6,2,4,-3,-5,+2,51%,38%,64%,119,58,177,28%,33%,26%,7,1,6,10,6,4
152,https://vlr.gg/player/22617/vitie,2024-07-02 10:00:00,1.49,1.15,1.31,260,257,253,60,27,33,47,20,27,32,25,7,+5,+2,+3,81%,81%,81%,167,170,164,26%,28%,24%,8,3,5,3,1,2
153,https://vlr.gg/player/20443/br-di,2024-07-02 10:00:00,1.05,1.07,1.06,184,169,194,44,20,24,44,21,23,32,11,21,-1,-2,+1,76%,72%,81%,113,107,119,27%,26%,27%,6,2,4,7,4,3
154,https://vlr.gg/player/31300/drog,2024-07-02 10:00:00,0.85,1.23,1.05,207,172,239,54,22,32,44,23,21,8,2,6,-1,-2,+1,69%,53%,83%,143,120,163,38%,19%,58%,2,1,1,3,3,0
155,https://vlr.gg/player/12471/kalkkuna,2024-07-02 10:00:00,0.74,1.23,1.00,200,167,240,52,20,32,51,27,24,3,1,2,-2,-4,+2,68%,63%,72%,137,105,165,35%,33%,36%,9,4,5,11,8,3
156,https://vlr.gg/player/28346/stolen,2024-07-02 10:00:00,0.87,0.67,0.77,170,185,156,39,20,19,50,24,26,12,8,4,-3,0,-3,59%,50%,67%,126,139,114,31%,27%,35%,8,3,5,11,3,8
157,https://vlr.gg/player/1339/ri4d,2024-07-02 10:00:00,1.15,1.62,1.37,289,253,333,66,29,37,49,27,22,34,17,17,+2,-1,+3,75%,72%,78%,195,173,219,36%,35%,37%,9,6,3,7,7,0
158,https://vlr.gg/player/9571/demiurge,2024-07-02 10:00:00,1.07,1.32,1.19,274,252,300,62,29,33,54,29,25,21,10,11,+4,0,+4,76%,69%,84%,193,178,208,23%,24%,22%,13,5,8,9,5,4
159,https://vlr.gg/player/8440/puggy,2024-07-02 10:00:00,1.19,1.12,1.15,197,189,219,48,24,24,43,23,20,19,10,9,+1,+1,0,68%,69%,66%,141,134,148,20%,15%,25%,7,2,5,6,1,5
160,https://vlr.gg/player/10403/jaf,2024-07-02 10:00:00,0.74,0.52,0.64,120,150,84,29,20,9,50,29,21,19,13,6,-4,-3,-1,62%,67%,56%,80,106,52,32%,31%,32%,3,1,2,7,4,3
161,https://vlr.gg/player/3936/sembern,2024-07-02 10:00:00,0.47,0.60,0.53,122,141,97,31,19,12,53,32,21,10,5,5,-1,-1,0,56%,53%,59%,80,89,70,19%,19%,18%,3,2,1,4,3,1
162,https://vlr.gg/player/34032/grumble,2024-07-02 09:20:00,1.30,1.58,1.42,265,213,328,50,24,26,26,12,14,10,4,6,+2,+1,+1,76%,79%,73%,168,141,203,39%,40%,38%,4,2,2,2,1,1
163,https://vlr.gg/player/7426/juicy,2024-07-02 09:20:00,1.46,1.28,1.38,256,273,237,46,28,18,31,16,15,9,5,4,+4,+3,+1,66%,68%,64%,167,183,146,34%,31%,38%,9,5,4,5,2,3
164,https://vlr.gg/player/11704/styron,2024-07-02 09:20:00,1.16,1.00,1.09,176,159,176,29,16,13,24,12,12,15,8,7,-3,-1,-2,72%,71%,73%,128,113,148,38%,33%,44%,1,0,1,4,1,3
165,https://vlr.gg/player/24628/wayne,2024-07-02 09:20:00,1.00,1.03,1.01,175,163,181,29,15,14,32,17,15,27,15,12,-3,-4,+1,82%,75%,91%,112,112,111,31%,33%,28%,2,1,1,5,5,0
166,https://vlr.gg/player/24653/vera,2024-07-02 09:20:00,1.16,0.70,0.96,206,261,170,38,26,12,37,19,18,10,4,6,-2,-1,-1,76%,79%,73%,147,168,119,32%,40%,22%,8,5,3,10,6,4
167,https://vlr.gg/player/3023/moosey,2024-07-02 09:20:00,1.24,0.79,0.99,232,280,198,40,22,18,41,17,24,6,2,4,+2,0,+2,68%,73%,64%,135,153,121,22%,23%,21%,7,2,5,5,2,3
168,https://vlr.gg/player/36687/miz,2024-07-02 09:20:00,1.09,0.78,0.91,176,210,169,30,16,14,37,15,22,18,10,8,-1,-3,+2,62%,64%,61%,123,134,114,41%,49%,35%,4,1,3,5,4,1
169,https://vlr.gg/player/7448/toy,2024-07-02 09:20:00,0.67,0.93,0.82,170,137,166,27,11,16,36,16,20,14,7,7,+2,0,+2,68%,77%,61%,107,102,110,30%,23%,38%,2,0,2,0,0,0
170,https://vlr.gg/player/26969/adept,2024-07-02 09:20:00,0.60,0.82,0.72,138,140,166,25,10,15,37,16,21,8,3,5,-1,0,-1,58%,55%,61%,107,103,109,28%,31%,26%,5,3,2,6,3,3
171,https://vlr.gg/player/36705/kestrel,2024-07-02 09:20:00,0.75,0.57,0.65,154,193,148,28,15,13,41,19,22,5,2,3,0,+3,-3,50%,55%,46%,113,120,106,29%,33%,26%,8,5,3,8,2,6
172,https://vlr.gg/player/46462/shu,2024-07-02 09:10:00,1.05,0.94,0.99,212,235,202,49,25,24,53,22,31,25,8,17,-4,+1,-5,70%,67%,73%,143,150,137,36%,42%,32%,6,3,3,10,2,8
173,https://vlr.gg/player/42994/nasty,2024-07-02 09:10:00,1.03,0.89,0.95,226,264,198,54,28,26,57,26,31,13,7,6,-8,-3,-5,60%,63%,57%,150,175,129,35%,37%,32%,11,6,5,19,9,10
174,https://vlr.gg/player/31853/n11,2024-07-02 09:10:00,0.95,0.91,0.93,200,178,217,44,17,27,53,20,33,27,15,12,+1,-1,+2,76%,73%,78%,129,115,141,38%,35%,41%,3,1,2,2,2,0
175,https://vlr.gg/player/46327/ethan,2024-07-02 09:10:00,0.93,0.84,0.88,192,214,177,45,21,24,53,23,30,13,9,4,-4,-2,-2,55%,57%,54%,135,144,129,29%,21%,41%,3,2,1,7,4,3
176,https://vlr.gg/player/2371/popoman4q,2024-07-02 09:10:00,0.65,1.01,0.85,183,118,234,41,14,27,55,22,33,25,8,17,-4,-1,-3,69%,63%,73%,118,75,153,19%,13%,23%,1,0,1,5,1,4
177,https://vlr.gg/player/31753/spiritz1,2024-07-02 09:10:00,1.58,1.19,1.41,318,369,254,76,48,28,53,29,24,9,7,2,+16,+11,+5,79%,92%,63%,205,247,154,47%,45%,51%,19,12,7,3,1,2
178,https://vlr.gg/player/46038/b1ngxun,2024-07-02 09:10:00,1.15,1.33,1.23,246,237,249,58,33,25,44,25,19,12,1,11,-2,0,-2,67%,62%,73%,166,159,175,36%,40%,33%,3,2,1,5,2,3
179,https://vlr.gg/player/46527/cangshu,2024-07-02 09:10:00,0.93,1.17,1.04,212,212,222,52,29,23,47,28,19,29,20,9,+7,+1,+6,78%,78%,77%,138,134,142,38%,36%,39%,13,6,7,6,5,1
180,https://vlr.gg/player/34183/rab1q,2024-07-02 09:10:00,0.90,1.13,1.00,173,140,201,37,17,20,40,19,21,30,13,17,+2,+1,+1,75%,70%,80%,116,97,139,21%,15%,27%,4,2,2,2,1,1
181,https://vlr.gg/player/34182/roud,2024-07-02 09:10:00,1.12,0.72,0.94,192,228,153,48,31,17,49,27,22,24,15,9,-4,0,-4,70%,73%,67%,128,153,98,35%,37%,32%,4,3,1,8,3,5
182,https://vlr.gg/player/33732/nunmeister,2024-07-02 09:00:00,1.36,1.53,1.44,256,226,284,62,32,30,40,21,19,28,12,16,+1,-4,+5,74%,69%,80%,166,150,184,37%,45%,29%,6,0,6,5,4,1
183,https://vlr.gg/player/15064/kajuks,2024-07-02 09:00:00,1.30,1.02,1.17,231,284,167,54,35,19,46,26,20,22,11,11,-3,+1,-4,71%,81%,60%,155,181,124,29%,31%,27%,2,1,1,5,0,5
184,https://vlr.gg/player/10448/kozok,2024-07-02 09:00:00,0.86,1.49,1.15,213,141,304,49,18,31,42,23,19,18,7,11,+1,-1,+2,68%,64%,73%,147,100,204,26%,27%,25%,6,3,3,5,4,1
185,https://vlr.gg/player/39682/wanzeru,2024-07-02 09:00:00,0.78,0.89,0.81,204,224,183,47,28,19,53,30,23,12,3,9,-2,-5,+3,56%,47%,67%,127,134,119,20%,17%,24%,13,7,6,15,12,3
186,https://vlr.gg/player/259/arch,2024-07-02 09:00:00,0.59,0.73,0.65,148,132,167,33,16,17,51,26,25,19,8,11,-3,-1,-2,64%,67%,60%,97,88,107,29%,28%,31%,3,2,1,6,3,3
187,https://vlr.gg/player/6925/chadi,2024-07-02 09:00:00,0.92,1.30,1.13,258,236,278,58,25,33,47,23,24,9,4,5,+2,-6,+8,76%,70%,81%,162,154,170,21%,25%,17%,14,4,10,12,10,2
188,https://vlr.gg/player/12673/bard0lf,2024-07-02 09:00:00,0.85,1.28,1.08,222,163,265,51,16,35,48,22,26,19,12,7,+2,0,+2,71%,70%,72%,138,108,163,45%,36%,52%,8,1,7,6,1,5
189,https://vlr.gg/player/3649/litshii,2024-07-02 09:00:00,0.93,0.94,0.94,192,200,195,44,21,23,50,23,27,12,5,7,-3,-3,0,65%,67%,64%,129,129,129,26%,25%,27%,3,0,3,6,3,3
190,https://vlr.gg/player/7185/nero,2024-07-02 09:00:00,0.89,0.76,0.82,148,175,128,36,19,17,47,22,25,18,9,9,-2,0,-2,64%,57%,69%,101,115,90,25%,21%,29%,2,2,0,4,2,2
191,https://vlr.gg/player/26404/zneva,2024-07-02 09:00:00,0.94,0.68,0.80,183,241,140,43,25,18,53,26,27,8,6,2,+7,+5,+2,64%,63%,64%,119,147,96,30%,32%,28%,9,6,3,2,1,1
192,https://vlr.gg/player/8137/lenne,2024-07-02 07:00:00,1.39,1.54,1.46,246,258,237,41,22,19,24,16,8,20,6,14,0,0,0,83%,80%,86%,164,175,151,24%,28%,19%,2,1,1,2,1,1
193,https://vlr.gg/player/9158/hyk,2024-07-02 07:00:00,0.71,1.52,1.09,182,139,231,32,12,20,29,19,10,9,3,6,-2,-3,+1,77%,60%,95%,130,103,161,36%,33%,38%,3,1,2,5,4,1
194,https://vlr.gg/player/24654/tempz,2024-07-02 07:00:00,0.82,1.34,1.06,213,172,260,37,15,22,33,19,14,22,8,14,+2,0,+2,83%,80%,86%,133,101,169,23%,20%,25%,4,1,3,2,1,1
195,https://vlr.gg/player/11737/xan,2024-07-02 07:00:00,0.79,1.24,1.00,225,167,287,36,14,22,36,21,15,8,5,3,+3,-3,+6,68%,56%,82%,147,123,174,23%,25%,21%,13,5,8,10,8,2
196,https://vlr.gg/player/2381/divine,2024-07-02 07:00:00,0.93,0.91,0.92,172,198,146,27,18,9,32,20,12,19,7,12,+2,+1,+1,79%,68%,91%,113,126,100,34%,49%,20%,4,2,2,2,1,1
197,https://vlr.gg/player/21051/jans0n,2024-07-02 07:00:00,0.65,1.62,1.17,226,153,287,39,12,27,30,17,13,14,2,12,+1,-2,+3,70%,50%,88%,140,108,168,23%,21%,24%,4,1,3,3,3,0
198,https://vlr.gg/player/2378/subbey,2024-07-02 07:00:00,0.76,1.18,0.99,192,158,229,34,11,23,34,19,15,10,4,6,+2,-1,+3,72%,64%,80%,134,108,157,34%,26%,40%,4,1,3,2,2,0
199,https://vlr.gg/player/7513/markl,2024-07-02 07:00:00,0.86,1.02,0.94,189,165,216,32,14,18,36,18,18,14,4,10,-2,-1,-1,68%,64%,72%,122,98,143,19%,19%,19%,3,0,3,5,1,4
200,https://vlr.gg/player/3480/thedoctorr,2024-07-02 07:00:00,1.00,0.81,0.90,167,216,132,24,15,9,35,19,16,26,7,19,+2,+2,0,70%,59%,80%,114,144,88,40%,40%,38%,5,4,1,3,2,1
201,https://vlr.gg/player/45876/fixy,2024-07-02 07:00:00,0.37,0.91,0.66,163,114,201,25,7,18,38,19,19,9,4,5,-8,-8,0,66%,59%,72%,114,90,136,19%,22%,16%,5,0,5,13,8,5
202,https://vlr.gg/player/46043/answerz,2024-07-02 07:00:00,0.73,2.12,1.35,242,162,345,39,14,25,26,19,7,7,3,4,+2,-3,+5,70%,50%,95%,165,103,244,31%,24%,36%,5,0,5,3,3,0
203,https://vlr.gg/player/40891/be,2024-07-02 07:00:00,1.37,0.68,1.07,204,275,115,30,23,7,28,17,11,17,10,7,+1,+2,-1,79%,71%,89%,137,175,88,49%,57%,35%,3,2,1,2,0,2
204,https://vlr.gg/player/44930/nex1sphix,2024-07-02 07:00:00,0.65,1.54,1.05,220,164,280,32,13,19,29,19,10,19,8,11,+2,0,+2,74%,71%,79%,144,116,180,27%,20%,33%,4,2,2,2,2,0
205,https://vlr.gg/player/40901/orgil,2024-07-02 07:00:00,1.00,0.77,0.90,192,186,192,29,16,13,30,17,13,12,4,8,-3,-3,0,67%,67%,68%,129,133,125,50%,56%,42%,1,0,1,4,3,1
206,https://vlr.gg/player/40912/123,2024-07-02 07:00:00,0.48,1.41,0.89,212,151,306,37,13,24,34,20,14,3,2,1,-3,-6,+3,58%,38%,84%,142,105,188,43%,45%,43%,8,3,5,11,9,2
207,https://vlr.gg/player/42979/zhannn,2024-07-02 07:00:00,1.14,1.27,1.21,218,223,217,33,15,18,29,16,13,16,7,9,+4,0,+4,65%,47%,79%,137,138,136,30%,26%,34%,6,1,5,2,1,1
208,https://vlr.gg/player/34178/queya,2024-07-02 07:00:00,0.56,1.32,0.98,211,144,267,31,8,23,35,18,17,5,4,1,+2,-1,+3,72%,63%,79%,144,109,171,33%,19%,41%,3,0,3,1,1,0
209,https://vlr.gg/player/34184/yzka1,2024-07-02 07:00:00,0.65,1.03,0.86,176,154,194,28,11,17,34,17,17,14,4,10,-2,-2,0,74%,74%,75%,108,91,122,35%,36%,34%,5,2,3,7,4,3
210,https://vlr.gg/player/44128/xiaofeng,2024-07-02 07:00:00,0.57,1.08,0.86,206,169,232,31,10,21,35,19,16,5,3,2,-3,-4,+1,60%,58%,63%,136,110,156,28%,33%,24%,5,2,3,8,6,2
211,https://vlr.gg/player/46039/awei,2024-07-02 07:00:00,0.64,0.91,0.79,179,186,170,24,11,13,34,18,16,11,5,6,0,-2,+2,77%,68%,83%,121,124,119,21%,17%,26%,3,0,3,3,2,1
212,https://vlr.gg/player/26310/ikana,2024-07-02 06:30:00,0.95,1.61,1.30,228,159,291,50,17,33,38,19,19,26,14,12,-2,-3,+1,69%,59%,79%,156,103,202,24%,30%,22%,2,0,2,4,3,1
213,https://vlr.gg/player/26316/ramen,2024-07-02 06:30:00,0.94,1.32,1.14,191,157,219,40,15,25,36,19,17,19,7,12,-1,-3,+2,68%,55%,79%,125,105,143,18%,17%,19%,3,1,2,4,4,0
214,https://vlr.gg/player/10089/andy,2024-07-02 06:30:00,1.13,0.94,1.03,209,223,192,45,22,23,41,19,22,20,11,9,-1,-4,+3,69%,72%,67%,141,145,137,28%,31%,26%,6,0,6,7,4,3
215,https://vlr.gg/player/31593/kiss,2024-07-02 06:30:00,0.78,1.21,1.01,199,197,203,44,18,26,42,24,18,21,9,12,-6,-4,-2,76%,69%,82%,135,135,136,31%,27%,34%,5,3,2,11,7,4
216,https://vlr.gg/player/31589/murza,2024-07-02 06:30:00,0.84,0.91,0.88,192,180,202,42,19,23,44,22,22,9,3,6,-2,+1,-3,61%,52%,70%,120,112,127,17%,14%,21%,9,4,5,11,3,8
217,https://vlr.gg/player/1771/myth,2024-07-02 06:30:00,0.89,1.37,1.12,213,188,247,45,22,23,44,27,17,36,17,19,+2,-1,+3,74%,61%,90%,132,124,142,20%,23%,17%,3,0,3,1,1,0
218,https://vlr.gg/player/22816/blessed,2024-07-02 06:30:00,0.82,1.31,1.05,206,171,247,41,17,24,43,25,18,33,13,20,+4,0,+4,65%,61%,69%,135,115,157,28%,28%,28%,8,3,5,4,3,1
219,https://vlr.gg/player/31580/vizsla,2024-07-02 06:30:00,0.67,1.39,1.00,191,156,229,41,15,26,42,26,16,6,2,4,0,-2,+2,61%,52%,72%,131,114,150,37%,33%,40%,7,3,4,7,5,2
220,https://vlr.gg/player/15081/maishiu,2024-07-02 06:30:00,0.95,0.72,0.84,167,194,142,35,22,13,43,24,19,17,9,8,0,-1,+1,61%,64%,59%,122,130,113,32%,38%,25%,4,1,3,4,2,2
221,https://vlr.gg/player/36747/bonobo,2024-07-02 06:30:00,0.80,0.87,0.83,190,198,183,39,22,17,49,28,21,8,3,5,+6,+3,+3,69%,64%,76%,133,128,139,35%,45%,26%,15,9,6,9,6,3
222,https://vlr.gg/player/31254/feta,2024-07-02 04:30:00,1.88,1.76,1.84,376,423,279,51,36,15,21,16,5,6,3,3,+13,+8,+5,87%,88%,86%,247,276,196,31%,33%,26%,15,9,6,2,1,1
223,https://vlr.gg/player/29821/sinaway,2024-07-02 04:30:00,0.90,1.84,1.25,227,172,314,31,15,16,22,16,6,12,2,10,+3,+2,+1,76%,63%,100%,156,134,195,28%,30%,27%,4,3,1,1,1,0
224,https://vlr.gg/player/31255/biggiecheese,2024-07-02 04:30:00,0.77,1.76,1.14,200,157,282,28,13,15,20,15,5,14,6,8,-1,-2,+1,82%,71%,100%,132,96,193,34%,26%,45%,2,1,1,3,3,0
225,https://vlr.gg/player/22828/milky,2024-07-02 04:30:00,0.87,1.21,1.00,175,152,210,22,10,12,24,16,8,21,14,7,+1,+1,0,84%,79%,93%,117,112,126,22%,18%,29%,4,3,1,3,2,1
226,https://vlr.gg/player/14170/mckinley,2024-07-02 04:30:00,0.78,1.08,0.89,114,92,154,17,9,8,19,12,7,14,5,9,0,-1,+1,68%,63%,79%,79,56,118,23%,23%,23%,2,0,2,2,1,1
227,https://vlr.gg/player/1062/lew,2024-07-02 04:30:00,0.95,1.27,1.16,225,246,217,29,10,19,24,12,12,1,0,1,0,0,0,63%,43%,75%,155,163,150,29%,22%,35%,1,1,0,1,1,0
228,https://vlr.gg/player/6659/dragon,2024-07-02 04:30:00,0.56,1.22,0.98,227,179,247,29,8,21,30,14,16,9,4,5,-4,-3,-1,68%,50%,79%,142,108,162,32%,27%,35%,2,0,2,6,3,3
229,https://vlr.gg/player/2993/rdeew,2024-07-02 04:30:00,0.71,0.72,0.72,169,191,161,19,8,11,34,14,20,10,3,7,-3,-2,-1,50%,50%,50%,118,126,113,28%,39%,22%,3,1,2,6,3,3
230,https://vlr.gg/player/5228/minimise,2024-07-02 04:30:00,0.22,0.82,0.59,116,58,153,16,2,14,29,13,16,9,5,4,-7,-3,-4,47%,43%,50%,73,35,95,25%,22%,26%,3,1,2,10,4,6
231,https://vlr.gg/player/1175/signed,2024-07-02 04:30:00,0.26,0.64,0.50,122,80,150,13,3,10,32,13,19,9,3,6,-2,0,-2,50%,43%,54%,96,61,116,37%,50%,33%,2,0,2,4,0,4
232,https://vlr.gg/player/4004/zekken,2024-07-01 19:25:00,1.31,1.58,1.42,296,291,307,40,24,16,24,15,9,6,3,3,+11,+5,+6,85%,79%,93%,181,174,193,26%,26%,26%,16,8,8,5,3,2
233,https://vlr.gg/player/729/zellsis,2024-07-01 19:25:00,0.91,1.92,1.30,208,154,298,31,13,18,18,14,4,14,8,6,-3,-3,0,77%,67%,93%,136,105,186,16%,18%,15%,0,0,0,3,3,0
234,https://vlr.gg/player/9/tenz,2024-07-01 19:25:00,1.12,0.95,1.05,184,206,149,24,16,8,23,16,7,17,9,8,-1,+1,-2,77%,75%,80%,128,139,110,27%,25%,31%,2,2,0,3,1,2
235,https://vlr.gg/player/1265/johnqt,2024-07-01 19:25:00,0.61,1.66,1.01,177,128,244,26,12,14,21,16,5,5,0,5,+2,0,+2,72%,67%,80%,107,78,153,29%,30%,27%,3,1,2,1,1,0
236,https://vlr.gg/player/659/sacy,2024-07-01 19:25:00,0.68,1.37,0.94,140,114,184,18,10,8,21,16,5,19,7,12,-3,-4,+1,79%,75%,87%,99,76,135,30%,29%,32%,2,1,1,5,5,0
237,https://vlr.gg/player/7871/xeppaa,2024-07-01 19:25:00,0.69,1.37,1.11,202,133,249,27,7,20,26,12,14,15,5,10,+3,0,+3,77%,73%,79%,133,83,165,25%,26%,25%,5,1,4,2,1,1
238,https://vlr.gg/player/7458/moose,2024-07-01 19:25:00,0.32,1.23,0.88,132,64,176,19,3,16,24,13,11,5,0,5,-1,0,-1,62%,33%,79%,82,37,109,24%,22%,24%,2,1,1,3,1,2
239,https://vlr.gg/player/16003/runi,2024-07-01 19:25:00,0.67,0.87,0.80,148,156,143,20,8,12,29,13,16,15,3,12,-1,-2,+1,69%,60%,75%,98,111,91,27%,45%,18%,1,0,1,2,2,0
240,https://vlr.gg/player/7870/vanity,2024-07-01 19:25:00,0.59,0.92,0.77,161,145,179,21,7,14,28,13,15,10,2,8,-3,-1,-2,62%,40%,75%,106,87,118,17%,17%,16%,4,1,3,7,2,5
241,https://vlr.gg/player/18796/oxy,2024-07-01 19:25:00,0.28,0.75,0.57,153,108,177,18,4,14,32,14,18,7,2,5,-4,-3,-1,62%,53%,67%,101,78,115,22%,13%,28%,4,1,3,8,4,4
242,https://vlr.gg/player/11225/ethan,2024-07-01 17:00:00,1.12,1.13,1.13,271,269,271,37,14,23,32,14,18,11,7,4,+4,+3,+1,78%,88%,71%,162,165,160,23%,25%,21%,7,4,3,3,1,2
243,https://vlr.gg/player/4164/s0m,2024-07-01 17:00:00,1.14,0.80,0.94,200,218,187,26,14,12,32,13,19,20,7,13,-1,0,-1,76%,88%,67%,132,134,130,32%,39%,27%,3,1,2,4,1,3
244,https://vlr.gg/player/4/crashies,2024-07-01 17:00:00,0.66,1.09,0.91,151,118,175,21,6,15,23,11,12,14,7,7,0,0,0,80%,71%,88%,103,86,115,21%,20%,22%,1,1,0,1,1,0
245,https://vlr.gg/player/261/victor,2024-07-01 17:00:00,0.76,0.80,0.79,186,173,195,27,12,15,32,13,19,10,4,6,-7,-1,-6,63%,71%,58%,131,128,133,33%,28%,36%,4,2,2,11,3,8
246,https://vlr.gg/player/817/finesse,2024-07-01 17:00:00,0.51,0.28,0.38,110,138,92,13,8,5,38,15,23,10,5,5,-1,+1,-2,46%,53%,42%,71,89,58,22%,25%,19%,3,2,1,4,1,3
247,https://vlr.gg/player/7873/leaf,2024-07-01 17:00:00,1.26,1.68,1.43,272,289,245,40,23,17,23,15,8,9,5,4,+4,+5,-1,71%,71%,71%,172,176,167,20%,20%,20%,8,7,1,4,2,2
248,https://vlr.gg/player/15500/trent,2024-07-01 17:00:00,1.16,1.38,1.25,270,257,289,38,24,14,30,17,13,16,5,11,+1,0,+1,80%,71%,94%,177,161,200,38%,33%,43%,5,3,2,4,3,1
249,https://vlr.gg/player/3885/valyn,2024-07-01 17:00:00,1.09,1.01,1.06,180,140,238,25,11,14,23,11,12,18,11,7,0,0,0,85%,88%,82%,116,94,148,19%,16%,22%,2,1,1,2,1,1
250,https://vlr.gg/player/4581/jonahp,2024-07-01 17:00:00,1.26,0.60,0.99,169,188,146,25,17,8,25,12,13,21,14,7,-1,+2,-3,76%,83%,65%,114,119,106,27%,28%,25%,2,2,0,3,0,3
251,https://vlr.gg/player/8402/icy,2024-07-01 17:00:00,0.85,1.17,0.98,194,192,198,29,16,13,23,15,8,5,4,1,+1,+1,0,88%,92%,82%,134,131,138,27%,30%,24%,6,3,3,5,2,3
252,https://vlr.gg/player/23169/minny,2024-07-01 13:35:00,1.25,1.50,1.35,240,235,232,37,22,15,21,14,7,7,5,2,0,-2,+2,73%,71%,76%,164,159,170,39%,39%,38%,2,0,2,2,2,0
253,https://vlr.gg/player/562/zeek,2024-07-01 13:35:00,1.45,1.00,1.26,267,298,173,34,24,10,24,16,8,16,9,7,+3,+1,+2,80%,75%,88%,163,192,122,18%,18%,17%,4,2,2,1,1,0
254,https://vlr.gg/player/25906/alexiiik,2024-07-01 13:35:00,0.79,1.54,1.10,242,209,307,37,18,19,29,21,8,7,4,3,+2,-4,+6,80%,71%,94%,147,121,183,30%,30%,29%,9,2,7,7,6,1
255,https://vlr.gg/player/5554/profek,2024-07-01 13:35:00,1.01,0.77,0.91,205,207,218,29,16,13,27,15,12,17,9,8,-1,0,-1,73%,67%,82%,138,136,140,23%,16%,40%,4,3,1,5,3,2
256,https://vlr.gg/player/1155/buld,2024-07-01 13:35:00,0.26,1.49,0.77,133,65,227,19,4,15,26,19,7,10,6,4,0,-1,+1,56%,38%,82%,87,49,140,26%,10%,38%,3,2,1,3,3,0
257,https://vlr.gg/player/28948/ninja,2024-07-01 13:35:00,0.76,1.32,1.09,196,168,224,31,11,20,28,14,14,9,1,8,-1,-1,0,73%,59%,83%,131,104,150,48%,61%,44%,3,1,2,4,2,2
258,https://vlr.gg/player/38424/zachkappa,2024-07-01 13:35:00,0.96,1.05,1.01,187,205,188,28,12,16,30,14,16,7,1,6,0,-2,+2,61%,59%,63%,130,132,129,38%,32%,43%,3,0,3,3,2,1
259,https://vlr.gg/player/40004/globex,2024-07-01 13:35:00,0.85,0.85,0.85,166,175,175,25,10,15,28,13,15,8,5,3,-3,-3,0,68%,65%,71%,109,115,104,10%,18%,6%,5,2,3,8,5,3
260,https://vlr.gg/player/18162/serial,2024-07-01 13:35:00,0.45,1.00,0.78,194,140,222,28,8,20,35,16,19,5,2,3,-2,-3,+1,63%,53%,71%,125,92,149,35%,27%,40%,3,0,3,5,3,2
261,https://vlr.gg/player/164/bzt,2024-07-01 13:35:00,0.16,0.88,0.58,132,37,203,15,1,14,35,15,20,14,4,10,+2,-1,+3,66%,59%,71%,101,30,150,27%,20%,29%,4,0,4,2,1,1
262,https://vlr.gg/player/31305/lar0k,2024-07-01 13:10:00,1.25,1.53,1.39,251,235,282,64,29,35,44,24,20,29,11,18,+1,+2,-1,83%,80%,85%,162,148,175,28%,25%,30%,4,3,1,3,1,2
263,https://vlr.gg/player/40591/comeback,2024-07-01 13:10:00,1.02,0.98,1.00,222,240,202,54,29,25,51,28,23,7,6,1,+1,0,+1,67%,69%,65%,149,159,138,32%,39%,20%,9,5,4,8,5,3
264,https://vlr.gg/player/24344/loita,2024-07-01 13:10:00,0.93,1.00,0.97,185,189,176,43,23,20,49,26,23,30,10,20,-1,-1,0,74%,69%,79%,118,127,109,36%,42%,30%,10,5,5,11,6,5
265,https://vlr.gg/player/5565/ros,2024-07-01 13:10:00,0.72,0.88,0.80,191,182,201,42,20,22,54,28,26,30,12,18,-8,-6,-2,64%,57%,71%,132,121,143,21%,19%,22%,3,0,3,11,6,5
266,https://vlr.gg/player/31855/celasun,2024-07-01 13:10:00,0.63,0.96,0.79,140,110,180,34,14,20,46,25,21,12,6,6,0,-2,+2,70%,69%,71%,99,74,125,24%,26%,22%,5,1,4,5,3,2
267,https://vlr.gg/player/4893/lauress,2024-07-01 13:10:00,0.93,1.62,1.28,249,170,313,59,19,40,48,24,24,17,8,9,+8,+1,+7,74%,71%,77%,155,116,192,37%,31%,40%,9,2,7,1,1,0
268,https://vlr.gg/player/11531/patrui,2024-07-01 13:10:00,1.21,1.07,1.14,206,210,199,52,27,25,42,22,20,34,21,13,+1,+3,-2,80%,79%,80%,116,111,121,23%,18%,30%,4,4,0,3,1,2
269,https://vlr.gg/player/18615/batujnax,2024-07-01 13:10:00,1.01,0.83,0.92,217,266,175,51,31,20,50,27,23,15,7,8,+1,-2,+3,67%,65%,69%,139,161,117,22%,27%,15%,13,8,5,12,10,2
270,https://vlr.gg/player/2107/russ,2024-07-01 13:10:00,0.95,0.79,0.87,165,169,170,42,20,22,47,24,23,10,7,3,-4,-1,-3,70%,71%,69%,127,135,121,35%,33%,38%,6,1,5,10,2,8
271,https://vlr.gg/player/5566/jeyj7y,2024-07-01 13:10:00,0.80,0.94,0.87,170,136,203,40,16,24,50,25,25,18,12,6,+1,-1,+2,71%,71%,71%,113,90,134,28%,26%,29%,6,2,4,5,3,2
272,https://vlr.gg/player/7972/reqz,2024-07-01 12:30:00,1.03,1.48,1.23,216,161,286,44,18,26,33,18,15,19,10,9,-1,0,-1,82%,74%,92%,148,111,195,33%,39%,29%,2,1,1,3,1,2
273,https://vlr.gg/player/10270/dev0,2024-07-01 12:30:00,1.07,1.13,1.10,211,201,229,44,23,21,37,19,18,8,3,5,0,-2,+2,75%,68%,84%,127,112,146,27%,29%,26%,8,4,4,8,6,2
274,https://vlr.gg/player/8838/chanformer,2024-07-01 12:30:00,1.09,1.10,1.09,212,228,192,41,23,18,34,21,13,17,11,6,-1,-1,0,75%,81%,68%,131,154,102,26%,26%,26%,5,2,3,6,3,3
275,https://vlr.gg/player/15491/maximn,2024-07-01 12:30:00,0.97,1.22,1.08,223,216,229,41,22,19,37,22,15,27,8,19,+9,+3,+6,77%,71%,84%,145,148,141,17%,16%,18%,12,6,6,3,3,0
276,https://vlr.gg/player/18384/bully,2024-07-01 12:30:00,0.83,1.05,0.92,185,170,205,37,18,19,43,24,19,36,21,15,+5,+1,+4,86%,81%,92%,117,110,125,26%,26%,25%,7,3,4,2,2,0
277,https://vlr.gg/player/1365/nixoon,2024-07-01 12:30:00,1.06,1.08,1.07,249,253,252,47,21,26,49,24,25,27,9,18,-6,-1,-5,77%,64%,87%,157,168,148,19%,21%,17%,5,2,3,11,3,8
278,https://vlr.gg/player/1620/ale,2024-07-01 12:30:00,0.84,1.20,1.04,201,169,229,42,17,25,39,19,20,16,7,9,-3,-7,+4,70%,68%,71%,136,116,152,21%,23%,19%,9,2,7,12,9,3
279,https://vlr.gg/player/23174/snowi,2024-07-01 12:30:00,0.90,1.00,0.96,156,169,149,31,14,17,36,19,17,28,11,17,-4,-3,-1,73%,68%,77%,102,101,103,25%,26%,25%,1,0,1,5,3,2
280,https://vlr.gg/player/23220/jesmu,2024-07-01 12:30:00,0.77,0.90,0.84,168,170,164,33,14,19,42,20,22,17,9,8,+2,0,+2,73%,72%,74%,114,115,113,20%,16%,24%,4,2,2,2,2,0
281,https://vlr.gg/player/2571/feeqn,2024-07-01 12:30:00,0.66,0.82,0.75,158,169,151,31,14,17,41,21,20,11,4,7,-1,0,-1,70%,64%,74%,106,125,90,17%,25%,10%,3,1,2,4,1,3
282,https://vlr.gg/player/6959/flickless,2024-07-01 12:00:00,1.22,1.33,1.27,210,187,236,51,26,25,43,22,21,39,15,24,0,0,0,78%,78%,79%,128,111,147,21%,27%,16%,4,2,2,4,2,2
283,https://vlr.gg/player/8502/olizera,2024-07-01 12:00:00,0.95,1.48,1.20,238,197,284,59,25,34,48,26,22,16,9,7,+3,0,+3,64%,56%,73%,147,120,175,28%,29%,27%,11,6,5,8,6,2
284,https://vlr.gg/player/16209/famsii,2024-07-01 12:00:00,0.98,1.15,1.06,247,238,253,57,29,28,54,30,24,25,13,12,+1,0,+1,68%,64%,73%,156,151,161,19%,20%,19%,11,6,5,10,6,4
285,https://vlr.gg/player/4629/azury,2024-07-01 12:00:00,0.94,1.10,1.02,174,180,167,43,23,20,45,26,19,30,18,12,-5,-3,-2,68%,67%,70%,120,117,123,29%,27%,31%,2,1,1,7,4,3
286,https://vlr.gg/player/341/quick,2024-07-01 12:00:00,0.87,0.84,0.85,157,169,143,41,24,17,49,27,22,19,13,6,-6,-3,-3,71%,72%,70%,103,114,91,31%,34%,26%,3,0,3,9,3,6
287,https://vlr.gg/player/173/l0udly,2024-07-01 12:00:00,1.16,1.10,1.12,220,224,221,52,24,28,46,23,23,16,9,7,+7,+3,+4,68%,67%,69%,144,153,135,22%,24%,20%,10,4,6,3,1,2
288,https://vlr.gg/player/6909/jannyxd,2024-07-01 12:00:00,1.01,1.09,1.05,223,212,230,53,24,29,50,24,26,19,6,13,+5,0,+5,72%,67%,78%,143,146,141,29%,35%,25%,10,4,6,5,4,1
289,https://vlr.gg/player/4519/kamisseq,2024-07-01 12:00:00,1.04,0.97,1.00,211,210,219,54,25,29,50,23,27,17,8,9,-4,-3,-1,67%,64%,69%,144,136,151,46%,44%,48%,4,1,3,8,4,4
290,https://vlr.gg/player/3784/katu,2024-07-01 12:00:00,0.61,1.02,0.83,178,176,184,42,19,23,53,28,25,32,13,19,-4,-3,-1,62%,58%,67%,128,121,136,41%,36%,45%,6,4,2,10,7,3
291,https://vlr.gg/player/8629/saiko,2024-07-01 12:00:00,0.50,0.90,0.71,155,126,178,36,14,22,52,28,24,17,7,10,+3,+4,-1,74%,67%,81%,102,81,122,20%,15%,24%,8,4,4,5,0,5
292,https://vlr.gg/player/32351/cullumx,2024-07-01 11:00:00,1.09,1.81,1.58,321,215,325,40,10,30,19,9,10,4,3,1,+4,0,+4,77%,73%,79%,180,126,205,48%,44%,49%,9,3,6,5,3,2
293,https://vlr.gg/player/8808/pyrolll,2024-07-01 11:00:00,1.52,1.27,1.38,216,259,203,45,22,23,28,13,15,16,9,7,+2,+1,+1,82%,78%,84%,153,182,133,29%,35%,25%,4,1,3,2,0,2
294,https://vlr.gg/player/321/chiwa,2024-07-01 11:00:00,0.88,1.23,1.08,184,162,202,35,13,22,31,17,14,21,7,14,-1,0,-1,76%,70%,81%,127,115,136,21%,23%,21%,2,0,2,3,0,3
295,https://vlr.gg/player/4325/musashi,2024-07-01 11:00:00,1.21,0.94,1.05,206,258,173,40,21,19,37,20,17,18,9,9,0,+2,-2,71%,74%,69%,140,160,127,30%,34%,26%,4,3,1,4,1,3
296,https://vlr.gg/player/1374/alive,2024-07-01 11:00:00,0.84,1.13,1.01,213,229,201,43,17,26,38,21,17,8,7,1,0,-3,+3,75%,70%,78%,148,155,143,28%,26%,30%,8,2,6,8,5,3
297,https://vlr.gg/player/13024/vuubit,2024-07-01 11:00:00,0.39,0.81,0.56,132,108,169,8,4,4,17,11,6,14,10,4,-2,-1,-1,70%,67%,75%,69,47,103,45%,30%,60%,2,2,0,4,3,1
298,https://vlr.gg/player/37840/msh,2024-07-01 11:00:00,1.08,1.07,1.07,192,189,213,42,22,20,37,21,16,6,2,4,-1,0,-1,65%,63%,70%,130,124,139,40%,47%,33%,6,4,2,7,4,3
299,https://vlr.gg/player/4525/stix,2024-07-01 11:00:00,1.01,0.98,1.00,147,123,196,30,14,16,34,18,16,13,7,6,0,0,0,73%,63%,87%,103,86,126,30%,25%,37%,1,0,1,1,0,1
300,https://vlr.gg/player/9556/demek,2024-07-01 11:00:00,0.76,0.96,0.85,198,196,212,36,19,17,46,28,18,9,4,5,+6,+3,+3,62%,56%,70%,135,131,141,25%,26%,22%,12,7,5,6,4,2
301,https://vlr.gg/player/19505/szalony,2024-07-01 11:00:00,0.50,0.96,0.69,170,143,229,33,15,18,48,29,19,10,3,7,-2,-4,+2,60%,47%,78%,125,92,169,37%,36%,38%,7,3,4,9,7,2
302,https://vlr.gg/player/9143/darkosek,2024-07-01 11:00:00,0.32,1.07,0.63,140,94,220,29,9,20,46,28,18,13,8,5,-6,-3,-3,60%,53%,70%,107,66,164,29%,26%,30%,0,0,0,6,3,3
303,https://vlr.gg/player/1399/sterben,2024-07-01 10:30:00,1.54,1.21,1.37,268,327,219,51,29,22,35,19,16,18,10,8,+5,+3,+2,81%,85%,78%,177,207,148,38%,34%,43%,9,4,5,4,1,3
304,https://vlr.gg/player/3557/skylen,2024-07-01 10:30:00,0.65,1.21,0.93,170,125,214,31,11,20,37,19,18,25,5,20,+5,+2,+3,81%,73%,89%,115,75,153,33%,34%,33%,5,2,3,0,0,0
305,https://vlr.gg/player/10160/izzy,2024-07-01 10:30:00,0.73,1.12,0.93,239,206,261,44,20,24,42,23,19,6,0,6,0,-2,+2,64%,62%,67%,149,125,173,34%,34%,34%,9,5,4,9,7,2
306,https://vlr.gg/player/5510/oxmann,2024-07-01 10:30:00,0.70,1.04,0.87,173,168,172,35,16,19,35,20,15,8,3,5,-1,0,-1,79%,81%,78%,118,111,124,35%,39%,32%,3,2,1,4,2,2
307,https://vlr.gg/player/556/souhcni,2024-07-01 10:30:00,0.53,0.86,0.70,166,145,188,28,11,17,39,21,18,19,10,9,0,-3,+3,74%,69%,78%,107,99,114,35%,39%,32%,5,0,5,5,3,2
308,https://vlr.gg/player/10152/padisah,2024-07-01 10:30:00,0.93,1.30,1.11,222,177,254,39,15,24,37,19,18,15,8,7,+3,+2,+1,72%,74%,69%,142,111,173,40%,35%,45%,3,2,1,0,0,0
309,https://vlr.gg/player/5500/docent,2024-07-01 10:30:00,1.13,1.05,1.09,244,263,214,44,24,20,38,22,16,17,7,10,-1,0,-1,68%,67%,69%,152,163,140,27%,26%,28%,3,2,1,4,2,2
310,https://vlr.gg/player/3549/touven,2024-07-01 10:30:00,0.85,1.17,1.01,208,169,249,38,16,22,39,20,19,10,3,7,-5,-5,0,62%,59%,65%,141,110,173,22%,26%,20%,7,2,5,12,7,5
311,https://vlr.gg/player/10163/cyderx,2024-07-01 10:30:00,0.80,1.13,0.96,153,150,160,29,14,15,34,20,14,17,5,12,-1,+1,-2,74%,74%,73%,108,102,115,43%,39%,48%,1,1,0,2,0,2
312,https://vlr.gg/player/20144/lewn,2024-07-01 10:30:00,0.76,1.04,0.90,208,180,249,38,17,21,41,21,20,9,2,7,-5,-7,+2,64%,59%,69%,136,108,165,28%,33%,25%,8,2,6,13,9,4
313,https://vlr.gg/player/28480/marky,2024-07-01 10:00:00,0.69,1.32,0.97,205,166,253,29,13,16,32,20,12,9,5,4,-4,-5,+1,53%,50%,58%,139,98,190,21%,29%,16%,3,1,2,7,6,1
314,https://vlr.gg/player/31298/luca,2024-07-01 10:00:00,0.90,0.95,0.92,190,182,201,30,17,13,32,19,13,3,1,2,0,+1,-1,60%,58%,63%,135,132,138,29%,26%,34%,1,1,0,1,0,1
315,https://vlr.gg/player/42549/ozzytk,2024-07-01 10:00:00,0.82,0.91,0.86,194,220,172,29,18,11,33,20,13,6,4,2,-4,-4,0,60%,67%,53%,134,146,117,44%,41%,50%,4,2,2,8,6,2
316,https://vlr.gg/player/5481/melo,2024-07-01 10:00:00,0.90,0.70,0.81,153,163,144,24,13,11,32,17,15,10,6,4,-2,0,-2,67%,71%,63%,108,113,102,33%,26%,46%,0,0,0,2,0,2
317,https://vlr.gg/player/22310/stike,2024-07-01 10:00:00,0.77,0.41,0.61,156,195,117,24,16,8,36,20,16,6,3,3,-5,-4,-1,60%,67%,53%,104,127,74,36%,26%,75%,6,2,4,11,6,5
318,https://vlr.gg/player/9554/kaajak,2024-07-01 10:00:00,1.10,1.48,1.31,284,237,318,41,15,26,29,13,16,6,2,4,+11,+2,+9,81%,74%,88%,187,154,214,39%,44%,37%,13,4,9,2,2,0
319,https://vlr.gg/player/1281/molsi,2024-07-01 10:00:00,1.07,1.32,1.21,216,183,235,31,11,20,26,12,14,20,10,10,-3,-1,-2,84%,74%,92%,141,113,162,38%,38%,39%,0,0,0,3,1,2
320,https://vlr.gg/player/129/hype,2024-07-01 10:00:00,0.97,1.19,1.09,194,153,227,33,12,21,25,11,14,3,1,2,+3,+1,+2,72%,63%,79%,126,105,143,33%,29%,35%,4,1,3,1,0,1
321,https://vlr.gg/player/1507/avova,2024-07-01 10:00:00,1.23,0.98,1.09,202,246,173,33,18,15,26,12,14,10,2,8,+1,+1,0,77%,79%,75%,126,145,112,46%,43%,48%,5,4,1,4,3,1
322,https://vlr.gg/player/101/soulcas,2024-07-01 10:00:00,1.13,0.74,0.91,193,203,185,27,13,14,30,11,19,11,7,4,+3,0,+3,74%,79%,71%,135,150,123,35%,32%,37%,7,2,5,4,2,2
323,https://vlr.gg/player/804/buzz,2024-07-01 06:00:00,1.57,0.76,1.21,257,327,170,61,44,17,46,22,24,6,2,4,+2,+7,-5,72%,86%,55%,155,195,106,21%,22%,18%,14,10,4,12,3,9
324,https://vlr.gg/player/35013/flashback,2024-07-01 06:00:00,0.96,1.11,1.02,253,233,265,55,29,26,54,27,27,13,7,6,+8,+4,+4,80%,81%,79%,162,162,163,33%,33%,32%,9,5,4,1,1,0
325,https://vlr.gg/player/11600/foxy9,2024-07-01 06:00:00,1.16,0.83,1.01,177,183,174,38,23,15,39,16,23,22,12,10,+3,+4,-1,80%,89%,69%,125,125,125,33%,33%,33%,6,5,1,3,1,2
326,https://vlr.gg/player/4462/mako,2024-07-01 06:00:00,1.15,0.73,0.97,191,214,155,44,28,16,47,23,24,23,18,5,-7,-4,-3,68%,78%,55%,118,131,103,29%,25%,37%,2,1,1,9,5,4
327,https://vlr.gg/player/4678/beyn,2024-07-01 06:00:00,0.86,0.96,0.91,147,113,182,29,13,16,40,18,22,23,13,10,-1,-1,0,72%,78%,66%,106,84,133,24%,23%,24%,4,2,2,5,3,2
328,https://vlr.gg/player/3977/crws,2024-07-01 06:00:00,1.59,0.93,1.23,248,287,211,55,33,22,43,15,28,24,8,16,+3,+1,+2,78%,86%,72%,162,188,140,24%,34%,19%,4,2,2,1,1,0
329,https://vlr.gg/player/23062/surf,2024-07-01 06:00:00,0.90,1.03,0.97,185,163,198,40,16,24,42,17,25,15,9,6,0,+1,-1,72%,72%,72%,129,115,139,34%,27%,40%,5,3,2,5,2,3
330,https://vlr.gg/player/13788/jitboys,2024-07-01 06:00:00,1.03,0.91,0.96,194,199,205,48,23,25,46,19,27,20,12,8,-1,+3,-4,74%,72%,75%,139,145,134,34%,28%,42%,6,5,1,7,2,5
331,https://vlr.gg/player/3980/governor,2024-07-01 06:00:00,1.18,0.74,0.94,202,250,164,44,25,19,50,21,29,26,14,12,-2,-3,+1,65%,79%,53%,134,164,110,29%,33%,24%,9,2,7,11,5,6
332,https://vlr.gg/player/5129/ban,2024-07-01 06:00:00,1.03,0.59,0.79,172,232,123,39,24,15,49,20,29,15,7,8,-5,+3,-8,69%,76%,64%,115,142,93,29%,35%,22%,6,5,1,11,2,9
333,https://vlr.gg/player/9801/f0rsaken,2024-07-01 04:00:00,1.59,1.24,1.43,299,297,308,39,23,16,25,12,13,18,8,10,+2,+1,+1,87%,90%,82%,206,207,205,25%,30%,19%,3,1,2,1,0,1
334,https://vlr.gg/player/7378/jinggg,2024-07-01 04:00:00,0.99,1.59,1.26,235,158,345,33,11,22,21,11,10,6,4,2,+4,+1,+3,74%,76%,71%,152,103,211,30%,29%,31%,6,2,4,2,1,1
335,https://vlr.gg/player/9803/d4v41,2024-07-01 04:00:00,1.24,0.94,1.11,230,274,164,30,20,10,26,15,11,14,7,7,+1,+1,0,79%,81%,76%,154,179,123,31%,28%,37%,4,3,1,3,2,1
336,https://vlr.gg/player/9800/mindfreak,2024-07-01 04:00:00,1.40,0.67,1.08,163,202,103,25,18,7,17,8,9,7,4,3,-3,-1,-2,74%,76%,71%,105,133,71,41%,46%,31%,1,1,0,4,2,2
337,https://vlr.gg/player/17086/something,2024-07-01 04:00:00,0.59,1.14,0.84,162,147,179,22,11,11,25,16,9,5,3,2,+2,-1,+3,74%,67%,82%,106,106,106,27%,24%,32%,8,4,4,6,5,1
338,https://vlr.gg/player/6672/meiy,2024-07-01 04:00:00,0.84,1.19,1.03,230,187,275,31,10,21,32,14,18,8,5,3,-2,-2,0,63%,59%,67%,161,134,183,29%,29%,29%,5,2,3,7,4,3
339,https://vlr.gg/player/21438/ssees,2024-07-01 04:00:00,0.93,0.96,0.94,189,195,194,24,11,13,28,12,16,13,5,8,+1,-1,+2,66%,59%,71%,121,120,122,33%,39%,29%,6,1,5,5,2,3
340,https://vlr.gg/player/6700/anthem,2024-07-01 04:00:00,0.92,0.80,0.83,174,199,166,23,11,12,30,14,16,6,3,3,-1,0,-1,74%,71%,76%,120,124,116,22%,29%,16%,3,2,1,4,2,2
341,https://vlr.gg/player/993/medusa,2024-07-01 04:00:00,0.94,0.54,0.72,158,189,129,21,13,8,29,13,16,4,2,2,-1,-1,0,63%,59%,67%,103,120,89,24%,18%,32%,2,1,1,3,2,1
342,https://vlr.gg/player/1970/neth,2024-07-01 04:00:00,0.63,0.57,0.60,129,124,124,15,7,8,30,13,17,9,2,7,-3,-1,-2,63%,65%,62%,83,87,80,31%,35%,28%,0,0,0,3,1,2
343,https://vlr.gg/player/8480/aspas,2024-06-30 20:20:00,1.18,1.59,1.43,295,225,338,42,13,29,26,11,15,4,1,3,+7,+2,+5,73%,69%,75%,171,124,203,24%,27%,23%,13,5,8,6,3,3
344,https://vlr.gg/player/8549/kingg,2024-06-30 20:20:00,0.98,1.68,1.40,233,165,277,34,9,25,21,11,10,17,5,12,+1,+1,0,83%,69%,92%,161,115,191,33%,35%,33%,4,2,2,3,1,2
345,https://vlr.gg/player/7603/mazino,2024-06-30 20:20:00,1.27,1.14,1.19,235,229,235,34,13,21,24,9,15,18,9,9,+1,+1,0,78%,81%,75%,154,150,157,22%,26%,19%,1,1,0,0,0,0
346,https://vlr.gg/player/1818/tex,2024-06-30 20:20:00,1.13,0.98,1.04,190,200,184,29,12,17,26,11,15,13,6,7,-1,-1,0,73%,69%,75%,124,123,124,36%,39%,33%,2,1,1,3,2,1
347,https://vlr.gg/player/619/c0m,2024-06-30 20:20:00,0.70,1.01,0.88,122,106,132,16,5,11,23,11,12,25,13,12,+2,+1,+1,73%,63%,79%,73,62,80,9%,13%,7%,5,1,4,3,0,3
348,https://vlr.gg/player/796/eeiu,2024-06-30 20:20:00,0.93,1.15,1.02,183,184,172,26,14,12,26,18,8,19,11,8,0,-1,+1,80%,75%,88%,115,120,108,31%,33%,26%,1,0,1,1,1,0
349,https://vlr.gg/player/601/asuna,2024-06-30 20:20:00,0.83,1.25,0.99,217,189,265,27,13,14,33,21,12,17,11,6,+2,+2,0,78%,79%,75%,144,121,180,15%,18%,12%,6,4,2,4,2,2
350,https://vlr.gg/player/604/boostio,2024-06-30 20:20:00,0.55,1.48,0.92,186,134,282,27,12,15,32,22,10,10,3,7,-1,-1,0,55%,50%,63%,134,95,192,32%,32%,31%,3,2,1,4,3,1
351,https://vlr.gg/player/3880/bang,2024-06-30 20:20:00,0.88,0.40,0.69,151,188,81,20,16,4,31,21,10,11,7,4,-6,-3,-3,63%,67%,56%,94,124,49,42%,55%,18%,3,2,1,9,5,4
352,https://vlr.gg/player/4147/cryocells,2024-06-30 20:20:00,0.66,0.62,0.64,153,166,143,20,12,8,33,21,12,11,8,3,-5,-3,-2,58%,54%,63%,108,118,94,33%,38%,26%,2,1,1,7,4,3
353,https://vlr.gg/player/6193/cauanzin,2024-06-30 17:00:00,1.04,1.41,1.24,236,193,276,54,20,34,43,21,22,21,11,10,+2,-1,+3,83%,87%,81%,148,127,166,33%,32%,33%,9,3,6,7,4,3
354,https://vlr.gg/player/8447/less,2024-06-30 17:00:00,1.03,1.33,1.19,231,218,244,56,25,31,42,20,22,15,6,9,+4,-1,+5,77%,73%,81%,146,137,154,35%,38%,33%,7,2,5,3,3,0
355,https://vlr.gg/player/2408/tuyz,2024-06-30 17:00:00,1.01,1.09,1.05,209,197,212,52,23,29,42,20,22,9,3,6,-3,-2,-1,70%,70%,69%,132,127,137,26%,38%,18%,5,1,4,8,3,5
356,https://vlr.gg/player/683/pancada,2024-06-30 17:00:00,1.13,0.80,0.95,164,185,145,40,21,19,39,17,22,20,9,11,-2,-1,-1,71%,70%,72%,118,132,105,31%,28%,33%,2,1,1,4,2,2
357,https://vlr.gg/player/727/saadhak,2024-06-30 17:00:00,0.74,0.74,0.73,195,205,182,39,19,20,53,25,28,28,13,15,+1,+1,0,71%,70%,72%,128,130,126,16%,16%,15%,11,6,5,10,5,5
358,https://vlr.gg/player/2567/liazzi,2024-06-30 17:00:00,0.92,1.33,1.10,199,166,241,47,21,26,44,25,19,22,12,10,-2,-3,+1,76%,75%,77%,131,108,159,33%,33%,32%,2,0,2,4,3,1
359,https://vlr.gg/player/8872/mazin,2024-06-30 17:00:00,1.11,0.91,1.02,157,169,140,36,21,15,39,22,17,18,11,7,0,0,0,65%,69%,60%,105,113,96,28%,22%,37%,1,0,1,1,0,1
360,https://vlr.gg/player/5957/artzin,2024-06-30 17:00:00,1.12,0.85,1.00,206,227,189,47,29,18,48,25,23,16,6,10,-3,-4,+1,61%,56%,67%,143,154,130,24%,25%,23%,7,1,6,10,5,5
361,https://vlr.gg/player/11105/rich,2024-06-30 17:00:00,0.77,1.01,0.88,190,178,207,44,22,22,51,29,22,9,6,3,0,-2,+2,68%,67%,70%,134,127,142,26%,32%,21%,5,2,3,5,4,1
362,https://vlr.gg/player/15681/palla,2024-06-30 17:00:00,0.69,0.78,0.73,203,193,221,45,23,22,59,32,27,9,6,3,+3,+3,0,61%,58%,63%,138,130,149,25%,24%,26%,17,12,5,14,9,5
363,https://vlr.gg/player/252/d3ffo,2024-06-30 15:00:00,0.97,1.28,1.13,261,260,268,33,16,17,29,16,13,7,3,4,+6,+6,0,73%,74%,71%,161,160,162,28%,22%,35%,9,6,3,3,0,3
364,https://vlr.gg/player/6889/neskaas,2024-06-30 15:00:00,0.95,0.91,0.93,197,187,208,28,12,16,30,14,16,3,2,1,+2,+2,0,55%,47%,62%,129,136,123,27%,28%,26%,6,3,3,4,1,3
365,https://vlr.gg/player/8805/sacake,2024-06-30 15:00:00,0.66,0.98,0.83,169,146,184,22,9,13,29,16,13,5,2,3,+1,+1,0,60%,53%,67%,113,94,130,20%,16%,23%,1,1,0,0,0,0
366,https://vlr.gg/player/2653/jesse,2024-06-30 15:00:00,0.97,0.68,0.82,165,200,136,24,14,10,30,15,15,3,2,1,-1,0,-1,60%,63%,57%,102,122,85,36%,39%,32%,4,2,2,5,2,3
367,https://vlr.gg/player/314/ambi,2024-06-30 15:00:00,0.17,0.61,0.41,95,68,119,10,3,7,30,16,14,19,11,8,-6,-4,-2,58%,53%,62%,63,43,81,13%,13%,13%,1,0,1,7,4,3
368,https://vlr.gg/player/1475/kamyk,2024-06-30 15:00:00,1.18,1.50,1.33,221,203,245,32,15,17,23,12,11,18,5,13,0,+2,-2,73%,76%,68%,155,152,157,25%,24%,27%,4,2,2,4,0,4
369,https://vlr.gg/player/5893/robbiebk,2024-06-30 15:00:00,1.03,1.66,1.33,211,158,269,34,14,20,20,12,8,10,5,5,-1,-1,0,73%,67%,79%,159,132,190,42%,58%,32%,3,2,1,4,3,1
370,https://vlr.gg/player/4308/magik,2024-06-30 15:00:00,1.53,1.10,1.32,232,242,220,35,21,14,23,12,11,13,6,7,+4,+3,+1,75%,81%,68%,163,172,153,32%,37%,27%,5,3,2,1,0,1
371,https://vlr.gg/player/2700/jas,2024-06-30 15:00:00,0.86,1.09,0.97,203,206,203,28,14,14,28,16,12,4,2,2,-1,+1,-2,60%,57%,63%,142,142,141,33%,31%,35%,7,5,2,8,4,4
372,https://vlr.gg/player/1284/mikee,2024-06-30 15:00:00,0.87,0.98,0.92,148,121,174,19,7,12,23,11,12,10,5,5,-4,-2,-2,70%,67%,74%,100,89,112,17%,12%,22%,0,0,0,4,2,2
373,https://vlr.gg/player/4973/otom,2024-06-30 14:15:00,1.53,1.27,1.42,328,366,278,25,17,8,15,8,7,5,3,2,+4,+2,+2,76%,83%,67%,201,215,183,28%,27%,29%,7,4,3,3,2,1
374,https://vlr.gg/player/11122/byron,2024-06-30 14:15:00,1.34,1.10,1.24,207,227,181,15,9,6,12,6,6,12,6,6,0,-1,+1,76%,67%,89%,145,160,125,19%,17%,22%,1,0,1,1,1,0
375,https://vlr.gg/player/33627/dok,2024-06-30 14:15:00,1.09,1.38,1.21,177,163,196,14,7,7,12,7,5,8,7,1,-5,-3,-2,86%,83%,89%,115,95,143,21%,26%,17%,0,0,0,5,3,2
376,https://vlr.gg/player/11013/balli,2024-06-30 14:15:00,1.60,0.44,1.10,171,246,72,13,11,2,12,6,6,6,4,2,+1,+1,0,95%,100%,89%,129,183,56,31%,29%,50%,1,1,0,0,0,0
377,https://vlr.gg/player/10375/braso,2024-06-30 14:15:00,0.83,1.20,0.99,230,181,297,17,8,9,17,8,9,3,1,2,-1,-1,0,71%,67%,78%,143,100,199,38%,35%,39%,1,0,1,2,1,1
378,https://vlr.gg/player/32345/snaptor,2024-06-30 14:15:00,0.99,0.87,0.92,236,226,245,16,7,9,17,6,11,2,1,1,-1,-3,+2,76%,78%,75%,162,176,151,23%,26%,21%,4,0,4,5,3,2
379,https://vlr.gg/player/46682/eya,2024-06-30 14:15:00,1.25,0.62,0.89,238,298,193,16,9,7,19,7,12,3,2,1,+2,+2,0,62%,78%,50%,160,189,138,38%,43%,33%,3,2,1,1,0,1
380,https://vlr.gg/player/29634/cintyx,2024-06-30 14:15:00,0.82,0.86,0.84,174,145,196,13,5,8,14,5,9,1,0,1,-1,+1,-2,57%,67%,50%,145,115,167,34%,30%,38%,1,1,0,2,0,2
381,https://vlr.gg/player/46681/brio,2024-06-30 14:15:00,0.80,0.77,0.78,164,183,150,12,5,7,18,7,11,4,2,2,+1,0,+1,57%,56%,58%,120,125,116,26%,20%,33%,2,1,1,1,1,0
382,https://vlr.gg/player/46683/esc,2024-06-30 14:15:00,0.71,0.54,0.61,145,190,112,11,7,4,16,7,9,2,1,1,0,-1,+1,62%,78%,50%,96,111,85,21%,15%,29%,1,0,1,1,1,0
383,https://vlr.gg/player/10125/qw1,2024-06-30 14:00:00,1.81,1.57,1.69,333,356,310,41,20,21,19,10,9,8,4,4,+6,+1,+5,82%,81%,82%,211,224,198,23%,25%,22%,9,4,5,3,3,0
384,https://vlr.gg/player/5568/sociablee,2024-06-30 14:00:00,2.13,0.91,1.50,275,358,199,35,24,11,21,8,13,17,4,13,+2,0,+2,88%,94%,82%,185,231,143,24%,29%,17%,3,1,2,1,1,0
385,https://vlr.gg/player/568/turko,2024-06-30 14:00:00,0.92,1.37,1.15,219,159,277,27,10,17,19,9,10,4,2,2,+3,+1,+2,79%,88%,71%,140,118,162,30%,37%,26%,5,2,3,2,1,1
386,https://vlr.gg/player/18677/ruxic,2024-06-30 14:00:00,0.67,1.33,1.01,161,148,175,21,8,13,18,11,7,18,11,7,+1,-1,+2,85%,81%,88%,102,86,117,31%,28%,33%,3,1,2,2,2,0
387,https://vlr.gg/player/12651/w0zzip,2024-06-30 14:00:00,0.54,1.27,0.92,156,81,223,18,4,14,19,10,9,11,8,3,-1,+1,-2,70%,69%,71%,109,70,146,24%,17%,28%,2,1,1,3,0,3
388,https://vlr.gg/player/5563/cacan,2024-06-30 14:00:00,1.27,1.13,1.20,276,245,313,31,16,15,28,14,14,5,2,3,-2,-4,+2,61%,71%,50%,175,150,202,49%,52%,47%,5,1,4,7,5,2
389,https://vlr.gg/player/12226/sturnn,2024-06-30 14:00:00,0.78,0.62,0.70,170,198,139,18,11,7,29,16,13,8,4,4,-5,-3,-2,64%,59%,69%,108,116,100,40%,39%,43%,0,0,0,5,3,2
390,https://vlr.gg/player/19776/jrayn,2024-06-30 14:00:00,0.73,0.56,0.65,152,197,103,16,10,6,27,15,12,5,4,1,0,0,0,64%,71%,56%,105,133,74,30%,30%,31%,1,0,1,1,0,1
391,https://vlr.gg/player/5564/deadink,2024-06-30 14:00:00,0.39,0.81,0.57,161,114,213,17,5,12,31,16,15,5,4,1,-4,-2,-2,55%,41%,69%,117,85,152,30%,26%,33%,3,2,1,7,4,3
392,https://vlr.gg/player/31307/yigox,2024-06-30 14:00:00,0.39,0.65,0.51,116,96,139,14,6,8,27,15,12,3,2,1,0,0,0,61%,53%,69%,75,64,87,32%,24%,40%,2,1,1,2,1,1
393,https://vlr.gg/player/8593/grmekista,2024-06-30 13:15:00,1.01,1.21,1.12,238,201,256,53,20,33,46,20,26,12,8,4,+1,0,+1,76%,73%,78%,151,136,163,27%,23%,32%,4,1,3,3,1,2
394,https://vlr.gg/player/34684/westside,2024-06-30 13:15:00,1.35,0.73,1.01,228,256,202,53,29,24,50,20,30,6,1,5,-3,0,-3,70%,77%,64%,156,175,140,50%,53%,48%,6,4,2,9,4,5
395,https://vlr.gg/player/24424/pa1ze,2024-06-30 13:15:00,1.06,0.74,0.89,208,253,185,47,28,19,52,24,28,11,3,8,-1,+2,-3,67%,70%,64%,136,149,125,21%,17%,25%,12,8,4,13,6,7
396,https://vlr.gg/player/5490/xitsha,2024-06-30 13:15:00,0.94,0.78,0.85,163,172,164,43,21,22,47,20,27,13,7,6,+2,+2,0,71%,77%,67%,112,106,117,29%,43%,21%,5,3,2,3,1,2
397,https://vlr.gg/player/3839/prti,2024-06-30 13:15:00,0.47,0.78,0.64,149,137,162,30,12,18,53,25,28,29,18,11,-3,-2,-1,70%,73%,67%,103,91,113,27%,18%,38%,4,0,4,7,2,5
398,https://vlr.gg/player/29575/luckymrj,2024-06-30 13:15:00,1.47,1.22,1.36,245,250,240,59,34,25,39,18,21,20,10,10,+7,+5,+2,89%,94%,83%,155,161,149,19%,17%,22%,12,8,4,5,3,2
399,https://vlr.gg/player/4537/tajrex,2024-06-30 13:15:00,1.42,1.24,1.34,259,269,232,60,36,24,41,22,19,16,8,8,+4,+4,0,77%,78%,77%,181,190,170,28%,32%,23%,10,6,4,6,2,4
400,https://vlr.gg/player/21216/f4ngeer,2024-06-30 13:15:00,1.14,1.11,1.12,226,220,229,51,27,24,45,23,22,16,11,5,-6,-2,-4,76%,72%,80%,153,156,149,23%,25%,20%,5,3,2,11,5,6
401,https://vlr.gg/player/21609/danda,2024-06-30 13:15:00,0.94,0.99,0.96,176,165,194,45,24,21,47,24,23,30,17,13,+1,0,+1,79%,81%,77%,112,106,118,20%,19%,20%,3,1,2,2,1,1
402,https://vlr.gg/player/29742/anxios,2024-06-30 13:15:00,0.63,0.64,0.63,136,140,140,33,18,15,54,29,25,30,18,12,-2,-1,-1,65%,75%,53%,89,87,90,31%,43%,22%,5,3,2,7,4,3
403,https://vlr.gg/player/30901/ianto,2024-06-30 13:00:00,1.69,1.36,1.51,247,287,209,43,22,21,25,11,14,14,7,7,-1,-1,0,78%,76%,80%,157,193,127,27%,31%,24%,4,2,2,5,3,2
404,https://vlr.gg/player/12372/szoren,2024-06-30 13:00:00,1.16,1.16,1.16,238,240,241,37,18,19,35,16,19,32,15,17,+3,+2,+1,76%,86%,68%,151,139,162,26%,25%,26%,6,2,4,3,0,3
405,https://vlr.gg/player/24428/harambe,2024-06-30 13:00:00,1.14,1.05,1.09,226,246,210,40,22,18,35,16,19,8,2,6,0,0,0,70%,71%,68%,146,154,139,18%,15%,22%,5,3,2,5,3,2
406,https://vlr.gg/player/42371/t0ba,2024-06-30 13:00:00,0.75,1.15,0.97,182,164,200,30,12,18,32,15,17,13,7,6,0,-2,+2,72%,62%,80%,134,134,133,27%,30%,24%,3,0,3,3,2,1
407,https://vlr.gg/player/31350/deqadz,2024-06-30 13:00:00,0.87,0.92,0.90,208,179,226,33,14,19,35,14,21,16,6,10,0,0,0,72%,71%,72%,119,99,135,9%,6%,11%,6,3,3,6,3,3
408,https://vlr.gg/player/10403/jaf,2024-06-30 13:00:00,1.17,0.97,1.08,226,251,185,38,23,15,36,19,17,8,6,2,0,-1,+1,78%,76%,81%,139,164,109,35%,34%,37%,4,2,2,4,3,1
409,https://vlr.gg/player/8440/puggy,2024-06-30 13:00:00,0.96,1.15,1.05,214,191,242,33,16,17,34,17,17,15,7,8,0,+1,-1,67%,64%,71%,147,130,169,23%,28%,19%,2,1,1,2,0,2
410,https://vlr.gg/player/1339/ri4d,2024-06-30 13:00:00,1.03,1.02,1.03,206,201,230,32,16,16,35,18,17,24,17,7,-1,-1,0,72%,76%,67%,142,146,138,39%,35%,45%,4,2,2,5,3,2
411,https://vlr.gg/player/3936/sembern,2024-06-30 13:00:00,1.14,0.55,0.87,188,226,146,34,23,11,36,17,19,5,2,3,+1,+2,-1,65%,72%,57%,137,155,115,27%,28%,26%,4,4,0,3,2,1
412,https://vlr.gg/player/9571/demiurge,2024-06-30 13:00:00,0.31,0.77,0.52,178,163,199,25,12,13,42,24,18,12,6,6,-2,-4,+2,65%,60%,71%,122,122,122,17%,20%,11%,8,2,6,10,6,4
413,https://vlr.gg/player/3860/al1en,2024-06-30 13:00:00,1.99,2.52,2.39,393,236,445,26,5,21,3,0,3,6,0,6,+2,0,+2,94%,100%,92%,248,166,276,22%,14%,24%,2,0,2,0,0,0
414,https://vlr.gg/player/2252/anq,2024-06-30 13:00:00,2.07,1.20,1.42,269,403,225,17,6,11,8,2,6,1,0,1,+2,+1,+1,69%,75%,67%,166,233,144,16%,29%,0%,4,1,3,2,0,2
415,https://vlr.gg/player/2431/basya,2024-06-30 13:00:00,0.56,1.47,1.24,220,88,265,11,1,10,8,2,6,5,1,4,+2,0,+2,75%,75%,75%,156,75,184,22%,17%,23%,2,0,2,0,0,0
416,https://vlr.gg/player/29998/drastz,2024-06-30 13:00:00,1.22,1.03,1.08,170,253,143,9,4,5,7,2,5,9,0,9,-1,0,-1,81%,75%,83%,107,153,91,29%,80%,19%,1,1,0,2,1,1
417,https://vlr.gg/player/1347/ivan4ezz,2024-06-30 13:00:00,1.36,0.53,0.74,110,170,90,7,3,4,8,1,7,2,1,1,+1,+1,0,81%,100%,75%,82,110,72,32%,75%,22%,2,1,1,1,0,1
418,https://vlr.gg/player/45142/browse,2024-06-30 13:00:00,1.47,0.28,1.17,234,276,109,14,13,1,13,9,4,1,0,1,-1,-1,0,56%,67%,25%,157,177,98,32%,42%,10%,1,1,0,2,2,0
419,https://vlr.gg/player/45143/francybald,2024-06-30 13:00:00,0.52,1.15,0.68,172,128,306,8,4,4,15,11,4,4,4,0,+1,+1,0,50%,42%,75%,113,85,196,42%,35%,57%,2,1,1,1,0,1
420,https://vlr.gg/player/33661/lupo,2024-06-30 13:00:00,0.48,0.34,0.44,92,94,86,4,3,1,14,10,4,4,4,0,0,0,0,50%,58%,25%,57,57,57,50%,50%,50%,1,1,0,1,1,0
421,https://vlr.gg/player/22188/jimbk,2024-06-30 13:00:00,0.60,0.02,0.41,119,150,26,6,6,0,14,10,4,3,3,0,-6,-4,-2,50%,58%,25%,72,88,26,26%,31%,0%,1,1,0,7,5,2
422,https://vlr.gg/player/9574/ayyzicle,2024-06-30 13:00:00,0.22,0.54,0.30,43,40,53,2,1,1,14,11,3,4,4,0,0,0,0,63%,67%,50%,31,28,40,22%,13%,100%,0,0,0,0,0,0
423,https://vlr.gg/player/1835/elllement,2024-06-30 12:45:00,,,,,,,,,,,,,,,,,,,,,,,,,,,,,,,,,
424,https://vlr.gg/player/2472/benny,2024-06-30 12:45:00,,,,,,,,,,,,,,,,,,,,,,,,,,,,,,,,,
425,https://vlr.gg/player/4329/vince,2024-06-30 12:45:00,,,,,,,,,,,,,,,,,,,,,,,,,,,,,,,,,
426,https://vlr.gg/player/7490/anguist,2024-06-30 12:45:00,,,,,,,,,,,,,,,,,,,,,,,,,,,,,,,,,
427,https://vlr.gg/player/10885/davih,2024-06-30 12:45:00,,,,,,,,,,,,,,,,,,,,,,,,,,,,,,,,,
428,https://vlr.gg/player/448/meddo,2024-06-30 12:45:00,,,,,,,,,,,,,,,,,,,,,,,,,,,,,,,,,
429,https://vlr.gg/player/1153/murii,2024-06-30 12:45:00,,,,,,,,,,,,,,,,,,,,,,,,,,,,,,,,,
430,https://vlr.gg/player/7105/qpert,2024-06-30 12:45:00,,,,,,,,,,,,,,,,,,,,,,,,,,,,,,,,,
431,https://vlr.gg/player/7866/click,2024-06-30 12:45:00,,,,,,,,,,,,,,,,,,,,,,,,,,,,,,,,,
432,https://vlr.gg/player/12593/felix,2024-06-30 12:45:00,,,,,,,,,,,,,,,,,,,,,,,,,,,,,,,,,
433,https://vlr.gg/player/2525/szimpli,2024-06-30 12:00:00,0.81,1.39,1.11,232,167,289,58,21,37,46,24,22,11,6,5,+2,-6,+8,65%,58%,71%,144,98,188,34%,27%,38%,12,1,11,10,7,3
434,https://vlr.gg/player/7104/juseu,2024-06-30 12:00:00,1.03,1.05,1.04,205,188,224,48,22,26,47,24,23,9,0,9,-2,-3,+1,75%,64%,86%,140,118,162,24%,31%,20%,7,4,3,9,7,2
435,https://vlr.gg/player/3579/marctylinho,2024-06-30 12:00:00,1.22,0.77,0.99,183,245,128,44,30,14,43,23,20,21,4,17,-2,0,-2,76%,70%,83%,119,153,86,20%,28%,11%,3,2,1,5,2,3
436,https://vlr.gg/player/6828/pa1ka,2024-06-30 12:00:00,0.87,0.94,0.90,173,166,183,40,18,22,46,24,22,16,6,10,-3,-2,-1,71%,70%,71%,117,113,121,50%,57%,45%,4,3,1,7,5,2
437,https://vlr.gg/player/2841/foxie,2024-06-30 12:00:00,0.52,0.97,0.75,157,123,191,35,13,22,48,27,21,17,5,12,0,-2,+2,65%,58%,71%,102,86,117,29%,39%,23%,5,0,5,5,2,3
438,https://vlr.gg/player/2256/jady,2024-06-30 12:00:00,1.31,1.22,1.27,240,243,237,57,30,27,42,22,20,15,5,10,+7,+1,+6,78%,71%,85%,164,158,171,36%,32%,40%,9,2,7,2,1,1
439,https://vlr.gg/player/4521/unfake,2024-06-30 12:00:00,0.95,1.08,1.02,185,174,193,44,22,22,45,24,21,23,14,9,-1,-1,0,81%,80%,82%,123,108,139,41%,38%,44%,1,0,1,2,1,1
440,https://vlr.gg/player/3563/babax,2024-06-30 12:00:00,0.93,0.98,0.95,164,159,168,40,19,21,41,23,18,20,15,5,0,-1,+1,72%,71%,73%,112,105,119,22%,23%,22%,5,2,3,5,3,2
441,https://vlr.gg/player/12928/veqaj,2024-06-30 12:00:00,0.90,0.97,0.93,172,153,194,38,16,22,45,23,22,26,19,7,-1,-3,+2,75%,77%,73%,124,111,138,16%,13%,19%,6,3,3,7,6,1
442,https://vlr.gg/player/14612/lux9,2024-06-30 12:00:00,0.71,1.16,0.92,217,171,268,51,21,30,52,29,23,10,4,6,0,-4,+4,68%,66%,70%,145,108,183,31%,25%,37%,15,6,9,15,10,5
443,https://vlr.gg/player/4544/filu,2024-06-30 12:00:00,1.77,1.54,1.61,279,388,235,18,7,11,8,3,5,3,0,3,+4,+2,+2,71%,60%,75%,204,279,172,37%,36%,37%,5,3,2,1,1,0
444,https://vlr.gg/player/7162/wackie,2024-06-30 12:00:00,1.17,1.63,1.49,275,171,319,18,3,15,11,3,8,4,3,1,+1,0,+1,88%,80%,92%,173,103,202,46%,57%,43%,2,0,2,1,0,1
445,https://vlr.gg/player/12474/tag,2024-06-30 12:00:00,1.17,1.18,1.18,206,246,191,12,4,8,10,3,7,7,2,5,+3,+1,+2,82%,80%,83%,157,151,159,33%,23%,39%,3,1,2,0,0,0
446,https://vlr.gg/player/8226/waddle,2024-06-30 12:00:00,0.32,1.41,1.09,177,31,238,11,0,11,9,3,6,7,3,4,+1,0,+1,76%,60%,83%,134,21,181,38%,50%,37%,1,0,1,0,0,0
447,https://vlr.gg/player/1944/cayden,2024-06-30 12:00:00,1.67,0.78,1.04,243,321,212,13,6,7,13,4,9,11,4,7,+2,0,+2,82%,100%,75%,148,192,129,26%,29%,25%,3,0,3,1,0,1
448,https://vlr.gg/player/16447/d3mur,2024-06-30 12:00:00,0.66,2.01,1.06,229,155,409,13,6,7,14,10,4,2,2,0,-3,-4,+1,71%,67%,80%,157,107,277,31%,29%,33%,2,1,1,5,5,0
449,https://vlr.gg/player/33358/shinnok,2024-06-30 12:00:00,0.88,0.61,0.80,189,201,164,12,9,3,14,10,4,2,2,0,-2,0,-2,76%,83%,60%,121,136,84,23%,16%,75%,0,0,0,2,0,2
450,https://vlr.gg/player/5854/z3ro,2024-06-30 12:00:00,0.85,0.67,0.80,176,191,143,10,7,3,15,11,4,8,4,4,-3,-3,0,65%,67%,60%,123,145,69,32%,35%,25%,0,0,0,3,3,0
451,https://vlr.gg/player/33501/sword,2024-06-30 12:00:00,0.86,0.18,0.66,136,160,80,10,9,1,14,10,4,1,0,1,-3,-1,-2,71%,67%,80%,94,112,51,24%,27%,18%,0,0,0,3,1,2
452,https://vlr.gg/player/7706/morphiw0w,2024-06-30 12:00:00,0.57,0.55,0.56,121,133,93,6,4,2,15,11,4,11,11,0,0,0,0,76%,92%,40%,87,94,71,29%,17%,80%,1,1,0,1,1,0
453,https://vlr.gg/player/20688/yassien,2024-06-30 12:00:00,0.76,1.32,1.04,233,193,262,54,22,32,55,30,25,18,8,10,-6,-5,-1,80%,68%,91%,156,136,176,25%,24%,26%,7,4,3,13,9,4
454,https://vlr.gg/player/8237/depyro,2024-06-30 12:00:00,0.99,1.01,1.00,204,197,205,45,23,22,52,26,26,34,11,23,0,-2,+2,67%,62%,71%,131,129,133,14%,15%,12%,3,0,3,3,2,1
455,https://vlr.gg/player/14366/shniider,2024-06-30 12:00:00,0.65,1.00,0.83,204,194,232,54,23,31,61,33,28,15,7,8,-1,-2,+1,68%,62%,74%,139,124,153,49%,47%,52%,8,4,4,9,6,3
456,https://vlr.gg/player/5639/shalaby,2024-06-30 12:00:00,0.55,1.09,0.82,167,121,218,42,14,28,51,27,24,13,5,8,0,-1,+1,61%,50%,71%,115,84,145,18%,13%,21%,6,2,4,6,3,3
457,https://vlr.gg/player/5642/chrollo,2024-06-30 12:00:00,0.63,0.53,0.58,121,131,114,27,16,11,54,28,26,19,5,14,-2,0,-2,64%,59%,69%,75,79,72,19%,26%,13%,6,2,4,8,2,6
458,https://vlr.gg/player/3807/winteryrook,2024-06-30 12:00:00,1.21,1.56,1.38,284,271,284,68,33,35,47,27,20,26,8,18,+9,+2,+7,84%,71%,97%,178,168,187,29%,30%,27%,13,6,7,4,4,0
459,https://vlr.gg/player/1470/simond4rk,2024-06-30 12:00:00,1.31,1.23,1.27,295,294,292,68,36,32,50,25,25,19,8,11,+2,-2,+4,74%,69%,79%,192,192,191,16%,15%,17%,10,4,6,8,6,2
460,https://vlr.gg/player/5795/sickrey,2024-06-30 12:00:00,1.06,1.18,1.12,172,167,186,45,20,25,42,24,18,45,31,14,-4,-2,-2,80%,80%,79%,127,117,137,27%,34%,22%,2,0,2,6,2,4
461,https://vlr.gg/player/1897/bgg,2024-06-30 12:00:00,0.93,1.33,1.12,192,201,183,48,24,24,43,28,15,26,10,16,+5,+2,+3,72%,63%,82%,129,139,119,33%,31%,35%,12,6,6,7,4,3
462,https://vlr.gg/player/2432/moner,2024-06-30 12:00:00,0.89,1.18,1.03,170,137,204,44,16,28,40,20,20,15,7,8,-3,-1,-2,78%,80%,76%,119,105,133,20%,20%,20%,2,1,1,5,2,3
463,https://vlr.gg/player/20032/treelover,2024-06-30 11:00:00,1.11,1.06,1.09,188,197,186,31,16,15,29,15,14,11,8,3,-7,-4,-3,74%,83%,64%,126,132,119,30%,28%,31%,1,0,1,8,4,4
464,https://vlr.gg/player/2189/qxv,2024-06-30 11:00:00,1.24,0.93,1.09,228,244,208,35,21,14,34,15,19,15,5,10,0,-1,+1,78%,79%,77%,153,161,145,39%,37%,41%,4,2,2,4,3,1
465,https://vlr.gg/player/4543/nyczu,2024-06-30 11:00:00,1.04,0.86,0.95,168,184,154,27,17,10,29,14,15,6,1,5,-1,-1,0,72%,71%,73%,124,133,115,26%,30%,21%,2,2,0,3,3,0
466,https://vlr.gg/player/3746/hitch,2024-06-30 11:00:00,0.92,0.82,0.87,177,177,176,26,13,13,35,17,18,29,19,10,-5,0,-5,78%,88%,68%,108,103,114,16%,14%,18%,0,0,0,5,0,5
467,https://vlr.gg/player/22179/shy,2024-06-30 11:00:00,0.73,0.80,0.76,202,198,207,32,17,15,37,18,19,7,3,4,-1,-2,+1,61%,58%,64%,127,120,135,14%,12%,17%,9,4,5,10,6,4
468,https://vlr.gg/player/6925/chadi,2024-06-30 11:00:00,1.61,1.33,1.46,263,299,239,44,23,21,27,11,16,8,5,3,+8,+3,+5,83%,95%,71%,175,187,165,27%,22%,36%,12,6,6,4,3,1
469,https://vlr.gg/player/26404/zneva,2024-06-30 11:00:00,0.90,1.41,1.17,208,165,248,36,14,22,27,13,14,7,2,5,+2,-1,+3,70%,64%,75%,148,117,176,22%,20%,22%,4,1,3,2,2,0
470,https://vlr.gg/player/12673/bard0lf,2024-06-30 11:00:00,1.23,1.07,1.15,236,270,203,37,20,17,32,15,17,17,12,5,+2,+4,-2,76%,82%,71%,155,163,147,32%,29%,36%,7,5,2,5,1,4
471,https://vlr.gg/player/7185/nero,2024-06-30 11:00:00,0.96,0.70,0.82,139,129,147,22,11,11,30,12,18,12,6,6,+1,-1,+2,67%,68%,67%,94,85,102,14%,12%,15%,3,0,3,2,1,1
472,https://vlr.gg/player/3649/litshii,2024-06-30 11:00:00,0.98,0.56,0.76,160,208,112,25,17,8,35,16,19,21,10,11,+1,+1,0,70%,77%,63%,100,133,70,20%,22%,17%,4,2,2,3,1,2
473,https://vlr.gg/player/7987/kovaq,2024-06-30 10:35:00,0.99,0.74,0.84,171,175,164,22,9,13,29,10,19,15,7,8,0,+1,-1,71%,87%,61%,112,113,111,36%,40%,33%,3,1,2,3,0,3
474,https://vlr.gg/player/7968/stavinci,2024-06-30 10:35:00,1.44,0.43,0.83,168,230,140,24,13,11,32,9,23,8,4,4,0,0,0,61%,80%,48%,114,146,93,36%,43%,30%,3,1,2,3,1,2
475,https://vlr.gg/player/20302/jini,2024-06-30 10:35:00,1.13,0.58,0.80,176,252,132,23,14,9,30,13,17,10,6,4,-2,0,-2,61%,73%,52%,115,152,91,27%,41%,20%,2,1,1,4,1,3
476,https://vlr.gg/player/30754/karma,2024-06-30 10:35:00,0.38,0.98,0.74,179,86,219,20,4,16,32,13,19,4,1,3,+1,0,+1,55%,47%,61%,112,70,140,37%,43%,36%,3,0,3,2,0,2
477,https://vlr.gg/player/4630/magnus,2024-06-30 10:35:00,0.43,0.45,0.44,112,136,106,15,7,8,33,13,20,1,1,0,-3,-2,-1,42%,60%,30%,76,83,72,19%,28%,9%,6,4,2,9,6,3
478,https://vlr.gg/player/7660/fizzy,2024-06-30 10:35:00,1.59,1.18,1.43,254,238,266,39,24,15,19,9,10,4,3,1,+3,+1,+2,74%,74%,73%,167,161,177,38%,37%,39%,4,1,3,1,0,1
479,https://vlr.gg/player/2658/xuss,2024-06-30 10:35:00,1.56,1.10,1.38,306,351,242,42,29,13,23,14,9,10,7,3,+5,+4,+1,79%,78%,80%,193,218,155,19%,24%,8%,8,6,2,3,2,1
480,https://vlr.gg/player/1616/starki,2024-06-30 10:35:00,1.54,0.74,1.22,234,270,132,28,21,7,19,9,10,22,10,12,-2,-1,-1,82%,87%,73%,141,174,89,35%,42%,23%,3,3,0,5,4,1
481,https://vlr.gg/player/3674/iluri,2024-06-30 10:35:00,1.18,0.79,1.03,146,141,150,22,13,9,19,9,10,10,5,5,-2,+1,-3,84%,87%,80%,94,84,111,37%,48%,26%,3,2,1,5,1,4
482,https://vlr.gg/player/3753/obnoks,2024-06-30 10:35:00,0.73,1.38,0.99,188,149,255,25,11,14,24,16,8,10,5,5,0,-2,+2,82%,78%,87%,137,108,182,38%,35%,40%,3,1,2,3,3,0
483,https://vlr.gg/player/12774/anima,2024-06-30 10:30:00,1.14,1.25,1.19,205,190,219,49,23,26,44,23,21,26,15,11,-3,-1,-2,75%,76%,74%,139,124,154,22%,22%,22%,2,1,1,5,2,3
484,https://vlr.gg/player/22676/ventt,2024-06-30 10:30:00,1.30,1.04,1.16,233,259,213,57,31,26,47,23,24,26,13,13,-1,-2,+1,74%,85%,63%,150,169,133,27%,27%,26%,5,1,4,6,3,3
485,https://vlr.gg/player/12793/xeus,2024-06-30 10:30:00,0.99,0.73,0.86,224,256,194,53,29,24,56,28,28,8,4,4,+6,+6,0,68%,68%,69%,145,166,124,28%,31%,25%,13,9,4,7,3,4
486,https://vlr.gg/player/12795/crewen,2024-06-30 10:30:00,0.75,0.87,0.81,179,161,199,44,20,24,52,25,27,15,6,9,-1,-6,+5,67%,62%,71%,126,122,130,20%,21%,20%,7,1,6,8,7,1
487,https://vlr.gg/player/16483/gloomy,2024-06-30 10:30:00,0.40,0.86,0.63,141,99,183,31,9,22,54,27,27,24,13,11,-6,-3,-3,64%,62%,66%,97,69,125,23%,21%,24%,5,2,3,11,5,6
488,https://vlr.gg/player/21584/deminatix,2024-06-30 10:30:00,1.26,1.72,1.48,323,278,370,77,33,44,51,26,25,12,8,4,+5,0,+5,65%,54%,76%,199,172,227,24%,26%,22%,18,8,10,13,8,5
489,https://vlr.gg/player/39675/sh1va,2024-06-30 10:30:00,1.40,1.08,1.24,213,230,201,54,30,24,40,20,20,10,3,7,+3,+2,+1,77%,80%,74%,148,156,139,38%,37%,39%,7,5,2,4,3,1
490,https://vlr.gg/player/11516/drky,2024-06-30 10:30:00,1.01,0.87,0.94,159,161,158,40,21,19,45,22,23,28,13,15,-1,-2,+1,75%,71%,79%,104,107,102,30%,26%,35%,1,0,1,2,2,0
491,https://vlr.gg/player/10114/baha,2024-06-30 10:30:00,0.94,0.88,0.91,187,198,176,45,25,20,50,25,25,22,9,13,+2,+2,0,65%,60%,71%,129,134,124,38%,34%,42%,6,2,4,4,0,4
492,https://vlr.gg/player/21865/merz,2024-06-30 10:30:00,0.69,1.00,0.85,164,165,159,37,18,19,49,30,19,33,15,18,-4,-3,-1,71%,71%,71%,102,110,94,18%,19%,17%,5,2,3,9,5,4
493,https://vlr.gg/player/28480/marky,2024-06-30 10:00:00,1.25,1.01,1.13,269,309,222,46,26,20,39,20,19,6,5,1,+3,+2,+1,70%,72%,68%,177,209,146,21%,26%,15%,11,8,3,8,6,2
494,https://vlr.gg/player/31298/luca,2024-06-30 10:00:00,1.12,0.98,1.05,203,197,211,34,18,16,34,15,19,15,7,8,+5,+1,+4,60%,56%,64%,143,150,135,27%,39%,17%,7,2,5,2,1,1
495,https://vlr.gg/player/22310/stike,2024-06-30 10:00:00,0.74,0.90,0.82,163,132,196,29,12,17,37,17,20,9,5,4,-2,0,-2,74%,72%,76%,101,86,115,31%,41%,26%,4,2,2,6,2,4
496,https://vlr.gg/player/5481/melo,2024-06-30 10:00:00,0.80,0.83,0.81,154,163,149,27,14,13,37,20,17,17,7,10,0,+2,-2,64%,72%,56%,107,119,96,25%,30%,20%,2,2,0,2,0,2
497,https://vlr.gg/player/42549/ozzytk,2024-06-30 10:00:00,0.91,0.68,0.79,155,180,130,30,18,12,35,17,18,8,6,2,0,0,0,74%,80%,68%,112,121,103,36%,40%,31%,4,1,3,4,1,3
498,https://vlr.gg/player/33994/creamydreamy,2024-06-30 10:00:00,1.39,1.26,1.33,227,248,207,40,22,18,30,14,16,24,13,11,+3,+1,+2,74%,88%,60%,141,146,137,60%,73%,51%,4,2,2,1,1,0
499,https://vlr.gg/player/12519/ticey,2024-06-30 10:00:00,0.97,1.56,1.26,260,243,278,45,21,24,34,19,15,8,5,3,-2,-3,+1,70%,64%,76%,175,164,186,28%,22%,35%,4,2,2,6,5,1
500,https://vlr.gg/player/2182/hearthbeat,2024-06-30 10:00:00,1.01,0.96,0.98,181,178,186,31,15,16,32,15,17,25,18,7,-2,+1,-3,80%,88%,72%,122,114,130,27%,28%,27%,2,2,0,4,1,3
501,https://vlr.gg/player/29628/famzzam,2024-06-30 10:00:00,1.28,0.62,0.95,196,224,164,34,19,15,35,14,21,10,9,1,0,+1,-1,74%,80%,68%,122,143,101,28%,23%,40%,6,4,2,6,3,3
502,https://vlr.gg/player/16188/tempo,2024-06-30 10:00:00,0.91,0.81,0.86,186,165,208,32,16,16,35,16,19,8,2,6,-5,-1,-4,60%,60%,60%,118,104,132,23%,35%,17%,6,2,4,11,3,8
0,https://vlr.gg/player/6101/999kvmil,2024-06-30 10:00:00,1.52,1.25,1.44,246,251,229,31,22,9,17,12,5,10,7,3,+4,+3,+1,82%,83%,80%,160,161,158,30%,29%,33%,8,6,2,4,3,1
1,https://vlr.gg/player/9557/nefi,2024-06-30 10:00:00,1.35,1.48,1.39,181,197,154,25,18,7,13,11,2,13,13,0,-2,-2,0,76%,75%,80%,142,142,140,40%,44%,32%,0,0,0,2,2,0
2,https://vlr.gg/player/22495/mochi,2024-06-30 10:00:00,1.13,1.37,1.20,276,263,303,34,23,11,25,18,7,7,4,3,+5,+4,+1,76%,67%,100%,174,174,176,36%,33%,42%,7,6,1,2,2,0
3,https://vlr.gg/player/15487/aqua,2024-06-30 10:00:00,1.20,1.07,1.16,191,184,197,25,17,8,18,12,6,14,12,2,0,0,0,74%,71%,80%,113,112,115,27%,29%,25%,0,0,0,0,0,0
4,https://vlr.gg/player/1353/dext,2024-06-30 10:00:00,0.67,1.68,0.97,235,191,343,29,17,12,25,20,5,5,2,3,+5,+1,+4,82%,75%,100%,158,139,205,30%,30%,30%,8,3,5,3,2,1
5,https://vlr.gg/player/2617/leare,2024-06-30 10:00:00,1.18,1.34,1.29,282,262,290,33,10,23,27,9,18,8,0,8,0,-1,+1,68%,60%,71%,175,176,174,38%,52%,33%,5,1,4,5,2,3
6,https://vlr.gg/player/27820/coronel,2024-06-30 10:00:00,0.40,1.47,1.15,229,96,296,26,3,23,28,9,19,7,2,5,0,-1,+1,62%,50%,67%,162,68,201,41%,21%,46%,4,0,4,4,1,3
7,https://vlr.gg/player/33517/tripsy,2024-06-30 10:00:00,0.83,0.46,0.57,138,210,110,14,6,8,29,9,20,9,3,6,-6,-3,-3,56%,50%,58%,113,175,86,22%,21%,23%,0,0,0,6,3,3
8,https://vlr.gg/player/2832/patix,2024-06-30 10:00:00,0.31,0.67,0.54,133,123,149,16,4,12,29,10,19,3,1,2,-4,0,-4,50%,70%,42%,97,68,109,28%,29%,28%,2,1,1,6,1,5
9,https://vlr.gg/player/26789/pdr,2024-06-30 10:00:00,0.37,0.37,0.38,109,115,100,9,2,7,31,10,21,12,5,7,-2,-1,-1,53%,60%,50%,71,80,67,11%,16%,8%,0,0,0,2,1,1
10,https://vlr.gg/player/9508/leosen,2024-06-30 08:00:00,1.12,1.58,1.34,320,311,328,53,23,30,36,23,13,8,6,2,+10,+7,+3,79%,71%,87%,193,195,192,30%,29%,32%,14,9,5,4,2,2
11,https://vlr.gg/player/122/luckerrr,2024-06-30 08:00:00,0.91,1.37,1.13,233,202,266,40,19,21,32,18,14,10,3,7,0,-2,+2,68%,58%,78%,145,128,162,17%,12%,23%,8,4,4,8,6,2
12,https://vlr.gg/player/7865/xanarchy,2024-06-30 08:00:00,1.11,0.91,1.01,170,196,143,28,18,10,28,15,13,31,14,17,-3,+1,-4,77%,88%,65%,107,120,94,27%,28%,25%,2,1,1,5,0,5
13,https://vlr.gg/player/30750/enes,2024-06-30 08:00:00,0.99,0.85,0.92,162,169,153,27,14,13,31,16,15,21,11,10,+1,0,+1,83%,88%,78%,95,106,84,22%,21%,22%,1,0,1,0,0,0
14,https://vlr.gg/player/4969/shazeon,2024-06-30 08:00:00,0.64,1.05,0.84,184,160,210,28,11,17,34,20,14,18,8,10,-5,-2,-3,68%,67%,70%,126,111,142,27%,23%,31%,0,0,0,5,2,3
15,https://vlr.gg/player/27813/zery,2024-06-30 08:00:00,1.00,1.46,1.23,287,252,319,43,18,25,40,22,18,9,2,7,+3,+1,+2,79%,74%,83%,181,159,202,21%,17%,25%,6,3,3,3,2,1
16,https://vlr.gg/player/15382/kongi,2024-06-30 08:00:00,1.03,0.94,0.98,191,201,183,35,19,16,32,16,16,11,3,8,-5,-3,-2,74%,65%,83%,124,127,121,39%,37%,41%,2,0,2,7,3,4
17,https://vlr.gg/player/5586/calvin-s,2024-06-30 08:00:00,0.62,1.23,0.93,177,129,222,30,10,20,35,18,17,12,5,7,-4,-2,-2,68%,52%,83%,113,88,137,21%,32%,16%,2,1,1,6,3,3
18,https://vlr.gg/player/12514/spocki,2024-06-30 08:00:00,0.81,0.92,0.87,175,162,191,29,12,17,35,18,17,14,8,6,+2,+2,0,74%,70%,79%,112,101,122,34%,40%,30%,7,5,2,5,3,2
19,https://vlr.gg/player/7867/rexon,2024-06-30 08:00:00,0.81,0.86,0.84,152,141,164,24,10,14,34,17,17,19,10,9,+1,+3,-2,62%,57%,67%,98,87,109,35%,38%,33%,5,3,2,4,0,4
20,https://vlr.gg/player/3520/zmjjkk,2024-06-30 07:20:00,,,,275,,,37,,,27,,,17,,,+6,,,,,,177,,,27%,,,10,,,4,,
21,https://vlr.gg/player/3017/nobody,2024-06-30 07:20:00,,,,232,,,34,,,23,,,11,,,+3,,,,,,150,,,45%,,,7,,,4,,
22,https://vlr.gg/player/15559/chichoo,2024-06-30 07:20:00,,,,215,,,34,,,24,,,12,,,+4,,,,,,130,,,24%,,,5,,,1,,
23,https://vlr.gg/player/4742/smoggy,2024-06-30 07:20:00,,,,173,,,25,,,23,,,9,,,-1,,,,,,116,,,17%,,,4,,,5,,
24,https://vlr.gg/player/13768/s1mon,2024-06-30 07:20:00,,,,136,,,21,,,24,,,12,,,-1,,,,,,98,,,31%,,,0,,,1,,
25,https://vlr.gg/player/41054/guang,2024-06-30 07:20:00,,,,198,,,27,,,31,,,14,,,+1,,,,,,138,,,28%,,,4,,,3,,
26,https://vlr.gg/player/1209/swerl,2024-06-30 07:20:00,,,,198,,,30,,,32,,,2,,,-3,,,,,,122,,,24%,,,7,,,10,,
27,https://vlr.gg/player/39697/cb,2024-06-30 07:20:00,,,,174,,,24,,,28,,,14,,,-3,,,,,,114,,,28%,,,3,,,6,,
28,https://vlr.gg/player/4402/o0o0o,2024-06-30 07:20:00,,,,151,,,21,,,32,,,10,,,-3,,,,,,92,,,33%,,,1,,,4,,
29,https://vlr.gg/player/46460/ezeir,2024-06-30 07:20:00,,,,141,,,19,,,28,,,5,,,-3,,,,,,94,,,37%,,,1,,,4,,
30,https://vlr.gg/player/9152/deryeon,2024-06-30 07:15:00,1.21,0.85,1.04,238,305,170,57,39,18,51,29,22,6,3,3,+7,+7,0,68%,71%,65%,149,187,106,33%,36%,25%,20,13,7,13,6,7
31,https://vlr.gg/player/772/zest,2024-06-30 07:15:00,1.19,0.83,1.02,185,195,169,41,24,17,44,21,23,32,25,7,-5,-5,0,73%,71%,74%,113,117,109,30%,37%,23%,4,1,3,9,6,3
32,https://vlr.gg/player/4382/sscary,2024-06-30 07:15:00,1.12,0.83,0.98,191,197,182,41,24,17,45,21,24,25,14,11,+1,+2,-1,73%,69%,77%,132,136,127,27%,27%,27%,5,3,2,4,1,3
33,https://vlr.gg/player/2361/retla,2024-06-30 07:15:00,0.88,0.89,0.88,169,172,168,42,22,20,48,26,22,9,5,4,-1,+1,-2,65%,66%,65%,119,122,116,28%,25%,32%,1,1,0,2,0,2
34,https://vlr.gg/player/1430/crazyguy,2024-06-30 07:15:00,0.71,0.91,0.80,154,130,183,34,16,18,48,25,23,15,9,6,-4,-4,0,71%,71%,71%,106,93,122,23%,23%,24%,2,0,2,6,4,2
35,https://vlr.gg/player/9196/t3xture,2024-06-30 07:15:00,1.26,1.35,1.30,278,234,304,63,26,37,47,21,26,14,9,5,+8,-1,+9,76%,77%,74%,167,162,172,28%,24%,34%,18,4,14,10,5,5
36,https://vlr.gg/player/13039/meteor,2024-06-30 07:15:00,1.20,1.04,1.12,206,213,199,49,24,25,42,16,26,16,6,10,-3,-1,-2,77%,77%,77%,142,138,146,30%,27%,34%,1,1,0,4,2,2
37,https://vlr.gg/player/34974/karon,2024-06-30 07:15:00,1.21,1.02,1.11,188,218,168,47,25,22,42,19,23,24,13,11,+3,+5,-2,85%,84%,86%,116,132,103,35%,28%,45%,6,6,0,3,1,2
38,https://vlr.gg/player/773/lakia,2024-06-30 07:15:00,1.07,0.98,1.02,189,193,185,44,22,22,41,18,23,27,8,19,-1,+2,-3,77%,84%,71%,145,148,141,34%,39%,30%,4,4,0,5,2,3
39,https://vlr.gg/player/2489/munchkin,2024-06-30 07:15:00,1.00,0.72,0.85,151,151,153,33,17,16,43,16,27,39,23,16,-5,-2,-3,71%,74%,69%,101,93,109,20%,22%,19%,5,2,3,10,4,6
40,https://vlr.gg/player/4885/whzy,2024-06-30 05:00:00,,,,254,,,44,,,36,,,10,,,0,,,,,,157,,,21%,,,7,,,7,,
41,https://vlr.gg/player/10698/nephh,2024-06-30 05:00:00,,,,219,,,37,,,36,,,25,,,+6,,,,,,125,,,20%,,,8,,,2,,
42,https://vlr.gg/player/6022/yosemite,2024-06-30 05:00:00,,,,200,,,32,,,31,,,10,,,-2,,,,,,137,,,18%,,,3,,,5,,
43,https://vlr.gg/player/4774/knight,2024-06-30 05:00:00,,,,190,,,32,,,29,,,33,,,-4,,,,,,142,,,17%,,,2,,,6,,
44,https://vlr.gg/player/4705/flex1n,2024-06-30 05:00:00,,,,186,,,29,,,32,,,21,,,-2,,,,,,126,,,21%,,,3,,,5,,
45,https://vlr.gg/player/7841/tvirusluke,2024-06-30 05:00:00,,,,254,,,39,,,38,,,13,,,+6,,,,,,156,,,25%,,,13,,,7,,
46,https://vlr.gg/player/3741/vo0kashu,2024-06-30 05:00:00,,,,246,,,44,,,33,,,10,,,+2,,,,,,162,,,34%,,,6,,,4,,
47,https://vlr.gg/player/11524/nicc,2024-06-30 05:00:00,,,,171,,,27,,,35,,,26,,,-2,,,,,,118,,,31%,,,2,,,4,,
48,https://vlr.gg/player/41774/shion7,2024-06-30 05:00:00,,,,169,,,29,,,38,,,5,,,0,,,,,,122,,,36%,,,3,,,3,,
49,https://vlr.gg/player/4880/nizhaotzh,2024-06-30 05:00:00,,,,140,,,25,,,30,,,19,,,-4,,,,,,95,,,35%,,,1,,,5,,
50,https://vlr.gg/player/1743/blazek1ng,2024-06-30 04:00:00,0.83,1.31,1.05,196,167,230,46,20,26,46,26,20,9,3,6,-5,-5,0,71%,69%,73%,126,110,145,34%,29%,39%,1,0,1,6,5,1
51,https://vlr.gg/player/1162/russ,2024-06-30 04:00:00,1.00,1.01,1.00,203,188,219,45,23,22,52,27,25,35,17,18,+5,+3,+2,69%,63%,77%,122,116,128,36%,30%,44%,11,6,5,6,3,3
52,https://vlr.gg/player/9802/benkai,2024-06-30 04:00:00,0.99,0.94,0.97,150,156,146,32,18,14,45,24,21,25,13,12,-4,-1,-3,75%,74%,77%,111,111,112,21%,23%,18%,1,1,0,5,2,3
53,https://vlr.gg/player/1839/polvi,2024-06-30 04:00:00,0.86,1.03,0.94,226,209,249,49,25,24,56,30,26,13,7,6,-3,-2,-1,63%,66%,60%,146,134,160,29%,24%,37%,11,5,6,14,7,7
54,https://vlr.gg/player/3626/lightningfast,2024-06-30 04:00:00,0.93,0.50,0.73,150,162,141,35,21,14,51,24,27,20,11,9,0,-2,+2,60%,66%,53%,91,97,84,32%,28%,39%,5,2,3,5,4,1
55,https://vlr.gg/player/29833/izu,2024-06-30 04:00:00,1.38,1.38,1.38,296,313,283,72,34,38,42,21,21,12,6,6,+1,+1,0,82%,80%,83%,202,211,195,26%,28%,25%,10,5,5,9,4,5
56,https://vlr.gg/player/4545/sayaplayer,2024-06-30 04:00:00,0.99,1.45,1.24,232,201,260,58,25,33,38,19,19,5,1,4,+6,-1,+7,77%,73%,80%,154,127,176,28%,25%,30%,13,5,8,7,6,1
57,https://vlr.gg/player/485/stax,2024-06-30 04:00:00,1.42,1.05,1.22,201,218,186,48,24,24,37,16,21,39,23,16,0,0,0,74%,80%,69%,139,155,126,35%,44%,28%,3,1,2,3,1,2
58,https://vlr.gg/player/31207/carpe,2024-06-30 04:00:00,1.19,0.77,0.96,186,234,145,42,25,17,42,20,22,30,14,16,+5,+2,+3,83%,90%,77%,124,158,96,23%,30%,16%,8,4,4,3,2,1
59,https://vlr.gg/player/10816/xccurate,2024-06-30 04:00:00,0.48,0.78,0.64,141,112,166,30,11,19,48,24,24,25,12,13,-5,-2,-3,71%,70%,71%,101,88,112,22%,19%,23%,2,0,2,7,2,5
60,https://vlr.gg/player/45895/mai,2024-06-29 22:30:00,1.19,0.94,1.06,196,232,170,38,21,17,38,17,21,9,4,5,-2,-1,-1,61%,64%,59%,139,150,130,36%,39%,33%,2,1,1,4,2,2
61,https://vlr.gg/player/45894/xyro,2024-06-29 22:30:00,1.08,0.86,0.96,220,241,210,41,21,20,43,18,25,13,6,7,+1,-2,+3,65%,60%,69%,143,150,137,31%,25%,39%,6,3,3,5,5,0
62,https://vlr.gg/player/45893/eks,2024-06-29 22:30:00,0.75,0.85,0.80,203,187,223,36,16,20,44,20,24,11,6,5,+1,-1,+2,67%,68%,66%,136,127,145,29%,27%,31%,6,1,5,5,2,3
63,https://vlr.gg/player/41927/gold,2024-06-29 22:30:00,0.77,0.59,0.67,116,98,134,22,9,13,40,15,25,14,5,9,-1,-1,0,70%,68%,72%,80,73,86,38%,25%,50%,3,0,3,4,1,3
64,https://vlr.gg/player/42220/sayo,2024-06-29 22:30:00,0.67,0.46,0.56,171,189,159,34,17,17,49,21,28,7,2,5,-9,-2,-7,56%,56%,55%,121,124,118,34%,35%,33%,5,4,1,14,6,8
65,https://vlr.gg/player/45882/starlys,2024-06-29 22:30:00,1.35,1.45,1.40,245,236,233,45,26,19,30,17,13,23,13,10,+5,+4,+1,87%,93%,80%,153,142,164,26%,31%,23%,7,5,2,2,1,1
66,https://vlr.gg/player/45883/jess,2024-06-29 22:30:00,1.67,1.07,1.39,276,320,221,57,36,21,35,18,17,18,11,7,+2,+1,+1,78%,93%,60%,170,198,138,27%,38%,15%,4,2,2,2,1,1
67,https://vlr.gg/player/45887/jaydiebabie,2024-06-29 22:30:00,1.22,1.00,1.12,218,229,207,41,23,18,35,16,19,12,5,7,+4,0,+4,74%,76%,72%,133,139,127,19%,18%,21%,8,3,5,4,3,1
68,https://vlr.gg/player/45884/shiny,2024-06-29 22:30:00,1.28,0.83,1.07,201,229,157,35,21,14,34,17,17,23,17,6,+1,+1,0,78%,79%,76%,142,160,122,40%,41%,38%,4,3,1,3,2,1
69,https://vlr.gg/player/45885/lynx,2024-06-29 22:30:00,0.81,1.08,0.94,191,175,220,35,17,18,37,19,18,12,4,8,-2,-3,+1,81%,76%,88%,130,122,140,16%,15%,16%,9,3,6,11,6,5
70,https://vlr.gg/player/9/tenz,2024-06-29 19:00:00,0.84,1.65,1.24,222,142,305,39,13,26,29,16,13,10,7,3,0,-2,+2,70%,63%,78%,138,100,177,30%,38%,27%,6,0,6,6,2,4
71,https://vlr.gg/player/4004/zekken,2024-06-29 19:00:00,1.70,0.70,1.21,279,376,179,41,28,13,39,18,21,16,9,7,0,+1,-1,74%,79%,70%,190,262,116,22%,26%,15%,8,6,2,8,5,3
72,https://vlr.gg/player/729/zellsis,2024-06-29 19:00:00,1.34,0.88,1.12,150,183,116,25,16,9,23,9,14,22,13,9,0,+1,-1,81%,88%,74%,96,120,72,18%,22%,13%,1,1,0,1,0,1
73,https://vlr.gg/player/659/sacy,2024-06-29 19:00:00,1.03,0.96,1.00,181,177,186,30,16,14,30,14,16,12,5,7,-1,-2,+1,70%,67%,74%,122,124,121,27%,35%,21%,5,2,3,6,4,2
74,https://vlr.gg/player/1265/johnqt,2024-06-29 19:00:00,0.94,0.96,0.95,172,156,189,26,13,13,30,13,17,14,6,8,-2,-4,+2,72%,79%,65%,123,114,131,32%,32%,32%,2,0,2,4,4,0
75,https://vlr.gg/player/2462/keznit,2024-06-29 19:00:00,0.83,1.32,1.08,249,201,296,39,16,23,36,17,19,9,3,6,+8,+5,+3,74%,65%,83%,165,132,197,26%,28%,25%,11,7,4,3,2,1
76,https://vlr.gg/player/1311/melser,2024-06-29 19:00:00,1.04,1.07,1.05,193,209,178,34,17,17,28,14,14,13,8,5,+1,-2,+3,83%,87%,79%,122,133,111,26%,27%,26%,5,1,4,4,3,1
77,https://vlr.gg/player/8673/heat,2024-06-29 19:00:00,1.15,0.93,1.04,205,224,189,35,20,15,32,15,17,13,3,10,-1,-4,+3,81%,78%,83%,134,151,119,36%,41%,31%,3,0,3,4,4,0
78,https://vlr.gg/player/24007/shyy,2024-06-29 19:00:00,0.85,0.51,0.67,135,175,97,23,15,8,31,15,16,10,5,5,-3,-2,-1,60%,61%,58%,96,132,61,25%,30%,19%,2,0,2,5,2,3
79,https://vlr.gg/player/2610/klaus,2024-06-29 19:00:00,0.94,0.39,0.66,127,153,103,20,13,7,34,14,20,11,5,6,-2,0,-2,64%,78%,50%,93,101,84,27%,35%,20%,4,2,2,6,2,4
80,https://vlr.gg/player/826/supamen,2024-06-29 17:00:00,1.49,1.63,1.56,231,231,235,35,17,18,15,10,5,12,3,9,0,-2,+2,89%,82%,94%,159,179,140,48%,51%,45%,3,0,3,3,2,1
81,https://vlr.gg/player/3993/jawgemo,2024-06-29 17:00:00,1.51,1.48,1.49,339,339,336,41,20,21,24,12,12,13,7,6,+7,+2,+5,91%,94%,89%,225,224,226,26%,22%,31%,10,3,7,3,1,2
82,https://vlr.gg/player/5188/apoth,2024-06-29 17:00:00,1.29,1.31,1.30,200,190,213,26,13,13,18,10,8,17,8,9,-3,-5,+2,89%,82%,94%,122,116,128,29%,36%,25%,2,0,2,5,5,0
83,https://vlr.gg/player/1533/derrek,2024-06-29 17:00:00,0.95,1.43,1.20,229,198,258,29,12,17,21,12,9,17,9,8,+4,+2,+2,91%,88%,94%,158,127,187,39%,39%,38%,5,3,2,1,1,0
84,https://vlr.gg/player/4927/nature,2024-06-29 17:00:00,0.96,1.39,1.18,206,194,216,27,12,15,19,12,7,15,5,10,+1,0,+1,86%,82%,89%,134,134,134,40%,38%,42%,2,1,1,1,1,0
85,https://vlr.gg/player/725/nzr,2024-06-29 17:00:00,0.79,1.35,1.06,246,196,300,29,12,17,31,17,14,7,1,6,+1,0,+1,71%,67%,76%,166,129,204,36%,43%,33%,2,1,1,1,1,0
86,https://vlr.gg/player/1711/khalil,2024-06-29 17:00:00,0.84,0.63,0.74,183,206,159,22,13,9,32,17,15,6,0,6,-1,-1,0,63%,50%,76%,119,130,108,21%,22%,19%,1,0,1,2,1,1
87,https://vlr.gg/player/8706/havoc,2024-06-29 17:00:00,0.56,0.79,0.66,157,101,213,19,6,13,30,15,15,5,2,3,-6,-4,-2,51%,44%,59%,102,63,143,39%,31%,43%,2,0,2,8,4,4
88,https://vlr.gg/player/939/mwzera,2024-06-29 17:00:00,0.17,0.98,0.56,153,105,205,17,5,12,33,18,15,9,3,6,0,-3,+3,63%,50%,76%,97,65,131,20%,13%,24%,7,2,5,7,5,2
89,https://vlr.gg/player/681/xand,2024-06-29 17:00:00,0.30,0.36,0.33,95,100,92,10,5,5,32,17,15,11,5,6,-3,-4,+1,63%,56%,71%,66,64,68,35%,44%,26%,1,0,1,4,4,0
90,https://vlr.gg/player/19526/rexxtoned,2024-06-29 15:15:00,1.32,1.74,1.50,318,258,398,23,11,12,16,8,8,4,1,3,+2,-1,+3,76%,75%,78%,227,182,287,40%,39%,41%,5,1,4,3,2,1
91,https://vlr.gg/player/9943/mezoky,2024-06-29 15:15:00,1.59,0.75,1.23,248,294,188,17,12,5,13,7,6,3,1,2,-1,-1,0,71%,75%,67%,161,181,134,28%,34%,21%,0,0,0,1,1,0
92,https://vlr.gg/player/6338/syyse,2024-06-29 15:15:00,1.18,0.53,0.90,163,217,91,13,10,3,14,8,6,4,1,3,+1,+1,0,71%,67%,78%,119,159,66,30%,33%,22%,1,1,0,0,0,0
93,https://vlr.gg/player/22566/pax,2024-06-29 15:15:00,0.48,0.58,0.52,187,207,162,13,9,4,20,12,8,0,0,0,+1,+1,0,62%,67%,56%,131,130,131,31%,60%,17%,6,4,2,5,3,2
94,https://vlr.gg/player/45138/aster,2024-06-29 15:15:00,0.11,0.69,0.36,82,60,113,6,2,4,16,10,6,5,3,2,0,0,0,57%,50%,67%,62,49,79,14%,29%,7%,0,0,0,0,0,0
95,https://vlr.gg/player/7162/wackie,2024-06-29 15:15:00,1.36,1.98,1.72,367,252,454,27,8,19,15,5,10,5,0,5,0,0,0,81%,78%,83%,224,155,276,31%,39%,27%,2,1,1,2,1,1
96,https://vlr.gg/player/1944/cayden,2024-06-29 15:15:00,1.48,1.13,1.28,203,209,199,15,7,8,12,4,8,6,3,3,-1,-1,0,71%,56%,83%,144,151,139,17%,15%,18%,1,0,1,2,1,1
97,https://vlr.gg/player/4544/filu,2024-06-29 15:15:00,0.95,0.81,0.87,189,220,167,15,7,8,16,7,9,1,1,0,-2,-2,0,62%,78%,50%,123,140,111,31%,29%,33%,2,1,1,4,3,1
98,https://vlr.gg/player/8226/waddle,2024-06-29 15:15:00,0.89,0.68,0.77,148,192,117,13,7,6,14,6,8,2,0,2,0,0,0,71%,56%,83%,101,131,78,67%,71%,63%,3,0,3,3,0,3
99,https://vlr.gg/player/12474/tag,2024-06-29 15:15:00,1.00,0.53,0.73,132,168,105,9,5,4,15,6,9,4,1,3,0,0,0,71%,78%,67%,104,123,90,40%,36%,45%,1,1,0,1,1,0
100,https://vlr.gg/player/23347/alannn,2024-06-29 14:30:00,1.62,2.73,1.84,255,247,292,17,13,4,4,4,0,3,2,1,0,0,0,87%,83%,100%,199,190,237,37%,31%,67%,0,0,0,0,0,0
101,https://vlr.gg/player/18400/bipo,2024-06-29 14:30:00,1.75,0.77,1.55,296,322,196,14,13,1,8,5,3,6,4,2,+3,+2,+1,87%,92%,67%,216,228,166,24%,22%,30%,4,3,1,1,1,0
102,https://vlr.gg/player/1493/starkk,2024-06-29 14:30:00,1.30,2.01,1.44,218,202,281,13,10,3,5,4,1,4,3,1,-2,-2,0,93%,92%,100%,137,133,152,38%,37%,43%,0,0,0,2,2,0
103,https://vlr.gg/player/1524/h1ber,2024-06-29 14:30:00,1.10,2.07,1.29,235,178,464,14,8,6,7,5,2,5,5,0,0,-1,+1,87%,83%,100%,146,118,255,15%,20%,0%,2,1,1,2,2,0
104,https://vlr.gg/player/4277/n-a-i-s,2024-06-29 14:30:00,1.37,0.01,1.03,237,288,34,13,13,0,10,7,3,5,3,2,0,+1,-1,80%,83%,67%,143,170,34,22%,26%,0%,2,2,0,2,1,1
105,https://vlr.gg/player/46682/eya,2024-06-29 14:30:00,0.01,1.26,0.96,225,,282,12,0,12,14,3,11,0,0,0,0,-1,+1,53%,33%,58%,135,,169,47%,,47%,2,0,2,2,1,1
106,https://vlr.gg/player/29634/cintyx,2024-06-29 14:30:00,0.58,0.65,0.64,114,107,116,5,1,4,13,3,10,3,1,2,+1,0,+1,47%,67%,42%,85,74,88,38%,0%,43%,1,0,1,0,0,0
107,https://vlr.gg/player/46683/esc,2024-06-29 14:30:00,0.72,0.54,0.58,173,198,167,8,2,6,15,3,12,2,1,1,+1,0,+1,60%,67%,58%,112,133,106,22%,20%,23%,2,0,2,1,0,1
108,https://vlr.gg/player/32345/snaptor,2024-06-29 14:30:00,1.96,0.13,0.49,136,442,60,5,4,1,14,3,11,2,1,1,0,0,0,53%,67%,50%,113,363,50,23%,25%,20%,1,0,1,1,0,1
109,https://vlr.gg/player/46681/brio,2024-06-29 14:30:00,0.07,0.14,0.13,81,83,81,3,1,2,15,3,12,2,0,2,-3,0,-3,33%,33%,33%,66,42,72,29%,100%,20%,1,1,0,4,1,3
110,https://vlr.gg/player/5517/masic,2024-06-29 14:20:00,1.06,1.10,1.08,225,235,224,60,33,27,53,27,26,13,3,10,-2,-5,+3,68%,63%,73%,155,160,151,25%,27%,21%,9,3,6,11,8,3
111,https://vlr.gg/player/10137/ip0tt,2024-06-29 14:20:00,1.39,0.70,1.05,250,293,187,62,41,21,59,28,31,17,7,10,+4,+5,-1,87%,89%,84%,157,181,133,34%,37%,29%,11,8,3,7,3,4
112,https://vlr.gg/player/7353/glovee,2024-06-29 14:20:00,1.13,0.94,1.04,190,199,185,52,29,23,47,23,24,26,15,11,+1,+1,0,73%,82%,65%,126,132,119,27%,36%,20%,5,1,4,4,0,4
113,https://vlr.gg/player/4962/lurzy0y0,2024-06-29 14:20:00,1.00,0.83,0.92,180,181,174,47,23,24,50,25,25,26,22,4,+1,0,+1,75%,84%,65%,118,120,115,33%,25%,43%,5,2,3,4,2,2
114,https://vlr.gg/player/6559/destruct1vee,2024-06-29 14:20:00,0.87,0.91,0.89,173,170,173,46,23,23,50,27,23,13,9,4,-5,-5,0,63%,58%,68%,116,120,113,29%,31%,28%,7,3,4,12,8,4
115,https://vlr.gg/player/31305/lar0k,2024-06-29 14:20:00,1.05,1.16,1.11,193,170,228,50,22,28,48,20,28,30,14,16,-1,0,-1,83%,84%,82%,131,108,154,24%,26%,23%,2,1,1,3,1,2
116,https://vlr.gg/player/24344/loita,2024-06-29 14:20:00,1.14,1.05,1.09,211,211,208,58,27,31,52,22,30,32,15,17,-2,-1,-1,80%,81%,79%,136,139,133,47%,44%,49%,3,2,1,5,3,2
117,https://vlr.gg/player/5565/ros,2024-06-29 14:20:00,1.38,0.66,1.01,191,236,157,49,31,18,55,23,32,33,15,18,+2,+4,-2,73%,78%,68%,129,151,108,30%,36%,24%,11,6,5,9,2,7
118,https://vlr.gg/player/40591/comeback,2024-06-29 14:20:00,0.90,1.06,0.98,221,225,216,58,29,29,56,29,27,11,7,4,0,-5,+5,65%,68%,63%,140,139,140,28%,29%,28%,18,8,10,18,13,5
119,https://vlr.gg/player/31855/celasun,2024-06-29 14:20:00,0.89,0.82,0.85,170,151,193,44,20,24,56,24,32,18,10,8,+2,-1,+3,71%,81%,61%,120,109,131,28%,26%,29%,4,0,4,2,1,1
120,https://vlr.gg/player/23169/minny,2024-06-29 14:15:00,1.92,1.57,1.77,318,354,282,48,30,18,23,12,11,4,1,3,+1,0,+1,82%,77%,88%,230,245,212,38%,36%,42%,4,2,2,3,2,1
121,https://vlr.gg/player/5554/profek,2024-06-29 14:15:00,1.54,1.62,1.57,261,275,236,36,21,15,18,11,7,15,9,6,0,0,0,85%,77%,94%,178,185,169,33%,25%,48%,1,1,0,1,1,0
122,https://vlr.gg/player/1155/buld,2024-06-29 14:15:00,0.92,1.59,1.21,198,149,257,29,12,17,24,14,10,14,8,6,+1,0,+1,85%,73%,100%,147,122,178,26%,24%,28%,2,1,1,1,1,0
123,https://vlr.gg/player/562/zeek,2024-06-29 14:15:00,1.13,0.69,0.94,190,217,146,25,18,7,27,15,12,16,11,5,-5,-3,-2,74%,82%,65%,125,143,103,24%,28%,21%,3,2,1,8,5,3
124,https://vlr.gg/player/25906/alexiiik,2024-06-29 14:15:00,0.56,0.68,0.61,183,165,206,24,12,12,33,20,13,8,6,2,-4,-3,-1,62%,73%,47%,114,105,125,22%,29%,11%,6,2,4,10,5,5
125,https://vlr.gg/player/4525/stix,2024-06-29 14:15:00,0.77,1.22,1.02,186,143,215,27,10,17,28,13,15,7,3,4,0,+1,-1,69%,59%,77%,137,102,164,31%,39%,27%,2,1,1,2,0,2
126,https://vlr.gg/player/9143/darkosek,2024-06-29 14:15:00,1.12,0.77,0.92,208,277,176,32,18,14,34,15,19,2,0,2,+9,+4,+5,64%,71%,59%,139,165,118,38%,41%,35%,12,6,6,3,2,1
127,https://vlr.gg/player/37840/msh,2024-06-29 14:15:00,0.72,0.81,0.77,191,160,207,27,9,18,32,13,19,4,3,1,-3,-3,0,62%,59%,64%,123,106,137,42%,39%,44%,2,0,2,5,3,2
128,https://vlr.gg/player/9556/demek,2024-06-29 14:15:00,0.67,0.69,0.68,176,160,184,22,10,12,34,15,19,11,1,10,-3,-3,0,64%,59%,68%,101,99,103,13%,17%,12%,2,0,2,5,3,2
129,https://vlr.gg/player/5487/adm1k,2024-06-29 14:15:00,0.50,0.56,0.53,159,141,175,17,6,11,35,14,21,16,7,9,+4,+2,+2,74%,82%,68%,114,96,127,26%,27%,25%,5,2,3,1,0,1
130,https://vlr.gg/player/11330/mcd,2024-06-29 14:00:00,0.81,1.28,1.05,178,146,206,43,17,26,38,23,15,12,6,6,-1,-2,+1,71%,63%,79%,126,103,147,33%,37%,31%,3,2,1,4,4,0
131,https://vlr.gg/player/1466/exampl,2024-06-29 14:00:00,1.07,1.01,1.04,167,186,147,41,23,18,39,20,19,24,11,13,0,-2,+2,76%,75%,76%,115,124,106,34%,45%,25%,4,0,4,4,2,2
132,https://vlr.gg/player/28098/linus,2024-06-29 14:00:00,1.15,0.90,1.02,219,232,200,49,26,23,50,26,24,22,14,8,-1,+4,-5,70%,75%,65%,140,151,129,27%,30%,24%,11,7,4,12,3,9
133,https://vlr.gg/player/29951/ziad,2024-06-29 14:00:00,0.82,1.18,1.01,231,197,262,50,21,29,50,26,24,11,5,6,+5,-1,+6,61%,56%,65%,154,133,175,24%,29%,20%,13,5,8,8,6,2
134,https://vlr.gg/player/22180/spmak,2024-06-29 14:00:00,0.76,0.96,0.86,176,173,181,41,18,23,48,25,23,25,11,14,+5,+1,+4,76%,75%,76%,116,107,124,21%,20%,21%,6,2,4,1,1,0
135,https://vlr.gg/player/10338/lime,2024-06-29 14:00:00,0.94,1.52,1.22,240,206,273,55,23,32,42,25,17,21,9,12,0,-2,+2,73%,71%,75%,149,131,167,32%,27%,36%,7,3,4,7,5,2
136,https://vlr.gg/player/5292/al0rante,2024-06-29 14:00:00,1.01,1.05,1.03,189,180,199,46,23,23,45,23,22,13,6,7,0,+1,-1,67%,62%,72%,129,120,139,49%,49%,49%,6,2,4,6,1,5
137,https://vlr.gg/player/217/seider,2024-06-29 14:00:00,0.85,1.16,1.00,194,154,243,44,17,27,44,22,22,19,7,12,-2,-2,0,74%,62%,88%,130,98,165,35%,28%,40%,4,1,3,6,3,3
138,https://vlr.gg/player/4244/yaboilewis,2024-06-29 14:00:00,0.79,1.10,0.93,196,182,218,43,20,23,49,27,22,26,10,16,-2,-3,+1,76%,74%,78%,131,115,148,34%,37%,33%,10,7,3,12,10,2
139,https://vlr.gg/player/8834/bucher,2024-06-29 14:00:00,1.11,0.67,0.89,156,180,125,37,22,15,44,22,22,19,12,7,-4,-2,-2,71%,76%,66%,101,123,78,39%,38%,41%,2,0,2,6,2,4
140,https://vlr.gg/player/3769/killu,2024-06-29 13:45:00,1.41,1.10,1.26,243,253,226,71,38,33,54,28,26,14,8,6,+4,+1,+3,80%,78%,83%,162,165,160,29%,28%,31%,8,1,7,4,0,4
141,https://vlr.gg/player/257/bramz,2024-06-29 13:45:00,0.93,1.17,1.05,244,237,249,69,32,37,60,33,27,16,8,8,+3,0,+3,75%,75%,75%,152,147,157,35%,31%,38%,15,8,7,12,8,4
142,https://vlr.gg/player/9135/oniby,2024-06-29 13:45:00,0.63,1.27,0.95,185,142,229,48,18,30,53,31,22,27,12,15,+1,-3,+4,76%,70%,83%,118,93,142,23%,24%,22%,6,1,5,5,4,1
143,https://vlr.gg/player/7173/soren,2024-06-29 13:45:00,0.57,1.17,0.87,190,154,240,55,20,35,61,37,24,13,5,8,+5,-3,+8,69%,65%,73%,130,100,159,28%,29%,28%,15,6,9,10,9,1
144,https://vlr.gg/player/219/tidus,2024-06-29 13:45:00,0.54,0.96,0.75,147,119,169,39,14,25,56,33,23,29,16,13,+1,+1,0,70%,65%,75%,99,78,120,31%,29%,33%,3,2,1,2,1,1
145,https://vlr.gg/player/1387/apo,2024-06-29 13:45:00,1.13,1.25,1.19,226,215,244,63,30,33,54,30,24,29,10,19,-5,-2,-3,76%,70%,83%,147,127,168,37%,38%,36%,5,2,3,10,4,6
146,https://vlr.gg/player/12579/darklight,2024-06-29 13:45:00,0.97,1.17,1.07,202,189,212,55,24,31,55,31,24,38,15,23,+2,-1,+3,79%,73%,85%,130,128,131,21%,19%,24%,5,2,3,3,3,0
147,https://vlr.gg/player/8217/memset,2024-06-29 13:45:00,0.91,1.11,1.01,178,176,186,53,25,28,55,31,24,15,6,9,-9,-7,-2,69%,60%,78%,122,121,123,31%,32%,29%,2,0,2,11,7,4
148,https://vlr.gg/player/2114/kinguyen,2024-06-29 13:45:00,0.65,1.34,1.00,230,197,262,62,24,38,61,37,24,19,11,8,-4,-4,0,76%,68%,85%,151,134,169,25%,28%,22%,12,6,6,16,10,6
149,https://vlr.gg/player/11322/sevire,2024-06-29 13:45:00,0.70,1.23,0.97,193,151,240,51,19,32,57,31,26,33,11,22,+2,-4,+6,78%,70%,85%,119,92,146,19%,13%,23%,9,1,8,7,5,2
150,https://vlr.gg/player/22188/jimbk,2024-06-29 13:25:00,1.26,1.82,1.52,318,274,367,26,10,16,17,10,7,7,5,2,0,-1,+1,74%,58%,91%,207,193,223,19%,18%,20%,1,0,1,1,1,0
151,https://vlr.gg/player/29559/javelin,2024-06-29 13:25:00,0.93,1.42,1.17,269,238,303,21,10,11,20,12,8,7,3,4,-1,-1,0,74%,67%,82%,163,132,197,12%,19%,9%,3,1,2,4,2,2
152,https://vlr.gg/player/9574/ayyzicle,2024-06-29 13:25:00,1.24,0.73,1.00,154,180,128,14,9,5,14,8,6,5,0,5,-1,+1,-2,83%,83%,82%,111,137,82,29%,42%,13%,1,1,0,2,0,2
153,https://vlr.gg/player/45143/francybald,2024-06-29 13:25:00,0.78,0.64,0.71,187,193,182,15,8,7,17,9,8,7,1,6,-1,-1,0,61%,50%,73%,119,128,109,33%,47%,22%,2,1,1,3,2,1
154,https://vlr.gg/player/33661/lupo,2024-06-29 13:25:00,0.27,0.54,0.40,111,91,135,9,4,5,19,10,9,5,1,4,-4,-4,0,61%,50%,73%,92,85,99,29%,33%,26%,1,0,1,5,4,1
155,https://vlr.gg/player/33627/dok,2024-06-29 13:25:00,1.51,1.39,1.44,215,207,222,20,10,10,15,8,7,15,4,11,+3,+1,+2,74%,64%,83%,127,124,129,39%,47%,33%,3,1,2,0,0,0
156,https://vlr.gg/player/11013/balli,2024-06-29 13:25:00,1.23,1.49,1.37,274,254,293,22,10,12,15,8,7,9,4,5,+1,+1,0,78%,73%,83%,178,166,190,33%,17%,44%,2,1,1,1,0,1
157,https://vlr.gg/player/11122/byron,2024-06-29 13:25:00,1.09,1.12,1.10,203,166,237,18,6,12,15,7,8,9,6,3,+1,-1,+2,91%,100%,83%,127,118,136,30%,26%,32%,2,0,2,1,1,0
158,https://vlr.gg/player/4973/otom,2024-06-29 13:25:00,0.62,0.88,0.76,196,183,210,14,6,8,21,11,10,7,5,2,+2,0,+2,70%,64%,75%,129,131,127,21%,15%,31%,6,3,3,4,3,1
159,https://vlr.gg/player/10375/braso,2024-06-29 13:25:00,0.55,0.79,0.67,176,160,192,13,6,7,19,10,9,4,0,4,0,0,0,61%,55%,67%,135,116,152,25%,33%,21%,2,1,1,2,1,1
160,https://vlr.gg/player/8838/chanformer,2024-06-29 12:25:00,1.06,1.64,1.40,240,177,283,58,19,39,33,13,20,17,5,12,-2,-3,+1,80%,70%,86%,145,106,173,30%,26%,33%,4,1,3,6,4,2
161,https://vlr.gg/player/15491/maximn,2024-06-29 12:25:00,1.56,0.84,1.14,225,284,185,53,29,24,42,15,27,14,8,6,+7,+3,+4,80%,81%,78%,143,174,121,23%,28%,18%,8,3,5,1,0,1
162,https://vlr.gg/player/10270/dev0,2024-06-29 12:25:00,1.08,1.13,1.11,273,292,260,62,28,34,47,20,27,14,2,12,+7,+6,+1,70%,74%,68%,170,174,167,21%,31%,16%,17,10,7,10,4,6
163,https://vlr.gg/player/7972/reqz,2024-06-29 12:25:00,1.05,0.88,0.95,199,216,182,46,21,25,47,18,29,19,10,9,0,0,0,73%,74%,73%,123,136,114,26%,27%,25%,4,1,3,4,1,3
164,https://vlr.gg/player/18384/bully,2024-06-29 12:25:00,0.77,0.96,0.88,174,131,199,37,12,25,42,16,26,29,11,18,+4,-1,+5,73%,70%,76%,113,96,126,20%,25%,18%,7,1,6,3,2,1
165,https://vlr.gg/player/22617/vitie,2024-06-29 12:25:00,1.17,0.71,0.97,195,221,151,40,28,12,49,27,22,35,21,14,0,+3,-3,77%,84%,67%,125,146,97,35%,42%,26%,3,3,0,3,0,3
166,https://vlr.gg/player/28346/stolen,2024-06-29 12:25:00,1.10,0.63,0.90,180,225,124,41,30,11,49,27,22,13,7,6,-4,-4,0,59%,57%,63%,116,138,85,23%,22%,28%,2,0,2,6,4,2
167,https://vlr.gg/player/31300/drog,2024-06-29 12:25:00,0.95,0.83,0.89,191,200,186,47,28,19,53,30,23,11,6,5,-5,-3,-2,64%,62%,67%,122,127,115,34%,36%,31%,3,1,2,8,4,4
168,https://vlr.gg/player/20443/br-di,2024-06-29 12:25:00,0.90,0.79,0.84,153,173,169,38,22,16,52,30,22,22,11,11,-1,0,-1,59%,62%,56%,114,125,99,21%,27%,14%,5,2,3,6,2,4
169,https://vlr.gg/player/12471/kalkkuna,2024-06-29 12:25:00,0.44,1.33,0.82,198,158,263,44,20,24,53,34,19,10,4,6,-6,-7,+1,72%,68%,78%,135,102,180,28%,24%,31%,11,7,4,17,14,3
170,https://vlr.gg/player/2617/leare,2024-06-29 12:20:00,0.93,1.61,1.26,266,220,314,60,26,34,48,27,21,7,4,3,+5,-1,+6,64%,61%,68%,167,135,201,27%,30%,24%,19,8,11,14,9,5
171,https://vlr.gg/player/27820/coronel,2024-06-29 12:20:00,1.27,0.85,1.06,186,206,162,43,25,18,43,21,22,26,15,11,+1,+1,0,73%,73%,74%,119,133,104,34%,29%,41%,2,1,1,1,0,1
172,https://vlr.gg/player/33517/tripsy,2024-06-29 12:20:00,1.08,0.80,0.94,209,222,204,49,27,22,48,23,25,10,5,5,-2,-2,0,67%,67%,68%,144,155,132,31%,27%,36%,2,2,0,4,4,0
173,https://vlr.gg/player/2832/patix,2024-06-29 12:20:00,0.99,0.79,0.89,159,160,162,33,18,15,46,21,25,21,9,12,-1,-2,+1,67%,64%,71%,121,117,125,39%,40%,39%,3,1,2,4,3,1
174,https://vlr.gg/player/26789/pdr,2024-06-29 12:20:00,0.61,0.74,0.68,138,143,140,29,15,14,50,27,23,28,15,13,+1,+1,0,59%,55%,65%,93,94,92,21%,16%,25%,8,3,5,7,2,5
175,https://vlr.gg/player/29340/cunha20,2024-06-29 12:20:00,1.54,0.94,1.23,214,261,170,53,32,21,39,17,22,26,15,11,+1,+1,0,83%,84%,82%,133,160,108,43%,51%,33%,4,2,2,3,1,2
176,https://vlr.gg/player/1378/addicted,2024-06-29 12:20:00,1.13,1.15,1.14,200,171,233,43,18,25,38,17,21,22,10,12,+4,+1,+3,66%,65%,67%,141,127,154,33%,31%,34%,5,2,3,1,1,0
177,https://vlr.gg/player/15376/grtw,2024-06-29 12:20:00,1.09,1.14,1.12,215,202,217,48,25,23,41,20,21,14,6,8,+4,0,+4,78%,77%,79%,145,145,144,22%,20%,25%,6,0,6,2,0,2
178,https://vlr.gg/player/13435/fragger,2024-06-29 12:20:00,1.03,0.85,0.94,218,240,195,46,23,23,52,25,27,31,18,13,-3,+1,-4,73%,84%,64%,146,167,127,32%,31%,32%,6,4,2,9,3,6
179,https://vlr.gg/player/15577/brk,2024-06-29 12:20:00,0.58,1.10,0.84,181,166,198,45,19,26,45,24,21,8,5,3,-10,-10,0,61%,48%,73%,115,102,127,19%,20%,17%,9,4,5,19,14,5
180,https://vlr.gg/player/226/roden,2024-06-29 12:00:00,0.32,1.12,0.89,185,96,217,19,2,17,28,9,19,13,4,9,+2,0,+2,73%,67%,75%,122,65,144,29%,20%,30%,4,1,3,2,1,1
181,https://vlr.gg/player/24439/yohpa,2024-06-29 12:00:00,0.74,0.94,0.89,201,178,207,25,6,19,31,9,22,5,2,3,-4,0,-4,70%,78%,67%,130,129,130,46%,60%,42%,0,0,0,4,0,4
182,https://vlr.gg/player/15969/yuta,2024-06-29 12:00:00,0.90,0.55,0.65,163,198,153,18,7,11,30,8,22,6,0,6,-1,0,-1,52%,56%,50%,114,138,106,48%,44%,50%,1,0,1,2,0,2
183,https://vlr.gg/player/126/nowaxxzang,2024-06-29 12:00:00,0.53,0.49,0.50,132,127,135,15,5,10,31,8,23,6,1,5,0,-1,+1,64%,67%,63%,95,84,99,33%,38%,32%,3,0,3,3,1,2
184,https://vlr.gg/player/253/sp1ke,2024-06-29 12:00:00,0.23,0.40,0.36,137,133,139,15,5,10,31,8,23,5,1,4,-4,-2,-2,45%,44%,46%,86,78,90,22%,20%,23%,5,2,3,9,4,5
185,https://vlr.gg/player/13258/cyvoph,2024-06-29 12:00:00,1.59,2.66,1.86,382,343,502,22,14,8,11,9,2,7,7,0,+5,+2,+3,94%,92%,100%,246,233,285,20%,19%,27%,6,3,3,1,1,0
186,https://vlr.gg/player/2621/goaster,2024-06-29 12:00:00,1.76,1.59,1.71,332,327,346,23,16,7,11,7,4,3,3,0,-2,-2,0,88%,92%,80%,194,186,214,15%,12%,25%,2,1,1,4,3,1
187,https://vlr.gg/player/2098/thebigfiz,2024-06-29 12:00:00,1.50,2.05,1.65,271,246,341,32,21,11,13,9,4,25,16,9,0,0,0,88%,83%,100%,190,169,246,23%,30%,15%,0,0,0,0,0,0
188,https://vlr.gg/player/440/akumaaaaa,2024-06-29 12:00:00,1.34,0.80,1.19,219,242,158,29,24,5,22,15,7,18,13,5,+4,+4,0,85%,79%,100%,146,168,89,48%,51%,36%,7,6,1,3,2,1
189,https://vlr.gg/player/113/hyp,2024-06-29 12:00:00,1.20,1.12,1.18,192,202,170,24,18,6,16,11,5,11,8,3,+2,+1,+1,91%,92%,89%,120,123,111,28%,26%,36%,2,1,1,0,0,0
190,https://vlr.gg/player/13439/soon,2024-06-29 12:00:00,1.00,1.08,1.02,183,198,140,21,16,5,19,16,3,10,8,2,-2,-1,-1,85%,88%,78%,139,152,103,26%,30%,17%,3,3,0,5,4,1
191,https://vlr.gg/player/16447/d3mur,2024-06-29 12:00:00,0.85,1.81,1.33,324,270,379,28,12,16,19,11,8,2,1,1,+2,-1,+3,79%,75%,83%,198,171,226,25%,16%,37%,7,2,5,5,3,2
192,https://vlr.gg/player/5854/z3ro,2024-06-29 12:00:00,1.15,1.09,1.12,190,229,153,16,9,7,15,8,7,10,6,4,-2,-2,0,83%,83%,83%,117,138,96,26%,28%,24%,2,1,1,4,3,1
193,https://vlr.gg/player/33358/shinnok,2024-06-29 12:00:00,1.04,1.02,1.03,170,177,164,14,6,8,13,6,7,6,3,3,-4,-2,-2,71%,67%,75%,131,129,133,28%,29%,26%,0,0,0,4,2,2
194,https://vlr.gg/player/33501/sword,2024-06-29 12:00:00,0.95,0.83,0.89,143,165,123,12,8,4,15,8,7,7,1,6,0,0,0,75%,75%,75%,98,110,86,33%,38%,29%,0,0,0,0,0,0
195,https://vlr.gg/player/7706/morphiw0w,2024-06-29 12:00:00,0.66,0.97,0.82,157,138,178,14,7,7,16,8,8,8,3,5,0,-1,+1,63%,58%,67%,99,93,105,28%,25%,30%,1,0,1,1,1,0
196,https://vlr.gg/player/3860/al1en,2024-06-29 12:00:00,1.23,1.12,1.17,149,214,86,16,10,6,14,8,6,9,6,3,+1,+2,-1,79%,92%,67%,101,115,87,32%,24%,50%,2,2,0,1,0,1
197,https://vlr.gg/player/1347/ivan4ezz,2024-06-29 12:00:00,0.76,1.52,1.14,204,130,279,15,4,11,14,7,7,12,6,6,+1,-2,+3,71%,67%,75%,136,83,189,33%,36%,32%,3,0,3,2,2,0
198,https://vlr.gg/player/2431/basya,2024-06-29 12:00:00,0.91,1.12,1.01,208,151,265,16,6,10,18,8,10,12,6,6,+1,0,+1,83%,75%,92%,140,109,172,25%,47%,18%,2,1,1,1,1,0
199,https://vlr.gg/player/29998/drastz,2024-06-29 12:00:00,0.90,0.81,0.85,223,238,209,18,11,7,21,10,11,7,2,5,0,-2,+2,67%,50%,83%,153,164,142,18%,29%,11%,3,0,3,3,2,1
200,https://vlr.gg/player/2252/anq,2024-06-29 12:00:00,0.59,0.93,0.76,148,152,146,13,6,7,17,9,8,2,1,1,+1,0,+1,58%,58%,58%,99,98,100,42%,50%,33%,4,2,2,3,2,1
201,https://vlr.gg/player/20292/akai,2024-06-29 12:00:00,1.47,1.57,1.52,308,304,296,67,36,31,36,19,17,7,2,5,+2,-1,+3,75%,74%,76%,198,194,203,25%,28%,22%,13,6,7,11,7,4
202,https://vlr.gg/player/5599/khaalid,2024-06-29 12:00:00,1.49,0.91,1.21,228,257,184,47,29,18,38,17,21,28,12,16,-2,+2,-4,73%,81%,66%,140,166,111,45%,49%,39%,5,4,1,7,2,5
203,https://vlr.gg/player/5600/moh,2024-06-29 12:00:00,1.04,1.36,1.20,222,212,237,47,23,24,39,20,19,26,11,15,+1,-2,+3,82%,74%,90%,144,129,160,24%,27%,22%,6,3,3,5,5,0
204,https://vlr.gg/player/1618/spyzera,2024-06-29 12:00:00,0.95,1.19,1.06,159,128,204,33,14,19,36,17,19,35,17,18,+1,+1,0,77%,74%,79%,106,82,132,29%,27%,31%,3,1,2,2,0,2
205,https://vlr.gg/player/6503/sand,2024-06-29 12:00:00,1.06,0.99,1.03,199,184,221,44,21,23,40,19,21,12,7,5,0,-1,+1,68%,68%,69%,133,115,152,29%,34%,26%,4,1,3,4,2,2
206,https://vlr.gg/player/5609/vague,2024-06-29 12:00:00,1.01,0.96,0.98,234,230,246,50,22,28,49,23,26,5,5,0,+1,+3,-2,70%,79%,61%,146,151,141,34%,40%,28%,8,6,2,7,3,4
207,https://vlr.gg/player/5615/chek,2024-06-29 12:00:00,0.87,1.07,0.97,216,200,226,45,22,23,45,23,22,5,2,3,+2,-1,+3,68%,76%,61%,134,120,147,27%,27%,27%,6,0,6,4,1,3
208,https://vlr.gg/player/5614/xelouz,2024-06-29 12:00:00,0.94,0.49,0.71,157,208,114,33,21,12,48,23,25,15,9,6,-2,-1,-1,62%,66%,58%,103,129,80,31%,36%,23%,7,4,3,9,5,4
209,https://vlr.gg/player/5612/near,2024-06-29 12:00:00,0.80,0.60,0.69,148,170,135,30,16,14,49,23,26,18,13,5,-4,-3,-1,65%,69%,61%,100,119,83,24%,22%,27%,2,0,2,6,3,3
210,https://vlr.gg/player/16885/snipkw,2024-06-29 12:00:00,0.66,0.69,0.68,152,158,152,31,16,15,47,23,24,23,14,9,+1,-1,+2,60%,76%,45%,103,101,105,22%,17%,27%,6,3,3,5,4,1
211,https://vlr.gg/player/4894/jn3v1ce,2024-06-29 11:10:00,0.97,0.94,0.95,185,216,175,37,20,17,48,22,26,24,8,16,-2,-3,+1,72%,70%,74%,126,136,118,28%,27%,28%,1,0,1,3,3,0
212,https://vlr.gg/player/3604/mojj,2024-06-29 11:10:00,0.78,1.06,0.93,189,171,224,42,16,26,45,21,24,10,3,7,-2,-1,-1,67%,59%,74%,140,119,156,35%,36%,34%,5,2,3,7,3,4
213,https://vlr.gg/player/18657/wasp,2024-06-29 11:10:00,0.83,0.93,0.89,189,172,209,41,16,25,48,21,27,11,4,7,+3,0,+3,54%,59%,50%,132,119,142,42%,38%,45%,9,4,5,6,4,2
214,https://vlr.gg/player/1401/sasuke,2024-06-29 11:10:00,0.75,0.91,0.84,154,127,171,30,11,19,44,19,25,23,7,16,-2,-4,+2,67%,63%,71%,102,88,113,26%,32%,22%,4,0,4,6,4,2
215,https://vlr.gg/player/15735/krostaly,2024-06-29 11:10:00,0.70,0.90,0.81,165,149,182,36,13,23,45,21,24,12,5,7,0,+3,-3,64%,63%,65%,102,96,107,41%,44%,38%,10,5,5,10,2,8
216,https://vlr.gg/player/5500/docent,2024-06-29 11:10:00,1.55,1.17,1.38,282,311,240,60,37,23,39,22,17,27,12,15,-1,-1,0,79%,74%,85%,166,187,140,29%,36%,21%,7,4,3,8,5,3
217,https://vlr.gg/player/20144/lewn,2024-06-29 11:10:00,1.07,1.33,1.18,285,271,298,59,31,28,47,28,19,9,6,3,+7,+1,+6,72%,68%,78%,190,183,198,41%,41%,40%,18,9,9,11,8,3
218,https://vlr.gg/player/10152/padisah,2024-06-29 11:10:00,1.07,1.11,1.09,195,171,209,45,23,22,34,19,15,4,3,1,-1,0,-1,72%,74%,70%,137,128,148,32%,29%,36%,2,1,1,3,1,2
219,https://vlr.gg/player/3549/touven,2024-06-29 11:10:00,0.97,1.23,1.08,205,194,209,42,23,19,37,22,15,25,12,13,-1,-2,+1,82%,76%,89%,136,133,140,23%,15%,34%,4,2,2,5,4,1
220,https://vlr.gg/player/10163/cyderx,2024-06-29 11:10:00,0.75,1.10,0.90,110,96,130,24,12,12,29,19,10,18,12,6,-1,0,-1,77%,71%,85%,79,63,100,37%,27%,47%,1,0,1,2,0,2
221,https://vlr.gg/player/40004/globex,2024-06-29 11:00:00,0.82,1.43,1.13,221,194,252,49,19,30,44,28,16,16,6,10,+3,+1,+2,67%,61%,74%,145,129,161,15%,17%,14%,12,6,6,9,5,4
222,https://vlr.gg/player/28948/ninja,2024-06-29 11:00:00,0.82,1.26,1.04,191,167,215,49,20,29,45,28,17,13,7,6,+3,0,+3,75%,61%,88%,116,95,136,31%,31%,31%,8,3,5,5,3,2
223,https://vlr.gg/player/164/bzt,2024-06-29 11:00:00,0.67,1.19,0.93,177,141,212,43,15,28,48,26,22,18,8,10,-2,-2,0,64%,58%,71%,123,106,139,30%,31%,29%,1,1,0,3,3,0
224,https://vlr.gg/player/18162/serial,2024-06-29 11:00:00,0.71,0.96,0.84,186,178,199,46,22,24,50,27,23,14,4,10,-5,-5,0,64%,55%,74%,121,113,130,51%,58%,46%,5,1,4,10,6,4
225,https://vlr.gg/player/38424/zachkappa,2024-06-29 11:00:00,0.74,0.87,0.81,162,167,157,39,19,20,45,27,18,4,2,2,0,+1,-1,64%,67%,62%,115,114,115,30%,34%,27%,7,3,4,7,2,5
226,https://vlr.gg/player/1374/alive,2024-06-29 11:00:00,0.73,1.57,1.14,223,179,270,51,19,32,43,28,15,20,8,12,+6,+2,+4,73%,62%,85%,145,119,172,20%,18%,23%,12,4,8,6,2,4
227,https://vlr.gg/player/4325/musashi,2024-06-29 11:00:00,1.02,1.25,1.14,213,203,229,51,24,27,44,25,19,18,5,13,+4,0,+4,76%,71%,82%,136,125,147,27%,26%,28%,11,5,6,7,5,2
228,https://vlr.gg/player/8808/pyrolll,2024-06-29 11:00:00,1.00,1.11,1.05,184,180,186,42,20,22,41,24,17,18,8,10,-4,-1,-3,67%,59%,76%,123,125,121,31%,29%,33%,3,2,1,7,3,4
229,https://vlr.gg/player/321/chiwa,2024-06-29 11:00:00,0.79,1.29,1.04,203,164,245,48,19,29,44,26,18,10,4,6,+2,-1,+3,72%,56%,88%,139,114,165,28%,33%,24%,6,3,3,4,4,0
230,https://vlr.gg/player/32351/cullumx,2024-06-29 11:00:00,0.50,0.99,0.74,173,134,213,39,14,25,54,28,26,23,5,18,-7,-4,-3,66%,53%,79%,108,88,129,36%,35%,37%,2,1,1,9,5,4
231,https://vlr.gg/player/6038/b3astm0d3,2024-06-29 11:00:00,1.25,1.24,1.24,240,237,250,61,27,34,41,18,23,12,5,7,-6,-2,-4,70%,75%,67%,166,166,165,37%,46%,32%,1,1,0,7,3,4
232,https://vlr.gg/player/1167/luzuh,2024-06-29 11:00:00,1.28,1.00,1.12,250,321,192,57,32,25,50,23,27,13,7,6,+8,+5,+3,80%,82%,78%,160,196,131,32%,33%,30%,18,10,8,10,5,5
233,https://vlr.gg/player/3934/eleo,2024-06-29 11:00:00,1.24,0.72,0.95,169,208,141,36,21,15,44,16,28,19,7,12,0,+1,-1,72%,79%,67%,117,137,102,33%,33%,34%,5,2,3,5,1,4
234,https://vlr.gg/player/8672/louitan,2024-06-29 11:00:00,0.64,1.16,0.93,188,120,222,40,11,29,45,20,25,29,12,17,+7,+3,+4,75%,75%,75%,110,77,135,27%,17%,33%,8,3,5,1,0,1
235,https://vlr.gg/player/15178/canefis,2024-06-29 11:00:00,0.97,0.81,0.88,176,170,176,43,20,23,45,17,28,9,3,6,-3,-1,-2,67%,71%,64%,121,116,125,34%,29%,40%,3,1,2,6,2,4
236,https://vlr.gg/player/2540/happen,2024-06-29 11:00:00,1.38,0.84,1.14,217,240,190,50,31,19,42,20,22,18,10,8,+7,+6,+1,78%,83%,71%,150,158,139,30%,22%,50%,7,6,1,0,0,0
237,https://vlr.gg/player/22433/quantumrino,2024-06-29 11:00:00,1.10,1.02,1.06,250,263,226,56,33,23,51,28,23,13,7,6,-3,+1,-4,73%,78%,68%,163,171,152,28%,26%,31%,6,4,2,9,3,6
238,https://vlr.gg/player/13238/shiio,2024-06-29 11:00:00,0.96,0.84,0.91,167,166,177,41,25,16,43,23,20,13,5,8,-10,-6,-4,67%,61%,75%,111,111,112,28%,32%,24%,0,0,0,10,6,4
239,https://vlr.gg/player/10359/daveeski,2024-06-29 11:00:00,0.64,1.14,0.86,203,176,266,44,20,24,53,30,23,15,9,6,+1,0,+1,66%,67%,64%,140,114,173,29%,29%,29%,14,7,7,13,7,6
240,https://vlr.gg/player/27954/movi,2024-06-29 11:00:00,0.86,0.62,0.75,142,162,120,34,22,12,48,25,23,23,14,9,-1,-1,0,75%,83%,64%,97,110,81,28%,28%,28%,2,1,1,3,2,1
241,https://vlr.gg/player/2571/feeqn,2024-06-29 10:00:00,1.15,1.05,1.10,215,228,204,35,17,18,35,17,18,7,2,5,+1,+1,0,73%,57%,87%,144,149,140,31%,27%,35%,2,2,0,1,1,0
242,https://vlr.gg/player/23174/snowi,2024-06-29 10:00:00,0.53,1.39,0.98,173,97,244,27,6,21,33,18,15,21,11,10,+2,0,+2,75%,62%,87%,116,74,155,23%,19%,25%,2,0,2,0,0,0
243,https://vlr.gg/player/1620/ale,2024-06-29 10:00:00,0.44,1.35,0.91,220,128,299,28,7,21,37,19,18,16,6,10,-2,-7,+5,70%,52%,87%,140,84,191,18%,15%,19%,10,2,8,12,9,3
244,https://vlr.gg/player/23220/jesmu,2024-06-29 10:00:00,0.76,0.90,0.83,172,168,178,27,14,13,35,17,18,13,4,9,-1,+1,-2,70%,62%,78%,115,111,119,17%,12%,22%,3,2,1,4,1,3
245,https://vlr.gg/player/1365/nixoon,2024-06-29 10:00:00,0.73,0.73,0.73,143,148,138,21,10,11,36,19,17,15,6,9,-2,0,-2,55%,57%,52%,95,110,81,20%,28%,13%,4,2,2,6,2,4
246,https://vlr.gg/player/1507/avova,2024-06-29 10:00:00,1.01,1.57,1.28,224,199,246,38,18,20,24,16,8,20,9,11,0,-2,+2,75%,61%,90%,141,123,160,36%,30%,43%,4,1,3,4,3,1
247,https://vlr.gg/player/129/hype,2024-06-29 10:00:00,1.15,1.22,1.18,234,226,237,34,17,17,25,14,11,13,7,6,+3,+1,+2,80%,74%,86%,155,148,163,20%,26%,16%,6,3,3,3,2,1
248,https://vlr.gg/player/9554/kaajak,2024-06-29 10:00:00,0.82,1.56,1.17,265,206,334,45,18,27,30,19,11,5,3,2,+5,+2,+3,75%,70%,81%,164,142,189,40%,36%,43%,10,4,6,5,2,3
249,https://vlr.gg/player/101/soulcas,2024-06-29 10:00:00,0.82,1.20,1.00,198,181,216,32,15,17,28,18,10,11,6,5,-4,-3,-1,61%,52%,71%,134,124,146,42%,52%,35%,0,0,0,4,3,1
250,https://vlr.gg/player/1281/molsi,2024-06-29 10:00:00,1.01,0.89,0.95,188,219,151,26,17,9,31,18,13,24,9,15,-2,-1,-1,80%,74%,86%,129,149,108,29%,33%,25%,3,2,1,5,3,2
251,https://vlr.gg/player/26808/fainz,2024-06-29 09:00:00,1.05,1.59,1.30,319,279,350,69,33,36,43,25,18,10,5,5,+8,-1,+9,74%,69%,79%,198,163,237,32%,29%,36%,18,8,10,10,9,1
252,https://vlr.gg/player/8590/killdream,2024-06-29 09:00:00,1.23,1.13,1.19,251,258,247,56,30,26,41,21,20,20,11,9,+8,+8,0,87%,91%,83%,154,151,157,25%,23%,28%,13,8,5,5,0,5
253,https://vlr.gg/player/7883/silenttt,2024-06-29 09:00:00,0.68,1.43,1.04,185,129,248,43,15,28,36,21,15,11,8,3,0,0,0,75%,69%,83%,120,85,159,31%,29%,32%,3,2,1,3,2,1
254,https://vlr.gg/player/1377/phatt,2024-06-29 09:00:00,1.00,0.91,0.96,146,167,133,34,19,15,33,19,14,24,14,10,-2,0,-2,85%,84%,86%,99,108,89,40%,45%,32%,1,0,1,3,0,3
255,https://vlr.gg/player/16012/akira,2024-06-29 09:00:00,1.01,0.87,0.94,170,189,134,33,21,12,39,21,18,31,12,19,+3,+1,+2,75%,69%,83%,112,132,89,24%,24%,24%,4,2,2,1,1,0
256,https://vlr.gg/player/1353/dext,2024-06-29 09:00:00,1.13,1.00,1.07,220,237,217,51,25,26,48,23,25,9,5,4,-4,-2,-2,66%,69%,63%,137,144,131,30%,30%,30%,6,3,3,10,5,5
257,https://vlr.gg/player/22495/mochi,2024-06-29 09:00:00,0.81,1.05,0.94,187,161,212,42,16,26,46,23,23,9,5,4,-3,-2,-1,66%,59%,72%,120,107,133,40%,44%,37%,3,1,2,6,3,3
258,https://vlr.gg/player/9557/nefi,2024-06-29 09:00:00,0.79,0.94,0.87,172,150,201,39,16,23,43,21,22,13,7,6,-5,-2,-3,69%,66%,72%,120,105,134,33%,32%,33%,4,0,4,9,2,7
259,https://vlr.gg/player/15487/aqua,2024-06-29 09:00:00,0.63,0.84,0.74,172,162,185,34,15,19,52,26,26,18,9,9,-6,-3,-3,67%,69%,66%,118,109,126,33%,46%,26%,4,2,2,10,5,5
260,https://vlr.gg/player/6101/999kvmil,2024-06-29 09:00:00,0.54,0.81,0.68,141,153,142,26,13,13,46,24,22,9,3,6,+1,0,+1,57%,48%,66%,104,102,106,20%,23%,16%,5,4,1,4,4,0
261,https://vlr.gg/player/14431/monk,2024-06-29 08:30:00,,,,215,,,53,,,45,,,29,,,+7,,,,,,134,,,33%,,,9,,,2,,
262,https://vlr.gg/player/4881/spitfires,2024-06-29 08:30:00,,,,203,,,48,,,46,,,7,,,+5,,,,,,123,,,21%,,,16,,,11,,
263,https://vlr.gg/player/3049/sword9,2024-06-29 08:30:00,,,,192,,,42,,,42,,,23,,,0,,,,,,124,,,20%,,,5,,,5,,
264,https://vlr.gg/player/25949/bunt,2024-06-29 08:30:00,,,,190,,,45,,,45,,,21,,,+2,,,,,,124,,,26%,,,5,,,3,,
265,https://vlr.gg/player/10821/delb,2024-06-29 08:30:00,,,,190,,,45,,,42,,,15,,,-1,,,,,,133,,,31%,,,4,,,5,,
266,https://vlr.gg/player/37489/lysoar,2024-06-29 08:30:00,,,,209,,,46,,,48,,,25,,,0,,,,,,138,,,23%,,,2,,,2,,
267,https://vlr.gg/player/7857/berlin,2024-06-29 08:30:00,,,,208,,,47,,,45,,,28,,,-2,,,,,,147,,,31%,,,5,,,7,,
268,https://vlr.gg/player/3028/life,2024-06-29 08:30:00,,,,203,,,46,,,48,,,16,,,-14,,,,,,123,,,36%,,,6,,,20,,
269,https://vlr.gg/player/19530/aaaay,2024-06-29 08:30:00,,,,202,,,46,,,43,,,27,,,-1,,,,,,142,,,36%,,,3,,,4,,
270,https://vlr.gg/player/872/autumn,2024-06-29 08:30:00,,,,157,,,35,,,49,,,19,,,+4,,,,,,106,,,32%,,,10,,,6,,
271,https://vlr.gg/player/10160/izzy,2024-06-29 08:00:00,1.21,1.11,1.17,253,273,229,47,29,18,49,26,23,33,15,18,+9,+5,+4,84%,82%,86%,175,180,170,26%,27%,25%,17,9,8,8,4,4
272,https://vlr.gg/player/5510/oxmann,2024-06-29 08:00:00,1.21,1.10,1.16,221,228,207,55,32,23,42,20,22,16,6,10,-1,-1,0,71%,74%,69%,133,139,127,37%,39%,35%,6,3,3,7,4,3
273,https://vlr.gg/player/3557/skylen,2024-06-29 08:00:00,1.07,1.21,1.13,216,181,260,48,20,28,44,19,25,26,14,12,+5,+3,+2,79%,85%,72%,135,115,158,27%,32%,23%,8,5,3,3,2,1
274,https://vlr.gg/player/1399/sterben,2024-06-29 08:00:00,1.03,0.90,0.97,189,194,185,39,21,18,45,22,23,35,22,13,-6,-3,-3,79%,79%,79%,127,125,129,23%,29%,19%,0,0,0,6,3,3
275,https://vlr.gg/player/556/souhcni,2024-06-29 08:00:00,1.12,0.79,0.97,177,182,170,38,23,15,41,19,22,26,12,14,-2,-2,0,81%,79%,83%,116,116,117,27%,32%,23%,3,1,2,5,3,2
276,https://vlr.gg/player/4893/lauress,2024-06-29 08:00:00,1.32,1.10,1.20,213,224,207,52,27,25,36,16,20,10,5,5,+2,0,+2,78%,79%,76%,137,145,131,25%,22%,29%,5,1,4,3,1,2
277,https://vlr.gg/player/2107/russ,2024-06-29 08:00:00,1.06,1.20,1.14,234,242,228,54,25,29,45,21,24,13,10,3,+5,+4,+1,75%,83%,68%,160,158,161,32%,28%,37%,10,4,6,5,0,5
278,https://vlr.gg/player/11531/patrui,2024-06-29 08:00:00,1.10,0.77,0.92,170,209,144,38,20,18,43,18,25,27,18,9,-3,+1,-4,79%,86%,74%,113,133,96,28%,21%,37%,2,1,1,5,0,5
279,https://vlr.gg/player/18615/batujnax,2024-06-29 08:00:00,0.83,0.79,0.81,195,223,178,40,22,18,53,25,28,22,11,11,-3,-5,+2,71%,72%,71%,131,135,128,21%,26%,17%,11,6,5,14,11,3
280,https://vlr.gg/player/5566/jeyj7y,2024-06-29 08:00:00,0.90,0.68,0.78,179,213,152,37,21,16,50,22,28,16,7,9,-6,-3,-3,68%,79%,59%,121,130,113,26%,19%,37%,1,1,0,7,4,3
281,https://vlr.gg/player/424/dep,2024-06-29 06:10:00,1.06,1.20,1.13,238,225,257,35,17,18,31,15,16,6,3,3,+4,+3,+1,70%,78%,62%,152,139,165,28%,26%,29%,13,9,4,9,6,3
282,https://vlr.gg/player/6668/sugarz3ro,2024-06-29 06:10:00,1.30,0.65,0.99,189,224,148,31,21,10,34,15,19,14,6,8,0,+1,-1,73%,83%,62%,128,151,104,37%,41%,32%,1,1,0,1,0,1
283,https://vlr.gg/player/999/laz,2024-06-29 06:10:00,0.92,1.03,0.97,198,168,233,30,13,17,32,15,17,18,14,4,-3,-1,-2,75%,83%,67%,125,111,141,43%,41%,45%,0,0,0,3,1,2
284,https://vlr.gg/player/10588/hiroronn,2024-06-29 06:10:00,1.11,0.74,0.93,168,175,162,25,15,10,28,12,16,8,4,4,-2,-1,-1,75%,83%,67%,107,116,97,35%,38%,32%,4,1,3,6,2,4
285,https://vlr.gg/player/29840/yuran,2024-06-29 06:10:00,1.05,0.33,0.71,119,160,71,16,12,4,30,13,17,20,12,8,-1,+1,-2,70%,83%,57%,86,112,57,27%,44%,12%,3,2,1,4,1,3
286,https://vlr.gg/player/4871/xffero,2024-06-29 06:10:00,1.46,1.27,1.36,272,297,251,42,23,19,28,13,15,18,8,10,+2,+2,0,82%,86%,78%,178,178,178,27%,20%,35%,6,3,3,4,1,3
287,https://vlr.gg/player/24895/jemkin,2024-06-29 06:10:00,1.16,1.11,1.14,229,265,198,37,21,16,28,15,13,3,2,1,0,-1,+1,75%,71%,78%,141,161,123,29%,27%,32%,5,3,2,5,4,1
288,https://vlr.gg/player/8497/monyet,2024-06-29 06:10:00,1.22,0.91,1.06,198,226,174,28,16,12,29,13,16,15,6,9,+1,+3,-2,73%,76%,70%,137,156,119,30%,38%,23%,5,4,1,4,1,3
289,https://vlr.gg/player/25025/estrella,2024-06-29 06:10:00,1.10,0.85,0.97,143,169,116,23,12,11,23,10,13,19,12,7,-1,0,-1,82%,81%,83%,97,101,93,42%,42%,41%,2,1,1,3,1,2
290,https://vlr.gg/player/7764/lmemore,2024-06-29 06:10:00,1.10,0.55,0.81,165,140,185,25,13,12,30,9,21,7,4,3,0,+1,-1,68%,86%,52%,108,95,120,25%,40%,17%,5,2,3,5,1,4
291,https://vlr.gg/player/488/rb,2024-06-29 05:00:00,,,,232,,,53,,,55,,,9,,,-7,,,,,,157,,,22%,,,5,,,12,,
292,https://vlr.gg/player/14445/ac,2024-06-29 05:00:00,,,,232,,,54,,,49,,,35,,,+5,,,,,,149,,,30%,,,7,,,2,,
293,https://vlr.gg/player/30526/b1ack,2024-06-29 05:00:00,,,,189,,,42,,,48,,,32,,,0,,,,,,119,,,22%,,,5,,,5,,
294,https://vlr.gg/player/5011/abo,2024-06-29 05:00:00,,,,186,,,47,,,52,,,11,,,-6,,,,,,130,,,34%,,,7,,,13,,
295,https://vlr.gg/player/25339/lockm,2024-06-29 05:00:00,,,,185,,,41,,,47,,,25,,,+1,,,,,,124,,,27%,,,6,,,5,,
296,https://vlr.gg/player/3547/ninebody,2024-06-29 05:00:00,,,,296,,,68,,,47,,,17,,,+6,,,,,,188,,,22%,,,23,,,17,,
297,https://vlr.gg/player/39485/scales,2024-06-29 05:00:00,,,,220,,,53,,,45,,,37,,,+3,,,,,,141,,,25%,,,5,,,2,,
298,https://vlr.gg/player/7135/hfmi0dzjc9z7,2024-06-29 05:00:00,,,,182,,,42,,,48,,,21,,,-4,,,,,,137,,,24%,,,1,,,5,,
299,https://vlr.gg/player/3020/coldfish,2024-06-29 05:00:00,,,,177,,,42,,,46,,,25,,,+5,,,,,,118,,,21%,,,7,,,2,,
300,https://vlr.gg/player/14444/eren,2024-06-29 05:00:00,,,,176,,,46,,,51,,,10,,,-3,,,,,,125,,,33%,,,1,,,4,,
301,https://vlr.gg/player/3980/governor,2024-06-29 04:00:00,1.11,1.48,1.27,319,280,360,48,24,24,35,19,16,12,4,8,+9,+6,+3,84%,79%,89%,177,159,199,16%,15%,17%,15,8,7,6,2,4
302,https://vlr.gg/player/13788/jitboys,2024-06-29 04:00:00,1.42,0.85,1.17,234,321,121,34,26,8,26,17,9,15,9,6,+2,+3,-1,77%,83%,68%,145,201,73,40%,43%,32%,5,4,1,3,1,2
303,https://vlr.gg/player/23062/surf,2024-06-29 04:00:00,0.65,1.75,1.13,182,99,283,31,10,21,23,15,8,11,3,8,-1,-3,+2,74%,58%,95%,113,61,180,60%,50%,66%,2,0,2,3,3,0
304,https://vlr.gg/player/3977/crws,2024-06-29 04:00:00,0.95,1.21,1.06,175,168,193,27,14,13,24,15,9,13,6,7,0,-1,+1,70%,58%,84%,123,109,139,19%,12%,27%,1,0,1,1,1,0
305,https://vlr.gg/player/5129/ban,2024-06-29 04:00:00,0.71,1.17,0.92,168,160,179,27,15,12,27,16,11,10,2,8,-1,-1,0,65%,54%,79%,112,103,124,37%,35%,40%,3,2,1,4,3,1
306,https://vlr.gg/player/21438/ssees,2024-06-29 04:00:00,0.97,1.19,1.09,211,202,224,33,14,19,32,15,17,15,5,10,-3,-2,-1,67%,63%,71%,132,126,137,45%,42%,48%,2,1,1,5,3,2
307,https://vlr.gg/player/6672/meiy,2024-06-29 04:00:00,0.58,1.30,0.98,229,170,281,37,11,26,37,18,19,7,4,3,-2,-2,0,70%,68%,71%,136,111,155,18%,16%,19%,8,2,6,10,4,6
308,https://vlr.gg/player/1970/neth,2024-06-29 04:00:00,0.53,1.02,0.80,148,103,187,20,5,15,32,15,17,23,11,12,-1,-1,0,77%,79%,75%,105,68,135,27%,23%,29%,2,1,1,3,2,1
309,https://vlr.gg/player/993/medusa,2024-06-29 04:00:00,0.76,0.75,0.76,158,165,151,22,10,12,32,14,18,8,3,5,-2,-1,-1,67%,63%,71%,112,120,106,29%,37%,23%,2,1,1,4,2,2
310,https://vlr.gg/player/6700/anthem,2024-06-29 04:00:00,0.78,0.67,0.72,151,176,127,23,13,10,34,16,18,13,4,9,-1,+1,-2,74%,74%,75%,85,89,81,14%,12%,17%,3,2,1,4,1,3
311,https://vlr.gg/player/41957/tiff,2024-06-28 22:15:00,1.40,1.80,1.57,252,202,317,33,16,17,16,8,8,10,6,4,+1,+1,0,77%,80%,73%,155,133,183,29%,28%,29%,3,2,1,2,1,1
312,https://vlr.gg/player/41958/silv,2024-06-28 22:15:00,1.68,0.85,1.32,213,272,119,27,20,7,19,10,9,14,12,2,-1,0,-1,74%,85%,60%,137,176,85,31%,29%,36%,3,2,1,4,2,2
313,https://vlr.gg/player/41881/yumi,2024-06-28 22:15:00,1.22,1.25,1.23,214,218,233,28,17,11,21,10,11,17,6,11,0,+1,-1,77%,80%,73%,141,136,147,26%,26%,26%,4,3,1,4,2,2
314,https://vlr.gg/player/26122/soko,2024-06-28 22:15:00,1.28,1.06,1.19,249,263,235,33,20,13,24,13,11,8,5,3,+1,0,+1,77%,80%,73%,156,171,135,34%,36%,32%,6,3,3,5,3,2
315,https://vlr.gg/player/41926/blue,2024-06-28 22:15:00,1.19,0.93,1.08,157,162,125,20,12,8,16,7,9,5,2,3,+2,+2,0,80%,85%,73%,99,98,99,35%,39%,29%,3,2,1,1,0,1
316,https://vlr.gg/player/41904/reach,2024-06-28 22:15:00,1.05,0.90,0.96,213,247,194,25,12,13,28,12,16,5,3,2,+4,+2,+2,66%,73%,60%,137,156,124,22%,16%,33%,9,4,5,5,2,3
317,https://vlr.gg/player/44644/jinx,2024-06-28 22:15:00,0.86,0.88,0.86,181,180,184,22,9,13,25,10,15,10,5,5,+2,0,+2,69%,67%,70%,117,130,108,11%,7%,15%,2,0,2,0,0,0
318,https://vlr.gg/player/41903/lielahh,2024-06-28 22:15:00,1.02,0.55,0.75,182,214,170,22,12,10,30,11,19,16,10,6,-6,0,-6,66%,80%,55%,116,116,117,28%,41%,21%,3,2,1,9,2,7
319,https://vlr.gg/player/45888/me1ody,2024-06-28 22:15:00,0.55,0.56,0.56,143,141,144,16,7,9,28,11,17,7,4,3,-2,-1,-1,57%,73%,45%,91,93,89,10%,10%,11%,1,1,0,3,2,1
320,https://vlr.gg/player/46546/lily,2024-06-28 22:15:00,0.58,0.20,0.37,97,137,67,11,8,3,30,12,18,2,0,2,-1,0,-1,51%,67%,40%,70,90,55,17%,22%,13%,1,1,0,2,1,1
321,https://vlr.gg/player/32533/alannah,2024-06-28 20:00:00,2.15,1.19,1.65,295,338,254,34,20,14,15,4,11,12,7,5,0,+1,-1,85%,100%,71%,201,235,169,35%,31%,42%,4,2,2,4,1,3
322,https://vlr.gg/player/31579/emi,2024-06-28 20:00:00,1.23,1.64,1.44,263,245,282,32,15,17,18,9,9,20,13,7,+4,0,+4,88%,94%,82%,168,160,176,16%,17%,15%,4,0,4,0,0,0
323,https://vlr.gg/player/26102/bethany,2024-06-28 20:00:00,1.79,0.86,1.31,260,380,152,29,22,7,21,10,11,12,6,6,+3,+3,0,79%,94%,65%,171,244,101,24%,22%,30%,5,4,1,2,1,1
324,https://vlr.gg/player/26100/rosa,2024-06-28 20:00:00,1.10,1.21,1.15,222,181,256,27,12,15,20,9,11,6,2,4,-1,-2,+1,76%,81%,71%,147,124,169,14%,24%,8%,4,1,3,5,3,2
325,https://vlr.gg/player/36897/ferret,2024-06-28 20:00:00,0.51,1.18,0.86,161,131,189,21,8,13,20,10,10,11,5,6,+1,0,+1,70%,63%,76%,101,61,138,23%,9%,32%,3,2,1,2,2,0
326,https://vlr.gg/player/43122/zensan1ty,2024-06-28 20:00:00,1.06,0.82,0.94,201,213,190,22,12,10,28,13,15,8,6,2,-2,+1,-3,61%,59%,63%,126,133,118,32%,26%,38%,3,2,1,5,1,4
327,https://vlr.gg/player/26101/nila,2024-06-28 20:00:00,0.93,0.87,0.90,200,181,221,23,11,12,27,12,15,3,1,2,-2,-1,-1,58%,59%,56%,131,113,150,22%,16%,29%,3,1,2,5,2,3
328,https://vlr.gg/player/41932/molly,2024-06-28 20:00:00,0.96,0.77,0.87,188,191,186,20,11,9,28,14,14,3,3,0,0,0,0,58%,65%,50%,130,122,138,17%,10%,27%,0,0,0,0,0,0
329,https://vlr.gg/player/41931/pink,2024-06-28 20:00:00,0.57,0.52,0.55,159,164,155,15,9,6,30,14,16,10,5,5,-2,-3,+1,52%,53%,50%,117,108,126,18%,16%,21%,2,1,1,4,4,0
330,https://vlr.gg/player/41933/evalin,2024-06-28 20:00:00,0.47,0.25,0.36,123,123,124,13,8,5,30,14,16,5,3,2,-1,-2,+1,52%,59%,44%,78,78,78,24%,25%,24%,5,2,3,6,4,2
331,https://vlr.gg/player/8056/mited,2024-06-28 19:00:00,1.07,1.02,1.04,173,176,174,72,37,35,67,34,33,38,20,18,+7,+3,+4,71%,66%,77%,117,113,122,27%,28%,26%,12,5,7,5,2,3
332,https://vlr.gg/player/3983/virtyy,2024-06-28 19:00:00,1.02,1.06,1.04,265,266,266,99,51,48,98,50,48,24,7,17,+6,-2,+8,74%,69%,79%,171,169,174,23%,26%,21%,30,16,14,24,18,6
333,https://vlr.gg/player/10557/darker,2024-06-28 19:00:00,0.97,1.04,1.00,203,213,199,79,43,36,87,47,40,49,19,30,-5,-1,-4,70%,71%,70%,137,144,131,29%,31%,26%,1,1,0,6,2,4
334,https://vlr.gg/player/7616/feniz,2024-06-28 19:00:00,0.87,1.03,0.95,182,172,191,75,36,39,82,44,38,23,10,13,+6,0,+6,70%,67%,73%,121,115,127,29%,30%,28%,11,4,7,5,4,1
335,https://vlr.gg/player/17690/jow,2024-06-28 19:00:00,0.75,0.96,0.85,164,143,183,64,28,36,82,44,38,36,22,14,+4,0,+4,73%,69%,77%,110,101,120,38%,40%,36%,12,3,9,8,3,5
336,https://vlr.gg/player/1294/nagz,2024-06-28 19:00:00,1.10,1.36,1.23,234,210,258,95,42,53,76,38,38,27,9,18,-2,-4,+2,75%,71%,78%,158,141,175,24%,31%,19%,9,3,6,11,7,4
337,https://vlr.gg/player/2468/delz1k,2024-06-28 19:00:00,1.42,0.88,1.14,212,265,164,86,53,33,75,36,39,49,18,31,-1,-2,+1,76%,80%,72%,132,171,94,23%,26%,20%,7,1,6,8,3,5
338,https://vlr.gg/player/2464/suther,2024-06-28 19:00:00,0.95,1.04,1.00,185,166,200,68,31,37,76,38,38,71,36,35,+5,0,+5,76%,77%,76%,120,105,135,21%,21%,21%,7,2,5,2,2,0
339,https://vlr.gg/player/783/murizzz,2024-06-28 19:00:00,0.82,1.08,0.95,188,156,221,77,32,45,81,39,42,41,16,25,-13,-8,-5,74%,66%,81%,121,101,140,22%,27%,19%,7,2,5,20,10,10
340,https://vlr.gg/player/8892/snw,2024-06-28 19:00:00,0.76,1.12,0.94,217,195,242,90,39,51,82,44,38,16,6,10,-7,-4,-3,71%,71%,71%,142,126,158,23%,31%,18%,18,11,7,25,15,10
341,https://vlr.gg/player/8742/jakee,2024-06-28 18:00:00,0.98,1.50,1.19,206,185,254,46,23,23,40,28,12,35,14,21,-5,-5,0,74%,61%,92%,130,118,148,27%,23%,32%,4,1,3,9,6,3
342,https://vlr.gg/player/739/fiziq,2024-06-28 18:00:00,0.80,1.31,1.01,181,148,227,37,19,18,39,29,10,14,5,9,0,-1,+1,67%,56%,84%,112,86,149,15%,8%,21%,8,3,5,8,4,4
343,https://vlr.gg/player/7716/penny,2024-06-28 18:00:00,0.55,1.56,0.97,209,170,255,46,18,28,44,33,11,9,5,4,-6,-8,+2,69%,53%,92%,137,117,167,29%,31%,27%,6,4,2,12,12,0
344,https://vlr.gg/player/1411/will,2024-06-28 18:00:00,0.58,1.28,0.87,159,115,235,33,13,20,43,29,14,22,12,10,+1,-2,+3,67%,53%,88%,105,77,146,19%,20%,18%,3,0,3,2,2,0
345,https://vlr.gg/player/69/thief,2024-06-28 18:00:00,0.56,1.07,0.77,152,155,145,31,18,13,45,33,12,18,3,15,+3,0,+3,62%,50%,80%,96,107,81,20%,18%,26%,6,2,4,3,2,1
346,https://vlr.gg/player/8082/zander,2024-06-28 18:00:00,0.85,1.40,1.18,236,164,283,53,15,38,41,19,22,21,6,15,+3,-1,+4,75%,64%,83%,142,93,176,25%,21%,26%,8,1,7,5,2,3
347,https://vlr.gg/player/3722/koalanoob,2024-06-28 18:00:00,0.71,1.40,1.12,260,220,284,55,17,38,42,23,19,7,1,6,0,-3,+3,72%,64%,78%,165,137,184,26%,26%,26%,11,3,8,11,6,5
348,https://vlr.gg/player/4828/nismo,2024-06-28 18:00:00,0.63,1.40,1.08,182,85,244,37,7,30,35,18,17,24,8,16,+1,-1,+2,69%,44%,86%,115,56,155,41%,30%,44%,4,1,3,3,2,1
349,https://vlr.gg/player/864/bcj,2024-06-28 18:00:00,0.41,1.38,0.98,176,112,219,37,8,29,37,22,15,17,5,12,+3,0,+3,70%,44%,89%,121,80,149,22%,19%,23%,5,2,3,2,2,0
350,https://vlr.gg/player/6582/net,2024-06-28 18:00:00,0.69,0.94,0.83,144,148,139,29,12,17,38,20,18,10,1,9,0,-4,+4,59%,48%,67%,97,98,96,22%,24%,21%,6,1,5,6,5,1
351,https://vlr.gg/player/818/mummay,2024-06-28 16:00:00,1.77,1.37,1.51,231,271,208,32,14,18,17,6,11,24,9,15,+2,0,+2,89%,92%,88%,144,163,134,33%,42%,28%,2,0,2,0,0,0
352,https://vlr.gg/player/3687/jonaaa6,2024-06-28 16:00:00,1.14,1.62,1.46,255,213,277,33,10,23,19,8,11,10,3,7,0,0,0,84%,77%,88%,173,141,190,34%,37%,33%,1,0,1,1,0,1
353,https://vlr.gg/player/2139/neptune,2024-06-28 16:00:00,1.36,1.35,1.36,252,245,258,36,12,24,22,9,13,25,13,12,-1,+1,-2,84%,85%,83%,162,144,171,48%,58%,44%,3,2,1,4,1,3
354,https://vlr.gg/player/8375/bones,2024-06-28 16:00:00,1.07,1.48,1.34,279,277,283,40,13,27,21,10,11,10,3,7,-1,-2,+1,81%,77%,83%,169,170,168,26%,35%,22%,7,2,5,8,4,4
355,https://vlr.gg/player/2164/paincakes,2024-06-28 16:00:00,0.46,1.19,0.93,208,142,245,25,5,20,25,11,14,13,3,10,+1,-2,+3,78%,69%,83%,129,87,152,32%,42%,28%,6,1,5,5,3,2
356,https://vlr.gg/player/766/ange,2024-06-28 16:00:00,0.95,0.92,0.94,205,228,166,25,18,7,32,22,10,13,5,8,0,+2,-2,68%,63%,77%,127,136,112,23%,23%,23%,5,5,0,5,3,2
357,https://vlr.gg/player/468/zachareee,2024-06-28 16:00:00,0.72,1.08,0.85,198,176,242,25,14,11,32,21,11,5,2,3,-4,-3,-1,59%,46%,85%,136,121,165,26%,35%,18%,5,4,1,9,7,2
358,https://vlr.gg/player/71/drone,2024-06-28 16:00:00,0.56,0.81,0.65,166,148,202,20,11,9,32,21,11,9,5,4,+1,-2,+3,54%,46%,69%,107,103,116,37%,48%,24%,3,0,3,2,2,0
359,https://vlr.gg/player/3012/riku,2024-06-28 16:00:00,0.50,0.77,0.60,168,150,204,20,11,9,37,25,12,12,7,5,+1,-1,+2,68%,63%,77%,114,104,132,19%,19%,20%,4,1,3,3,2,1
360,https://vlr.gg/player/8118/precision,2024-06-28 16:00:00,0.35,0.88,0.54,123,96,170,14,6,8,33,23,10,10,9,1,+1,0,+1,59%,54%,69%,81,69,104,20%,13%,32%,1,0,1,0,0,0
361,https://vlr.gg/player/5022/derke,2024-06-28 14:30:00,1.57,1.32,1.43,278,310,244,37,19,18,22,10,12,9,1,8,+3,+4,-1,84%,94%,76%,180,196,167,26%,27%,26%,9,5,4,6,1,5
362,https://vlr.gg/player/29867/hiro,2024-06-28 14:30:00,0.79,1.90,1.42,269,181,322,35,10,25,22,11,11,16,4,12,+4,+1,+3,70%,63%,76%,163,112,201,33%,28%,34%,5,1,4,1,0,1
363,https://vlr.gg/player/9810/alfajer,2024-06-28 14:30:00,1.20,1.15,1.17,230,252,210,32,14,18,23,10,13,9,6,3,-1,0,-1,76%,88%,67%,159,176,147,23%,20%,26%,1,1,0,2,1,1
364,https://vlr.gg/player/458/chronicle,2024-06-28 14:30:00,1.15,1.19,1.17,208,238,196,28,14,14,21,9,12,17,7,10,+1,+1,0,84%,88%,81%,150,157,144,23%,28%,19%,4,3,1,3,2,1
365,https://vlr.gg/player/438/boaster,2024-06-28 14:30:00,1.21,0.67,0.90,152,175,139,20,10,10,25,9,16,22,12,10,0,+2,-2,76%,94%,62%,94,105,85,22%,33%,14%,3,2,1,3,0,3
366,https://vlr.gg/player/10307/marteen,2024-06-28 14:30:00,1.05,1.09,1.07,250,254,245,29,17,12,31,18,13,9,4,5,0,+2,-2,76%,71%,81%,168,165,172,29%,27%,32%,5,3,2,5,1,4
367,https://vlr.gg/player/36245/n4rrate,2024-06-28 14:30:00,0.88,0.90,0.89,184,186,183,24,13,11,30,16,14,6,1,5,0,0,0,70%,62%,81%,131,143,114,23%,24%,23%,1,1,0,1,1,0
368,https://vlr.gg/player/19691/tomaszy,2024-06-28 14:30:00,0.91,0.77,0.85,191,209,177,24,16,8,31,17,14,7,4,3,-5,-3,-2,57%,62%,50%,140,150,126,34%,36%,32%,1,0,1,6,3,3
369,https://vlr.gg/player/2173/magnum,2024-06-28 14:30:00,0.83,0.82,0.82,161,176,145,21,12,9,29,17,12,8,3,5,-1,+1,-2,78%,76%,81%,110,125,91,41%,42%,40%,6,6,0,7,5,2
370,https://vlr.gg/player/2625/sh1n,2024-06-28 14:30:00,0.30,0.61,0.43,122,90,163,15,6,9,31,17,14,8,5,3,-1,+1,-2,51%,57%,44%,78,57,105,14%,18%,11%,2,1,1,3,0,3
371,https://vlr.gg/player/1428/sheydos,2024-06-28 12:00:00,1.25,1.36,1.31,235,227,245,40,20,20,27,14,13,8,4,4,+1,+1,0,85%,83%,88%,156,148,165,28%,24%,31%,4,2,2,3,1,2
372,https://vlr.gg/player/5550/grubinho,2024-06-28 12:00:00,1.40,0.89,1.15,215,213,217,36,19,17,32,13,19,17,12,5,+2,-1,+3,81%,92%,71%,137,139,135,38%,33%,45%,6,2,4,4,3,1
373,https://vlr.gg/player/14681/kamo,2024-06-28 12:00:00,1.14,0.75,0.95,224,270,178,35,21,14,37,19,18,9,6,3,0,0,0,71%,88%,54%,144,177,111,19%,25%,12%,7,4,3,7,4,3
374,https://vlr.gg/player/565/starxo,2024-06-28 12:00:00,0.85,0.97,0.91,164,149,180,29,14,15,32,15,17,13,6,7,-9,-5,-4,73%,67%,79%,114,102,126,26%,26%,27%,1,0,1,10,5,5
375,https://vlr.gg/player/451/shadow,2024-06-28 12:00:00,0.43,0.76,0.59,125,91,160,20,7,13,36,18,18,15,5,10,-3,-2,-1,79%,79%,79%,84,66,101,14%,14%,15%,1,0,1,4,2,2
376,https://vlr.gg/player/301/takas,2024-06-28 12:00:00,1.39,1.49,1.44,273,278,268,45,23,22,28,15,13,10,4,6,+14,+6,+8,88%,79%,96%,170,158,181,25%,22%,29%,17,8,9,3,2,1
377,https://vlr.gg/player/5004/natank,2024-06-28 12:00:00,1.14,0.96,1.05,191,193,189,34,17,17,31,14,17,10,6,4,+1,0,+1,77%,79%,75%,131,127,135,29%,33%,26%,5,2,3,4,2,2
378,https://vlr.gg/player/19522/wailers,2024-06-28 12:00:00,1.01,1.01,1.01,200,215,185,36,19,17,32,17,15,15,8,7,+1,0,+1,79%,75%,83%,132,133,130,43%,36%,51%,2,1,1,1,1,0
379,https://vlr.gg/player/20871/k4davra,2024-06-28 12:00:00,0.74,0.87,0.81,181,162,201,30,13,17,35,17,18,15,12,3,-2,-2,0,69%,67%,71%,123,109,137,27%,22%,31%,4,2,2,6,4,2
380,https://vlr.gg/player/220/beyaz,2024-06-28 12:00:00,0.81,0.39,0.60,122,152,92,19,13,6,34,16,18,18,9,9,-5,-2,-3,71%,83%,58%,87,110,65,21%,20%,21%,0,0,0,5,2,3
381,https://vlr.gg/player/10703/shiba,2024-06-28 09:05:00,1.08,1.22,1.15,223,223,223,41,20,21,38,22,16,15,7,8,+1,0,+1,71%,64%,78%,157,155,160,27%,23%,32%,5,3,2,4,3,1
382,https://vlr.gg/player/34031/inf,2024-06-28 09:05:00,0.82,1.25,1.03,237,175,308,45,16,29,42,21,21,6,2,4,+4,-2,+6,64%,54%,74%,158,122,196,22%,18%,24%,7,1,6,3,3,0
383,https://vlr.gg/player/7418/bryce,2024-06-28 09:05:00,0.86,1.05,0.95,150,154,154,31,15,16,35,21,14,15,5,10,-3,0,-3,69%,68%,70%,99,96,101,38%,40%,36%,2,1,1,5,1,4
384,https://vlr.gg/player/42389/persona11,2024-06-28 09:05:00,0.51,1.28,0.89,200,131,263,37,12,25,42,24,18,3,2,1,-5,-7,+2,64%,54%,74%,126,90,164,26%,23%,29%,8,2,6,13,9,4
385,https://vlr.gg/player/7417/joshh,2024-06-28 09:05:00,0.72,0.87,0.79,138,130,150,26,11,15,37,21,16,17,7,10,-4,-3,-1,73%,61%,85%,92,94,89,32%,24%,43%,2,1,1,6,4,2
386,https://vlr.gg/player/7007/shinsei,2024-06-28 09:05:00,0.74,1.55,1.15,268,226,306,51,20,31,38,24,14,3,0,3,+5,-1,+6,65%,52%,79%,169,157,181,28%,31%,25%,12,6,6,7,7,0
387,https://vlr.gg/player/27073/esmonde,2024-06-28 09:05:00,1.40,0.84,1.11,183,248,121,35,24,11,32,18,14,26,11,15,+1,0,+1,75%,74%,75%,117,159,76,23%,23%,22%,5,2,3,4,2,2
388,https://vlr.gg/player/16942/reverie,2024-06-28 09:05:00,0.63,1.41,1.03,202,138,262,41,14,27,33,20,13,10,3,7,-2,-4,+2,75%,70%,79%,131,95,166,27%,27%,27%,3,0,3,5,4,1
389,https://vlr.gg/player/19126/kayle,2024-06-28 09:05:00,1.00,0.94,0.97,197,213,201,38,19,19,38,21,17,6,3,3,+2,0,+2,69%,59%,79%,132,137,127,18%,16%,20%,6,2,4,4,2,2
390,https://vlr.gg/player/9171/kairo,2024-06-28 09:05:00,0.54,1.19,0.87,167,114,219,29,8,21,39,23,16,31,16,15,+1,0,+1,76%,78%,75%,110,70,149,28%,12%,38%,5,1,4,4,1,3
391,https://vlr.gg/player/31495/umaruchans,2024-06-28 09:00:00,1.30,0.98,1.13,209,244,188,43,23,20,40,17,23,10,6,4,-2,-1,-1,67%,73%,63%,150,175,130,22%,22%,22%,4,1,3,6,2,4
392,https://vlr.gg/player/46554/sontaya,2024-06-28 09:00:00,0.76,1.14,0.97,170,150,185,34,13,21,41,19,22,22,11,11,-1,-3,+2,74%,81%,69%,120,97,139,30%,24%,34%,3,1,2,4,4,0
393,https://vlr.gg/player/23896/itaoearth,2024-06-28 09:00:00,1.40,0.43,0.87,151,223,96,31,24,7,42,15,27,23,9,14,-3,0,-3,67%,81%,56%,103,142,71,34%,41%,24%,2,1,1,5,1,4
394,https://vlr.gg/player/31497/allr1ghtt,2024-06-28 09:00:00,0.76,0.93,0.86,167,143,199,37,14,23,46,19,27,11,6,5,-2,0,-2,69%,69%,69%,114,101,125,20%,18%,22%,1,1,0,3,1,2
395,https://vlr.gg/player/27225/d4rf,2024-06-28 09:00:00,0.63,0.88,0.77,216,200,236,40,15,25,52,24,28,15,6,9,+4,0,+4,71%,65%,75%,149,140,156,21%,21%,21%,17,7,10,13,7,6
396,https://vlr.gg/player/23930/potter,2024-06-28 09:00:00,1.40,1.28,1.35,279,311,229,55,35,20,40,22,18,12,7,5,+5,+1,+4,83%,81%,85%,184,204,161,26%,30%,21%,12,7,5,7,6,1
397,https://vlr.gg/player/12289/siraww,2024-06-28 09:00:00,1.05,1.30,1.16,203,177,236,44,21,23,33,17,16,25,13,12,-2,0,-2,76%,75%,77%,141,116,172,29%,27%,30%,4,2,2,6,2,4
398,https://vlr.gg/player/2368/b3ta,2024-06-28 09:00:00,1.19,0.96,1.09,178,194,152,40,24,16,35,18,17,35,20,15,-3,-2,-1,84%,88%,81%,115,123,106,32%,32%,33%,1,0,1,4,2,2
399,https://vlr.gg/player/2366/alert,2024-06-28 09:00:00,1.17,0.86,1.03,216,214,229,45,26,19,38,17,21,14,3,11,+1,0,+1,74%,75%,73%,142,138,147,23%,32%,14%,7,3,4,6,3,3
400,https://vlr.gg/player/10791/bnwgiggs,2024-06-28 09:00:00,0.97,0.95,0.96,198,205,187,37,21,16,39,22,17,28,16,12,+3,+1,+2,78%,75%,81%,132,138,125,19%,21%,16%,7,4,3,4,3,1
401,https://vlr.gg/player/16924/stew,2024-06-28 07:35:00,,,,281,,,58,,,31,,,7,,,+5,,,,,,180,,,25%,,,11,,,6,,
402,https://vlr.gg/player/10486/yhchen,2024-06-28 07:35:00,,,,255,,,49,,,33,,,21,,,+4,,,,,,161,,,28%,,,5,,,1,,
403,https://vlr.gg/player/41029/z1yan,2024-06-28 07:35:00,,,,189,,,39,,,40,,,9,,,-3,,,,,,129,,,42%,,,4,,,7,,
404,https://vlr.gg/player/36415/viva,2024-06-28 07:35:00,,,,175,,,34,,,30,,,11,,,+5,,,,,,120,,,31%,,,6,,,1,,
405,https://vlr.gg/player/3519/jkuro,2024-06-28 07:35:00,,,,173,,,34,,,38,,,18,,,0,,,,,,116,,,27%,,,7,,,7,,
406,https://vlr.gg/player/3045/luok1ng,2024-06-28 07:35:00,,,,206,,,38,,,44,,,16,,,-4,,,,,,127,,,35%,,,1,,,5,,
407,https://vlr.gg/player/4770/fengf,2024-06-28 07:35:00,,,,196,,,38,,,44,,,11,,,-4,,,,,,131,,,25%,,,6,,,10,,
408,https://vlr.gg/player/3021/biank,2024-06-28 07:35:00,,,,192,,,39,,,40,,,11,,,+4,,,,,,128,,,22%,,,8,,,4,,
409,https://vlr.gg/player/37494/kai,2024-06-28 07:35:00,,,,183,,,35,,,44,,,10,,,-8,,,,,,129,,,25%,,,4,,,12,,
410,https://vlr.gg/player/4712/heybay,2024-06-28 07:35:00,,,,132,,,22,,,42,,,26,,,+1,,,,,,93,,,27%,,,3,,,2,,
411,https://vlr.gg/player/1174/crunchy,2024-06-28 07:25:00,0.95,1.81,1.48,266,180,321,39,11,28,24,12,12,24,9,15,+4,-1,+5,82%,87%,79%,167,98,210,27%,29%,27%,6,0,6,2,1,1
412,https://vlr.gg/player/27550/exirst,2024-06-28 07:25:00,0.68,1.90,1.43,282,166,356,41,8,33,25,13,12,8,4,4,-2,-3,+1,74%,53%,88%,181,125,217,33%,18%,40%,6,1,5,8,4,4
413,https://vlr.gg/player/29790/zauqk,2024-06-28 07:25:00,1.08,1.59,1.40,265,227,286,35,10,25,23,12,11,20,10,10,+2,+1,+1,85%,87%,83%,180,164,190,23%,29%,20%,3,1,2,1,0,1
414,https://vlr.gg/player/1176/nozz,2024-06-28 07:25:00,1.41,1.03,1.18,195,261,153,30,15,15,23,11,12,14,6,8,-2,-2,0,77%,80%,75%,129,175,100,37%,39%,34%,1,1,0,3,3,0
415,https://vlr.gg/player/11106/m1ke,2024-06-28 07:25:00,1.16,0.55,0.78,165,230,127,22,13,9,30,11,19,11,3,8,-3,0,-3,74%,67%,79%,117,163,87,24%,32%,18%,3,2,1,6,2,4
416,https://vlr.gg/player/5210/amnesty,2024-06-28 07:25:00,0.83,1.13,0.95,210,189,241,29,16,13,31,21,10,12,6,6,+4,+2,+2,82%,79%,87%,135,130,143,41%,50%,29%,5,2,3,1,0,1
417,https://vlr.gg/player/31632/zenox,2024-06-28 07:25:00,0.57,1.48,0.92,211,144,318,29,12,17,35,23,12,8,1,7,0,-2,+2,74%,58%,100%,134,87,208,23%,30%,17%,4,2,2,4,4,0
418,https://vlr.gg/player/12964/jawsy,2024-06-28 07:25:00,0.70,1.23,0.91,198,183,224,29,16,13,33,23,10,12,7,5,+2,0,+2,74%,71%,80%,136,114,172,34%,34%,33%,4,1,3,2,1,1
419,https://vlr.gg/player/22826/phequa,2024-06-28 07:25:00,0.48,0.74,0.58,161,164,159,21,12,9,34,23,11,6,3,3,-3,-3,0,59%,50%,73%,111,113,108,23%,30%,14%,6,4,2,9,7,2
420,https://vlr.gg/player/3287/exempt,2024-06-28 07:25:00,0.66,0.42,0.57,135,142,126,17,10,7,34,20,14,20,14,6,-2,-1,-1,77%,79%,73%,89,96,79,20%,27%,12%,1,1,0,3,2,1
421,https://vlr.gg/player/18037/fluky,2024-06-28 07:00:00,1.33,0.94,1.07,220,243,206,28,11,17,28,9,19,12,7,5,-1,0,-1,75%,100%,63%,134,132,135,28%,29%,28%,5,1,4,6,1,5
422,https://vlr.gg/player/15902/xcool3,2024-06-28 07:00:00,0.72,1.09,0.96,204,175,222,27,7,20,28,10,18,4,2,2,0,0,0,67%,67%,67%,132,112,141,33%,23%,39%,3,0,3,3,0,3
423,https://vlr.gg/player/41702/canady,2024-06-28 07:00:00,0.77,0.95,0.88,222,201,233,28,8,20,30,11,19,5,2,3,-2,-1,-1,67%,75%,63%,145,141,148,29%,31%,29%,5,2,3,7,3,4
424,https://vlr.gg/player/27248/earthy,2024-06-28 07:00:00,0.60,0.53,0.55,133,117,139,16,5,11,30,9,21,7,3,4,-3,-3,0,56%,58%,54%,94,84,99,27%,26%,27%,1,0,1,4,3,1
425,https://vlr.gg/player/6721/pedio,2024-06-28 07:00:00,0.57,0.51,0.53,138,143,136,15,7,8,30,10,20,6,1,5,-2,-2,0,53%,42%,58%,94,81,100,17%,19%,16%,0,0,0,2,2,0
426,https://vlr.gg/player/12291/arpoom,2024-06-28 07:00:00,1.47,1.91,1.62,311,298,337,42,27,15,23,16,7,14,9,5,+6,+2,+4,69%,63%,83%,207,194,234,38%,44%,28%,8,4,4,2,2,0
427,https://vlr.gg/player/18035/garnets,2024-06-28 07:00:00,1.59,1.14,1.44,318,363,237,39,29,10,28,19,9,10,6,4,+7,+5,+2,81%,79%,83%,219,238,182,38%,38%,38%,10,7,3,3,2,1
428,https://vlr.gg/player/5687/alonefillz,2024-06-28 07:00:00,1.24,0.72,1.06,177,190,149,23,17,6,20,12,8,14,11,3,0,+2,-2,78%,88%,58%,109,115,97,21%,17%,28%,2,2,0,2,0,2
429,https://vlr.gg/player/16977/socools0da,2024-06-28 07:00:00,0.85,1.20,0.96,173,154,217,25,14,11,24,17,7,14,10,4,-2,-3,+1,78%,71%,92%,125,120,135,44%,47%,39%,1,0,1,3,3,0
430,https://vlr.gg/player/8582/laz,2024-06-28 07:00:00,0.83,1.14,0.94,137,122,165,17,10,7,19,12,7,10,5,5,-3,-4,+1,75%,71%,83%,100,89,122,30%,26%,35%,1,0,1,4,4,0
431,https://vlr.gg/player/7381/redkoh,2024-06-28 07:00:00,1.50,1.63,1.54,261,273,248,34,26,8,16,11,5,12,7,5,+1,+2,-1,76%,79%,67%,161,160,166,36%,38%,33%,2,2,0,1,0,1
432,https://vlr.gg/player/5886/flaring,2024-06-28 07:00:00,1.59,0.71,1.35,227,248,140,25,21,4,17,11,6,19,15,4,-1,0,-1,88%,88%,89%,149,173,84,19%,21%,12%,0,0,0,1,0,1
433,https://vlr.gg/player/7443/riza,2024-06-28 07:00:00,1.25,1.01,1.19,192,203,154,24,18,6,17,12,5,9,8,1,-2,-1,-1,73%,75%,67%,134,148,98,36%,39%,29%,1,1,0,3,2,1
434,https://vlr.gg/player/16852/nakya,2024-06-28 07:00:00,0.89,1.53,1.07,303,266,366,35,23,12,29,21,8,5,4,1,+1,-3,+4,70%,67%,78%,172,159,206,42%,39%,56%,11,6,5,10,9,1
435,https://vlr.gg/player/27068/pudj,2024-06-28 07:00:00,1.11,0.83,1.03,184,181,202,23,17,6,21,14,7,10,7,3,0,0,0,70%,79%,44%,125,117,145,17%,19%,15%,2,2,0,2,2,0
436,https://vlr.gg/player/36685/splash,2024-06-28 07:00:00,1.03,1.10,1.05,242,229,259,28,8,20,28,7,21,2,1,1,+3,-2,+5,61%,56%,63%,151,138,156,35%,50%,30%,7,1,6,4,3,1
437,https://vlr.gg/player/36704/impecunity,2024-06-28 07:00:00,1.69,0.76,1.01,225,345,179,27,12,15,28,6,22,4,1,3,+2,+1,+1,61%,67%,58%,156,232,127,36%,35%,37%,5,1,4,3,0,3
438,https://vlr.gg/player/2377/aduka,2024-06-28 07:00:00,1.37,0.68,0.86,170,276,136,20,9,11,27,7,20,4,1,3,+1,+2,-1,73%,78%,71%,115,189,88,32%,31%,32%,4,2,2,3,0,3
439,https://vlr.gg/player/44919/aplycs,2024-06-28 07:00:00,0.28,0.66,0.55,159,82,193,17,2,15,29,8,21,9,2,7,-2,-2,0,70%,56%,75%,112,48,136,24%,33%,23%,1,0,1,3,2,1
440,https://vlr.gg/player/8156/mojo,2024-06-28 07:00:00,0.07,0.42,0.32,95,27,126,8,0,8,29,8,21,16,7,9,-3,0,-3,58%,78%,50%,63,11,83,18%,0%,19%,0,0,0,3,0,3
441,https://vlr.gg/player/16215/dos9,2024-06-28 06:30:00,1.45,1.40,1.43,288,299,268,60,37,23,38,25,13,18,12,6,+2,0,+2,70%,61%,83%,189,197,178,38%,31%,53%,10,5,5,8,5,3
442,https://vlr.gg/player/6913/sultan,2024-06-28 06:30:00,1.45,1.19,1.34,227,246,197,51,32,19,33,19,14,18,12,6,-2,-3,+1,73%,75%,71%,148,170,116,30%,35%,21%,3,1,2,5,4,1
443,https://vlr.gg/player/4095/skrossi,2024-06-28 06:30:00,1.00,1.31,1.12,189,154,246,43,21,22,33,19,14,8,4,4,+6,+2,+4,75%,72%,79%,120,101,147,24%,27%,21%,9,4,5,3,2,1
444,https://vlr.gg/player/10463/paradox,2024-06-28 06:30:00,0.78,1.46,1.05,225,176,295,46,20,26,40,25,15,20,12,8,-1,-4,+3,70%,61%,83%,155,124,201,31%,35%,26%,6,3,3,7,7,0
445,https://vlr.gg/player/3630/skillz,2024-06-28 06:30:00,1.04,0.86,0.97,145,160,122,30,22,8,33,20,13,25,12,13,+1,+3,-2,73%,75%,71%,93,98,87,28%,35%,19%,5,4,1,4,1,3
446,https://vlr.gg/player/3627/hellff,2024-06-28 06:30:00,1.04,0.85,0.93,206,232,191,43,20,23,49,20,29,14,4,10,+2,0,+2,72%,75%,69%,132,134,132,26%,21%,32%,5,2,3,3,2,1
447,https://vlr.gg/player/7434/d1srupt,2024-06-28 06:30:00,0.79,0.94,0.88,190,202,189,38,15,23,45,20,25,5,1,4,-1,-2,+1,67%,67%,67%,125,131,120,17%,16%,18%,8,2,6,9,4,5
448,https://vlr.gg/player/3628/deathmaker,2024-06-28 06:30:00,0.74,0.84,0.80,159,155,163,35,14,21,42,18,24,8,3,5,-3,-1,-2,57%,54%,58%,108,102,111,35%,43%,32%,6,2,4,9,3,6
449,https://vlr.gg/player/27775/techno,2024-06-28 06:30:00,0.57,0.93,0.79,155,114,185,31,8,23,45,19,26,23,13,10,0,-3,+3,63%,58%,67%,98,74,114,32%,29%,34%,5,0,5,5,3,2
450,https://vlr.gg/player/9741/aryu,2024-06-28 06:30:00,0.57,0.70,0.65,156,162,156,30,12,18,49,21,28,9,2,7,-4,-2,-2,60%,54%,64%,109,114,106,29%,37%,24%,3,2,1,7,4,3
451,https://vlr.gg/player/23041/louboutin,2024-06-28 06:00:00,1.38,1.25,1.31,259,276,250,89,47,42,62,31,31,19,9,10,-1,+1,-2,76%,71%,81%,181,184,178,36%,35%,38%,8,5,3,9,4,5
452,https://vlr.gg/player/1431/p1na,2024-06-28 06:00:00,1.18,1.35,1.26,229,209,243,77,38,39,60,31,29,43,17,26,-4,-3,-1,77%,75%,79%,149,139,159,34%,35%,32%,7,2,5,11,5,6
453,https://vlr.gg/player/1433/hyzee,2024-06-28 06:00:00,0.77,1.24,1.00,203,150,261,68,27,41,69,35,34,23,8,15,-1,-3,+2,68%,67%,70%,131,91,173,28%,22%,31%,7,2,5,8,5,3
454,https://vlr.gg/player/14227/nhatthong2k,2024-06-28 06:00:00,1.04,0.87,0.95,210,229,189,65,37,28,72,36,36,19,6,13,+4,0,+4,66%,63%,70%,143,152,134,32%,42%,23%,16,9,7,12,9,3
455,https://vlr.gg/player/21807/somethai,2024-06-28 06:00:00,0.69,1.04,0.86,190,160,227,62,25,37,78,40,38,30,12,18,+1,+1,0,72%,69%,74%,128,113,144,34%,29%,39%,9,4,5,8,3,5
456,https://vlr.gg/player/21840/lilhieu,2024-06-28 06:00:00,1.23,1.21,1.22,276,283,266,90,48,42,72,36,36,20,10,10,+4,+2,+2,68%,70%,67%,184,183,184,22%,23%,22%,18,9,9,14,7,7
457,https://vlr.gg/player/44142/dafam1,2024-06-28 06:00:00,0.96,0.99,0.98,236,236,242,81,41,40,85,44,41,36,20,16,+4,+1,+3,76%,81%,71%,151,156,145,26%,26%,27%,10,5,5,6,4,2
458,https://vlr.gg/player/2440/bmv,2024-06-28 06:00:00,0.77,0.92,0.84,161,131,193,54,22,32,65,32,33,17,11,6,0,-1,+1,66%,68%,65%,111,91,129,20%,21%,19%,2,0,2,2,1,1
459,https://vlr.gg/player/44444/tyson,2024-06-28 06:00:00,0.84,0.83,0.84,176,188,161,61,34,27,73,38,35,22,11,11,-6,-7,+1,69%,74%,65%,120,139,102,34%,41%,26%,7,2,5,13,9,4
460,https://vlr.gg/player/8166/nh0zkon,2024-06-28 06:00:00,0.68,0.93,0.81,174,165,176,54,25,29,69,38,31,30,16,14,-1,+2,-3,73%,72%,73%,113,110,115,26%,31%,20%,11,6,5,12,4,8
461,https://vlr.gg/player/4866/kushy,2024-06-28 05:15:00,1.58,1.11,1.41,263,298,195,34,24,10,22,13,9,22,15,7,+1,0,+1,89%,92%,85%,170,196,122,28%,28%,27%,6,4,2,5,4,1
462,https://vlr.gg/player/7807/valdyn,2024-06-28 05:15:00,1.27,1.39,1.31,271,265,282,37,24,13,24,14,10,11,7,4,+1,+1,0,86%,88%,85%,178,164,203,30%,31%,28%,3,1,2,2,0,2
463,https://vlr.gg/player/23710/gotten,2024-06-28 05:15:00,1.37,0.88,1.20,217,246,156,31,23,8,21,14,7,5,4,1,0,-2,+2,78%,75%,85%,138,150,115,33%,27%,57%,4,2,2,4,4,0
464,https://vlr.gg/player/2346/cud,2024-06-28 05:15:00,1.28,1.03,1.19,204,204,205,28,19,9,20,10,10,12,4,8,-3,-3,0,81%,79%,85%,129,134,121,40%,46%,32%,2,1,1,5,4,1
465,https://vlr.gg/player/11666/ray4c,2024-06-28 05:15:00,0.93,1.65,1.18,254,207,337,35,19,16,24,16,8,11,5,6,0,0,0,81%,79%,85%,158,132,205,10%,12%,8%,3,2,1,3,2,1
466,https://vlr.gg/player/46045/aderrr,2024-06-28 05:15:00,1.26,0.63,0.85,188,278,153,25,13,12,32,10,22,2,0,2,+3,+1,+2,54%,62%,50%,119,163,95,18%,29%,12%,4,2,2,1,1,0
467,https://vlr.gg/player/34082/tupai,2024-06-28 05:15:00,0.66,0.93,0.84,196,157,208,21,6,15,32,11,21,11,5,6,+4,+2,+2,65%,62%,67%,138,115,150,23%,30%,20%,6,2,4,2,0,2
468,https://vlr.gg/player/8257/limitado,2024-06-28 05:15:00,0.95,0.73,0.80,160,200,141,22,10,12,31,11,20,12,3,9,-2,-1,-1,65%,69%,63%,106,121,98,35%,36%,33%,1,0,1,3,1,2
469,https://vlr.gg/player/9280/padangrice,2024-06-28 05:15:00,0.52,0.75,0.67,192,123,228,21,5,16,35,11,24,13,5,8,-1,-1,0,76%,77%,75%,124,76,150,20%,26%,19%,3,0,3,4,1,3
470,https://vlr.gg/player/23671/mas,2024-06-28 05:15:00,0.62,0.60,0.61,175,212,160,22,10,12,35,13,22,4,0,4,-3,-4,+1,59%,77%,50%,114,130,106,19%,23%,18%,5,1,4,8,5,3
471,https://vlr.gg/player/41054/guang,2024-06-28 05:00:00,,,,261,,,50,,,36,,,12,,,-2,,,,,,175,,,26%,,,5,,,7,,
472,https://vlr.gg/player/39697/cb,2024-06-28 05:00:00,,,,226,,,44,,,33,,,15,,,-2,,,,,,153,,,34%,,,2,,,4,,
473,https://vlr.gg/player/46460/ezeir,2024-06-28 05:00:00,,,,221,,,40,,,37,,,18,,,-1,,,,,,147,,,22%,,,5,,,6,,
474,https://vlr.gg/player/1209/swerl,2024-06-28 05:00:00,,,,218,,,39,,,44,,,9,,,-6,,,,,,153,,,26%,,,6,,,12,,
475,https://vlr.gg/player/4402/o0o0o,2024-06-28 05:00:00,,,,149,,,26,,,41,,,29,,,+1,,,,,,99,,,32%,,,4,,,3,,
476,https://vlr.gg/player/11218/yuicaw,2024-06-28 05:00:00,,,,266,,,51,,,41,,,22,,,+2,,,,,,182,,,35%,,,7,,,5,,
477,https://vlr.gg/player/14125/spring,2024-06-28 05:00:00,,,,228,,,40,,,44,,,11,,,+7,,,,,,150,,,21%,,,17,,,10,,
478,https://vlr.gg/player/14441/aluba,2024-06-28 05:00:00,,,,219,,,43,,,39,,,10,,,-1,,,,,,140,,,24%,,,2,,,3,,
479,https://vlr.gg/player/871/pl1xx,2024-06-28 05:00:00,,,,167,,,30,,,39,,,22,,,+1,,,,,,120,,,30%,,,2,,,1,,
480,https://vlr.gg/player/7849/siufatbb,2024-06-28 05:00:00,,,,138,,,26,,,36,,,17,,,+1,,,,,,92,,,30%,,,4,,,3,,
481,https://vlr.gg/player/17169/muto,2024-06-28 04:30:00,0.81,1.16,1.03,207,201,212,22,9,13,28,13,15,25,5,20,+3,+1,+2,68%,64%,71%,156,154,157,33%,36%,32%,3,1,2,0,0,0
482,https://vlr.gg/player/4664/gangpin,2024-06-28 04:30:00,0.63,1.21,1.00,204,178,225,29,9,20,33,14,19,11,5,6,0,0,0,71%,57%,79%,145,111,164,40%,22%,53%,2,0,2,2,0,2
483,https://vlr.gg/player/34827/hals,2024-06-28 04:30:00,0.55,0.91,0.78,217,179,236,28,7,21,32,13,19,3,3,0,+1,0,+1,58%,57%,58%,132,120,139,16%,20%,13%,9,4,5,8,4,4
484,https://vlr.gg/player/25915/brian,2024-06-28 04:30:00,0.35,0.88,0.68,164,119,189,21,6,15,30,14,16,9,3,6,-2,0,-2,55%,43%,63%,107,63,133,43%,17%,58%,3,2,1,5,2,3
485,https://vlr.gg/player/13002/akame,2024-06-28 04:30:00,0.43,0.77,0.64,144,124,160,20,7,13,30,13,17,5,2,3,+2,+1,+1,55%,57%,54%,103,81,116,18%,9%,22%,4,1,3,2,0,2
486,https://vlr.gg/player/12990/syouta,2024-06-28 04:30:00,1.49,1.52,1.50,328,340,309,46,29,17,28,19,9,11,9,2,+3,+3,0,79%,75%,86%,211,223,190,26%,24%,31%,8,6,2,5,3,2
487,https://vlr.gg/player/2615/clz,2024-06-28 04:30:00,0.95,1.60,1.19,182,168,209,23,13,10,22,16,6,27,14,13,-3,-3,0,84%,75%,100%,118,110,132,21%,22%,19%,2,2,0,5,5,0
488,https://vlr.gg/player/6673/gon,2024-06-28 04:30:00,0.93,1.62,1.18,187,170,222,28,15,13,21,16,5,18,15,3,0,0,0,79%,75%,86%,108,97,125,28%,24%,33%,2,1,1,2,1,1
489,https://vlr.gg/player/1395/tennn,2024-06-28 04:30:00,0.86,1.36,1.04,185,142,254,27,14,13,22,14,8,12,4,8,+1,-1,+2,76%,75%,79%,116,87,165,44%,42%,46%,3,0,3,2,1,1
490,https://vlr.gg/player/25221/xdll,2024-06-28 04:30:00,0.86,1.30,1.02,217,183,273,29,15,14,27,17,10,17,9,8,-5,-1,-4,84%,88%,79%,141,125,168,22%,17%,28%,2,2,0,7,3,4
491,https://vlr.gg/player/43125/kadiri,2024-06-28 04:30:00,1.21,1.34,1.27,318,304,333,64,31,33,49,24,25,10,5,5,+2,+1,+1,69%,76%,63%,214,205,223,40%,44%,37%,11,5,6,9,4,5
492,https://vlr.gg/player/34257/strame,2024-06-28 04:30:00,1.15,1.17,1.16,226,225,231,51,27,24,40,20,20,15,4,11,+7,+2,+5,78%,72%,83%,143,138,148,36%,36%,37%,7,2,5,0,0,0
493,https://vlr.gg/player/41185/kaza,2024-06-28 04:30:00,1.16,0.91,1.03,205,228,193,41,22,19,40,19,21,15,7,8,-1,-2,+1,75%,69%,80%,133,140,126,24%,26%,22%,3,1,2,4,3,1
494,https://vlr.gg/player/5436/azoh,2024-06-28 04:30:00,0.88,1.05,0.97,159,131,174,33,14,19,35,17,18,18,11,7,-9,-5,-4,63%,55%,70%,103,85,119,16%,13%,18%,1,0,1,10,5,5
495,https://vlr.gg/player/14336/loubert,2024-06-28 04:30:00,0.84,0.76,0.80,170,161,167,30,13,17,42,21,21,28,16,12,-6,-5,-1,75%,72%,77%,111,106,115,29%,28%,31%,4,2,2,10,7,3
496,https://vlr.gg/player/26321/songry,2024-06-28 04:30:00,1.29,1.10,1.19,222,250,189,47,27,20,41,22,19,13,8,5,+5,+3,+2,75%,73%,76%,156,171,139,31%,34%,28%,7,4,3,2,1,1
497,https://vlr.gg/player/31583/maine,2024-06-28 04:30:00,0.88,1.35,1.11,213,158,278,46,16,30,44,23,21,20,12,8,+1,-3,+4,75%,73%,76%,140,105,176,26%,20%,31%,6,0,6,5,3,2
498,https://vlr.gg/player/26322/lg1c,2024-06-28 04:30:00,1.23,0.77,1.00,195,251,141,45,30,15,42,21,21,9,3,6,+1,-2,+3,69%,70%,69%,129,157,101,22%,24%,18%,6,3,3,5,5,0
499,https://vlr.gg/player/34221/phi,2024-06-28 04:30:00,0.90,0.88,0.89,199,185,221,41,18,23,47,23,24,17,11,6,+2,+1,+1,75%,77%,72%,129,113,146,31%,31%,31%,9,4,5,7,3,4
500,https://vlr.gg/player/31238/alucard,2024-06-28 04:30:00,0.62,0.74,0.68,153,152,167,27,14,13,45,23,22,26,9,17,-2,-1,-1,59%,60%,59%,109,102,115,25%,24%,25%,5,3,2,7,4,3
0,https://vlr.gg/player/31398/ichisolo,2024-06-28 04:05:00,1.05,1.15,1.10,222,183,245,32,12,20,34,14,20,16,8,8,0,0,0,73%,68%,77%,158,127,184,24%,21%,26%,2,1,1,2,1,1
1,https://vlr.gg/player/44259/patrickwho,2024-06-28 04:05:00,0.88,1.13,1.02,223,206,239,41,18,23,37,19,18,6,2,4,-2,0,-2,69%,68%,69%,152,137,165,29%,44%,23%,9,6,3,11,6,5
2,https://vlr.gg/player/10249/uyen,2024-06-28 04:05:00,1.09,0.77,0.91,188,215,181,34,17,17,36,16,20,14,9,5,-3,-2,-1,71%,73%,69%,124,137,113,21%,23%,20%,2,0,2,5,2,3
3,https://vlr.gg/player/7435/astr0,2024-06-28 04:05:00,1.17,0.62,0.87,186,245,131,34,21,13,35,16,19,14,6,8,-5,-2,-3,75%,77%,73%,128,159,101,31%,37%,24%,1,0,1,6,2,4
4,https://vlr.gg/player/37375/chanyboi,2024-06-28 04:05:00,0.73,0.99,0.87,177,171,204,30,13,17,39,19,20,22,12,10,0,0,0,75%,73%,77%,123,115,130,33%,24%,42%,5,2,3,5,2,3
5,https://vlr.gg/player/13744/patmen,2024-06-28 04:05:00,1.27,1.38,1.32,262,266,250,46,24,22,36,20,16,17,10,7,+7,+4,+3,79%,77%,82%,165,171,158,35%,38%,32%,11,7,4,4,3,1
6,https://vlr.gg/player/7746/kevzii,2024-06-28 04:05:00,0.97,1.35,1.15,238,184,299,37,16,21,33,17,16,17,8,9,+3,+2,+1,75%,73%,77%,164,131,203,28%,21%,35%,7,3,4,4,1,3
7,https://vlr.gg/player/16953/zynd,2024-06-28 04:05:00,1.35,0.74,1.07,180,212,151,33,21,12,29,14,15,5,4,1,0,-1,+1,69%,69%,68%,134,155,109,24%,23%,26%,4,2,2,4,3,1
8,https://vlr.gg/player/9737/kakarot,2024-06-28 04:05:00,0.81,1.17,0.98,221,201,239,37,18,19,38,22,16,10,6,4,-1,+1,-2,69%,62%,77%,154,146,164,27%,26%,27%,6,4,2,7,3,4
9,https://vlr.gg/player/13223/micr0,2024-06-28 04:05:00,1.11,0.57,0.86,162,180,140,28,18,10,35,17,18,13,8,5,+1,0,+1,79%,85%,73%,105,108,102,23%,21%,26%,1,0,1,0,0,0
10,https://vlr.gg/player/7805/rizkymd,2024-06-28 03:00:00,0.68,1.81,1.22,213,151,281,34,10,24,29,20,9,14,9,5,-1,-3,+2,75%,61%,90%,143,106,184,27%,20%,32%,3,0,3,4,3,1
11,https://vlr.gg/player/7042/eeyore,2024-06-28 03:00:00,0.99,1.34,1.16,227,211,239,37,17,20,28,19,9,9,2,7,0,-1,+1,68%,61%,76%,148,147,151,25%,35%,19%,1,0,1,1,1,0
12,https://vlr.gg/player/11458/kuroza,2024-06-28 03:00:00,1.11,1.11,1.11,204,189,217,32,15,17,29,17,12,14,8,6,+3,-1,+4,75%,65%,86%,130,118,142,20%,25%,17%,4,0,4,1,1,0
13,https://vlr.gg/player/12207/rapheleen,2024-06-28 03:00:00,0.91,1.32,1.10,210,196,228,33,16,17,28,19,9,11,3,8,-2,-5,+3,75%,65%,86%,141,130,152,16%,23%,10%,4,0,4,6,5,1
14,https://vlr.gg/player/26829/damaraa,2024-06-28 03:00:00,0.46,1.06,0.75,179,151,215,28,11,17,33,21,12,9,6,3,-8,-11,+3,64%,43%,86%,118,107,130,17%,25%,9%,6,1,5,14,12,2
15,https://vlr.gg/player/7804/severine,2024-06-28 03:00:00,0.88,1.43,1.17,231,160,298,35,11,24,33,18,15,15,7,8,+6,0,+6,66%,48%,83%,143,94,187,21%,25%,19%,6,0,6,0,0,0
16,https://vlr.gg/player/7783/zhar,2024-06-28 03:00:00,0.78,1.27,1.04,213,189,237,30,12,18,32,18,14,10,2,8,+3,-1,+4,68%,52%,83%,141,129,152,30%,30%,31%,5,1,4,2,2,0
17,https://vlr.gg/player/4872/frostmind,2024-06-28 03:00:00,0.92,0.96,0.94,194,220,174,30,15,15,33,20,13,8,2,6,+1,-1,+2,73%,62%,83%,138,151,126,33%,37%,29%,2,0,2,1,1,0
18,https://vlr.gg/player/7048/budimeister,2024-06-28 03:00:00,0.36,1.37,0.89,178,77,269,26,5,21,31,18,13,17,6,11,+2,-4,+6,68%,48%,87%,118,54,177,26%,28%,26%,6,0,6,4,4,0
19,https://vlr.gg/player/9717/lilo,2024-06-28 03:00:00,0.25,0.95,0.62,164,122,202,26,8,18,35,21,14,4,0,4,-4,-7,+3,61%,38%,83%,115,86,141,20%,22%,20%,7,3,4,11,10,1
20,https://vlr.gg/player/29841/caedye,2024-06-28 02:00:00,1.30,1.21,1.25,267,275,258,38,18,20,27,12,15,10,2,8,0,0,0,76%,68%,83%,166,163,169,25%,20%,31%,4,3,1,4,3,1
21,https://vlr.gg/player/4663/joxjo,2024-06-28 02:00:00,1.45,1.01,1.21,200,224,176,29,16,13,26,11,15,27,14,13,-6,-2,-4,76%,84%,70%,130,146,116,33%,23%,46%,0,0,0,6,2,4
22,https://vlr.gg/player/43064/aace,2024-06-28 02:00:00,1.21,1.17,1.19,206,217,196,32,16,16,23,12,11,13,2,11,-1,0,-1,81%,74%,87%,136,145,128,33%,37%,29%,2,1,1,3,1,2
23,https://vlr.gg/player/29843/yatsuka,2024-06-28 02:00:00,1.35,0.69,0.99,188,209,175,30,16,14,29,10,19,13,6,7,-1,-2,+1,76%,79%,74%,131,136,127,55%,59%,50%,3,0,3,4,2,2
24,https://vlr.gg/player/10584/seoldam,2024-06-28 02:00:00,0.30,1.31,0.85,187,125,236,30,8,22,30,17,13,4,3,1,-2,-5,+3,71%,58%,83%,121,79,155,30%,42%,26%,7,1,6,9,6,3
25,https://vlr.gg/player/4477/lob,2024-06-28 02:00:00,1.27,0.97,1.14,237,223,244,31,17,14,30,15,15,17,10,7,0,+1,-1,71%,74%,68%,167,163,173,22%,36%,14%,1,1,0,1,0,1
26,https://vlr.gg/player/34727/kayle,2024-06-28 02:00:00,0.96,0.88,0.92,198,192,199,26,15,11,32,17,15,10,4,6,+1,0,+1,69%,70%,68%,134,134,133,29%,27%,33%,6,4,2,5,4,1
27,https://vlr.gg/player/7718/xnfri,2024-06-28 02:00:00,0.94,0.77,0.87,188,199,184,28,16,12,33,18,15,7,4,3,+4,+2,+2,64%,74%,53%,127,130,123,28%,24%,33%,7,5,2,3,3,0
28,https://vlr.gg/player/687/zepher,2024-06-28 02:00:00,0.67,1.09,0.86,178,147,226,27,12,15,29,16,13,4,2,2,+4,-2,+6,62%,52%,74%,118,93,147,24%,14%,38%,10,2,8,6,4,2
29,https://vlr.gg/player/7888/blackwiz,2024-06-28 02:00:00,0.83,0.75,0.80,169,164,175,23,13,10,35,19,16,15,7,8,+1,0,+1,76%,78%,74%,127,128,127,25%,26%,24%,2,0,2,1,0,1
30,https://vlr.gg/player/44251/dignified,2024-06-28 02:00:00,1.70,0.87,1.31,230,271,186,21,13,8,16,7,9,3,3,0,+1,+1,0,65%,67%,64%,157,196,114,49%,41%,69%,1,1,0,0,0,0
31,https://vlr.gg/player/24794/exotic,2024-06-28 02:00:00,1.03,1.11,1.06,271,228,337,19,10,9,20,12,8,2,0,2,+4,+3,+1,75%,75%,75%,175,150,213,42%,56%,32%,4,3,1,0,0,0
32,https://vlr.gg/player/35028/fallx,2024-06-28 02:00:00,0.92,0.92,0.92,224,238,214,34,19,15,34,19,15,4,2,2,-3,0,-3,56%,50%,63%,160,163,158,33%,34%,31%,6,4,2,9,4,5
33,https://vlr.gg/player/35027/owen-q-t,2024-06-28 02:00:00,1.00,0.39,0.73,139,164,113,21,14,7,32,15,17,17,8,9,-2,0,-2,58%,58%,58%,92,109,71,19%,19%,19%,3,2,1,5,2,3
34,https://vlr.gg/player/44250/dizzyfps,2024-06-28 02:00:00,0.78,0.59,0.69,181,197,161,27,17,10,33,18,15,2,1,1,-6,-4,-2,49%,50%,47%,114,119,108,34%,33%,36%,2,1,1,8,5,3
35,https://vlr.gg/player/35020/aeonyx,2024-06-28 02:00:00,0.50,0.68,0.58,137,111,173,19,9,10,35,20,15,11,5,6,-3,-2,-1,65%,63%,68%,96,83,113,22%,23%,22%,1,0,1,4,2,2
36,https://vlr.gg/player/10217/marky,2024-06-28 02:00:00,1.95,1.30,1.59,284,310,255,44,23,21,23,8,15,19,11,8,+5,+1,+4,86%,89%,83%,160,183,141,19%,25%,13%,6,2,4,1,1,0
37,https://vlr.gg/player/2679/dubstep,2024-06-28 02:00:00,1.25,1.13,1.18,209,210,216,33,14,19,26,10,16,12,6,6,+3,+2,+1,77%,74%,79%,125,128,123,22%,13%,33%,5,2,3,2,0,2
38,https://vlr.gg/player/7754/xavi8k,2024-06-28 02:00:00,0.90,1.31,1.13,219,174,258,35,11,24,30,15,15,6,3,3,+3,+3,0,72%,74%,71%,146,121,166,38%,34%,41%,4,3,1,1,0,1
39,https://vlr.gg/player/7437/kellys,2024-06-28 02:00:00,0.98,0.95,0.96,213,216,210,31,16,15,31,14,17,8,2,6,-1,0,-1,72%,74%,71%,131,123,137,13%,16%,11%,6,4,2,7,4,3
40,https://vlr.gg/player/10782/witz,2024-06-28 02:00:00,1.27,0.66,0.93,201,224,178,27,15,12,31,12,19,17,5,12,-1,+1,-2,79%,79%,79%,135,149,123,18%,24%,12%,5,2,3,6,1,5
41,https://vlr.gg/player/26757/otaq,2024-06-27 19:00:00,0.97,1.10,1.03,198,192,193,53,26,27,59,34,25,42,23,19,-2,0,-2,73%,72%,74%,125,124,127,22%,23%,20%,3,2,1,5,2,3
42,https://vlr.gg/player/10718/rowancy,2024-06-27 19:00:00,0.75,1.20,0.94,174,143,223,55,24,31,57,34,23,10,6,4,+3,0,+3,62%,62%,63%,116,94,142,22%,20%,24%,7,1,6,4,1,3
43,https://vlr.gg/player/10556/drakk,2024-06-27 19:00:00,0.78,1.15,0.92,218,194,257,64,31,33,69,42,27,14,8,6,-10,-15,+5,61%,53%,71%,138,121,159,36%,38%,35%,15,5,10,25,20,5
44,https://vlr.gg/player/15931/peloncito,2024-06-27 19:00:00,1.09,0.71,0.92,166,190,143,51,32,19,62,34,28,27,13,14,-3,-3,0,67%,66%,68%,114,127,98,33%,36%,27%,6,3,3,9,6,3
45,https://vlr.gg/player/2753/bandicoot,2024-06-27 19:00:00,0.78,0.77,0.77,145,143,147,42,22,20,63,36,27,26,18,8,-3,-5,+2,69%,68%,71%,90,90,90,21%,23%,18%,4,1,3,7,6,1
46,https://vlr.gg/player/1294/nagz,2024-06-27 19:00:00,1.12,1.40,1.27,226,213,235,71,29,42,46,26,20,17,7,10,+4,+1,+3,78%,71%,83%,147,140,152,31%,35%,28%,14,6,8,10,5,5
47,https://vlr.gg/player/2468/delz1k,2024-06-27 19:00:00,0.90,1.26,1.10,212,148,261,65,21,44,55,25,30,36,17,19,+3,-2,+5,75%,68%,81%,128,92,157,16%,11%,19%,5,0,5,2,2,0
48,https://vlr.gg/player/8892/snw,2024-06-27 19:00:00,1.06,1.00,1.03,232,270,207,69,35,34,58,29,29,11,5,6,+7,0,+7,65%,58%,70%,158,177,143,29%,36%,22%,20,8,12,13,8,5
49,https://vlr.gg/player/2464/suther,2024-06-27 19:00:00,0.88,1.13,1.02,188,164,201,53,22,31,54,27,27,44,16,28,+3,-2,+5,84%,79%,87%,122,114,129,23%,28%,20%,7,1,6,4,3,1
50,https://vlr.gg/player/783/murizzz,2024-06-27 19:00:00,1.01,0.90,0.95,170,170,168,52,23,29,52,23,29,21,10,11,-2,-5,+3,74%,71%,77%,113,112,114,27%,31%,24%,4,0,4,6,5,1
51,https://vlr.gg/player/612/mitch,2024-06-27 18:10:00,0.88,1.22,1.06,220,180,258,40,15,25,44,23,21,37,16,21,+5,-1,+6,73%,66%,81%,132,108,154,32%,29%,34%,9,2,7,4,3,1
52,https://vlr.gg/player/21668/verno,2024-06-27 18:10:00,1.07,1.03,1.05,171,183,162,36,20,16,35,17,18,25,14,11,0,-1,+1,78%,76%,81%,115,106,124,36%,33%,38%,2,1,1,2,2,0
53,https://vlr.gg/player/11118/skuba,2024-06-27 18:10:00,1.04,1.03,1.03,195,195,188,43,20,23,42,22,20,14,8,6,+5,+1,+4,75%,79%,71%,123,130,116,30%,39%,24%,7,2,5,2,1,1
54,https://vlr.gg/player/454/dapr,2024-06-27 18:10:00,1.01,0.96,0.98,192,208,170,38,19,19,42,24,18,19,12,7,-2,0,-2,70%,79%,61%,130,147,114,19%,22%,15%,4,2,2,6,2,4
55,https://vlr.gg/player/8419/reduxx,2024-06-27 18:10:00,0.51,1.18,0.85,193,137,234,38,13,25,42,23,19,5,1,4,0,-6,+6,62%,41%,81%,120,85,154,17%,21%,13%,12,4,8,12,10,2
56,https://vlr.gg/player/260/corey,2024-06-27 18:10:00,1.01,1.35,1.18,238,216,281,52,23,29,41,23,18,19,9,10,+1,-4,+5,75%,68%,83%,158,141,176,32%,26%,40%,11,5,6,10,9,1
57,https://vlr.gg/player/1856/wedid,2024-06-27 18:10:00,0.99,1.03,1.01,176,157,194,37,18,19,38,19,19,19,6,13,-1,-3,+2,77%,68%,86%,110,101,119,30%,29%,31%,4,0,4,5,3,2
58,https://vlr.gg/player/844/bdog,2024-06-27 18:10:00,0.84,1.11,0.97,192,180,213,45,22,23,41,25,16,12,7,5,-9,-7,-2,70%,65%,76%,116,99,135,25%,36%,17%,3,1,2,12,8,4
59,https://vlr.gg/player/4931/add3r,2024-06-27 18:10:00,0.95,0.96,0.96,181,171,185,38,18,20,38,21,17,15,9,6,+2,-1,+3,72%,68%,76%,117,118,115,32%,31%,34%,7,2,5,5,3,2
60,https://vlr.gg/player/733/stellar,2024-06-27 18:10:00,0.82,0.84,0.83,136,126,157,32,14,18,37,21,16,19,13,6,-1,0,-1,72%,71%,72%,98,89,108,20%,15%,25%,1,0,1,2,0,2
61,https://vlr.gg/player/8373/okeanos,2024-06-27 16:00:00,2.18,1.49,1.71,370,520,307,49,20,29,22,7,15,11,5,6,+7,+3,+4,97%,100%,96%,230,324,187,29%,34%,24%,9,5,4,2,2,0
62,https://vlr.gg/player/8422/spaz,2024-06-27 16:00:00,1.99,1.34,1.54,269,318,234,30,14,16,16,3,13,23,6,17,+3,+1,+2,89%,91%,88%,183,197,177,17%,33%,12%,5,1,4,2,0,2
63,https://vlr.gg/player/3874/teague,2024-06-27 16:00:00,1.42,1.31,1.34,214,183,232,28,7,21,19,4,15,21,9,12,+2,-2,+4,83%,91%,79%,135,118,143,25%,30%,24%,5,0,5,3,2,1
64,https://vlr.gg/player/4385/monsi,2024-06-27 16:00:00,1.37,1.24,1.28,187,165,203,26,8,18,15,3,12,15,4,11,0,0,0,83%,91%,79%,111,77,127,22%,27%,21%,1,0,1,1,0,1
65,https://vlr.gg/player/29688/mikee,2024-06-27 16:00:00,0.85,1.15,1.05,186,93,225,26,5,21,19,4,15,3,0,3,+5,-1,+6,91%,82%,96%,117,61,143,38%,75%,31%,6,0,6,1,1,0
66,https://vlr.gg/player/765/jerk,2024-06-27 16:00:00,0.69,1.63,0.98,188,120,340,22,11,11,28,18,10,3,2,1,0,-3,+3,49%,50%,45%,132,83,238,32%,23%,41%,4,1,3,4,4,0
67,https://vlr.gg/player/17865/nahsie,2024-06-27 16:00:00,0.97,0.58,0.85,244,262,184,27,22,5,35,24,11,11,7,4,+1,0,+1,66%,75%,45%,148,161,122,30%,28%,33%,3,2,1,2,2,0
68,https://vlr.gg/player/3227/screwface,2024-06-27 16:00:00,0.80,0.07,0.56,140,186,53,17,15,2,31,20,11,5,5,0,-5,-3,-2,49%,58%,27%,104,134,38,28%,25%,50%,1,0,1,6,3,3
69,https://vlr.gg/player/2118/silenx,2024-06-27 16:00:00,0.68,0.02,0.41,107,155,12,11,11,0,32,21,11,14,12,2,-5,-3,-2,46%,58%,18%,70,99,7,31%,33%,0%,0,0,0,5,3,2
70,https://vlr.gg/player/9063/infiltrator,2024-06-27 16:00:00,0.52,0.11,0.39,115,139,74,14,11,3,33,22,11,6,6,0,-8,-7,-1,46%,50%,36%,76,93,39,20%,26%,0%,1,1,0,9,8,1
71,https://vlr.gg/player/98/ardiis,2024-06-27 14:00:00,1.33,0.76,1.04,212,267,156,32,19,13,33,16,17,13,5,8,0,-1,+1,70%,71%,68%,140,171,111,27%,33%,18%,6,3,3,6,4,2
72,https://vlr.gg/player/384/shao,2024-06-27 14:00:00,0.28,1.46,0.88,178,61,289,27,4,23,37,20,17,19,12,7,+2,-1,+3,70%,62%,77%,111,31,188,37%,33%,37%,3,0,3,1,1,0
73,https://vlr.gg/player/2858/suygetsu,2024-06-27 14:00:00,0.79,0.91,0.85,174,198,153,26,13,13,32,18,14,5,3,2,+4,+3,+1,67%,67%,68%,118,133,104,26%,24%,29%,4,3,1,0,0,0
74,https://vlr.gg/player/11/zyppan,2024-06-27 14:00:00,0.58,0.93,0.76,177,158,196,27,12,15,35,18,17,17,6,11,-4,-5,+1,63%,67%,59%,116,107,124,27%,39%,18%,6,2,4,10,7,3
75,https://vlr.gg/player/109/ange1,2024-06-27 14:00:00,0.76,0.69,0.73,151,126,176,22,10,12,33,16,17,12,2,10,-7,-1,-6,58%,52%,64%,111,94,127,27%,38%,22%,0,0,0,7,1,6
76,https://vlr.gg/player/1885/purp0,2024-06-27 14:00:00,1.32,1.49,1.40,311,317,303,48,25,23,29,16,13,8,3,5,+3,+1,+2,77%,73%,81%,204,212,194,36%,42%,29%,10,6,4,7,5,2
77,https://vlr.gg/player/1427/redgar,2024-06-27 14:00:00,1.45,1.07,1.26,205,234,175,34,21,13,26,14,12,24,9,15,+4,+1,+3,86%,73%,100%,132,148,116,44%,45%,42%,6,2,4,2,1,1
78,https://vlr.gg/player/4181/cloud,2024-06-27 14:00:00,0.93,1.31,1.12,208,170,250,28,11,17,25,14,11,20,10,10,-2,0,-2,74%,73%,76%,145,115,176,17%,9%,21%,3,1,2,5,1,4
79,https://vlr.gg/player/2690/hoody,2024-06-27 14:00:00,0.75,1.40,1.07,181,119,247,30,10,20,27,16,11,13,5,8,-3,-2,-1,77%,68%,86%,128,100,157,25%,14%,34%,0,0,0,3,2,1
80,https://vlr.gg/player/292/fit1nho,2024-06-27 14:00:00,0.89,1.21,1.05,191,187,196,30,15,15,27,16,11,20,11,9,+3,0,+3,81%,77%,86%,119,109,129,25%,29%,22%,5,2,3,2,2,0
81,https://vlr.gg/player/16459/elite,2024-06-27 12:00:00,1.12,1.77,1.44,233,207,262,32,14,18,17,11,6,9,6,3,+3,+2,+1,84%,79%,89%,161,135,188,37%,32%,40%,3,2,1,0,0,0
82,https://vlr.gg/player/8041/brave,2024-06-27 12:00:00,1.40,1.11,1.26,228,240,214,32,17,15,21,10,11,11,8,3,+4,+2,+2,73%,74%,72%,153,171,135,32%,31%,34%,7,2,5,3,0,3
83,https://vlr.gg/player/569/paura,2024-06-27 12:00:00,1.35,0.78,1.07,167,208,125,22,15,7,22,11,11,24,12,12,+1,0,+1,76%,84%,67%,99,119,77,30%,37%,23%,4,2,2,3,2,1
84,https://vlr.gg/player/10161/qutionerx,2024-06-27 12:00:00,0.72,1.35,1.03,271,234,308,33,14,19,30,16,14,11,2,9,+5,+4,+1,76%,74%,78%,171,144,200,30%,36%,26%,10,7,3,5,3,2
85,https://vlr.gg/player/10146/reazy,2024-06-27 12:00:00,0.67,1.10,0.88,162,120,208,23,9,14,22,12,10,9,4,5,+2,+1,+1,70%,68%,72%,107,81,135,48%,40%,54%,2,1,1,0,0,0
86,https://vlr.gg/player/457/nats,2024-06-27 12:00:00,1.03,1.02,1.03,212,238,189,28,15,13,26,15,11,16,7,9,+2,0,+2,78%,83%,74%,133,156,112,32%,34%,29%,4,1,3,2,1,1
87,https://vlr.gg/player/114/enzo,2024-06-27 12:00:00,0.53,1.19,0.86,178,113,236,20,5,15,27,15,12,11,9,2,-2,-2,0,70%,61%,79%,115,70,158,14%,6%,17%,0,0,0,2,2,0
88,https://vlr.gg/player/9780/jamppi,2024-06-27 12:00:00,1.20,0.46,0.82,154,220,94,18,13,5,29,14,15,6,3,3,-4,0,-4,57%,78%,37%,109,151,70,24%,28%,17%,2,2,0,6,2,4
89,https://vlr.gg/player/1457/mistic,2024-06-27 12:00:00,0.46,1.07,0.77,177,119,230,22,7,15,29,15,14,12,7,5,-4,-2,-2,70%,61%,79%,119,78,157,30%,41%,26%,0,0,0,4,2,2
90,https://vlr.gg/player/11494/keiko,2024-06-27 12:00:00,0.78,0.71,0.74,173,159,186,24,12,12,31,14,17,4,1,3,-7,-2,-5,62%,56%,68%,109,83,133,28%,22%,32%,5,3,2,12,5,7
91,https://vlr.gg/player/21840/lilhieu,2024-06-27 09:25:00,0.90,1.49,1.13,240,225,269,82,47,35,75,51,24,28,15,13,+6,-1,+7,77%,73%,82%,156,141,181,20%,17%,24%,17,8,9,11,9,2
92,https://vlr.gg/player/8166/nh0zkon,2024-06-27 09:25:00,0.96,1.12,1.02,205,178,260,73,37,36,74,43,31,26,15,11,-4,-3,-1,68%,63%,76%,137,118,167,28%,32%,24%,8,5,3,12,8,4
93,https://vlr.gg/player/44142/dafam1,2024-06-27 09:25:00,0.94,0.90,0.91,194,206,180,67,42,25,74,49,25,32,21,11,-11,-5,-6,68%,67%,71%,127,132,120,22%,25%,18%,6,5,1,17,10,7
94,https://vlr.gg/player/44444/tyson,2024-06-27 09:25:00,0.92,0.91,0.91,165,190,129,59,41,18,68,45,23,30,14,16,-4,-1,-3,66%,67%,66%,106,115,92,31%,34%,26%,7,5,2,11,6,5
95,https://vlr.gg/player/2440/bmv,2024-06-27 09:25:00,0.76,1.10,0.89,171,149,216,56,28,28,73,47,26,36,24,12,+1,0,+1,68%,65%,74%,117,105,136,29%,29%,29%,5,2,3,4,2,2
96,https://vlr.gg/player/41536/hansia,2024-06-27 09:25:00,1.22,1.56,1.43,296,267,320,106,36,70,66,27,39,19,9,10,+6,-1,+7,73%,68%,77%,195,172,209,30%,30%,31%,21,7,14,15,8,7
97,https://vlr.gg/player/41538/bobae,2024-06-27 09:25:00,1.06,1.31,1.20,230,193,252,82,27,55,63,26,37,27,9,18,+5,+4,+1,74%,68%,78%,155,125,174,33%,38%,30%,9,5,4,4,1,3
98,https://vlr.gg/player/24419/palette,2024-06-27 09:25:00,0.88,0.99,0.95,174,170,171,57,22,35,64,27,37,39,15,24,+2,0,+2,78%,79%,77%,108,108,109,22%,16%,27%,5,0,5,3,0,3
99,https://vlr.gg/player/41535/bioforst,2024-06-27 09:25:00,0.87,0.86,0.86,193,200,187,62,26,36,73,32,41,22,9,13,0,-2,+2,70%,66%,73%,130,129,131,27%,36%,22%,13,5,8,13,7,6
100,https://vlr.gg/player/41537/bbc,2024-06-27 09:25:00,0.52,0.92,0.76,167,138,186,57,18,39,71,30,41,33,10,23,-1,+1,-2,67%,58%,73%,112,93,124,38%,39%,37%,7,3,4,8,2,6
101,https://vlr.gg/player/23930/potter,2024-06-27 09:20:00,0.91,1.13,1.02,252,235,261,51,21,30,51,22,29,6,4,2,+2,-3,+5,71%,69%,73%,163,160,165,24%,26%,21%,15,6,9,13,9,4
102,https://vlr.gg/player/2368/b3ta,2024-06-27 09:20:00,1.13,0.86,0.98,190,233,168,37,19,18,45,20,25,21,13,8,+3,+4,-1,69%,77%,64%,126,152,105,27%,25%,30%,7,4,3,4,0,4
103,https://vlr.gg/player/12289/siraww,2024-06-27 09:20:00,0.88,0.93,0.91,180,181,183,38,17,21,47,20,27,25,11,14,0,+1,-1,75%,73%,76%,123,123,123,30%,28%,32%,2,2,0,2,1,1
104,https://vlr.gg/player/2366/alert,2024-06-27 09:20:00,1.08,0.65,0.84,159,181,151,34,19,15,44,17,27,11,3,8,-1,+3,-4,69%,73%,67%,117,126,111,36%,50%,27%,5,3,2,6,0,6
105,https://vlr.gg/player/10791/bnwgiggs,2024-06-27 09:20:00,1.00,0.51,0.73,141,147,149,28,13,15,45,14,31,27,12,15,-3,+1,-4,68%,73%,64%,109,114,105,31%,32%,30%,1,1,0,4,0,4
106,https://vlr.gg/player/19150/niffy,2024-06-27 09:20:00,1.83,1.57,1.72,348,342,331,70,42,28,34,18,16,17,8,9,+7,+7,0,85%,91%,77%,215,224,204,26%,28%,24%,13,9,4,6,2,4
107,https://vlr.gg/player/23918/reality,2024-06-27 09:20:00,1.21,1.16,1.18,228,250,208,51,31,20,37,20,17,15,7,8,+1,+1,0,76%,82%,69%,145,150,140,28%,31%,23%,6,5,1,5,4,1
108,https://vlr.gg/player/1910/acetics,2024-06-27 09:20:00,1.41,0.82,1.15,199,218,172,43,28,15,34,15,19,17,9,8,-5,-2,-3,78%,82%,73%,126,134,117,26%,30%,20%,4,2,2,9,4,5
109,https://vlr.gg/player/2390/pinocchios,2024-06-27 09:20:00,0.84,1.05,0.93,187,172,209,37,19,18,40,23,17,23,15,8,-2,-1,-1,81%,82%,81%,142,133,153,31%,31%,30%,1,1,0,3,2,1
110,https://vlr.gg/player/6733/xze,2024-06-27 09:20:00,0.80,0.58,0.70,152,159,141,31,19,12,43,23,20,25,17,8,-2,0,-2,61%,70%,50%,94,100,86,49%,45%,57%,5,2,3,7,2,5
111,https://vlr.gg/player/8137/lenne,2024-06-27 09:00:00,1.77,1.63,1.71,322,308,319,42,26,16,21,10,11,16,8,8,+2,0,+2,82%,91%,69%,219,210,233,40%,32%,54%,8,3,5,6,3,3
112,https://vlr.gg/player/24654/tempz,2024-06-27 09:00:00,1.84,0.63,1.35,247,320,140,36,29,7,24,11,13,17,14,3,0,-1,+1,77%,91%,56%,148,185,94,26%,21%,45%,1,0,1,1,1,0
113,https://vlr.gg/player/11737/xan,2024-06-27 09:00:00,1.21,1.11,1.17,235,255,229,32,20,12,28,16,12,13,8,5,-2,0,-2,85%,87%,81%,166,163,170,24%,27%,20%,6,6,0,8,6,2
114,https://vlr.gg/player/2381/divine,2024-06-27 09:00:00,1.24,0.99,1.14,167,163,159,24,14,10,20,10,10,21,15,6,+1,+2,-1,82%,91%,69%,101,103,97,37%,45%,27%,4,2,2,3,0,3
115,https://vlr.gg/player/9158/hyk,2024-06-27 09:00:00,1.17,0.83,1.03,169,177,153,26,17,9,22,10,12,9,4,5,0,0,0,74%,74%,75%,109,121,93,25%,26%,22%,1,1,0,1,1,0
116,https://vlr.gg/player/3023/moosey,2024-06-27 09:00:00,1.00,1.01,1.01,236,265,219,31,14,17,32,13,19,10,6,4,+5,+2,+3,67%,69%,65%,147,167,133,22%,22%,23%,9,3,6,4,1,3
117,https://vlr.gg/player/36687/miz,2024-06-27 09:00:00,1.14,0.61,0.83,178,184,191,23,10,13,32,9,23,9,6,3,-1,-1,0,59%,81%,43%,142,131,150,26%,46%,17%,4,1,3,5,2,3
118,https://vlr.gg/player/26965/haeart,2024-06-27 09:00:00,0.91,0.61,0.74,185,211,162,24,12,12,33,13,20,8,4,4,0,+2,-2,72%,81%,65%,130,140,123,23%,25%,22%,4,3,1,4,1,3
119,https://vlr.gg/player/7448/toy,2024-06-27 09:00:00,1.36,0.20,0.67,119,214,61,19,14,5,29,8,21,11,6,5,-2,0,-2,62%,81%,48%,83,137,46,22%,17%,35%,1,1,0,3,1,2
120,https://vlr.gg/player/26969/adept,2024-06-27 09:00:00,0.60,0.48,0.53,144,108,147,18,8,10,34,11,23,8,2,6,-3,-3,0,59%,63%,57%,91,76,102,33%,40%,29%,1,0,1,4,3,1
121,https://vlr.gg/player/27172/jacobbb,2024-06-27 08:45:00,1.13,0.93,1.02,212,222,211,34,16,18,34,13,21,6,2,4,+3,+2,+1,70%,84%,60%,130,131,129,26%,33%,21%,4,3,1,1,1,0
122,https://vlr.gg/player/27171/grooovy,2024-06-27 08:45:00,0.82,1.14,1.00,229,163,270,29,9,20,34,13,21,15,5,10,0,-1,+1,70%,74%,68%,165,115,204,16%,8%,20%,4,0,4,4,1,3
123,https://vlr.gg/player/10190/gabbydiz,2024-06-27 08:45:00,1.23,0.65,0.90,193,279,140,31,19,12,35,15,20,11,5,6,0,+1,-1,68%,84%,56%,119,162,87,35%,41%,28%,4,2,2,4,1,3
124,https://vlr.gg/player/19975/yort,2024-06-27 08:45:00,0.97,0.62,0.78,159,202,126,22,13,9,32,12,20,14,7,7,-1,0,-1,55%,63%,48%,112,133,95,19%,19%,20%,3,2,1,4,2,2
125,https://vlr.gg/player/27173/sovano,2024-06-27 08:45:00,0.80,0.65,0.71,149,184,125,23,13,10,34,15,19,5,2,3,-4,-1,-3,66%,79%,56%,111,129,97,28%,33%,24%,6,3,3,10,4,6
126,https://vlr.gg/player/13219/papi,2024-06-27 08:45:00,1.80,1.17,1.53,248,277,200,41,28,13,23,10,13,26,8,18,+4,+4,0,80%,88%,68%,144,166,115,34%,38%,28%,5,4,1,1,0,1
127,https://vlr.gg/player/13220/ja,2024-06-27 08:45:00,1.24,1.27,1.25,237,240,235,38,22,16,27,14,13,9,5,4,-3,-1,-2,73%,76%,68%,161,155,168,24%,23%,28%,6,4,2,9,5,4
128,https://vlr.gg/player/7749/nexi,2024-06-27 08:45:00,1.14,1.11,1.13,229,198,243,33,17,16,31,14,17,16,8,8,+1,0,+1,70%,76%,63%,142,128,161,28%,35%,21%,4,2,2,3,2,1
129,https://vlr.gg/player/16842/mojer,2024-06-27 08:45:00,1.24,0.82,1.06,239,291,190,38,25,13,31,17,14,12,7,5,+1,+1,0,82%,80%,84%,183,218,138,17%,18%,15%,7,4,3,6,3,3
130,https://vlr.gg/player/9747/emman,2024-06-27 08:45:00,0.72,0.85,0.78,134,117,162,19,9,10,27,14,13,14,8,6,-1,-1,0,77%,80%,74%,91,85,99,32%,21%,48%,1,0,1,2,1,1
131,https://vlr.gg/player/1771/myth,2024-06-27 07:35:00,1.79,1.18,1.51,275,338,199,44,28,16,27,14,13,16,11,5,+6,+5,+1,84%,91%,75%,170,213,120,30%,34%,24%,7,5,2,1,0,1
132,https://vlr.gg/player/15081/maishiu,2024-06-27 07:35:00,1.26,1.14,1.21,206,219,191,29,17,12,25,14,11,13,5,8,+3,+1,+2,74%,70%,80%,144,156,131,23%,26%,19%,4,1,3,1,0,1
133,https://vlr.gg/player/31580/vizsla,2024-06-27 07:35:00,0.76,1.28,1.00,228,174,289,34,14,20,32,18,14,6,3,3,+4,+2,+2,77%,74%,80%,148,117,184,27%,21%,30%,5,3,2,1,1,0
134,https://vlr.gg/player/22816/blessed,2024-06-27 07:35:00,0.96,1.01,0.98,187,192,187,27,17,10,31,17,14,23,10,13,-4,+1,-5,74%,74%,75%,125,126,125,23%,20%,28%,3,2,1,7,1,6
135,https://vlr.gg/player/36747/bonobo,2024-06-27 07:35:00,0.80,1.15,0.96,191,194,183,30,17,13,28,17,11,4,2,2,+2,+2,0,74%,74%,75%,130,136,124,21%,29%,14%,8,6,2,6,4,2
136,https://vlr.gg/player/5210/amnesty,2024-06-27 07:35:00,0.94,1.39,1.18,220,186,250,34,13,21,29,14,15,22,10,12,-2,0,-2,79%,80%,78%,140,124,153,28%,41%,21%,1,1,0,3,1,2
137,https://vlr.gg/player/31632/zenox,2024-06-27 07:35:00,0.99,0.91,0.95,240,224,251,31,15,16,36,15,21,17,6,11,-2,-1,-1,72%,70%,74%,165,141,185,25%,27%,25%,7,4,3,9,5,4
138,https://vlr.gg/player/22826/phequa,2024-06-27 07:35:00,0.81,0.89,0.85,214,204,222,34,14,20,35,16,19,6,4,2,-2,+1,-3,58%,65%,52%,138,134,141,22%,24%,21%,7,4,3,9,3,6
139,https://vlr.gg/player/12964/jawsy,2024-06-27 07:35:00,0.71,0.90,0.81,166,119,212,24,8,16,33,15,18,18,11,7,-6,-1,-5,67%,65%,70%,112,86,135,32%,33%,31%,0,0,0,6,1,5
140,https://vlr.gg/player/3287/exempt,2024-06-27 07:35:00,1.12,0.50,0.79,146,166,128,19,12,7,31,12,19,24,12,12,+1,+1,0,77%,80%,74%,97,108,86,20%,21%,20%,1,1,0,0,0,0
141,https://vlr.gg/player/23896/itaoearth,2024-06-27 07:00:00,1.09,1.23,1.17,207,202,211,35,15,20,32,14,18,13,8,5,+1,0,+1,74%,81%,68%,136,129,142,34%,35%,33%,2,1,1,1,1,0
142,https://vlr.gg/player/27225/d4rf,2024-06-27 07:00:00,0.54,1.34,0.98,262,199,308,40,14,26,41,19,22,7,2,5,+4,-3,+7,70%,62%,76%,156,121,185,25%,29%,22%,16,7,9,12,10,2
143,https://vlr.gg/player/31495/umaruchans,2024-06-27 07:00:00,1.39,0.59,0.96,183,251,141,30,20,10,33,13,20,9,4,5,+5,+2,+3,67%,76%,60%,129,168,96,26%,27%,23%,6,2,4,1,0,1
144,https://vlr.gg/player/31497/allr1ghtt,2024-06-27 07:00:00,0.71,0.70,0.71,179,158,194,25,11,14,36,14,22,12,6,6,-1,0,-1,70%,71%,68%,123,111,133,26%,29%,25%,2,0,2,3,0,3
145,https://vlr.gg/player/46554/sontaya,2024-06-27 07:00:00,0.74,0.68,0.71,121,111,132,20,8,12,32,13,19,16,10,6,-1,0,-1,70%,71%,68%,83,65,98,32%,26%,36%,1,0,1,2,0,2
146,https://vlr.gg/player/40511/niz,2024-06-27 07:00:00,1.24,1.43,1.33,236,229,273,43,23,20,28,15,13,16,8,8,0,-2,+2,83%,84%,81%,157,153,161,41%,43%,40%,4,0,4,4,2,2
147,https://vlr.gg/player/8581/raigard,2024-06-27 07:00:00,1.09,1.20,1.14,209,212,193,31,17,14,30,17,13,25,19,6,-2,-2,0,70%,80%,57%,135,136,133,38%,35%,43%,3,1,2,5,3,2
148,https://vlr.gg/player/37547/tbloy,2024-06-27 07:00:00,0.97,1.28,1.11,256,264,235,38,21,17,33,20,13,12,5,7,-2,-3,+1,83%,84%,81%,169,178,159,24%,20%,30%,8,4,4,10,7,3
149,https://vlr.gg/player/1908/kongared,2024-06-27 07:00:00,1.05,0.93,1.00,188,201,167,30,18,12,29,16,13,22,11,11,-2,-1,-1,78%,72%,86%,125,141,107,30%,27%,33%,3,2,1,5,3,2
150,https://vlr.gg/player/4376/santagolf,2024-06-27 07:00:00,1.21,0.73,0.99,177,211,145,31,21,10,30,15,15,12,7,5,-2,-1,-1,78%,88%,67%,109,127,86,19%,19%,19%,1,1,0,3,2,1
151,https://vlr.gg/player/3520/zmjjkk,2024-06-27 07:00:00,,,,311,,,45,,,34,,,12,,,+3,,,,,,197,,,18%,,,9,,,6,,
152,https://vlr.gg/player/15559/chichoo,2024-06-27 07:00:00,,,,189,,,29,,,30,,,17,,,-2,,,,,,134,,,27%,,,0,,,2,,
153,https://vlr.gg/player/4742/smoggy,2024-06-27 07:00:00,,,,159,,,23,,,33,,,6,,,-1,,,,,,100,,,24%,,,4,,,5,,
154,https://vlr.gg/player/13768/s1mon,2024-06-27 07:00:00,,,,156,,,24,,,32,,,29,,,0,,,,,,89,,,41%,,,3,,,3,,
155,https://vlr.gg/player/3017/nobody,2024-06-27 07:00:00,,,,141,,,18,,,33,,,17,,,-2,,,,,,96,,,17%,,,4,,,6,,
156,https://vlr.gg/player/3741/vo0kashu,2024-06-27 07:00:00,,,,342,,,54,,,25,,,18,,,+4,,,,,,197,,,30%,,,6,,,2,,
157,https://vlr.gg/player/41774/shion7,2024-06-27 07:00:00,,,,232,,,33,,,28,,,10,,,-2,,,,,,162,,,28%,,,3,,,5,,
158,https://vlr.gg/player/7841/tvirusluke,2024-06-27 07:00:00,,,,223,,,30,,,33,,,14,,,+3,,,,,,145,,,20%,,,9,,,6,,
159,https://vlr.gg/player/4880/nizhaotzh,2024-06-27 07:00:00,,,,158,,,21,,,29,,,28,,,-1,,,,,,104,,,24%,,,3,,,4,,
160,https://vlr.gg/player/11524/nicc,2024-06-27 07:00:00,,,,151,,,24,,,24,,,20,,,-2,,,,,,98,,,27%,,,1,,,3,,
161,https://vlr.gg/player/24628/wayne,2024-06-27 07:00:00,1.36,1.79,1.56,271,232,328,35,17,18,18,8,10,10,3,7,+2,-2,+4,82%,78%,88%,185,154,220,28%,26%,30%,5,1,4,3,3,0
162,https://vlr.gg/player/24653/vera,2024-06-27 07:00:00,1.33,1.56,1.44,288,314,253,36,20,16,18,12,6,4,3,1,+5,+1,+4,76%,78%,75%,202,214,188,31%,23%,47%,9,3,6,4,2,2
163,https://vlr.gg/player/34032/grumble,2024-06-27 07:00:00,1.59,1.06,1.34,217,271,147,28,18,10,15,9,6,13,9,4,+1,0,+1,91%,94%,88%,143,175,107,43%,40%,50%,2,1,1,1,1,0
164,https://vlr.gg/player/11704/styron,2024-06-27 07:00:00,1.06,1.27,1.16,182,158,209,23,10,13,17,10,7,7,3,4,+4,+2,+2,74%,72%,75%,123,111,137,17%,21%,14%,4,2,2,0,0,0
165,https://vlr.gg/player/7426/juicy,2024-06-27 07:00:00,0.66,1.03,0.83,188,177,199,22,11,11,25,15,10,11,4,7,0,+1,-1,68%,67%,69%,127,110,147,37%,24%,54%,3,3,0,3,2,1
166,https://vlr.gg/player/9171/kairo,2024-06-27 07:00:00,1.32,1.03,1.22,284,272,309,17,11,6,14,9,5,6,5,1,-1,-2,+1,61%,67%,50%,181,174,195,27%,30%,22%,1,0,1,2,2,0
167,https://vlr.gg/player/16942/reverie,2024-06-27 07:00:00,0.78,0.74,0.76,167,141,194,17,7,10,28,13,15,5,3,2,+2,0,+2,62%,56%,67%,113,91,133,35%,26%,43%,3,0,3,1,0,1
168,https://vlr.gg/player/7007/shinsei,2024-06-27 07:00:00,0.65,0.82,0.74,208,199,211,24,10,14,30,15,15,1,1,0,-5,-5,0,53%,38%,67%,131,127,136,25%,15%,38%,7,3,4,12,8,4
169,https://vlr.gg/player/27073/esmonde,2024-06-27 07:00:00,0.36,0.90,0.64,138,74,191,16,4,12,26,13,13,8,3,5,-5,-2,-3,62%,56%,67%,89,49,126,15%,12%,17%,0,0,0,5,2,3
170,https://vlr.gg/player/27053/ender,2024-06-27 07:00:00,0.38,0.63,0.57,141,147,140,7,2,5,14,4,10,4,2,2,-3,-1,-2,56%,75%,50%,98,88,102,33%,43%,30%,0,0,0,3,1,2
171,https://vlr.gg/player/19126/kayle,2024-06-27 07:00:00,0.45,0.46,0.46,130,114,141,12,5,7,32,14,18,3,2,1,0,0,0,44%,56%,33%,94,87,101,18%,22%,16%,0,0,0,0,0,0
172,https://vlr.gg/player/27775/techno,2024-06-27 06:30:00,1.16,1.31,1.24,256,252,251,98,45,53,76,40,36,46,19,27,+17,+6,+11,80%,75%,84%,161,166,157,30%,29%,31%,23,9,14,6,3,3
173,https://vlr.gg/player/7434/d1srupt,2024-06-27 06:30:00,0.89,1.21,1.06,214,189,233,85,35,50,75,41,34,26,14,12,+1,-4,+5,72%,63%,79%,146,135,156,33%,35%,31%,11,2,9,10,6,4
174,https://vlr.gg/player/3627/hellff,2024-06-27 06:30:00,0.88,1.17,1.03,208,167,237,78,30,48,74,37,37,35,13,22,-5,-3,-2,75%,63%,84%,135,110,156,33%,35%,32%,5,1,4,10,4,6
175,https://vlr.gg/player/9741/aryu,2024-06-27 06:30:00,1.00,1.01,1.00,195,204,190,78,39,39,70,39,31,25,9,16,+2,+2,0,75%,69%,79%,135,139,132,19%,23%,17%,5,2,3,3,0,3
176,https://vlr.gg/player/3628/deathmaker,2024-06-27 06:30:00,0.65,1.06,0.87,191,172,206,76,34,42,78,41,37,13,4,9,-5,-7,+2,68%,60%,76%,126,109,142,28%,31%,25%,16,9,7,21,16,5
177,https://vlr.gg/player/27336/venka,2024-06-27 06:30:00,0.97,1.26,1.11,255,237,274,96,47,49,89,49,40,15,4,11,-1,-2,+1,66%,60%,73%,165,148,183,30%,32%,27%,20,11,9,21,13,8
178,https://vlr.gg/player/9263/sayoo,2024-06-27 06:30:00,0.83,1.08,0.94,175,167,188,68,33,35,78,45,33,33,16,17,-12,-9,-3,65%,59%,71%,125,116,135,28%,23%,35%,3,1,2,15,10,5
179,https://vlr.gg/player/3639/hoax,2024-06-27 06:30:00,0.87,1.02,0.94,171,164,179,63,31,32,79,44,35,48,21,27,+1,-4,+5,74%,67%,81%,113,109,118,20%,19%,21%,7,1,6,6,5,1
180,https://vlr.gg/player/1745/adrnking,2024-06-27 06:30:00,0.71,1.16,0.92,193,146,259,78,30,48,87,49,38,32,14,18,+4,-1,+5,70%,55%,87%,128,98,160,33%,42%,29%,12,4,8,8,5,3
181,https://vlr.gg/player/10758/kohliii,2024-06-27 06:30:00,0.84,0.97,0.90,178,174,190,67,33,34,82,46,36,31,18,13,-2,0,-2,71%,60%,83%,118,115,122,18%,21%,16%,8,4,4,10,4,6
182,https://vlr.gg/player/46045/aderrr,2024-06-27 06:05:00,1.10,0.84,0.92,183,250,164,22,10,12,27,10,17,7,2,5,+1,+1,0,63%,73%,58%,120,151,106,30%,35%,28%,4,1,3,3,0,3
183,https://vlr.gg/player/9280/padangrice,2024-06-27 06:05:00,0.91,0.73,0.78,168,203,162,20,8,12,31,10,21,7,3,4,+2,0,+2,69%,82%,63%,119,146,106,17%,19%,16%,4,1,3,2,1,1
184,https://vlr.gg/player/23671/mas,2024-06-27 06:05:00,0.37,0.81,0.67,188,119,213,20,4,16,29,10,19,6,3,3,-4,-4,0,54%,45%,58%,118,82,135,7%,13%,6%,3,0,3,7,4,3
185,https://vlr.gg/player/8257/limitado,2024-06-27 06:05:00,0.43,0.76,0.66,163,113,192,21,5,16,29,9,20,3,0,3,-2,-2,0,63%,64%,63%,93,62,107,28%,15%,33%,2,0,2,4,2,2
186,https://vlr.gg/player/34082/tupai,2024-06-27 06:05:00,0.34,0.53,0.45,117,101,124,13,4,9,32,11,21,10,3,7,0,0,0,57%,64%,54%,80,63,87,28%,22%,30%,3,1,2,3,1,2
187,https://vlr.gg/player/23717/nythan,2024-06-27 06:05:00,1.81,1.75,1.79,293,282,283,39,26,13,15,10,5,17,11,6,+4,+3,+1,94%,92%,100%,193,196,185,42%,44%,36%,4,3,1,0,0,0
188,https://vlr.gg/player/37057/woody,2024-06-27 06:05:00,1.57,1.60,1.58,288,277,283,35,24,11,19,13,6,17,11,6,+1,+1,0,86%,88%,82%,191,175,226,33%,36%,29%,2,2,0,1,1,0
189,https://vlr.gg/player/9279/kylee,2024-06-27 06:05:00,1.07,1.40,1.18,215,199,251,29,19,10,21,14,7,7,4,3,+1,0,+1,77%,79%,73%,151,145,162,41%,38%,47%,4,2,2,3,2,1
190,https://vlr.gg/player/34100/scar,2024-06-27 06:05:00,1.02,1.37,1.13,155,125,234,19,10,9,16,10,6,21,14,7,0,-2,+2,83%,79%,91%,96,82,127,49%,37%,75%,2,0,2,2,2,0
191,https://vlr.gg/player/34096/faustao,2024-06-27 06:05:00,0.93,0.84,0.90,211,220,167,26,19,7,25,18,7,7,5,2,-3,-4,+1,71%,71%,73%,135,144,117,22%,20%,29%,7,4,3,10,8,2
192,https://vlr.gg/player/36101/acerola,2024-06-27 06:00:00,1.47,1.14,1.29,236,278,210,64,35,29,47,20,27,24,8,16,+2,-1,+3,72%,74%,70%,148,164,135,41%,47%,35%,6,3,3,4,4,0
193,https://vlr.gg/player/14228/moefcute,2024-06-27 06:00:00,1.15,1.03,1.08,250,251,235,62,31,31,52,24,28,6,3,3,+8,+6,+2,69%,68%,70%,163,166,161,27%,26%,28%,17,10,7,9,4,5
194,https://vlr.gg/player/14224/duct,2024-06-27 06:00:00,0.80,1.05,0.94,174,148,206,45,17,28,53,23,30,32,14,18,-4,-2,-2,70%,74%,68%,113,101,123,23%,21%,24%,5,2,3,9,4,5
195,https://vlr.gg/player/1432/ntk,2024-06-27 06:00:00,0.96,0.92,0.94,191,209,190,50,24,26,55,26,29,16,9,7,+3,0,+3,69%,79%,60%,139,148,130,26%,27%,26%,10,2,8,7,2,5
196,https://vlr.gg/player/3908/akashi,2024-06-27 06:00:00,0.90,0.68,0.78,132,163,127,35,19,16,53,25,28,32,20,12,+1,-1,+2,73%,76%,70%,100,115,88,25%,25%,25%,4,1,3,3,2,1
197,https://vlr.gg/player/23041/louboutin,2024-06-27 06:00:00,1.20,1.06,1.13,224,232,233,62,34,28,51,26,25,11,8,3,-8,-5,-3,65%,68%,62%,162,163,161,41%,41%,42%,3,3,0,11,8,3
198,https://vlr.gg/player/1433/hyzee,2024-06-27 06:00:00,1.04,1.16,1.10,199,159,228,47,22,25,44,22,22,31,14,17,+2,-2,+4,73%,73%,74%,133,118,150,34%,32%,36%,8,2,6,6,4,2
199,https://vlr.gg/player/1431/p1na,2024-06-27 06:00:00,0.88,1.21,1.03,204,164,249,50,23,27,51,25,26,27,14,13,-2,-3,+1,74%,75%,74%,139,113,170,25%,25%,24%,5,1,4,7,4,3
200,https://vlr.gg/player/14227/nhatthong2k,2024-06-27 06:00:00,1.32,0.58,0.98,209,279,131,52,38,14,56,29,27,14,9,5,0,+3,-3,72%,78%,65%,151,194,101,29%,35%,16%,9,6,3,9,3,6
201,https://vlr.gg/player/21807/somethai,2024-06-27 06:00:00,0.90,0.90,0.90,176,161,200,48,24,24,54,29,25,20,14,6,-2,-1,-1,64%,65%,62%,122,112,133,43%,42%,43%,7,4,3,9,5,4
202,https://vlr.gg/player/33801/loydream,2024-06-27 05:10:00,1.17,1.21,1.19,230,244,209,51,26,25,44,23,21,20,13,7,-4,-5,+1,75%,74%,75%,158,170,147,27%,26%,29%,1,0,1,5,5,0
203,https://vlr.gg/player/24737/par-scofield,2024-06-27 05:10:00,1.28,1.06,1.17,237,261,218,52,27,25,46,22,24,13,10,3,+2,0,+2,65%,68%,63%,153,165,141,35%,33%,37%,13,6,7,11,6,5
204,https://vlr.gg/player/44246/repulsive,2024-06-27 05:10:00,1.02,0.90,0.96,190,173,215,40,19,21,47,22,25,27,15,12,+6,+3,+3,79%,81%,78%,132,116,147,33%,30%,36%,9,3,6,3,0,3
205,https://vlr.gg/player/26143/secondlove,2024-06-27 05:10:00,0.70,1.10,0.90,172,141,201,40,16,24,46,23,23,13,4,9,+2,+2,0,81%,74%,88%,110,85,135,25%,29%,23%,6,4,2,4,2,2
206,https://vlr.gg/player/21793/syko,2024-06-27 05:10:00,0.86,0.90,0.88,201,213,191,44,23,21,50,26,24,17,7,10,-7,-3,-4,68%,65%,72%,131,132,131,28%,30%,27%,2,1,1,9,4,5
207,https://vlr.gg/player/13744/patmen,2024-06-27 05:10:00,1.14,1.24,1.19,245,222,276,53,24,29,48,23,25,30,16,14,+1,+1,0,76%,78%,74%,174,155,193,37%,38%,36%,5,2,3,4,1,3
208,https://vlr.gg/player/7746/kevzii,2024-06-27 05:10:00,0.99,1.31,1.15,222,185,263,50,21,29,42,21,21,26,13,13,+1,-3,+4,75%,75%,74%,152,131,173,36%,25%,48%,6,1,5,5,4,1
209,https://vlr.gg/player/9737/kakarot,2024-06-27 05:10:00,1.04,0.90,0.97,235,270,201,53,31,22,47,26,21,7,3,4,+5,+2,+3,70%,72%,68%,150,173,126,16%,19%,11%,12,6,6,7,4,3
210,https://vlr.gg/player/16953/zynd,2024-06-27 05:10:00,0.97,0.93,0.95,204,221,184,44,24,20,45,23,22,12,4,8,-2,0,-2,63%,56%,71%,138,148,128,30%,33%,28%,7,5,2,9,5,4
211,https://vlr.gg/player/13223/micr0,2024-06-27 05:10:00,0.73,0.78,0.75,151,156,140,33,17,16,45,23,22,18,9,9,-4,-2,-2,67%,69%,65%,95,96,95,15%,19%,12%,2,1,1,6,3,3
212,https://vlr.gg/player/476/exy,2024-06-27 04:35:00,0.63,2.06,1.27,211,122,322,32,10,22,23,17,6,16,10,6,+2,0,+2,83%,77%,89%,139,83,207,41%,35%,44%,3,0,3,1,0,1
213,https://vlr.gg/player/482/intro,2024-06-27 04:35:00,0.95,1.56,1.22,236,167,322,36,13,23,24,13,11,7,5,2,+2,-3,+5,80%,68%,94%,149,120,185,47%,45%,49%,6,1,5,4,4,0
214,https://vlr.gg/player/9221/kanade,2024-06-27 04:35:00,1.74,0.59,1.22,274,411,82,35,30,5,27,16,11,9,6,3,+1,0,+1,78%,77%,78%,167,251,64,32%,35%,20%,7,5,2,6,5,1
215,https://vlr.gg/player/1916/free1ng,2024-06-27 04:35:00,1.10,1.25,1.17,227,178,281,31,13,18,24,13,11,15,8,7,0,0,0,85%,82%,89%,144,114,181,29%,29%,29%,3,3,0,3,3,0
216,https://vlr.gg/player/17049/hermes,2024-06-27 04:35:00,0.75,1.60,1.13,157,110,229,24,7,17,23,16,7,29,18,11,+3,+1,+2,85%,82%,89%,110,79,149,29%,23%,33%,5,1,4,2,0,2
217,https://vlr.gg/player/4479/jeong-hi,2024-06-27 04:35:00,0.74,1.17,0.98,217,188,236,29,12,17,31,17,14,9,1,8,+2,+1,+1,70%,56%,82%,141,131,150,33%,28%,35%,3,1,2,1,0,1
218,https://vlr.gg/player/7483/nakji,2024-06-27 04:35:00,0.45,1.18,0.85,179,129,227,27,8,19,31,17,14,11,5,6,-2,-2,0,58%,50%,64%,113,75,145,64%,62%,65%,2,0,2,4,2,2
219,https://vlr.gg/player/24977/beomjun,2024-06-27 04:35:00,0.71,0.84,0.78,156,169,147,21,10,11,30,16,14,9,5,4,+2,0,+2,63%,67%,59%,111,117,107,33%,35%,32%,2,0,2,0,0,0
220,https://vlr.gg/player/25017/ash,2024-06-27 04:35:00,0.63,0.79,0.71,164,180,157,21,10,11,32,17,15,13,5,8,-7,-5,-2,58%,50%,64%,114,114,113,30%,30%,29%,4,2,2,11,7,4
221,https://vlr.gg/player/1963/hate,2024-06-27 04:35:00,0.26,1.02,0.66,156,106,198,23,6,17,34,18,16,3,1,2,-3,-4,+1,53%,44%,59%,109,73,139,38%,30%,44%,5,1,4,8,5,3
222,https://vlr.gg/player/20657/yotaa,2024-06-27 04:30:00,1.66,1.47,1.55,311,349,273,47,22,25,23,11,12,7,6,1,+5,0,+5,85%,88%,83%,193,231,166,22%,26%,16%,9,4,5,4,4,0
223,https://vlr.gg/player/25258/lumo,2024-06-27 04:30:00,1.84,0.79,1.23,218,286,165,29,17,12,25,8,17,23,16,7,-2,-1,-1,80%,88%,75%,142,187,111,17%,18%,16%,0,0,0,2,1,1
224,https://vlr.gg/player/12968/tixx,2024-06-27 04:30:00,1.48,1.00,1.20,213,244,198,31,15,16,26,9,17,32,14,18,+1,-1,+2,80%,76%,83%,148,180,125,31%,26%,38%,6,2,4,5,3,2
225,https://vlr.gg/player/7745/yoshiii,2024-06-27 04:30:00,0.89,1.30,1.10,217,166,258,33,12,21,23,10,13,8,1,7,-3,0,-3,76%,65%,83%,153,105,187,26%,20%,28%,1,1,0,4,1,3
226,https://vlr.gg/player/12979/mrtenzouez,2024-06-27 04:30:00,1.13,1.06,1.09,197,185,197,29,12,17,24,10,14,13,7,6,0,+1,-1,76%,76%,75%,121,115,124,20%,29%,15%,5,1,4,5,0,5
227,https://vlr.gg/player/34776/absol,2024-06-27 04:30:00,1.22,0.43,0.88,237,315,139,32,25,7,37,21,16,6,4,2,0,+2,-2,63%,71%,53%,152,194,92,20%,18%,29%,9,7,2,9,5,4
228,https://vlr.gg/player/700/million,2024-06-27 04:30:00,0.95,0.64,0.82,158,174,139,21,14,7,33,17,16,22,13,9,0,0,0,68%,71%,65%,102,108,93,18%,23%,11%,0,0,0,0,0,0
229,https://vlr.gg/player/1003/reita,2024-06-27 04:30:00,0.64,1.06,0.81,162,102,246,23,9,14,32,17,15,4,3,1,0,-4,+4,61%,58%,65%,114,78,164,31%,22%,38%,4,0,4,4,4,0
230,https://vlr.gg/player/686/tonbo,2024-06-27 04:30:00,0.81,0.78,0.80,182,169,199,24,13,11,34,19,15,7,6,1,0,+1,-1,71%,79%,59%,117,109,129,25%,34%,17%,5,4,1,5,3,2
231,https://vlr.gg/player/20465/biju,2024-06-27 04:30:00,0.75,0.51,0.65,141,126,167,21,12,9,33,17,16,8,4,4,-1,-1,0,56%,54%,59%,101,96,109,21%,16%,27%,2,0,2,3,1,2
232,https://vlr.gg/player/29790/zauqk,2024-06-27 04:30:00,1.23,0.89,1.08,226,252,197,47,30,17,50,27,23,25,14,11,-3,-1,-2,73%,66%,82%,154,166,138,24%,25%,22%,2,2,0,5,3,2
233,https://vlr.gg/player/1174/crunchy,2024-06-27 04:30:00,0.61,1.39,0.96,204,154,270,46,18,28,50,30,20,29,15,14,-5,-6,+1,70%,66%,75%,135,100,178,38%,34%,42%,2,0,2,7,6,1
234,https://vlr.gg/player/1176/nozz,2024-06-27 04:30:00,1.18,0.69,0.96,171,187,149,40,26,14,45,24,21,23,14,9,-6,-1,-5,59%,63%,54%,114,124,101,28%,25%,32%,1,1,0,7,2,5
235,https://vlr.gg/player/11106/m1ke,2024-06-27 04:30:00,0.70,1.15,0.90,170,151,198,38,17,21,46,29,17,16,9,7,-4,-3,-1,62%,51%,75%,123,109,140,23%,28%,20%,6,2,4,10,5,5
236,https://vlr.gg/player/27550/exirst,2024-06-27 04:30:00,0.55,0.84,0.68,172,168,181,35,18,17,56,33,23,20,10,10,-3,0,-3,65%,71%,57%,125,112,140,21%,18%,25%,10,7,3,13,7,6
237,https://vlr.gg/player/26310/ikana,2024-06-27 04:30:00,0.99,1.67,1.37,240,187,282,53,17,36,36,19,17,20,8,12,+4,+1,+3,87%,89%,86%,171,123,210,27%,16%,33%,6,2,4,2,1,1
238,https://vlr.gg/player/31593/kiss,2024-06-27 04:30:00,1.20,1.19,1.20,235,225,244,52,22,30,44,20,24,30,13,17,+2,0,+2,73%,68%,77%,158,146,168,38%,44%,34%,7,3,4,5,3,2
239,https://vlr.gg/player/31589/murza,2024-06-27 04:30:00,1.02,1.12,1.07,226,215,230,49,21,28,43,20,23,13,6,7,+5,+4,+1,75%,75%,74%,152,141,160,26%,30%,22%,13,6,7,8,2,6
240,https://vlr.gg/player/26316/ramen,2024-06-27 04:30:00,1.03,1.11,1.07,193,178,207,44,18,26,38,17,21,16,9,7,+2,0,+2,76%,68%,83%,131,125,137,24%,30%,20%,4,1,3,2,1,1
241,https://vlr.gg/player/10089/andy,2024-06-27 04:30:00,1.17,0.91,1.03,225,273,192,49,26,23,45,21,24,18,9,9,+8,+5,+3,76%,71%,80%,151,179,128,22%,21%,23%,12,7,5,4,2,2
242,https://vlr.gg/player/10749/k1ngkappa,2024-06-27 03:00:00,1.29,1.18,1.24,263,253,264,57,31,26,42,20,22,16,7,9,+6,+4,+2,70%,78%,62%,167,172,163,29%,40%,23%,8,5,3,2,1,1
243,https://vlr.gg/player/9290/madelyn,2024-06-27 03:00:00,1.27,1.03,1.16,204,204,208,44,24,20,36,15,21,15,5,10,+5,+2,+3,77%,75%,79%,130,134,124,25%,45%,14%,8,3,5,3,1,2
244,https://vlr.gg/player/7802/flynch,2024-06-27 03:00:00,1.13,1.16,1.15,244,245,237,53,28,25,44,22,22,10,5,5,0,0,0,70%,72%,69%,160,159,162,33%,36%,29%,9,6,3,9,6,3
245,https://vlr.gg/player/7046/no1syboy,2024-06-27 03:00:00,0.88,1.27,1.06,228,196,271,48,21,27,47,23,24,21,6,15,-4,-3,-1,72%,81%,62%,150,138,163,21%,28%,17%,2,0,2,6,3,3
246,https://vlr.gg/player/7049/natz,2024-06-27 03:00:00,1.06,0.38,0.74,151,202,98,31,23,8,43,18,25,27,14,13,-4,-1,-3,62%,66%,59%,95,125,61,22%,23%,19%,5,3,2,9,4,5
247,https://vlr.gg/player/9717/lilo,2024-06-27 03:00:00,1.21,1.04,1.12,265,297,235,55,29,26,48,23,25,10,8,2,+1,0,+1,70%,79%,63%,171,199,146,27%,27%,26%,13,8,5,12,8,4
248,https://vlr.gg/player/7048/budimeister,2024-06-27 03:00:00,1.26,0.75,0.99,194,233,152,41,26,15,45,20,25,21,12,9,+1,+3,-2,70%,86%,56%,126,147,106,28%,27%,30%,7,4,3,6,1,5
249,https://vlr.gg/player/7047/vascalizz,2024-06-27 03:00:00,0.91,0.90,0.91,186,188,187,41,21,20,47,21,26,17,7,10,+2,+1,+1,72%,79%,66%,127,116,137,28%,27%,28%,4,1,3,2,0,2
250,https://vlr.gg/player/7804/severine,2024-06-27 03:00:00,0.85,0.85,0.84,173,192,169,37,19,18,48,23,25,27,17,10,-5,-3,-2,69%,79%,59%,115,126,105,26%,31%,20%,3,1,2,8,4,4
251,https://vlr.gg/player/4872/frostmind,2024-06-27 03:00:00,0.87,0.72,0.79,171,175,169,38,19,19,45,19,26,8,5,3,-2,-2,0,69%,72%,66%,120,125,115,27%,25%,30%,2,0,2,4,2,2
252,https://vlr.gg/player/10769/nobita,2024-06-27 02:00:00,1.69,1.36,1.52,257,280,236,36,19,17,20,9,11,14,7,7,+1,+2,-1,77%,79%,75%,169,183,155,30%,27%,33%,4,3,1,3,1,2
253,https://vlr.gg/player/10628/misaya,2024-06-27 02:00:00,1.33,1.36,1.35,209,221,198,28,15,13,22,12,10,27,16,11,-1,0,-1,87%,89%,85%,122,126,119,14%,14%,14%,2,2,0,3,2,1
254,https://vlr.gg/player/4052/jinboong,2024-06-27 02:00:00,1.39,1.03,1.20,205,234,183,28,16,12,24,9,15,8,4,4,+1,0,+1,85%,84%,85%,139,148,131,31%,35%,27%,3,1,2,2,1,1
255,https://vlr.gg/player/37664/gatorada,2024-06-27 02:00:00,1.19,1.04,1.11,192,220,168,28,16,12,24,12,12,24,12,12,0,0,0,87%,95%,80%,118,134,102,17%,19%,15%,2,1,1,2,1,1
256,https://vlr.gg/player/40726/gwangboong,2024-06-27 02:00:00,0.68,1.39,1.04,231,168,286,32,11,21,29,15,14,6,2,4,-2,-1,-1,74%,79%,70%,147,115,177,23%,22%,24%,8,3,5,10,4,6
257,https://vlr.gg/player/6676/thiefy,2024-06-27 02:00:00,0.77,0.90,0.83,210,193,229,26,12,14,31,15,16,7,3,4,+3,+2,+1,64%,60%,68%,145,143,147,31%,26%,39%,10,5,5,7,3,4
258,https://vlr.gg/player/1014/pepper,2024-06-27 02:00:00,0.69,0.83,0.76,195,162,232,27,13,14,32,15,17,6,1,5,-1,0,-1,72%,75%,68%,131,102,161,23%,30%,20%,3,2,1,4,2,2
259,https://vlr.gg/player/1952/esperanza,2024-06-27 02:00:00,0.86,0.50,0.68,145,188,98,19,14,5,28,14,14,9,6,3,+3,+2,+1,69%,80%,58%,99,124,72,36%,54%,19%,3,2,1,0,0,0
260,https://vlr.gg/player/25053/wolverine,2024-06-27 02:00:00,0.79,0.53,0.67,173,241,101,25,17,8,31,17,14,4,1,3,-1,0,-1,62%,65%,58%,107,149,64,29%,28%,31%,2,2,0,3,2,1
261,https://vlr.gg/player/17800/tempura,2024-06-27 02:00:00,0.46,0.88,0.66,163,108,223,22,7,15,32,15,17,7,3,4,-3,-2,-1,59%,55%,63%,111,70,154,22%,29%,20%,2,0,2,5,2,3
262,https://vlr.gg/player/4122/persia,2024-06-27 02:00:00,1.35,1.14,1.26,218,240,179,30,19,11,26,16,10,26,14,12,0,0,0,71%,71%,71%,147,163,124,35%,36%,32%,1,1,0,1,1,0
263,https://vlr.gg/player/31829/ivy,2024-06-27 02:00:00,0.95,1.40,1.14,250,193,315,39,19,20,32,20,12,4,2,2,-3,-2,-1,66%,54%,82%,158,132,194,26%,33%,20%,1,0,1,4,2,2
264,https://vlr.gg/player/31828/francis,2024-06-27 02:00:00,0.73,1.14,0.89,177,144,207,26,12,14,31,19,12,21,15,6,0,+2,-2,61%,54%,71%,103,82,132,20%,30%,13%,5,4,1,5,2,3
265,https://vlr.gg/player/33576/margaret,2024-06-27 02:00:00,0.88,0.87,0.88,178,190,163,26,16,10,31,18,13,10,5,5,+1,+2,-1,59%,54%,65%,114,127,96,28%,36%,20%,7,5,2,6,3,3
266,https://vlr.gg/player/31827/dambi,2024-06-27 02:00:00,0.72,0.91,0.80,205,194,211,27,15,12,34,20,14,9,3,6,-5,-2,-3,61%,58%,65%,138,130,150,20%,19%,22%,3,2,1,8,4,4
267,https://vlr.gg/player/25081/yoman,2024-06-27 02:00:00,1.35,1.46,1.41,280,275,304,41,16,25,28,12,16,16,6,10,+2,-1,+3,71%,59%,79%,178,173,181,34%,32%,35%,5,1,4,3,2,1
268,https://vlr.gg/player/28401/pkm,2024-06-27 02:00:00,1.41,1.11,1.23,261,352,228,40,21,19,30,15,15,11,4,7,+4,+5,-1,78%,82%,75%,171,200,151,32%,44%,24%,8,7,1,4,2,2
269,https://vlr.gg/player/24979/cloy,2024-06-27 02:00:00,0.91,0.97,0.94,184,150,196,25,8,17,29,12,17,18,10,8,+1,0,+1,78%,71%,83%,120,109,129,24%,27%,22%,3,1,2,2,1,1
270,https://vlr.gg/player/25048/sid,2024-06-27 02:00:00,0.22,1.11,0.74,157,77,216,25,5,20,31,15,16,11,5,6,-3,0,-3,63%,53%,71%,108,50,149,28%,19%,31%,0,0,0,3,0,3
271,https://vlr.gg/player/42772/xross,2024-06-27 02:00:00,0.75,0.66,0.70,162,173,156,22,11,11,30,13,17,8,3,5,+3,+3,0,61%,59%,63%,118,129,111,25%,22%,27%,8,3,5,5,0,5
272,https://vlr.gg/player/46135/zeus,2024-06-27 02:00:00,1.35,1.42,1.39,289,300,284,67,32,35,42,22,20,8,5,3,-2,-1,-1,74%,69%,79%,175,173,177,24%,29%,20%,13,7,6,15,8,7
273,https://vlr.gg/player/36013/hydrakid,2024-06-27 02:00:00,1.18,1.49,1.34,283,261,311,58,24,34,46,22,24,30,13,17,+3,+1,+2,77%,79%,76%,195,178,209,28%,31%,25%,7,2,5,4,1,3
274,https://vlr.gg/player/11541/xty,2024-06-27 02:00:00,1.31,0.88,1.08,182,234,139,42,27,15,37,17,20,19,6,13,+1,+2,-1,73%,79%,67%,126,161,95,26%,30%,22%,4,2,2,3,0,3
275,https://vlr.gg/player/44294/eur,2024-06-27 02:00:00,1.12,1.03,1.07,169,192,139,37,20,17,37,18,19,35,17,18,-2,-1,-1,79%,79%,79%,107,120,96,28%,32%,23%,0,0,0,2,1,1
276,https://vlr.gg/player/46134/denz,2024-06-27 02:00:00,0.69,1.18,0.95,196,126,245,40,13,27,43,20,23,21,9,12,0,-2,+2,74%,69%,79%,129,89,164,25%,19%,28%,7,3,4,7,5,2
277,https://vlr.gg/player/10257/irismonstah,2024-06-27 02:00:00,0.98,1.18,1.07,208,208,200,46,25,21,44,25,19,5,1,4,+2,+2,0,71%,61%,83%,143,148,137,23%,25%,21%,6,4,2,4,2,2
278,https://vlr.gg/player/32585/n1er,2024-06-27 02:00:00,1.06,0.94,0.99,229,241,225,53,30,23,48,25,23,9,1,8,+1,+1,0,68%,67%,69%,159,164,152,25%,28%,23%,8,3,5,7,2,5
279,https://vlr.gg/player/35026/chaze,2024-06-27 02:00:00,0.63,1.24,0.90,184,131,248,20,5,15,30,15,15,20,15,5,+1,-1,+2,74%,71%,76%,125,90,168,16%,10%,22%,3,1,2,2,2,0
280,https://vlr.gg/player/10192/chowdy,2024-06-27 02:00:00,1.03,0.64,0.85,185,211,145,35,23,12,51,26,25,28,18,10,-3,-3,0,71%,73%,69%,123,146,98,25%,29%,20%,1,0,1,4,3,1
281,https://vlr.gg/player/25542/ash999,2024-06-27 02:00:00,0.75,0.84,0.79,195,186,232,44,19,25,52,26,26,15,9,6,+3,+1,+2,71%,70%,72%,133,122,146,27%,25%,29%,11,7,4,8,6,2
282,https://vlr.gg/player/35965/yukxx,2024-06-27 02:00:00,0.31,0.48,0.39,114,125,105,7,4,3,19,11,8,8,3,5,-4,-1,-3,54%,50%,58%,74,82,66,28%,33%,23%,2,1,1,6,2,4
283,https://vlr.gg/player/11921/silentzz,2024-06-26 18:35:00,1.44,1.71,1.57,342,313,373,59,28,31,35,18,17,5,3,2,+10,+7,+3,76%,77%,74%,207,191,224,42%,37%,49%,17,12,5,7,5,2
284,https://vlr.gg/player/6195/lz,2024-06-26 18:35:00,1.37,0.65,1.04,199,254,121,37,27,10,31,14,17,16,9,7,+2,0,+2,78%,88%,65%,123,162,80,48%,52%,41%,4,0,4,2,0,2
285,https://vlr.gg/player/3169/zap,2024-06-26 18:35:00,0.86,1.11,0.98,167,128,217,28,12,16,28,13,15,4,3,1,-3,0,-3,63%,65%,61%,125,95,159,23%,29%,19%,2,2,0,5,2,3
286,https://vlr.gg/player/662/pryze,2024-06-26 18:35:00,0.97,0.86,0.92,162,153,173,23,14,9,29,14,15,22,11,11,+1,+1,0,84%,92%,74%,110,93,130,20%,18%,22%,2,1,1,1,0,1
287,https://vlr.gg/player/21661/spike,2024-06-26 18:35:00,1.19,0.57,0.90,162,227,93,29,22,7,32,16,16,18,10,8,-7,-2,-5,69%,73%,65%,111,147,69,21%,19%,28%,1,1,0,8,3,5
288,https://vlr.gg/player/20240/xenom,2024-06-26 18:35:00,1.16,1.27,1.22,201,173,223,39,16,23,28,12,16,9,4,5,0,0,0,69%,74%,65%,138,127,148,47%,57%,40%,0,0,0,0,0,0
289,https://vlr.gg/player/3424/siduzord,2024-06-26 18:35:00,1.03,1.04,1.04,217,213,210,36,17,19,36,15,21,15,7,8,+2,0,+2,69%,65%,73%,139,149,130,23%,25%,21%,6,1,5,4,1,3
290,https://vlr.gg/player/6202/guuih,2024-06-26 18:35:00,0.89,0.88,0.88,169,151,193,27,13,14,34,13,21,6,2,4,+2,+1,+1,65%,74%,58%,122,103,140,28%,27%,29%,4,2,2,2,1,1
291,https://vlr.gg/player/13823/pxs,2024-06-26 18:35:00,1.02,0.62,0.81,173,218,133,33,20,13,38,17,21,4,1,3,+3,+5,-2,67%,65%,69%,110,141,83,20%,27%,11%,10,8,2,7,3,4
292,https://vlr.gg/player/23010/nicksz,2024-06-26 18:35:00,1.10,0.22,0.64,148,206,100,20,14,6,40,16,24,29,20,9,-10,-3,-7,71%,78%,65%,103,138,73,29%,33%,23%,3,2,1,13,5,8
293,https://vlr.gg/player/3007/tdawgg,2024-06-26 18:15:00,1.18,1.25,1.21,259,254,265,44,23,21,35,19,16,11,3,8,+2,+1,+1,71%,68%,75%,160,146,175,36%,44%,30%,6,3,3,4,2,2
294,https://vlr.gg/player/1023/xxif,2024-06-26 18:15:00,1.22,1.19,1.20,218,223,219,40,20,20,32,18,14,8,5,3,0,+1,-1,76%,72%,79%,158,162,154,31%,32%,30%,3,2,1,3,1,2
295,https://vlr.gg/player/754/nerve,2024-06-26 18:15:00,0.91,0.86,0.88,168,171,171,29,15,14,32,16,16,21,10,11,-5,-3,-2,73%,76%,71%,109,107,111,30%,27%,33%,0,0,0,5,3,2
296,https://vlr.gg/player/13831/zeldris,2024-06-26 18:15:00,0.88,0.84,0.86,208,194,223,36,17,19,37,19,18,9,6,3,0,-1,+1,65%,64%,67%,134,135,134,22%,24%,20%,9,4,5,9,5,4
297,https://vlr.gg/player/21878/snarly,2024-06-26 18:15:00,0.54,0.50,0.52,121,141,97,20,12,8,40,23,17,17,8,9,-6,-3,-3,67%,76%,58%,79,92,66,33%,46%,21%,2,1,1,8,4,4
298,https://vlr.gg/player/6437/dark3st,2024-06-26 18:15:00,1.06,1.31,1.19,203,176,235,36,14,22,30,16,14,23,13,10,+3,+1,+2,82%,83%,80%,127,103,150,24%,21%,27%,4,2,2,1,1,0
299,https://vlr.gg/player/8397/dip,2024-06-26 18:15:00,1.08,1.27,1.18,195,170,222,35,14,21,28,14,14,17,7,10,0,-2,+2,78%,75%,80%,129,114,142,23%,29%,18%,3,0,3,3,2,1
300,https://vlr.gg/player/15636/scarn,2024-06-26 18:15:00,1.34,0.89,1.11,270,294,254,46,25,21,42,19,23,9,2,7,+9,+6,+3,78%,79%,76%,170,189,152,24%,39%,12%,15,9,6,6,3,3
301,https://vlr.gg/player/21886/furbsa,2024-06-26 18:15:00,1.28,0.78,1.02,204,225,180,36,20,16,33,15,18,5,2,3,+1,+2,-1,65%,71%,60%,144,160,128,32%,34%,29%,4,2,2,3,0,3
302,https://vlr.gg/player/16757/cohburg,2024-06-26 18:15:00,0.54,0.97,0.76,149,111,182,23,8,15,36,18,18,20,10,10,-4,-3,-1,76%,75%,76%,106,87,125,20%,24%,18%,3,1,2,7,4,3
303,https://vlr.gg/player/26214/cidzzz,2024-06-26 16:00:00,1.14,1.21,1.17,210,202,221,36,15,21,32,15,17,15,11,4,0,+2,-2,76%,76%,76%,150,145,154,33%,31%,36%,7,3,4,7,1,6
304,https://vlr.gg/player/36106/skz,2024-06-26 16:00:00,1.18,1.12,1.15,233,234,231,41,20,21,37,19,18,25,13,12,-1,0,-1,86%,88%,84%,145,152,138,29%,36%,23%,2,1,1,3,1,2
305,https://vlr.gg/player/15361/swag,2024-06-26 16:00:00,1.17,0.76,0.97,179,213,145,32,20,12,32,16,16,10,2,8,+1,+1,0,72%,76%,68%,118,140,96,33%,41%,23%,5,3,2,4,2,2
306,https://vlr.gg/player/14950/gobera,2024-06-26 16:00:00,0.68,1.16,0.92,230,187,268,35,16,19,39,20,19,13,1,12,+2,0,+2,78%,76%,80%,149,120,178,14%,18%,12%,10,6,4,8,6,2
307,https://vlr.gg/player/945/drakonz,2024-06-26 16:00:00,0.99,0.70,0.84,166,177,156,32,17,15,37,17,20,12,6,6,+2,0,+2,64%,64%,64%,111,122,101,25%,20%,32%,3,1,2,1,1,0
308,https://vlr.gg/player/28716/lukxo,2024-06-26 16:00:00,1.47,1.00,1.23,212,249,177,38,23,15,30,14,16,18,10,8,-3,0,-3,82%,80%,84%,147,165,128,30%,29%,30%,1,1,0,4,1,3
309,https://vlr.gg/player/6238/urango,2024-06-26 16:00:00,0.94,1.26,1.10,235,208,260,40,18,22,38,21,17,17,10,7,-2,-1,-1,70%,64%,76%,152,122,183,26%,34%,22%,7,5,2,9,6,3
310,https://vlr.gg/player/1688/rood,2024-06-26 16:00:00,1.26,0.73,1.00,222,258,189,37,21,16,36,16,20,15,7,8,0,+2,-2,68%,72%,64%,148,165,130,23%,25%,21%,5,3,2,5,1,4
311,https://vlr.gg/player/21659/sato,2024-06-26 16:00:00,0.52,1.34,0.93,201,147,257,36,13,23,39,22,17,12,6,6,+3,-1,+4,74%,72%,76%,136,112,159,34%,44%,29%,8,3,5,5,4,1
312,https://vlr.gg/player/1994/evilkyk,2024-06-26 16:00:00,1.06,0.64,0.85,142,162,124,26,15,11,33,15,18,20,11,9,-2,-1,-1,74%,76%,72%,101,120,82,34%,41%,27%,2,0,2,4,1,3
313,https://vlr.gg/player/5132/mada,2024-06-26 16:00:00,1.57,1.61,1.59,334,352,317,45,23,22,23,13,10,17,8,9,+5,+2,+3,90%,95%,85%,220,244,196,21%,26%,16%,11,6,5,6,4,2
314,https://vlr.gg/player/17433/v1c,2024-06-26 16:00:00,1.72,1.10,1.40,224,271,181,34,21,13,18,7,11,21,12,9,+1,+1,0,85%,84%,85%,132,149,116,26%,30%,22%,2,1,1,1,0,1
315,https://vlr.gg/player/3685/flyuh,2024-06-26 16:00:00,1.30,1.45,1.38,264,260,267,37,18,19,23,13,10,21,14,7,+4,+1,+3,82%,79%,85%,165,152,177,26%,20%,33%,7,2,5,3,1,2
316,https://vlr.gg/player/2172/brawk,2024-06-26 16:00:00,1.04,1.58,1.32,223,168,274,30,10,20,23,12,11,17,11,6,+1,0,+1,85%,79%,90%,150,113,185,22%,18%,24%,1,0,1,0,0,0
317,https://vlr.gg/player/1851/oderus,2024-06-26 16:00:00,0.26,0.74,0.51,101,37,163,15,2,13,25,12,13,1,0,1,-8,-5,-3,64%,63%,65%,63,25,99,28%,18%,31%,0,0,0,8,5,3
318,https://vlr.gg/player/849/poised,2024-06-26 16:00:00,0.96,1.06,1.01,203,220,183,26,15,11,30,17,13,12,4,8,+2,+1,+1,72%,65%,79%,140,147,132,27%,28%,26%,4,3,1,2,2,0
319,https://vlr.gg/player/3702/sym,2024-06-26 16:00:00,0.74,1.22,0.97,249,199,309,36,14,22,36,19,17,2,2,0,0,-2,+2,59%,50%,68%,159,135,184,31%,31%,31%,9,2,7,9,4,5
320,https://vlr.gg/player/8376/seven,2024-06-26 16:00:00,0.46,0.89,0.67,142,110,175,20,8,12,32,17,15,5,2,3,0,-1,+1,59%,50%,68%,100,75,127,40%,39%,41%,3,2,1,3,3,0
321,https://vlr.gg/player/64/gmd,2024-06-26 16:00:00,0.63,0.48,0.56,127,139,114,15,8,7,33,17,16,8,6,2,-3,-1,-2,67%,65%,68%,94,104,83,24%,21%,29%,2,1,1,5,2,3
322,https://vlr.gg/player/740/aproto,2024-06-26 16:00:00,0.58,0.44,0.51,107,133,79,15,10,5,30,17,13,9,5,4,-2,-1,-1,59%,65%,53%,69,87,50,54%,53%,56%,0,0,0,2,1,1
323,https://vlr.gg/player/7652/tuli,2024-06-26 16:00:00,1.21,1.26,1.24,273,284,264,87,43,44,71,39,32,14,8,6,+3,+1,+2,73%,71%,75%,178,188,167,26%,29%,23%,16,7,9,13,6,7
324,https://vlr.gg/player/12872/david,2024-06-26 16:00:00,0.84,1.11,0.98,186,161,212,67,31,36,68,37,31,34,21,13,0,-4,+4,75%,71%,79%,120,100,140,31%,30%,31%,6,1,5,6,5,1
325,https://vlr.gg/player/13860/rubkkoide,2024-06-26 16:00:00,0.90,0.95,0.92,183,177,190,59,29,30,66,35,31,22,4,18,0,-2,+2,66%,60%,71%,127,125,128,27%,34%,22%,5,1,4,5,3,2
326,https://vlr.gg/player/11046/deigara,2024-06-26 16:00:00,0.51,1.11,0.81,191,133,250,64,21,43,74,38,36,25,11,14,-2,-6,+4,67%,54%,79%,120,85,155,34%,43%,30%,9,2,7,11,8,3
327,https://vlr.gg/player/2403/mizu,2024-06-26 16:00:00,0.65,0.91,0.78,158,167,149,54,27,27,69,41,28,14,5,9,-13,-7,-6,64%,56%,71%,109,119,100,42%,41%,43%,6,4,2,19,11,8
328,https://vlr.gg/player/41135/dantedeu5,2024-06-26 16:00:00,1.22,1.19,1.21,252,274,232,84,45,39,72,38,34,22,10,12,+8,-2,+10,75%,73%,77%,163,177,150,26%,25%,28%,19,7,12,11,9,2
329,https://vlr.gg/player/9354/cebando,2024-06-26 16:00:00,0.92,1.46,1.19,218,184,253,76,31,45,63,37,26,42,22,20,+6,0,+6,73%,71%,75%,134,119,148,40%,40%,40%,13,2,11,7,2,5
330,https://vlr.gg/player/3826/adverso,2024-06-26 16:00:00,0.96,1.22,1.09,226,193,261,73,29,44,69,34,35,36,17,19,+4,+2,+2,78%,71%,85%,153,126,181,27%,25%,29%,13,7,6,9,5,4
331,https://vlr.gg/player/2585/tinchoff,2024-06-26 16:00:00,0.90,1.05,0.97,159,149,170,58,27,31,58,32,26,17,8,9,-3,-2,-1,77%,77%,77%,111,100,123,33%,37%,30%,4,2,2,7,4,3
332,https://vlr.gg/player/13861/nicomachine,2024-06-26 16:00:00,0.75,1.06,0.91,179,170,189,57,26,31,69,39,30,54,30,24,-3,-4,+1,76%,73%,79%,123,111,135,28%,31%,25%,5,3,2,8,7,1
333,https://vlr.gg/player/458/chronicle,2024-06-26 14:15:00,1.15,1.42,1.25,227,220,239,44,27,17,35,24,11,21,12,9,+3,0,+3,84%,86%,82%,160,148,180,26%,29%,22%,5,2,3,2,2,0
334,https://vlr.gg/player/9810/alfajer,2024-06-26 14:15:00,1.20,1.29,1.24,241,224,270,52,30,22,37,23,14,13,10,3,+1,0,+1,74%,78%,68%,170,174,165,28%,24%,35%,6,4,2,5,4,1
335,https://vlr.gg/player/5022/derke,2024-06-26 14:15:00,0.91,1.15,1.00,226,208,262,47,27,20,44,27,17,13,10,3,+1,-1,+2,74%,72%,77%,153,138,178,22%,21%,24%,10,5,5,9,6,3
336,https://vlr.gg/player/29867/hiro,2024-06-26 14:15:00,1.21,0.59,0.98,159,216,67,36,31,5,35,22,13,13,10,3,-3,-1,-2,66%,72%,55%,96,125,50,21%,20%,24%,3,2,1,6,3,3
337,https://vlr.gg/player/438/boaster,2024-06-26 14:15:00,0.73,0.90,0.79,144,134,164,29,15,14,39,24,15,26,19,7,-4,0,-4,72%,78%,64%,93,87,104,23%,18%,30%,4,4,0,8,4,4
338,https://vlr.gg/player/2168/trexx,2024-06-26 14:15:00,1.00,1.29,1.18,237,202,260,47,16,31,42,16,26,20,6,14,+2,+2,0,72%,73%,72%,154,123,173,19%,21%,19%,4,2,2,2,0,2
339,https://vlr.gg/player/21610/runner,2024-06-26 14:15:00,0.96,1.06,1.02,211,209,213,43,15,28,41,16,25,11,7,4,+2,-1,+3,71%,68%,72%,148,148,147,33%,27%,38%,8,2,6,6,3,3
340,https://vlr.gg/player/4321/cender,2024-06-26 14:15:00,0.95,0.96,0.95,171,167,173,34,14,20,39,14,25,19,8,11,-1,-2,+1,62%,55%,67%,112,102,118,45%,38%,50%,4,1,3,5,3,2
341,https://vlr.gg/player/312/sayf,2024-06-26 14:15:00,1.08,0.81,0.91,191,212,179,39,17,22,43,14,29,15,5,10,+1,+1,0,64%,73%,58%,118,122,116,25%,31%,22%,13,6,7,12,5,7
342,https://vlr.gg/player/11134/kicks,2024-06-26 14:15:00,0.63,0.79,0.73,145,132,153,27,8,19,43,18,25,14,8,6,-2,0,-2,62%,68%,58%,101,100,102,23%,18%,26%,1,0,1,3,0,3
343,https://vlr.gg/player/10971/riens,2024-06-26 12:00:00,1.49,1.45,1.47,237,235,256,39,14,25,22,10,12,19,10,9,0,0,0,81%,78%,83%,154,152,155,39%,30%,48%,4,1,3,4,1,3
344,https://vlr.gg/player/21328/wo0t,2024-06-26 12:00:00,0.92,1.62,1.32,255,180,309,37,10,27,27,12,15,16,7,9,+2,+1,+1,83%,89%,79%,177,130,213,37%,31%,40%,7,4,3,5,3,2
345,https://vlr.gg/player/1144/boo,2024-06-26 12:00:00,1.20,1.16,1.18,211,165,236,31,13,18,27,10,17,22,7,15,-1,-1,0,81%,78%,83%,134,106,155,24%,32%,21%,2,0,2,3,1,2
346,https://vlr.gg/player/18350/miniboo,2024-06-26 12:00:00,1.01,1.14,1.08,222,258,195,32,16,16,29,15,14,13,6,7,-1,+1,-2,79%,67%,88%,137,139,134,24%,26%,22%,5,4,1,6,3,3
347,https://vlr.gg/player/29873/benjyfishy,2024-06-26 12:00:00,0.90,0.81,0.85,189,159,203,27,10,17,32,13,19,17,5,12,-2,-1,-1,69%,72%,67%,120,109,129,32%,24%,38%,2,0,2,4,1,3
348,https://vlr.gg/player/573/cned,2024-06-26 12:00:00,0.88,1.48,1.14,257,220,318,36,18,18,33,21,12,9,4,5,+2,+1,+1,69%,67%,72%,170,138,212,21%,19%,22%,8,5,3,6,4,2
349,https://vlr.gg/player/8044/mrfalin,2024-06-26 12:00:00,0.89,1.07,0.97,168,166,181,25,14,11,29,19,10,27,19,8,+2,0,+2,76%,79%,72%,103,98,111,24%,21%,28%,3,1,2,1,1,0
350,https://vlr.gg/player/8369/yetujey,2024-06-26 12:00:00,0.72,1.23,0.94,190,163,231,28,13,15,32,21,11,8,2,6,-2,0,-2,55%,50%,61%,124,110,143,29%,28%,30%,2,1,1,4,1,3
351,https://vlr.gg/player/1139/qraxs,2024-06-26 12:00:00,0.82,0.47,0.67,176,208,139,25,17,8,37,21,16,11,7,4,+3,+2,+1,69%,75%,61%,114,136,84,21%,18%,28%,5,4,1,2,2,0
352,https://vlr.gg/player/6510/atakaptan,2024-06-26 12:00:00,0.77,0.51,0.66,162,180,132,23,15,8,35,21,14,14,6,8,-3,-1,-2,71%,71%,72%,109,119,95,27%,25%,29%,4,2,2,7,3,4
353,https://vlr.gg/player/5541/tryst,2024-06-26 10:00:00,1.20,1.09,1.13,230,239,230,32,13,19,31,11,20,19,10,9,-3,-2,-1,68%,71%,67%,142,142,142,23%,22%,24%,1,1,0,4,3,1
354,https://vlr.gg/player/26376/deecee,2024-06-26 10:00:00,1.19,1.01,1.08,218,199,223,34,15,19,30,11,19,1,0,1,-2,-1,-1,61%,65%,58%,147,151,144,37%,40%,36%,3,1,2,5,2,3
355,https://vlr.gg/player/3502/ri0,2024-06-26 10:00:00,0.65,0.87,0.78,160,158,167,23,10,13,30,12,18,9,4,5,-1,-1,0,63%,65%,63%,103,99,106,27%,15%,40%,1,0,1,2,1,1
356,https://vlr.gg/player/31371/trinxty,2024-06-26 10:00:00,1.00,0.53,0.73,190,268,140,26,15,11,35,15,20,7,5,2,-5,0,-5,66%,82%,54%,125,170,93,27%,35%,18%,7,4,3,12,4,8
357,https://vlr.gg/player/30693/makaveli,2024-06-26 10:00:00,0.96,0.52,0.70,142,181,115,19,11,8,30,11,19,14,6,8,0,-1,+1,54%,65%,46%,98,116,85,26%,21%,31%,3,0,3,3,1,2
358,https://vlr.gg/player/9263/sayoo,2024-06-26 10:00:00,1.33,1.07,1.22,203,198,214,31,18,13,22,10,12,3,2,1,+4,+3,+1,68%,75%,59%,141,139,144,52%,63%,40%,5,3,2,1,0,1
359,https://vlr.gg/player/10758/kohliii,2024-06-26 10:00:00,0.99,1.44,1.18,213,161,287,32,14,18,26,13,13,15,10,5,+2,+1,+1,78%,71%,88%,141,116,176,32%,33%,31%,3,2,1,1,1,0
360,https://vlr.gg/player/1745/adrnking,2024-06-26 10:00:00,1.31,0.87,1.13,225,265,170,34,23,11,27,14,13,12,6,6,+2,+4,-2,83%,83%,82%,157,181,122,40%,38%,43%,4,4,0,2,0,2
361,https://vlr.gg/player/27336/venka,2024-06-26 10:00:00,0.97,1.13,1.03,266,267,253,36,22,14,34,20,14,7,2,5,+2,-2,+4,63%,58%,71%,175,175,175,39%,57%,18%,12,5,7,10,7,3
362,https://vlr.gg/player/3639/hoax,2024-06-26 10:00:00,1.22,0.69,1.00,168,215,113,23,19,4,25,13,12,14,3,11,+1,0,+1,76%,71%,82%,121,148,83,21%,22%,19%,2,1,1,1,1,0
363,https://vlr.gg/player/16852/nakya,2024-06-26 09:30:00,1.30,0.68,0.92,223,337,154,29,17,12,33,14,19,6,4,2,+5,+2,+3,62%,80%,50%,145,219,99,27%,35%,19%,8,4,4,3,2,1
364,https://vlr.gg/player/5886/flaring,2024-06-26 09:30:00,0.37,1.17,0.86,168,100,210,24,5,19,29,13,16,9,4,5,+2,0,+2,74%,60%,83%,116,64,149,26%,4%,38%,2,0,2,0,0,0
365,https://vlr.gg/player/7443/riza,2024-06-26 09:30:00,0.56,0.99,0.82,211,161,235,26,7,19,33,14,19,10,6,4,-1,-1,0,64%,67%,63%,147,109,171,35%,23%,40%,2,1,1,3,2,1
366,https://vlr.gg/player/27068/pudj,2024-06-26 09:30:00,0.39,1.03,0.79,175,125,209,23,6,17,31,13,18,6,1,5,-5,-1,-4,67%,67%,67%,112,81,131,21%,13%,27%,1,0,1,6,1,5
367,https://vlr.gg/player/7381/redkoh,2024-06-26 09:30:00,0.53,0.90,0.76,185,159,207,25,9,16,34,14,20,14,3,11,0,-1,+1,74%,80%,71%,124,111,132,35%,52%,27%,7,2,5,7,3,4
368,https://vlr.gg/player/45876/fixy,2024-06-26 09:30:00,1.41,1.52,1.46,282,288,265,41,25,16,24,15,9,9,6,3,0,-1,+1,72%,67%,80%,179,170,194,21%,22%,21%,7,4,3,7,5,2
369,https://vlr.gg/player/3480/thedoctorr,2024-06-26 09:30:00,1.20,1.38,1.27,247,230,280,35,19,16,25,15,10,13,8,5,0,-1,+1,79%,79%,80%,161,150,179,27%,26%,28%,4,2,2,4,3,1
370,https://vlr.gg/player/21051/jans0n,2024-06-26 09:30:00,0.94,1.46,1.14,213,197,233,31,18,13,25,16,9,11,3,8,-5,-2,-3,77%,75%,80%,132,131,135,30%,39%,18%,1,0,1,6,2,4
371,https://vlr.gg/player/2378/subbey,2024-06-26 09:30:00,1.01,1.03,1.02,213,223,197,28,19,9,28,18,10,18,7,11,+2,+1,+1,77%,75%,80%,138,147,125,33%,31%,37%,2,1,1,0,0,0
372,https://vlr.gg/player/7513/markl,2024-06-26 09:30:00,0.61,1.61,1.00,168,128,239,25,11,14,25,19,6,7,2,5,+2,+1,+1,69%,58%,87%,109,84,147,22%,26%,18%,5,4,1,3,3,0
373,https://vlr.gg/player/14674/kntz,2024-06-26 09:05:00,1.54,1.41,1.48,251,278,222,45,25,20,27,14,13,11,4,7,+1,-1,+2,80%,83%,77%,170,183,155,45%,40%,53%,2,0,2,1,1,0
374,https://vlr.gg/player/27244/seph1roth,2024-06-26 09:05:00,1.14,1.02,1.08,203,195,212,34,18,16,28,14,14,12,6,6,-2,-1,-1,74%,79%,68%,144,137,151,41%,44%,37%,3,1,2,5,2,3
375,https://vlr.gg/player/13784/killua,2024-06-26 09:05:00,0.67,1.43,1.03,193,139,253,33,13,20,30,18,12,13,3,10,-1,-1,0,78%,67%,91%,128,96,164,30%,38%,26%,5,3,2,6,4,2
376,https://vlr.gg/player/24679/cgrs,2024-06-26 09:05:00,0.57,1.28,0.91,170,127,217,26,8,18,28,17,11,14,9,5,-2,-2,0,76%,75%,77%,114,98,132,31%,25%,36%,2,0,2,4,2,2
377,https://vlr.gg/player/12098/kadoom,2024-06-26 09:05:00,0.80,0.98,0.88,192,189,196,29,14,15,31,17,14,9,5,4,0,-1,+1,72%,67%,77%,125,132,118,24%,27%,21%,9,5,4,9,6,3
378,https://vlr.gg/player/12291/arpoom,2024-06-26 09:05:00,0.57,1.38,0.99,205,133,271,30,9,21,34,18,16,12,5,7,+7,+1,+6,70%,64%,75%,133,92,170,19%,14%,23%,10,3,7,3,2,1
379,https://vlr.gg/player/5687/alonefillz,2024-06-26 09:05:00,0.67,1.28,0.99,191,152,227,31,11,20,32,18,14,12,1,11,-1,-1,0,65%,50%,79%,130,115,144,31%,32%,30%,2,1,1,3,2,1
380,https://vlr.gg/player/8582/laz,2024-06-26 09:05:00,0.92,0.76,0.84,176,176,176,29,14,15,35,17,18,13,10,3,0,0,0,63%,64%,63%,116,114,118,36%,48%,26%,4,1,3,4,1,3
381,https://vlr.gg/player/16977/socools0da,2024-06-26 09:05:00,0.76,0.91,0.84,174,171,178,29,14,15,35,18,17,10,6,4,-4,-4,0,63%,64%,63%,123,123,122,33%,30%,38%,2,0,2,6,4,2
382,https://vlr.gg/player/18035/garnets,2024-06-26 09:05:00,0.94,0.73,0.83,163,218,113,25,16,9,31,18,13,3,1,2,+2,+2,0,63%,55%,71%,103,135,74,38%,41%,35%,7,5,2,5,3,2
383,https://vlr.gg/player/7851/uta,2024-06-26 09:00:00,1.25,1.45,1.36,265,245,283,61,26,35,43,21,22,16,7,9,+2,-3,+5,77%,73%,81%,165,149,178,20%,16%,25%,12,4,8,10,7,3
384,https://vlr.gg/player/37421/riyabtw,2024-06-26 09:00:00,0.80,1.33,1.09,223,176,268,53,19,34,46,24,22,8,5,3,-1,-7,+6,73%,67%,78%,141,117,161,25%,35%,21%,12,2,10,13,9,4
385,https://vlr.gg/player/24302/chimei,2024-06-26 09:00:00,0.87,1.12,1.01,154,139,172,37,13,24,40,19,21,31,13,18,-3,-1,-2,74%,80%,69%,103,88,115,18%,18%,18%,1,1,0,4,2,2
386,https://vlr.gg/player/24304/kiuuuu,2024-06-26 09:00:00,1.13,0.83,0.97,201,250,160,46,25,21,48,23,25,23,13,10,+3,+2,+1,71%,77%,67%,140,160,122,33%,37%,30%,7,3,4,4,1,3
387,https://vlr.gg/player/12365/coconut,2024-06-26 09:00:00,1.00,0.95,0.97,193,204,176,42,21,21,44,22,22,14,6,8,-1,-1,0,65%,60%,69%,135,146,126,29%,26%,33%,1,0,1,2,1,1
388,https://vlr.gg/player/1906/ra1ny,2024-06-26 09:00:00,1.09,1.12,1.10,194,197,201,48,25,23,43,24,19,12,7,5,+3,0,+3,68%,69%,67%,134,133,136,31%,29%,33%,4,0,4,1,0,1
389,https://vlr.gg/player/24305/xyus,2024-06-26 09:00:00,0.88,1.10,0.98,201,190,211,46,23,23,45,26,19,11,4,7,-11,-8,-3,73%,61%,87%,142,125,163,28%,36%,20%,3,2,1,14,10,4
390,https://vlr.gg/player/37673/yanli,2024-06-26 09:00:00,0.67,1.14,0.89,172,154,201,42,20,22,47,29,18,14,4,10,0,-1,+1,71%,64%,80%,122,108,139,38%,44%,33%,5,3,2,5,4,1
391,https://vlr.gg/player/7861/w1nner,2024-06-26 09:00:00,0.80,0.95,0.87,201,179,229,47,23,24,53,29,24,12,4,8,+3,-3,+6,71%,61%,83%,136,123,152,29%,39%,22%,11,4,7,8,7,1
392,https://vlr.gg/player/42932/ngk,2024-06-26 09:00:00,0.85,0.82,0.84,210,214,206,33,17,16,38,20,18,7,1,6,+6,+3,+3,60%,54%,65%,135,141,128,23%,21%,24%,10,4,6,4,1,3
393,https://vlr.gg/player/24301/kino,2024-06-26 09:00:00,0.75,0.20,0.55,96,120,57,5,4,1,13,7,6,9,9,0,-1,-1,0,63%,83%,29%,66,79,45,21%,24%,14%,0,0,0,1,1,0
394,https://vlr.gg/player/46552/minori,2024-06-26 07:45:00,0.80,1.50,1.17,234,177,287,37,12,25,33,18,15,10,2,8,+4,0,+4,72%,64%,79%,160,135,182,33%,28%,36%,6,2,4,2,2,0
395,https://vlr.gg/player/7430/youngpork,2024-06-26 07:45:00,0.76,1.41,1.10,241,206,279,40,16,24,38,20,18,19,7,12,0,-1,+1,72%,64%,79%,150,126,171,25%,17%,31%,5,1,4,5,2,3
396,https://vlr.gg/player/46471/hirenkyaku,2024-06-26 07:45:00,0.74,0.86,0.80,194,193,189,29,14,15,36,19,17,10,4,6,-9,-6,-3,63%,64%,63%,123,117,129,14%,13%,14%,1,1,0,10,7,3
397,https://vlr.gg/player/7429/cms,2024-06-26 07:45:00,0.43,0.77,0.61,133,87,176,20,7,13,37,19,18,6,1,5,-2,-2,0,54%,41%,67%,97,70,122,21%,35%,15%,3,0,3,5,2,3
398,https://vlr.gg/player/7431/foods,2024-06-26 07:45:00,0.51,0.63,0.57,156,130,182,25,9,16,40,21,19,4,2,2,-5,-5,0,48%,41%,54%,104,88,118,15%,18%,11%,2,0,2,7,5,2
399,https://vlr.gg/player/35965/yukxx,2024-06-26 07:45:00,1.27,1.67,1.47,289,256,322,25,11,14,15,8,7,9,4,5,+3,-1,+4,88%,83%,92%,199,174,225,48%,36%,64%,5,1,4,2,2,0
400,https://vlr.gg/player/32585/n1er,2024-06-26 07:45:00,0.75,1.78,1.24,244,177,315,42,13,29,31,20,11,10,8,2,+1,-3,+4,76%,67%,86%,162,124,204,30%,26%,34%,6,1,5,5,4,1
401,https://vlr.gg/player/10257/irismonstah,2024-06-26 07:45:00,1.17,1.24,1.20,219,247,188,35,20,15,27,18,9,8,3,5,0,-1,+1,80%,67%,95%,161,178,142,31%,38%,23%,1,0,1,1,1,0
402,https://vlr.gg/player/25542/ash999,2024-06-26 07:45:00,1.35,0.94,1.15,237,290,181,37,23,14,33,18,15,17,7,10,+5,+3,+2,76%,67%,86%,151,176,125,32%,32%,31%,10,7,3,5,4,1
403,https://vlr.gg/player/10192/chowdy,2024-06-26 07:45:00,0.97,1.18,1.07,210,200,218,33,17,16,30,19,11,20,10,10,+2,+1,+1,78%,75%,82%,138,132,145,28%,22%,36%,5,2,3,3,1,2
404,https://vlr.gg/player/35026/chaze,2024-06-26 07:45:00,0.24,1.52,0.82,158,73,260,11,2,9,15,11,4,12,5,7,+1,-1,+2,86%,75%,100%,104,43,177,8%,0%,10%,2,0,2,1,1,0
405,https://vlr.gg/player/6659/dragon,2024-06-26 07:40:00,2.10,1.06,1.77,291,337,183,41,33,8,15,9,6,14,9,5,+3,+4,-1,89%,88%,91%,193,218,139,37%,39%,29%,6,5,1,3,1,2
406,https://vlr.gg/player/1175/signed,2024-06-26 07:40:00,1.45,1.20,1.37,233,256,204,30,22,8,17,11,6,6,5,1,+2,+2,0,89%,88%,91%,159,174,127,24%,28%,16%,2,2,0,0,0,0
407,https://vlr.gg/player/1062/lew,2024-06-26 07:40:00,0.89,1.85,1.19,240,180,372,29,15,14,22,15,7,13,7,6,+3,0,+3,83%,79%,91%,165,135,230,19%,18%,21%,5,2,3,2,2,0
408,https://vlr.gg/player/5228/minimise,2024-06-26 07:40:00,0.83,1.66,1.09,191,181,212,27,17,10,19,15,4,10,6,4,+3,+2,+1,91%,88%,100%,121,108,150,28%,29%,27%,5,3,2,2,1,1
409,https://vlr.gg/player/2993/rdeew,2024-06-26 07:40:00,0.82,1.25,0.95,218,192,239,26,16,10,21,15,6,7,3,4,+10,+8,+2,80%,71%,100%,129,122,145,31%,28%,36%,10,8,2,0,0,0
410,https://vlr.gg/player/26321/songry,2024-06-26 07:40:00,0.90,1.20,1.11,200,189,220,27,8,19,27,9,18,4,0,4,-3,-1,-2,54%,55%,54%,138,126,144,38%,26%,44%,1,0,1,4,1,3
411,https://vlr.gg/player/15956/hash,2024-06-26 07:40:00,0.53,1.00,0.85,165,98,197,19,4,15,28,9,19,8,2,6,-3,-1,-2,69%,73%,67%,117,63,142,32%,42%,29%,1,0,1,4,1,3
412,https://vlr.gg/player/26322/lg1c,2024-06-26 07:40:00,0.38,0.59,0.51,162,140,164,18,5,13,33,11,22,3,1,2,-7,-2,-5,54%,45%,58%,103,95,107,11%,15%,10%,2,1,1,9,3,6
413,https://vlr.gg/player/31238/alucard,2024-06-26 07:40:00,0.73,0.38,0.47,138,187,119,17,7,10,33,10,23,5,1,4,-2,-2,0,51%,45%,54%,88,120,74,31%,50%,23%,1,0,1,3,2,1
414,https://vlr.gg/player/31583/maine,2024-06-26 07:40:00,0.37,0.47,0.44,121,141,121,13,5,8,32,11,21,9,2,7,-6,+1,-7,54%,45%,58%,93,83,98,20%,20%,19%,2,2,0,8,1,7
415,https://vlr.gg/player/6723/foxz,2024-06-26 07:00:00,1.98,1.51,1.79,298,343,240,39,28,11,18,10,8,17,10,7,+2,+2,0,74%,82%,62%,210,228,180,33%,32%,36%,4,3,1,2,1,1
416,https://vlr.gg/player/3342/sushiboys,2024-06-26 07:00:00,1.31,1.15,1.25,249,256,239,30,20,10,22,13,9,11,6,5,+2,+1,+1,77%,77%,77%,175,182,163,22%,26%,16%,3,2,1,1,1,0
417,https://vlr.gg/player/3401/ptc,2024-06-26 07:00:00,1.26,0.85,1.11,164,180,135,22,16,6,18,9,9,11,4,7,+4,+3,+1,74%,73%,77%,100,117,72,27%,28%,25%,5,3,2,1,0,1
418,https://vlr.gg/player/27254/leviathan,2024-06-26 07:00:00,0.80,1.57,1.08,164,108,272,23,10,13,19,11,8,14,6,8,+3,0,+3,74%,68%,85%,108,74,165,37%,40%,35%,4,1,3,1,1,0
419,https://vlr.gg/player/4377/johnolsen,2024-06-26 07:00:00,1.12,1.13,1.03,308,282,272,32,20,12,30,19,11,12,6,6,0,0,0,71%,68%,77%,194,199,187,28%,27%,32%,7,5,2,7,5,2
420,https://vlr.gg/player/15902/xcool3,2024-06-26 07:00:00,1.32,0.83,1.01,209,265,201,28,12,16,27,8,19,6,2,4,-2,-1,-1,69%,69%,68%,150,186,130,31%,48%,22%,2,1,1,4,2,2
421,https://vlr.gg/player/27248/earthy,2024-06-26 07:00:00,0.43,1.11,0.86,205,124,269,21,4,17,30,12,18,13,7,6,+1,-1,+2,63%,62%,64%,141,81,177,25%,27%,25%,3,0,3,2,1,1
422,https://vlr.gg/player/6721/pedio,2024-06-26 07:00:00,0.40,0.90,0.71,179,115,203,20,5,15,30,11,19,8,1,7,+3,0,+3,69%,62%,73%,103,79,117,36%,25%,41%,5,1,4,2,1,1
423,https://vlr.gg/player/18037/fluky,2024-06-26 07:00:00,1.06,0.43,0.66,149,240,123,19,12,7,29,10,19,12,7,5,-2,-1,-1,63%,69%,59%,106,146,83,19%,26%,14%,1,1,0,3,2,1
424,https://vlr.gg/player/41702/canady,2024-06-26 07:00:00,1.11,0.30,0.60,154,266,101,19,12,7,30,11,19,4,2,2,-11,-2,-9,54%,77%,41%,108,158,78,23%,27%,17%,1,1,0,12,3,9
425,https://vlr.gg/player/16924/stew,2024-06-26 07:00:00,,,,207,,,36,,,31,,,6,,,-2,,,,,,142,,,35%,,,6,,,8,,
426,https://vlr.gg/player/41029/z1yan,2024-06-26 07:00:00,,,,198,,,34,,,34,,,12,,,+2,,,,,,127,,,39%,,,5,,,3,,
427,https://vlr.gg/player/36415/viva,2024-06-26 07:00:00,,,,192,,,34,,,32,,,14,,,0,,,,,,123,,,35%,,,3,,,3,,
428,https://vlr.gg/player/10486/yhchen,2024-06-26 07:00:00,,,,149,,,22,,,36,,,20,,,-1,,,,,,100,,,12%,,,4,,,5,,
429,https://vlr.gg/player/3519/jkuro,2024-06-26 07:00:00,,,,130,,,22,,,39,,,5,,,+2,,,,,,82,,,36%,,,6,,,4,,
430,https://vlr.gg/player/3028/life,2024-06-26 07:00:00,,,,231,,,39,,,31,,,3,,,+2,,,,,,133,,,29%,,,12,,,10,,
431,https://vlr.gg/player/7857/berlin,2024-06-26 07:00:00,,,,216,,,33,,,34,,,22,,,-2,,,,,,139,,,24%,,,5,,,7,,
432,https://vlr.gg/player/19530/aaaay,2024-06-26 07:00:00,,,,201,,,35,,,28,,,15,,,0,,,,,,141,,,41%,,,1,,,1,,
433,https://vlr.gg/player/37489/lysoar,2024-06-26 07:00:00,,,,191,,,30,,,27,,,20,,,0,,,,,,123,,,34%,,,3,,,3,,
434,https://vlr.gg/player/872/autumn,2024-06-26 07:00:00,,,,183,,,35,,,28,,,5,,,-1,,,,,,128,,,35%,,,2,,,3,,
435,https://vlr.gg/player/36685/splash,2024-06-26 07:00:00,1.43,1.51,1.46,331,340,328,53,29,24,34,19,15,9,4,5,+1,0,+1,72%,77%,67%,213,222,202,31%,32%,30%,8,4,4,7,4,3
436,https://vlr.gg/player/36704/impecunity,2024-06-26 07:00:00,0.82,1.21,1.00,223,171,256,35,15,20,32,17,15,7,4,3,-3,-1,-2,64%,58%,71%,153,114,202,41%,41%,41%,3,2,1,6,3,3
437,https://vlr.gg/player/8156/mojo,2024-06-26 07:00:00,1.26,0.63,0.98,165,197,120,25,19,6,29,14,15,20,9,11,-2,-2,0,74%,77%,71%,104,122,81,20%,29%,4%,0,0,0,2,2,0
438,https://vlr.gg/player/44919/aplycs,2024-06-26 07:00:00,1.32,0.54,0.97,171,209,139,30,21,9,32,15,17,17,7,10,-1,+3,-4,79%,81%,76%,121,149,86,29%,39%,15%,3,3,0,4,0,4
439,https://vlr.gg/player/2377/aduka,2024-06-26 07:00:00,0.81,1.12,0.95,191,140,249,29,11,18,32,16,16,8,3,5,0,-2,+2,72%,69%,76%,131,102,168,34%,30%,37%,7,3,4,7,5,2
440,https://vlr.gg/player/34031/inf,2024-06-26 07:00:00,1.14,1.08,1.10,252,246,283,45,19,26,38,15,23,4,2,2,-2,0,-2,68%,67%,69%,171,165,176,31%,27%,35%,4,1,3,6,1,5
441,https://vlr.gg/player/10703/shiba,2024-06-26 07:00:00,1.37,0.60,0.95,190,274,127,28,17,11,33,15,18,17,11,6,+3,+3,0,64%,76%,54%,128,178,87,24%,26%,20%,4,3,1,1,0,1
442,https://vlr.gg/player/7418/bryce,2024-06-26 07:00:00,1.08,0.81,0.93,181,180,170,28,14,14,31,14,17,12,6,6,+2,+1,+1,68%,76%,62%,121,123,119,25%,39%,17%,4,2,2,2,1,1
443,https://vlr.gg/player/7417/joshh,2024-06-26 07:00:00,0.69,1.06,0.89,162,141,190,27,11,16,34,17,17,16,6,10,0,-1,+1,68%,62%,73%,115,96,131,31%,21%,39%,6,3,3,6,4,2
444,https://vlr.gg/player/42389/persona11,2024-06-26 07:00:00,0.95,0.76,0.84,177,198,160,31,17,14,36,16,20,7,2,5,+2,0,+2,70%,81%,62%,117,130,107,16%,19%,13%,8,3,5,6,3,3
445,https://vlr.gg/player/46042/youjun,2024-06-26 07:00:00,0.91,1.70,1.23,257,190,361,34,15,19,31,20,11,17,8,9,-1,-2,+1,66%,54%,82%,167,124,227,15%,19%,12%,5,3,2,6,5,1
446,https://vlr.gg/player/46040/youze,2024-06-26 07:00:00,1.00,1.04,1.01,212,201,229,27,16,11,32,19,13,23,10,13,+3,+3,0,63%,58%,71%,138,132,147,21%,24%,18%,3,3,0,0,0,0
447,https://vlr.gg/player/42996/sheny9,2024-06-26 07:00:00,0.42,1.33,0.79,183,117,274,26,8,18,34,23,11,11,11,0,+3,+1,+2,63%,54%,76%,120,81,174,24%,9%,47%,3,1,2,0,0,0
448,https://vlr.gg/player/46041/boyi,2024-06-26 07:00:00,0.85,0.62,0.76,146,168,117,21,14,7,32,20,12,13,8,5,0,+3,-3,61%,63%,59%,109,117,98,31%,31%,32%,4,3,1,4,0,4
449,https://vlr.gg/player/46551/bubble,2024-06-26 07:00:00,0.98,0.28,0.69,182,230,109,26,19,7,34,20,14,4,4,0,-2,+1,-3,54%,67%,35%,114,147,67,35%,30%,50%,7,5,2,9,4,5
450,https://vlr.gg/player/42994/nasty,2024-06-26 07:00:00,1.75,1.77,1.76,358,351,370,54,22,32,25,11,14,9,3,6,+6,+5,+1,80%,71%,88%,233,223,239,39%,45%,35%,9,6,3,3,1,2
451,https://vlr.gg/player/46462/shu,2024-06-26 07:00:00,0.84,1.15,1.02,178,170,186,29,11,18,24,11,13,13,7,6,-4,-3,-1,76%,71%,79%,117,105,125,23%,27%,21%,2,1,1,6,4,2
452,https://vlr.gg/player/2371/popoman4q,2024-06-26 07:00:00,0.57,1.29,0.99,197,115,242,26,7,19,27,13,14,16,3,13,0,+1,-1,68%,59%,75%,123,73,159,22%,9%,27%,4,2,2,4,1,3
453,https://vlr.gg/player/31853/n11,2024-06-26 07:00:00,0.73,1.11,0.95,174,153,191,27,9,18,29,14,15,17,8,9,+1,0,+1,80%,71%,88%,119,101,131,40%,53%,34%,2,1,1,1,1,0
454,https://vlr.gg/player/46327/ethan,2024-06-26 07:00:00,0.99,0.85,0.91,197,216,186,27,12,15,29,13,16,14,5,9,-6,0,-6,71%,82%,63%,136,153,125,34%,33%,34%,2,0,2,8,0,8
455,https://vlr.gg/player/6913/sultan,2024-06-26 06:30:00,1.16,1.27,1.21,246,228,274,64,32,32,50,26,24,24,11,13,+3,+2,+1,75%,68%,82%,161,146,177,43%,53%,35%,8,4,4,5,2,3
456,https://vlr.gg/player/16215/dos9,2024-06-26 06:30:00,1.23,1.01,1.13,212,220,205,52,29,23,44,23,21,21,12,9,0,0,0,81%,82%,79%,140,148,131,25%,31%,19%,5,1,4,5,1,4
457,https://vlr.gg/player/3630/skillz,2024-06-26 06:30:00,0.90,1.12,1.01,182,157,209,47,22,25,44,24,20,20,9,11,+2,+2,0,76%,79%,74%,121,104,140,40%,37%,44%,8,7,1,6,5,1
458,https://vlr.gg/player/10463/paradox,2024-06-26 06:30:00,0.90,0.91,0.90,173,189,161,43,23,20,50,26,24,30,15,15,+3,+1,+2,69%,71%,68%,118,134,100,31%,32%,28%,7,3,4,4,2,2
459,https://vlr.gg/player/4095/skrossi,2024-06-26 06:30:00,0.85,0.87,0.86,184,190,169,46,26,20,51,26,25,10,4,6,-1,-3,+2,67%,66%,68%,122,124,120,20%,22%,17%,11,5,6,12,8,4
460,https://vlr.gg/player/7434/d1srupt,2024-06-26 06:30:00,0.92,1.12,1.03,190,174,198,49,22,27,50,25,25,22,13,9,-2,-4,+2,78%,74%,82%,127,117,136,38%,45%,34%,4,1,3,6,5,1
461,https://vlr.gg/player/3628/deathmaker,2024-06-26 06:30:00,0.95,1.03,0.99,221,213,227,54,25,29,53,25,28,9,5,4,+4,+2,+2,64%,62%,66%,146,137,154,27%,28%,25%,18,9,9,14,7,7
462,https://vlr.gg/player/27775/techno,2024-06-26 06:30:00,1.02,0.91,0.96,187,198,189,46,23,23,51,24,27,24,12,12,0,+3,-3,71%,71%,71%,127,127,126,19%,16%,22%,6,4,2,6,1,5
463,https://vlr.gg/player/3627/hellff,2024-06-26 06:30:00,0.95,0.97,0.96,215,216,211,50,23,27,55,26,29,16,9,7,-7,-4,-3,57%,65%,50%,146,152,140,32%,33%,31%,4,1,3,11,5,6
464,https://vlr.gg/player/9741/aryu,2024-06-26 06:30:00,1.01,0.81,0.90,147,160,147,40,22,18,44,20,24,10,2,8,-2,-1,-1,79%,79%,79%,109,109,108,30%,27%,32%,1,0,1,3,1,2
465,https://vlr.gg/player/46134/denz,2024-06-26 05:20:00,1.55,1.83,1.69,304,287,327,49,24,25,28,13,15,7,1,6,+3,-2,+5,67%,55%,81%,196,185,208,38%,37%,39%,8,2,6,5,4,1
466,https://vlr.gg/player/46135/zeus,2024-06-26 05:20:00,0.88,1.07,0.98,242,235,252,36,18,18,36,18,18,5,2,3,-2,-1,-1,77%,68%,86%,155,146,165,35%,42%,29%,4,1,3,6,2,4
467,https://vlr.gg/player/11541/xty,2024-06-26 05:20:00,1.05,0.58,0.82,145,168,120,22,14,8,32,14,18,20,11,9,-2,0,-2,84%,91%,76%,94,101,86,24%,23%,26%,0,0,0,2,0,2
468,https://vlr.gg/player/44294/eur,2024-06-26 05:20:00,0.69,0.46,0.58,157,160,155,22,11,11,39,20,19,10,7,3,-6,-3,-3,67%,68%,67%,104,105,102,22%,21%,23%,1,1,0,7,4,3
469,https://vlr.gg/player/36013/hydrakid,2024-06-26 05:20:00,0.55,0.39,0.48,114,137,85,7,5,2,18,10,8,5,4,1,0,+1,-1,33%,42%,22%,80,82,79,20%,27%,11%,3,3,0,3,2,1
470,https://vlr.gg/player/46132/sly,2024-06-26 05:20:00,0.57,0.41,0.48,103,91,113,8,3,5,16,6,10,6,5,1,-4,-3,-1,59%,60%,58%,74,70,78,44%,50%,40%,0,0,0,4,3,1
471,https://vlr.gg/player/13744/patmen,2024-06-26 05:20:00,1.47,1.21,1.34,294,337,252,44,25,19,31,14,17,12,5,7,+4,0,+4,81%,86%,77%,191,215,167,31%,33%,30%,7,3,4,3,3,0
472,https://vlr.gg/player/16953/zynd,2024-06-26 05:20:00,0.96,1.59,1.28,250,188,309,41,15,26,25,13,12,7,3,4,-2,-1,-1,74%,67%,82%,174,143,204,32%,31%,33%,1,0,1,3,1,2
473,https://vlr.gg/player/9737/kakarot,2024-06-26 05:20:00,1.00,1.18,1.09,250,270,228,34,19,15,31,19,12,7,3,4,+7,+2,+5,63%,62%,64%,162,170,155,20%,22%,18%,12,6,6,5,4,1
474,https://vlr.gg/player/13223/micr0,2024-06-26 05:20:00,1.36,0.70,1.02,191,227,158,32,19,13,29,12,17,12,7,5,+1,+2,-1,74%,81%,68%,117,143,92,17%,20%,14%,2,2,0,1,0,1
475,https://vlr.gg/player/7746/kevzii,2024-06-26 05:20:00,0.89,0.60,0.74,131,130,134,18,10,8,28,11,17,17,9,8,+1,0,+1,74%,81%,68%,90,97,83,26%,24%,29%,5,1,4,4,1,3
476,https://vlr.gg/player/46472/sasuke,2024-06-26 04:45:00,1.00,1.52,1.24,264,216,331,41,19,22,34,17,17,7,1,6,-1,-3,+2,64%,54%,75%,171,138,210,28%,38%,21%,8,3,5,9,6,3
477,https://vlr.gg/player/42793/kally,2024-06-26 04:45:00,1.11,0.88,1.01,173,166,179,25,14,11,23,11,12,9,4,5,-1,0,-1,75%,75%,75%,116,114,119,34%,33%,35%,0,0,0,1,0,1
478,https://vlr.gg/player/4127/felix,2024-06-26 04:45:00,1.20,0.52,0.89,162,195,115,25,17,8,31,13,18,11,7,4,-3,-1,-2,73%,79%,65%,97,117,73,21%,29%,10%,2,1,1,5,2,3
479,https://vlr.gg/player/25089/cabeza,2024-06-26 04:45:00,0.91,0.76,0.84,170,168,180,27,15,12,32,16,16,6,2,4,+5,+3,+2,70%,67%,75%,114,113,114,29%,26%,33%,7,4,3,2,1,1
480,https://vlr.gg/player/42716/doyou,2024-06-26 04:45:00,0.77,0.86,0.81,178,185,174,27,15,12,33,19,14,14,7,7,0,-1,+1,73%,79%,65%,112,112,112,30%,26%,38%,5,3,2,5,4,1
481,https://vlr.gg/player/985/efina,2024-06-26 04:45:00,1.57,1.13,1.33,214,248,208,37,21,16,22,9,13,4,2,2,+2,+1,+1,70%,80%,63%,144,152,137,25%,23%,27%,6,2,4,4,1,3
482,https://vlr.gg/player/9783/doenmo,2024-06-26 04:45:00,1.41,0.86,1.11,221,236,199,32,17,15,28,10,18,19,11,8,-4,-2,-2,75%,75%,75%,138,154,124,19%,15%,22%,1,0,1,5,2,3
483,https://vlr.gg/player/4827/goddead,2024-06-26 04:45:00,0.92,0.95,0.94,204,216,186,32,15,17,34,16,18,13,8,5,0,-1,+1,73%,70%,75%,129,133,125,32%,25%,41%,5,3,2,5,4,1
484,https://vlr.gg/player/5280/972,2024-06-26 04:45:00,0.87,0.77,0.82,166,199,133,27,15,12,29,14,15,13,5,8,0,+1,-1,77%,75%,79%,104,129,84,32%,39%,26%,3,2,1,3,1,2
485,https://vlr.gg/player/5283/bunny,2024-06-26 04:45:00,0.51,1.00,0.78,161,133,183,25,9,16,32,16,16,6,2,4,+2,-1,+3,68%,75%,63%,110,84,131,13%,10%,15%,7,2,5,5,3,2
486,https://vlr.gg/player/31254/feta,2024-06-26 04:30:00,0.80,1.56,1.16,252,200,319,57,24,33,48,28,20,13,4,9,+6,-1,+7,71%,61%,83%,171,134,213,37%,32%,42%,15,5,10,9,6,3
487,https://vlr.gg/player/14170/mckinley,2024-06-26 04:30:00,0.99,1.32,1.14,204,177,234,42,19,23,38,23,15,23,17,6,-1,-3,+2,74%,73%,76%,148,133,164,24%,19%,29%,3,1,2,4,4,0
488,https://vlr.gg/player/29821/sinaway,2024-06-26 04:30:00,1.00,0.95,0.98,184,189,188,42,23,19,43,21,22,11,5,6,-2,-3,+1,71%,64%,79%,143,136,150,25%,23%,26%,2,0,2,4,3,1
489,https://vlr.gg/player/31255/biggiecheese,2024-06-26 04:30:00,0.98,0.94,0.96,220,232,198,43,24,19,47,26,21,27,15,12,+1,-1,+2,73%,76%,69%,139,141,137,28%,26%,30%,8,4,4,7,5,2
490,https://vlr.gg/player/22828/milky,2024-06-26 04:30:00,1.06,0.78,0.93,183,204,158,41,25,16,42,23,19,21,13,8,0,-1,+1,74%,76%,72%,112,118,105,25%,29%,20%,5,2,3,5,3,2
491,https://vlr.gg/player/43125/kadiri,2024-06-26 04:30:00,1.03,1.61,1.34,275,233,312,61,25,36,47,23,24,17,2,15,+8,+2,+6,68%,59%,76%,185,152,215,39%,56%,29%,10,3,7,2,1,1
492,https://vlr.gg/player/41185/kaza,2024-06-26 04:30:00,1.07,1.03,1.05,209,231,192,45,22,23,46,23,23,18,8,10,+2,-2,+4,68%,62%,73%,139,154,126,21%,22%,19%,5,1,4,3,3,0
493,https://vlr.gg/player/5436/azoh,2024-06-26 04:30:00,0.77,1.18,0.99,198,173,221,43,17,26,44,23,21,21,8,13,-6,-5,-1,68%,72%,64%,139,122,153,24%,26%,22%,6,2,4,12,7,5
494,https://vlr.gg/player/34257/strame,2024-06-26 04:30:00,0.81,0.76,0.79,134,149,127,33,18,15,41,20,21,8,3,5,-1,-2,+1,65%,66%,64%,94,104,86,41%,47%,36%,5,1,4,6,3,3
495,https://vlr.gg/player/14336/loubert,2024-06-26 04:30:00,0.82,0.75,0.78,169,159,180,36,15,21,47,21,26,19,11,8,-7,-6,-1,66%,66%,67%,109,108,109,25%,25%,25%,3,1,2,10,7,3
496,https://vlr.gg/player/13000/redlight,2024-06-26 02:00:00,2.51,1.05,1.53,238,387,164,18,9,9,7,1,6,2,1,1,0,0,0,83%,100%,75%,156,240,114,50%,47%,53%,1,0,1,1,0,1
497,https://vlr.gg/player/4475/benecia,2024-06-26 02:00:00,1.78,1.14,1.40,231,262,216,35,17,18,25,8,17,23,10,13,0,+1,-1,85%,94%,79%,156,180,139,34%,28%,41%,3,1,2,3,0,3
498,https://vlr.gg/player/20879/sungjin,2024-06-26 02:00:00,1.02,1.42,1.25,220,181,245,33,11,22,22,10,12,9,4,5,+5,+1,+4,68%,65%,71%,149,116,173,26%,27%,25%,6,2,4,1,1,0
499,https://vlr.gg/player/37535/jaebin,2024-06-26 02:00:00,1.45,0.90,1.13,263,332,225,39,21,18,30,11,19,11,4,7,+2,+4,-2,78%,82%,75%,170,207,145,30%,31%,29%,7,5,2,5,1,4
500,https://vlr.gg/player/4657/moves,2024-06-26 02:00:00,0.73,1.13,0.97,200,115,249,24,6,18,27,9,18,22,5,17,+2,0,+2,76%,76%,75%,127,69,168,28%,25%,29%,6,2,4,4,2,2
501,https://vlr.gg/player/9192/cloudy,2024-06-26 02:00:00,0.76,0.69,0.72,130,127,133,9,4,5,15,7,8,5,3,2,-4,-3,-1,65%,64%,67%,91,92,90,19%,25%,9%,0,0,0,4,3,1
502,https://vlr.gg/player/4054/secret,2024-06-26 02:00:00,1.16,0.61,0.93,183,212,151,26,18,8,28,16,12,8,6,2,0,0,0,56%,63%,47%,128,147,101,38%,39%,36%,4,2,2,4,2,2
503,https://vlr.gg/player/42749/godsb,2024-06-26 02:00:00,0.73,1.14,0.90,233,222,239,31,17,14,34,22,12,9,7,2,-1,-1,0,71%,67%,76%,151,148,155,28%,22%,37%,7,4,3,8,5,3
504,https://vlr.gg/player/9236/manggong,2024-06-26 02:00:00,0.87,0.80,0.84,146,124,189,24,12,12,30,15,15,8,5,3,-3,-3,0,68%,71%,65%,101,91,116,32%,46%,21%,0,0,0,3,3,0
505,https://vlr.gg/player/17063/vow,2024-06-26 02:00:00,1.09,0.43,0.81,185,213,137,23,16,7,33,18,15,10,7,3,0,+3,-3,63%,71%,53%,126,153,89,35%,36%,33%,5,4,1,5,1,4
506,https://vlr.gg/player/4038/bangnan,2024-06-26 02:00:00,0.94,0.33,0.69,148,203,84,22,17,5,33,19,14,7,7,0,-1,-1,0,61%,71%,47%,101,136,51,41%,41%,42%,2,1,1,3,2,1
0,https://vlr.gg/player/10217/marky,2024-06-26 02:00:00,0.98,1.55,1.29,235,224,237,59,25,34,40,25,15,23,11,12,+1,-2,+3,82%,77%,86%,148,141,154,27%,25%,28%,5,1,4,4,3,1
1,https://vlr.gg/player/7437/kellys,2024-06-26 02:00:00,0.83,1.54,1.21,251,179,318,57,19,38,45,25,20,15,3,12,-4,-5,+1,70%,58%,81%,158,106,202,16%,19%,15%,13,5,8,17,10,7
2,https://vlr.gg/player/10782/witz,2024-06-26 02:00:00,1.08,1.15,1.12,194,210,184,45,24,21,40,22,18,31,9,22,+2,+1,+1,76%,84%,69%,127,130,124,14%,16%,13%,4,2,2,2,1,1
3,https://vlr.gg/player/7754/xavi8k,2024-06-26 02:00:00,0.85,1.03,0.95,202,191,209,45,18,27,47,24,23,15,8,7,0,-3,+3,73%,68%,78%,135,129,140,27%,29%,25%,6,1,5,6,4,2
4,https://vlr.gg/player/2679/dubstep,2024-06-26 02:00:00,0.52,0.98,0.77,138,121,158,34,12,22,46,26,20,16,10,6,-6,-2,-4,78%,77%,78%,88,74,101,31%,33%,30%,2,1,1,8,3,5
5,https://vlr.gg/player/13220/ja,2024-06-26 02:00:00,0.77,1.45,1.08,242,202,293,57,24,33,51,31,20,9,4,5,+2,-2,+4,64%,53%,77%,154,129,182,28%,29%,28%,7,3,4,5,5,0
6,https://vlr.gg/player/13219/papi,2024-06-26 02:00:00,0.98,1.03,1.01,147,147,150,37,21,16,41,24,17,31,10,21,-2,0,-2,81%,81%,81%,101,95,109,32%,33%,31%,2,0,2,4,0,4
7,https://vlr.gg/player/16842/mojer,2024-06-26 02:00:00,0.62,1.40,0.98,221,147,313,47,14,33,52,29,23,19,11,8,+4,-1,+5,67%,61%,74%,161,121,208,20%,24%,18%,13,6,7,9,7,2
8,https://vlr.gg/player/7749/nexi,2024-06-26 02:00:00,0.82,1.10,0.95,162,163,168,38,19,19,47,29,18,32,10,22,-1,-1,0,69%,64%,74%,112,120,103,29%,28%,30%,7,3,4,8,4,4
9,https://vlr.gg/player/9747/emman,2024-06-26 02:00:00,0.64,0.98,0.79,172,156,191,38,18,20,49,29,20,17,5,12,+4,0,+4,63%,50%,77%,113,99,128,26%,22%,30%,8,4,4,4,4,0
10,https://vlr.gg/player/5395/cortezia,2024-06-25 18:35:00,1.18,1.59,1.38,280,254,313,61,27,34,39,20,19,14,5,9,+5,+1,+4,71%,69%,72%,184,159,209,45%,40%,50%,10,4,6,5,3,2
11,https://vlr.gg/player/3455/zanatsu,2024-06-25 18:35:00,0.66,1.41,1.03,241,200,280,49,20,29,44,25,19,10,3,7,-1,-5,+4,64%,48%,79%,155,125,184,30%,21%,37%,10,3,7,11,8,3
12,https://vlr.gg/player/3433/ctc,2024-06-25 18:35:00,0.96,0.96,0.96,192,200,180,38,20,18,37,20,17,17,7,10,0,-1,+1,74%,79%,69%,128,134,121,32%,29%,35%,3,0,3,3,1,2
13,https://vlr.gg/player/1586/v1nny,2024-06-25 18:35:00,0.86,0.65,0.76,160,186,139,29,17,12,45,24,21,22,12,10,-1,0,-1,69%,72%,66%,107,122,91,36%,42%,30%,3,2,1,4,2,2
14,https://vlr.gg/player/3157/gaabxx,2024-06-25 18:35:00,0.45,0.65,0.55,119,120,122,21,10,11,44,24,20,23,12,11,-5,-4,-1,71%,66%,76%,85,84,85,14%,14%,13%,2,1,1,7,5,2
15,https://vlr.gg/player/1567/bezn1,2024-06-25 18:35:00,1.17,1.46,1.32,232,230,228,46,23,23,35,21,14,29,10,19,+4,+1,+3,79%,76%,83%,147,151,144,23%,23%,22%,7,3,4,3,2,1
16,https://vlr.gg/player/27149/brinks,2024-06-25 18:35:00,0.91,1.43,1.17,217,195,244,47,20,27,37,20,17,27,13,14,-3,-5,+2,81%,66%,97%,136,124,149,32%,33%,32%,4,2,2,7,7,0
17,https://vlr.gg/player/1684/denaro,2024-06-25 18:35:00,0.80,1.29,1.04,205,160,246,45,17,28,40,20,20,17,8,9,+2,-1,+3,71%,66%,76%,123,96,151,24%,27%,22%,8,2,6,6,3,3
18,https://vlr.gg/player/1566/prozin,2024-06-25 18:35:00,0.99,0.88,0.94,170,183,164,36,20,16,40,20,20,18,6,12,+1,-1,+2,83%,79%,86%,115,120,110,24%,34%,17%,4,1,3,3,2,1
19,https://vlr.gg/player/1999/rnd,2024-06-25 18:35:00,0.70,0.88,0.79,202,175,223,35,16,19,46,23,23,20,8,12,-2,-1,-1,71%,62%,79%,131,114,148,15%,15%,14%,7,3,4,9,4,5
20,https://vlr.gg/player/660/pancc,2024-06-25 16:00:00,1.36,0.90,1.10,222,267,177,33,19,14,30,12,18,10,2,8,+1,+1,0,70%,68%,71%,138,172,112,33%,34%,31%,5,3,2,4,2,2
21,https://vlr.gg/player/1581/guhrvn,2024-06-25 16:00:00,0.72,0.96,0.86,171,149,189,27,10,17,33,15,18,12,7,5,-4,-1,-3,63%,68%,58%,112,93,126,30%,29%,31%,1,0,1,5,1,4
22,https://vlr.gg/player/20238/askia,2024-06-25 16:00:00,0.72,0.95,0.85,177,146,198,23,8,15,31,15,16,13,5,8,+1,+1,0,72%,68%,75%,121,108,130,23%,23%,22%,1,1,0,0,0,0
23,https://vlr.gg/player/25743/raafa,2024-06-25 16:00:00,0.60,0.93,0.79,205,160,247,28,10,18,37,16,21,12,5,7,-1,-4,+3,58%,58%,58%,126,86,158,25%,13%,33%,6,1,5,7,5,2
24,https://vlr.gg/player/8873/dgzin,2024-06-25 16:00:00,0.46,0.93,0.72,169,137,198,25,8,17,35,17,18,10,4,6,-2,-2,0,72%,74%,71%,107,86,124,18%,22%,15%,6,2,4,8,4,4
25,https://vlr.gg/player/21251/blowz,2024-06-25 16:00:00,1.25,1.74,1.47,282,265,301,42,21,21,26,17,9,14,9,5,+5,+2,+3,79%,75%,84%,176,175,177,30%,25%,38%,8,4,4,3,2,1
26,https://vlr.gg/player/1578/shion,2024-06-25 16:00:00,1.10,1.32,1.20,214,208,232,32,17,15,26,17,9,27,11,16,-3,-2,-1,84%,88%,79%,145,141,150,21%,22%,20%,2,0,2,5,2,3
27,https://vlr.gg/player/5722/prince,2024-06-25 16:00:00,1.32,0.79,1.09,159,185,127,25,18,7,22,11,11,16,7,9,+1,0,+1,79%,88%,68%,108,121,91,30%,36%,23%,3,2,1,2,2,0
28,https://vlr.gg/player/2486/pollo,2024-06-25 16:00:00,0.91,1.21,1.04,195,212,167,30,17,13,27,18,9,12,7,5,-1,+1,-2,86%,88%,84%,120,133,104,31%,39%,23%,2,2,0,3,1,2
29,https://vlr.gg/player/42867/ghoul33,2024-06-25 16:00:00,0.82,1.09,0.94,241,201,284,37,18,19,35,18,17,7,3,4,+3,-1,+4,72%,71%,74%,149,123,182,37%,41%,34%,9,4,5,6,5,1
30,https://vlr.gg/player/15916/jotinha,2024-06-25 16:00:00,1.21,0.71,0.96,197,236,157,45,26,19,46,22,24,26,18,8,-4,+1,-5,68%,79%,57%,119,145,94,39%,43%,33%,4,3,1,8,2,6
31,https://vlr.gg/player/46082/jcz,2024-06-25 16:00:00,0.94,0.96,0.95,171,176,166,41,21,20,44,23,21,19,8,11,-1,-2,+1,67%,68%,66%,113,110,116,19%,18%,20%,3,0,3,4,2,2
32,https://vlr.gg/player/39154/kimb0,2024-06-25 16:00:00,1.00,0.82,0.91,196,230,164,50,29,21,46,24,22,8,6,2,-3,-3,0,70%,74%,66%,125,148,103,29%,34%,24%,6,3,3,9,6,3
33,https://vlr.gg/player/29123/kivary,2024-06-25 16:00:00,0.48,1.12,0.80,170,125,218,43,15,28,49,28,21,7,4,3,-5,-5,0,62%,59%,66%,116,84,146,25%,24%,25%,10,4,6,15,9,6
34,https://vlr.gg/player/15547/forcee,2024-06-25 16:00:00,0.70,0.86,0.78,129,140,121,27,15,12,46,26,20,35,16,19,+2,+3,-1,70%,62%,77%,76,80,72,23%,26%,20%,6,4,2,4,1,3
35,https://vlr.gg/player/41135/dantedeu5,2024-06-25 16:00:00,1.38,1.13,1.26,294,309,279,72,38,34,49,23,26,6,4,2,+4,0,+4,75%,80%,71%,180,188,171,33%,44%,22%,17,7,10,13,7,6
36,https://vlr.gg/player/9354/cebando,2024-06-25 16:00:00,1.32,0.95,1.14,176,208,143,46,28,18,39,19,20,18,9,9,+6,+7,-1,70%,69%,71%,108,134,82,38%,39%,37%,11,8,3,5,1,4
37,https://vlr.gg/player/13861/nicomachine,2024-06-25 16:00:00,1.01,1.20,1.10,190,158,223,45,19,26,40,19,21,26,10,16,+2,0,+2,78%,77%,79%,118,93,144,24%,24%,24%,7,3,4,5,3,2
38,https://vlr.gg/player/3826/adverso,2024-06-25 16:00:00,0.67,1.51,1.08,183,97,273,40,10,30,42,22,20,28,12,16,-2,-1,-1,71%,66%,76%,132,72,194,23%,24%,22%,2,2,0,4,3,1
39,https://vlr.gg/player/2585/tinchoff,2024-06-25 16:00:00,0.74,0.89,0.82,117,105,130,28,13,15,36,17,19,9,2,7,+1,-1,+2,75%,80%,71%,81,75,88,29%,29%,29%,3,0,3,2,1,1
40,https://vlr.gg/player/5550/grubinho,2024-06-25 14:00:00,1.51,1.38,1.46,272,307,229,43,27,16,23,14,9,18,10,8,+3,+2,+1,84%,88%,79%,158,183,126,34%,35%,33%,6,3,3,3,1,2
41,https://vlr.gg/player/14681/kamo,2024-06-25 14:00:00,1.41,1.27,1.35,288,329,233,45,29,16,25,14,11,12,6,6,+1,0,+1,75%,76%,74%,189,211,159,26%,30%,22%,10,8,2,9,8,1
42,https://vlr.gg/player/1428/sheydos,2024-06-25 14:00:00,1.07,1.50,1.25,199,146,267,35,16,19,20,10,10,6,2,4,+1,0,+1,75%,68%,84%,131,98,175,26%,33%,22%,3,0,3,2,0,2
43,https://vlr.gg/player/565/starxo,2024-06-25 14:00:00,1.31,1.14,1.23,215,220,207,31,17,14,24,13,11,34,23,11,+1,0,+1,82%,92%,68%,137,149,122,24%,23%,27%,3,1,2,2,1,1
44,https://vlr.gg/player/451/shadow,2024-06-25 14:00:00,0.88,1.20,1.02,150,139,166,26,14,12,23,14,9,16,8,8,-4,-3,-1,80%,80%,79%,92,86,99,21%,24%,18%,1,0,1,5,3,2
45,https://vlr.gg/player/4181/cloud,2024-06-25 14:00:00,1.12,0.82,0.95,174,208,167,29,14,15,35,15,20,11,7,4,0,-1,+1,64%,74%,56%,122,146,104,31%,36%,26%,3,1,2,3,2,1
46,https://vlr.gg/player/1885/purp0,2024-06-25 14:00:00,0.95,0.88,0.91,195,205,205,30,14,16,37,15,22,9,2,7,-1,+1,-2,61%,63%,60%,141,138,143,33%,36%,30%,8,4,4,9,3,6
47,https://vlr.gg/player/292/fit1nho,2024-06-25 14:00:00,0.55,0.97,0.79,160,113,195,22,7,15,36,16,20,9,2,7,+1,0,+1,59%,53%,64%,110,85,129,30%,42%,26%,2,1,1,1,1,0
48,https://vlr.gg/player/2690/hoody,2024-06-25 14:00:00,0.76,0.78,0.77,174,172,162,26,12,14,35,14,21,6,2,4,+2,0,+2,52%,53%,52%,111,113,110,29%,33%,26%,6,1,5,4,1,3
49,https://vlr.gg/player/1427/redgar,2024-06-25 14:00:00,0.16,0.46,0.33,77,80,68,8,3,5,37,17,20,19,7,12,-4,-3,-1,50%,53%,48%,52,65,42,21%,22%,20%,2,1,1,6,4,2
50,https://vlr.gg/player/8137/lenne,2024-06-25 10:00:00,1.53,1.15,1.37,259,285,187,35,25,10,21,13,8,12,6,6,+4,+3,+1,81%,86%,73%,155,181,118,38%,32%,53%,5,3,2,1,0,1
51,https://vlr.gg/player/2381/divine,2024-06-25 10:00:00,1.16,1.60,1.34,226,205,243,29,15,14,19,12,7,16,8,8,+2,0,+2,86%,86%,87%,145,139,152,36%,38%,34%,3,1,2,1,1,0
52,https://vlr.gg/player/11737/xan,2024-06-25 10:00:00,1.26,1.42,1.32,290,284,288,37,22,15,26,16,10,11,8,3,+2,-1,+3,81%,86%,73%,182,188,174,21%,23%,16%,9,5,4,7,6,1
53,https://vlr.gg/player/24654/tempz,2024-06-25 10:00:00,1.39,1.19,1.30,209,213,213,29,18,11,21,11,10,19,11,8,-1,-1,0,78%,76%,80%,128,129,127,30%,28%,33%,1,0,1,2,1,1
54,https://vlr.gg/player/9158/hyk,2024-06-25 10:00:00,0.71,1.07,0.86,170,169,182,22,12,10,24,15,9,9,5,4,+3,+2,+1,75%,71%,80%,113,100,133,35%,25%,48%,5,3,2,2,1,1
55,https://vlr.gg/player/16942/reverie,2024-06-25 10:00:00,1.07,1.09,1.09,222,260,216,28,13,15,28,12,16,7,1,6,-1,0,-1,69%,73%,67%,163,177,153,27%,23%,31%,2,1,1,3,1,2
56,https://vlr.gg/player/7007/shinsei,2024-06-25 10:00:00,1.25,0.65,0.90,205,246,201,27,14,13,30,10,20,5,2,3,0,+1,-1,64%,67%,62%,151,172,136,22%,15%,27%,5,2,3,5,1,4
57,https://vlr.gg/player/27073/esmonde,2024-06-25 10:00:00,0.63,0.74,0.70,177,154,199,23,9,14,32,13,19,11,5,6,+2,-1,+3,69%,53%,81%,108,84,125,14%,12%,15%,3,0,3,1,1,0
58,https://vlr.gg/player/27053/ender,2024-06-25 10:00:00,0.19,1.00,0.65,172,60,234,20,3,17,31,13,18,3,2,1,-7,-6,-1,53%,33%,67%,102,41,146,38%,50%,36%,3,1,2,10,7,3
59,https://vlr.gg/player/19126/kayle,2024-06-25 10:00:00,0.41,0.44,0.41,109,103,110,13,5,8,31,12,19,8,2,6,-4,-1,-3,61%,53%,67%,72,68,75,22%,17%,26%,0,0,0,4,1,3
60,https://vlr.gg/player/3627/hellff,2024-06-25 08:45:00,1.11,1.82,1.60,286,218,324,39,10,29,19,8,11,15,2,13,+1,-3,+4,80%,73%,83%,180,121,207,23%,17%,25%,5,1,4,4,4,0
61,https://vlr.gg/player/27775/techno,2024-06-25 08:45:00,1.87,1.41,1.55,250,266,241,35,14,21,16,4,12,19,2,17,+3,+1,+2,83%,82%,83%,146,154,143,20%,18%,21%,6,1,5,3,0,3
62,https://vlr.gg/player/3628/deathmaker,2024-06-25 08:45:00,0.56,1.70,1.34,283,157,319,32,5,27,24,10,14,7,3,4,+4,-1,+5,86%,82%,88%,168,96,201,24%,19%,25%,7,1,6,3,2,1
63,https://vlr.gg/player/7434/d1srupt,2024-06-25 08:45:00,1.61,1.01,1.20,201,255,174,26,11,15,19,5,14,21,5,16,0,+1,-1,83%,73%,88%,136,162,123,33%,28%,36%,2,1,1,2,0,2
64,https://vlr.gg/player/9741/aryu,2024-06-25 08:45:00,1.17,1.09,1.12,180,252,157,23,8,15,18,7,11,14,5,9,-1,+1,-2,86%,91%,83%,140,175,123,28%,24%,31%,1,1,0,2,0,2
65,https://vlr.gg/player/27336/venka,2024-06-25 08:45:00,0.73,1.39,0.93,219,190,316,28,16,12,30,22,8,5,4,1,-3,-3,0,57%,50%,73%,138,111,195,25%,34%,19%,5,3,2,8,6,2
66,https://vlr.gg/player/1745/adrnking,2024-06-25 08:45:00,0.72,0.49,0.65,159,162,151,16,11,5,30,20,10,11,8,3,+1,+1,0,69%,75%,55%,108,110,104,22%,26%,13%,4,3,1,3,2,1
67,https://vlr.gg/player/9263/sayoo,2024-06-25 08:45:00,0.72,0.45,0.63,170,185,119,20,15,5,32,22,10,6,5,1,-2,-2,0,57%,50%,73%,103,119,66,25%,27%,19%,2,1,1,4,3,1
68,https://vlr.gg/player/3639/hoax,2024-06-25 08:45:00,0.60,0.51,0.57,152,138,200,18,11,7,32,21,11,14,11,3,-2,-3,+1,80%,79%,82%,101,83,140,25%,21%,32%,1,0,1,3,3,0
69,https://vlr.gg/player/10758/kohliii,2024-06-25 08:45:00,0.50,0.60,0.53,126,122,129,14,9,5,31,22,9,11,7,4,-1,-1,0,54%,50%,64%,74,73,76,26%,26%,26%,2,1,1,3,2,1
70,https://vlr.gg/player/7443/riza,2024-06-25 07:00:00,1.20,1.37,1.28,240,200,283,46,20,26,36,18,18,14,6,8,+6,+1,+5,76%,75%,77%,155,144,167,24%,21%,26%,10,3,7,4,2,2
71,https://vlr.gg/player/7381/redkoh,2024-06-25 07:00:00,1.02,1.53,1.27,222,208,226,45,22,23,33,19,14,22,8,14,-1,+1,-2,80%,79%,81%,139,127,151,31%,33%,30%,4,4,0,5,3,2
72,https://vlr.gg/player/27068/pudj,2024-06-25 07:00:00,1.03,1.43,1.23,206,191,199,39,20,19,31,18,13,8,3,5,+5,+1,+4,74%,71%,77%,136,128,144,29%,31%,27%,6,2,4,1,1,0
73,https://vlr.gg/player/16852/nakya,2024-06-25 07:00:00,1.19,0.94,1.07,277,301,236,53,31,22,41,21,20,13,6,7,0,+1,-1,76%,75%,77%,169,188,149,32%,34%,29%,9,6,3,9,5,4
74,https://vlr.gg/player/5886/flaring,2024-06-25 07:00:00,0.80,0.99,0.89,169,129,197,29,13,16,37,17,20,27,9,18,-6,-2,-4,76%,79%,73%,113,94,134,21%,20%,22%,0,0,0,6,2,4
75,https://vlr.gg/player/7448/toy,2024-06-25 07:00:00,0.80,1.12,0.97,207,175,215,35,15,20,40,20,20,22,13,9,-3,-2,-1,74%,73%,75%,131,112,149,24%,27%,21%,1,0,1,4,2,2
76,https://vlr.gg/player/26965/haeart,2024-06-25 07:00:00,0.79,1.15,0.97,241,217,298,46,18,28,46,24,22,8,6,2,+4,+1,+3,63%,54%,71%,170,149,189,30%,30%,30%,11,6,5,7,5,2
77,https://vlr.gg/player/3023/moosey,2024-06-25 07:00:00,1.00,0.74,0.85,198,247,159,37,23,14,45,22,23,8,3,5,-1,0,-1,65%,69%,61%,138,170,108,26%,22%,31%,3,2,1,4,2,2
78,https://vlr.gg/player/26969/adept,2024-06-25 07:00:00,0.50,1.07,0.80,151,93,216,30,9,21,41,20,21,15,9,6,-3,-1,-2,69%,73%,64%,113,63,159,26%,9%,36%,3,1,2,6,2,4
79,https://vlr.gg/player/36687/miz,2024-06-25 07:00:00,0.90,0.59,0.73,168,214,113,30,20,10,40,20,20,7,5,2,-1,0,-1,67%,73%,61%,109,136,84,23%,24%,23%,7,3,4,8,3,5
80,https://vlr.gg/player/4095/skrossi,2024-06-25 06:30:00,1.38,1.86,1.55,362,333,417,47,28,19,27,19,8,6,2,4,+10,+6,+4,84%,75%,100%,229,208,268,23%,24%,21%,13,8,5,3,2,1
81,https://vlr.gg/player/16215/dos9,2024-06-25 06:30:00,1.54,1.16,1.40,245,282,178,36,27,9,18,12,6,8,4,4,+5,+3,+2,84%,88%,77%,156,182,108,26%,28%,19%,5,3,2,0,0,0
82,https://vlr.gg/player/3630/skillz,2024-06-25 06:30:00,1.13,1.46,1.24,193,190,200,27,16,11,19,14,5,11,6,5,+3,+4,-1,78%,75%,85%,132,127,141,24%,20%,33%,4,4,0,1,0,1
83,https://vlr.gg/player/10463/paradox,2024-06-25 06:30:00,0.83,1.44,1.04,174,136,244,24,12,12,21,14,7,18,11,7,0,-1,+1,73%,75%,69%,99,83,127,33%,50%,21%,2,0,2,2,1,1
84,https://vlr.gg/player/6913/sultan,2024-06-25 06:30:00,0.57,1.26,0.81,125,112,151,16,9,7,19,15,4,9,2,7,-1,-2,+1,76%,67%,92%,83,78,92,29%,28%,31%,3,2,1,4,4,0
85,https://vlr.gg/player/31371/trinxty,2024-06-25 06:30:00,0.34,1.27,0.94,228,147,272,30,6,24,30,12,18,4,1,3,-1,-2,+1,70%,54%,79%,148,103,173,30%,21%,35%,7,3,4,8,5,3
86,https://vlr.gg/player/26376/deecee,2024-06-25 06:30:00,0.63,0.96,0.84,182,144,206,25,8,17,30,12,18,1,1,0,-5,-2,-3,51%,54%,50%,119,102,129,43%,27%,57%,0,0,0,5,2,3
87,https://vlr.gg/player/5541/tryst,2024-06-25 06:30:00,1.19,0.55,0.78,156,227,119,21,12,9,29,10,19,9,2,7,-2,-1,-1,57%,69%,50%,96,126,79,27%,30%,24%,0,0,0,2,1,1
88,https://vlr.gg/player/30693/makaveli,2024-06-25 06:30:00,0.49,0.77,0.67,139,93,164,15,3,12,30,12,18,8,3,5,-1,0,-1,62%,54%,67%,101,91,107,19%,3%,34%,2,0,2,3,0,3
89,https://vlr.gg/player/3502/ri0,2024-06-25 06:30:00,0.12,0.64,0.43,113,47,147,13,1,12,31,12,19,5,2,3,-8,-2,-6,41%,46%,38%,76,38,96,32%,17%,40%,1,0,1,9,2,7
90,https://vlr.gg/player/7873/leaf,2024-06-24 17:00:00,0.78,1.43,1.12,222,192,253,48,18,30,43,25,18,19,10,9,-3,-6,+3,70%,60%,79%,155,136,172,19%,20%,19%,4,1,3,7,7,0
91,https://vlr.gg/player/3885/valyn,2024-06-24 17:00:00,1.03,1.19,1.11,210,190,223,45,18,27,43,22,21,21,11,10,+5,+3,+2,78%,73%,82%,129,123,135,26%,27%,25%,10,4,6,5,1,4
92,https://vlr.gg/player/15500/trent,2024-06-24 17:00:00,0.82,1.34,1.10,181,167,196,42,18,24,38,22,16,15,6,9,0,-2,+2,71%,67%,76%,118,113,122,27%,29%,25%,6,2,4,6,4,2
93,https://vlr.gg/player/4581/jonahp,2024-06-24 17:00:00,0.79,1.09,0.95,176,135,215,39,15,24,43,21,22,24,6,18,+2,+1,+1,63%,57%,70%,108,78,134,20%,21%,20%,7,3,4,5,2,3
94,https://vlr.gg/player/8402/icy,2024-06-24 17:00:00,0.71,1.00,0.86,171,149,194,39,16,23,44,22,22,17,3,14,-3,-4,+1,65%,57%,73%,110,98,121,20%,22%,19%,5,1,4,8,5,3
95,https://vlr.gg/player/16003/runi,2024-06-24 17:00:00,1.04,1.32,1.17,198,189,202,42,23,19,34,22,12,25,8,17,+2,+1,+1,79%,76%,83%,129,115,145,33%,48%,25%,3,1,2,1,0,1
96,https://vlr.gg/player/18796/oxy,2024-06-24 17:00:00,0.71,1.37,1.02,239,185,302,54,21,33,48,28,20,12,6,6,+5,-1,+6,71%,64%,80%,152,121,185,26%,37%,20%,15,6,9,10,7,3
97,https://vlr.gg/player/7870/vanity,2024-06-24 17:00:00,0.80,1.02,0.91,196,181,214,45,22,23,48,27,21,23,9,14,0,-4,+4,70%,70%,70%,130,121,140,23%,34%,17%,7,2,5,7,6,1
98,https://vlr.gg/player/7458/moose,2024-06-24 17:00:00,0.86,0.94,0.90,152,165,138,35,18,17,38,24,14,10,9,1,-1,-2,+1,71%,64%,80%,115,127,102,21%,20%,23%,3,1,2,4,3,1
99,https://vlr.gg/player/7871/xeppaa,2024-06-24 17:00:00,0.62,1.11,0.85,174,144,203,35,15,20,45,27,18,25,10,15,-7,-3,-4,68%,61%,77%,118,105,132,23%,21%,25%,3,2,1,10,5,5
100,https://vlr.gg/player/15091/zepiczz,2024-06-24 16:00:00,2.00,0.46,1.30,278,396,139,21,18,3,16,7,9,7,3,4,+4,+2,+2,68%,92%,40%,185,261,93,32%,33%,27%,4,2,2,0,0,0
101,https://vlr.gg/player/12430/skypzz,2024-06-24 16:00:00,1.70,0.36,1.09,199,276,107,16,13,3,14,6,8,5,5,0,0,0,0,64%,83%,40%,139,198,69,14%,22%,4%,0,0,0,0,0,0
102,https://vlr.gg/player/8110/kayban,2024-06-24 16:00:00,1.18,0.15,0.71,150,213,77,12,10,2,16,8,8,11,9,2,+1,+2,-1,64%,92%,30%,98,137,51,18%,22%,9%,2,2,0,1,0,1
103,https://vlr.gg/player/12429/symon,2024-06-24 16:00:00,0.92,0.28,0.63,139,185,84,9,6,3,17,9,8,16,14,2,+3,+3,0,68%,83%,50%,91,126,50,17%,19%,10%,3,3,0,0,0,0
104,https://vlr.gg/player/42077/noheart,2024-06-24 16:00:00,0.45,0.85,0.63,175,118,245,13,5,8,18,9,9,5,4,1,-2,-5,+3,68%,58%,80%,130,109,155,21%,16%,28%,5,0,5,7,5,2
105,https://vlr.gg/player/42155/h4te,2024-06-24 16:00:00,2.76,1.03,1.82,282,416,172,25,17,8,12,2,10,8,3,5,-1,0,-1,86%,90%,83%,167,229,115,35%,28%,50%,0,0,0,1,0,1
106,https://vlr.gg/player/18217/kylou,2024-06-24 16:00:00,1.47,0.94,1.18,236,295,188,18,10,8,14,4,10,6,5,1,-1,0,-1,68%,80%,58%,152,183,127,43%,36%,53%,1,1,0,2,1,1
107,https://vlr.gg/player/23179/hiiro,2024-06-24 16:00:00,0.64,1.39,1.05,192,78,289,14,2,12,15,5,10,10,3,7,-3,-3,0,77%,80%,75%,117,52,171,21%,20%,21%,2,0,2,5,3,2
108,https://vlr.gg/player/22952/caim,2024-06-24 16:00:00,1.00,0.92,0.96,218,202,231,15,7,8,15,5,10,7,3,4,+1,0,+1,68%,70%,67%,151,137,162,19%,23%,16%,5,2,3,4,2,2
109,https://vlr.gg/player/6117/kayn,2024-06-24 16:00:00,1.23,0.21,0.68,116,146,92,9,6,3,15,3,12,11,5,6,-2,-1,-1,82%,90%,75%,76,88,66,23%,27%,20%,0,0,0,2,1,1
110,https://vlr.gg/player/8226/waddle,2024-06-24 15:15:00,0.93,2.03,1.50,269,170,360,24,8,16,14,9,5,6,1,5,0,-1,+1,87%,82%,92%,195,126,259,51%,70%,45%,2,1,1,2,2,0
111,https://vlr.gg/player/4544/filu,2024-06-24 15:15:00,1.00,1.89,1.46,334,283,382,27,10,17,19,11,8,7,3,4,+4,0,+4,70%,64%,75%,205,172,236,30%,52%,16%,7,1,6,3,1,2
112,https://vlr.gg/player/12474/tag,2024-06-24 15:15:00,0.95,0.77,0.85,223,245,203,15,8,7,18,9,9,10,3,7,-3,-3,0,74%,64%,83%,159,166,152,27%,28%,26%,1,0,1,4,3,1
113,https://vlr.gg/player/7162/wackie,2024-06-24 15:15:00,0.70,0.74,0.72,133,127,139,12,6,6,16,9,7,2,1,1,-1,-2,+1,57%,45%,67%,96,88,104,21%,17%,25%,1,0,1,2,2,0
114,https://vlr.gg/player/1944/cayden,2024-06-24 15:15:00,0.61,0.44,0.52,99,110,89,8,4,4,16,8,8,4,2,2,-1,-1,0,65%,45%,83%,63,73,53,14%,13%,17%,0,0,0,1,1,0
115,https://vlr.gg/player/1524/h1ber,2024-06-24 15:15:00,1.80,1.44,1.63,307,337,276,24,14,10,16,10,6,8,4,4,+3,+1,+2,83%,75%,91%,201,208,193,32%,32%,32%,3,1,2,0,0,0
116,https://vlr.gg/player/18400/bipo,2024-06-24 15:15:00,0.49,2.07,1.24,247,148,356,22,6,16,17,11,6,5,3,2,+1,-3,+4,78%,58%,100%,177,111,248,30%,29%,30%,6,2,4,5,5,0
117,https://vlr.gg/player/1493/starkk,2024-06-24 15:15:00,0.53,1.21,0.86,178,111,252,15,4,11,17,10,7,5,4,1,-1,-1,0,87%,92%,82%,118,83,155,34%,38%,32%,1,0,1,2,1,1
118,https://vlr.gg/player/23347/alannn,2024-06-24 15:15:00,0.97,0.63,0.81,194,189,202,14,7,7,19,9,10,6,4,2,+1,-1,+2,61%,67%,55%,138,133,143,35%,40%,31%,2,0,2,1,1,0
119,https://vlr.gg/player/4277/n-a-i-s,2024-06-24 15:15:00,0.62,0.40,0.52,95,124,63,8,6,2,17,10,7,6,3,3,-3,-2,-1,65%,58%,73%,69,83,55,18%,40%,0%,0,0,0,3,2,1
120,https://vlr.gg/player/16012/akira,2024-06-24 15:00:00,2.78,2.29,2.41,398,439,385,23,7,16,6,2,4,11,2,9,+3,0,+3,88%,100%,83%,259,299,245,22%,45%,18%,3,0,3,0,0,0
121,https://vlr.gg/player/1377/phatt,2024-06-24 15:00:00,0.72,1.47,1.28,175,99,201,11,1,10,7,3,4,13,4,9,0,-1,+1,81%,75%,83%,121,76,136,33%,67%,30%,1,0,1,1,1,0
122,https://vlr.gg/player/8590/killdream,2024-06-24 15:00:00,0.94,1.33,1.23,271,263,274,17,4,13,11,4,7,5,1,4,0,0,0,81%,75%,83%,174,156,180,29%,38%,27%,2,1,1,2,1,1
123,https://vlr.gg/player/26808/fainz,2024-06-24 15:00:00,0.16,1.21,0.95,210,85,253,12,1,11,12,4,8,3,1,2,+1,+1,0,81%,75%,83%,139,49,169,18%,25%,17%,3,1,2,2,0,2
124,https://vlr.gg/player/7883/silenttt,2024-06-24 15:00:00,0.39,1.02,0.86,152,119,163,9,2,7,9,4,5,3,0,3,+2,0,+2,88%,75%,92%,97,67,108,26%,17%,29%,2,0,2,0,0,0
125,https://vlr.gg/player/22495/mochi,2024-06-24 15:00:00,1.13,0.34,0.93,208,253,73,11,10,1,14,11,3,4,3,1,0,0,0,50%,50%,50%,133,154,71,32%,29%,50%,0,0,0,0,0,0
126,https://vlr.gg/player/9557/nefi,2024-06-24 15:00:00,1.05,0.03,0.78,201,245,69,11,10,1,15,11,4,0,0,0,+1,+1,0,69%,67%,75%,124,149,52,65%,67%,50%,2,2,0,1,1,0
127,https://vlr.gg/player/1353/dext,2024-06-24 15:00:00,0.36,1.79,0.71,172,124,317,10,5,5,14,12,2,2,1,1,0,-1,+1,56%,42%,100%,130,96,231,24%,31%,19%,2,1,1,2,2,0
128,https://vlr.gg/player/15487/aqua,2024-06-24 15:00:00,0.18,1.57,0.52,138,68,351,8,2,6,15,12,3,3,2,1,-1,-1,0,44%,33%,75%,80,44,189,30%,20%,40%,1,0,1,2,1,1
129,https://vlr.gg/player/6101/999kvmil,2024-06-24 15:00:00,0.04,1.19,0.31,89,38,243,5,1,4,14,11,3,2,1,1,-6,-5,-1,50%,42%,75%,55,30,129,16%,13%,18%,0,0,0,6,5,1
130,https://vlr.gg/player/11013/balli,2024-06-24 14:00:00,0.27,2.11,1.23,261,81,428,19,2,17,19,9,10,10,3,7,+2,-2,+4,87%,82%,92%,165,62,259,21%,0%,29%,5,0,5,3,2,1
131,https://vlr.gg/player/33513/sihw,2024-06-24 14:00:00,1.69,0.55,1.10,223,327,129,18,12,6,16,6,10,3,2,1,0,-1,+1,74%,91%,58%,152,221,89,20%,30%,11%,2,0,2,2,1,1
132,https://vlr.gg/player/11122/byron,2024-06-24 14:00:00,1.33,0.77,1.04,140,199,87,11,9,2,14,7,7,16,4,12,0,+1,-1,74%,82%,67%,87,113,64,18%,41%,4%,2,2,0,2,1,1
133,https://vlr.gg/player/33627/dok,2024-06-24 14:00:00,0.62,0.70,0.66,132,140,125,10,5,5,17,8,9,6,3,3,-3,-3,0,61%,73%,50%,97,105,90,34%,38%,31%,0,0,0,3,3,0
134,https://vlr.gg/player/33523/vuexlex,2024-06-24 14:00:00,0.41,0.60,0.51,128,144,114,12,6,6,20,10,10,4,3,1,-2,0,-2,61%,82%,42%,96,84,106,41%,42%,40%,1,1,0,3,1,2
135,https://vlr.gg/player/33358/shinnok,2024-06-24 14:00:00,1.36,1.38,1.37,218,222,214,21,11,10,10,5,5,4,0,4,+1,0,+1,87%,83%,91%,148,156,139,23%,21%,25%,1,0,1,0,0,0
136,https://vlr.gg/player/5854/z3ro,2024-06-24 14:00:00,1.31,1.37,1.34,236,224,250,20,10,10,12,6,6,12,8,4,+1,-1,+2,83%,83%,82%,134,129,139,25%,38%,17%,3,1,2,2,2,0
137,https://vlr.gg/player/33501/sword,2024-06-24 14:00:00,1.18,1.15,1.17,175,184,167,14,9,5,11,6,5,11,5,6,0,0,0,78%,75%,82%,124,119,129,24%,26%,20%,0,0,0,0,0,0
138,https://vlr.gg/player/16447/d3mur,2024-06-24 14:00:00,0.60,1.16,0.87,204,188,223,16,7,9,18,10,8,4,2,2,+1,-1,+2,70%,50%,91%,137,125,151,42%,50%,36%,7,4,3,6,5,1
139,https://vlr.gg/player/7706/morphiw0w,2024-06-24 14:00:00,1.08,0.56,0.83,194,222,166,15,9,6,19,9,10,8,5,3,0,0,0,70%,67%,73%,115,133,97,32%,37%,28%,2,0,2,2,0,2
140,https://vlr.gg/player/7258/nask,2024-06-24 14:00:00,0.32,1.82,1.14,265,126,383,20,4,16,18,9,9,5,0,5,-6,-5,-1,64%,30%,92%,167,94,228,26%,24%,26%,1,0,1,7,5,2
141,https://vlr.gg/player/12571/furyan,2024-06-24 14:00:00,0.77,1.16,0.98,173,142,201,13,4,9,16,8,8,9,4,5,+4,+1,+3,73%,60%,83%,115,94,133,16%,20%,14%,4,1,3,0,0,0
142,https://vlr.gg/player/2980/raxtazzz,2024-06-24 14:00:00,0.45,1.14,0.83,164,133,191,13,4,9,16,9,7,5,2,3,-1,-1,0,68%,50%,83%,99,80,114,22%,20%,23%,0,0,0,1,1,0
143,https://vlr.gg/player/2880/rlzy,2024-06-24 14:00:00,0.32,1.11,0.75,157,88,216,12,3,9,18,9,9,2,0,2,-2,-2,0,50%,30%,67%,96,49,136,34%,38%,33%,3,0,3,5,2,3
144,https://vlr.gg/player/6910/kenzmps,2024-06-24 14:00:00,0.59,0.71,0.65,120,122,119,8,4,4,17,9,8,7,1,6,-1,-1,0,64%,40%,83%,89,103,77,28%,43%,13%,0,0,0,1,1,0
145,https://vlr.gg/player/15577/brk,2024-06-24 14:00:00,0.90,2.03,1.42,298,272,331,23,11,12,12,10,2,6,2,4,+1,-2,+3,82%,67%,100%,209,183,241,20%,28%,16%,4,1,3,3,3,0
146,https://vlr.gg/player/13435/fragger,2024-06-24 14:00:00,1.24,1.25,1.24,263,299,221,20,12,8,15,10,5,10,3,7,+2,+2,0,82%,75%,90%,184,225,135,32%,28%,41%,4,3,1,2,1,1
147,https://vlr.gg/player/29340/cunha20,2024-06-24 14:00:00,0.91,1.55,1.20,183,159,214,17,7,10,12,8,4,6,6,0,+1,0,+1,68%,67%,70%,117,97,141,35%,26%,47%,1,0,1,0,0,0
148,https://vlr.gg/player/15376/grtw,2024-06-24 14:00:00,0.81,1.56,1.15,219,178,269,16,7,9,13,9,4,5,2,3,+4,0,+4,82%,75%,90%,155,130,184,25%,39%,20%,5,1,4,1,1,0
149,https://vlr.gg/player/1378/addicted,2024-06-24 14:00:00,0.43,1.07,0.72,121,124,119,9,4,5,14,10,4,6,3,3,-2,-2,0,73%,58%,90%,79,84,74,10%,12%,9%,0,0,0,2,2,0
150,https://vlr.gg/player/1897/bgg,2024-06-24 14:00:00,1.25,1.16,1.21,202,219,186,49,29,20,36,19,17,13,11,2,-1,+1,-2,77%,83%,68%,127,135,116,32%,30%,34%,7,5,2,8,4,4
151,https://vlr.gg/player/3807/winteryrook,2024-06-24 14:00:00,1.21,0.89,1.08,223,246,188,45,30,15,45,25,20,22,13,9,+7,+4,+3,73%,83%,60%,148,169,119,37%,40%,33%,10,5,5,3,1,2
152,https://vlr.gg/player/5795/sickrey,2024-06-24 14:00:00,0.98,1.12,1.04,159,151,175,37,20,17,38,24,14,28,22,6,-1,+1,-2,85%,91%,76%,96,87,108,32%,33%,30%,2,2,0,3,1,2
153,https://vlr.gg/player/1470/simond4rk,2024-06-24 14:00:00,1.13,0.65,0.93,256,282,199,48,33,15,50,27,23,14,9,5,+9,+8,+1,67%,74%,56%,161,185,128,20%,23%,16%,16,11,5,7,3,4
154,https://vlr.gg/player/2432/moner,2024-06-24 14:00:00,0.82,0.88,0.85,158,126,196,31,15,16,38,19,19,12,8,4,-2,-3,+1,62%,63%,60%,116,102,135,30%,30%,30%,1,0,1,3,3,0
155,https://vlr.gg/player/6126/sibeastw0w,2024-06-24 14:00:00,1.41,1.32,1.36,288,302,275,59,27,32,43,17,26,12,3,9,+1,+2,-1,73%,72%,74%,173,176,170,24%,21%,27%,9,6,3,8,4,4
156,https://vlr.gg/player/363/7ssk7,2024-06-24 14:00:00,0.90,0.94,0.92,167,179,174,38,16,22,39,16,23,16,5,11,-1,+1,-2,68%,56%,77%,108,112,106,29%,24%,33%,6,3,3,7,2,5
157,https://vlr.gg/player/172/vakk,2024-06-24 14:00:00,1.11,0.77,0.91,188,253,142,44,25,19,42,19,23,7,2,5,0,0,0,68%,88%,54%,125,165,97,31%,44%,22%,5,2,3,5,2,3
158,https://vlr.gg/player/3806/xenon,2024-06-24 14:00:00,0.80,0.87,0.84,164,146,186,36,13,23,44,16,28,20,6,14,-3,0,-3,68%,80%,60%,106,95,114,31%,32%,30%,4,1,3,7,1,6
159,https://vlr.gg/player/5654/avez,2024-06-24 14:00:00,0.89,0.74,0.80,153,161,148,30,12,18,42,15,27,20,11,9,-9,-4,-5,75%,88%,66%,115,123,109,28%,30%,26%,0,0,0,9,4,5
160,https://vlr.gg/player/1347/ivan4ezz,2024-06-24 13:00:00,2.40,1.37,1.58,261,429,220,14,5,9,7,1,6,5,1,4,+4,+2,+2,93%,100%,92%,160,207,148,32%,56%,25%,5,2,3,1,0,1
161,https://vlr.gg/player/29998/drastz,2024-06-24 13:00:00,1.73,1.25,1.35,182,195,180,11,3,8,6,1,5,5,1,4,-1,0,-1,80%,67%,83%,134,130,135,37%,43%,35%,0,0,0,1,0,1
162,https://vlr.gg/player/2252/anq,2024-06-24 13:00:00,2.02,1.07,1.26,237,398,198,14,5,9,8,2,6,2,0,2,-1,+1,-2,73%,67%,75%,178,295,149,36%,33%,38%,1,1,0,2,0,2
163,https://vlr.gg/player/2431/basya,2024-06-24 13:00:00,0.53,1.06,0.96,183,91,207,10,1,9,9,2,7,5,1,4,0,0,0,87%,100%,83%,125,67,140,18%,0%,23%,1,0,1,1,0,1
164,https://vlr.gg/player/3860/al1en,2024-06-24 13:00:00,0.45,1.06,0.94,225,111,254,13,1,12,13,3,10,3,1,2,+1,0,+1,87%,100%,83%,129,70,144,32%,33%,32%,2,0,2,1,0,1
165,https://vlr.gg/player/22566/pax,2024-06-24 13:00:00,1.44,0.47,1.25,263,283,188,14,12,2,12,9,3,3,3,0,0,+1,-1,60%,67%,33%,181,187,155,32%,32%,33%,4,4,0,4,3,1
166,https://vlr.gg/player/6338/syyse,2024-06-24 13:00:00,1.09,0.02,0.86,119,147,9,7,7,0,9,6,3,4,4,0,+1,+1,0,67%,83%,,66,80,9,17%,18%,0%,1,1,0,0,0,0
167,https://vlr.gg/player/19526/rexxtoned,2024-06-24 13:00:00,0.87,0.55,0.80,211,230,137,10,9,1,14,11,3,2,2,0,0,0,0,60%,58%,67%,138,145,112,42%,47%,20%,1,1,0,1,1,0
168,https://vlr.gg/player/9943/mezoky,2024-06-24 13:00:00,0.32,1.70,0.60,166,64,579,8,2,6,13,10,3,3,3,0,-2,-1,-1,53%,50%,67%,99,49,298,53%,33%,67%,0,0,0,2,1,1
169,https://vlr.gg/player/45138/aster,2024-06-24 13:00:00,0.48,0.02,0.36,113,130,48,4,4,0,14,11,3,5,4,1,-2,-1,-1,53%,58%,33%,87,96,48,16%,14%,25%,0,0,0,2,1,1
170,https://vlr.gg/player/3604/mojj,2024-06-24 13:00:00,1.31,1.20,1.25,241,256,227,52,26,26,39,18,21,13,5,8,+9,+4,+5,73%,75%,71%,150,161,139,36%,30%,43%,13,7,6,4,3,1
171,https://vlr.gg/player/15735/krostaly,2024-06-24 13:00:00,1.09,1.35,1.23,243,237,252,51,23,28,38,18,20,14,9,5,0,0,0,66%,68%,65%,165,169,161,41%,41%,41%,6,3,3,6,3,3
172,https://vlr.gg/player/1401/sasuke,2024-06-24 13:00:00,1.28,0.73,0.99,192,216,170,38,24,14,41,15,26,27,12,15,+1,0,+1,73%,86%,61%,117,122,112,27%,35%,19%,6,3,3,5,3,2
173,https://vlr.gg/player/4894/jn3v1ce,2024-06-24 13:00:00,0.82,0.86,0.84,152,126,175,30,13,17,40,16,24,22,11,11,-1,+1,-2,71%,79%,65%,103,75,129,26%,24%,28%,5,2,3,6,1,5
174,https://vlr.gg/player/18657/wasp,2024-06-24 13:00:00,1.15,0.49,0.80,157,209,111,31,21,10,42,16,26,16,9,7,+2,+1,+1,73%,86%,61%,112,146,81,37%,38%,36%,5,2,3,3,1,2
175,https://vlr.gg/player/19776/jrayn,2024-06-24 13:00:00,1.15,1.52,1.32,220,153,291,45,17,28,32,14,18,26,12,14,+1,0,+1,83%,87%,79%,133,93,176,35%,33%,37%,1,0,1,0,0,0
176,https://vlr.gg/player/5564/deadink,2024-06-24 13:00:00,0.92,0.89,0.91,224,211,240,46,24,22,46,22,24,8,4,4,-3,-4,+1,63%,58%,68%,137,130,145,23%,35%,13%,14,6,8,17,10,7
177,https://vlr.gg/player/12226/sturnn,2024-06-24 13:00:00,1.15,0.59,0.88,190,242,133,35,24,11,43,20,23,19,11,8,-3,0,-3,68%,74%,61%,122,152,89,17%,21%,10%,3,2,1,6,2,4
178,https://vlr.gg/player/5563/cacan,2024-06-24 13:00:00,0.92,0.67,0.80,176,207,144,39,24,15,41,20,21,12,6,6,-5,-2,-3,66%,61%,71%,119,135,101,31%,30%,32%,3,3,0,8,5,3
179,https://vlr.gg/player/31307/yigox,2024-06-24 13:00:00,1.20,0.34,0.77,153,238,63,35,28,7,40,19,21,9,5,4,-1,+1,-2,63%,71%,54%,101,152,45,44%,48%,33%,3,2,1,4,1,3
180,https://vlr.gg/player/321/chiwa,2024-06-24 12:50:00,1.22,1.49,1.37,239,207,290,42,15,27,29,12,17,10,4,6,+2,-1,+3,77%,71%,81%,172,143,195,29%,34%,27%,5,1,4,3,2,1
181,https://vlr.gg/player/1374/alive,2024-06-24 12:50:00,1.07,1.29,1.19,231,211,241,38,17,21,30,14,16,6,2,4,+4,-2,+6,66%,62%,69%,150,131,165,33%,38%,29%,10,4,6,6,6,0
182,https://vlr.gg/player/8808/pyrolll,2024-06-24 12:50:00,1.02,1.02,1.02,164,175,162,30,13,17,27,12,15,14,7,7,0,-1,+1,77%,67%,85%,121,123,119,33%,27%,38%,4,2,2,4,3,1
183,https://vlr.gg/player/32351/cullumx,2024-06-24 12:50:00,1.23,0.84,1.01,226,237,198,35,18,17,32,14,18,13,7,6,+1,+3,-2,72%,71%,73%,143,149,139,37%,36%,39%,5,3,2,4,0,4
184,https://vlr.gg/player/4325/musashi,2024-06-24 12:50:00,1.11,0.70,0.88,182,197,148,27,14,13,31,14,17,9,7,2,-2,0,-2,64%,81%,50%,115,137,98,33%,38%,29%,2,0,2,4,0,4
185,https://vlr.gg/player/3839/prti,2024-06-24 12:50:00,1.29,0.72,1.04,213,240,175,35,23,12,36,18,18,12,6,6,+5,+2,+3,66%,69%,62%,129,146,108,25%,24%,27%,6,2,4,1,0,1
186,https://vlr.gg/player/34684/westside,2024-06-24 12:50:00,0.85,1.10,0.97,184,156,228,30,14,16,32,17,15,9,4,5,0,-1,+1,74%,65%,86%,131,114,151,36%,32%,40%,3,1,2,3,2,1
187,https://vlr.gg/player/5490/xitsha,2024-06-24 12:50:00,1.01,0.79,0.92,181,199,167,32,19,13,32,17,15,13,8,5,-5,-3,-2,66%,69%,62%,114,118,109,28%,45%,13%,3,1,2,8,4,4
188,https://vlr.gg/player/8593/grmekista,2024-06-24 12:50:00,0.55,0.86,0.69,136,124,158,26,13,13,35,21,14,5,1,4,-3,-2,-1,57%,54%,62%,91,83,100,24%,29%,21%,0,0,0,3,2,1
189,https://vlr.gg/player/24424/pa1ze,2024-06-24 12:50:00,0.63,0.78,0.69,175,170,175,26,14,12,37,22,15,9,6,3,-2,-2,0,62%,62%,62%,112,113,112,20%,19%,20%,9,6,3,11,8,3
190,https://vlr.gg/player/2897/limp,2024-06-24 12:00:00,1.52,2.05,1.73,354,284,461,26,12,14,13,8,5,10,7,3,+3,+2,+1,90%,83%,100%,226,192,277,37%,32%,41%,4,2,2,1,0,1
191,https://vlr.gg/player/10375/braso,2024-06-24 12:00:00,0.99,1.40,1.16,230,204,270,17,10,7,12,8,4,3,1,2,+2,0,+2,75%,67%,88%,149,135,169,33%,35%,32%,4,1,3,2,1,1
192,https://vlr.gg/player/4274/xazyy,2024-06-24 12:00:00,0.88,1.37,1.08,183,183,185,12,7,5,12,9,3,14,7,7,0,-1,+1,85%,83%,88%,122,124,120,18%,14%,24%,1,0,1,1,1,0
193,https://vlr.gg/player/31114/frandina,2024-06-24 12:00:00,1.28,0.75,1.07,211,311,64,15,13,2,12,9,3,3,1,2,+2,+2,0,70%,67%,75%,137,197,48,39%,39%,40%,4,4,0,2,2,0
194,https://vlr.gg/player/30508/rickyvaila,2024-06-24 12:00:00,0.39,1.13,0.69,121,89,171,9,4,5,12,9,3,6,4,2,-1,-1,0,75%,67%,88%,83,64,112,33%,25%,42%,0,0,0,1,1,0
195,https://vlr.gg/player/22188/jimbk,2024-06-24 12:00:00,1.28,1.31,1.30,270,276,266,18,8,10,15,6,9,4,0,4,+1,0,+1,70%,75%,67%,183,150,205,25%,37%,17%,1,0,1,0,0,0
196,https://vlr.gg/player/45142/browse,2024-06-24 12:00:00,0.61,1.44,1.11,218,134,275,15,3,12,15,6,9,3,2,1,+2,0,+2,80%,63%,92%,159,114,190,30%,21%,35%,2,0,2,0,0,0
197,https://vlr.gg/player/9574/ayyzicle,2024-06-24 12:00:00,0.81,0.96,0.90,172,155,185,12,4,8,14,7,7,6,3,3,-1,0,-1,60%,63%,58%,118,103,128,37%,63%,27%,2,1,1,3,1,2
198,https://vlr.gg/player/45143/francybald,2024-06-24 12:00:00,0.27,0.71,0.53,116,45,164,8,1,7,19,8,11,9,3,6,-3,-2,-1,55%,50%,58%,64,24,90,24%,0%,33%,1,0,1,4,2,2
199,https://vlr.gg/player/22191/bouncy,2024-06-24 12:00:00,0.33,0.61,0.50,121,84,147,8,2,6,16,6,10,1,0,1,-5,-2,-3,60%,50%,67%,79,54,95,2%,0%,3%,1,1,0,6,3,3
200,https://vlr.gg/player/16885/snipkw,2024-06-24 12:00:00,1.70,1.57,1.63,296,343,264,35,18,17,18,9,9,17,6,11,+1,-1,+2,91%,93%,89%,198,227,174,30%,31%,29%,4,0,4,3,1,2
201,https://vlr.gg/player/5614/xelouz,2024-06-24 12:00:00,1.58,1.30,1.42,219,221,215,28,14,14,14,6,8,22,8,14,+4,+3,+1,88%,100%,78%,135,147,125,33%,44%,24%,5,3,2,1,0,1
202,https://vlr.gg/player/5609/vague,2024-06-24 12:00:00,1.21,1.22,1.21,229,203,255,28,11,17,20,8,12,5,2,3,+4,+2,+2,79%,93%,67%,162,144,178,25%,27%,23%,6,4,2,2,2,0
203,https://vlr.gg/player/19311/kuro,2024-06-24 12:00:00,0.91,1.46,1.21,229,165,271,28,10,18,18,9,9,6,1,5,+5,+1,+4,79%,73%,83%,151,119,177,18%,14%,19%,7,2,5,2,1,1
204,https://vlr.gg/player/5612/near,2024-06-24 12:00:00,0.98,1.35,1.18,192,179,199,25,10,15,16,9,7,12,8,4,-3,-2,-1,85%,87%,83%,126,112,138,23%,17%,28%,0,0,0,3,2,1
205,https://vlr.gg/player/46252/titanjr,2024-06-24 12:00:00,1.12,0.63,0.89,227,261,183,23,15,8,29,16,13,10,7,3,-3,-1,-2,58%,61%,53%,143,167,115,26%,30%,21%,2,0,2,5,1,4
206,https://vlr.gg/player/29025/adelano,2024-06-24 12:00:00,0.85,0.77,0.79,167,169,171,19,10,9,30,16,14,7,5,2,-2,-2,0,61%,61%,60%,118,113,124,31%,21%,45%,1,0,1,3,2,1
207,https://vlr.gg/player/15188/a1mly,2024-06-24 12:00:00,0.56,0.86,0.70,141,149,146,18,9,9,26,16,10,1,0,1,-3,-2,-1,45%,33%,60%,94,88,102,35%,27%,43%,2,2,0,5,4,1
208,https://vlr.gg/player/11914/rezy,2024-06-24 12:00:00,0.47,0.73,0.59,131,92,176,12,5,7,30,16,14,14,7,7,-2,0,-2,55%,50%,60%,84,50,123,33%,21%,41%,1,1,0,3,1,2
209,https://vlr.gg/player/36071/mabuchi,2024-06-24 12:00:00,0.23,0.74,0.46,126,108,152,14,6,8,29,17,12,3,2,1,-1,-3,+2,55%,50%,60%,88,70,110,14%,7%,22%,5,2,3,6,5,1
210,https://vlr.gg/player/33902/sayonara,2024-06-24 12:00:00,1.49,1.57,1.54,259,239,266,49,14,35,23,7,16,28,7,21,+4,0,+4,88%,71%,94%,176,190,171,30%,37%,27%,6,1,5,2,1,1
211,https://vlr.gg/player/443/zeddy,2024-06-24 12:00:00,1.60,1.32,1.40,240,295,221,45,17,28,24,7,17,19,2,17,+2,-1,+3,84%,86%,83%,161,200,145,31%,38%,28%,4,0,4,2,1,1
212,https://vlr.gg/player/2894/kiles,2024-06-24 12:00:00,1.09,1.46,1.36,234,209,239,42,10,32,27,9,18,23,4,19,+5,+1,+4,76%,64%,81%,156,138,163,34%,33%,35%,7,2,5,2,1,1
213,https://vlr.gg/player/251/b1sk,2024-06-24 12:00:00,1.10,1.29,1.23,253,229,260,45,11,34,29,9,20,10,1,9,+8,+4,+4,86%,79%,89%,171,157,176,20%,26%,18%,13,5,8,5,1,4
214,https://vlr.gg/player/402/insider,2024-06-24 12:00:00,1.08,1.26,1.21,216,191,223,37,10,27,24,6,18,13,1,12,+3,+2,+1,84%,79%,86%,150,114,164,24%,30%,23%,6,2,4,3,0,3
215,https://vlr.gg/player/33731/stonezy,2024-06-24 12:00:00,0.94,0.29,0.75,175,216,98,30,27,3,43,30,13,9,4,5,-5,-5,0,50%,53%,43%,117,132,79,24%,25%,15%,7,6,1,12,11,1
216,https://vlr.gg/player/4201/m4xikk,2024-06-24 12:00:00,0.61,0.94,0.70,160,138,220,25,15,10,43,30,13,9,7,2,-2,-2,0,56%,53%,64%,112,97,151,37%,34%,42%,2,1,1,4,3,1
217,https://vlr.gg/player/532/vtagut,2024-06-24 12:00:00,0.70,0.59,0.64,131,153,114,22,17,5,44,32,12,14,11,3,-5,-2,-3,56%,58%,50%,96,107,68,32%,33%,27%,2,1,1,7,3,4
218,https://vlr.gg/player/2996/neiker,2024-06-24 12:00:00,0.52,0.86,0.61,143,128,209,28,16,12,43,31,12,1,1,0,-2,-2,0,52%,44%,71%,96,85,127,43%,42%,44%,2,1,1,4,3,1
219,https://vlr.gg/player/7491/mikael,2024-06-24 12:00:00,0.49,0.91,0.60,141,128,192,22,14,8,45,33,12,18,12,6,-8,-5,-3,56%,56%,57%,96,86,121,32%,37%,25%,1,1,0,9,6,3
220,https://vlr.gg/player/5487/adm1k,2024-06-24 11:00:00,0.78,1.11,1.00,208,192,219,26,7,19,28,10,18,5,2,3,0,0,0,69%,58%,75%,140,133,143,21%,27%,19%,2,1,1,2,1,1
221,https://vlr.gg/player/4525/stix,2024-06-24 11:00:00,0.68,1.00,0.89,170,145,183,20,6,14,27,10,17,10,2,8,0,-1,+1,64%,42%,75%,128,113,136,28%,25%,29%,1,0,1,1,1,0
222,https://vlr.gg/player/9143/darkosek,2024-06-24 11:00:00,0.59,0.85,0.76,207,175,219,26,8,18,33,11,22,12,2,10,-5,-3,-2,69%,58%,75%,120,96,132,32%,26%,35%,3,0,3,8,3,5
223,https://vlr.gg/player/9556/demek,2024-06-24 11:00:00,0.18,0.77,0.57,150,67,192,17,2,15,31,11,20,6,2,4,-3,-2,-1,64%,67%,63%,104,52,130,35%,25%,37%,4,1,3,7,3,4
224,https://vlr.gg/player/37840/msh,2024-06-24 11:00:00,0.90,0.40,0.57,151,228,112,19,9,10,31,10,21,4,1,3,-4,0,-4,64%,75%,58%,99,139,78,38%,38%,38%,2,1,1,6,1,5
225,https://vlr.gg/player/33732/nunmeister,2024-06-24 11:00:00,1.56,2.08,1.73,279,277,282,39,24,15,19,15,4,16,13,3,+1,+1,0,81%,79%,83%,168,168,168,39%,42%,32%,5,4,1,4,3,1
226,https://vlr.gg/player/39682/wanzeru,2024-06-24 11:00:00,1.43,1.60,1.48,303,299,307,38,25,13,21,16,5,9,7,2,+5,+3,+2,67%,58%,83%,196,194,199,25%,26%,24%,8,6,2,3,3,0
227,https://vlr.gg/player/10448/kozok,2024-06-24 11:00:00,1.15,1.30,1.20,194,198,196,28,19,9,19,13,6,9,7,2,0,0,0,83%,83%,83%,146,147,143,30%,32%,28%,1,0,1,1,0,1
228,https://vlr.gg/player/15064/kajuks,2024-06-24 11:00:00,0.96,0.82,0.92,172,169,175,21,14,7,24,16,8,17,14,3,+5,+3,+2,86%,83%,92%,114,112,117,12%,13%,9%,6,4,2,1,1,0
229,https://vlr.gg/player/259/arch,2024-06-24 11:00:00,0.85,0.95,0.88,175,167,195,24,16,8,25,16,9,12,4,8,+1,-1,+2,67%,63%,75%,116,110,130,21%,16%,29%,4,1,3,3,2,1
230,https://vlr.gg/player/12795/crewen,2024-06-24 10:30:00,1.51,0.95,1.23,234,243,224,39,21,18,30,12,18,9,6,3,0,0,0,69%,83%,55%,154,170,137,26%,25%,28%,4,1,3,4,1,3
231,https://vlr.gg/player/12793/xeus,2024-06-24 10:30:00,1.23,0.94,1.09,250,297,202,36,23,13,33,16,17,11,4,7,+2,+4,-2,67%,74%,59%,180,209,150,23%,25%,20%,7,5,2,5,1,4
232,https://vlr.gg/player/12774/anima,2024-06-24 10:30:00,1.43,0.65,1.05,189,202,175,30,18,12,29,11,18,24,16,8,+3,+4,-1,76%,87%,64%,122,129,115,24%,24%,25%,6,4,2,3,0,3
233,https://vlr.gg/player/22676/ventt,2024-06-24 10:30:00,1.10,0.87,0.99,199,239,156,32,19,13,32,17,15,18,12,6,+1,0,+1,73%,74%,73%,124,148,100,35%,33%,39%,4,3,1,3,3,0
234,https://vlr.gg/player/16483/gloomy,2024-06-24 10:30:00,0.99,0.76,0.88,158,168,151,24,14,10,31,14,17,17,10,7,-1,+1,-2,69%,74%,64%,110,119,100,24%,21%,27%,4,3,1,5,2,3
235,https://vlr.gg/player/40591/comeback,2024-06-24 10:30:00,1.40,0.76,1.08,247,326,168,38,25,13,34,15,19,6,3,3,+2,+4,-2,64%,73%,57%,161,216,108,30%,37%,20%,8,6,2,6,2,4
236,https://vlr.gg/player/24344/loita,2024-06-24 10:30:00,1.10,0.96,1.03,187,175,199,29,14,15,32,14,18,17,8,9,-3,0,-3,73%,86%,61%,127,123,131,38%,41%,35%,4,4,0,7,4,3
237,https://vlr.gg/player/5565/ros,2024-06-24 10:30:00,1.15,0.77,0.96,205,213,197,33,17,16,34,14,20,12,10,2,-1,0,-1,73%,82%,65%,155,166,145,33%,42%,26%,3,1,2,4,1,3
238,https://vlr.gg/player/31855/celasun,2024-06-24 10:30:00,1.09,0.83,0.96,187,187,191,29,15,14,31,13,18,9,3,6,+1,0,+1,64%,68%,61%,125,127,123,32%,40%,25%,2,1,1,1,1,0
239,https://vlr.gg/player/31305/lar0k,2024-06-24 10:30:00,1.12,0.63,0.87,166,168,164,26,14,12,30,10,20,5,3,2,-4,0,-4,71%,82%,61%,109,114,103,28%,24%,34%,3,1,2,7,1,6
240,https://vlr.gg/player/8504/invy,2024-06-24 06:20:00,0.95,1.55,1.23,217,179,273,55,24,31,46,27,19,34,20,14,+1,-2,+3,69%,69%,69%,142,117,169,29%,36%,25%,5,1,4,4,3,1
241,https://vlr.gg/player/9735/2ge,2024-06-24 06:20:00,1.30,1.11,1.21,204,191,214,51,27,24,43,21,22,26,12,14,+2,+2,0,74%,81%,66%,133,125,143,30%,25%,35%,7,4,3,5,2,3
242,https://vlr.gg/player/9740/wild0reoo,2024-06-24 06:20:00,0.95,0.97,0.96,176,169,190,42,20,22,48,26,22,18,10,8,+2,0,+2,76%,69%,84%,125,126,123,30%,28%,32%,4,1,3,2,1,1
243,https://vlr.gg/player/7405/jremy,2024-06-24 06:20:00,0.93,0.85,0.89,213,224,194,47,26,21,53,28,25,13,8,5,-3,-3,0,66%,64%,69%,140,149,129,22%,24%,20%,14,7,7,17,10,7
244,https://vlr.gg/player/2334/jessievash,2024-06-24 06:20:00,0.95,0.68,0.82,154,187,106,38,26,12,44,24,20,12,4,8,-2,-1,-1,63%,58%,69%,92,111,69,20%,20%,21%,4,3,1,6,4,2
245,https://vlr.gg/player/1129/rossy,2024-06-24 06:20:00,1.14,1.10,1.12,211,221,209,49,23,26,44,22,22,20,11,9,-2,-1,-1,66%,63%,69%,147,152,141,43%,35%,53%,4,1,3,6,2,4
246,https://vlr.gg/player/10816/xccurate,2024-06-24 06:20:00,1.02,1.07,1.05,214,190,240,50,21,29,48,21,27,27,11,16,+3,-1,+4,76%,72%,81%,141,133,148,24%,32%,20%,7,2,5,4,3,1
247,https://vlr.gg/player/4545/sayaplayer,2024-06-24 06:20:00,1.06,0.90,0.97,198,204,195,49,24,25,46,21,25,8,1,7,+4,+2,+2,69%,69%,69%,122,125,119,16%,29%,7%,14,7,7,10,5,5
248,https://vlr.gg/player/29833/izu,2024-06-24 06:20:00,0.82,1.01,0.92,213,205,214,50,23,27,49,26,23,9,4,5,-1,-3,+2,71%,69%,72%,140,140,139,28%,35%,24%,8,3,5,9,6,3
249,https://vlr.gg/player/485/stax,2024-06-24 06:20:00,0.90,0.81,0.85,157,160,156,34,16,18,46,21,25,38,22,16,-4,-1,-3,69%,69%,69%,99,90,106,27%,20%,34%,1,1,0,5,2,3
250,https://vlr.gg/player/35013/flashback,2024-06-24 04:00:00,0.80,1.23,1.01,198,174,223,39,15,24,41,24,17,13,7,6,+2,0,+2,65%,62%,69%,128,110,146,30%,28%,31%,4,1,3,2,1,1
251,https://vlr.gg/player/4678/beyn,2024-06-24 04:00:00,0.98,0.94,0.96,185,193,178,33,16,17,39,22,17,14,3,11,0,0,0,71%,65%,77%,123,127,120,23%,28%,19%,1,0,1,1,0,1
252,https://vlr.gg/player/11600/foxy9,2024-06-24 04:00:00,0.70,0.98,0.84,152,154,152,28,13,15,35,21,14,17,5,12,-2,-2,0,67%,54%,81%,106,104,107,36%,53%,25%,5,2,3,7,4,3
253,https://vlr.gg/player/4462/mako,2024-06-24 04:00:00,0.39,1.22,0.81,185,122,248,34,12,22,43,26,17,20,7,13,+1,-2,+3,67%,54%,81%,126,74,179,31%,20%,37%,5,1,4,4,3,1
254,https://vlr.gg/player/804/buzz,2024-06-24 04:00:00,0.36,1.23,0.79,197,142,253,35,12,23,44,25,19,10,3,7,-3,-10,+7,63%,46%,81%,128,94,162,17%,23%,14%,10,2,8,13,12,1
255,https://vlr.gg/player/7764/lmemore,2024-06-24 04:00:00,1.51,1.24,1.37,253,288,219,48,26,22,32,19,13,18,12,6,-1,-1,0,81%,81%,81%,166,180,153,55%,51%,61%,4,1,3,5,2,3
256,https://vlr.gg/player/25025/estrella,2024-06-24 04:00:00,1.25,1.25,1.25,202,210,194,37,19,18,28,17,11,29,11,18,+2,-1,+3,85%,81%,88%,133,146,120,38%,34%,44%,3,0,3,1,1,0
257,https://vlr.gg/player/4871/xffero,2024-06-24 04:00:00,0.79,1.44,1.12,219,162,275,42,15,27,34,20,14,11,4,7,+1,-2,+3,73%,54%,92%,143,121,166,31%,28%,33%,4,0,4,3,2,1
258,https://vlr.gg/player/24895/jemkin,2024-06-24 04:00:00,0.42,1.57,0.99,215,122,308,37,9,28,35,22,13,8,6,2,-3,-8,+5,81%,65%,96%,142,85,199,23%,26%,21%,8,2,6,11,10,1
259,https://vlr.gg/player/8497/monyet,2024-06-24 04:00:00,0.76,1.17,0.97,206,172,241,38,15,23,40,23,17,19,10,9,+3,0,+3,75%,65%,85%,139,120,158,28%,25%,31%,8,4,4,5,4,1
260,https://vlr.gg/player/8447/less,2024-06-23 19:45:00,1.45,1.08,1.24,219,250,197,51,25,26,36,16,20,13,6,7,-1,+2,-3,70%,67%,72%,142,161,128,27%,39%,19%,4,3,1,5,1,4
261,https://vlr.gg/player/6193/cauanzin,2024-06-23 19:45:00,1.25,0.91,1.05,237,275,212,52,27,25,45,18,27,23,6,17,-2,0,-2,81%,85%,78%,162,191,141,26%,33%,19%,5,2,3,7,2,5
262,https://vlr.gg/player/2408/tuyz,2024-06-23 19:45:00,0.82,1.14,1.00,193,170,220,45,17,28,42,18,24,14,5,9,-1,-2,+1,75%,78%,72%,134,114,150,31%,34%,29%,4,0,4,5,2,3
263,https://vlr.gg/player/727/saadhak,2024-06-23 19:45:00,0.80,1.09,0.96,224,193,242,46,16,30,48,22,26,18,7,11,-5,-1,-4,73%,67%,78%,144,135,150,24%,27%,22%,8,5,3,13,6,7
264,https://vlr.gg/player/683/pancada,2024-06-23 19:45:00,0.65,1.07,0.89,152,129,168,35,12,23,38,19,19,24,10,14,-4,-4,0,70%,63%,75%,105,97,111,36%,32%,38%,4,1,3,8,5,3
265,https://vlr.gg/player/3993/jawgemo,2024-06-23 19:45:00,1.31,1.21,1.26,279,272,277,58,33,25,49,26,23,15,6,9,+18,+11,+7,78%,78%,78%,177,177,178,23%,25%,21%,21,13,8,3,2,1
266,https://vlr.gg/player/1533/derrek,2024-06-23 19:45:00,0.93,1.25,1.07,177,169,193,42,22,20,41,25,16,23,15,8,+3,+1,+2,70%,72%,67%,119,115,125,30%,31%,29%,3,1,2,0,0,0
267,https://vlr.gg/player/826/supamen,2024-06-23 19:45:00,1.14,0.86,1.02,212,216,211,50,29,21,48,25,23,16,11,5,-9,-3,-6,71%,75%,67%,126,129,123,51%,50%,53%,3,2,1,12,5,7
268,https://vlr.gg/player/4927/nature,2024-06-23 19:45:00,0.77,0.90,0.83,135,151,121,28,17,11,42,27,15,24,13,11,+2,+1,+1,71%,69%,74%,96,107,80,31%,25%,43%,6,4,2,4,3,1
269,https://vlr.gg/player/5188/apoth,2024-06-23 19:45:00,0.50,0.83,0.64,155,137,170,31,15,16,49,29,20,12,7,5,-1,-2,+1,62%,61%,63%,99,95,105,23%,20%,27%,5,2,3,6,4,2
270,https://vlr.gg/player/1711/khalil,2024-06-23 17:00:00,1.16,1.59,1.38,253,192,318,53,21,32,32,15,17,19,10,9,0,-1,+1,82%,93%,71%,162,120,203,42%,33%,48%,5,1,4,5,2,3
271,https://vlr.gg/player/725/nzr,2024-06-23 17:00:00,1.91,0.66,1.29,237,352,121,47,37,10,35,16,19,24,12,12,-1,+2,-3,79%,96%,61%,155,215,94,25%,20%,39%,2,2,0,3,0,3
272,https://vlr.gg/player/8706/havoc,2024-06-23 17:00:00,1.09,0.79,0.94,200,206,191,39,20,19,40,18,22,10,7,3,-4,-1,-3,68%,71%,64%,141,151,132,35%,36%,34%,2,2,0,6,3,3
273,https://vlr.gg/player/939/mwzera,2024-06-23 17:00:00,0.77,0.89,0.83,210,222,200,39,21,18,49,26,23,17,8,9,+1,0,+1,77%,71%,82%,132,136,129,17%,22%,11%,11,6,5,10,6,4
274,https://vlr.gg/player/681/xand,2024-06-23 17:00:00,0.90,0.62,0.76,162,157,166,30,15,15,40,18,22,19,10,9,-4,-4,0,73%,79%,68%,102,99,105,29%,29%,29%,4,1,3,8,5,3
275,https://vlr.gg/player/796/eeiu,2024-06-23 17:00:00,1.36,0.75,1.06,189,212,165,36,23,13,37,15,22,19,6,13,+1,+1,0,77%,79%,75%,147,159,135,36%,49%,24%,2,1,1,1,0,1
276,https://vlr.gg/player/601/asuna,2024-06-23 17:00:00,0.96,1.14,1.05,197,164,233,39,16,23,41,19,22,24,15,9,-1,-1,0,75%,79%,71%,130,113,147,23%,17%,30%,6,1,5,7,2,5
277,https://vlr.gg/player/4147/cryocells,2024-06-23 17:00:00,1.00,0.97,0.99,234,245,222,46,23,23,47,24,23,10,6,4,+5,+3,+2,66%,68%,64%,145,157,133,23%,26%,19%,11,6,5,6,3,3
278,https://vlr.gg/player/604/boostio,2024-06-23 17:00:00,1.09,0.78,0.94,200,204,198,38,20,18,43,18,25,16,7,9,-1,-1,0,70%,68%,71%,145,152,138,30%,32%,27%,3,1,2,4,2,2
279,https://vlr.gg/player/3880/bang,2024-06-23 17:00:00,1.17,0.66,0.91,195,222,167,37,21,16,40,18,22,18,12,6,+4,+2,+2,77%,79%,75%,120,137,104,32%,26%,42%,10,7,3,6,5,1
280,https://vlr.gg/player/2098/thebigfiz,2024-06-23 15:00:00,1.40,1.34,1.37,251,264,237,52,31,21,35,19,16,31,13,18,+3,+1,+2,81%,84%,78%,160,163,156,31%,33%,29%,6,4,2,3,3,0
281,https://vlr.gg/player/113/hyp,2024-06-23 15:00:00,1.07,1.33,1.19,194,180,214,42,21,21,33,19,14,20,10,10,+2,+1,+1,83%,81%,85%,131,120,144,19%,13%,27%,3,1,2,1,0,1
282,https://vlr.gg/player/13258/cyvoph,2024-06-23 15:00:00,1.21,1.18,1.19,225,242,197,29,19,10,27,19,8,32,18,14,+1,+2,-1,85%,92%,73%,153,161,141,20%,23%,14%,5,4,1,4,2,2
283,https://vlr.gg/player/2621/goaster,2024-06-23 15:00:00,0.68,1.37,1.03,215,162,269,29,11,18,27,14,13,12,2,10,0,-1,+1,80%,75%,85%,148,117,179,17%,18%,15%,8,3,5,8,4,4
284,https://vlr.gg/player/440/akumaaaaa,2024-06-23 15:00:00,0.89,0.89,0.89,180,187,176,38,21,17,42,24,18,11,6,5,0,-2,+2,71%,66%,78%,126,138,113,31%,38%,25%,8,3,5,8,5,3
285,https://vlr.gg/player/13439/soon,2024-06-23 15:00:00,0.54,0.75,0.64,133,110,156,18,7,11,28,15,13,8,3,5,-2,-1,-1,62%,60%,63%,94,77,111,25%,45%,17%,1,1,0,3,2,1
286,https://vlr.gg/player/7104/juseu,2024-06-23 15:00:00,0.78,1.52,1.18,245,191,290,50,18,32,41,21,20,7,2,5,+2,-1,+3,80%,70%,88%,163,131,190,23%,30%,20%,7,2,5,5,3,2
287,https://vlr.gg/player/3579/marctylinho,2024-06-23 15:00:00,1.24,0.91,1.06,195,218,176,41,23,18,39,18,21,22,3,19,-2,+3,-5,78%,78%,78%,120,137,106,24%,33%,18%,5,3,2,7,0,7
288,https://vlr.gg/player/2841/foxie,2024-06-23 15:00:00,0.81,1.04,0.93,171,137,199,36,12,24,40,17,23,17,7,10,-6,-5,-1,69%,63%,75%,106,88,121,24%,23%,24%,4,1,3,10,6,4
289,https://vlr.gg/player/2525/szimpli,2024-06-23 15:00:00,0.86,0.85,0.85,189,189,190,36,18,18,45,20,25,16,2,14,0,-3,+3,75%,63%,84%,123,118,128,26%,36%,19%,8,3,5,8,6,2
290,https://vlr.gg/player/6828/pa1ka,2024-06-23 15:00:00,0.53,0.80,0.68,132,117,144,29,12,17,44,22,22,8,2,6,+2,+3,-1,68%,63%,72%,88,81,95,32%,31%,32%,4,3,1,2,0,2
291,https://vlr.gg/player/2431/basya,2024-06-23 15:00:00,1.03,1.19,1.11,198,197,200,16,8,8,14,8,6,3,2,1,+2,+1,+1,74%,67%,82%,125,140,108,28%,25%,32%,3,1,2,1,0,1
292,https://vlr.gg/player/29998/drastz,2024-06-23 15:00:00,0.90,1.28,1.08,251,225,281,17,8,9,17,9,8,8,5,3,0,-1,+1,65%,58%,73%,168,144,195,21%,18%,25%,2,0,2,2,1,1
293,https://vlr.gg/player/3860/al1en,2024-06-23 15:00:00,0.90,1.08,0.99,191,186,196,17,7,10,16,9,7,10,6,4,+1,-1,+2,70%,58%,82%,122,122,122,24%,17%,33%,3,1,2,2,2,0
294,https://vlr.gg/player/1347/ivan4ezz,2024-06-23 15:00:00,0.84,1.07,0.95,191,186,198,14,8,6,17,9,8,15,4,11,-3,-2,-1,78%,67%,91%,135,130,141,30%,37%,25%,1,1,0,4,3,1
295,https://vlr.gg/player/2252/anq,2024-06-23 15:00:00,0.81,0.89,0.85,186,200,172,15,8,7,17,10,7,3,3,0,-3,-1,-2,65%,75%,55%,126,138,113,37%,32%,46%,1,1,0,4,2,2
296,https://vlr.gg/player/11013/balli,2024-06-23 15:00:00,1.64,1.08,1.35,258,296,224,22,13,9,16,7,9,4,1,3,+3,0,+3,83%,73%,92%,168,206,132,26%,29%,22%,3,0,3,0,0,0
297,https://vlr.gg/player/33513/sihw,2024-06-23 15:00:00,1.49,1.10,1.29,231,260,206,19,10,9,14,6,8,4,2,2,0,0,0,70%,73%,67%,156,181,134,18%,18%,17%,1,0,1,1,0,1
298,https://vlr.gg/player/11122/byron,2024-06-23 15:00:00,0.65,1.25,0.96,171,106,231,15,5,10,14,8,6,9,6,3,+1,0,+1,74%,64%,83%,102,61,140,29%,33%,28%,2,0,2,1,0,1
299,https://vlr.gg/player/33523/vuexlex,2024-06-23 15:00:00,0.40,1.38,0.91,205,148,259,17,5,12,18,10,8,3,1,2,0,0,0,61%,55%,67%,143,99,183,38%,36%,39%,7,5,2,7,5,2
300,https://vlr.gg/player/33627/dok,2024-06-23 15:00:00,0.48,0.95,0.73,122,97,146,8,3,5,17,9,8,16,8,8,-1,-1,0,74%,73%,75%,73,51,94,38%,43%,36%,0,0,0,1,1,0
301,https://vlr.gg/player/4214/eso177,2024-06-23 15:00:00,0.89,1.34,1.16,219,171,248,29,10,19,27,12,15,9,0,9,+3,+1,+2,63%,50%,71%,138,110,157,33%,35%,32%,5,2,3,2,1,1
302,https://vlr.gg/player/2864/ease,2024-06-23 15:00:00,0.97,0.87,0.91,154,150,165,21,8,13,26,11,15,14,7,7,-2,0,-2,68%,63%,71%,104,97,110,26%,20%,31%,1,0,1,3,0,3
303,https://vlr.gg/player/12331/zmart,2024-06-23 15:00:00,0.44,0.98,0.76,185,152,207,26,7,19,31,15,16,4,2,2,-7,-3,-4,53%,50%,54%,117,102,127,25%,25%,25%,5,2,3,12,5,7
304,https://vlr.gg/player/6069/kheops,2024-06-23 15:00:00,0.67,0.78,0.74,166,156,180,26,9,17,35,15,20,7,4,3,-2,-1,-1,58%,50%,63%,104,92,112,31%,24%,36%,1,0,1,3,1,2
305,https://vlr.gg/player/12333/achrf,2024-06-23 15:00:00,0.28,0.70,0.49,128,104,147,16,5,11,34,16,18,10,3,7,-6,-5,-1,58%,38%,71%,84,59,101,19%,11%,24%,1,0,1,7,5,2
306,https://vlr.gg/player/3806/xenon,2024-06-23 15:00:00,1.06,1.70,1.32,236,178,327,34,14,20,23,14,9,16,9,7,+1,+1,0,90%,92%,88%,150,114,204,21%,17%,25%,3,1,2,2,0,2
307,https://vlr.gg/player/363/7ssk7,2024-06-23 15:00:00,1.39,1.15,1.29,215,232,183,31,21,10,21,14,7,18,8,10,+1,+1,0,80%,79%,81%,139,152,119,28%,23%,37%,3,2,1,2,1,1
308,https://vlr.gg/player/6126/sibeastw0w,2024-06-23 15:00:00,1.10,1.23,1.15,259,245,271,35,21,14,29,19,10,10,3,7,+10,+5,+5,80%,75%,88%,175,158,200,28%,29%,26%,12,7,5,2,2,0
309,https://vlr.gg/player/5654/avez,2024-06-23 15:00:00,0.93,1.30,1.07,161,135,201,24,12,12,20,13,7,12,8,4,-3,-3,0,73%,67%,81%,107,82,145,27%,31%,24%,2,1,1,5,4,1
310,https://vlr.gg/player/172/vakk,2024-06-23 15:00:00,0.72,1.52,1.04,188,184,191,29,16,13,25,19,6,6,2,4,+5,+2,+3,75%,63%,94%,119,121,117,39%,44%,33%,7,4,3,2,2,0
311,https://vlr.gg/player/5586/calvin-s,2024-06-23 14:00:00,1.21,0.90,1.03,241,300,216,37,21,16,39,17,22,14,5,9,0,0,0,67%,67%,68%,167,190,150,35%,29%,42%,4,1,3,4,1,3
312,https://vlr.gg/player/7867/rexon,2024-06-23 14:00:00,1.36,0.78,1.02,220,263,182,32,17,15,34,13,21,13,5,8,0,-1,+1,67%,78%,60%,143,180,116,24%,21%,28%,4,1,3,4,2,2
313,https://vlr.gg/player/27813/zery,2024-06-23 14:00:00,0.98,0.92,0.95,196,196,213,28,11,17,34,13,21,17,11,6,+4,0,+4,60%,61%,60%,142,144,141,30%,47%,20%,9,4,5,5,4,1
314,https://vlr.gg/player/15382/kongi,2024-06-23 14:00:00,0.69,0.75,0.72,167,176,154,24,10,14,37,16,21,11,7,4,-2,-2,0,70%,78%,64%,120,144,102,13%,16%,10%,1,0,1,3,2,1
315,https://vlr.gg/player/12514/spocki,2024-06-23 14:00:00,0.60,0.59,0.54,109,85,137,16,6,10,33,13,20,9,2,7,-5,-3,-2,53%,44%,60%,88,72,99,20%,29%,18%,2,0,2,7,3,4
316,https://vlr.gg/player/1466/exampl,2024-06-23 14:00:00,1.44,1.47,1.46,251,247,280,42,23,19,27,16,11,16,7,9,-3,-2,-1,84%,76%,94%,171,170,171,28%,29%,26%,2,1,1,5,3,2
317,https://vlr.gg/player/11330/mcd,2024-06-23 14:00:00,1.47,1.25,1.38,242,257,212,38,24,14,23,12,11,10,5,5,0,-1,+1,72%,68%,78%,167,177,152,29%,29%,29%,1,0,1,1,1,0
318,https://vlr.gg/player/28098/linus,2024-06-23 14:00:00,1.11,1.14,1.12,238,212,276,35,18,17,31,16,15,16,10,6,+5,+2,+3,79%,80%,78%,159,146,177,37%,35%,40%,9,4,5,4,2,2
319,https://vlr.gg/player/22180/spmak,2024-06-23 14:00:00,1.48,0.46,1.05,202,245,105,26,20,6,26,12,14,31,21,10,0,+1,-1,81%,92%,67%,119,153,71,20%,17%,29%,2,2,0,2,1,1
320,https://vlr.gg/player/29951/ziad,2024-06-23 14:00:00,0.86,1.22,1.01,218,192,260,35,19,16,32,19,13,11,5,6,+1,-3,+4,77%,76%,78%,140,122,165,36%,41%,31%,9,4,5,8,7,1
321,https://vlr.gg/player/8226/waddle,2024-06-23 14:00:00,1.88,0.77,1.55,259,305,150,16,14,2,8,5,3,11,6,5,-2,-1,-1,100%,100%,100%,193,230,103,37%,52%,7%,0,0,0,2,1,1
322,https://vlr.gg/player/4544/filu,2024-06-23 14:00:00,1.02,2.79,1.54,360,265,590,23,12,11,11,9,2,1,1,0,-1,-2,+1,88%,83%,100%,220,149,392,31%,29%,35%,2,1,1,3,3,0
323,https://vlr.gg/player/12474/tag,2024-06-23 14:00:00,1.42,1.40,1.41,245,280,163,15,12,3,9,8,1,4,3,1,+2,+1,+1,88%,83%,100%,164,184,117,19%,18%,23%,2,1,1,0,0,0
324,https://vlr.gg/player/7162/wackie,2024-06-23 14:00:00,1.29,0.93,1.18,180,193,148,13,10,3,8,5,3,2,1,1,-1,-1,0,71%,67%,80%,136,142,120,39%,45%,25%,1,1,0,2,2,0
325,https://vlr.gg/player/1944/cayden,2024-06-23 14:00:00,1.02,1.51,1.16,188,184,199,12,7,5,9,7,2,9,7,2,+1,+1,0,82%,75%,100%,151,152,148,20%,19%,21%,3,2,1,2,1,1
326,https://vlr.gg/player/30508/rickyvaila,2024-06-23 14:00:00,2.11,1.01,1.33,279,390,233,17,7,10,15,4,11,1,0,1,+2,+1,+1,53%,60%,50%,177,249,147,24%,26%,23%,2,1,1,0,0,0
327,https://vlr.gg/player/10375/braso,2024-06-23 14:00:00,0.02,1.20,0.81,193,25,265,11,0,11,15,5,10,1,0,1,+2,-1,+3,59%,20%,75%,126,25,169,39%,0%,50%,4,0,4,2,1,1
328,https://vlr.gg/player/31114/frandina,2024-06-23 14:00:00,0.43,0.64,0.58,125,148,116,7,2,5,15,5,10,2,1,1,-1,0,-1,41%,40%,42%,86,110,76,17%,11%,20%,0,0,0,1,0,1
329,https://vlr.gg/player/2897/limp,2024-06-23 14:00:00,0.63,0.30,0.39,104,165,80,4,2,2,16,5,11,2,1,1,0,+1,-1,29%,40%,25%,97,139,79,15%,20%,12%,1,1,0,1,0,1
330,https://vlr.gg/player/4274/xazyy,2024-06-23 14:00:00,0.01,0.28,0.11,127,11,176,6,0,6,18,5,13,4,1,3,-2,-2,0,53%,60%,50%,91,6,126,18%,0%,19%,2,0,2,4,2,2
331,https://vlr.gg/player/10160/izzy,2024-06-23 14:00:00,1.05,1.39,1.23,269,222,312,69,25,44,52,26,26,8,4,4,-6,-2,-4,64%,63%,66%,173,146,197,31%,30%,33%,9,3,6,15,5,10
332,https://vlr.gg/player/1399/sterben,2024-06-23 14:00:00,0.94,1.30,1.13,211,208,215,52,25,27,48,27,21,28,10,18,-4,-5,+1,73%,63%,82%,146,140,152,21%,21%,21%,5,3,2,9,8,1
333,https://vlr.gg/player/5510/oxmann,2024-06-23 14:00:00,0.97,1.09,1.03,216,207,227,57,26,31,53,27,26,13,6,7,0,-1,+1,67%,60%,74%,142,134,149,37%,37%,37%,7,4,3,7,5,2
334,https://vlr.gg/player/556/souhcni,2024-06-23 14:00:00,0.97,0.71,0.84,155,172,144,40,22,18,51,24,27,19,5,14,+2,0,+2,67%,69%,66%,105,108,102,32%,27%,36%,7,2,5,5,2,3
335,https://vlr.gg/player/3557/skylen,2024-06-23 14:00:00,0.67,0.92,0.80,168,135,189,41,16,25,55,27,28,25,12,13,+1,-1,+2,68%,63%,74%,111,93,128,34%,33%,34%,5,1,4,4,2,2
336,https://vlr.gg/player/18677/ruxic,2024-06-23 14:00:00,0.76,1.39,1.07,226,182,288,57,22,35,52,30,22,29,10,19,+4,-3,+7,74%,63%,86%,156,120,194,26%,26%,26%,10,3,7,6,6,0
337,https://vlr.gg/player/12651/w0zzip,2024-06-23 14:00:00,1.17,0.94,1.06,212,240,182,53,31,22,49,28,21,28,13,15,+3,+3,0,75%,79%,71%,138,151,124,31%,29%,33%,5,3,2,2,0,2
338,https://vlr.gg/player/5568/sociablee,2024-06-23 14:00:00,0.94,0.99,0.96,197,201,187,49,26,23,51,28,23,16,5,11,+1,+1,0,70%,68%,71%,127,133,121,20%,17%,25%,6,3,3,5,2,3
339,https://vlr.gg/player/568/turko,2024-06-23 14:00:00,0.99,0.81,0.91,186,180,192,49,26,23,55,28,27,11,4,7,-4,-3,-1,68%,71%,66%,120,116,125,26%,31%,23%,3,1,2,7,4,3
340,https://vlr.gg/player/10125/qw1,2024-06-23 14:00:00,0.65,1.07,0.85,196,178,219,51,23,28,52,31,21,6,4,2,+3,0,+3,70%,66%,74%,126,115,137,28%,28%,27%,16,8,8,13,8,5
341,https://vlr.gg/player/4277/n-a-i-s,2024-06-23 13:00:00,2.55,1.15,1.67,286,379,233,20,10,10,9,0,9,9,4,5,0,0,0,89%,100%,83%,211,237,196,37%,44%,33%,0,0,0,0,0,0
342,https://vlr.gg/player/1493/starkk,2024-06-23 13:00:00,2.27,1.07,1.51,285,432,200,21,12,9,9,2,7,5,3,2,+3,+3,0,79%,100%,67%,176,255,129,26%,38%,19%,3,3,0,0,0,0
343,https://vlr.gg/player/18400/bipo,2024-06-23 13:00:00,1.11,1.11,1.11,225,188,247,15,5,10,12,3,9,5,3,2,+4,0,+4,84%,86%,83%,145,133,152,14%,21%,10%,6,1,5,2,1,1
344,https://vlr.gg/player/1524/h1ber,2024-06-23 13:00:00,1.18,0.94,1.03,213,178,234,14,4,10,12,3,9,8,3,5,+1,+2,-1,89%,100%,83%,126,119,130,31%,33%,29%,3,2,1,2,0,2
345,https://vlr.gg/player/23347/alannn,2024-06-23 13:00:00,1.01,0.98,0.99,161,120,186,11,3,8,10,3,7,3,2,1,+1,0,+1,79%,71%,83%,102,74,118,22%,13%,30%,2,0,2,1,0,1
346,https://vlr.gg/player/33501/sword,2024-06-23 13:00:00,2.01,0.76,1.55,301,376,173,19,16,3,16,9,7,8,8,0,+1,0,+1,74%,92%,43%,190,237,111,38%,40%,31%,1,0,1,0,0,0
347,https://vlr.gg/player/33358/shinnok,2024-06-23 13:00:00,1.12,0.04,0.71,136,180,62,10,9,1,14,7,7,0,0,0,-3,0,-3,42%,58%,14%,95,122,49,20%,15%,67%,1,1,0,4,1,3
348,https://vlr.gg/player/16447/d3mur,2024-06-23 13:00:00,0.36,0.99,0.59,172,134,238,10,5,5,18,12,6,3,3,0,-2,-2,0,58%,58%,57%,114,92,153,23%,21%,27%,3,3,0,5,5,0
349,https://vlr.gg/player/5854/z3ro,2024-06-23 13:00:00,0.70,0.23,0.53,132,146,108,8,6,2,17,10,7,8,6,2,-2,-1,-1,58%,58%,57%,85,96,66,29%,28%,33%,0,0,0,2,1,1
350,https://vlr.gg/player/7706/morphiw0w,2024-06-23 13:00:00,0.47,0.02,0.25,69,98,21,5,5,0,16,9,7,4,2,2,-3,-1,-2,47%,58%,29%,46,65,14,19%,23%,0%,0,0,0,3,1,2
351,https://vlr.gg/player/26789/pdr,2024-06-23 13:00:00,1.22,1.29,1.26,241,243,239,20,10,10,16,8,8,12,8,4,+3,+4,-1,87%,100%,73%,149,142,156,26%,27%,25%,4,4,0,1,0,1
352,https://vlr.gg/player/2617/leare,2024-06-23 13:00:00,0.89,1.60,1.23,271,168,384,21,7,14,17,6,11,6,1,5,+5,+1,+4,78%,75%,82%,170,106,240,25%,18%,29%,8,2,6,3,1,2
353,https://vlr.gg/player/33517/tripsy,2024-06-23 13:00:00,1.22,1.21,1.22,267,283,250,23,13,10,17,8,9,4,1,3,+1,+1,0,78%,75%,82%,184,191,176,33%,27%,44%,2,2,0,1,1,0
354,https://vlr.gg/player/27820/coronel,2024-06-23 13:00:00,1.16,1.10,1.13,172,152,195,13,6,7,13,5,8,13,8,5,+1,0,+1,78%,83%,73%,132,121,144,18%,26%,11%,1,0,1,0,0,0
355,https://vlr.gg/player/2832/patix,2024-06-23 13:00:00,1.30,0.23,0.78,140,183,94,14,10,4,13,4,9,3,2,1,+1,+2,-1,74%,92%,55%,86,115,55,40%,35%,60%,2,2,0,1,0,1
356,https://vlr.gg/player/2880/rlzy,2024-06-23 13:00:00,1.53,0.81,1.16,248,326,179,20,13,7,16,8,8,3,2,1,0,+1,-1,61%,73%,50%,163,221,110,29%,34%,19%,3,2,1,3,1,2
357,https://vlr.gg/player/2980/raxtazzz,2024-06-23 13:00:00,0.80,1.33,1.08,183,178,189,16,7,9,17,9,8,7,4,3,-3,-1,-2,74%,82%,67%,118,111,125,23%,25%,22%,0,0,0,3,1,2
358,https://vlr.gg/player/7258/nask,2024-06-23 13:00:00,0.74,1.12,0.94,175,156,194,14,6,8,17,8,9,9,5,4,-2,-2,0,70%,64%,75%,114,104,122,30%,33%,28%,1,0,1,3,2,1
359,https://vlr.gg/player/6910/kenzmps,2024-06-23 13:00:00,1.01,0.67,0.83,194,251,143,15,10,5,20,10,10,9,5,4,-1,-1,0,65%,73%,58%,129,172,90,28%,30%,26%,0,0,0,1,1,0
360,https://vlr.gg/player/12571/furyan,2024-06-23 13:00:00,0.67,0.12,0.38,155,253,67,11,9,2,21,10,11,4,2,2,-5,0,-5,48%,55%,42%,97,153,46,17%,25%,0%,2,2,0,7,2,5
361,https://vlr.gg/player/5554/profek,2024-06-23 12:30:00,1.59,1.11,1.36,274,325,219,61,39,22,40,20,20,26,10,16,0,+2,-2,83%,85%,81%,178,206,149,26%,29%,23%,6,4,2,6,2,4
362,https://vlr.gg/player/25906/alexiiik,2024-06-23 12:30:00,1.04,1.38,1.20,286,272,308,64,31,33,51,27,24,13,7,6,+9,0,+9,80%,73%,87%,198,177,220,25%,23%,28%,20,9,11,11,9,2
363,https://vlr.gg/player/1155/buld,2024-06-23 12:30:00,1.12,1.24,1.18,219,200,237,50,23,27,41,20,21,28,14,14,-1,+2,-3,77%,76%,77%,135,123,149,26%,26%,27%,3,2,1,4,0,4
364,https://vlr.gg/player/562/zeek,2024-06-23 12:30:00,1.10,1.27,1.18,199,191,210,44,21,23,36,20,16,38,20,18,0,-1,+1,78%,70%,87%,139,127,152,28%,24%,32%,2,1,1,2,2,0
365,https://vlr.gg/player/23169/minny,2024-06-23 12:30:00,0.63,0.79,0.71,138,115,162,34,15,19,46,22,24,11,5,6,-2,-4,+2,73%,70%,77%,86,73,100,19%,17%,22%,4,0,4,6,4,2
366,https://vlr.gg/player/15064/kajuks,2024-06-23 12:30:00,1.16,1.04,1.10,208,202,212,47,22,25,46,22,24,24,17,7,-1,0,-1,73%,77%,70%,128,137,119,22%,25%,20%,5,1,4,6,1,5
367,https://vlr.gg/player/33732/nunmeister,2024-06-23 12:30:00,1.20,0.97,1.08,209,244,183,48,28,20,49,23,26,29,12,17,-5,-4,-1,64%,65%,64%,134,150,119,30%,29%,31%,1,0,1,6,4,2
368,https://vlr.gg/player/39682/wanzeru,2024-06-23 12:30:00,1.03,1.09,1.06,246,239,255,53,25,28,51,23,28,13,8,5,+8,+1,+7,73%,71%,76%,161,157,164,19%,22%,16%,19,9,10,11,8,3
369,https://vlr.gg/player/10448/kozok,2024-06-23 12:30:00,0.76,0.73,0.75,170,189,156,36,18,18,51,26,25,22,12,10,-4,-2,-2,69%,68%,70%,108,120,96,23%,21%,25%,1,0,1,5,2,3
370,https://vlr.gg/player/259/arch,2024-06-23 12:30:00,0.35,0.80,0.58,152,110,187,30,12,18,56,30,26,17,8,9,-4,-2,-2,58%,58%,58%,100,67,130,23%,21%,24%,3,2,1,7,4,3
371,https://vlr.gg/player/2700/jas,2024-06-23 12:00:00,1.74,1.04,1.34,277,363,214,64,36,28,43,18,25,17,8,9,+1,+1,0,75%,89%,64%,182,234,144,31%,28%,33%,10,6,4,9,5,4
372,https://vlr.gg/player/4308/magik,2024-06-23 12:00:00,0.92,1.22,1.09,233,181,261,52,17,35,47,19,28,19,10,9,+4,+2,+2,71%,70%,72%,143,128,155,37%,37%,36%,7,2,5,3,0,3
373,https://vlr.gg/player/1475/kamyk,2024-06-23 12:00:00,1.20,0.84,0.99,186,218,178,44,21,23,43,16,27,36,19,17,-12,-8,-4,70%,78%,64%,119,121,118,36%,30%,42%,1,0,1,13,8,5
374,https://vlr.gg/player/5893/robbiebk,2024-06-23 12:00:00,1.11,0.87,0.98,197,227,186,42,23,19,43,19,24,16,4,12,+1,+1,0,67%,70%,64%,138,149,130,27%,38%,20%,6,2,4,5,1,4
375,https://vlr.gg/player/1284/mikee,2024-06-23 12:00:00,0.61,0.61,0.59,119,126,127,27,12,15,42,17,25,11,4,7,-3,-3,0,63%,56%,69%,86,77,93,18%,9%,25%,3,0,3,6,3,3
376,https://vlr.gg/player/24439/yohpa,2024-06-23 12:00:00,1.48,1.02,1.29,237,281,173,56,37,19,41,21,20,12,8,4,0,0,0,70%,72%,67%,160,186,125,35%,38%,30%,6,4,2,6,4,2
377,https://vlr.gg/player/253/sp1ke,2024-06-23 12:00:00,1.18,0.88,1.05,227,229,221,50,31,19,46,23,23,13,6,7,+9,+1,+8,75%,75%,74%,147,150,143,28%,29%,27%,18,8,10,9,7,2
378,https://vlr.gg/player/15969/yuta,2024-06-23 12:00:00,1.05,0.82,0.95,191,196,188,43,26,17,47,23,24,11,5,6,-1,0,-1,63%,69%,56%,134,133,135,38%,45%,31%,5,3,2,6,3,3
379,https://vlr.gg/player/226/roden,2024-06-23 12:00:00,0.75,1.14,0.92,183,144,235,39,19,20,48,27,21,24,10,14,-2,-1,-1,67%,58%,78%,118,93,151,20%,14%,26%,2,1,1,4,2,2
380,https://vlr.gg/player/126/nowaxxzang,2024-06-23 12:00:00,0.76,0.76,0.76,139,139,152,30,16,14,47,26,21,24,16,8,+3,+2,+1,73%,75%,70%,98,95,102,23%,19%,27%,5,3,2,2,1,1
381,https://vlr.gg/player/6338/syyse,2024-06-23 12:00:00,1.21,0.99,1.14,239,250,218,16,11,5,14,9,5,6,5,1,+1,+1,0,67%,75%,50%,136,131,148,30%,26%,40%,1,1,0,0,0,0
382,https://vlr.gg/player/19526/rexxtoned,2024-06-23 12:00:00,0.98,1.44,1.13,200,158,286,13,7,6,13,8,5,3,2,1,-1,0,-1,67%,67%,67%,141,114,195,64%,71%,55%,0,0,0,1,0,1
383,https://vlr.gg/player/9943/mezoky,2024-06-23 12:00:00,0.90,0.47,0.75,185,209,140,11,8,3,16,10,6,3,2,1,+1,0,+1,50%,50%,50%,110,129,73,26%,22%,38%,3,2,1,2,2,0
384,https://vlr.gg/player/45138/aster,2024-06-23 12:00:00,0.41,0.38,0.40,76,68,93,4,2,2,14,9,5,5,4,1,-2,0,-2,56%,58%,50%,57,59,54,18%,30%,0%,0,0,0,2,0,2
385,https://vlr.gg/player/22566/pax,2024-06-23 12:00:00,0.47,0.01,0.24,97,147,,7,7,0,17,11,6,0,0,0,-3,-1,-2,44%,50%,33%,60,90,,60%,60%,,3,3,0,6,4,2
386,https://vlr.gg/player/29559/javelin,2024-06-23 12:00:00,1.53,1.88,1.76,348,302,372,22,6,16,9,4,5,3,2,1,+3,+2,+1,89%,100%,83%,239,222,248,25%,32%,21%,4,2,2,1,0,1
387,https://vlr.gg/player/22188/jimbk,2024-06-23 12:00:00,0.99,1.43,1.28,231,139,277,15,4,11,11,3,8,6,2,4,+2,+1,+1,78%,83%,75%,147,73,183,27%,0%,34%,3,1,2,1,0,1
388,https://vlr.gg/player/9574/ayyzicle,2024-06-23 12:00:00,1.28,0.94,1.06,144,195,118,12,6,6,8,2,6,3,0,3,-1,-1,0,78%,67%,83%,99,136,81,45%,57%,38%,0,0,0,1,1,0
389,https://vlr.gg/player/45142/browse,2024-06-23 12:00:00,1.23,0.94,1.04,218,239,209,13,6,7,11,3,8,5,0,5,0,0,0,72%,83%,67%,153,162,148,15%,18%,14%,2,0,2,2,0,2
390,https://vlr.gg/player/45143/francybald,2024-06-23 12:00:00,1.30,0.63,0.85,191,257,159,12,5,7,12,4,8,4,4,0,0,+2,-2,78%,100%,67%,117,165,93,22%,20%,24%,2,2,0,2,0,2
391,https://vlr.gg/player/14668/waer,2024-06-23 12:00:00,1.29,1.79,1.52,257,266,246,22,11,11,11,8,3,3,2,1,+1,+1,0,82%,67%,100%,174,159,193,33%,35%,32%,1,1,0,0,0,0
392,https://vlr.gg/player/29996/stepa,2024-06-23 12:00:00,0.67,2.27,1.40,300,173,453,23,7,16,14,10,4,6,2,4,+6,+3,+3,73%,58%,90%,189,95,301,26%,25%,27%,8,5,3,2,2,0
393,https://vlr.gg/player/7256/andresg,2024-06-23 12:00:00,0.54,1.05,0.77,150,127,180,12,5,7,15,9,6,6,4,2,+1,-1,+2,82%,75%,90%,112,90,139,32%,38%,27%,3,0,3,2,1,1
394,https://vlr.gg/player/29994/xini,2024-06-23 12:00:00,0.44,1.13,0.76,184,107,277,15,5,10,18,10,8,5,2,3,+1,-1,+2,64%,58%,70%,130,92,176,19%,27%,15%,3,1,2,2,2,0
395,https://vlr.gg/player/10399/lekyy,2024-06-23 12:00:00,0.66,0.64,0.65,93,113,71,8,5,3,14,9,5,3,2,1,+1,0,+1,68%,67%,70%,53,64,40,17%,23%,10%,1,0,1,0,0,0
396,https://vlr.gg/player/1353/dext,2024-06-23 12:00:00,0.90,1.62,1.29,268,230,300,21,8,13,16,9,7,4,0,4,-2,-1,-1,77%,60%,92%,169,138,195,30%,19%,42%,2,1,1,4,2,2
397,https://vlr.gg/player/9557/nefi,2024-06-23 12:00:00,0.65,1.62,1.18,240,186,287,18,6,12,16,10,6,3,1,2,-1,-1,0,73%,60%,83%,167,144,187,43%,28%,55%,1,0,1,2,1,1
398,https://vlr.gg/player/15487/aqua,2024-06-23 12:00:00,0.78,1.24,1.03,171,169,174,13,6,7,15,9,6,8,2,6,-1,-2,+1,77%,70%,83%,116,115,117,55%,56%,54%,1,0,1,2,2,0
399,https://vlr.gg/player/22495/mochi,2024-06-23 12:00:00,0.34,0.98,0.69,139,100,172,10,3,7,15,9,6,3,2,1,0,-1,+1,50%,30%,67%,90,65,112,46%,44%,47%,1,0,1,1,1,0
400,https://vlr.gg/player/6101/999kvmil,2024-06-23 12:00:00,0.17,0.81,0.52,124,106,140,10,3,7,18,10,8,4,1,3,-6,-3,-3,59%,40%,75%,101,89,112,24%,25%,23%,1,0,1,7,3,4
401,https://vlr.gg/player/27316/elixllo,2024-06-23 12:00:00,1.40,1.24,1.33,241,233,250,41,22,19,30,15,15,12,2,10,-1,0,-1,72%,71%,74%,161,157,166,36%,28%,47%,2,1,1,3,1,2
402,https://vlr.gg/player/33464/avvix,2024-06-23 12:00:00,0.80,1.57,1.18,233,155,316,38,12,26,31,16,15,14,9,5,0,-1,+1,77%,75%,78%,157,102,214,28%,24%,30%,3,1,2,3,2,1
403,https://vlr.gg/player/7286/str1ker,2024-06-23 12:00:00,0.84,0.65,0.75,153,165,143,23,12,11,35,18,17,14,9,5,-3,0,-3,66%,67%,65%,105,120,88,27%,23%,34%,2,1,1,5,1,4
404,https://vlr.gg/player/5636/kugio,2024-06-23 12:00:00,0.98,0.50,0.75,171,218,122,29,20,9,39,20,19,11,7,4,0,+1,-1,53%,58%,48%,106,128,84,22%,29%,13%,5,4,1,5,3,2
405,https://vlr.gg/player/37847/fighter,2024-06-23 12:00:00,0.26,0.78,0.51,143,117,168,22,8,14,39,23,16,7,5,2,-7,-6,-1,66%,71%,61%,91,74,108,22%,18%,26%,6,2,4,13,8,5
406,https://vlr.gg/player/11914/rezy,2024-06-23 12:00:00,1.09,1.32,1.21,202,171,230,35,14,21,27,13,14,17,11,6,+7,+3,+4,83%,78%,88%,120,105,134,22%,19%,25%,8,4,4,1,1,0
407,https://vlr.gg/player/46252/titanjr,2024-06-23 12:00:00,1.13,1.19,1.16,224,230,217,39,19,20,34,18,16,13,5,8,+5,+2,+3,74%,70%,79%,152,151,152,36%,33%,39%,6,2,4,1,0,1
408,https://vlr.gg/player/15188/a1mly,2024-06-23 12:00:00,0.88,1.24,1.06,198,170,229,33,13,20,31,16,15,4,1,3,0,+1,-1,66%,57%,75%,133,115,150,38%,34%,40%,6,4,2,6,3,3
409,https://vlr.gg/player/29025/adelano,2024-06-23 12:00:00,1.16,0.95,1.05,203,187,216,33,16,17,29,14,15,19,11,8,+2,0,+2,66%,65%,67%,130,128,132,33%,36%,30%,6,1,5,4,1,3
410,https://vlr.gg/player/36071/mabuchi,2024-06-23 12:00:00,0.98,0.97,0.98,208,248,169,34,20,14,32,18,14,9,3,6,-3,-1,-2,68%,70%,67%,141,159,123,18%,22%,13%,3,3,0,6,4,2
411,https://vlr.gg/player/41220/krejz,2024-06-23 12:00:00,0.95,1.49,1.20,248,208,311,72,31,41,58,34,24,8,6,2,-1,-5,+4,64%,56%,73%,165,143,191,36%,38%,35%,13,5,8,14,10,4
412,https://vlr.gg/player/15473/yuno,2024-06-23 12:00:00,0.73,1.03,0.87,175,173,193,47,22,25,59,37,22,30,15,15,+2,+1,+1,70%,60%,81%,117,112,122,21%,20%,23%,6,4,2,4,3,1
413,https://vlr.gg/player/36645/tomatte,2024-06-23 12:00:00,0.81,0.84,0.82,155,151,164,38,22,16,57,31,26,25,11,14,-3,-2,-1,65%,58%,73%,112,107,119,29%,30%,28%,3,1,2,6,3,3
414,https://vlr.gg/player/29958/ximy,2024-06-23 12:00:00,0.59,0.99,0.77,141,106,197,41,15,26,63,35,28,37,20,17,-6,-3,-3,61%,53%,70%,99,73,129,29%,32%,28%,5,3,2,11,6,5
415,https://vlr.gg/player/22314/mober,2024-06-23 12:00:00,0.77,0.73,0.74,153,174,145,47,27,20,60,35,25,9,2,7,-6,-2,-4,58%,58%,57%,103,110,95,37%,44%,31%,6,3,3,12,5,7
416,https://vlr.gg/player/3784/katu,2024-06-23 12:00:00,1.43,1.42,1.43,260,240,254,73,32,41,42,21,21,24,12,12,+2,0,+2,75%,73%,77%,175,170,179,41%,41%,41%,5,1,4,3,1,2
417,https://vlr.gg/player/6909/jannyxd,2024-06-23 12:00:00,1.00,1.58,1.30,256,228,268,73,29,44,50,28,22,18,8,10,+7,0,+7,73%,62%,81%,156,142,169,29%,22%,36%,16,6,10,9,6,3
418,https://vlr.gg/player/4519/kamisseq,2024-06-23 12:00:00,0.95,1.23,1.10,199,154,231,58,23,35,49,25,24,26,9,17,0,+2,-2,76%,65%,86%,123,94,147,50%,58%,46%,9,3,6,9,1,8
419,https://vlr.gg/player/173/l0udly,2024-06-23 12:00:00,0.90,1.09,1.00,191,186,181,54,23,31,47,26,21,10,6,4,+3,+2,+1,68%,65%,70%,122,124,120,34%,42%,29%,8,6,2,5,4,1
420,https://vlr.gg/player/8629/saiko,2024-06-23 12:00:00,0.65,0.85,0.76,148,140,162,39,18,21,57,28,29,26,9,17,+2,-1,+3,71%,68%,74%,103,89,115,19%,17%,21%,9,4,5,7,5,2
421,https://vlr.gg/player/6925/chadi,2024-06-23 11:00:00,0.44,1.76,0.98,190,146,290,27,10,17,29,21,8,3,0,3,0,-4,+4,62%,48%,81%,134,94,193,20%,29%,13%,7,3,4,7,7,0
422,https://vlr.gg/player/12673/bard0lf,2024-06-23 11:00:00,1.20,0.48,0.89,209,260,123,25,19,6,32,18,14,16,6,10,-2,0,-2,62%,61%,63%,143,179,91,39%,43%,29%,3,2,1,5,2,3
423,https://vlr.gg/player/3649/litshii,2024-06-23 11:00:00,0.70,1.12,0.88,157,130,218,23,10,13,31,19,12,18,13,5,0,-2,+2,72%,70%,75%,110,84,148,19%,21%,18%,2,0,2,2,2,0
424,https://vlr.gg/player/7185/nero,2024-06-23 11:00:00,0.61,0.91,0.73,162,140,205,22,11,11,32,20,12,11,5,6,-3,-2,-1,74%,65%,88%,107,81,144,13%,11%,16%,0,0,0,3,2,1
425,https://vlr.gg/player/26404/zneva,2024-06-23 11:00:00,0.52,0.75,0.61,169,149,183,21,11,10,31,19,12,7,4,3,+4,+1,+3,59%,52%,69%,103,93,118,28%,30%,27%,7,3,4,3,2,1
426,https://vlr.gg/player/21216/f4ngeer,2024-06-23 11:00:00,1.70,1.56,1.62,308,358,300,47,21,26,25,12,13,5,1,4,+2,-1,+3,74%,75%,74%,201,236,177,24%,29%,15%,10,4,6,8,5,3
427,https://vlr.gg/player/4537/tajrex,2024-06-23 11:00:00,1.08,1.69,1.44,303,207,364,42,14,28,25,11,14,8,2,6,+1,0,+1,87%,81%,91%,180,110,229,25%,26%,24%,3,1,2,2,1,1
428,https://vlr.gg/player/21609/danda,2024-06-23 11:00:00,0.66,1.21,0.98,158,123,177,20,5,15,22,12,10,15,9,6,0,-3,+3,69%,56%,78%,109,98,117,26%,30%,24%,3,0,3,3,3,0
429,https://vlr.gg/player/29575/luckymrj,2024-06-23 11:00:00,0.57,1.24,0.97,166,110,183,22,5,17,20,11,9,13,4,9,-2,-2,0,74%,63%,83%,109,87,124,29%,21%,34%,2,0,2,4,2,2
430,https://vlr.gg/player/29742/anxios,2024-06-23 11:00:00,1.23,0.71,0.92,176,233,128,24,13,11,26,11,15,14,8,6,0,0,0,69%,81%,61%,111,147,87,22%,26%,18%,2,0,2,2,0,2
431,https://vlr.gg/player/10338/lime,2024-06-23 11:00:00,1.38,1.71,1.56,297,291,302,61,27,34,35,17,18,15,9,6,+8,+5,+3,77%,72%,81%,185,176,192,38%,36%,39%,13,7,6,5,2,3
432,https://vlr.gg/player/5292/al0rante,2024-06-23 11:00:00,1.40,1.48,1.45,274,238,303,56,24,32,36,13,23,19,10,9,+5,0,+5,82%,88%,77%,183,168,196,41%,42%,41%,6,1,5,1,1,0
433,https://vlr.gg/player/4244/yaboilewis,2024-06-23 11:00:00,0.94,1.00,0.97,201,204,199,38,16,22,42,20,22,26,14,12,0,+2,-2,66%,72%,61%,135,137,133,41%,47%,37%,6,3,3,6,1,5
434,https://vlr.gg/player/8834/bucher,2024-06-23 11:00:00,1.04,0.84,0.93,167,167,167,33,16,17,35,13,22,22,14,8,0,+1,-1,84%,92%,77%,117,109,123,39%,54%,31%,3,2,1,3,1,2
435,https://vlr.gg/player/217/seider,2024-06-23 11:00:00,0.67,0.59,0.63,129,147,115,24,13,11,41,18,23,19,9,10,-1,+1,-2,59%,68%,52%,79,86,73,26%,28%,24%,6,4,2,7,3,4
436,https://vlr.gg/player/10885/davih,2024-06-23 11:00:00,1.17,0.83,1.02,200,214,185,37,24,13,38,20,18,21,11,10,-4,-2,-2,68%,74%,60%,138,142,134,27%,34%,20%,3,1,2,7,3,4
437,https://vlr.gg/player/7490/anguist,2024-06-23 11:00:00,0.89,1.12,0.99,194,200,190,41,23,18,40,23,17,13,6,7,-3,-2,-1,70%,71%,68%,128,134,121,28%,24%,33%,4,3,1,7,5,2
438,https://vlr.gg/player/1835/elllement,2024-06-23 11:00:00,1.05,0.87,0.97,217,250,177,44,28,16,44,24,20,8,4,4,+3,+4,-1,75%,84%,64%,156,189,115,28%,30%,25%,10,7,3,7,3,4
439,https://vlr.gg/player/2472/benny,2024-06-23 11:00:00,0.71,1.17,0.92,188,162,220,39,19,20,44,25,19,10,5,5,-4,-3,-1,66%,68%,64%,118,105,134,28%,38%,21%,5,3,2,9,6,3
440,https://vlr.gg/player/4329/vince,2024-06-23 11:00:00,0.73,0.65,0.70,147,140,158,28,14,14,46,24,22,24,19,5,-4,0,-4,71%,84%,56%,103,92,117,26%,19%,34%,0,0,0,4,0,4
441,https://vlr.gg/player/22952/caim,2024-06-23 11:00:00,0.47,1.37,1.10,245,183,271,13,3,10,12,5,7,5,1,4,+1,-1,+2,71%,80%,67%,155,116,171,8%,7%,8%,4,0,4,3,1,2
442,https://vlr.gg/player/23179/hiiro,2024-06-23 11:00:00,1.05,0.71,0.81,176,240,150,10,3,7,13,5,8,3,2,1,-1,0,-1,59%,80%,50%,115,155,99,19%,30%,13%,0,0,0,1,0,1
443,https://vlr.gg/player/18217/kylou,2024-06-23 11:00:00,0.16,1.07,0.80,179,75,223,10,1,9,15,5,10,6,1,5,-4,-2,-2,65%,40%,75%,130,55,162,27%,0%,36%,0,0,0,4,2,2
444,https://vlr.gg/player/6117/kayn,2024-06-23 11:00:00,0.04,0.83,0.60,140,50,179,9,1,8,13,5,8,3,0,3,+1,-1,+2,71%,60%,75%,93,23,122,32%,0%,38%,2,0,2,1,1,0
445,https://vlr.gg/player/42155/h4te,2024-06-23 11:00:00,0.06,0.62,0.45,140,72,170,8,1,7,14,5,9,3,0,3,-2,-1,-1,59%,20%,75%,91,58,105,24%,33%,23%,0,0,0,2,1,1
446,https://vlr.gg/player/16012/akira,2024-06-23 11:00:00,1.70,2.28,1.87,337,340,334,19,14,5,8,7,1,8,3,5,+1,0,+1,82%,75%,100%,209,205,221,21%,14%,38%,1,0,1,0,0,0
447,https://vlr.gg/player/8590/killdream,2024-06-23 11:00:00,1.47,1.31,1.42,237,257,190,15,11,4,9,7,2,7,3,4,+1,0,+1,82%,75%,100%,143,160,100,20%,28%,6%,2,1,1,1,1,0
448,https://vlr.gg/player/1377/phatt,2024-06-23 11:00:00,0.73,1.55,0.97,149,107,252,11,5,6,11,8,3,11,5,6,-1,-1,0,82%,75%,100%,96,66,169,35%,38%,33%,0,0,0,1,1,0
449,https://vlr.gg/player/7883/silenttt,2024-06-23 11:00:00,0.69,1.47,0.92,140,141,138,10,6,4,9,8,1,2,1,1,0,0,0,71%,58%,100%,79,87,59,12%,11%,13%,1,1,0,1,1,0
450,https://vlr.gg/player/26808/fainz,2024-06-23 11:00:00,0.42,1.97,0.87,221,170,343,12,6,6,13,11,2,6,3,3,+4,+1,+3,65%,50%,100%,160,126,242,29%,33%,21%,7,4,3,3,3,0
451,https://vlr.gg/player/10137/ip0tt,2024-06-23 10:30:00,1.45,1.30,1.38,277,290,243,67,39,28,41,21,20,19,4,15,+1,-1,+2,74%,72%,76%,181,204,156,43%,38%,50%,9,4,5,8,5,3
452,https://vlr.gg/player/4962/lurzy0y0,2024-06-23 10:30:00,1.38,0.85,1.12,206,254,159,51,34,17,43,20,23,25,12,13,+2,+3,-1,78%,81%,76%,130,159,99,38%,47%,29%,7,5,2,5,2,3
453,https://vlr.gg/player/5517/masic,2024-06-23 10:30:00,1.19,0.89,1.05,210,249,170,51,31,20,45,24,21,15,9,6,+4,+5,-1,71%,72%,70%,140,160,118,28%,31%,25%,9,6,3,5,1,4
454,https://vlr.gg/player/6559/destruct1vee,2024-06-23 10:30:00,0.80,1.26,1.02,217,182,256,52,24,28,47,26,21,15,5,10,+3,0,+3,70%,61%,79%,143,118,170,27%,30%,24%,9,5,4,6,5,1
455,https://vlr.gg/player/7353/glovee,2024-06-23 10:30:00,0.84,1.08,0.95,165,129,207,39,14,25,43,22,21,21,14,7,+1,-1,+2,77%,83%,70%,116,92,142,25%,28%,24%,6,1,5,5,2,3
456,https://vlr.gg/player/11531/patrui,2024-06-23 10:30:00,1.48,0.81,1.13,190,237,155,46,28,18,46,20,26,31,17,14,+3,+2,+1,62%,61%,64%,122,143,102,23%,25%,21%,5,3,2,2,1,1
457,https://vlr.gg/player/18615/batujnax,2024-06-23 10:30:00,0.86,0.97,0.92,215,217,212,46,21,25,54,26,28,20,13,7,-4,-2,-2,68%,64%,72%,144,142,146,16%,14%,18%,9,5,4,13,7,6
458,https://vlr.gg/player/4893/lauress,2024-06-23 10:30:00,0.83,0.92,0.87,193,186,200,46,22,24,55,26,29,14,5,9,-1,+1,-2,71%,79%,64%,133,129,136,20%,21%,20%,4,3,1,5,2,3
459,https://vlr.gg/player/2107/russ,2024-06-23 10:30:00,0.74,0.95,0.85,180,157,210,46,19,27,54,24,30,15,7,8,-6,-4,-2,67%,70%,64%,121,102,137,39%,27%,51%,6,3,3,12,7,5
460,https://vlr.gg/player/5566/jeyj7y,2024-06-23 10:30:00,0.69,0.69,0.69,132,113,155,34,15,19,51,23,28,13,6,7,-3,-2,-1,64%,64%,64%,89,76,101,25%,24%,25%,5,0,5,8,2,6
461,https://vlr.gg/player/15577/brk,2024-06-23 10:00:00,1.63,1.95,1.70,323,325,318,17,13,4,7,6,1,3,3,0,+7,+5,+2,87%,83%,100%,218,213,235,25%,26%,20%,8,6,2,1,1,0
462,https://vlr.gg/player/29340/cunha20,2024-06-23 10:00:00,1.65,1.74,1.66,252,257,231,15,13,2,6,5,1,16,9,7,+2,+1,+1,93%,92%,100%,153,152,157,54%,52%,57%,2,1,1,0,0,0
463,https://vlr.gg/player/13435/fragger,2024-06-23 10:00:00,1.53,2.01,1.63,272,269,290,15,12,3,8,7,1,16,11,5,+1,+1,0,100%,100%,100%,175,177,164,33%,30%,43%,1,1,0,0,0,0
464,https://vlr.gg/player/15376/grtw,2024-06-23 10:00:00,1.28,1.52,1.33,210,191,288,12,9,3,7,6,1,6,5,1,+2,+2,0,93%,92%,100%,166,156,206,20%,29%,9%,2,2,0,0,0,0
465,https://vlr.gg/player/1378/addicted,2024-06-23 10:00:00,1.09,1.40,1.15,179,177,187,11,8,3,7,6,1,6,6,0,-1,-1,0,80%,75%,100%,117,107,158,29%,33%,22%,0,0,0,1,1,0
466,https://vlr.gg/player/15091/zepiczz,2024-06-23 10:00:00,0.94,1.20,1.15,265,226,275,11,2,9,14,3,11,6,1,5,+1,-1,+2,60%,67%,58%,188,143,200,17%,29%,15%,2,0,2,1,1,0
467,https://vlr.gg/player/8110/kayban,2024-06-23 10:00:00,0.32,0.78,0.69,139,75,155,7,1,6,14,3,11,5,0,5,-1,0,-1,47%,33%,50%,78,56,83,20%,0%,27%,0,0,0,1,0,1
468,https://vlr.gg/player/12430/skypzz,2024-06-23 10:00:00,0.04,0.52,0.42,112,63,124,5,0,5,13,3,10,2,1,1,-5,-1,-4,40%,33%,42%,82,63,87,23%,50%,19%,0,0,0,5,1,4
469,https://vlr.gg/player/42077/noheart,2024-06-23 10:00:00,0.35,0.40,0.39,127,73,142,7,1,6,14,3,11,2,0,2,-5,-1,-4,53%,33%,58%,80,30,93,36%,0%,45%,0,0,0,5,1,4
470,https://vlr.gg/player/39153/dake,2024-06-23 10:00:00,0.56,0.35,0.39,120,149,113,5,1,4,15,3,12,2,1,1,-1,0,-1,47%,67%,42%,86,99,83,23%,14%,26%,0,0,0,1,0,1
471,https://vlr.gg/player/1209/swerl,2024-06-23 08:05:00,,,,224,,,53,,,56,,,13,,,-3,,,,,,138,,,18%,,,9,,,12,,
472,https://vlr.gg/player/41054/guang,2024-06-23 08:05:00,,,,196,,,52,,,54,,,16,,,+5,,,,,,135,,,37%,,,11,,,6,,
473,https://vlr.gg/player/39697/cb,2024-06-23 08:05:00,,,,174,,,44,,,53,,,18,,,+1,,,,,,119,,,17%,,,8,,,7,,
474,https://vlr.gg/player/4402/o0o0o,2024-06-23 08:05:00,,,,160,,,39,,,50,,,35,,,-3,,,,,,109,,,26%,,,3,,,6,,
475,https://vlr.gg/player/46460/ezeir,2024-06-23 08:05:00,,,,148,,,38,,,48,,,30,,,-7,,,,,,98,,,31%,,,1,,,8,,
476,https://vlr.gg/player/4885/whzy,2024-06-23 08:05:00,,,,275,,,66,,,48,,,20,,,+7,,,,,,168,,,24%,,,17,,,10,,
477,https://vlr.gg/player/4774/knight,2024-06-23 08:05:00,,,,243,,,57,,,45,,,23,,,+5,,,,,,151,,,23%,,,12,,,7,,
478,https://vlr.gg/player/6022/yosemite,2024-06-23 08:05:00,,,,208,,,54,,,44,,,28,,,-3,,,,,,151,,,33%,,,3,,,6,,
479,https://vlr.gg/player/10698/nephh,2024-06-23 08:05:00,,,,208,,,47,,,48,,,41,,,-1,,,,,,134,,,23%,,,4,,,5,,
480,https://vlr.gg/player/4705/flex1n,2024-06-23 08:05:00,,,,146,,,36,,,42,,,51,,,-1,,,,,,96,,,25%,,,3,,,4,,
481,https://vlr.gg/player/1616/starki,2024-06-23 08:00:00,0.99,1.61,1.30,270,202,331,61,24,37,44,23,21,13,10,3,+2,-3,+5,76%,71%,81%,168,126,209,29%,31%,27%,8,1,7,6,4,2
482,https://vlr.gg/player/3674/iluri,2024-06-23 08:00:00,1.15,0.88,1.01,168,157,180,36,18,18,42,18,24,27,15,12,-1,0,-1,66%,71%,61%,112,103,120,33%,35%,31%,3,2,1,4,2,2
483,https://vlr.gg/player/2658/xuss,2024-06-23 08:00:00,1.12,0.69,0.90,201,251,155,42,27,15,48,23,25,12,5,7,+8,+4,+4,66%,77%,55%,131,161,101,27%,31%,20%,14,7,7,6,3,3
484,https://vlr.gg/player/7660/fizzy,2024-06-23 08:00:00,1.24,0.47,0.86,158,225,89,34,25,9,40,17,23,6,3,3,-1,0,-1,61%,58%,65%,105,137,72,32%,32%,31%,6,4,2,7,4,3
485,https://vlr.gg/player/3753/obnoks,2024-06-23 08:00:00,0.90,0.81,0.86,168,158,173,36,17,19,40,20,20,16,9,7,-6,-4,-2,73%,81%,65%,117,114,120,33%,42%,26%,1,0,1,7,4,3
486,https://vlr.gg/player/122/luckerrr,2024-06-23 08:00:00,1.22,1.10,1.16,227,252,205,51,28,23,40,21,19,17,9,8,+1,+1,0,68%,68%,68%,140,146,134,26%,18%,35%,9,6,3,8,5,3
487,https://vlr.gg/player/7865/xanarchy,2024-06-23 08:00:00,1.19,0.90,1.04,190,203,179,43,22,21,39,19,20,17,12,5,+2,0,+2,73%,77%,68%,133,148,119,35%,32%,38%,4,1,3,2,1,1
488,https://vlr.gg/player/30750/enes,2024-06-23 08:00:00,1.11,0.87,0.99,203,212,194,45,25,20,46,20,26,24,10,14,0,-3,+3,73%,74%,71%,128,136,120,23%,23%,25%,5,0,5,5,3,2
489,https://vlr.gg/player/4969/shazeon,2024-06-23 08:00:00,1.26,0.69,0.97,174,207,141,35,23,12,39,17,22,21,10,11,-3,0,-3,73%,77%,68%,120,144,97,32%,34%,29%,4,3,1,7,3,4
490,https://vlr.gg/player/9508/leosen,2024-06-23 08:00:00,0.67,0.96,0.81,170,136,211,40,16,24,46,21,25,3,2,1,-2,-3,+1,53%,58%,48%,116,88,145,25%,26%,25%,8,3,5,10,6,4
491,https://vlr.gg/player/6672/meiy,2024-06-23 06:05:00,1.13,1.63,1.39,315,274,357,70,26,44,49,23,26,8,6,2,+16,+5,+11,78%,77%,79%,204,178,227,29%,19%,41%,22,9,13,6,4,2
492,https://vlr.gg/player/993/medusa,2024-06-23 06:05:00,1.44,0.75,1.08,208,242,181,50,31,19,40,17,23,8,1,7,-2,-2,0,69%,65%,74%,138,155,122,30%,50%,19%,6,4,2,8,6,2
493,https://vlr.gg/player/21438/ssees,2024-06-23 06:05:00,0.87,1.26,1.07,199,171,224,48,19,29,44,22,22,25,14,11,+2,0,+2,75%,74%,76%,125,108,141,43%,39%,46%,5,1,4,3,1,2
494,https://vlr.gg/player/1970/neth,2024-06-23 06:05:00,1.10,1.05,1.07,186,175,199,42,20,22,42,17,25,33,13,20,-1,-1,0,83%,90%,76%,123,116,130,26%,29%,23%,2,0,2,3,1,2
495,https://vlr.gg/player/6700/anthem,2024-06-23 06:05:00,0.61,0.56,0.58,123,121,127,25,11,14,49,22,27,16,8,8,-6,-3,-3,68%,71%,65%,90,89,91,21%,19%,22%,2,1,1,8,4,4
496,https://vlr.gg/player/10588/hiroronn,2024-06-23 06:05:00,1.37,0.95,1.17,217,238,189,48,28,20,43,21,22,20,11,9,-4,-4,0,75%,79%,71%,147,166,126,30%,31%,28%,2,0,2,6,4,2
497,https://vlr.gg/player/6668/sugarz3ro,2024-06-23 06:05:00,1.18,1.01,1.10,215,252,175,50,31,19,46,25,21,24,12,12,-5,-3,-2,78%,79%,77%,147,168,124,33%,33%,33%,2,1,1,7,4,3
498,https://vlr.gg/player/29840/yuran,2024-06-23 06:05:00,0.71,1.09,0.89,164,123,209,37,14,23,48,26,22,39,24,15,+1,-1,+2,75%,71%,81%,103,79,129,37%,25%,46%,4,1,3,3,2,1
499,https://vlr.gg/player/999/laz,2024-06-23 06:05:00,0.78,1.01,0.89,182,177,188,42,22,20,45,27,18,10,4,6,-2,-1,-1,63%,62%,65%,123,121,125,35%,35%,35%,7,3,4,9,4,5
500,https://vlr.gg/player/424/dep,2024-06-23 06:05:00,0.86,0.70,0.78,215,240,191,46,28,18,53,29,24,17,9,8,+1,-1,+2,72%,79%,65%,145,162,125,30%,37%,20%,13,7,6,12,8,4
0,https://vlr.gg/player/7135/hfmi0dzjc9z7,2024-06-23 05:00:00,,,,225,,,48,,,41,,,14,,,-2,,,,,,163,,,35%,,,4,,,6,,
1,https://vlr.gg/player/14444/eren,2024-06-23 05:00:00,,,,218,,,48,,,45,,,12,,,0,,,,,,132,,,31%,,,7,,,7,,
2,https://vlr.gg/player/3547/ninebody,2024-06-23 05:00:00,,,,205,,,42,,,48,,,13,,,-1,,,,,,139,,,23%,,,9,,,10,,
3,https://vlr.gg/player/3020/coldfish,2024-06-23 05:00:00,,,,192,,,43,,,39,,,18,,,-1,,,,,,127,,,20%,,,3,,,4,,
4,https://vlr.gg/player/39485/scales,2024-06-23 05:00:00,,,,160,,,33,,,46,,,40,,,+1,,,,,,99,,,35%,,,6,,,5,,
5,https://vlr.gg/player/4770/fengf,2024-06-23 05:00:00,,,,236,,,48,,,40,,,16,,,+2,,,,,,161,,,28%,,,8,,,6,,
6,https://vlr.gg/player/3045/luok1ng,2024-06-23 05:00:00,,,,217,,,47,,,42,,,36,,,+1,,,,,,140,,,31%,,,5,,,4,,
7,https://vlr.gg/player/3021/biank,2024-06-23 05:00:00,,,,206,,,43,,,43,,,20,,,+2,,,,,,144,,,20%,,,6,,,4,,
8,https://vlr.gg/player/37494/kai,2024-06-23 05:00:00,,,,205,,,43,,,45,,,16,,,+4,,,,,,132,,,24%,,,11,,,7,,
9,https://vlr.gg/player/4712/heybay,2024-06-23 05:00:00,,,,173,,,38,,,44,,,25,,,-6,,,,,,112,,,26%,,,2,,,8,,
10,https://vlr.gg/player/9802/benkai,2024-06-23 04:00:00,1.51,1.60,1.55,232,218,246,31,16,15,16,7,9,21,11,10,-1,0,-1,89%,95%,84%,154,139,169,29%,29%,30%,0,0,0,1,0,1
11,https://vlr.gg/player/1839/polvi,2024-06-23 04:00:00,1.45,0.81,1.13,270,345,196,37,22,15,31,15,16,13,9,4,0,+2,-2,74%,84%,63%,172,222,121,26%,30%,18%,8,6,2,8,4,4
12,https://vlr.gg/player/1743/blazek1ng,2024-06-23 04:00:00,1.14,1.03,1.08,182,169,196,25,12,13,24,10,14,10,4,6,+6,+3,+3,79%,84%,74%,118,112,124,25%,28%,23%,7,3,4,1,0,1
13,https://vlr.gg/player/1162/russ,2024-06-23 04:00:00,1.02,1.14,1.08,211,212,211,26,15,11,25,12,13,22,7,15,0,-2,+2,84%,84%,84%,147,140,153,30%,34%,27%,5,2,3,5,4,1
14,https://vlr.gg/player/3626/lightningfast,2024-06-23 04:00:00,0.90,1.12,1.01,148,152,146,23,12,11,22,12,10,16,7,9,+1,0,+1,92%,100%,84%,82,79,86,36%,21%,60%,2,0,2,1,0,1
15,https://vlr.gg/player/4382/sscary,2024-06-23 04:00:00,1.62,0.93,1.28,237,304,170,35,23,12,24,11,13,10,1,9,+4,+3,+1,89%,84%,95%,137,170,105,26%,24%,29%,4,3,1,0,0,0
16,https://vlr.gg/player/2361/retla,2024-06-23 04:00:00,1.12,0.57,0.85,199,264,136,27,18,9,30,15,15,8,4,4,0,+1,-1,58%,68%,47%,124,154,94,30%,25%,38%,3,2,1,3,1,2
17,https://vlr.gg/player/1430/crazyguy,2024-06-23 04:00:00,0.72,0.69,0.70,140,145,136,16,9,7,29,12,17,15,7,8,0,0,0,68%,68%,68%,106,113,98,21%,26%,15%,3,0,3,3,0,3
18,https://vlr.gg/player/772/zest,2024-06-23 04:00:00,0.42,0.97,0.69,149,59,240,20,4,16,27,12,15,8,4,4,-4,-3,-1,55%,42%,68%,97,44,149,44%,33%,47%,2,1,1,6,4,2
19,https://vlr.gg/player/9152/deryeon,2024-06-23 04:00:00,0.49,0.79,0.64,157,135,179,20,8,12,32,15,17,8,3,5,-6,-4,-2,63%,53%,74%,112,102,122,19%,32%,11%,4,2,2,10,6,4
20,https://vlr.gg/player/4004/zekken,2024-06-22 19:15:00,1.61,1.17,1.41,317,391,228,46,32,14,33,19,14,21,9,12,+4,+6,-2,77%,88%,64%,213,253,167,29%,30%,28%,12,9,3,8,3,5
21,https://vlr.gg/player/729/zellsis,2024-06-22 19:15:00,1.39,1.15,1.28,212,238,185,37,22,15,24,12,12,22,11,11,+1,+2,-1,83%,80%,86%,135,158,109,22%,20%,24%,2,2,0,1,0,1
22,https://vlr.gg/player/9/tenz,2024-06-22 19:15:00,1.35,1.08,1.22,209,205,219,36,20,16,29,12,17,24,12,12,+2,+1,+1,77%,80%,73%,134,139,129,20%,27%,13%,5,2,3,3,1,2
23,https://vlr.gg/player/659/sacy,2024-06-22 19:15:00,1.34,1.09,1.22,218,219,212,38,22,16,26,10,16,17,6,11,-2,-1,-1,81%,88%,73%,145,150,139,36%,41%,30%,3,1,2,5,2,3
24,https://vlr.gg/player/1265/johnqt,2024-06-22 19:15:00,0.67,1.11,0.87,150,106,205,25,9,16,28,14,14,9,6,3,-1,-3,+2,70%,64%,77%,102,75,133,33%,30%,35%,3,1,2,4,4,0
25,https://vlr.gg/player/11225/ethan,2024-06-22 19:15:00,0.78,1.15,0.98,195,198,193,32,15,17,34,16,18,23,12,11,+2,+3,-1,74%,73%,76%,118,113,123,24%,20%,30%,5,5,0,3,2,1
26,https://vlr.gg/player/4164/s0m,2024-06-22 19:15:00,1.22,0.69,0.94,195,214,176,30,16,14,35,14,21,21,17,4,-2,-1,-1,74%,86%,64%,131,140,124,23%,14%,37%,4,0,4,6,1,5
27,https://vlr.gg/player/261/victor,2024-06-22 19:15:00,1.20,0.52,0.84,219,279,178,34,20,14,41,16,25,10,7,3,-4,-2,-2,62%,68%,56%,150,187,118,24%,19%,34%,9,4,5,13,6,7
28,https://vlr.gg/player/4/crashies,2024-06-22 19:15:00,0.77,0.64,0.70,138,153,125,23,12,11,35,15,20,14,10,4,-2,0,-2,57%,68%,48%,92,95,89,26%,33%,19%,1,1,0,3,1,2
29,https://vlr.gg/player/817/finesse,2024-06-22 19:15:00,0.59,0.67,0.64,133,124,143,21,11,10,38,16,22,8,2,6,+2,+2,0,53%,55%,52%,90,76,103,16%,23%,13%,3,2,1,1,0,1
30,https://vlr.gg/player/8872/mazin,2024-06-22 17:00:00,1.23,1.11,1.18,244,280,197,35,22,13,29,18,11,15,10,5,+4,-1,+5,71%,71%,72%,156,181,122,31%,36%,25%,6,1,5,2,2,0
31,https://vlr.gg/player/5957/artzin,2024-06-22 17:00:00,1.05,1.07,1.06,229,265,181,34,22,12,30,20,10,13,5,8,+4,+5,-1,69%,71%,67%,144,162,120,34%,33%,35%,7,7,0,3,2,1
32,https://vlr.gg/player/46/shahzam,2024-06-22 17:00:00,1.01,0.77,0.91,173,186,157,23,15,8,29,17,12,14,9,5,-1,0,-1,74%,71%,78%,124,129,118,24%,21%,28%,3,1,2,4,1,3
33,https://vlr.gg/player/2567/liazzi,2024-06-22 17:00:00,0.48,0.87,0.65,140,121,170,21,11,10,30,20,10,6,2,4,-2,-2,0,67%,54%,83%,104,95,116,31%,29%,33%,1,0,1,3,2,1
34,https://vlr.gg/player/23407/pa1nt,2024-06-22 17:00:00,0.34,0.77,0.53,141,108,187,19,6,13,35,21,14,12,9,3,-5,-6,+1,64%,63%,67%,101,78,133,24%,17%,32%,4,1,3,9,7,2
35,https://vlr.gg/player/8549/kingg,2024-06-22 17:00:00,0.96,1.51,1.27,232,174,269,34,10,24,24,12,12,16,9,7,+3,0,+3,69%,67%,71%,158,129,180,26%,32%,23%,6,1,5,3,1,2
36,https://vlr.gg/player/8480/aspas,2024-06-22 17:00:00,0.80,1.44,1.17,206,169,231,32,10,22,24,13,11,8,2,6,+2,0,+2,74%,72%,75%,144,112,169,31%,18%,41%,7,3,4,5,3,2
37,https://vlr.gg/player/7603/mazino,2024-06-22 17:00:00,1.14,1.16,1.15,221,206,239,31,13,18,29,10,19,21,5,16,-4,-3,-1,76%,72%,79%,150,127,168,27%,28%,26%,2,1,1,6,4,2
38,https://vlr.gg/player/1818/tex,2024-06-22 17:00:00,0.89,1.20,1.07,198,168,228,29,10,19,28,12,16,5,1,4,-2,-1,-1,64%,67%,63%,143,116,164,30%,23%,35%,4,2,2,6,3,3
39,https://vlr.gg/player/619/c0m,2024-06-22 17:00:00,1.46,0.76,1.06,185,218,157,27,14,13,27,9,18,12,4,8,+1,0,+1,71%,78%,67%,130,156,110,23%,24%,22%,2,0,2,1,0,1
40,https://vlr.gg/player/29559/javelin,2024-06-22 15:10:00,1.02,1.77,1.45,321,269,361,23,8,15,17,8,9,5,1,4,+5,+1,+4,67%,56%,75%,202,181,217,17%,25%,12%,9,3,6,4,2,2
41,https://vlr.gg/player/45142/browse,2024-06-22 15:10:00,1.39,0.81,1.06,240,319,182,16,9,7,15,7,8,5,2,3,0,+1,-1,71%,78%,67%,170,227,127,40%,37%,44%,2,2,0,2,1,1
42,https://vlr.gg/player/22188/jimbk,2024-06-22 15:10:00,0.46,1.21,0.89,211,155,254,14,4,10,18,9,9,7,1,6,0,0,0,62%,67%,58%,144,107,171,17%,33%,13%,0,0,0,0,0,0
43,https://vlr.gg/player/45143/francybald,2024-06-22 15:10:00,0.25,1.05,0.71,137,76,184,10,1,9,17,9,8,12,7,5,-2,-1,-1,71%,56%,83%,91,48,123,18%,8%,23%,0,0,0,2,1,1
44,https://vlr.gg/player/9574/ayyzicle,2024-06-22 15:10:00,0.45,0.31,0.37,77,87,71,6,3,3,17,7,10,4,1,3,-2,0,-2,57%,56%,58%,61,57,65,13%,9%,15%,0,0,0,2,0,2
45,https://vlr.gg/player/5854/z3ro,2024-06-22 15:10:00,2.34,2.61,2.45,419,405,439,34,18,16,10,7,3,9,5,4,+4,+3,+1,90%,92%,89%,272,260,288,37%,30%,47%,5,3,2,1,0,1
46,https://vlr.gg/player/16447/d3mur,2024-06-22 15:10:00,0.83,1.02,0.91,235,215,262,19,11,8,17,9,8,4,1,3,-3,-3,0,67%,58%,78%,156,131,190,34%,29%,41%,2,0,2,5,3,2
47,https://vlr.gg/player/7706/morphiw0w,2024-06-22 15:10:00,0.64,1.16,0.86,157,139,182,10,5,5,13,9,4,8,3,5,+1,+2,-1,71%,58%,89%,106,92,124,20%,20%,20%,3,3,0,2,1,1
48,https://vlr.gg/player/33358/shinnok,2024-06-22 15:10:00,0.64,0.93,0.76,149,162,133,12,7,5,15,10,5,3,2,1,-2,-1,-1,67%,75%,56%,97,107,84,31%,33%,29%,0,0,0,2,1,1
49,https://vlr.gg/player/33501/sword,2024-06-22 15:10:00,0.58,0.97,0.75,132,99,178,9,3,6,14,9,5,7,6,1,-1,-1,0,71%,83%,56%,96,74,126,28%,13%,56%,0,0,0,1,1,0
50,https://vlr.gg/player/3807/winteryrook,2024-06-22 15:00:00,1.63,0.64,1.12,242,334,156,54,37,17,46,19,27,17,8,9,-4,0,-4,66%,80%,53%,154,208,103,51%,51%,50%,5,3,2,9,3,6
51,https://vlr.gg/player/5795/sickrey,2024-06-22 15:00:00,1.28,0.88,1.07,202,217,188,46,24,22,42,17,25,16,10,6,+4,+3,+1,71%,83%,59%,132,146,119,25%,25%,25%,7,3,4,3,0,3
52,https://vlr.gg/player/2432/moner,2024-06-22 15:00:00,1.11,0.85,0.98,192,177,207,41,19,22,42,14,28,8,5,3,+2,+2,0,69%,80%,59%,142,138,146,28%,25%,30%,4,2,2,2,0,2
53,https://vlr.gg/player/1470/simond4rk,2024-06-22 15:00:00,1.07,0.82,0.94,235,257,216,50,31,19,50,22,28,13,6,7,-6,-4,-2,66%,77%,56%,162,162,163,16%,19%,13%,7,4,3,13,8,5
54,https://vlr.gg/player/1897/bgg,2024-06-22 15:00:00,0.85,0.56,0.70,126,146,109,26,15,11,46,20,26,16,10,6,0,+1,-1,63%,83%,44%,84,90,78,29%,33%,25%,6,4,2,6,3,3
55,https://vlr.gg/player/8237/depyro,2024-06-22 15:00:00,1.12,1.49,1.30,248,198,300,54,22,32,43,20,23,23,18,5,+4,0,+4,81%,88%,73%,163,140,188,29%,26%,31%,6,2,4,2,2,0
56,https://vlr.gg/player/5639/shalaby,2024-06-22 15:00:00,1.51,0.57,1.05,211,271,147,47,34,13,43,15,28,13,7,6,-5,-2,-3,68%,88%,47%,141,188,92,27%,34%,18%,4,2,2,9,4,5
57,https://vlr.gg/player/20688/yassien,2024-06-22 15:00:00,1.29,0.68,1.00,183,227,138,41,26,15,40,18,22,18,10,8,+1,+2,-1,73%,81%,63%,127,160,92,27%,32%,19%,8,4,4,7,2,5
58,https://vlr.gg/player/5642/chrollo,2024-06-22 15:00:00,1.09,0.81,0.96,170,182,156,35,19,16,41,18,23,25,16,9,+2,+3,-1,68%,72%,63%,108,118,98,23%,25%,21%,4,4,0,2,1,1
59,https://vlr.gg/player/14366/shniider,2024-06-22 15:00:00,1.33,0.39,0.88,217,265,164,49,35,14,52,20,32,15,10,5,+2,+3,-1,71%,84%,57%,141,171,110,29%,28%,31%,11,7,4,9,4,5
60,https://vlr.gg/player/22433/quantumrino,2024-06-22 14:00:00,1.21,0.96,1.09,227,242,213,31,18,13,34,15,19,7,3,4,+1,+2,-1,70%,80%,60%,141,142,140,22%,18%,27%,7,5,2,6,3,3
61,https://vlr.gg/player/10359/daveeski,2024-06-22 14:00:00,1.03,0.93,0.98,245,249,242,34,19,15,34,16,18,5,2,3,-2,+2,-4,68%,70%,65%,161,159,164,31%,33%,29%,5,3,2,7,1,6
62,https://vlr.gg/player/27954/movi,2024-06-22 14:00:00,0.81,0.99,0.90,188,162,214,28,13,15,32,15,17,11,5,6,0,-2,+2,78%,75%,80%,126,113,138,29%,39%,23%,2,0,2,2,2,0
63,https://vlr.gg/player/2540/happen,2024-06-22 14:00:00,0.62,0.81,0.72,144,171,117,19,10,9,33,18,15,16,11,5,+1,+1,0,58%,70%,45%,100,121,79,32%,31%,33%,4,3,1,3,2,1
64,https://vlr.gg/player/13238/shiio,2024-06-22 14:00:00,0.94,0.42,0.68,137,179,96,19,13,6,32,14,18,11,8,3,-2,+1,-3,63%,75%,50%,94,112,76,33%,41%,23%,1,1,0,3,0,3
65,https://vlr.gg/player/7987/kovaq,2024-06-22 14:00:00,1.53,1.76,1.64,306,277,336,42,20,22,24,10,14,22,7,15,+2,+2,0,80%,75%,85%,215,184,246,27%,27%,28%,7,4,3,5,2,3
66,https://vlr.gg/player/4630/magnus,2024-06-22 14:00:00,1.60,1.37,1.48,292,341,245,46,26,20,25,13,12,5,1,4,+10,+7,+3,85%,85%,85%,188,218,157,23%,23%,23%,11,8,3,1,1,0
67,https://vlr.gg/player/30754/karma,2024-06-22 14:00:00,1.05,0.90,0.98,156,172,140,25,13,12,23,10,13,10,5,5,-3,-2,-1,78%,75%,80%,118,116,120,22%,20%,26%,0,0,0,3,2,1
68,https://vlr.gg/player/20302/jini,2024-06-22 14:00:00,0.91,0.76,0.83,178,191,165,26,14,12,29,12,17,16,8,8,-4,0,-4,80%,85%,75%,107,117,97,24%,26%,24%,1,1,0,5,1,4
69,https://vlr.gg/player/7968/stavinci,2024-06-22 14:00:00,0.76,0.69,0.73,165,168,163,26,14,12,30,13,17,13,8,5,-3,-1,-2,75%,80%,70%,104,107,102,29%,29%,29%,2,0,2,5,1,4
70,https://vlr.gg/player/2114/kinguyen,2024-06-22 14:00:00,0.97,1.31,1.14,237,198,277,42,17,25,36,19,17,11,4,7,+1,-1,+2,65%,60%,71%,151,138,164,29%,23%,36%,9,5,4,8,6,2
71,https://vlr.gg/player/11322/sevire,2024-06-22 14:00:00,1.16,0.98,1.07,217,227,209,36,19,17,36,17,19,27,14,13,+1,0,+1,65%,72%,58%,138,135,141,30%,29%,32%,3,0,3,2,0,2
72,https://vlr.gg/player/1387/apo,2024-06-22 14:00:00,0.87,1.02,0.94,153,155,155,27,14,13,31,19,12,23,14,9,-2,-1,-1,82%,80%,83%,112,102,123,33%,32%,35%,1,1,0,3,2,1
73,https://vlr.gg/player/8217/memset,2024-06-22 14:00:00,0.80,0.94,0.87,196,207,195,33,17,16,38,21,17,11,5,6,0,-1,+1,63%,60%,67%,127,137,115,33%,35%,29%,10,4,6,10,5,5
74,https://vlr.gg/player/12579/darklight,2024-06-22 14:00:00,0.43,0.73,0.58,121,119,123,21,10,11,39,22,17,13,8,5,-1,0,-1,69%,72%,67%,82,77,87,22%,12%,37%,1,1,0,2,1,1
75,https://vlr.gg/player/252/d3ffo,2024-06-22 14:00:00,1.49,1.65,1.57,295,264,321,51,24,27,31,15,16,11,2,9,+1,-1,+2,76%,75%,76%,190,163,216,27%,33%,24%,8,3,5,7,4,3
76,https://vlr.gg/player/314/ambi,2024-06-22 14:00:00,1.19,1.18,1.18,222,223,217,37,17,20,32,17,15,24,13,11,+3,+3,0,76%,79%,72%,146,154,138,31%,33%,28%,4,3,1,1,0,1
77,https://vlr.gg/player/2653/jesse,2024-06-22 14:00:00,0.74,1.30,1.02,181,160,204,34,14,20,31,19,12,18,7,11,-1,-2,+1,76%,71%,80%,116,104,128,32%,36%,29%,4,0,4,5,2,3
78,https://vlr.gg/player/8805/sacake,2024-06-22 14:00:00,0.81,0.95,0.88,173,177,171,28,13,15,31,16,15,15,7,8,-3,-3,0,73%,75%,72%,121,118,124,21%,24%,19%,2,1,1,5,4,1
79,https://vlr.gg/player/6889/neskaas,2024-06-22 14:00:00,0.90,0.86,0.88,177,165,190,30,14,16,34,15,19,16,7,9,+1,+1,0,71%,67%,76%,113,108,118,33%,41%,27%,7,4,3,6,3,3
80,https://vlr.gg/player/29998/drastz,2024-06-22 14:00:00,0.84,1.28,1.15,217,154,244,12,2,10,13,4,9,6,3,3,0,-1,+1,65%,60%,67%,144,128,151,16%,14%,17%,2,0,2,2,1,1
81,https://vlr.gg/player/1347/ivan4ezz,2024-06-22 14:00:00,1.08,0.60,0.74,147,204,124,9,4,5,14,5,9,0,0,0,-1,0,-1,47%,40%,50%,106,137,92,27%,33%,24%,0,0,0,1,0,1
82,https://vlr.gg/player/2431/basya,2024-06-22 14:00:00,0.27,0.78,0.63,147,44,190,7,1,6,15,4,11,4,0,4,-1,-1,0,59%,40%,67%,108,35,138,45%,50%,45%,1,0,1,2,1,1
83,https://vlr.gg/player/2252/anq,2024-06-22 14:00:00,0.27,0.67,0.55,140,110,153,8,2,6,14,5,9,0,0,0,-3,0,-3,53%,40%,58%,90,64,101,22%,17%,24%,2,1,1,5,1,4
84,https://vlr.gg/player/3860/al1en,2024-06-22 14:00:00,0.30,0.46,0.41,101,103,101,4,1,3,14,5,9,5,2,3,0,+1,-1,41%,40%,42%,69,73,67,33%,50%,29%,1,1,0,1,0,1
85,https://vlr.gg/player/18400/bipo,2024-06-22 14:00:00,1.81,1.69,1.77,373,396,320,22,17,5,8,6,2,4,1,3,+2,+2,0,88%,83%,100%,258,268,234,30%,31%,28%,3,3,0,1,1,0
86,https://vlr.gg/player/23347/alannn,2024-06-22 14:00:00,1.06,2.49,1.48,227,189,320,17,9,8,7,6,1,1,1,0,0,-1,+1,76%,67%,100%,163,131,240,37%,27%,58%,2,1,1,2,2,0
87,https://vlr.gg/player/1524/h1ber,2024-06-22 14:00:00,1.31,0.98,1.21,160,156,169,12,8,4,7,5,2,12,11,1,+1,+1,0,82%,83%,80%,81,77,90,27%,25%,33%,2,2,0,1,1,0
88,https://vlr.gg/player/4277/n-a-i-s,2024-06-22 14:00:00,1.29,0.90,1.18,204,236,128,13,10,3,9,7,2,4,3,1,0,+1,-1,76%,83%,60%,152,163,125,21%,19%,29%,1,1,0,1,0,1
89,https://vlr.gg/player/1493/starkk,2024-06-22 14:00:00,0.75,1.42,0.95,123,76,239,6,3,3,9,6,3,11,5,6,+2,+1,+1,82%,75%,100%,87,56,161,20%,20%,20%,3,1,2,1,0,1
90,https://vlr.gg/player/20032/treelover,2024-06-22 13:45:00,0.87,1.25,1.07,213,168,255,38,15,23,38,20,18,18,9,9,+3,0,+3,71%,64%,78%,130,102,156,26%,28%,25%,5,1,4,2,1,1
91,https://vlr.gg/player/2189/qxv,2024-06-22 13:45:00,1.07,1.04,1.05,196,216,170,35,19,16,36,20,16,12,6,6,-1,-1,0,67%,72%,63%,133,150,117,29%,37%,22%,2,0,2,3,1,2
92,https://vlr.gg/player/22179/shy,2024-06-22 13:45:00,0.82,1.04,0.93,216,206,232,38,17,21,42,21,21,10,3,7,0,+1,-1,63%,60%,67%,142,129,154,22%,27%,17%,13,8,5,13,7,6
93,https://vlr.gg/player/4543/nyczu,2024-06-22 13:45:00,0.61,1.13,0.88,199,155,237,35,12,23,42,22,20,8,5,3,-7,-5,-2,69%,60%,78%,130,105,153,31%,29%,32%,1,0,1,8,5,3
94,https://vlr.gg/player/3746/hitch,2024-06-22 13:45:00,0.88,0.84,0.86,164,188,150,27,15,12,40,21,19,28,15,13,-5,-2,-3,73%,76%,70%,122,128,117,22%,20%,26%,0,0,0,5,2,3
95,https://vlr.gg/player/18162/serial,2024-06-22 13:45:00,1.98,0.99,1.50,307,363,233,58,37,21,33,14,19,10,3,7,+9,+6,+3,83%,89%,76%,194,233,152,50%,56%,41%,11,6,5,2,0,2
96,https://vlr.gg/player/40935/umu7,2024-06-22 13:45:00,0.57,1.53,1.03,207,159,272,40,15,25,35,22,13,7,3,4,+1,-2,+3,69%,56%,84%,141,103,182,25%,26%,24%,6,3,3,5,5,0
97,https://vlr.gg/player/40004/globex,2024-06-22 13:45:00,0.70,1.19,0.93,190,174,222,37,16,21,36,22,14,14,4,10,-4,0,-4,71%,63%,80%,133,126,141,17%,15%,20%,5,4,1,9,4,5
98,https://vlr.gg/player/164/bzt,2024-06-22 13:45:00,0.60,1.28,0.93,185,123,245,31,11,20,34,19,15,15,6,9,+2,0,+2,71%,63%,80%,129,84,178,20%,14%,25%,4,1,3,2,1,1
99,https://vlr.gg/player/38424/zachkappa,2024-06-22 13:45:00,0.86,0.91,0.89,178,165,179,32,15,17,35,18,17,15,8,7,+2,-1,+3,67%,67%,68%,116,111,120,38%,43%,33%,5,1,4,3,2,1
100,https://vlr.gg/player/41066/slender,2024-06-22 13:15:00,1.28,1.34,1.31,221,250,192,22,12,10,16,9,7,5,2,3,-3,-2,-1,75%,71%,79%,156,165,147,47%,61%,33%,1,0,1,4,2,2
101,https://vlr.gg/player/12571/furyan,2024-06-22 13:15:00,1.07,1.05,1.06,249,235,263,23,11,12,22,11,11,6,2,4,+4,+2,+2,71%,79%,64%,163,158,167,18%,26%,11%,7,3,4,3,1,2
102,https://vlr.gg/player/6910/kenzmps,2024-06-22 13:15:00,1.02,0.96,0.99,163,166,161,15,9,6,19,10,9,12,5,7,-1,0,-1,71%,79%,64%,125,127,123,40%,40%,39%,1,0,1,2,0,2
103,https://vlr.gg/player/2980/raxtazzz,2024-06-22 13:15:00,1.06,0.88,0.97,212,212,212,19,10,9,20,10,10,12,5,7,-1,0,-1,75%,79%,71%,132,134,130,25%,21%,31%,0,0,0,1,0,1
104,https://vlr.gg/player/2880/rlzy,2024-06-22 13:15:00,0.33,1.47,0.90,209,150,270,22,7,15,21,13,8,2,0,2,-3,-4,+1,57%,36%,79%,129,96,162,20%,26%,18%,3,2,1,6,6,0
105,https://vlr.gg/player/10399/lekyy,2024-06-22 13:15:00,0.81,1.22,1.01,199,152,248,21,9,12,19,9,10,5,0,5,0,0,0,82%,79%,86%,139,108,171,37%,44%,33%,1,1,0,1,1,0
106,https://vlr.gg/player/29994/xini,2024-06-22 13:15:00,0.58,1.40,0.99,221,121,323,22,5,17,20,10,10,7,5,2,+2,0,+2,71%,64%,79%,153,87,219,29%,17%,35%,3,1,2,1,1,0
107,https://vlr.gg/player/44433/droperz,2024-06-22 13:15:00,1.26,0.68,0.97,194,283,107,20,14,6,20,11,9,7,6,1,-1,0,-1,82%,93%,71%,129,175,83,14%,18%,7%,1,0,1,2,0,2
108,https://vlr.gg/player/29996/stepa,2024-06-22 13:15:00,0.90,0.97,0.94,226,250,202,20,11,9,22,12,10,6,3,3,+4,+2,+2,57%,57%,57%,138,150,125,22%,19%,27%,8,5,3,4,3,1
109,https://vlr.gg/player/7256/andresg,2024-06-22 13:15:00,0.77,1.02,0.90,173,147,200,15,6,9,20,10,10,13,6,7,-1,-2,+1,75%,64%,86%,110,98,122,29%,40%,23%,3,0,3,4,2,2
110,https://vlr.gg/player/11013/balli,2024-06-22 13:00:00,1.76,1.17,1.48,309,374,239,26,17,9,15,6,9,2,1,1,+1,0,+1,83%,92%,73%,200,248,148,44%,44%,44%,3,1,2,2,1,1
111,https://vlr.gg/player/11122/byron,2024-06-22 13:00:00,1.29,0.86,1.09,181,202,159,15,9,6,14,7,7,7,4,3,+1,+1,0,83%,92%,73%,107,114,99,19%,17%,21%,1,1,0,0,0,0
112,https://vlr.gg/player/33513/sihw,2024-06-22 13:00:00,0.96,0.71,0.84,130,146,114,11,6,5,14,7,7,6,4,2,-1,0,-1,70%,75%,64%,93,99,88,55%,38%,86%,2,1,1,3,1,2
113,https://vlr.gg/player/33523/vuexlex,2024-06-22 13:00:00,0.85,0.47,0.67,180,219,139,14,9,5,18,9,9,5,3,2,-1,+1,-2,57%,75%,36%,122,140,104,30%,26%,35%,3,3,0,4,2,2
114,https://vlr.gg/player/33627/dok,2024-06-22 13:00:00,0.69,0.15,0.43,73,117,25,6,5,1,15,7,8,2,2,0,-5,-2,-3,57%,75%,36%,59,94,22,38%,38%,33%,0,0,0,5,2,3
115,https://vlr.gg/player/4544/filu,2024-06-22 13:00:00,1.89,1.38,1.62,352,376,330,29,16,13,15,5,10,5,2,3,+2,0,+2,78%,73%,83%,222,243,202,28%,36%,21%,5,2,3,3,2,1
116,https://vlr.gg/player/8226/waddle,2024-06-22 13:00:00,1.20,0.89,1.04,149,171,131,13,7,6,14,6,8,10,6,4,-1,+1,-2,70%,82%,58%,102,105,100,50%,54%,47%,2,2,0,3,1,2
117,https://vlr.gg/player/7162/wackie,2024-06-22 13:00:00,0.73,1.22,0.99,165,87,238,12,2,10,14,5,9,5,3,2,+1,0,+1,70%,73%,67%,108,67,146,28%,21%,31%,2,0,2,1,0,1
118,https://vlr.gg/player/12474/tag,2024-06-22 13:00:00,1.45,0.50,0.96,156,244,76,14,10,4,13,5,8,2,1,1,+1,+2,-1,65%,82%,50%,102,148,59,22%,23%,18%,3,2,1,2,0,2
119,https://vlr.gg/player/1944/cayden,2024-06-22 13:00:00,1.06,0.47,0.75,120,137,105,8,5,3,16,5,11,15,8,7,+2,+2,0,70%,82%,58%,91,89,94,17%,17%,17%,2,2,0,0,0,0
120,https://vlr.gg/player/12774/anima,2024-06-22 13:00:00,1.08,1.91,1.53,260,189,318,38,14,24,17,10,7,15,4,11,+2,+1,+1,88%,78%,95%,165,118,203,22%,25%,22%,2,1,1,0,0,0
121,https://vlr.gg/player/12793/xeus,2024-06-22 13:00:00,1.43,1.39,1.41,319,324,310,45,20,25,25,11,14,9,3,6,0,0,0,78%,72%,82%,225,217,232,46%,53%,41%,8,4,4,8,4,4
122,https://vlr.gg/player/22676/ventt,2024-06-22 13:00:00,1.28,1.08,1.17,219,213,223,30,13,17,24,10,14,20,8,12,+1,-1,+2,75%,67%,82%,141,127,153,35%,38%,34%,4,1,3,3,2,1
123,https://vlr.gg/player/16483/gloomy,2024-06-22 13:00:00,0.81,1.08,0.96,154,144,160,24,8,16,22,10,12,5,1,4,+1,-1,+2,73%,61%,82%,106,97,113,27%,29%,26%,4,1,3,3,2,1
124,https://vlr.gg/player/12795/crewen,2024-06-22 13:00:00,0.64,1.03,0.85,144,100,175,19,6,13,22,10,12,13,3,10,0,-1,+1,70%,67%,73%,99,75,119,33%,33%,33%,4,1,3,4,2,2
125,https://vlr.gg/player/15735/krostaly,2024-06-22 13:00:00,0.89,1.19,1.03,233,209,262,31,15,16,31,19,12,4,4,0,0,-2,+2,60%,50%,72%,153,144,165,30%,40%,22%,5,2,3,5,4,1
126,https://vlr.gg/player/4894/jn3v1ce,2024-06-22 13:00:00,0.70,1.12,0.89,159,134,203,22,10,12,28,18,10,9,6,3,-4,-2,-2,65%,59%,72%,109,86,137,28%,30%,26%,1,0,1,5,2,3
127,https://vlr.gg/player/3604/mojj,2024-06-22 13:00:00,0.85,0.72,0.79,152,184,116,18,13,5,29,18,11,10,6,4,+2,+2,0,68%,68%,67%,110,131,86,28%,36%,19%,4,2,2,2,0,2
128,https://vlr.gg/player/1401/sasuke,2024-06-22 13:00:00,0.56,0.97,0.74,170,137,214,23,11,12,36,21,15,17,8,9,0,-2,+2,65%,59%,72%,103,78,135,26%,25%,26%,2,0,2,2,2,0
129,https://vlr.gg/player/13571/musz3kk,2024-06-22 13:00:00,0.65,0.66,0.65,140,157,122,16,10,6,32,19,13,10,6,4,-2,-2,0,58%,59%,56%,98,103,91,25%,26%,24%,6,4,2,8,6,2
130,https://vlr.gg/player/219/tidus,2024-06-22 12:00:00,1.35,0.91,1.13,221,259,184,34,20,14,32,16,16,9,5,4,+1,+2,-1,71%,80%,62%,134,153,117,31%,33%,28%,3,2,1,2,0,2
131,https://vlr.gg/player/3769/killu,2024-06-22 12:00:00,1.05,0.99,1.02,185,207,164,27,15,12,27,14,13,12,5,7,+1,0,+1,73%,75%,71%,117,137,97,17%,17%,17%,3,1,2,2,1,1
132,https://vlr.gg/player/7173/soren,2024-06-22 12:00:00,1.00,0.76,0.88,220,245,197,30,17,13,34,17,17,10,5,5,0,-1,+1,76%,80%,71%,145,166,125,30%,29%,32%,8,4,4,8,5,3
133,https://vlr.gg/player/257/bramz,2024-06-22 12:00:00,0.74,0.51,0.62,102,132,76,16,10,6,27,14,13,6,4,2,-4,-1,-3,68%,75%,62%,72,95,51,21%,25%,16%,2,1,1,6,2,4
134,https://vlr.gg/player/9135/oniby,2024-06-22 12:00:00,0.45,0.58,0.52,142,133,151,19,8,11,36,18,18,13,10,3,-5,-4,-1,68%,80%,57%,103,96,110,29%,30%,29%,1,0,1,6,4,2
135,https://vlr.gg/player/12928/veqaj,2024-06-22 12:00:00,1.50,1.52,1.51,235,225,244,34,17,17,19,9,10,25,12,13,+4,+3,+1,85%,90%,80%,144,142,148,26%,35%,20%,4,3,1,0,0,0
136,https://vlr.gg/player/2256/jady,2024-06-22 12:00:00,1.34,1.57,1.45,266,262,271,40,19,21,26,12,14,18,6,12,+4,+2,+2,90%,90%,90%,166,169,164,31%,32%,30%,7,4,3,3,2,1
137,https://vlr.gg/player/14612/lux9,2024-06-22 12:00:00,1.10,1.34,1.22,273,223,328,39,17,22,30,13,17,7,2,5,+1,+1,0,71%,67%,75%,183,156,211,32%,40%,26%,9,4,5,8,3,5
138,https://vlr.gg/player/4521/unfake,2024-06-22 12:00:00,1.32,0.65,0.99,163,181,146,24,14,10,22,9,13,15,8,7,0,-1,+1,78%,86%,70%,112,120,104,38%,34%,45%,2,0,2,2,1,1
139,https://vlr.gg/player/3563/babax,2024-06-22 12:00:00,0.86,0.49,0.68,130,140,119,18,10,8,29,13,16,16,7,9,-2,-2,0,76%,81%,70%,96,104,86,20%,25%,13%,2,1,1,4,3,1
140,https://vlr.gg/player/30508/rickyvaila,2024-06-22 12:00:00,1.37,1.61,1.50,243,247,241,19,9,10,11,7,4,10,4,6,+1,0,+1,86%,80%,92%,172,166,178,33%,30%,36%,1,0,1,0,0,0
141,https://vlr.gg/player/2897/limp,2024-06-22 12:00:00,1.28,1.00,1.13,229,244,217,18,9,9,17,8,9,8,6,2,0,-2,+2,73%,70%,75%,166,188,147,29%,33%,25%,2,0,2,2,2,0
142,https://vlr.gg/player/31114/frandina,2024-06-22 12:00:00,0.68,1.29,1.01,234,214,251,16,6,10,16,8,8,3,1,2,0,-1,+1,64%,70%,58%,152,135,167,24%,19%,29%,3,1,2,3,2,1
143,https://vlr.gg/player/10375/braso,2024-06-22 12:00:00,1.23,0.60,0.89,173,225,131,14,9,5,14,7,7,0,0,0,+3,+1,+2,77%,80%,75%,117,165,78,25%,23%,29%,3,1,2,0,0,0
144,https://vlr.gg/player/4274/xazyy,2024-06-22 12:00:00,0.01,0.75,0.31,132,36,213,10,0,10,20,10,10,3,3,0,-6,-4,-2,55%,50%,58%,86,34,130,45%,0%,77%,1,0,1,7,4,3
145,https://vlr.gg/player/45138/aster,2024-06-22 12:00:00,1.16,1.44,1.29,238,229,250,20,10,10,14,8,6,3,2,1,-1,-1,0,82%,75%,90%,184,185,183,36%,36%,36%,1,1,0,2,2,0
146,https://vlr.gg/player/19526/rexxtoned,2024-06-22 12:00:00,1.33,0.85,1.11,192,232,144,15,10,5,14,8,6,7,2,5,+1,+1,0,68%,67%,70%,115,132,96,42%,65%,19%,2,1,1,1,0,1
147,https://vlr.gg/player/9943/mezoky,2024-06-22 12:00:00,0.70,1.49,1.06,187,130,258,15,6,9,15,9,6,9,2,7,+1,0,+1,77%,67%,90%,131,93,177,58%,56%,60%,2,1,1,1,1,0
148,https://vlr.gg/player/22566/pax,2024-06-22 12:00:00,0.49,1.38,0.89,245,145,367,18,6,12,19,10,9,5,1,4,+1,-4,+5,59%,50%,70%,158,98,229,36%,58%,29%,6,1,5,5,5,0
149,https://vlr.gg/player/6338/syyse,2024-06-22 12:00:00,0.64,0.96,0.78,145,152,137,10,6,4,15,9,6,16,3,13,0,0,0,77%,58%,100%,95,102,87,19%,17%,23%,1,0,1,1,0,1
150,https://vlr.gg/player/8590/killdream,2024-06-22 12:00:00,1.11,1.44,1.27,276,267,287,22,11,11,16,9,7,7,3,4,+2,+1,+1,71%,50%,92%,190,192,188,26%,20%,34%,4,1,3,2,0,2
151,https://vlr.gg/player/26808/fainz,2024-06-22 12:00:00,1.42,0.85,1.13,245,337,155,20,13,7,16,9,7,2,2,0,-1,0,-1,63%,67%,58%,152,210,94,44%,41%,50%,4,3,1,5,3,2
152,https://vlr.gg/player/16012/akira,2024-06-22 12:00:00,0.87,1.21,1.04,173,175,172,14,8,6,14,9,5,3,0,3,+2,+1,+1,79%,75%,83%,123,113,132,33%,31%,35%,2,1,1,0,0,0
153,https://vlr.gg/player/1377/phatt,2024-06-22 12:00:00,0.73,1.28,1.00,142,97,189,13,4,9,12,7,5,9,7,2,-2,-2,0,58%,58%,58%,93,72,115,32%,36%,30%,1,0,1,3,2,1
154,https://vlr.gg/player/7883/silenttt,2024-06-22 12:00:00,0.38,1.09,0.73,118,81,156,10,3,7,16,10,6,3,3,0,-3,-2,-1,75%,67%,83%,77,55,99,22%,6%,33%,0,0,0,3,2,1
155,https://vlr.gg/player/15577/brk,2024-06-22 12:00:00,0.83,1.37,1.10,236,214,259,20,9,11,15,8,7,4,1,3,+2,-1,+3,75%,67%,83%,153,138,168,25%,23%,27%,5,1,4,3,2,1
156,https://vlr.gg/player/15376/grtw,2024-06-22 12:00:00,0.98,1.09,1.03,196,194,199,15,7,8,15,9,6,5,2,3,0,+2,-2,67%,67%,67%,149,163,134,27%,31%,22%,3,2,1,3,0,3
157,https://vlr.gg/player/1378/addicted,2024-06-22 12:00:00,0.89,1.08,0.99,149,124,175,13,5,8,13,6,7,7,2,5,-1,-1,0,63%,58%,67%,89,65,113,30%,38%,27%,1,1,0,2,2,0
158,https://vlr.gg/player/29340/cunha20,2024-06-22 12:00:00,0.71,1.03,0.87,186,144,228,16,6,10,19,8,11,6,1,5,+1,+2,-1,75%,67%,83%,124,96,151,44%,60%,36%,2,2,0,1,0,1
159,https://vlr.gg/player/13435/fragger,2024-06-22 12:00:00,0.42,1.00,0.71,135,90,180,10,3,7,17,9,8,8,6,2,0,-2,+2,71%,50%,92%,88,68,107,18%,13%,21%,2,0,2,2,2,0
160,https://vlr.gg/player/20292/akai,2024-06-22 12:00:00,1.33,2.31,1.86,395,321,449,61,23,38,29,15,14,9,4,5,+5,+3,+2,84%,75%,92%,256,206,297,32%,32%,33%,11,8,3,6,5,1
161,https://vlr.gg/player/5600/moh,2024-06-22 12:00:00,1.26,0.87,1.05,204,262,151,31,18,13,31,15,16,11,7,4,+1,+1,0,75%,75%,75%,137,184,98,35%,34%,36%,5,1,4,4,0,4
162,https://vlr.gg/player/6503/sand,2024-06-22 12:00:00,1.07,0.94,1.00,183,191,171,30,14,16,26,11,15,8,1,7,-2,-1,-1,80%,80%,79%,118,122,115,35%,38%,32%,1,0,1,3,1,2
163,https://vlr.gg/player/5599/khaalid,2024-06-22 12:00:00,0.91,0.70,0.79,149,143,160,24,11,13,30,11,19,19,7,12,-3,0,-3,70%,70%,71%,92,83,100,39%,38%,39%,2,1,1,5,1,4
164,https://vlr.gg/player/1618/spyzera,2024-06-22 12:00:00,0.97,0.61,0.77,146,142,149,21,11,10,31,10,21,19,7,12,+1,-1,+2,77%,85%,71%,97,90,102,28%,22%,33%,4,1,3,3,2,1
165,https://vlr.gg/player/5609/vague,2024-06-22 12:00:00,1.14,1.15,1.14,253,256,243,36,20,16,34,18,16,12,7,5,+8,+5,+3,77%,71%,85%,160,171,148,34%,36%,31%,14,8,6,6,3,3
166,https://vlr.gg/player/16885/snipkw,2024-06-22 12:00:00,1.06,0.92,1.00,212,234,200,35,22,13,34,19,15,17,8,9,-3,-2,-1,75%,75%,75%,140,146,133,33%,32%,34%,3,1,2,6,3,3
167,https://vlr.gg/player/5614/xelouz,2024-06-22 12:00:00,0.99,0.93,0.96,183,184,173,28,15,13,33,18,15,18,14,4,0,+1,-1,80%,88%,70%,115,120,109,32%,37%,27%,2,2,0,2,1,1
168,https://vlr.gg/player/5612/near,2024-06-22 12:00:00,0.80,0.99,0.89,164,144,190,23,12,11,31,17,14,17,10,7,-2,-2,0,64%,63%,65%,124,114,136,24%,23%,26%,1,0,1,3,2,1
169,https://vlr.gg/player/19311/kuro,2024-06-22 12:00:00,0.81,0.55,0.69,161,191,134,25,16,9,35,18,17,5,1,4,-5,-2,-3,64%,71%,55%,112,120,103,25%,20%,31%,1,1,0,6,3,3
170,https://vlr.gg/player/33732/nunmeister,2024-06-22 11:00:00,1.30,0.78,1.06,206,253,148,47,31,16,41,23,18,12,6,6,-3,+1,-4,69%,75%,63%,129,164,88,20%,22%,16%,4,3,1,7,2,5
171,https://vlr.gg/player/10448/kozok,2024-06-22 11:00:00,0.84,1.25,1.03,214,175,254,43,19,24,44,25,19,23,11,12,+1,-1,+2,71%,63%,81%,137,117,160,23%,30%,19%,6,2,4,5,3,2
172,https://vlr.gg/player/39682/wanzeru,2024-06-22 11:00:00,0.47,1.61,0.99,228,136,338,49,15,34,49,28,21,7,4,3,+7,0,+7,81%,69%,96%,155,95,225,28%,27%,29%,14,7,7,7,7,0
173,https://vlr.gg/player/259/arch,2024-06-22 11:00:00,0.97,0.87,0.93,175,155,195,41,21,20,40,20,20,14,7,7,-5,-2,-3,64%,63%,67%,116,105,130,18%,25%,14%,2,1,1,7,3,4
174,https://vlr.gg/player/15064/kajuks,2024-06-22 11:00:00,1.05,0.62,0.86,182,215,147,39,26,13,45,24,21,16,8,8,+3,+4,-1,64%,69%,59%,115,127,102,24%,25%,23%,5,4,1,2,0,2
175,https://vlr.gg/player/4325/musashi,2024-06-22 11:00:00,0.93,1.37,1.17,222,165,274,47,16,31,40,20,20,15,8,7,-2,-1,-1,73%,67%,78%,152,108,189,37%,24%,45%,5,1,4,7,2,5
176,https://vlr.gg/player/321/chiwa,2024-06-22 11:00:00,1.31,1.01,1.15,221,271,187,48,27,21,43,21,22,13,5,8,+2,+2,0,69%,74%,66%,156,184,132,32%,34%,30%,5,3,2,3,1,2
177,https://vlr.gg/player/1374/alive,2024-06-22 11:00:00,0.78,1.31,1.07,230,191,261,52,20,32,44,22,22,4,1,3,+2,-1,+3,69%,67%,72%,148,127,167,35%,51%,24%,10,5,5,8,6,2
178,https://vlr.gg/player/8808/pyrolll,2024-06-22 11:00:00,1.14,0.88,1.00,199,226,173,38,21,17,43,19,24,22,7,15,-1,0,-1,75%,74%,75%,126,142,113,26%,30%,23%,4,1,3,5,1,4
179,https://vlr.gg/player/32351/cullumx,2024-06-22 11:00:00,0.67,0.78,0.72,171,172,176,34,15,19,49,25,24,24,13,11,-4,-1,-3,71%,74%,69%,118,113,122,36%,38%,34%,4,3,1,8,4,4
180,https://vlr.gg/player/7866/click,2024-06-22 11:00:00,1.16,1.58,1.35,284,233,355,62,27,35,45,26,19,21,12,9,+7,0,+7,82%,79%,85%,177,145,216,38%,41%,36%,15,5,10,8,5,3
181,https://vlr.gg/player/12593/felix,2024-06-22 11:00:00,1.06,1.45,1.23,226,192,266,49,23,26,40,24,16,20,7,13,+5,0,+5,75%,68%,85%,145,125,170,30%,35%,26%,9,4,5,4,4,0
182,https://vlr.gg/player/1153/murii,2024-06-22 11:00:00,1.18,1.02,1.11,201,240,148,49,33,16,37,25,12,10,2,8,+2,+2,0,72%,71%,74%,133,156,103,45%,54%,32%,7,5,2,5,3,2
183,https://vlr.gg/player/448/meddo,2024-06-22 11:00:00,0.72,1.06,0.87,155,122,192,33,15,18,39,23,16,21,7,14,-3,-2,-1,72%,65%,81%,104,76,140,30%,37%,27%,2,2,0,5,4,1
184,https://vlr.gg/player/7105/qpert,2024-06-22 11:00:00,0.77,0.96,0.85,140,130,160,30,14,16,41,24,17,31,15,16,+2,0,+2,77%,71%,85%,90,86,93,29%,33%,25%,4,1,3,2,1,1
185,https://vlr.gg/player/1167/luzuh,2024-06-22 11:00:00,0.80,1.30,1.08,244,198,282,52,18,34,46,24,22,10,3,7,0,-5,+5,62%,44%,76%,162,141,179,29%,33%,26%,11,2,9,11,7,4
186,https://vlr.gg/player/15178/canefis,2024-06-22 11:00:00,1.11,0.95,1.02,193,222,176,44,20,24,43,21,22,5,3,2,-1,-2,+1,69%,70%,68%,132,153,115,44%,50%,40%,2,1,1,3,3,0
187,https://vlr.gg/player/6038/b3astm0d3,2024-06-22 11:00:00,0.79,0.96,0.88,178,187,171,38,18,20,42,22,20,18,6,12,-6,-3,-3,69%,59%,76%,115,124,107,26%,19%,33%,4,2,2,10,5,5
188,https://vlr.gg/player/3934/eleo,2024-06-22 11:00:00,0.52,1.08,0.83,191,124,238,36,10,26,48,23,25,21,7,14,-1,0,-1,69%,63%,74%,126,88,156,23%,26%,22%,4,2,2,5,2,3
189,https://vlr.gg/player/8672/louitan,2024-06-22 11:00:00,0.80,0.74,0.76,149,145,151,32,14,18,44,21,23,19,8,11,-5,-3,-2,61%,63%,59%,96,98,95,28%,31%,25%,3,0,3,8,3,5
190,https://vlr.gg/player/42077/noheart,2024-06-22 11:00:00,1.21,0.91,1.09,273,290,249,19,12,7,17,10,7,0,0,0,+1,+1,0,75%,75%,75%,176,183,164,51%,59%,40%,5,4,1,4,3,1
191,https://vlr.gg/player/15091/zepiczz,2024-06-22 11:00:00,0.96,1.23,1.07,217,195,252,14,8,6,13,8,5,6,3,3,+1,-1,+2,60%,58%,63%,154,143,169,19%,13%,29%,2,0,2,1,1,0
192,https://vlr.gg/player/12430/skypzz,2024-06-22 11:00:00,0.81,0.86,0.83,181,225,117,13,9,4,17,12,5,4,3,1,-3,-1,-2,60%,58%,63%,134,156,102,32%,35%,27%,1,1,0,4,2,2
193,https://vlr.gg/player/8110/kayban,2024-06-22 11:00:00,0.62,0.94,0.75,131,98,182,9,3,6,15,9,6,6,4,2,0,0,0,65%,58%,75%,86,77,100,22%,20%,24%,0,0,0,0,0,0
194,https://vlr.gg/player/39153/dake,2024-06-22 11:00:00,0.90,0.47,0.73,107,128,77,8,6,2,14,8,6,8,4,4,-3,-1,-2,75%,75%,75%,70,88,44,24%,29%,17%,0,0,0,3,1,2
195,https://vlr.gg/player/27820/coronel,2024-06-22 11:00:00,1.57,1.35,1.44,218,268,186,18,9,9,12,5,7,15,3,12,+1,0,+1,80%,88%,75%,134,173,108,31%,30%,32%,2,0,2,1,0,1
196,https://vlr.gg/player/26789/pdr,2024-06-22 11:00:00,1.03,1.50,1.31,237,156,292,18,5,13,13,5,8,10,4,6,+3,0,+3,95%,88%,100%,152,82,199,44%,25%,54%,5,1,4,2,1,1
197,https://vlr.gg/player/2617/leare,2024-06-22 11:00:00,0.80,1.31,1.10,216,164,252,16,4,12,13,6,7,2,1,1,+2,+2,0,65%,75%,58%,142,136,146,28%,27%,29%,4,3,1,2,1,1
198,https://vlr.gg/player/2832/patix,2024-06-22 11:00:00,1.01,1.01,1.01,169,118,203,8,2,6,12,4,8,16,7,9,-1,0,-1,70%,63%,75%,135,98,161,45%,38%,50%,0,0,0,1,0,1
199,https://vlr.gg/player/33517/tripsy,2024-06-22 11:00:00,1.40,0.74,1.01,210,287,159,16,9,7,13,5,8,6,3,3,-1,0,-1,80%,100%,67%,151,202,117,15%,17%,14%,1,1,0,2,1,1
200,https://vlr.gg/player/5500/docent,2024-06-22 10:30:00,1.09,1.85,1.41,277,214,336,42,20,22,26,17,9,24,11,13,+1,0,+1,79%,80%,78%,176,148,216,33%,35%,32%,3,1,2,2,1,1
201,https://vlr.gg/player/20144/lewn,2024-06-22 10:30:00,1.54,1.00,1.31,276,302,243,41,26,15,31,17,14,9,7,2,+8,+6,+2,84%,88%,78%,178,201,146,40%,41%,39%,15,9,6,7,3,4
202,https://vlr.gg/player/10163/cyderx,2024-06-22 10:30:00,1.22,1.23,1.23,215,215,208,34,21,13,24,13,11,15,6,9,+1,-1,+2,91%,88%,94%,135,130,141,38%,35%,42%,2,0,2,1,1,0
203,https://vlr.gg/player/3549/touven,2024-06-22 10:30:00,1.00,1.05,1.02,155,160,169,24,13,11,26,14,12,24,13,11,-3,-2,-1,84%,80%,89%,112,103,124,30%,35%,26%,1,1,0,4,3,1
204,https://vlr.gg/player/10152/padisah,2024-06-22 10:30:00,0.99,0.91,0.96,177,186,151,27,16,11,27,14,13,8,6,2,-2,-2,0,74%,72%,78%,124,139,104,35%,32%,39%,3,2,1,5,4,1
205,https://vlr.gg/player/39675/sh1va,2024-06-22 10:30:00,1.32,0.84,1.04,169,208,162,30,16,14,29,11,18,5,2,3,-2,-3,+1,70%,78%,64%,134,138,131,36%,41%,33%,4,0,4,6,3,3
206,https://vlr.gg/player/10114/baha,2024-06-22 10:30:00,0.73,0.98,0.86,183,200,193,31,12,19,32,14,18,13,7,6,0,+1,-1,67%,72%,64%,127,128,126,38%,26%,51%,4,3,1,4,2,2
207,https://vlr.gg/player/11516/drky,2024-06-22 10:30:00,0.54,1.06,0.84,180,138,200,28,10,18,33,16,17,10,6,4,+1,0,+1,74%,78%,72%,105,78,126,38%,32%,41%,1,0,1,0,0,0
208,https://vlr.gg/player/21584/deminatix,2024-06-22 10:30:00,0.57,0.97,0.81,230,196,236,29,11,18,36,16,20,9,4,5,-3,-3,0,67%,61%,72%,145,129,158,21%,31%,17%,7,3,4,10,6,4
209,https://vlr.gg/player/21865/merz,2024-06-22 10:30:00,0.77,0.29,0.49,110,167,90,16,10,6,38,15,23,13,6,7,-1,+1,-2,56%,61%,52%,82,108,63,23%,21%,25%,3,1,2,4,0,4
210,https://vlr.gg/player/22495/mochi,2024-06-22 10:00:00,1.78,1.72,1.74,287,309,274,22,9,13,10,4,6,7,2,5,+4,+2,+2,89%,86%,92%,165,172,162,23%,23%,23%,5,2,3,1,0,1
211,https://vlr.gg/player/6101/999kvmil,2024-06-22 10:00:00,0.96,1.54,1.33,286,202,336,21,5,16,11,5,6,5,3,2,+4,+1,+3,89%,86%,92%,177,132,203,28%,19%,31%,4,1,3,0,0,0
212,https://vlr.gg/player/1353/dext,2024-06-22 10:00:00,1.13,1.10,1.11,223,222,225,16,6,10,13,4,9,0,0,0,+2,0,+2,68%,57%,75%,149,151,148,48%,50%,47%,3,1,2,1,1,0
213,https://vlr.gg/player/9557/nefi,2024-06-22 10:00:00,0.81,0.94,0.89,150,191,127,9,5,4,11,6,5,6,0,6,+1,+1,0,84%,71%,92%,100,108,96,28%,38%,21%,2,1,1,1,0,1
214,https://vlr.gg/player/15487/aqua,2024-06-22 10:00:00,0.61,0.98,0.84,153,151,156,10,3,7,14,6,8,11,4,7,0,+1,-1,79%,86%,75%,102,110,98,28%,33%,25%,1,1,0,1,0,1
215,https://vlr.gg/player/42155/h4te,2024-06-22 10:00:00,1.22,0.92,1.11,220,241,186,14,9,5,14,9,5,7,6,1,-1,-1,0,79%,75%,86%,157,182,113,30%,26%,40%,0,0,0,1,1,0
216,https://vlr.gg/player/23179/hiiro,2024-06-22 10:00:00,1.26,0.35,0.92,210,265,116,14,11,3,15,9,6,4,4,0,-4,-3,-1,58%,75%,29%,145,183,79,36%,34%,40%,1,1,0,5,4,1
217,https://vlr.gg/player/18217/kylou,2024-06-22 10:00:00,0.54,1.58,0.92,206,107,377,13,3,10,17,10,7,4,3,1,-2,0,-2,63%,58%,71%,128,88,197,39%,29%,50%,1,1,0,3,1,2
218,https://vlr.gg/player/6117/kayn,2024-06-22 10:00:00,0.77,0.85,0.80,199,213,177,12,8,4,16,11,5,9,3,6,-2,-1,-1,68%,67%,71%,134,156,96,18%,19%,14%,0,0,0,2,1,1
219,https://vlr.gg/player/22952/caim,2024-06-22 10:00:00,0.16,0.93,0.44,113,72,185,6,3,3,16,11,5,5,1,4,-2,-1,-1,63%,42%,100%,77,43,135,18%,8%,25%,2,1,1,4,2,2
220,https://vlr.gg/player/9803/d4v41,2024-06-22 07:50:00,1.28,1.31,1.29,235,230,235,48,31,17,31,19,12,9,4,5,+6,+4,+2,75%,75%,75%,160,152,174,30%,21%,41%,9,6,3,3,2,1
221,https://vlr.gg/player/9801/f0rsaken,2024-06-22 07:50:00,1.25,1.12,1.21,229,226,240,45,29,16,35,20,15,24,16,8,+3,+2,+1,75%,83%,60%,151,143,164,32%,30%,34%,8,4,4,5,2,3
222,https://vlr.gg/player/9800/mindfreak,2024-06-22 07:50:00,1.25,0.99,1.16,197,190,201,38,24,14,28,16,12,18,15,3,0,-1,+1,79%,75%,85%,124,128,118,48%,45%,54%,3,1,2,3,2,1
223,https://vlr.gg/player/17086/something,2024-06-22 07:50:00,1.22,0.79,1.07,223,263,144,43,34,9,37,23,14,12,7,5,-1,0,-1,73%,81%,60%,144,168,100,26%,25%,27%,5,4,1,6,4,2
224,https://vlr.gg/player/7378/jinggg,2024-06-22 07:50:00,1.24,0.63,1.02,222,259,156,46,34,12,38,22,16,18,10,8,0,-1,+1,80%,81%,80%,140,164,98,28%,31%,22%,7,5,2,7,6,1
225,https://vlr.gg/player/804/buzz,2024-06-22 07:50:00,1.47,0.75,1.01,230,340,175,46,25,21,48,16,32,9,2,7,-2,0,-2,54%,65%,47%,143,191,116,20%,19%,22%,8,5,3,10,5,5
226,https://vlr.gg/player/35013/flashback,2024-06-22 07:50:00,0.76,1.00,0.91,215,170,239,39,11,28,50,15,35,26,15,11,+4,-1,+5,70%,75%,67%,135,118,145,23%,18%,25%,9,1,8,5,2,3
227,https://vlr.gg/player/4678/beyn,2024-06-22 07:50:00,1.04,0.71,0.83,153,151,157,29,12,17,41,11,30,17,4,13,0,0,0,71%,85%,64%,96,92,98,29%,33%,27%,4,1,3,4,1,3
228,https://vlr.gg/player/11600/foxy9,2024-06-22 07:50:00,1.05,0.71,0.80,147,171,140,28,13,15,40,13,27,13,3,10,-4,-2,-2,64%,70%,61%,101,122,90,31%,39%,26%,1,0,1,5,2,3
229,https://vlr.gg/player/4462/mako,2024-06-22 07:50:00,0.76,0.60,0.66,154,152,153,27,9,18,42,13,29,12,5,7,-6,-1,-5,66%,80%,58%,103,116,95,26%,24%,28%,2,1,1,8,2,6
230,https://vlr.gg/player/3520/zmjjkk,2024-06-22 07:00:00,,,,286,,,67,,,46,,,8,,,+5,,,,,,183,,,20%,,,15,,,10,,
231,https://vlr.gg/player/4742/smoggy,2024-06-22 07:00:00,,,,201,,,45,,,50,,,19,,,-4,,,,,,134,,,31%,,,4,,,8,,
232,https://vlr.gg/player/3017/nobody,2024-06-22 07:00:00,,,,198,,,43,,,51,,,25,,,+2,,,,,,134,,,19%,,,6,,,4,,
233,https://vlr.gg/player/15559/chichoo,2024-06-22 07:00:00,,,,194,,,47,,,43,,,19,,,-5,,,,,,138,,,24%,,,1,,,6,,
234,https://vlr.gg/player/4720/haodong,2024-06-22 07:00:00,,,,123,,,26,,,49,,,25,,,-4,,,,,,82,,,23%,,,4,,,8,,
235,https://vlr.gg/player/14125/spring,2024-06-22 07:00:00,,,,269,,,62,,,54,,,15,,,+2,,,,,,181,,,28%,,,15,,,13,,
236,https://vlr.gg/player/11218/yuicaw,2024-06-22 07:00:00,,,,229,,,51,,,46,,,34,,,+3,,,,,,152,,,34%,,,7,,,4,,
237,https://vlr.gg/player/871/pl1xx,2024-06-22 07:00:00,,,,185,,,44,,,44,,,22,,,-2,,,,,,120,,,22%,,,5,,,7,,
238,https://vlr.gg/player/14441/aluba,2024-06-22 07:00:00,,,,176,,,42,,,48,,,15,,,+4,,,,,,111,,,25%,,,8,,,4,,
239,https://vlr.gg/player/7849/siufatbb,2024-06-22 07:00:00,,,,169,,,40,,,36,,,24,,,-1,,,,,,115,,,25%,,,1,,,2,,
240,https://vlr.gg/player/14445/ac,2024-06-22 05:00:00,,,,220,,,31,,,32,,,15,,,-4,,,,,,139,,,26%,,,1,,,5,,
241,https://vlr.gg/player/25339/lockm,2024-06-22 05:00:00,,,,194,,,29,,,29,,,16,,,-2,,,,,,125,,,39%,,,2,,,4,,
242,https://vlr.gg/player/488/rb,2024-06-22 05:00:00,,,,191,,,27,,,35,,,14,,,-4,,,,,,118,,,43%,,,5,,,9,,
243,https://vlr.gg/player/5011/abo,2024-06-22 05:00:00,,,,166,,,25,,,32,,,11,,,-4,,,,,,109,,,39%,,,4,,,8,,
244,https://vlr.gg/player/4778/kawaii,2024-06-22 05:00:00,,,,156,,,22,,,31,,,5,,,0,,,,,,113,,,26%,,,2,,,2,,
245,https://vlr.gg/player/4881/spitfires,2024-06-22 05:00:00,,,,294,,,43,,,36,,,6,,,+12,,,,,,199,,,34%,,,18,,,6,,
246,https://vlr.gg/player/25949/bunt,2024-06-22 05:00:00,,,,229,,,35,,,21,,,16,,,-2,,,,,,160,,,33%,,,2,,,4,,
247,https://vlr.gg/player/14431/monk,2024-06-22 05:00:00,,,,211,,,30,,,25,,,30,,,+3,,,,,,133,,,34%,,,4,,,1,,
248,https://vlr.gg/player/3049/sword9,2024-06-22 05:00:00,,,,171,,,26,,,26,,,11,,,-1,,,,,,117,,,24%,,,2,,,3,,
249,https://vlr.gg/player/10821/delb,2024-06-22 05:00:00,,,,166,,,25,,,26,,,10,,,+2,,,,,,115,,,38%,,,2,,,0,,
250,https://vlr.gg/player/13788/jitboys,2024-06-22 04:00:00,1.22,1.17,1.19,204,199,212,54,26,28,47,22,25,24,13,11,-2,0,-2,77%,81%,73%,138,134,141,36%,37%,35%,3,2,1,5,2,3
251,https://vlr.gg/player/5129/ban,2024-06-22 04:00:00,1.34,0.93,1.13,233,267,191,63,37,26,55,25,30,13,8,5,+3,+4,-1,72%,73%,70%,151,178,124,36%,38%,31%,15,9,6,12,5,7
252,https://vlr.gg/player/3977/crws,2024-06-22 04:00:00,1.08,0.88,0.98,166,169,172,41,22,19,45,19,26,19,9,10,-2,-2,0,72%,84%,59%,122,125,119,16%,31%,10%,2,0,2,4,2,2
253,https://vlr.gg/player/3980/governor,2024-06-22 04:00:00,0.96,0.98,0.97,211,216,209,57,30,27,56,26,30,17,6,11,+4,+3,+1,73%,78%,68%,140,136,144,28%,21%,36%,15,8,7,11,5,6
254,https://vlr.gg/player/23062/surf,2024-06-22 04:00:00,0.84,0.71,0.77,151,157,140,38,21,17,51,25,26,17,12,5,+1,0,+1,66%,76%,57%,97,94,100,39%,34%,45%,4,2,2,3,2,1
255,https://vlr.gg/player/24895/jemkin,2024-06-22 04:00:00,1.45,0.99,1.22,224,246,198,65,38,27,44,19,25,9,5,4,0,+2,-2,76%,84%,68%,143,154,132,29%,41%,19%,6,3,3,6,1,5
256,https://vlr.gg/player/8497/monyet,2024-06-22 04:00:00,1.01,1.10,1.06,231,217,255,60,30,30,54,27,27,19,7,12,+3,0,+3,76%,76%,76%,159,148,169,38%,34%,41%,13,6,7,10,6,4
257,https://vlr.gg/player/25025/estrella,2024-06-22 04:00:00,0.87,0.87,0.87,151,147,149,38,19,19,47,22,25,25,16,9,-3,+1,-4,65%,70%,59%,89,84,93,22%,22%,22%,3,3,0,6,2,4
258,https://vlr.gg/player/7764/lmemore,2024-06-22 04:00:00,0.91,0.82,0.86,191,190,188,48,25,23,56,26,30,13,6,7,-2,-2,0,65%,70%,59%,126,125,128,28%,31%,25%,9,3,6,11,5,6
259,https://vlr.gg/player/4871/xffero,2024-06-22 04:00:00,0.98,0.68,0.83,174,198,145,41,24,17,52,24,28,21,14,7,-2,0,-2,65%,73%,57%,123,140,106,30%,29%,30%,4,4,0,6,4,2
260,https://vlr.gg/player/10718/rowancy,2024-06-21 21:00:00,1.23,0.78,1.06,208,254,175,27,20,7,32,18,14,14,6,8,+4,+2,+2,67%,67%,67%,146,160,126,15%,11%,24%,4,2,2,0,0,0
261,https://vlr.gg/player/26757/otaq,2024-06-21 21:00:00,0.69,1.14,0.87,194,168,237,25,13,12,35,21,14,22,11,11,+3,0,+3,72%,67%,80%,130,122,144,20%,29%,12%,4,1,3,1,1,0
262,https://vlr.gg/player/10556/drakk,2024-06-21 21:00:00,0.61,0.94,0.74,206,199,216,26,16,10,34,22,12,6,3,3,0,-2,+2,51%,54%,47%,132,132,133,27%,47%,6%,6,3,3,6,5,1
263,https://vlr.gg/player/15931/peloncito,2024-06-21 21:00:00,0.66,0.62,0.64,135,157,131,18,12,6,33,21,12,9,5,4,-5,-1,-4,51%,54%,47%,95,99,88,38%,35%,41%,3,3,0,8,4,4
264,https://vlr.gg/player/2753/bandicoot,2024-06-21 21:00:00,0.66,0.61,0.64,130,133,106,17,11,6,31,19,12,11,6,5,-3,-3,0,59%,63%,53%,85,93,72,29%,35%,21%,2,1,1,5,4,1
265,https://vlr.gg/player/8056/mited,2024-06-21 21:00:00,1.59,1.22,1.36,212,257,184,32,16,16,20,6,14,24,6,18,+3,0,+3,85%,87%,83%,136,162,119,19%,17%,21%,4,1,3,1,1,0
266,https://vlr.gg/player/10557/darker,2024-06-21 21:00:00,1.16,1.38,1.30,245,231,266,36,13,23,26,10,16,18,6,12,+2,-1,+3,85%,73%,92%,167,157,173,28%,21%,34%,4,0,4,2,1,1
267,https://vlr.gg/player/7616/feniz,2024-06-21 21:00:00,0.81,1.50,1.24,200,112,264,29,6,23,19,7,12,15,5,10,+2,0,+2,85%,80%,88%,133,79,166,32%,23%,35%,3,1,2,1,1,0
268,https://vlr.gg/player/17690/jow,2024-06-21 21:00:00,2.04,0.73,1.23,210,336,132,31,20,11,21,6,15,9,2,7,+1,+2,-1,87%,93%,83%,138,225,83,36%,63%,10%,5,2,3,4,0,4
269,https://vlr.gg/player/3983/virtyy,2024-06-21 21:00:00,0.65,1.43,1.13,287,204,325,37,9,28,27,12,15,13,5,8,-7,-4,-3,72%,60%,79%,178,143,200,17%,24%,15%,4,2,2,11,6,5
270,https://vlr.gg/player/7716/penny,2024-06-21 19:10:00,1.83,1.82,1.83,338,339,331,41,32,9,14,10,4,4,1,3,+10,+7,+3,94%,92%,100%,225,219,244,25%,30%,13%,10,7,3,0,0,0
271,https://vlr.gg/player/69/thief,2024-06-21 19:10:00,1.17,1.82,1.33,242,214,332,31,19,12,19,14,5,2,2,0,+2,0,+2,72%,67%,88%,159,140,215,37%,33%,44%,6,4,2,4,4,0
272,https://vlr.gg/player/8742/jakee,2024-06-21 19:10:00,1.06,1.58,1.19,216,210,238,24,17,7,17,14,3,15,12,3,+5,+4,+1,88%,92%,75%,137,137,138,29%,31%,24%,5,4,1,0,0,0
273,https://vlr.gg/player/739/fiziq,2024-06-21 19:10:00,1.34,0.63,1.16,169,189,117,19,17,2,13,8,5,12,7,5,+2,+2,0,81%,83%,75%,121,131,91,28%,31%,17%,2,2,0,0,0,0
274,https://vlr.gg/player/1411/will,2024-06-21 19:10:00,1.17,1.00,1.13,202,191,217,22,17,5,16,10,6,15,9,6,+3,+3,0,84%,83%,88%,120,116,132,14%,24%,5%,4,3,1,1,0,1
275,https://vlr.gg/player/766/ange,2024-06-21 19:10:00,0.65,0.88,0.82,166,113,189,17,4,13,26,7,19,7,3,4,-3,-1,-2,66%,75%,63%,118,62,137,16%,23%,15%,1,0,1,4,1,3
276,https://vlr.gg/player/468/zachareee,2024-06-21 19:10:00,0.48,0.85,0.76,203,151,224,21,4,17,29,7,22,4,1,3,-6,-2,-4,53%,50%,54%,132,97,144,18%,18%,18%,2,1,1,8,3,5
277,https://vlr.gg/player/3012/riku,2024-06-21 19:10:00,0.39,0.69,0.62,170,116,186,16,3,13,29,7,22,6,1,5,-6,-1,-5,47%,50%,46%,107,79,116,18%,17%,19%,1,0,1,7,1,6
278,https://vlr.gg/player/71/drone,2024-06-21 19:10:00,0.99,0.48,0.61,111,188,88,13,6,7,25,7,18,8,3,5,-3,0,-3,66%,88%,58%,78,130,60,38%,50%,30%,0,0,0,3,0,3
279,https://vlr.gg/player/8118/precision,2024-06-21 19:10:00,0.76,0.45,0.53,132,219,104,12,6,6,28,7,21,10,2,8,-4,-2,-2,47%,63%,42%,78,113,66,20%,8%,30%,1,0,1,5,2,3
280,https://vlr.gg/player/1581/guhrvn,2024-06-21 18:10:00,1.52,1.34,1.41,238,241,233,34,14,20,19,7,12,10,4,6,+2,+2,0,75%,81%,71%,160,161,159,31%,32%,30%,3,2,1,1,0,1
281,https://vlr.gg/player/8873/dgzin,2024-06-21 18:10:00,1.47,1.29,1.37,273,308,249,39,18,21,22,9,13,4,2,2,+5,+3,+2,78%,81%,75%,167,200,144,29%,43%,15%,9,4,5,4,1,3
282,https://vlr.gg/player/660/pancc,2024-06-21 18:10:00,0.82,1.15,1.01,244,210,267,36,14,22,29,11,18,8,0,8,+4,0,+4,75%,75%,75%,163,139,178,28%,38%,24%,8,2,6,4,2,2
283,https://vlr.gg/player/20238/askia,2024-06-21 18:10:00,1.05,0.85,0.93,154,153,149,20,8,12,21,7,14,14,7,7,+1,0,+1,85%,88%,83%,103,113,96,23%,20%,25%,3,1,2,2,1,1
284,https://vlr.gg/player/25743/raafa,2024-06-21 18:10:00,1.04,0.84,0.92,180,173,191,29,10,19,26,7,19,11,5,6,+2,+1,+1,80%,81%,79%,113,99,122,40%,59%,33%,4,2,2,2,1,1
285,https://vlr.gg/player/1607/ntk,2024-06-21 18:10:00,0.99,1.17,1.06,227,235,220,31,19,12,32,20,12,6,3,3,+1,+2,-1,53%,58%,44%,149,148,151,19%,20%,18%,5,4,1,4,2,2
286,https://vlr.gg/player/22964/forbanz,2024-06-21 18:10:00,1.17,0.57,0.93,207,262,116,24,19,5,32,20,12,10,7,3,-4,-3,-1,68%,71%,63%,136,175,77,26%,30%,14%,3,2,1,7,5,2
287,https://vlr.gg/player/32717/maestr0,2024-06-21 18:10:00,0.61,1.12,0.81,162,111,244,21,9,12,32,19,13,18,9,9,-4,-3,-1,68%,67%,69%,98,59,157,21%,21%,21%,2,0,2,6,3,3
288,https://vlr.gg/player/3450/woddy,2024-06-21 18:10:00,0.80,0.80,0.80,162,173,160,25,16,9,29,17,12,2,0,2,-3,-2,-1,58%,54%,63%,105,110,96,30%,35%,22%,2,1,1,5,3,2
289,https://vlr.gg/player/32718/kenkayyy,2024-06-21 18:10:00,0.79,0.31,0.60,124,155,73,16,13,3,33,18,15,14,10,4,-4,-2,-2,63%,67%,56%,74,97,40,24%,24%,21%,1,1,0,5,3,2
290,https://vlr.gg/player/8892/snw,2024-06-21 18:00:00,1.16,1.48,1.31,294,279,310,57,29,28,38,23,15,12,5,7,+7,0,+7,74%,68%,81%,180,169,192,23%,30%,16%,16,7,9,9,7,2
291,https://vlr.gg/player/783/murizzz,2024-06-21 18:00:00,1.41,0.64,1.05,208,279,116,42,31,11,37,19,18,19,8,11,+4,+4,0,71%,77%,63%,130,180,72,30%,36%,19%,6,4,2,2,0,2
292,https://vlr.gg/player/2468/delz1k,2024-06-21 18:00:00,0.74,1.35,1.02,178,132,251,39,13,26,39,23,16,26,18,8,+1,-2,+3,71%,68%,74%,119,95,146,23%,22%,24%,5,1,4,4,3,1
293,https://vlr.gg/player/2464/suther,2024-06-21 18:00:00,0.91,0.87,0.88,156,161,158,30,15,15,35,19,16,23,14,9,+1,0,+1,81%,81%,81%,106,111,101,23%,22%,25%,3,2,1,2,2,0
294,https://vlr.gg/player/1294/nagz,2024-06-21 18:00:00,0.84,0.82,0.83,155,151,168,30,16,14,38,21,17,14,3,11,-1,-1,0,67%,55%,81%,109,108,110,18%,24%,13%,5,2,3,6,3,3
295,https://vlr.gg/player/8286/glyph,2024-06-21 18:00:00,1.29,1.18,1.23,238,212,247,49,20,29,37,15,22,14,7,7,-4,-1,-3,71%,70%,71%,142,132,151,27%,28%,27%,2,0,2,6,1,5
296,https://vlr.gg/player/8792/xhowi,2024-06-21 18:00:00,1.03,0.98,1.00,209,209,196,41,19,22,41,20,21,5,1,4,-1,+1,-2,66%,63%,68%,136,137,135,40%,46%,35%,4,4,0,5,3,2
297,https://vlr.gg/player/8790/mininiwde,2024-06-21 18:00:00,1.41,0.63,0.99,188,240,144,40,25,15,41,18,23,14,8,6,-1,-1,0,64%,70%,58%,131,163,103,34%,35%,33%,2,1,1,3,2,1
298,https://vlr.gg/player/2490/jfoen,2024-06-21 18:00:00,0.59,1.24,0.93,150,101,184,28,8,20,38,19,19,31,11,20,-5,-3,-2,66%,67%,65%,87,62,109,30%,19%,39%,3,0,3,8,3,5
299,https://vlr.gg/player/13962/nate,2024-06-21 18:00:00,0.47,1.02,0.77,169,123,194,29,10,19,41,22,19,8,3,5,-1,-7,+6,69%,63%,74%,102,77,124,27%,34%,23%,12,3,9,13,10,3
300,https://vlr.gg/player/27149/brinks,2024-06-21 16:00:00,1.18,1.22,1.20,216,205,227,28,16,12,26,17,9,7,6,1,+1,+2,-1,79%,88%,64%,145,146,145,29%,34%,22%,3,3,0,2,1,1
301,https://vlr.gg/player/1567/bezn1,2024-06-21 16:00:00,0.93,1.23,1.04,231,213,294,34,18,16,33,21,12,7,3,4,-1,-1,0,68%,58%,86%,159,146,181,29%,22%,39%,2,1,1,3,2,1
302,https://vlr.gg/player/1684/denaro,2024-06-21 16:00:00,0.88,1.01,0.91,186,194,183,22,13,9,31,21,10,14,10,4,+1,+1,0,68%,71%,64%,131,139,118,36%,33%,42%,2,2,0,1,1,0
303,https://vlr.gg/player/1566/prozin,2024-06-21 16:00:00,0.52,0.75,0.61,149,133,178,18,11,7,34,22,12,18,11,7,0,-3,+3,76%,75%,79%,89,74,116,24%,18%,30%,4,0,4,4,3,1
304,https://vlr.gg/player/1999/rnd,2024-06-21 16:00:00,0.19,0.72,0.39,143,139,162,17,10,7,36,25,11,5,2,3,-9,-9,0,61%,50%,79%,94,86,108,30%,33%,25%,4,1,3,13,10,3
305,https://vlr.gg/player/21251/blowz,2024-06-21 16:00:00,0.92,1.80,1.47,269,182,317,38,8,30,21,10,11,14,7,7,+3,0,+3,84%,71%,92%,185,140,212,27%,21%,30%,5,1,4,2,1,1
306,https://vlr.gg/player/5722/prince,2024-06-21 16:00:00,1.14,1.48,1.36,216,198,238,32,12,20,18,8,10,13,2,11,+3,-1,+4,79%,57%,92%,150,125,165,30%,22%,35%,5,0,5,2,1,1
307,https://vlr.gg/player/2486/pollo,2024-06-21 16:00:00,1.25,1.14,1.18,214,203,213,27,10,17,23,8,15,13,4,9,+3,0,+3,84%,79%,88%,143,140,146,27%,28%,25%,3,0,3,0,0,0
308,https://vlr.gg/player/42867/ghoul33,2024-06-21 16:00:00,1.39,0.97,1.13,268,336,240,38,17,21,31,12,19,6,2,4,+2,+2,0,71%,71%,71%,195,230,175,44%,56%,37%,8,5,3,6,3,3
309,https://vlr.gg/player/1578/shion,2024-06-21 16:00:00,0.47,1.33,1.01,215,151,219,25,7,18,26,13,13,27,7,20,-3,-3,0,79%,71%,83%,138,104,158,19%,19%,19%,2,0,2,5,3,2
310,https://vlr.gg/player/29688/mikee,2024-06-21 16:00:00,1.24,0.85,1.03,211,238,187,44,25,19,44,19,25,8,3,5,+2,-2,+4,77%,82%,72%,152,188,121,38%,32%,47%,5,1,4,3,3,0
311,https://vlr.gg/player/8373/okeanos,2024-06-21 16:00:00,1.01,0.99,1.00,256,249,262,54,25,29,49,23,26,9,4,5,+9,+6,+3,77%,82%,72%,157,142,170,26%,25%,26%,17,10,7,8,4,4
312,https://vlr.gg/player/8422/spaz,2024-06-21 16:00:00,1.01,0.97,0.98,180,183,184,37,17,20,39,18,21,21,10,11,+1,0,+1,67%,75%,59%,125,127,124,15%,13%,17%,5,1,4,4,1,3
313,https://vlr.gg/player/4385/monsi,2024-06-21 16:00:00,0.80,0.94,0.87,173,163,188,34,14,20,43,19,24,30,16,14,-1,-3,+2,73%,68%,78%,116,116,117,28%,25%,32%,3,0,3,4,3,1
314,https://vlr.gg/player/3874/teague,2024-06-21 16:00:00,0.85,0.72,0.78,162,166,158,31,16,15,44,21,23,27,13,14,-1,-1,0,72%,86%,59%,103,103,103,34%,31%,38%,5,2,3,6,3,3
315,https://vlr.gg/player/260/corey,2024-06-21 16:00:00,1.28,1.26,1.27,244,254,233,53,30,23,39,19,20,25,14,11,-1,-2,+1,73%,69%,79%,161,163,158,40%,46%,35%,5,2,3,6,4,2
316,https://vlr.gg/player/733/stellar,2024-06-21 16:00:00,1.09,1.17,1.13,178,166,193,35,18,17,35,20,15,34,19,15,0,-1,+1,75%,69%,82%,117,100,136,17%,12%,24%,2,0,2,2,1,1
317,https://vlr.gg/player/1856/wedid,2024-06-21 16:00:00,1.05,1.11,1.08,228,199,246,46,22,24,44,21,23,24,13,11,-1,-1,0,72%,69%,75%,145,128,164,25%,22%,27%,3,1,2,4,2,2
318,https://vlr.gg/player/4931/add3r,2024-06-21 16:00:00,1.12,0.98,1.05,191,198,191,42,23,19,38,19,19,9,6,3,-1,-1,0,72%,72%,71%,129,128,131,29%,28%,31%,9,5,4,10,6,4
319,https://vlr.gg/player/844/bdog,2024-06-21 16:00:00,1.08,0.82,0.96,216,239,171,43,26,17,44,24,20,15,6,9,-7,-5,-2,67%,66%,68%,133,150,113,24%,23%,25%,6,3,3,13,8,5
320,https://vlr.gg/player/11/zyppan,2024-06-21 13:50:00,1.15,1.50,1.30,250,208,316,37,18,19,29,15,14,23,12,11,-1,-1,0,74%,75%,72%,170,155,189,42%,51%,35%,2,0,2,3,1,2
321,https://vlr.gg/player/2858/suygetsu,2024-06-21 13:50:00,1.15,0.61,0.92,203,237,130,26,19,7,28,16,12,9,6,3,+1,+2,-1,76%,83%,67%,127,162,81,25%,27%,22%,2,2,0,1,0,1
322,https://vlr.gg/player/98/ardiis,2024-06-21 13:50:00,0.84,1.01,0.89,211,235,206,33,20,13,33,20,13,3,2,1,-6,-5,-1,55%,54%,56%,142,150,133,23%,22%,25%,7,4,3,13,9,4
323,https://vlr.gg/player/384/shao,2024-06-21 13:50:00,1.07,0.59,0.86,180,203,159,27,17,10,34,17,17,12,7,5,+2,+1,+1,71%,79%,61%,130,138,119,38%,45%,32%,4,2,2,2,1,1
324,https://vlr.gg/player/109/ange1,2024-06-21 13:50:00,0.93,0.27,0.65,141,195,83,19,16,3,31,16,15,13,8,5,-4,-1,-3,50%,58%,39%,102,125,72,42%,45%,33%,2,2,0,6,3,3
325,https://vlr.gg/player/573/cned,2024-06-21 13:50:00,1.57,1.06,1.28,274,303,234,40,21,19,30,11,19,6,1,5,+9,+4,+5,69%,78%,63%,166,192,146,34%,36%,32%,11,5,6,2,1,1
326,https://vlr.gg/player/1139/qraxs,2024-06-21 13:50:00,1.53,0.93,1.19,200,217,187,30,16,14,27,8,19,19,10,9,-1,-1,0,74%,78%,71%,131,136,127,38%,39%,38%,0,0,0,1,1,0
327,https://vlr.gg/player/8044/mrfalin,2024-06-21 13:50:00,1.26,1.10,1.17,236,263,206,32,14,18,28,12,16,20,13,7,+1,+2,-1,79%,89%,71%,155,173,141,27%,23%,31%,6,3,3,5,1,4
328,https://vlr.gg/player/8369/yetujey,2024-06-21 13:50:00,1.01,1.14,1.08,199,197,206,29,13,16,26,11,15,10,2,8,0,+2,-2,74%,78%,71%,130,120,137,19%,15%,22%,4,3,1,4,1,3
329,https://vlr.gg/player/6510/atakaptan,2024-06-21 13:50:00,0.77,0.80,0.79,152,103,195,24,7,17,31,10,21,13,7,6,-1,-3,+2,71%,72%,71%,97,62,123,33%,27%,36%,4,0,4,5,3,2
330,https://vlr.gg/player/16459/elite,2024-06-21 12:00:00,0.75,0.93,0.87,199,191,202,28,10,18,28,12,16,6,3,3,0,+1,-1,62%,46%,71%,120,93,135,43%,32%,49%,4,3,1,4,2,2
331,https://vlr.gg/player/10146/reazy,2024-06-21 12:00:00,0.46,1.00,0.81,163,148,173,23,6,17,27,12,15,4,3,1,-1,0,-1,54%,46%,58%,105,101,108,25%,18%,29%,1,0,1,2,0,2
332,https://vlr.gg/player/10161/qutionerx,2024-06-21 12:00:00,0.41,0.76,0.64,189,140,215,20,6,14,31,12,19,10,3,7,+1,-2,+3,70%,69%,71%,130,90,152,33%,33%,33%,6,1,5,5,3,2
333,https://vlr.gg/player/569/paura,2024-06-21 12:00:00,0.51,0.60,0.57,119,129,114,16,6,10,29,12,17,9,2,7,-3,0,-3,59%,54%,63%,81,78,82,41%,50%,36%,2,1,1,5,1,4
334,https://vlr.gg/player/8041/brave,2024-06-21 12:00:00,0.56,0.51,0.53,146,179,129,17,7,10,30,12,18,8,5,3,0,0,0,62%,62%,63%,96,111,88,28%,22%,32%,4,1,3,4,1,3
335,https://vlr.gg/player/2173/magnum,2024-06-21 12:00:00,1.22,1.65,1.37,200,191,218,28,17,11,19,13,6,19,11,8,-2,-2,0,84%,75%,100%,127,124,134,45%,55%,30%,3,2,1,5,4,1
336,https://vlr.gg/player/36245/n4rrate,2024-06-21 12:00:00,0.97,1.93,1.31,248,200,340,32,16,16,23,17,6,14,5,9,+4,+3,+1,81%,79%,85%,169,135,230,29%,33%,25%,7,5,2,3,2,1
337,https://vlr.gg/player/19691/tomaszy,2024-06-21 12:00:00,1.30,1.31,1.30,190,197,180,28,19,9,18,12,6,6,3,3,0,-1,+1,81%,79%,85%,126,135,108,42%,43%,42%,2,0,2,2,1,1
338,https://vlr.gg/player/10307/marteen,2024-06-21 12:00:00,1.25,1.27,1.26,234,227,240,31,19,12,22,14,8,9,5,4,+1,+3,-2,84%,83%,85%,154,152,158,32%,34%,28%,5,4,1,4,1,3
339,https://vlr.gg/player/2625/sh1n,2024-06-21 12:00:00,1.05,1.37,1.16,201,151,288,26,14,12,22,13,9,21,11,10,0,-1,+1,92%,92%,92%,139,106,199,39%,45%,33%,3,2,1,3,3,0
340,https://vlr.gg/player/3342/sushiboys,2024-06-21 10:00:00,1.00,1.57,1.29,204,166,240,33,12,21,23,13,10,28,14,14,+1,-1,+2,76%,73%,79%,144,128,159,24%,24%,24%,4,1,3,3,2,1
341,https://vlr.gg/player/27254/leviathan,2024-06-21 10:00:00,1.24,1.07,1.16,224,238,213,35,19,16,30,15,15,16,6,10,0,0,0,78%,77%,79%,146,152,141,32%,36%,29%,4,2,2,4,2,2
342,https://vlr.gg/player/4377/johnolsen,2024-06-21 10:00:00,0.79,1.41,1.11,246,208,277,42,17,25,36,21,15,8,2,6,0,-1,+1,70%,64%,75%,169,142,194,26%,33%,20%,9,4,5,9,5,4
343,https://vlr.gg/player/3401/ptc,2024-06-21 10:00:00,1.23,0.93,1.07,208,243,175,32,18,14,31,15,16,13,5,8,-2,0,-2,70%,64%,75%,130,147,114,19%,27%,13%,2,1,1,4,1,3
344,https://vlr.gg/player/6723/foxz,2024-06-21 10:00:00,0.90,0.92,0.91,197,178,216,34,15,19,34,16,18,10,4,6,+3,0,+3,74%,68%,79%,126,131,121,24%,22%,25%,5,2,3,2,2,0
345,https://vlr.gg/player/14674/kntz,2024-06-21 10:00:00,1.22,0.90,1.07,198,219,178,33,19,14,30,16,14,10,4,6,+1,+1,0,74%,75%,73%,135,142,128,34%,36%,32%,2,1,1,1,0,1
346,https://vlr.gg/player/24679/cgrs,2024-06-21 10:00:00,0.92,1.09,1.00,210,180,243,31,12,19,33,16,17,12,8,4,0,+1,-1,78%,83%,73%,147,134,160,25%,17%,33%,3,2,1,3,1,2
347,https://vlr.gg/player/12098/kadoom,2024-06-21 10:00:00,0.91,0.81,0.86,217,231,206,34,19,15,39,21,18,6,4,2,+2,+1,+1,65%,58%,73%,149,166,131,26%,26%,26%,8,3,5,6,2,4
348,https://vlr.gg/player/13784/killua,2024-06-21 10:00:00,0.82,0.89,0.85,190,189,190,32,17,15,36,21,15,5,1,4,-3,-3,0,70%,63%,77%,116,115,119,36%,46%,27%,4,3,1,7,6,1
349,https://vlr.gg/player/27244/seph1roth,2024-06-21 10:00:00,0.28,1.08,0.66,160,93,233,24,7,17,38,21,17,13,5,8,-2,-4,+2,54%,46%,64%,103,59,151,31%,30%,31%,5,1,4,7,5,2
350,https://vlr.gg/player/24653/vera,2024-06-21 09:05:00,1.02,1.61,1.36,293,249,310,36,12,24,22,13,9,11,6,5,+8,+2,+6,89%,73%,100%,172,151,188,21%,25%,17%,11,5,6,3,3,0
351,https://vlr.gg/player/24628/wayne,2024-06-21 09:05:00,1.04,1.46,1.28,237,226,237,31,13,18,22,10,12,20,7,13,+2,+1,+1,81%,80%,81%,140,109,162,31%,28%,33%,5,1,4,3,0,3
352,https://vlr.gg/player/7426/juicy,2024-06-21 09:05:00,1.17,1.36,1.28,251,245,266,35,14,21,22,10,12,10,3,7,0,-2,+2,86%,87%,86%,187,182,191,27%,34%,23%,2,0,2,2,2,0
353,https://vlr.gg/player/34032/grumble,2024-06-21 09:05:00,0.72,1.58,1.22,213,125,264,30,8,22,16,8,8,12,1,11,+2,-1,+3,81%,60%,95%,133,86,167,36%,47%,32%,4,1,3,2,2,0
354,https://vlr.gg/player/11704/styron,2024-06-21 09:05:00,1.37,1.06,1.19,171,211,139,21,12,9,14,6,8,12,4,8,0,+1,-1,83%,87%,81%,107,124,94,18%,31%,11%,2,1,1,2,0,2
355,https://vlr.gg/player/7418/bryce,2024-06-21 09:05:00,0.87,1.33,1.06,231,173,292,27,13,14,30,19,11,8,3,5,-1,-1,0,69%,57%,87%,141,114,180,25%,22%,27%,4,1,3,5,2,3
356,https://vlr.gg/player/7417/joshh,2024-06-21 09:05:00,0.67,0.99,0.80,135,134,160,17,9,8,28,17,11,15,9,6,-2,-3,+1,61%,57%,67%,92,74,116,27%,19%,38%,1,0,1,3,3,0
357,https://vlr.gg/player/10703/shiba,2024-06-21 09:05:00,0.76,0.65,0.72,173,181,161,19,11,8,31,19,12,10,6,4,+2,+1,+1,64%,62%,67%,113,116,109,24%,25%,22%,3,1,2,1,0,1
358,https://vlr.gg/player/42389/persona11,2024-06-21 09:05:00,0.33,0.81,0.53,132,117,173,18,8,10,32,20,12,3,2,1,-7,-7,0,42%,43%,40%,91,87,98,24%,24%,23%,3,2,1,10,9,1
359,https://vlr.gg/player/34031/inf,2024-06-21 09:05:00,0.43,0.47,0.45,115,106,150,15,8,7,33,20,13,5,3,2,-4,-1,-3,44%,38%,53%,83,76,94,16%,15%,18%,1,1,0,5,2,3
360,https://vlr.gg/player/14227/nhatthong2k,2024-06-21 08:50:00,1.26,0.98,1.12,269,328,218,33,19,14,32,16,16,4,2,2,-1,+1,-2,74%,82%,67%,170,196,145,38%,45%,31%,9,6,3,10,5,5
361,https://vlr.gg/player/14216/vizzz,2024-06-21 08:50:00,0.98,0.75,0.86,161,145,174,17,8,9,30,13,17,25,16,9,0,-1,+1,74%,82%,67%,101,96,106,23%,25%,21%,1,0,1,1,1,0
362,https://vlr.gg/player/21807/somethai,2024-06-21 08:50:00,1.04,0.58,0.81,202,229,180,24,13,11,32,15,17,11,6,5,-1,0,-1,71%,88%,56%,124,135,115,47%,46%,47%,2,1,1,3,1,2
363,https://vlr.gg/player/1431/p1na,2024-06-21 08:50:00,0.58,0.58,0.58,132,132,131,16,8,8,29,13,16,12,4,8,-2,-1,-1,66%,59%,72%,83,79,88,31%,40%,25%,0,0,0,2,1,1
364,https://vlr.gg/player/1433/hyzee,2024-06-21 08:50:00,0.59,0.20,0.39,123,146,101,14,9,5,33,15,18,7,4,3,-5,-2,-3,49%,65%,33%,89,107,71,23%,22%,25%,1,0,1,6,2,4
365,https://vlr.gg/player/23042/tripciew,2024-06-21 08:50:00,1.80,1.60,1.70,285,277,295,37,20,17,15,6,9,18,7,11,+2,+1,+1,86%,89%,82%,184,188,181,37%,41%,33%,5,2,3,3,1,2
366,https://vlr.gg/player/44149/pr0digy,2024-06-21 08:50:00,1.74,1.02,1.53,323,378,193,22,18,4,12,8,4,1,0,1,+2,+1,+1,76%,83%,60%,226,251,166,44%,43%,50%,3,2,1,1,1,0
367,https://vlr.gg/player/14553/b-nhmj,2024-06-21 08:50:00,1.63,0.76,1.21,228,286,162,29,19,10,21,9,12,9,2,7,0,+2,-2,83%,89%,76%,148,188,106,30%,36%,21%,5,4,1,5,2,3
368,https://vlr.gg/player/14209/suka,2024-06-21 08:50:00,1.13,1.27,1.20,229,210,252,31,14,17,22,10,12,15,6,9,+2,+1,+1,83%,78%,88%,144,129,159,25%,21%,30%,5,3,2,3,2,1
369,https://vlr.gg/player/19154/albus,2024-06-21 08:50:00,1.15,1.14,1.15,245,175,281,15,4,11,12,3,9,4,1,3,0,0,0,72%,83%,67%,176,148,189,23%,36%,19%,1,0,1,1,0,1
370,https://vlr.gg/player/14587/daft,2024-06-21 08:50:00,1.01,1.11,1.06,189,163,220,22,9,13,22,11,11,23,18,5,+3,+1,+2,83%,89%,76%,134,122,146,27%,21%,36%,3,1,2,0,0,0
371,https://vlr.gg/player/872/autumn,2024-06-21 08:15:00,,,,254,,,59,,,47,,,8,,,-1,,,,,,173,,,34%,,,4,,,5,,
372,https://vlr.gg/player/3028/life,2024-06-21 08:15:00,,,,212,,,49,,,46,,,10,,,-5,,,,,,143,,,30%,,,14,,,19,,
373,https://vlr.gg/player/37489/lysoar,2024-06-21 08:15:00,,,,201,,,47,,,40,,,28,,,-1,,,,,,132,,,31%,,,3,,,4,,
374,https://vlr.gg/player/7857/berlin,2024-06-21 08:15:00,,,,173,,,34,,,46,,,34,,,+3,,,,,,110,,,33%,,,6,,,3,,
375,https://vlr.gg/player/19530/aaaay,2024-06-21 08:15:00,,,,160,,,33,,,45,,,18,,,-3,,,,,,102,,,35%,,,2,,,5,,
376,https://vlr.gg/player/4770/fengf,2024-06-21 08:15:00,,,,242,,,60,,,44,,,7,,,+4,,,,,,170,,,31%,,,11,,,7,,
377,https://vlr.gg/player/3021/biank,2024-06-21 08:15:00,,,,192,,,43,,,46,,,21,,,-3,,,,,,118,,,15%,,,4,,,7,,
378,https://vlr.gg/player/37494/kai,2024-06-21 08:15:00,,,,189,,,45,,,43,,,11,,,+1,,,,,,112,,,25%,,,12,,,11,,
379,https://vlr.gg/player/3045/luok1ng,2024-06-21 08:15:00,,,,164,,,38,,,42,,,27,,,+3,,,,,,102,,,25%,,,6,,,3,,
380,https://vlr.gg/player/4712/heybay,2024-06-21 08:15:00,,,,156,,,37,,,46,,,27,,,+2,,,,,,104,,,21%,,,3,,,1,,
381,https://vlr.gg/player/23918/reality,2024-06-21 07:00:00,1.25,1.21,1.23,209,238,188,46,20,26,34,14,20,11,2,9,-4,-4,0,76%,78%,75%,142,154,135,31%,33%,29%,5,1,4,9,5,4
382,https://vlr.gg/player/6733/xze,2024-06-21 07:00:00,1.04,1.14,1.10,222,195,237,46,17,29,43,16,27,20,5,15,-1,-1,0,78%,78%,78%,136,123,144,48%,52%,47%,6,1,5,7,2,5
383,https://vlr.gg/player/2390/pinocchios,2024-06-21 07:00:00,1.33,0.92,1.08,196,199,190,39,16,23,37,11,26,18,5,13,+4,+3,+1,76%,74%,78%,129,114,138,22%,15%,27%,8,4,4,4,1,3
384,https://vlr.gg/player/19150/niffy,2024-06-21 07:00:00,0.62,1.32,1.05,202,118,256,40,9,31,40,17,23,18,5,13,0,0,0,73%,57%,83%,142,80,181,19%,10%,23%,7,4,3,7,4,3
385,https://vlr.gg/player/1910/acetics,2024-06-21 07:00:00,1.25,0.90,1.04,172,194,158,35,16,19,37,13,24,22,9,13,+2,+1,+1,78%,78%,78%,109,124,99,27%,22%,31%,4,1,3,2,0,2
386,https://vlr.gg/player/37547/tbloy,2024-06-21 07:00:00,0.95,1.14,1.02,252,253,260,52,31,21,43,29,14,8,5,3,+1,0,+1,75%,72%,78%,164,151,184,20%,21%,19%,12,8,4,11,8,3
387,https://vlr.gg/player/1908/kongared,2024-06-21 07:00:00,1.07,0.84,0.98,169,174,160,36,23,13,37,21,16,18,10,8,-4,-4,0,71%,75%,65%,108,109,106,30%,27%,34%,1,0,1,5,4,1
388,https://vlr.gg/player/8581/raigard,2024-06-21 07:00:00,1.12,0.64,0.92,211,241,167,42,31,11,42,25,17,17,10,7,+1,+2,-1,73%,78%,65%,140,152,121,25%,24%,28%,9,4,5,8,2,6
389,https://vlr.gg/player/40511/niz,2024-06-21 07:00:00,0.78,0.90,0.83,160,172,152,34,21,13,41,27,14,14,7,7,0,-1,+1,66%,61%,74%,116,125,101,32%,36%,26%,3,2,1,3,3,0
390,https://vlr.gg/player/4376/santagolf,2024-06-21 07:00:00,0.54,0.79,0.64,133,110,174,27,14,13,43,26,17,8,4,4,+1,+1,0,64%,64%,65%,87,66,121,35%,29%,41%,4,3,1,3,2,1
391,https://vlr.gg/player/36685/splash,2024-06-21 07:00:00,1.30,1.55,1.44,291,292,293,42,19,23,27,13,14,6,4,2,+7,+5,+2,87%,88%,86%,203,195,210,27%,29%,25%,11,8,3,4,3,1
392,https://vlr.gg/player/2377/aduka,2024-06-21 07:00:00,1.76,1.00,1.34,221,304,161,32,19,13,20,8,12,12,8,4,-1,+1,-2,87%,94%,81%,147,195,107,25%,23%,32%,2,1,1,3,0,3
393,https://vlr.gg/player/44919/aplycs,2024-06-21 07:00:00,1.21,1.21,1.21,240,196,271,34,14,20,25,9,16,17,5,12,+4,0,+4,82%,76%,86%,148,124,167,37%,32%,40%,7,1,6,3,1,2
394,https://vlr.gg/player/8156/mojo,2024-06-21 07:00:00,1.11,1.26,1.19,180,162,187,23,10,13,20,8,12,24,9,15,+1,0,+1,79%,82%,76%,118,105,130,19%,19%,19%,1,0,1,0,0,0
395,https://vlr.gg/player/36704/impecunity,2024-06-21 07:00:00,0.93,0.82,0.86,204,166,234,28,11,17,28,9,19,8,1,7,+3,+1,+2,68%,65%,71%,150,127,168,16%,14%,18%,5,2,3,2,1,1
396,https://vlr.gg/player/7513/markl,2024-06-21 07:00:00,1.34,0.75,1.08,217,285,147,31,22,9,28,15,13,7,5,2,-4,-2,-2,74%,81%,65%,154,191,108,26%,25%,27%,0,0,0,4,2,2
397,https://vlr.gg/player/3480/thedoctorr,2024-06-21 07:00:00,0.86,1.26,1.04,218,190,244,26,12,14,32,18,14,9,6,3,-4,-2,-2,71%,71%,71%,155,146,167,34%,23%,53%,1,1,0,5,3,2
398,https://vlr.gg/player/21051/jans0n,2024-06-21 07:00:00,0.89,0.55,0.74,184,186,169,22,14,8,33,17,16,10,6,4,-2,+1,-3,61%,71%,47%,130,129,133,28%,29%,27%,2,1,1,4,0,4
399,https://vlr.gg/player/2378/subbey,2024-06-21 07:00:00,0.58,0.93,0.74,157,126,198,19,9,10,31,17,14,13,8,5,-2,-3,+1,74%,76%,71%,113,96,134,31%,38%,26%,3,1,2,5,4,1
400,https://vlr.gg/player/45876/fixy,2024-06-21 07:00:00,0.78,0.30,0.57,173,223,117,22,16,6,35,19,16,4,3,1,-2,-1,-1,53%,67%,35%,110,133,81,24%,23%,25%,6,4,2,8,5,3
401,https://vlr.gg/player/33801/loydream,2024-06-21 06:10:00,1.05,1.29,1.13,282,258,256,30,20,10,31,23,8,16,10,6,+3,+1,+2,80%,79%,82%,162,163,159,28%,33%,18%,3,1,2,0,0,0
402,https://vlr.gg/player/26143/secondlove,2024-06-21 06:10:00,1.04,0.97,1.01,223,227,255,27,18,9,28,19,9,7,6,1,-1,0,-1,60%,67%,45%,161,148,188,36%,37%,33%,2,1,1,3,1,2
403,https://vlr.gg/player/24737/par-scofield,2024-06-21 06:10:00,0.49,0.99,0.65,138,154,180,20,13,7,30,22,8,2,1,1,-4,-3,-1,49%,46%,55%,114,105,134,38%,32%,50%,6,5,1,10,8,2
404,https://vlr.gg/player/46470/stazy,2024-06-21 06:10:00,0.72,0.43,0.63,139,170,75,15,13,2,29,22,7,12,11,1,-1,+1,-2,71%,71%,73%,98,115,59,29%,34%,9%,2,2,0,3,1,2
405,https://vlr.gg/player/21793/syko,2024-06-21 06:10:00,0.44,0.64,0.50,128,132,149,16,11,5,31,21,10,8,3,5,-2,-1,-1,63%,58%,73%,92,85,105,28%,52%,12%,2,2,0,4,3,1
406,https://vlr.gg/player/44259/patrickwho,2024-06-21 06:10:00,1.28,1.71,1.56,350,337,348,48,14,34,26,9,17,6,1,5,+4,+1,+3,83%,73%,88%,221,221,221,25%,30%,22%,7,2,5,3,1,2
407,https://vlr.gg/player/37375/chanyboi,2024-06-21 06:10:00,1.42,1.41,1.41,272,192,282,32,7,25,20,5,15,11,7,4,+3,+1,+2,89%,91%,88%,161,135,172,35%,37%,34%,4,1,3,1,0,1
408,https://vlr.gg/player/31398/ichisolo,2024-06-21 06:10:00,1.36,1.05,1.15,212,228,198,26,8,18,23,7,16,9,3,6,0,0,0,74%,82%,71%,151,169,143,23%,18%,26%,2,1,1,2,1,1
409,https://vlr.gg/player/10249/uyen,2024-06-21 06:10:00,1.09,1.19,1.15,178,159,210,23,6,17,20,6,14,14,6,8,+1,0,+1,83%,82%,83%,127,102,139,25%,25%,25%,4,1,3,3,1,2
410,https://vlr.gg/player/7435/astr0,2024-06-21 06:10:00,1.01,1.01,1.01,159,150,157,20,7,13,19,6,13,14,6,8,-3,+1,-4,77%,73%,79%,116,85,130,30%,20%,33%,3,2,1,6,1,5
411,https://vlr.gg/player/2348/famouz,2024-06-21 06:00:00,1.03,1.73,1.38,288,249,328,42,16,26,30,16,14,10,7,3,+4,0,+4,74%,67%,81%,188,173,204,16%,17%,15%,8,4,4,4,4,0
412,https://vlr.gg/player/4874/berserx,2024-06-21 06:00:00,1.45,1.29,1.37,247,239,255,39,19,20,24,10,14,5,2,3,+1,+1,0,79%,76%,81%,156,155,156,28%,27%,28%,2,1,1,1,0,1
413,https://vlr.gg/player/7043/ncslasher,2024-06-21 06:00:00,0.94,1.46,1.20,226,178,275,30,12,18,28,15,13,26,15,11,+1,+1,0,81%,71%,90%,154,110,199,27%,28%,27%,7,4,3,6,3,3
414,https://vlr.gg/player/10739/shiro,2024-06-21 06:00:00,1.58,0.79,1.18,200,250,149,31,21,10,24,10,14,21,7,14,-4,0,-4,81%,86%,76%,121,134,107,20%,23%,16%,2,1,1,6,1,5
415,https://vlr.gg/player/2380/zesbeew,2024-06-21 06:00:00,0.94,0.77,0.85,176,192,161,24,12,12,30,14,16,20,11,9,-4,-3,-1,83%,76%,90%,123,135,112,24%,20%,30%,1,0,1,5,3,2
416,https://vlr.gg/player/7802/flynch,2024-06-21 06:00:00,1.28,1.02,1.15,265,272,258,40,22,18,36,17,19,5,2,3,-1,0,-1,64%,62%,67%,167,153,180,35%,37%,34%,6,4,2,7,4,3
417,https://vlr.gg/player/9290/madelyn,2024-06-21 06:00:00,1.14,0.71,0.92,147,186,109,22,14,8,28,15,13,20,14,6,-4,-1,-3,62%,71%,52%,96,124,67,28%,37%,15%,0,0,0,4,1,3
418,https://vlr.gg/player/10749/k1ngkappa,2024-06-21 06:00:00,0.61,0.94,0.77,167,147,188,24,10,14,30,16,14,7,4,3,+4,+1,+3,60%,48%,71%,117,108,127,19%,20%,18%,7,3,4,3,2,1
419,https://vlr.gg/player/7049/natz,2024-06-21 06:00:00,0.57,0.88,0.73,178,156,200,24,11,13,35,19,16,18,11,7,+1,0,+1,71%,81%,62%,114,101,126,34%,32%,36%,5,2,3,4,2,2
420,https://vlr.gg/player/7046/no1syboy,2024-06-21 06:00:00,0.70,0.71,0.71,175,180,170,26,14,12,37,19,18,14,8,6,+2,+1,+1,74%,76%,71%,118,126,110,22%,24%,21%,4,2,2,2,1,1
421,https://vlr.gg/player/14224/duct,2024-06-21 06:00:00,0.92,1.28,1.12,215,176,244,43,15,28,38,18,20,23,11,12,+1,-1,+2,78%,75%,81%,140,104,167,37%,31%,41%,3,0,3,2,1,1
422,https://vlr.gg/player/14228/moefcute,2024-06-21 06:00:00,1.16,0.98,1.06,246,242,251,45,20,25,43,17,26,10,3,7,-1,-4,+3,65%,50%,77%,169,159,176,27%,34%,22%,10,3,7,11,7,4
423,https://vlr.gg/player/1432/ntk,2024-06-21 06:00:00,0.44,1.24,0.89,191,120,227,32,8,24,40,21,19,16,8,8,+3,0,+3,65%,58%,71%,126,80,162,16%,13%,17%,7,3,4,4,3,1
424,https://vlr.gg/player/36101/acerola,2024-06-21 06:00:00,0.72,1.00,0.87,196,187,211,40,15,25,42,21,21,17,5,12,-1,0,-1,65%,67%,65%,124,119,128,29%,34%,25%,2,1,1,3,1,2
425,https://vlr.gg/player/3908/akashi,2024-06-21 06:00:00,0.94,0.78,0.85,177,193,159,32,17,15,41,19,22,15,5,10,-1,-1,0,67%,63%,71%,123,127,120,18%,23%,14%,6,2,4,7,3,4
426,https://vlr.gg/player/37639/hyuse,2024-06-21 06:00:00,1.32,1.53,1.41,282,282,310,59,32,27,38,24,14,7,5,2,-3,-4,+1,69%,68%,71%,193,187,201,28%,26%,29%,7,3,4,10,7,3
427,https://vlr.gg/player/37638/shaun,2024-06-21 06:00:00,1.06,1.04,1.05,196,210,180,41,24,17,34,21,13,10,5,5,+1,-2,+3,85%,81%,92%,129,143,111,23%,22%,27%,4,1,3,3,3,0
428,https://vlr.gg/player/44144/rageee,2024-06-21 06:00:00,0.89,1.20,1.02,192,166,213,36,18,18,38,23,15,24,13,11,-1,-2,+1,76%,71%,83%,117,110,126,29%,28%,30%,3,1,2,4,3,1
429,https://vlr.gg/player/16967/namgoku,2024-06-21 06:00:00,0.89,1.14,0.99,192,180,229,36,18,18,41,25,16,18,10,8,+5,-1,+6,69%,68%,71%,131,121,144,36%,41%,31%,10,4,6,5,5,0
430,https://vlr.gg/player/14562/fuzzie,2024-06-21 06:00:00,0.82,0.86,0.84,170,174,179,32,16,16,41,24,17,28,17,11,-3,+2,-5,78%,77%,79%,120,114,127,23%,23%,23%,3,3,0,6,1,5
431,https://vlr.gg/player/7745/yoshiii,2024-06-21 05:25:00,1.21,1.47,1.35,266,223,311,70,28,42,49,24,25,8,0,8,+5,-1,+6,72%,63%,81%,180,150,206,32%,35%,30%,11,3,8,6,4,2
432,https://vlr.gg/player/25258/lumo,2024-06-21 05:25:00,1.00,1.20,1.11,180,192,176,45,21,24,43,24,19,41,16,25,+2,+1,+1,77%,75%,78%,119,120,119,15%,12%,19%,2,1,1,0,0,0
433,https://vlr.gg/player/20657/yotaa,2024-06-21 05:25:00,1.03,1.14,1.09,256,241,264,57,26,31,55,28,27,12,4,8,+5,-2,+7,68%,66%,70%,160,159,161,24%,29%,19%,17,7,10,12,9,3
434,https://vlr.gg/player/12968/tixx,2024-06-21 05:25:00,1.07,1.01,1.04,168,180,160,38,18,20,45,23,22,33,20,13,0,-1,+1,70%,75%,65%,124,126,122,24%,26%,22%,4,1,3,4,2,2
435,https://vlr.gg/player/12979/mrtenzouez,2024-06-21 05:25:00,0.36,0.96,0.68,138,96,178,32,9,23,52,28,24,23,9,14,-3,-3,0,70%,66%,73%,93,66,116,29%,29%,29%,5,1,4,8,4,4
436,https://vlr.gg/player/25221/xdll,2024-06-21 05:25:00,1.03,1.29,1.15,229,213,248,49,26,23,47,27,20,25,8,17,-3,-4,+1,71%,65%,78%,160,149,172,28%,32%,25%,4,2,2,7,6,1
437,https://vlr.gg/player/2615/clz,2024-06-21 05:25:00,0.90,1.09,0.98,211,197,222,50,25,25,47,27,20,30,11,19,+2,+1,+1,80%,70%,91%,132,113,155,23%,23%,23%,5,3,2,3,2,1
438,https://vlr.gg/player/12990/syouta,2024-06-21 05:25:00,0.45,1.52,0.95,200,100,312,49,12,37,50,29,21,8,5,3,0,-5,+5,72%,68%,78%,127,68,195,24%,11%,33%,12,3,9,12,8,4
439,https://vlr.gg/player/6673/gon,2024-06-21 05:25:00,0.92,0.98,0.95,199,190,205,51,26,25,48,28,20,25,9,16,-5,-3,-2,77%,70%,84%,130,125,136,31%,25%,38%,4,1,3,9,4,5
440,https://vlr.gg/player/1395/tennn,2024-06-21 05:25:00,0.92,0.68,0.81,178,221,135,45,28,17,50,29,21,10,5,5,-3,-4,+1,67%,62%,72%,117,139,91,45%,41%,52%,5,2,3,8,6,2
441,https://vlr.gg/player/3741/vo0kashu,2024-06-21 05:00:00,,,,242,,,57,,,43,,,16,,,+7,,,,,,163,,,35%,,,11,,,4,,
442,https://vlr.gg/player/7841/tvirusluke,2024-06-21 05:00:00,,,,237,,,48,,,51,,,16,,,+4,,,,,,156,,,23%,,,12,,,8,,
443,https://vlr.gg/player/11524/nicc,2024-06-21 05:00:00,,,,194,,,44,,,43,,,26,,,-3,,,,,,133,,,34%,,,3,,,6,,
444,https://vlr.gg/player/4880/nizhaotzh,2024-06-21 05:00:00,,,,177,,,41,,,45,,,32,,,0,,,,,,118,,,28%,,,3,,,3,,
445,https://vlr.gg/player/41774/shion7,2024-06-21 05:00:00,,,,168,,,37,,,49,,,8,,,-8,,,,,,116,,,32%,,,3,,,11,,
446,https://vlr.gg/player/1209/swerl,2024-06-21 05:00:00,,,,242,,,54,,,50,,,12,,,-2,,,,,,156,,,18%,,,8,,,10,,
447,https://vlr.gg/player/46460/ezeir,2024-06-21 05:00:00,,,,225,,,50,,,45,,,28,,,+3,,,,,,132,,,26%,,,5,,,2,,
448,https://vlr.gg/player/41054/guang,2024-06-21 05:00:00,,,,195,,,50,,,41,,,10,,,+8,,,,,,140,,,26%,,,10,,,2,,
449,https://vlr.gg/player/39697/cb,2024-06-21 05:00:00,,,,184,,,39,,,45,,,27,,,-7,,,,,,134,,,28%,,,3,,,10,,
450,https://vlr.gg/player/4402/o0o0o,2024-06-21 05:00:00,,,,169,,,38,,,46,,,31,,,-2,,,,,,120,,,26%,,,6,,,8,,
451,https://vlr.gg/player/7430/youngpork,2024-06-21 04:20:00,0.94,1.30,1.18,244,215,260,29,7,22,25,10,15,5,2,3,-1,0,-1,71%,64%,75%,166,135,180,43%,33%,49%,3,2,1,4,2,2
452,https://vlr.gg/player/7431/foods,2024-06-21 04:20:00,0.17,1.24,0.90,224,92,284,26,3,23,32,11,21,5,1,4,-1,-4,+3,57%,45%,63%,146,65,183,28%,38%,27%,6,0,6,7,4,3
453,https://vlr.gg/player/46138/sanji,2024-06-21 04:20:00,0.24,0.78,0.61,151,88,181,16,2,14,31,11,20,10,3,7,-1,0,-1,63%,64%,63%,104,71,119,42%,31%,45%,2,0,2,3,0,3
454,https://vlr.gg/player/7429/cms,2024-06-21 04:20:00,0.51,0.55,0.51,106,118,103,13,5,8,29,10,19,7,1,6,-3,-2,-1,51%,45%,54%,81,79,81,26%,45%,19%,0,0,0,3,2,1
455,https://vlr.gg/player/46471/hirenkyaku,2024-06-21 04:20:00,0.58,0.37,0.43,123,162,105,13,6,7,32,11,21,6,1,5,+1,+1,0,51%,55%,50%,83,108,71,28%,47%,20%,4,1,3,3,0,3
456,https://vlr.gg/player/16953/zynd,2024-06-21 04:20:00,1.88,1.55,1.77,350,374,294,44,32,12,19,14,5,7,5,2,+5,+4,+1,86%,83%,91%,232,240,215,35%,36%,33%,7,5,2,2,1,1
457,https://vlr.gg/player/13744/patmen,2024-06-21 04:20:00,0.91,2.21,1.32,274,209,411,38,20,18,21,16,5,5,4,1,+3,+1,+2,71%,67%,82%,161,122,245,41%,27%,60%,5,2,3,2,1,1
458,https://vlr.gg/player/13223/micr0,2024-06-21 04:20:00,1.14,1.36,1.21,180,186,172,22,16,6,18,15,3,18,11,7,0,-1,+1,77%,71%,91%,116,121,107,33%,39%,23%,2,1,1,2,2,0
459,https://vlr.gg/player/9737/kakarot,2024-06-21 04:20:00,0.93,1.50,1.11,233,218,266,30,17,13,22,17,5,11,8,3,-3,-5,+2,83%,79%,91%,154,146,171,19%,17%,24%,5,3,2,8,8,0
460,https://vlr.gg/player/7746/kevzii,2024-06-21 04:20:00,1.04,0.77,0.95,135,155,97,15,11,4,18,13,5,22,19,3,0,+1,-1,80%,83%,73%,87,93,74,21%,20%,25%,1,1,0,1,0,1
461,https://vlr.gg/player/46045/aderrr,2024-06-21 03:00:00,1.20,0.88,1.02,207,259,172,48,26,22,45,21,24,18,5,13,0,+2,-2,73%,79%,69%,127,153,108,39%,40%,38%,6,4,2,6,2,4
462,https://vlr.gg/player/9280/padangrice,2024-06-21 03:00:00,0.83,1.16,1.02,204,185,220,45,17,28,47,23,24,20,8,12,0,-1,+1,77%,71%,81%,143,132,151,19%,19%,18%,4,1,3,4,2,2
463,https://vlr.gg/player/23671/mas,2024-06-21 03:00:00,0.65,1.17,0.94,223,193,247,42,16,26,51,25,26,18,7,11,-4,-5,+1,67%,61%,72%,151,132,166,23%,21%,24%,8,2,6,12,7,5
464,https://vlr.gg/player/34082/tupai,2024-06-21 03:00:00,0.69,1.03,0.88,194,174,209,45,18,27,48,23,25,20,8,12,-1,-2,+1,75%,71%,78%,123,102,139,33%,28%,36%,5,1,4,6,3,3
465,https://vlr.gg/player/8257/limitado,2024-06-21 03:00:00,0.70,1.03,0.88,177,140,207,44,15,29,47,22,25,14,11,3,-7,-2,-5,69%,61%,75%,120,90,143,34%,34%,34%,3,2,1,10,4,6
466,https://vlr.gg/player/10738/heynf,2024-06-21 03:00:00,1.32,1.79,1.53,268,228,320,67,32,35,37,22,15,24,12,12,+3,+1,+2,86%,83%,89%,167,144,196,36%,38%,35%,5,3,2,2,2,0
467,https://vlr.gg/player/15678/reeq,2024-06-21 03:00:00,1.26,1.18,1.22,231,248,203,51,31,20,42,26,16,21,11,10,+3,+3,0,73%,69%,79%,148,155,138,31%,33%,29%,7,6,1,4,3,1
468,https://vlr.gg/player/23709/jefz,2024-06-21 03:00:00,0.75,1.19,0.94,223,197,251,47,24,23,48,29,19,11,2,9,+2,0,+2,70%,64%,79%,144,124,170,11%,11%,11%,10,4,6,8,4,4
469,https://vlr.gg/player/10807/dragy,2024-06-21 03:00:00,0.78,0.94,0.85,188,162,223,41,19,22,51,27,24,28,19,9,+1,-1,+2,73%,67%,82%,118,107,133,23%,22%,24%,8,3,5,7,4,3
470,https://vlr.gg/player/4867/onigiri,2024-06-21 03:00:00,0.72,0.87,0.78,146,149,150,32,18,14,46,28,18,18,9,9,+3,+1,+2,72%,64%,82%,96,95,97,26%,22%,33%,8,4,4,5,3,2
471,https://vlr.gg/player/34776/absol,2024-06-21 02:00:00,1.10,1.14,1.12,230,238,230,48,20,28,45,20,25,19,9,10,+6,+2,+4,69%,68%,69%,153,158,149,21%,19%,23%,11,4,7,5,2,3
472,https://vlr.gg/player/700/million,2024-06-21 02:00:00,0.74,1.30,1.08,197,157,230,43,15,28,45,22,23,33,10,23,+2,0,+2,74%,56%,86%,142,115,160,30%,37%,27%,4,1,3,2,1,1
473,https://vlr.gg/player/20465/biju,2024-06-21 02:00:00,0.80,1.04,0.94,170,178,173,37,16,21,42,20,22,18,6,12,+4,+2,+2,69%,76%,64%,121,117,125,23%,27%,21%,6,2,4,2,0,2
474,https://vlr.gg/player/1003/reita,2024-06-21 02:00:00,0.63,0.97,0.83,205,160,243,41,13,28,50,19,31,12,4,8,+1,-1,+2,74%,64%,81%,139,108,161,23%,24%,22%,11,5,6,10,6,4
475,https://vlr.gg/player/686/tonbo,2024-06-21 02:00:00,0.67,0.96,0.83,151,130,165,36,13,23,44,20,24,17,4,13,+2,0,+2,64%,64%,64%,104,90,114,31%,39%,27%,6,2,4,4,2,2
476,https://vlr.gg/player/17169/muto,2024-06-21 02:00:00,0.87,1.62,1.18,233,168,318,48,21,27,41,25,16,25,13,12,+2,-2,+4,69%,58%,84%,153,110,216,30%,25%,36%,5,1,4,3,3,0
477,https://vlr.gg/player/34827/hals,2024-06-21 02:00:00,1.05,1.34,1.17,227,216,237,47,26,21,40,25,15,15,7,8,0,-1,+1,66%,58%,76%,155,144,171,22%,22%,22%,3,1,2,3,2,1
478,https://vlr.gg/player/4664/gangpin,2024-06-21 02:00:00,1.09,1.11,1.10,186,179,196,41,24,17,34,21,13,32,19,13,0,+1,-1,80%,81%,80%,127,127,126,28%,29%,26%,4,3,1,4,2,2
479,https://vlr.gg/player/13002/akame,2024-06-21 02:00:00,1.04,1.14,1.08,238,257,228,53,32,21,47,30,17,11,5,6,-6,-5,-1,75%,69%,84%,146,157,130,19%,21%,17%,6,3,3,12,8,4
480,https://vlr.gg/player/25915/brian,2024-06-21 02:00:00,0.87,0.91,0.88,190,186,178,37,22,15,43,27,16,22,11,11,-11,-5,-6,70%,69%,72%,122,122,122,36%,36%,36%,5,4,1,16,9,7
481,https://vlr.gg/player/19975/yort,2024-06-21 02:00:00,1.04,1.04,1.04,201,210,191,30,17,13,32,19,13,18,13,5,-2,-2,0,73%,72%,74%,142,149,132,25%,24%,25%,3,1,2,5,3,2
482,https://vlr.gg/player/27171/grooovy,2024-06-21 02:00:00,1.24,0.69,1.00,203,235,168,29,23,6,33,18,15,18,5,13,-2,0,-2,70%,76%,63%,143,150,133,22%,30%,15%,2,1,1,4,1,3
483,https://vlr.gg/player/27173/sovano,2024-06-21 02:00:00,0.56,1.06,0.78,215,172,264,33,15,18,37,22,15,3,1,2,0,-2,+2,66%,64%,68%,133,110,165,24%,24%,24%,10,6,4,10,8,2
484,https://vlr.gg/player/27172/jacobbb,2024-06-21 02:00:00,0.78,0.56,0.68,130,153,106,19,12,7,34,18,16,12,6,6,+2,+2,0,68%,68%,68%,88,109,61,27%,29%,22%,3,2,1,1,0,1
485,https://vlr.gg/player/10190/gabbydiz,2024-06-21 02:00:00,0.75,0.56,0.67,137,160,123,23,15,8,36,21,15,11,5,6,-4,-1,-3,59%,60%,58%,101,108,93,34%,33%,35%,1,1,0,5,2,3
486,https://vlr.gg/player/7437/kellys,2024-06-21 02:00:00,1.31,1.53,1.43,305,279,338,47,18,29,33,13,20,11,4,7,+4,+2,+2,77%,74%,80%,216,187,238,25%,30%,23%,10,6,4,6,4,2
487,https://vlr.gg/player/7754/xavi8k,2024-06-21 02:00:00,1.20,1.42,1.32,251,229,257,41,16,25,26,12,14,12,5,7,+6,+3,+3,86%,89%,84%,160,159,160,28%,33%,25%,7,3,4,1,0,1
488,https://vlr.gg/player/10217/marky,2024-06-21 02:00:00,1.33,1.20,1.26,186,167,198,26,11,15,20,6,14,17,6,11,+1,-1,+2,84%,79%,88%,137,118,152,31%,41%,25%,2,0,2,1,1,0
489,https://vlr.gg/player/10782/witz,2024-06-21 02:00:00,1.48,0.79,1.08,196,225,164,30,15,15,27,9,18,21,11,10,-2,0,-2,80%,84%,76%,127,159,102,24%,30%,19%,2,0,2,4,0,4
490,https://vlr.gg/player/2679/dubstep,2024-06-21 02:00:00,1.13,0.98,1.04,190,196,177,28,14,14,28,12,16,21,7,14,-3,-1,-2,75%,79%,72%,121,115,125,28%,31%,26%,4,2,2,7,3,4
491,https://vlr.gg/player/10557/darker,2024-06-20 21:30:00,1.21,1.30,1.26,250,256,245,47,23,24,37,20,17,18,9,9,0,-2,+2,78%,76%,80%,163,171,155,28%,30%,27%,3,0,3,3,2,1
492,https://vlr.gg/player/3983/virtyy,2024-06-20 21:30:00,0.82,1.51,1.17,274,251,300,41,17,24,39,24,15,19,7,12,+8,+2,+6,80%,72%,88%,194,175,214,28%,28%,29%,15,8,7,7,6,1
493,https://vlr.gg/player/7616/feniz,2024-06-20 21:30:00,0.98,1.08,1.03,181,180,181,32,16,16,30,17,13,19,10,9,0,-2,+2,76%,64%,88%,123,126,119,34%,33%,35%,2,0,2,2,2,0
494,https://vlr.gg/player/8056/mited,2024-06-20 21:30:00,0.80,1.10,0.95,206,175,237,37,15,22,37,20,17,21,12,9,+1,0,+1,74%,72%,76%,136,113,160,21%,17%,23%,4,1,3,3,1,2
495,https://vlr.gg/player/17690/jow,2024-06-20 21:30:00,0.68,1.15,0.91,160,120,198,30,11,19,33,19,14,8,3,5,+3,-1,+4,70%,56%,84%,110,90,131,36%,50%,30%,7,2,5,4,3,1
496,https://vlr.gg/player/2490/jfoen,2024-06-20 21:30:00,1.20,1.37,1.29,248,244,252,43,21,22,34,20,14,20,8,12,-1,-5,+4,74%,64%,84%,169,169,169,35%,35%,36%,4,0,4,5,5,0
497,https://vlr.gg/player/8790/mininiwde,2024-06-20 21:30:00,0.99,1.29,1.14,189,168,209,34,14,20,33,19,14,26,16,10,-5,-1,-4,76%,72%,80%,132,113,151,33%,35%,32%,0,0,0,5,1,4
498,https://vlr.gg/player/13962/nate,2024-06-20 21:30:00,0.57,1.21,0.89,222,172,271,36,13,23,44,24,20,12,7,5,-1,-4,+3,72%,68%,76%,149,112,186,29%,22%,35%,10,3,7,11,7,4
499,https://vlr.gg/player/8792/xhowi,2024-06-20 21:30:00,0.79,0.97,0.88,194,195,193,34,17,17,39,22,17,12,4,8,-1,-1,0,72%,68%,76%,129,127,130,35%,43%,28%,3,2,1,4,3,1
500,https://vlr.gg/player/8286/glyph,2024-06-20 21:30:00,0.57,1.06,0.81,167,124,213,29,11,18,37,20,17,11,2,9,-4,-4,0,68%,56%,80%,110,86,133,17%,19%,17%,2,0,2,6,4,2
